char,height,origin_path,path,seg_areas,width,x1,x2,y1,y2,isTrain,label
8,28,"kaist_dataset/Korean/Mobile_Phone/(M,K)C-outdoor/P090912042.jpg",char_data/8/P090912042.jpg_2.jpg,504,18,347,365,256,284,True,10
8,50,"kaist_dataset/Korean/Mobile_Phone/(M,K)C-outdoor/P090912033.jpg",char_data/8/P090912033.jpg_2.jpg,2000,40,207,247,354,404,True,10
8,43,"kaist_dataset/Korean/Mobile_Phone/(M,K)C-outdoor/P090912034.jpg",char_data/8/P090912034.jpg_4.jpg,1204,28,97,125,258,301,True,10
8,44,"kaist_dataset/Korean/Mobile_Phone/(M,K)C-outdoor/P090912034.jpg",char_data/8/P090912034.jpg_4.jpg,1144,26,235,261,258,302,True,10
8,39,kaist_dataset/Korean/Digital_Camera/outdoor5/DSC03996.JPG,char_data/8/DSC03996.JPG_2.jpg,1248,32,224,256,286,325,True,10
8,62,kaist_dataset/Korean/Digital_Camera/outdoor5/DSC03979.JPG,char_data/8/DSC03979.JPG_2.jpg,4588,74,39,113,374,436,True,10
8,37,kaist_dataset/Korean/Digital_Camera/outdoor5/DSC03627.JPG,char_data/8/DSC03627.JPG_2.jpg,1147,31,387,418,223,260,True,10
8,36,kaist_dataset/Korean/Digital_Camera/outdoor5/DSC03768.JPG,char_data/8/DSC03768.JPG_6.jpg,756,21,443,464,241,277,True,10
8,35,kaist_dataset/Korean/Digital_Camera/outdoor5/DSC03768.JPG,char_data/8/DSC03768.JPG_6.jpg,735,21,466,487,241,276,True,10
8,36,kaist_dataset/Korean/Digital_Camera/outdoor5/DSC03768.JPG,char_data/8/DSC03768.JPG_6.jpg,792,22,503,525,239,275,True,10
8,27,kaist_dataset/Korean/Digital_Camera/outdoor5/DSC03688.JPG,char_data/8/DSC03688.JPG_2.jpg,297,11,555,566,229,256,True,10
8,25,kaist_dataset/Korean/Digital_Camera/outdoor5/DSC03744.JPG,char_data/8/DSC03744.JPG_2.jpg,775,31,282,313,307,332,True,10
8,23,kaist_dataset/Korean/Digital_Camera/outdoor5/DSC03780.JPG,char_data/8/DSC03780.JPG_2.jpg,345,15,159,174,443,466,True,10
8,38,kaist_dataset/Korean/Digital_Camera/outdoor5/DSC03779.JPG,char_data/8/DSC03779.JPG_2.jpg,722,19,487,506,240,278,True,10
8,30,kaist_dataset/Korean/Digital_Camera/outdoor5/DSC03736.JPG,char_data/8/DSC03736.JPG_4.jpg,450,15,312,327,406,436,True,10
8,27,kaist_dataset/Korean/Digital_Camera/outdoor5/DSC03736.JPG,char_data/8/DSC03736.JPG_4.jpg,486,18,353,371,408,435,True,10
8,38,kaist_dataset/Korean/Digital_Camera/outdoor5/DSC03692.JPG,char_data/8/DSC03692.JPG_2.jpg,722,19,518,537,188,226,True,10
8,37,kaist_dataset/Korean/Digital_Camera/outdoor5/DSC03671.JPG,char_data/8/DSC03671.JPG_6.jpg,703,19,261,280,408,445,True,10
8,35,kaist_dataset/Korean/Digital_Camera/outdoor5/DSC03671.JPG,char_data/8/DSC03671.JPG_6.jpg,490,14,281,295,407,442,True,10
8,36,kaist_dataset/Korean/Digital_Camera/outdoor5/DSC03671.JPG,char_data/8/DSC03671.JPG_6.jpg,576,16,475,491,410,446,True,10
8,94,kaist_dataset/Korean/Digital_Camera/outdoor5/DSC03715.JPG,char_data/8/DSC03715.JPG_4.jpg,4136,44,273,317,80,174,True,10
8,90,kaist_dataset/Korean/Digital_Camera/outdoor5/DSC03715.JPG,char_data/8/DSC03715.JPG_4.jpg,4050,45,317,362,83,173,True,10
8,66,kaist_dataset/Korean/Digital_Camera/outdoor5/DSC03694.JPG,char_data/8/DSC03694.JPG_4.jpg,2046,31,439,470,113,179,True,10
8,68,kaist_dataset/Korean/Digital_Camera/outdoor5/DSC03694.JPG,char_data/8/DSC03694.JPG_4.jpg,1972,29,469,498,109,177,True,10
8,24,kaist_dataset/Korean/Digital_Camera/outdoor5/DSC03752.JPG,char_data/8/DSC03752.JPG_4.jpg,408,17,105,122,412,436,True,10
8,30,kaist_dataset/Korean/Digital_Camera/outdoor5/DSC03752.JPG,char_data/8/DSC03752.JPG_4.jpg,420,14,151,165,409,439,True,10
8,40,kaist_dataset/Korean/Digital_Camera/outdoor5/DSC03685.JPG,char_data/8/DSC03685.JPG_10.jpg,920,23,110,133,187,227,True,10
8,38,kaist_dataset/Korean/Digital_Camera/outdoor5/DSC03685.JPG,char_data/8/DSC03685.JPG_10.jpg,874,23,216,239,187,225,True,10
8,36,kaist_dataset/Korean/Digital_Camera/outdoor5/DSC03685.JPG,char_data/8/DSC03685.JPG_10.jpg,828,23,240,263,188,224,True,10
8,35,kaist_dataset/Korean/Digital_Camera/outdoor5/DSC03685.JPG,char_data/8/DSC03685.JPG_10.jpg,805,23,361,384,187,222,True,10
8,36,kaist_dataset/Korean/Digital_Camera/outdoor5/DSC03685.JPG,char_data/8/DSC03685.JPG_10.jpg,828,23,462,485,186,222,True,10
8,51,kaist_dataset/Korean/Digital_Camera/outdoor5/DSC03708.JPG,char_data/8/DSC03708.JPG_4.jpg,1581,31,354,385,264,315,True,10
8,48,kaist_dataset/Korean/Digital_Camera/outdoor5/DSC03708.JPG,char_data/8/DSC03708.JPG_4.jpg,1392,29,431,460,260,308,True,10
8,36,kaist_dataset/Korean/Digital_Camera/outdoor5/DSC03778.JPG,char_data/8/DSC03778.JPG_6.jpg,612,17,319,336,338,374,True,10
8,38,kaist_dataset/Korean/Digital_Camera/outdoor5/DSC03778.JPG,char_data/8/DSC03778.JPG_6.jpg,494,13,405,418,339,377,True,10
8,39,kaist_dataset/Korean/Digital_Camera/outdoor5/DSC03778.JPG,char_data/8/DSC03778.JPG_6.jpg,741,19,420,439,337,376,True,10
8,36,kaist_dataset/Korean/Digital_Camera/outdoor5/DSC03770.JPG,char_data/8/DSC03770.JPG_6.jpg,792,22,462,484,423,459,True,10
8,36,kaist_dataset/Korean/Digital_Camera/outdoor5/DSC03770.JPG,char_data/8/DSC03770.JPG_6.jpg,756,21,485,506,421,457,True,10
8,39,kaist_dataset/Korean/Digital_Camera/outdoor5/DSC03770.JPG,char_data/8/DSC03770.JPG_6.jpg,858,22,524,546,423,462,True,10
8,36,kaist_dataset/Korean/Digital_Camera/outdoor5/DSC04040.JPG,char_data/8/DSC04040.JPG_2.jpg,1188,33,310,343,339,375,True,10
8,70,kaist_dataset/Korean/Digital_Camera/outdoor5/DSC03749.JPG,char_data/8/DSC03749.JPG_2.jpg,2310,33,368,401,404,474,True,10
8,40,kaist_dataset/Korean/Digital_Camera/outdoor5/DSC03709.JPG,char_data/8/DSC03709.JPG_2.jpg,560,14,450,464,361,401,True,10
8,35,kaist_dataset/Korean/Digital_Camera/outdoor5/DSC03789.JPG,char_data/8/DSC03789.JPG_2.jpg,700,20,249,269,212,247,True,10
8,45,kaist_dataset/Korean/Digital_Camera/outdoor5/DSC03626.JPG,char_data/8/DSC03626.JPG_8.jpg,1215,27,158,185,294,339,True,10
8,43,kaist_dataset/Korean/Digital_Camera/outdoor5/DSC03626.JPG,char_data/8/DSC03626.JPG_8.jpg,1376,32,319,351,298,341,True,10
8,43,kaist_dataset/Korean/Digital_Camera/outdoor5/DSC03626.JPG,char_data/8/DSC03626.JPG_8.jpg,1075,25,404,429,297,340,True,10
8,48,kaist_dataset/Korean/Digital_Camera/outdoor5/DSC03626.JPG,char_data/8/DSC03626.JPG_8.jpg,1392,29,530,559,293,341,True,10
8,24,kaist_dataset/Korean/Digital_Camera/outdoor5/DSC03751.JPG,char_data/8/DSC03751.JPG_2.jpg,504,21,243,264,416,440,True,10
8,39,kaist_dataset/Korean/Digital_Camera/outdoor5/DSC03970.JPG,char_data/8/DSC03970.JPG_4.jpg,1443,37,62,99,99,138,True,10
8,48,kaist_dataset/Korean/Digital_Camera/outdoor5/DSC03970.JPG,char_data/8/DSC03970.JPG_4.jpg,1728,36,202,238,93,141,True,10
8,37,kaist_dataset/Korean/Digital_Camera/outdoor5/DSC03669.JPG,char_data/8/DSC03669.JPG_2.jpg,1073,29,239,268,315,352,True,10
8,36,kaist_dataset/Korean/Digital_Camera/outdoor5/DSC03636.JPG,char_data/8/DSC03636.JPG_4.jpg,756,21,252,273,394,430,True,10
8,36,kaist_dataset/Korean/Digital_Camera/outdoor5/DSC03636.JPG,char_data/8/DSC03636.JPG_4.jpg,720,20,362,382,394,430,True,10
8,29,kaist_dataset/Korean/Digital_Camera/outdoor5/DSC04028.JPG,char_data/8/DSC04028.JPG_6.jpg,725,25,303,328,344,373,True,10
8,24,kaist_dataset/Korean/Digital_Camera/outdoor5/DSC04028.JPG,char_data/8/DSC04028.JPG_6.jpg,552,23,328,351,345,369,True,10
8,26,kaist_dataset/Korean/Digital_Camera/outdoor5/DSC04028.JPG,char_data/8/DSC04028.JPG_6.jpg,572,22,391,413,344,370,True,10
8,40,kaist_dataset/Korean/Digital_Camera/outdoor5/DSC03740.JPG,char_data/8/DSC03740.JPG_2.jpg,920,23,376,399,286,326,True,10
8,35,kaist_dataset/Korean/Digital_Camera/outdoor5/DSC03641.JPG,char_data/8/DSC03641.JPG_2.jpg,630,18,382,400,418,453,True,10
8,17,kaist_dataset/Korean/Digital_Camera/outdoor5/DSC03776.JPG,char_data/8/DSC03776.JPG_8.jpg,204,12,498,510,440,457,True,10
8,21,kaist_dataset/Korean/Digital_Camera/outdoor5/DSC03776.JPG,char_data/8/DSC03776.JPG_8.jpg,210,10,497,507,420,441,True,10
8,18,kaist_dataset/Korean/Digital_Camera/outdoor5/DSC03776.JPG,char_data/8/DSC03776.JPG_8.jpg,198,11,554,565,424,442,True,10
8,20,kaist_dataset/Korean/Digital_Camera/outdoor5/DSC03776.JPG,char_data/8/DSC03776.JPG_8.jpg,260,13,565,578,424,444,True,10
8,41,kaist_dataset/Korean/Digital_Camera/outdoor5/DSC03645.JPG,char_data/8/DSC03645.JPG_2.jpg,1025,25,353,378,351,392,True,10
8,39,kaist_dataset/Korean/Digital_Camera/outdoor4/DSC03293.JPG,char_data/8/DSC03293.JPG_4.jpg,468,12,308,320,286,325,True,10
8,34,kaist_dataset/Korean/Digital_Camera/outdoor4/DSC03293.JPG,char_data/8/DSC03293.JPG_4.jpg,510,15,340,355,286,320,True,10
8,103,kaist_dataset/Korean/Digital_Camera/outdoor4/DSC03542.JPG,char_data/8/DSC03542.JPG_2.jpg,4841,47,294,341,235,338,True,10
8,31,kaist_dataset/Korean/Digital_Camera/outdoor4/DSC03295.JPG,char_data/8/DSC03295.JPG_2.jpg,589,19,241,260,401,432,True,10
8,49,kaist_dataset/Korean/Digital_Camera/outdoor4/DSC03607.JPG,char_data/8/DSC03607.JPG_2.jpg,1568,32,99,131,161,210,True,10
8,47,kaist_dataset/Korean/Digital_Camera/outdoor4/DSC03614.JPG,char_data/8/DSC03614.JPG_2.jpg,1175,25,337,362,392,439,True,10
8,47,kaist_dataset/Korean/Digital_Camera/outdoor4/DSC03319.JPG,char_data/8/DSC03319.JPG_2.jpg,1316,28,242,270,82,129,True,10
8,67,kaist_dataset/Korean/Digital_Camera/outdoor4/DSC03550.JPG,char_data/8/DSC03550.JPG_2.jpg,3484,52,207,259,307,374,True,10
8,91,kaist_dataset/Korean/Digital_Camera/outdoor4/DSC03566.JPG,char_data/8/DSC03566.JPG_4.jpg,5278,58,151,209,149,240,True,10
8,33,kaist_dataset/Korean/Digital_Camera/outdoor4/DSC03566.JPG,char_data/8/DSC03566.JPG_4.jpg,2079,63,106,169,92,125,True,10
8,50,kaist_dataset/Korean/Digital_Camera/outdoor4/DSC03601.JPG,char_data/8/DSC03601.JPG_2.jpg,1950,39,280,319,239,289,True,10
8,57,kaist_dataset/Korean/Digital_Camera/outdoor4/DSC03537.JPG,char_data/8/DSC03537.JPG_8.jpg,2223,39,311,350,134,191,True,10
8,59,kaist_dataset/Korean/Digital_Camera/outdoor4/DSC03537.JPG,char_data/8/DSC03537.JPG_8.jpg,2478,42,423,465,127,186,True,10
8,62,kaist_dataset/Korean/Digital_Camera/outdoor4/DSC03537.JPG,char_data/8/DSC03537.JPG_8.jpg,2604,42,504,546,121,183,True,10
8,66,kaist_dataset/Korean/Digital_Camera/outdoor4/DSC03537.JPG,char_data/8/DSC03537.JPG_8.jpg,2640,40,548,588,117,183,True,10
8,48,kaist_dataset/Korean/Digital_Camera/outdoor4/DSC03580.JPG,char_data/8/DSC03580.JPG_2.jpg,1344,28,249,277,213,261,True,10
8,27,kaist_dataset/Korean/Digital_Camera/outdoor4/DSC03555.JPG,char_data/8/DSC03555.JPG_2.jpg,648,24,319,343,426,453,True,10
8,56,kaist_dataset/Korean/Digital_Camera/outdoor4/DSC03261.JPG,char_data/8/DSC03261.JPG_2.jpg,2072,37,239,276,390,446,True,10
8,30,kaist_dataset/Korean/Digital_Camera/outdoor2/DSC02467.JPG,char_data/8/DSC02467.JPG_4.jpg,1050,35,212,247,257,287,True,10
8,37,kaist_dataset/Korean/Digital_Camera/outdoor2/DSC02467.JPG,char_data/8/DSC02467.JPG_4.jpg,629,17,323,340,257,294,True,10
8,58,kaist_dataset/Korean/Digital_Camera/outdoor2/2007-12-09-day-exterior-016.jpg,char_data/8/2007-12-09-day-exterior-016.jpg_4.jpg,1740,30,27,57,355,413,True,10
8,59,kaist_dataset/Korean/Digital_Camera/outdoor2/2007-12-09-day-exterior-016.jpg,char_data/8/2007-12-09-day-exterior-016.jpg_4.jpg,2419,41,508,549,748,807,True,10
8,41,kaist_dataset/Korean/Digital_Camera/outdoor2/DSC02476.JPG,char_data/8/DSC02476.JPG_4.jpg,1230,30,213,243,275,316,True,10
8,40,kaist_dataset/Korean/Digital_Camera/outdoor2/DSC02476.JPG,char_data/8/DSC02476.JPG_4.jpg,1040,26,362,388,270,310,True,10
8,23,kaist_dataset/Korean/Digital_Camera/outdoor2/DSC02314.JPG,char_data/8/DSC02314.JPG_4.jpg,414,18,323,341,204,227,True,10
8,23,kaist_dataset/Korean/Digital_Camera/outdoor2/DSC02314.JPG,char_data/8/DSC02314.JPG_4.jpg,368,16,396,412,204,227,True,10
8,68,kaist_dataset/Korean/Digital_Camera/outdoor2/2007-12-08-day-101.jpg,char_data/8/2007-12-08-day-101.jpg_4.jpg,2448,36,723,759,634,702,True,10
8,37,kaist_dataset/Korean/Digital_Camera/outdoor2/2007-12-08-day-101.jpg,char_data/8/2007-12-08-day-101.jpg_4.jpg,703,19,808,827,743,780,True,10
8,29,kaist_dataset/Korean/Digital_Camera/outdoor2/DSC02308.JPG,char_data/8/DSC02308.JPG_2.jpg,1044,36,222,258,241,270,True,10
8,35,kaist_dataset/Korean/Digital_Camera/outdoor2/2007-12-09-day-exterior-036.jpg,char_data/8/2007-12-09-day-exterior-036.jpg_2.jpg,805,23,1434,1457,629,664,True,10
8,31,kaist_dataset/Korean/Digital_Camera/outdoor2/2007-12-08-day-122.jpg,char_data/8/2007-12-08-day-122.jpg_1.jpg,1736,56,883,939,113,144,True,10
8,40,kaist_dataset/Korean/Digital_Camera/outdoor2/2007-12-08-day-122.jpg,char_data/8/2007-12-08-day-122.jpg_1.jpg,1040,26,1191,1217,566,606,True,10
8,40,kaist_dataset/Korean/Digital_Camera/outdoor2/2007-12-09-day-exterior-084.jpg,char_data/8/2007-12-09-day-exterior-084.jpg_0.jpg,1680,42,722,764,806,846,True,10
8,63,kaist_dataset/Korean/Digital_Camera/outdoor2/2007-12-09-day-exterior-033.jpg,char_data/8/2007-12-09-day-exterior-033.jpg_0.jpg,5607,89,403,492,726,789,True,10
8,54,kaist_dataset/Korean/Digital_Camera/outdoor2/DSC02305.JPG,char_data/8/DSC02305.JPG_0.jpg,2268,42,321,363,248,302,True,10
8,52,kaist_dataset/Korean/Digital_Camera/outdoor2/DSC02305.JPG,char_data/8/DSC02305.JPG_0.jpg,1976,38,565,603,247,299,True,10
8,22,kaist_dataset/Korean/Digital_Camera/outdoor2/DSC02326.JPG,char_data/8/DSC02326.JPG_0.jpg,396,18,363,381,340,362,True,10
8,33,kaist_dataset/Korean/Digital_Camera/outdoor2/DSC02326.JPG,char_data/8/DSC02326.JPG_0.jpg,462,14,477,491,336,369,True,10
8,31,kaist_dataset/Korean/Digital_Camera/outdoor2/DSC02426.JPG,char_data/8/DSC02426.JPG_0.jpg,806,26,491,517,220,251,True,10
8,31,kaist_dataset/Korean/Digital_Camera/outdoor2/DSC02396.JPG,char_data/8/DSC02396.JPG_0.jpg,806,26,346,372,375,406,True,10
8,46,kaist_dataset/Korean/Digital_Camera/outdoor2/080119-0031.jpg,char_data/8/080119-0031.jpg_0.jpg,966,21,591,612,1105,1151,True,10
8,30,kaist_dataset/Korean/Digital_Camera/outdoor2/DSC02441.JPG,char_data/8/DSC02441.JPG_0.jpg,480,16,427,443,199,229,True,10
8,24,kaist_dataset/Korean/Digital_Camera/outdoor2/DSC02424.JPG,char_data/8/DSC02424.JPG_0.jpg,480,20,452,472,244,268,True,10
8,27,kaist_dataset/Korean/Digital_Camera/outdoor2/DSC02424.JPG,char_data/8/DSC02424.JPG_0.jpg,405,15,518,533,244,271,True,10
8,25,kaist_dataset/Korean/Digital_Camera/outdoor2/DSC02424.JPG,char_data/8/DSC02424.JPG_0.jpg,275,11,534,545,246,271,True,10
8,34,kaist_dataset/Korean/Digital_Camera/outdoor2/DSC02393.JPG,char_data/8/DSC02393.JPG_0.jpg,646,19,456,475,307,341,True,10
8,35,kaist_dataset/Korean/Digital_Camera/outdoor2/DSC02393.JPG,char_data/8/DSC02393.JPG_0.jpg,805,23,586,609,305,340,True,10
8,42,kaist_dataset/Korean/Digital_Camera/outdoor2/DSC02366.JPG,char_data/8/DSC02366.JPG_0.jpg,1176,28,316,344,404,446,True,10
8,37,kaist_dataset/Korean/Digital_Camera/outdoor2/DSC02381.JPG,char_data/8/DSC02381.JPG_0.jpg,999,27,201,228,316,353,True,10
8,42,kaist_dataset/Korean/Digital_Camera/outdoor2/DSC02414.JPG,char_data/8/DSC02414.JPG_0.jpg,1554,37,327,364,243,285,True,10
8,34,kaist_dataset/Korean/Digital_Camera/outdoor2/DSC02380.JPG,char_data/8/DSC02380.JPG_0.jpg,714,21,339,360,238,272,True,10
8,37,kaist_dataset/Korean/Digital_Camera/outdoor2/DSC02311.JPG,char_data/8/DSC02311.JPG_0.jpg,814,22,447,469,252,289,True,10
8,27,kaist_dataset/Korean/Digital_Camera/outdoor2/DSC02435.JPG,char_data/8/DSC02435.JPG_0.jpg,486,18,469,487,248,275,True,10
8,21,kaist_dataset/Korean/Digital_Camera/outdoor2/DSC02435.JPG,char_data/8/DSC02435.JPG_0.jpg,315,15,575,590,250,271,True,10
8,81,kaist_dataset/Korean/Digital_Camera/outdoor2/DSC02451.JPG,char_data/8/DSC02451.JPG_0.jpg,5022,62,55,117,330,411,True,10
8,80,kaist_dataset/Korean/Digital_Camera/outdoor2/DSC02451.JPG,char_data/8/DSC02451.JPG_0.jpg,4400,55,374,429,320,400,True,10
8,84,kaist_dataset/Korean/Digital_Camera/outdoor2/DSC02451.JPG,char_data/8/DSC02451.JPG_0.jpg,5040,60,429,489,319,403,True,10
8,37,kaist_dataset/Korean/Digital_Camera/outdoor2/DSC02383.JPG,char_data/8/DSC02383.JPG_0.jpg,740,20,26,46,296,333,True,10
8,25,kaist_dataset/Korean/Digital_Camera/outdoor2/DSC02373.JPG,char_data/8/DSC02373.JPG_0.jpg,400,16,339,355,337,362,True,10
8,21,kaist_dataset/Korean/Digital_Camera/outdoor2/DSC02373.JPG,char_data/8/DSC02373.JPG_0.jpg,336,16,420,436,340,361,True,10
8,29,kaist_dataset/Korean/Digital_Camera/outdoor2/DSC02321.JPG,char_data/8/DSC02321.JPG_0.jpg,667,23,184,207,379,408,True,10
8,33,kaist_dataset/Korean/Digital_Camera/outdoor2/DSC02321.JPG,char_data/8/DSC02321.JPG_0.jpg,990,30,340,370,378,411,True,10
8,37,kaist_dataset/Korean/Digital_Camera/outdoor2/DSC02321.JPG,char_data/8/DSC02321.JPG_0.jpg,666,18,320,338,376,413,True,10
8,33,kaist_dataset/Korean/Digital_Camera/outdoor2/DSC02386.JPG,char_data/8/DSC02386.JPG_0.jpg,660,20,426,446,260,293,True,10
8,32,kaist_dataset/Korean/Digital_Camera/outdoor2/DSC02299.JPG,char_data/8/DSC02299.JPG_0.jpg,736,23,557,580,210,242,True,10
8,53,kaist_dataset/Korean/Digital_Camera/outdoor2/DSC02512.JPG,char_data/8/DSC02512.JPG_0.jpg,2014,38,385,423,290,343,True,10
8,35,kaist_dataset/Korean/Digital_Camera/outdoor2/DSC02371.JPG,char_data/8/DSC02371.JPG_0.jpg,945,27,109,136,240,275,True,10
8,51,kaist_dataset/Korean/Digital_Camera/outdoor2/2007-12-09-day-exterior-035.jpg,char_data/8/2007-12-09-day-exterior-035.jpg_0.jpg,1785,35,409,444,709,760,True,10
8,59,kaist_dataset/Korean/Digital_Camera/outdoor2/2007-12-09-day-exterior-035.jpg,char_data/8/2007-12-09-day-exterior-035.jpg_0.jpg,1947,33,601,634,708,767,True,10
8,67,kaist_dataset/Korean/Digital_Camera/outdoor2/2007-12-09-day-exterior-009.jpg,char_data/8/2007-12-09-day-exterior-009.jpg_0.jpg,2747,41,699,740,684,751,True,10
8,38,kaist_dataset/Korean/Digital_Camera/outdoor2/DSC02327.JPG,char_data/8/DSC02327.JPG_0.jpg,1330,35,143,178,351,389,True,10
8,40,kaist_dataset/Korean/Digital_Camera/outdoor2/DSC02327.JPG,char_data/8/DSC02327.JPG_0.jpg,1040,26,452,478,360,400,True,10
8,53,kaist_dataset/Korean/Digital_Camera/outdoor2/DSC02515.JPG,char_data/8/DSC02515.JPG_0.jpg,2597,49,204,253,324,377,True,10
8,29,kaist_dataset/Korean/Digital_Camera/outdoor2/DSC02506.JPG,char_data/8/DSC02506.JPG_0.jpg,841,29,241,270,439,468,True,10
8,27,kaist_dataset/Korean/Digital_Camera/outdoor2/DSC02506.JPG,char_data/8/DSC02506.JPG_0.jpg,702,26,362,388,435,462,True,10
8,26,kaist_dataset/Korean/Digital_Camera/outdoor2/DSC02506.JPG,char_data/8/DSC02506.JPG_0.jpg,702,27,413,440,438,464,True,10
8,123,kaist_dataset/Korean/Digital_Camera/outdoor2/DSC02520.JPG,char_data/8/DSC02520.JPG_0.jpg,4182,34,459,493,296,419,True,10
8,30,kaist_dataset/Korean/Digital_Camera/outdoor2/DSC02304.JPG,char_data/8/DSC02304.JPG_0.jpg,810,27,225,252,261,291,True,10
8,28,kaist_dataset/Korean/Digital_Camera/outdoor2/DSC02470.JPG,char_data/8/DSC02470.JPG_0.jpg,700,25,172,197,184,212,True,10
8,60,kaist_dataset/Korean/Digital_Camera/outdoor2/DSC02470.JPG,char_data/8/DSC02470.JPG_0.jpg,2040,34,258,292,374,434,True,10
8,63,kaist_dataset/Korean/Digital_Camera/outdoor2/DSC02470.JPG,char_data/8/DSC02470.JPG_0.jpg,2457,39,417,456,371,434,True,10
8,77,kaist_dataset/Korean/Digital_Camera/outdoor2/2007-12-09-day-exterior-012.jpg,char_data/8/2007-12-09-day-exterior-012.jpg_0.jpg,4158,54,1009,1063,621,698,True,10
8,78,kaist_dataset/Korean/Digital_Camera/outdoor2/2007-12-09-day-exterior-012.jpg,char_data/8/2007-12-09-day-exterior-012.jpg_0.jpg,4134,53,1179,1232,620,698,True,10
8,79,kaist_dataset/Korean/Digital_Camera/outdoor2/2007-12-09-day-exterior-012.jpg,char_data/8/2007-12-09-day-exterior-012.jpg_0.jpg,3713,47,1234,1281,620,699,True,10
8,75,kaist_dataset/Korean/Digital_Camera/outdoor2/2007-12-09-day-exterior-012.jpg,char_data/8/2007-12-09-day-exterior-012.jpg_0.jpg,3900,52,1281,1333,621,696,True,10
8,32,kaist_dataset/Korean/Digital_Camera/outdoor2/DSC02310.JPG,char_data/8/DSC02310.JPG_0.jpg,1056,33,197,230,209,241,True,10
8,30,kaist_dataset/Korean/Digital_Camera/outdoor2/DSC02372.JPG,char_data/8/DSC02372.JPG_0.jpg,300,10,465,475,293,323,True,10
8,31,kaist_dataset/Korean/Digital_Camera/outdoor2/DSC02521.JPG,char_data/8/DSC02521.JPG_0.jpg,837,27,282,309,328,359,True,10
8,39,kaist_dataset/Korean/Digital_Camera/outdoor2/DSC02523.JPG,char_data/8/DSC02523.JPG_0.jpg,702,18,456,474,337,376,True,10
8,38,kaist_dataset/Korean/Digital_Camera/outdoor2/DSC02523.JPG,char_data/8/DSC02523.JPG_0.jpg,722,19,579,598,340,378,True,10
8,49,kaist_dataset/Korean/Digital_Camera/E-night/DSC02645.JPG,char_data/8/DSC02645.JPG_0.jpg,1568,32,295,327,333,382,True,10
8,25,kaist_dataset/Korean/Digital_Camera/E-night/P1010149.JPG,char_data/8/P1010149.JPG_0.jpg,275,11,549,560,242,267,True,10
8,29,kaist_dataset/Korean/Digital_Camera/E-night/P1010146.JPG,char_data/8/P1010146.JPG_0.jpg,435,15,289,304,250,279,True,10
8,41,kaist_dataset/Korean/Digital_Camera/E-night/DSC02649.JPG,char_data/8/DSC02649.JPG_0.jpg,1066,26,445,471,393,434,True,10
8,20,kaist_dataset/Korean/Digital_Camera/E-night/103.jpg,char_data/8/103.jpg_0.jpg,120,6,177,183,313,333,True,10
8,37,kaist_dataset/Korean/Digital_Camera/E-night/DSC02658.JPG,char_data/8/DSC02658.JPG_0.jpg,1036,28,213,241,356,393,True,10
8,59,kaist_dataset/Korean/Digital_Camera/E-night/DSC02594.JPG,char_data/8/DSC02594.JPG_0.jpg,2714,46,92,138,378,437,True,10
8,58,kaist_dataset/Korean/Digital_Camera/E-night/DSC02594.JPG,char_data/8/DSC02594.JPG_0.jpg,2088,36,334,370,371,429,True,10
8,57,kaist_dataset/Korean/Digital_Camera/E-night/DSC02594.JPG,char_data/8/DSC02594.JPG_0.jpg,2394,42,424,466,372,429,True,10
8,33,kaist_dataset/Korean/Digital_Camera/E-night/DSC02626.JPG,char_data/8/DSC02626.JPG_0.jpg,528,16,85,101,377,410,True,10
8,32,kaist_dataset/Korean/Digital_Camera/E-night/DSC02626.JPG,char_data/8/DSC02626.JPG_0.jpg,544,17,270,287,368,400,True,10
8,45,kaist_dataset/Korean/Digital_Camera/E-night/DSC02597.JPG,char_data/8/DSC02597.JPG_0.jpg,1530,34,374,408,290,335,True,10
8,55,kaist_dataset/Korean/Digital_Camera/E-night/DSC02597.JPG,char_data/8/DSC02597.JPG_0.jpg,1705,31,510,541,289,344,True,10
8,58,kaist_dataset/Korean/Digital_Camera/E-night/DSC02597.JPG,char_data/8/DSC02597.JPG_0.jpg,1798,31,573,604,285,343,True,10
8,48,kaist_dataset/Korean/Digital_Camera/E-night/DSC03515.JPG,char_data/8/DSC03515.JPG_0.jpg,864,18,562,580,270,318,True,10
8,63,kaist_dataset/Korean/Digital_Camera/indoor1/080119-0018.jpg,char_data/8/080119-0018.jpg_0.jpg,1953,31,854,885,439,502,True,10
8,41,kaist_dataset/Korean/Digital_Camera/outdoor7/P1010012.JPG,char_data/8/P1010012.JPG_0.jpg,1681,41,207,248,221,262,True,10
8,43,kaist_dataset/Korean/Digital_Camera/outdoor7/P1010082.JPG,char_data/8/P1010082.JPG_0.jpg,1290,30,155,185,47,90,True,10
8,40,kaist_dataset/Korean/Digital_Camera/outdoor7/P1010082.JPG,char_data/8/P1010082.JPG_0.jpg,1040,26,182,208,51,91,True,10
8,33,kaist_dataset/Korean/Digital_Camera/outdoor7/P1010054.JPG,char_data/8/P1010054.JPG_0.jpg,759,23,507,530,227,260,True,10
8,29,kaist_dataset/Korean/Digital_Camera/outdoor7/P1010107.JPG,char_data/8/P1010107.JPG_0.jpg,464,16,287,303,230,259,True,10
8,29,kaist_dataset/Korean/Digital_Camera/outdoor7/P1010107.JPG,char_data/8/P1010107.JPG_0.jpg,580,20,301,321,227,256,True,10
8,48,kaist_dataset/Korean/Digital_Camera/outdoor7/P1010069.JPG,char_data/8/P1010069.JPG_0.jpg,1248,26,338,364,309,357,True,10
8,51,kaist_dataset/Korean/Digital_Camera/outdoor7/P1010069.JPG,char_data/8/P1010069.JPG_0.jpg,1581,31,391,422,311,362,True,10
8,47,kaist_dataset/Korean/Digital_Camera/outdoor7/P1010069.JPG,char_data/8/P1010069.JPG_0.jpg,1410,30,422,452,312,359,True,10
8,36,kaist_dataset/Korean/Digital_Camera/outdoor7/P1010101.JPG,char_data/8/P1010101.JPG_0.jpg,684,19,349,368,232,268,True,10
8,33,kaist_dataset/Korean/Digital_Camera/outdoor7/P1010101.JPG,char_data/8/P1010101.JPG_0.jpg,858,26,465,491,232,265,True,10
8,35,kaist_dataset/Korean/Digital_Camera/outdoor7/P1010003.JPG,char_data/8/P1010003.JPG_0.jpg,980,28,279,307,278,313,True,10
8,33,kaist_dataset/Korean/Digital_Camera/outdoor7/P1010003.JPG,char_data/8/P1010003.JPG_0.jpg,792,24,309,333,279,312,True,10
8,35,kaist_dataset/Korean/Digital_Camera/outdoor7/P1010136.JPG,char_data/8/P1010136.JPG_0.jpg,630,18,322,340,264,299,True,10
8,48,kaist_dataset/Korean/Digital_Camera/outdoor7/P1010111.JPG,char_data/8/P1010111.JPG_0.jpg,1680,35,381,416,220,268,True,10
8,51,kaist_dataset/Korean/Digital_Camera/outdoor7/P1010111.JPG,char_data/8/P1010111.JPG_0.jpg,1683,33,418,451,218,269,True,10
8,43,kaist_dataset/Korean/Digital_Camera/outdoor7/P1010111.JPG,char_data/8/P1010111.JPG_0.jpg,1720,40,488,528,221,264,True,10
8,27,kaist_dataset/Korean/Digital_Camera/outdoor7/P1010005.JPG,char_data/8/P1010005.JPG_0.jpg,783,29,418,447,191,218,True,10
8,31,kaist_dataset/Korean/Digital_Camera/outdoor7/P1010005.JPG,char_data/8/P1010005.JPG_0.jpg,868,28,516,544,189,220,True,10
8,41,kaist_dataset/Korean/Digital_Camera/outdoor7/P1010138.JPG,char_data/8/P1010138.JPG_0.jpg,738,18,274,292,282,323,True,10
8,34,kaist_dataset/Korean/Digital_Camera/outdoor7/P1010138.JPG,char_data/8/P1010138.JPG_0.jpg,612,18,327,345,285,319,True,10
8,41,kaist_dataset/Korean/Digital_Camera/outdoor7/P1010138.JPG,char_data/8/P1010138.JPG_0.jpg,738,18,363,381,279,320,True,10
8,42,kaist_dataset/Korean/Digital_Camera/outdoor7/P1010138.JPG,char_data/8/P1010138.JPG_0.jpg,882,21,381,402,280,322,True,10
8,49,kaist_dataset/Korean/Digital_Camera/outdoor7/P1010085.JPG,char_data/8/P1010085.JPG_0.jpg,1470,30,353,383,268,317,True,10
8,52,kaist_dataset/Korean/Digital_Camera/outdoor7/P1010077.JPG,char_data/8/P1010077.JPG_0.jpg,1404,27,383,410,244,296,True,10
8,59,kaist_dataset/Korean/Digital_Camera/outdoor7/P1010077.JPG,char_data/8/P1010077.JPG_0.jpg,2065,35,407,442,242,301,True,10
8,36,kaist_dataset/Korean/Digital_Camera/outdoor7/P1010121.JPG,char_data/8/P1010121.JPG_0.jpg,792,22,467,489,204,240,True,10
8,30,kaist_dataset/Korean/Digital_Camera/outdoor7/P1010078.JPG,char_data/8/P1010078.JPG_0.jpg,690,23,191,214,252,282,True,10
8,52,kaist_dataset/Korean/Digital_Camera/outdoor7/P1010011.JPG,char_data/8/P1010011.JPG_0.jpg,2132,41,267,308,227,279,True,10
8,74,kaist_dataset/Korean/Digital_Camera/outdoor7/P1010086.JPG,char_data/8/P1010086.JPG_0.jpg,4588,62,292,354,257,331,True,10
8,25,kaist_dataset/Korean/Digital_Camera/outdoor7/P1010112.JPG,char_data/8/P1010112.JPG_0.jpg,500,20,480,500,361,386,True,10
8,29,kaist_dataset/Korean/Digital_Camera/outdoor7/P1010112.JPG,char_data/8/P1010112.JPG_0.jpg,493,17,520,537,357,386,True,10
8,30,kaist_dataset/Korean/Digital_Camera/outdoor7/P1010112.JPG,char_data/8/P1010112.JPG_0.jpg,330,11,538,549,356,386,True,10
8,24,kaist_dataset/Korean/Digital_Camera/outdoor7/P1010100.JPG,char_data/8/P1010100.JPG_0.jpg,336,14,233,247,224,248,True,10
8,24,kaist_dataset/Korean/Digital_Camera/outdoor7/P1010100.JPG,char_data/8/P1010100.JPG_0.jpg,432,18,313,331,222,246,True,10
8,24,kaist_dataset/Korean/Digital_Camera/outdoor7/P1010100.JPG,char_data/8/P1010100.JPG_0.jpg,456,19,333,352,222,246,True,10
8,30,kaist_dataset/Korean/Digital_Camera/outdoor7/P1010100.JPG,char_data/8/P1010100.JPG_0.jpg,510,17,393,410,217,247,True,10
8,44,kaist_dataset/Korean/Digital_Camera/outdoor7/P1010100.JPG,char_data/8/P1010100.JPG_0.jpg,1364,31,196,227,349,393,True,10
8,43,kaist_dataset/Korean/Digital_Camera/outdoor7/P1010100.JPG,char_data/8/P1010100.JPG_0.jpg,1376,32,355,387,347,390,True,10
8,45,kaist_dataset/Korean/Digital_Camera/outdoor7/P1010100.JPG,char_data/8/P1010100.JPG_0.jpg,1665,37,387,424,347,392,True,10
8,19,kaist_dataset/Korean/Digital_Camera/outdoor7/P1010124.JPG,char_data/8/P1010124.JPG_0.jpg,247,13,304,317,153,172,True,10
8,21,kaist_dataset/Korean/Digital_Camera/outdoor7/P1010124.JPG,char_data/8/P1010124.JPG_0.jpg,273,13,366,379,152,173,True,10
8,34,kaist_dataset/Korean/Digital_Camera/outdoor7/P1010009.JPG,char_data/8/P1010009.JPG_0.jpg,1156,34,377,411,269,303,True,10
8,54,kaist_dataset/Korean/Digital_Camera/outdoor7/P1010023.JPG,char_data/8/P1010023.JPG_0.jpg,1674,31,514,545,284,338,True,10
8,71,kaist_dataset/Korean/Digital_Camera/outdoor7/DSC04483.JPG,char_data/8/DSC04483.JPG_0.jpg,2769,39,168,207,365,436,True,10
8,57,kaist_dataset/Korean/Digital_Camera/outdoor7/P1010081.JPG,char_data/8/P1010081.JPG_0.jpg,3135,55,155,210,219,276,True,10
8,34,kaist_dataset/Korean/Digital_Camera/outdoor7/P1010056.JPG,char_data/8/P1010056.JPG_0.jpg,680,20,414,434,265,299,True,10
8,40,kaist_dataset/Korean/Digital_Camera/outdoor7/P1010067.JPG,char_data/8/P1010067.JPG_0.jpg,1280,32,337,369,312,352,True,10
8,42,kaist_dataset/Korean/Digital_Camera/outdoor7/P1010067.JPG,char_data/8/P1010067.JPG_0.jpg,1554,37,370,407,310,352,True,10
8,38,kaist_dataset/Korean/Digital_Camera/outdoor7/P1010061.JPG,char_data/8/P1010061.JPG_0.jpg,1026,27,370,397,318,356,True,10
8,29,kaist_dataset/Korean/Digital_Camera/outdoor7/P1010035.JPG,char_data/8/P1010035.JPG_0.jpg,464,16,57,73,208,237,True,10
8,33,kaist_dataset/Korean/Digital_Camera/outdoor7/P1010057.JPG,char_data/8/P1010057.JPG_0.jpg,627,19,526,545,228,261,True,10
8,104,kaist_dataset/Korean/Digital_Camera/outdoor7/P1010079.JPG,char_data/8/P1010079.JPG_0.jpg,7176,69,453,522,340,444,True,10
8,36,kaist_dataset/Korean/Digital_Camera/outdoor8/P1010143.JPG,char_data/8/P1010143.JPG_0.jpg,828,23,334,357,266,302,True,10
8,38,kaist_dataset/Korean/Digital_Camera/outdoor8/P1010189.JPG,char_data/8/P1010189.JPG_0.jpg,1026,27,342,369,230,268,True,10
8,36,kaist_dataset/Korean/Digital_Camera/outdoor8/P1010189.JPG,char_data/8/P1010189.JPG_0.jpg,1080,30,432,462,232,268,True,10
8,37,kaist_dataset/Korean/Digital_Camera/outdoor8/P1010142.JPG,char_data/8/P1010142.JPG_0.jpg,814,22,285,307,281,318,True,10
8,37,kaist_dataset/Korean/Digital_Camera/outdoor8/P1010142.JPG,char_data/8/P1010142.JPG_0.jpg,814,22,355,377,280,317,True,10
8,39,kaist_dataset/Korean/Digital_Camera/outdoor8/P1010142.JPG,char_data/8/P1010142.JPG_0.jpg,936,24,426,450,279,318,True,10
8,38,kaist_dataset/Korean/Digital_Camera/outdoor8/P1010142.JPG,char_data/8/P1010142.JPG_0.jpg,798,21,404,425,278,316,True,10
8,39,kaist_dataset/Korean/Digital_Camera/outdoor8/P1010170.JPG,char_data/8/P1010170.JPG_0.jpg,858,22,355,377,274,313,True,10
8,57,kaist_dataset/Korean/Digital_Camera/outdoor8/DSC02950.JPG,char_data/8/DSC02950.JPG_0.jpg,2736,48,194,242,281,338,True,10
8,26,kaist_dataset/Korean/Digital_Camera/outdoor8/P090912069.jpg,char_data/8/P090912069.jpg_0.jpg,676,26,273,299,259,285,True,10
8,28,kaist_dataset/Korean/Digital_Camera/outdoor8/P090912069.jpg,char_data/8/P090912069.jpg_0.jpg,952,34,387,421,232,260,True,10
8,67,kaist_dataset/Korean/Digital_Camera/outdoor8/P1010160.JPG,char_data/8/P1010160.JPG_0.jpg,3618,54,191,245,228,295,True,10
8,30,kaist_dataset/Korean/Digital_Camera/outdoor8/P1010178.JPG,char_data/8/P1010178.JPG_0.jpg,570,19,295,314,392,422,True,10
8,44,kaist_dataset/Korean/Digital_Camera/outdoor8/P1010147.JPG,char_data/8/P1010147.JPG_0.jpg,1320,30,384,414,315,359,True,10
8,41,kaist_dataset/Korean/Digital_Camera/outdoor8/P1010147.JPG,char_data/8/P1010147.JPG_0.jpg,1107,27,414,441,317,358,True,10
8,51,kaist_dataset/Korean/Digital_Camera/outdoor8/P1010147.JPG,char_data/8/P1010147.JPG_0.jpg,1632,32,489,521,314,365,True,10
8,36,kaist_dataset/Korean/Digital_Camera/outdoor8/P1011112.JPG,char_data/8/P1011112.JPG_0.jpg,828,23,298,321,208,244,True,10
8,75,kaist_dataset/Korean/Digital_Camera/indoor2/DSC04006.JPG,char_data/8/DSC04006.JPG_0.jpg,2400,32,275,307,149,224,True,10
8,56,kaist_dataset/Korean/Digital_Camera/indoor2/DSC03474.JPG,char_data/8/DSC03474.JPG_0.jpg,2016,36,271,307,151,207,True,10
8,56,kaist_dataset/Korean/Digital_Camera/indoor2/DSC03474.JPG,char_data/8/DSC03474.JPG_0.jpg,1512,27,410,437,150,206,True,10
8,36,kaist_dataset/Korean/Digital_Camera/indoor2/DSC03983.JPG,char_data/8/DSC03983.JPG_0.jpg,864,24,279,303,325,361,True,10
8,57,kaist_dataset/Korean/Digital_Camera/indoor2/DSC03475.JPG,char_data/8/DSC03475.JPG_0.jpg,2166,38,494,532,89,146,True,10
8,64,kaist_dataset/Korean/Digital_Camera/indoor2/P071209063.jpg,char_data/8/P071209063.jpg_0.jpg,4096,64,958,1022,1074,1138,True,10
8,55,kaist_dataset/Korean/Digital_Camera/indoor2/DSC04204.JPG,char_data/8/DSC04204.JPG_0.jpg,1870,34,283,317,202,257,True,10
8,53,kaist_dataset/Korean/Digital_Camera/indoor2/DSC04204.JPG,char_data/8/DSC04204.JPG_0.jpg,1696,32,318,350,202,255,True,10
8,40,kaist_dataset/Korean/Digital_Camera/indoor2/DSC04204.JPG,char_data/8/DSC04204.JPG_0.jpg,880,22,326,348,280,320,True,10
8,46,kaist_dataset/Korean/Digital_Camera/indoor2/DSC04204.JPG,char_data/8/DSC04204.JPG_0.jpg,1058,23,453,476,277,323,True,10
8,30,kaist_dataset/Korean/Digital_Camera/indoor2/DSC03975.JPG,char_data/8/DSC03975.JPG_0.jpg,450,15,151,166,294,324,True,10
8,88,kaist_dataset/Korean/Digital_Camera/indoor2/DSC03565.JPG,char_data/8/DSC03565.JPG_0.jpg,5544,63,228,291,274,362,True,10
8,39,kaist_dataset/Korean/Digital_Camera/G-others/2007-12-09-day-exterior-083.jpg,char_data/8/2007-12-09-day-exterior-083.jpg_0.jpg,1326,34,511,545,969,1008,True,10
8,53,kaist_dataset/Korean/Digital_Camera/G-others/2007-12-09-day-exterior-083.jpg,char_data/8/2007-12-09-day-exterior-083.jpg_0.jpg,2650,50,278,328,127,180,True,10
8,28,kaist_dataset/Korean/Digital_Camera/G-others/DSC03863.JPG,char_data/8/DSC03863.JPG_0.jpg,308,11,180,191,407,435,True,10
8,56,kaist_dataset/Korean/Digital_Camera/G-others/DSC03434.JPG,char_data/8/DSC03434.JPG_0.jpg,1624,29,265,294,24,80,True,10
8,50,kaist_dataset/Korean/Digital_Camera/G-others/DSC03434.JPG,char_data/8/DSC03434.JPG_0.jpg,1550,31,344,375,29,79,True,10
8,55,kaist_dataset/Korean/Digital_Camera/G-others/DSC03434.JPG,char_data/8/DSC03434.JPG_0.jpg,1760,32,397,429,29,84,True,10
8,109,kaist_dataset/Korean/Digital_Camera/G-others/2007-12-09-day-exterior-062.jpg,char_data/8/2007-12-09-day-exterior-062.jpg_0.jpg,4142,38,466,504,1395,1504,True,10
8,50,kaist_dataset/Korean/Digital_Camera/G-others/2007-12-08-day-045.jpg,char_data/8/2007-12-08-day-045.jpg_0.jpg,950,19,102,121,795,845,True,10
8,48,kaist_dataset/Korean/Digital_Camera/G-others/2007-12-08-day-045.jpg,char_data/8/2007-12-08-day-045.jpg_0.jpg,912,19,157,176,791,839,True,10
8,44,kaist_dataset/Korean/Digital_Camera/G-others/2007-12-08-day-045.jpg,char_data/8/2007-12-08-day-045.jpg_0.jpg,660,15,193,208,790,834,True,10
8,82,kaist_dataset/Korean/Digital_Camera/G-others/2007-12-08-day-108.jpg,char_data/8/2007-12-08-day-108.jpg_0.jpg,3608,44,728,772,632,714,True,10
8,79,kaist_dataset/Korean/Digital_Camera/G-others/2007-12-08-day-108.jpg,char_data/8/2007-12-08-day-108.jpg_0.jpg,3081,39,919,958,697,776,True,10
8,80,kaist_dataset/Korean/Digital_Camera/G-others/2007-12-08-day-108.jpg,char_data/8/2007-12-08-day-108.jpg_0.jpg,3120,39,808,847,745,825,True,10
8,75,kaist_dataset/Korean/Digital_Camera/G-others/2007-12-08-day-108.jpg,char_data/8/2007-12-08-day-108.jpg_0.jpg,3075,41,938,979,783,858,True,10
8,29,kaist_dataset/Korean/Digital_Camera/B-light/DSC02987.JPG,char_data/8/DSC02987.JPG_0.jpg,377,13,405,418,277,306,True,10
8,28,kaist_dataset/Korean/Digital_Camera/B-light/DSC02987.JPG,char_data/8/DSC02987.JPG_0.jpg,336,12,511,523,280,308,True,10
8,28,kaist_dataset/Korean/Digital_Camera/B-light/DSC02987.JPG,char_data/8/DSC02987.JPG_0.jpg,392,14,523,537,278,306,True,10
8,31,kaist_dataset/Korean/Digital_Camera/B-light/DSC02987.JPG,char_data/8/DSC02987.JPG_0.jpg,403,13,557,570,279,310,True,10
8,34,kaist_dataset/Korean/Digital_Camera/B-light/DSC02987.JPG,char_data/8/DSC02987.JPG_0.jpg,476,14,570,584,277,311,True,10
8,44,kaist_dataset/Korean/Digital_Camera/outdoor6/DSC04081.JPG,char_data/8/DSC04081.JPG_0.jpg,1892,43,252,295,318,362,True,10
8,44,kaist_dataset/Korean/Digital_Camera/outdoor6/DSC04081.JPG,char_data/8/DSC04081.JPG_0.jpg,1980,45,297,342,320,364,True,10
8,43,kaist_dataset/Korean/Digital_Camera/outdoor6/DSC04081.JPG,char_data/8/DSC04081.JPG_0.jpg,1892,44,383,427,317,360,True,10
8,96,kaist_dataset/Korean/Digital_Camera/outdoor6/DSC04090.JPG,char_data/8/DSC04090.JPG_0.jpg,4608,48,205,253,190,286,True,10
8,57,kaist_dataset/Korean/Digital_Camera/outdoor6/DSC04143.JPG,char_data/8/DSC04143.JPG_0.jpg,1824,32,225,257,353,410,True,10
8,51,kaist_dataset/Korean/Digital_Camera/outdoor6/DSC04143.JPG,char_data/8/DSC04143.JPG_0.jpg,1734,34,318,352,362,413,True,10
8,51,kaist_dataset/Korean/Digital_Camera/outdoor6/DSC04143.JPG,char_data/8/DSC04143.JPG_0.jpg,1734,34,382,416,357,408,True,10
8,69,kaist_dataset/Korean/Digital_Camera/outdoor6/DSC04359.JPG,char_data/8/DSC04359.JPG_0.jpg,3243,47,101,148,119,188,True,10
8,75,kaist_dataset/Korean/Digital_Camera/outdoor6/DSC04359.JPG,char_data/8/DSC04359.JPG_0.jpg,3450,46,253,299,113,188,True,10
8,79,kaist_dataset/Korean/Digital_Camera/outdoor6/DSC04359.JPG,char_data/8/DSC04359.JPG_0.jpg,3397,43,297,340,109,188,True,10
8,77,kaist_dataset/Korean/Digital_Camera/outdoor6/DSC04359.JPG,char_data/8/DSC04359.JPG_0.jpg,3080,40,338,378,108,185,True,10
8,53,kaist_dataset/Korean/Digital_Camera/outdoor6/DSC04308.JPG,char_data/8/DSC04308.JPG_0.jpg,1272,24,273,297,384,437,True,10
8,54,kaist_dataset/Korean/Digital_Camera/outdoor6/DSC04136.JPG,char_data/8/DSC04136.JPG_0.jpg,2052,38,375,413,328,382,True,10
8,27,kaist_dataset/Korean/Digital_Camera/outdoor6/DSC04132.JPG,char_data/8/DSC04132.JPG_0.jpg,432,16,263,279,158,185,True,10
8,44,kaist_dataset/Korean/Digital_Camera/outdoor6/DSC04400.JPG,char_data/8/DSC04400.JPG_0.jpg,1100,25,256,281,222,266,True,10
8,38,kaist_dataset/Korean/Digital_Camera/outdoor6/DSC04400.JPG,char_data/8/DSC04400.JPG_0.jpg,912,24,352,376,226,264,True,10
8,37,kaist_dataset/Korean/Digital_Camera/outdoor6/DSC04400.JPG,char_data/8/DSC04400.JPG_0.jpg,1036,28,248,276,399,436,True,10
8,25,kaist_dataset/Korean/Digital_Camera/outdoor6/DSC04041.JPG,char_data/8/DSC04041.JPG_0.jpg,450,18,428,446,142,167,True,10
8,21,kaist_dataset/Korean/Digital_Camera/outdoor6/DSC04343.JPG,char_data/8/DSC04343.JPG_0.jpg,525,25,277,302,210,231,True,10
8,41,kaist_dataset/Korean/Digital_Camera/outdoor6/DSC04339.JPG,char_data/8/DSC04339.JPG_0.jpg,1107,27,271,298,208,249,True,10
8,43,kaist_dataset/Korean/Digital_Camera/outdoor6/DSC04339.JPG,char_data/8/DSC04339.JPG_0.jpg,688,16,399,415,205,248,True,10
8,49,kaist_dataset/Korean/Digital_Camera/outdoor6/DSC04352.JPG,char_data/8/DSC04352.JPG_0.jpg,1274,26,483,509,280,329,True,10
8,38,kaist_dataset/Korean/Digital_Camera/outdoor6/DSC04099.JPG,char_data/8/DSC04099.JPG_0.jpg,988,26,412,438,412,450,True,10
8,25,kaist_dataset/Korean/Digital_Camera/outdoor6/DSC04341.JPG,char_data/8/DSC04341.JPG_0.jpg,450,18,483,501,223,248,True,10
8,29,kaist_dataset/Korean/Digital_Camera/outdoor6/DSC04341.JPG,char_data/8/DSC04341.JPG_0.jpg,406,14,584,598,222,251,True,10
8,49,kaist_dataset/Korean/Digital_Camera/outdoor6/DSC04089.JPG,char_data/8/DSC04089.JPG_0.jpg,1078,22,328,350,274,323,True,10
8,41,kaist_dataset/Korean/Digital_Camera/outdoor6/DSC04121.JPG,char_data/8/DSC04121.JPG_0.jpg,1230,30,213,243,179,220,True,10
8,35,kaist_dataset/Korean/Digital_Camera/outdoor6/DSC04121.JPG,char_data/8/DSC04121.JPG_0.jpg,1085,31,308,339,181,216,True,10
8,71,kaist_dataset/Korean/Digital_Camera/outdoor6/DSC04301.JPG,char_data/8/DSC04301.JPG_0.jpg,4828,68,58,126,361,432,True,10
8,69,kaist_dataset/Korean/Digital_Camera/outdoor6/DSC04301.JPG,char_data/8/DSC04301.JPG_0.jpg,4623,67,445,512,364,433,True,10
8,27,kaist_dataset/Korean/Digital_Camera/outdoor6/DSC04042.JPG,char_data/8/DSC04042.JPG_0.jpg,432,16,69,85,330,357,True,10
8,40,kaist_dataset/Korean/Digital_Camera/outdoor6/DSC04116.JPG,char_data/8/DSC04116.JPG_0.jpg,560,14,190,204,318,358,True,10
8,38,kaist_dataset/Korean/Digital_Camera/outdoor6/DSC04116.JPG,char_data/8/DSC04116.JPG_0.jpg,646,17,342,359,318,356,True,10
8,92,kaist_dataset/Korean/Digital_Camera/outdoor6/DSC04096.JPG,char_data/8/DSC04096.JPG_0.jpg,3312,36,177,213,219,311,True,10
8,36,kaist_dataset/Korean/Digital_Camera/outdoor6/DSC04112.JPG,char_data/8/DSC04112.JPG_0.jpg,504,14,428,442,273,309,True,10
8,57,kaist_dataset/Korean/Digital_Camera/outdoor6/DSC04296.JPG,char_data/8/DSC04296.JPG_0.jpg,1311,23,360,383,305,362,True,10
8,57,kaist_dataset/Korean/Digital_Camera/outdoor6/DSC04296.JPG,char_data/8/DSC04296.JPG_0.jpg,1425,25,379,404,303,360,True,10
8,54,kaist_dataset/Korean/Digital_Camera/outdoor6/DSC04100.JPG,char_data/8/DSC04100.JPG_0.jpg,1620,30,521,551,54,108,True,10
8,64,kaist_dataset/Korean/Digital_Camera/outdoor6/DSC04073.JPG,char_data/8/DSC04073.JPG_0.jpg,1920,30,424,454,30,94,True,10
8,70,kaist_dataset/Korean/Digital_Camera/outdoor6/DSC04147.JPG,char_data/8/DSC04147.JPG_0.jpg,2520,36,195,231,178,248,True,10
8,81,kaist_dataset/Korean/Digital_Camera/outdoor6/DSC04083.JPG,char_data/8/DSC04083.JPG_0.jpg,3159,39,399,438,160,241,True,10
8,28,kaist_dataset/Korean/Digital_Camera/outdoor6/DSC04046.JPG,char_data/8/DSC04046.JPG_0.jpg,392,14,425,439,262,290,True,10
8,26,kaist_dataset/Korean/Digital_Camera/outdoor6/DSC04046.JPG,char_data/8/DSC04046.JPG_0.jpg,338,13,470,483,261,287,True,10
8,51,kaist_dataset/Korean/Digital_Camera/outdoor6/DSC04370.JPG,char_data/8/DSC04370.JPG_0.jpg,2448,48,123,171,320,371,True,10
8,62,kaist_dataset/Korean/Digital_Camera/outdoor6/DSC04370.JPG,char_data/8/DSC04370.JPG_0.jpg,3410,55,436,491,322,384,True,10
8,53,kaist_dataset/Korean/Digital_Camera/outdoor6/DSC04332.JPG,char_data/8/DSC04332.JPG_0.jpg,2862,54,83,137,350,403,True,10
8,61,kaist_dataset/Korean/Digital_Camera/outdoor6/DSC04118.JPG,char_data/8/DSC04118.JPG_0.jpg,1830,30,312,342,250,311,True,10
8,54,kaist_dataset/Korean/Digital_Camera/outdoor6/DSC04118.JPG,char_data/8/DSC04118.JPG_0.jpg,1782,33,341,374,252,306,True,10
8,31,kaist_dataset/Korean/Digital_Camera/outdoor6/DSC04138.JPG,char_data/8/DSC04138.JPG_0.jpg,868,28,274,302,152,183,True,10
8,29,kaist_dataset/Korean/Digital_Camera/outdoor6/DSC04138.JPG,char_data/8/DSC04138.JPG_0.jpg,870,30,436,466,155,184,True,10
8,33,kaist_dataset/Korean/Digital_Camera/A-shadow/2007-12-09-day-exterior-040.jpg,char_data/8/2007-12-09-day-exterior-040.jpg_0.jpg,726,22,958,980,815,848,True,10
8,33,kaist_dataset/Korean/Digital_Camera/A-shadow/2007-12-09-day-exterior-040.jpg,char_data/8/2007-12-09-day-exterior-040.jpg_0.jpg,693,21,1076,1097,815,848,True,10
8,54,kaist_dataset/Korean/Digital_Camera/A-shadow/DSC04315.JPG,char_data/8/DSC04315.JPG_0.jpg,1944,36,104,140,410,464,True,10
8,73,kaist_dataset/Korean/Digital_Camera/A-shadow/2007-12-09-day-exterior-026.jpg,char_data/8/2007-12-09-day-exterior-026.jpg_0.jpg,3212,44,875,919,754,827,True,10
8,48,kaist_dataset/Korean/Digital_Camera/A-shadow/2007-12-09-day-exterior-025.jpg,char_data/8/2007-12-09-day-exterior-025.jpg_0.jpg,1776,37,918,955,735,783,True,10
8,54,kaist_dataset/Korean/Digital_Camera/A-shadow/2007-12-09-day-exterior-025.jpg,char_data/8/2007-12-09-day-exterior-025.jpg_0.jpg,1728,32,1060,1092,735,789,True,10
8,51,kaist_dataset/Korean/Digital_Camera/A-shadow/DSC03536.JPG,char_data/8/DSC03536.JPG_0.jpg,1530,30,94,124,271,322,True,10
8,75,kaist_dataset/Korean/Digital_Camera/A-shadow/DSC03536.JPG,char_data/8/DSC03536.JPG_0.jpg,3150,42,226,268,244,319,True,10
8,168,kaist_dataset/Korean/Digital_Camera/A-shadow/DSC02670.JPG,char_data/8/DSC02670.JPG_0.jpg,14112,84,6,90,24,192,True,10
8,36,kaist_dataset/Korean/Digital_Camera/A-shadow/DSC02598.JPG,char_data/8/DSC02598.JPG_0.jpg,792,22,501,523,415,451,True,10
8,132,kaist_dataset/Korean/Digital_Camera/A-shadow/DSC04300.JPG,char_data/8/DSC04300.JPG_0.jpg,8580,65,97,162,222,354,True,10
8,93,kaist_dataset/Korean/Digital_Camera/A-shadow/2007-12-09-day-exterior-031.jpg,char_data/8/2007-12-09-day-exterior-031.jpg_0.jpg,5580,60,543,603,658,751,True,10
8,78,kaist_dataset/Korean/Digital_Camera/A-shadow/2007-12-09-day-exterior-031.jpg,char_data/8/2007-12-09-day-exterior-031.jpg_0.jpg,3744,48,841,889,667,745,True,10
8,34,kaist_dataset/Korean/Digital_Camera/outdoor3/DSC02999.JPG,char_data/8/DSC02999.JPG_0.jpg,680,20,278,298,432,466,True,10
8,35,kaist_dataset/Korean/Digital_Camera/outdoor3/DSC02971.JPG,char_data/8/DSC02971.JPG_0.jpg,770,22,276,298,293,328,True,10
8,48,kaist_dataset/Korean/Digital_Camera/outdoor3/DSC02546.JPG,char_data/8/DSC02546.JPG_0.jpg,1440,30,219,249,121,169,True,10
8,48,kaist_dataset/Korean/Digital_Camera/outdoor3/DSC02546.JPG,char_data/8/DSC02546.JPG_0.jpg,1488,31,209,240,235,283,True,10
8,57,kaist_dataset/Korean/Digital_Camera/outdoor3/DSC02546.JPG,char_data/8/DSC02546.JPG_0.jpg,1653,29,209,238,357,414,True,10
8,30,kaist_dataset/Korean/Digital_Camera/outdoor3/DSC02531.JPG,char_data/8/DSC02531.JPG_0.jpg,690,23,201,224,352,382,True,10
8,33,kaist_dataset/Korean/Digital_Camera/outdoor3/DSC02943.JPG,char_data/8/DSC02943.JPG_0.jpg,759,23,323,346,430,463,True,10
8,36,kaist_dataset/Korean/Digital_Camera/outdoor3/DSC02943.JPG,char_data/8/DSC02943.JPG_0.jpg,864,24,347,371,431,467,True,10
8,64,kaist_dataset/Korean/Digital_Camera/outdoor3/DSC03198.JPG,char_data/8/DSC03198.JPG_0.jpg,2880,45,75,120,198,262,True,10
8,35,kaist_dataset/Korean/Digital_Camera/outdoor3/DSC02944.JPG,char_data/8/DSC02944.JPG_0.jpg,840,24,239,263,235,270,True,10
8,36,kaist_dataset/Korean/Digital_Camera/outdoor3/DSC02944.JPG,char_data/8/DSC02944.JPG_0.jpg,684,19,263,282,233,269,True,10
8,41,kaist_dataset/Korean/Digital_Camera/outdoor3/DSC02686.JPG,char_data/8/DSC02686.JPG_0.jpg,1230,30,413,443,225,266,True,10
8,45,kaist_dataset/Korean/Digital_Camera/outdoor3/DSC02899.JPG,char_data/8/DSC02899.JPG_0.jpg,1485,33,380,413,231,276,True,10
8,71,kaist_dataset/Korean/Digital_Camera/outdoor3/DSC02900.JPG,char_data/8/DSC02900.JPG_0.jpg,2698,38,294,332,256,327,True,10
8,74,kaist_dataset/Korean/Digital_Camera/outdoor3/DSC02900.JPG,char_data/8/DSC02900.JPG_0.jpg,2886,39,334,373,254,328,True,10
8,45,kaist_dataset/Korean/Digital_Camera/outdoor3/DSC02528.JPG,char_data/8/DSC02528.JPG_0.jpg,1755,39,166,205,412,457,True,10
8,47,kaist_dataset/Korean/Digital_Camera/outdoor3/DSC02528.JPG,char_data/8/DSC02528.JPG_0.jpg,1504,32,332,364,409,456,True,10
8,52,kaist_dataset/Korean/Digital_Camera/outdoor3/DSC02528.JPG,char_data/8/DSC02528.JPG_0.jpg,1560,30,405,435,410,462,True,10
8,62,kaist_dataset/Korean/Digital_Camera/outdoor3/DSC02562.JPG,char_data/8/DSC02562.JPG_0.jpg,2108,34,196,230,362,424,True,10
8,55,kaist_dataset/Korean/Digital_Camera/outdoor3/DSC02953.JPG,char_data/8/DSC02953.JPG_0.jpg,1870,34,355,389,385,440,True,10
8,57,kaist_dataset/Korean/Digital_Camera/outdoor3/DSC02953.JPG,char_data/8/DSC02953.JPG_0.jpg,1653,29,389,418,382,439,True,10
8,64,kaist_dataset/Korean/Digital_Camera/outdoor3/DSC02953.JPG,char_data/8/DSC02953.JPG_0.jpg,1536,24,442,466,384,448,True,10
8,24,kaist_dataset/Korean/Digital_Camera/outdoor3/DSC02891.JPG,char_data/8/DSC02891.JPG_0.jpg,264,11,521,532,306,330,True,10
8,22,kaist_dataset/Korean/Digital_Camera/outdoor3/DSC02891.JPG,char_data/8/DSC02891.JPG_0.jpg,286,13,532,545,304,326,True,10
8,42,kaist_dataset/Korean/Digital_Camera/outdoor3/DSC02975.JPG,char_data/8/DSC02975.JPG_0.jpg,1134,27,323,350,236,278,True,10
8,42,kaist_dataset/Korean/Digital_Camera/outdoor3/DSC02975.JPG,char_data/8/DSC02975.JPG_0.jpg,1134,27,350,377,238,280,True,10
8,47,kaist_dataset/Korean/Digital_Camera/outdoor3/DSC03237.JPG,char_data/8/DSC03237.JPG_0.jpg,1316,28,229,257,400,447,True,10
8,36,kaist_dataset/Korean/Digital_Camera/outdoor3/DSC02598.JPG,char_data/8/DSC02598.JPG_0.jpg,792,22,501,523,415,451,True,10
8,46,kaist_dataset/Korean/Digital_Camera/outdoor3/DSC03064.JPG,char_data/8/DSC03064.JPG_0.jpg,1150,25,321,346,345,391,True,10
8,40,kaist_dataset/Korean/Digital_Camera/outdoor3/DSC02941.JPG,char_data/8/DSC02941.JPG_0.jpg,880,22,355,377,251,291,True,10
8,51,kaist_dataset/Korean/Digital_Camera/outdoor3/DSC02972.JPG,char_data/8/DSC02972.JPG_0.jpg,2142,42,350,392,41,92,True,10
8,46,kaist_dataset/Korean/Digital_Camera/outdoor3/DSC02994.JPG,char_data/8/DSC02994.JPG_0.jpg,1380,30,224,254,285,331,True,10
8,58,kaist_dataset/Korean/Digital_Camera/outdoor3/DSC02697.JPG,char_data/8/DSC02697.JPG_0.jpg,1624,28,215,243,373,431,True,10
8,52,kaist_dataset/Korean/Digital_Camera/outdoor3/DSC02697.JPG,char_data/8/DSC02697.JPG_0.jpg,1664,32,244,276,373,425,True,10
8,30,kaist_dataset/Korean/Digital_Camera/outdoor3/DSC02558.JPG,char_data/8/DSC02558.JPG_0.jpg,540,18,482,500,220,250,True,10
8,31,kaist_dataset/Korean/Digital_Camera/outdoor3/DSC02558.JPG,char_data/8/DSC02558.JPG_0.jpg,620,20,537,557,221,252,True,10
8,34,kaist_dataset/Korean/Digital_Camera/outdoor3/DSC02558.JPG,char_data/8/DSC02558.JPG_0.jpg,442,13,558,571,219,253,True,10
8,31,kaist_dataset/Korean/Digital_Camera/outdoor3/DSC02558.JPG,char_data/8/DSC02558.JPG_0.jpg,434,14,572,586,218,249,True,10
8,29,kaist_dataset/Korean/Digital_Camera/outdoor3/DSC03219.JPG,char_data/8/DSC03219.JPG_0.jpg,493,17,352,369,415,444,True,10
8,46,kaist_dataset/Korean/Digital_Camera/outdoor3/DSC02957.JPG,char_data/8/DSC02957.JPG_0.jpg,1472,32,253,285,401,447,True,10
8,50,kaist_dataset/Korean/Digital_Camera/outdoor3/DSC02957.JPG,char_data/8/DSC02957.JPG_0.jpg,1550,31,285,316,400,450,True,10
8,61,kaist_dataset/Korean/Digital_Camera/outdoor3/DSC03195.JPG,char_data/8/DSC03195.JPG_0.jpg,2257,37,277,314,253,314,True,10
8,114,kaist_dataset/Korean/Digital_Camera/outdoor3/DSC02983.JPG,char_data/8/DSC02983.JPG_0.jpg,6042,53,147,200,297,411,True,10
8,130,kaist_dataset/Korean/Digital_Camera/outdoor3/DSC03159.JPG,char_data/8/DSC03159.JPG_0.jpg,8320,64,61,125,209,339,True,10
8,130,kaist_dataset/Korean/Digital_Camera/outdoor3/DSC03159.JPG,char_data/8/DSC03159.JPG_0.jpg,7150,55,126,181,207,337,True,10
8,31,kaist_dataset/Korean/Digital_Camera/outdoor3/DSC02888.JPG,char_data/8/DSC02888.JPG_0.jpg,775,25,160,185,425,456,True,10
8,63,kaist_dataset/Korean/Digital_Camera/outdoor3/DSC02951.JPG,char_data/8/DSC02951.JPG_0.jpg,3276,52,122,174,389,452,True,10
8,75,kaist_dataset/Korean/Digital_Camera/outdoor3/DSC02951.JPG,char_data/8/DSC02951.JPG_0.jpg,4275,57,277,334,390,465,True,10
8,70,kaist_dataset/Korean/Digital_Camera/outdoor3/DSC02951.JPG,char_data/8/DSC02951.JPG_0.jpg,3710,53,387,440,389,459,True,10
8,29,kaist_dataset/Korean/Digital_Camera/outdoor3/DSC02939.JPG,char_data/8/DSC02939.JPG_0.jpg,812,28,426,454,373,402,True,10
8,37,kaist_dataset/Korean/Digital_Camera/outdoor3/DSC02939.JPG,char_data/8/DSC02939.JPG_0.jpg,962,26,453,479,371,408,True,10
8,34,kaist_dataset/Korean/Digital_Camera/outdoor3/DSC03232.JPG,char_data/8/DSC03232.JPG_0.jpg,850,25,220,245,288,322,True,10
8,32,kaist_dataset/Korean/Digital_Camera/outdoor3/DSC03232.JPG,char_data/8/DSC03232.JPG_0.jpg,864,27,347,374,283,315,True,10
8,25,kaist_dataset/Korean/Digital_Camera/outdoor3/DSC03232.JPG,char_data/8/DSC03232.JPG_0.jpg,625,25,377,402,282,307,True,10
8,38,kaist_dataset/Korean/Digital_Camera/outdoor3/DSC02561.JPG,char_data/8/DSC02561.JPG_0.jpg,988,26,212,238,352,390,True,10
8,22,kaist_dataset/Korean/Digital_Camera/outdoor1/071.JPG,char_data/8/071.JPG_0.jpg,506,23,238,261,261,283,True,10
8,20,kaist_dataset/Korean/Digital_Camera/outdoor1/017.JPG,char_data/8/017.JPG_0.jpg,400,20,406,426,273,293,True,10
8,15,kaist_dataset/Korean/Digital_Camera/outdoor1/070.JPG,char_data/8/070.JPG_0.jpg,165,11,362,373,254,269,True,10
8,21,kaist_dataset/Korean/Digital_Camera/outdoor1/028.JPG,char_data/8/028.JPG_0.jpg,357,17,283,300,265,286,True,10
8,44,kaist_dataset/Korean/Digital_Camera/outdoor1/052.JPG,char_data/8/052.JPG_0.jpg,1232,28,236,264,318,362,True,10
8,32,kaist_dataset/Korean/Digital_Camera/outdoor1/102.JPG,char_data/8/102.JPG_0.jpg,672,21,329,350,309,341,True,10
8,38,kaist_dataset/Korean/Digital_Camera/outdoor1/029.JPG,char_data/8/029.JPG_0.jpg,950,25,232,257,286,324,True,10
8,45,kaist_dataset/Korean/Digital_Camera/outdoor1/127.JPG,char_data/8/127.JPG_0.jpg,1350,30,211,241,269,314,True,10
8,41,kaist_dataset/Korean/Digital_Camera/outdoor1/127.JPG,char_data/8/127.JPG_0.jpg,1025,25,342,367,270,311,True,10
8,26,kaist_dataset/Korean/Digital_Camera/outdoor1/069.JPG,char_data/8/069.JPG_0.jpg,468,18,257,275,270,296,True,10
8,68,kaist_dataset/Korean/Digital_Camera/outdoor1/46.JPG,char_data/8/46.JPG_0.jpg,2992,44,157,201,368,436,True,10
8,70,kaist_dataset/Korean/Digital_Camera/outdoor1/46.JPG,char_data/8/46.JPG_0.jpg,2380,34,393,427,364,434,True,10
8,21,kaist_dataset/Korean/Digital_Camera/outdoor1/126.JPG,char_data/8/126.JPG_0.jpg,525,25,218,243,267,288,True,10
8,26,kaist_dataset/Korean/Digital_Camera/outdoor1/126.JPG,char_data/8/126.JPG_0.jpg,312,12,492,504,256,282,True,10
8,59,kaist_dataset/Korean/Digital_Camera/outdoor1/2007-12-08-day-057.jpg,char_data/8/2007-12-08-day-057.jpg_0.jpg,2537,43,793,836,602,661,True,10
8,76,kaist_dataset/Korean/Digital_Camera/outdoor1/2007-12-08-day-057.jpg,char_data/8/2007-12-08-day-057.jpg_0.jpg,3420,45,1069,1114,590,666,True,10
8,28,kaist_dataset/Korean/Digital_Camera/outdoor1/040.JPG,char_data/8/040.JPG_0.jpg,868,31,217,248,297,325,True,10
8,27,kaist_dataset/Korean/Digital_Camera/outdoor1/023.JPG,char_data/8/023.JPG_0.jpg,621,23,144,167,271,298,True,10
8,24,kaist_dataset/Korean/Digital_Camera/outdoor1/002.JPG,char_data/8/002.JPG_0.jpg,360,15,333,348,374,398,True,10
8,19,kaist_dataset/Korean/Digital_Camera/outdoor1/006.JPG,char_data/8/006.JPG_0.jpg,342,18,275,293,256,275,True,10
8,18,kaist_dataset/Korean/Digital_Camera/outdoor1/006.JPG,char_data/8/006.JPG_0.jpg,324,18,402,420,254,272,True,10
8,15,kaist_dataset/Korean/Digital_Camera/outdoor1/013.JPG,char_data/8/013.JPG_0.jpg,255,17,358,375,254,269,True,10
8,16,kaist_dataset/Korean/Digital_Camera/outdoor1/013.JPG,char_data/8/013.JPG_0.jpg,144,9,405,414,251,267,True,10
8,34,kaist_dataset/Korean/Digital_Camera/outdoor1/50.JPG,char_data/8/50.JPG_0.jpg,714,21,300,321,336,370,True,10
8,24,kaist_dataset/Korean/Digital_Camera/outdoor1/011.JPG,char_data/8/011.JPG_0.jpg,552,23,342,365,256,280,True,10
8,43,kaist_dataset/Korean/Digital_Camera/outdoor1/54.JPG,char_data/8/54.JPG_0.jpg,1462,34,374,408,364,407,True,10
8,45,kaist_dataset/Korean/Digital_Camera/outdoor1/54.JPG,char_data/8/54.JPG_0.jpg,1170,26,523,549,364,409,True,10
8,31,kaist_dataset/Korean/Digital_Camera/outdoor1/032.JPG,char_data/8/032.JPG_0.jpg,713,23,64,87,256,287,True,10
8,22,kaist_dataset/Korean/Digital_Camera/outdoor1/032.JPG,char_data/8/032.JPG_0.jpg,418,19,245,264,260,282,True,10
8,30,kaist_dataset/Korean/Digital_Camera/outdoor1/032.JPG,char_data/8/032.JPG_0.jpg,600,20,418,438,255,285,True,10
8,27,kaist_dataset/Korean/Digital_Camera/outdoor1/125.JPG,char_data/8/125.JPG_0.jpg,540,20,267,287,259,286,True,10
8,33,kaist_dataset/Korean/Digital_Camera/outdoor1/123.JPG,char_data/8/123.JPG_0.jpg,660,20,343,363,273,306,True,10
8,30,kaist_dataset/Korean/Digital_Camera/outdoor1/123.JPG,char_data/8/123.JPG_0.jpg,630,21,168,189,280,310,True,10
8,37,kaist_dataset/Korean/Digital_Camera/outdoor1/059.JPG,char_data/8/059.JPG_0.jpg,703,19,377,396,320,357,True,10
8,31,kaist_dataset/Korean/Digital_Camera/outdoor1/035.JPG,char_data/8/035.JPG_0.jpg,744,24,249,273,287,318,True,10
8,30,kaist_dataset/Korean/Digital_Camera/outdoor1/035.JPG,char_data/8/035.JPG_0.jpg,570,19,455,474,288,318,True,10
8,51,kaist_dataset/Korean/Digital_Camera/outdoor1/2007-12-08-day-047.jpg,char_data/8/2007-12-08-day-047.jpg_0.jpg,1734,34,823,857,706,757,True,10
8,38,kaist_dataset/Korean/Digital_Camera/outdoor1/120.JPG,char_data/8/120.JPG_0.jpg,1596,42,197,239,294,332,True,10
8,28,kaist_dataset/Mixed/Mobile_Phone/(C.M)A-outdoor/P090908006.jpg,char_data/8/P090908006.jpg_0.jpg,672,24,329,353,369,397,True,10
8,34,kaist_dataset/Mixed/Mobile_Phone/(C.M)A-outdoor/P090908006.jpg,char_data/8/P090908006.jpg_0.jpg,646,19,432,451,363,397,True,10
8,26,kaist_dataset/Mixed/Mobile_Phone/(C.M)A-outdoor/P090912040.jpg,char_data/8/P090912040.jpg_0.jpg,676,26,132,158,190,216,True,10
8,25,kaist_dataset/Mixed/Mobile_Phone/(C.M)A-outdoor/P090912040.jpg,char_data/8/P090912040.jpg_0.jpg,475,19,221,240,193,218,True,10
8,26,kaist_dataset/Mixed/Mobile_Phone/(C.M)A-outdoor/P090912040.jpg,char_data/8/P090912040.jpg_0.jpg,520,20,265,285,193,219,True,10
8,43,kaist_dataset/Mixed/Mobile_Phone/(C.M)A-outdoor/P090912038.jpg,char_data/8/P090912038.jpg_0.jpg,946,22,490,512,155,198,True,10
8,34,kaist_dataset/Mixed/Mobile_Phone/(C.M)A-outdoor/P090912047.jpg,char_data/8/P090912047.jpg_0.jpg,646,19,233,252,283,317,True,10
8,43,kaist_dataset/Mixed/Mobile_Phone/(C.M)C-bookCover/P090902016.jpg,char_data/8/P090902016.jpg_0.jpg,1204,28,83,111,200,243,True,10
8,51,kaist_dataset/Mixed/Digital_Camera/(C.S)C-outdoor1/P1010012.JPG,char_data/8/P1010012.JPG_0.jpg,1581,31,328,359,234,285,True,10
8,57,kaist_dataset/Mixed/Digital_Camera/(C.S)C-outdoor1/P1010012.JPG,char_data/8/P1010012.JPG_0.jpg,1710,30,426,456,231,288,True,10
8,31,kaist_dataset/Mixed/Digital_Camera/(C.S)C-outdoor1/027.JPG,char_data/8/027.JPG_0.jpg,496,16,394,410,274,305,True,10
8,27,kaist_dataset/Mixed/Digital_Camera/(C.S)C-outdoor1/027.JPG,char_data/8/027.JPG_0.jpg,405,15,482,497,278,305,True,10
8,29,kaist_dataset/Mixed/Digital_Camera/(C.S)C-outdoor1/048.JPG,char_data/8/048.JPG_0.jpg,580,20,260,280,258,287,True,10
8,42,kaist_dataset/Mixed/Digital_Camera/(C.S)C-outdoor1/51.JPG,char_data/8/51.JPG_0.jpg,1092,26,498,524,375,417,True,10
8,48,kaist_dataset/Mixed/Digital_Camera/(C.S)C-outdoor1/2007-12-09-day-exterior-078.jpg,char_data/8/2007-12-09-day-exterior-078.jpg_0.jpg,1200,25,420,445,597,645,True,10
8,94,kaist_dataset/Mixed/Digital_Camera/(C.S)C-outdoor1/2007-12-08-day-092.jpg,char_data/8/2007-12-08-day-092.jpg_0.jpg,5922,63,534,597,664,758,True,10
8,93,kaist_dataset/Mixed/Digital_Camera/(C.S)C-outdoor1/2007-12-08-day-092.jpg,char_data/8/2007-12-08-day-092.jpg_0.jpg,6417,69,828,897,659,752,True,10
8,71,kaist_dataset/Mixed/Digital_Camera/(C.S)C-outdoor1/2007-12-09-day-exterior-086.jpg,char_data/8/2007-12-09-day-exterior-086.jpg_0.jpg,4828,68,688,756,718,789,True,10
8,33,kaist_dataset/Mixed/Digital_Camera/(C.S)C-outdoor1/DSC02344.JPG,char_data/8/DSC02344.JPG_0.jpg,528,16,494,510,255,288,True,10
8,36,kaist_dataset/Mixed/Digital_Camera/(C.S)C-outdoor1/118.JPG,char_data/8/118.JPG_0.jpg,684,19,334,353,357,393,True,10
8,29,kaist_dataset/Mixed/Digital_Camera/(C.S)C-outdoor1/118.JPG,char_data/8/118.JPG_0.jpg,609,21,462,483,361,390,True,10
8,30,kaist_dataset/Mixed/Digital_Camera/(C.S)C-outdoor1/121.JPG,char_data/8/121.JPG_0.jpg,450,15,276,291,275,305,True,10
8,34,kaist_dataset/Mixed/Digital_Camera/(C.S)C-outdoor1/121.JPG,char_data/8/121.JPG_0.jpg,476,14,412,426,270,304,True,10
8,22,kaist_dataset/Mixed/Digital_Camera/(C.S)C-outdoor1/121.JPG,char_data/8/121.JPG_0.jpg,286,13,507,520,279,301,True,10
8,38,kaist_dataset/Mixed/Digital_Camera/(C.S)C-outdoor1/009.JPG,char_data/8/009.JPG_0.jpg,874,23,257,280,320,358,True,10
8,35,kaist_dataset/Mixed/Digital_Camera/(C.S)C-outdoor1/009.JPG,char_data/8/009.JPG_0.jpg,770,22,340,362,320,355,True,10
8,157,kaist_dataset/Mixed/Digital_Camera/(C.S)C-outdoor1/080118-0007.jpg,char_data/8/080118-0007.jpg_0.jpg,14915,95,135,230,199,356,True,10
8,220,kaist_dataset/Mixed/Digital_Camera/(C.S)C-outdoor1/2007-12-08-day-118.jpg,char_data/8/2007-12-08-day-118.jpg_0.jpg,28380,129,756,885,501,721,True,10
8,31,kaist_dataset/Mixed/Digital_Camera/(C.S)C-outdoor1/008.JPG,char_data/8/008.JPG_0.jpg,589,19,438,457,265,296,True,10
8,24,kaist_dataset/Mixed/Digital_Camera/(C.S)C-outdoor1/48.JPG,char_data/8/48.JPG_0.jpg,432,18,197,215,340,364,True,10
8,39,kaist_dataset/Mixed/Digital_Camera/(C.S)C-outdoor1/56.JPG,char_data/8/56.JPG_0.jpg,1287,33,319,352,303,342,True,10
8,19,kaist_dataset/Mixed/Digital_Camera/(C.S)C-outdoor1/047.JPG,char_data/8/047.JPG_0.jpg,190,10,552,562,175,194,True,10
8,24,kaist_dataset/Mixed/Digital_Camera/(C.S)C-outdoor1/047.JPG,char_data/8/047.JPG_0.jpg,288,12,591,603,241,265,True,10
8,24,kaist_dataset/Mixed/Digital_Camera/(C.S)C-outdoor1/047.JPG,char_data/8/047.JPG_0.jpg,312,13,610,623,241,265,True,10
8,39,kaist_dataset/Mixed/Digital_Camera/(C.S)C-outdoor1/45.JPG,char_data/8/45.JPG_0.jpg,1443,37,269,306,364,403,True,10
8,59,kaist_dataset/Mixed/Digital_Camera/(C.S)C-outdoor1/2007-12-09-day-exterior-004.jpg,char_data/8/2007-12-09-day-exterior-004.jpg_0.jpg,2891,49,979,1028,662,721,True,10
8,49,kaist_dataset/Mixed/Digital_Camera/(C.S)C-outdoor1/P1010009.JPG,char_data/8/P1010009.JPG_0.jpg,1078,22,182,204,237,286,True,10
8,37,kaist_dataset/Mixed/Digital_Camera/(C.S)C-outdoor1/DSC02349.JPG,char_data/8/DSC02349.JPG_0.jpg,999,27,265,292,196,233,True,10
8,38,kaist_dataset/Mixed/Digital_Camera/(C.S)C-outdoor1/DSC02349.JPG,char_data/8/DSC02349.JPG_0.jpg,950,25,346,371,426,464,True,10
8,28,kaist_dataset/Mixed/Digital_Camera/(C.S)C-outdoor1/57.JPG,char_data/8/57.JPG_0.jpg,392,14,324,338,291,319,True,10
8,26,kaist_dataset/Mixed/Digital_Camera/(C.S)C-outdoor1/57.JPG,char_data/8/57.JPG_0.jpg,364,14,402,416,295,321,True,10
8,23,kaist_dataset/Mixed/Digital_Camera/(C.S)C-outdoor1/054.JPG,char_data/8/054.JPG_0.jpg,414,18,454,472,304,327,True,10
8,21,kaist_dataset/Mixed/Digital_Camera/(C.S)C-outdoor1/054.JPG,char_data/8/054.JPG_0.jpg,378,18,553,571,309,330,True,10
8,22,kaist_dataset/Mixed/Digital_Camera/(C.S)C-outdoor1/054.JPG,char_data/8/054.JPG_0.jpg,374,17,572,589,306,328,True,10
8,43,kaist_dataset/Mixed/Digital_Camera/(C.S)C-outdoor1/DSC02312.JPG,char_data/8/DSC02312.JPG_0.jpg,1634,38,128,166,220,263,True,10
8,27,kaist_dataset/Mixed/Digital_Camera/(C.S)C-outdoor1/47.JPG,char_data/8/47.JPG_0.jpg,486,18,305,323,475,502,True,10
8,42,kaist_dataset/Mixed/Digital_Camera/(C.S)C-outdoor1/DSC02350.JPG,char_data/8/DSC02350.JPG_0.jpg,1050,25,242,267,396,438,True,10
8,47,kaist_dataset/Mixed/Digital_Camera/(C.S)C-outdoor1/2007-12-09-day-exterior-037.jpg,char_data/8/2007-12-09-day-exterior-037.jpg_0.jpg,1786,38,661,699,709,756,True,10
8,38,kaist_dataset/Mixed/Digital_Camera/(C.S)C-outdoor1/DSC02242.JPG,char_data/8/DSC02242.JPG_0.jpg,798,21,537,558,257,295,True,10
8,41,kaist_dataset/Mixed/Digital_Camera/(C.S)C-outdoor1/105.jpg,char_data/8/105.jpg_0.jpg,861,21,297,318,383,424,True,10
8,80,kaist_dataset/Mixed/Digital_Camera/(C.S)C-outdoor1/DSC02244.JPG,char_data/8/DSC02244.JPG_0.jpg,4160,52,176,228,351,431,True,10
8,46,kaist_dataset/Mixed/Digital_Camera/(C.S)C-outdoor1/2007-12-08-day-130.jpg,char_data/8/2007-12-08-day-130.jpg_0.jpg,1380,30,950,980,750,796,True,10
8,37,kaist_dataset/Mixed/Digital_Camera/(C.S)C-outdoor1/2007-12-08-day-130.jpg,char_data/8/2007-12-08-day-130.jpg_0.jpg,1110,30,1102,1132,762,799,True,10
8,42,kaist_dataset/Mixed/Digital_Camera/(C.S)C-outdoor1/2007-12-08-day-130.jpg,char_data/8/2007-12-08-day-130.jpg_0.jpg,1470,35,1131,1166,761,803,True,10
8,58,kaist_dataset/Mixed/Digital_Camera/(C.S)C-outdoor1/025.JPG,char_data/8/025.JPG_0.jpg,1624,28,123,151,331,389,True,10
8,55,kaist_dataset/Mixed/Digital_Camera/(C.S)C-outdoor1/025.JPG,char_data/8/025.JPG_0.jpg,1760,32,226,258,334,389,True,10
8,55,kaist_dataset/Mixed/Digital_Camera/(C.S)C-outdoor1/025.JPG,char_data/8/025.JPG_0.jpg,1595,29,281,310,335,390,True,10
8,54,kaist_dataset/Mixed/Digital_Camera/(C.S)C-outdoor1/025.JPG,char_data/8/025.JPG_0.jpg,1674,31,380,411,340,394,True,10
8,52,kaist_dataset/Mixed/Digital_Camera/(C.S)C-outdoor1/025.JPG,char_data/8/025.JPG_0.jpg,1404,27,485,512,340,392,True,10
8,51,kaist_dataset/Mixed/Digital_Camera/(C.S)C-outdoor1/025.JPG,char_data/8/025.JPG_0.jpg,1428,28,535,563,341,392,True,10
8,33,kaist_dataset/Mixed/Digital_Camera/(C.S)C-outdoor1/55.JPG,char_data/8/55.JPG_0.jpg,891,27,279,306,371,404,True,10
8,43,kaist_dataset/Mixed/Digital_Camera/(C.S)C-outdoor1/2.JPG,char_data/8/2.JPG_0.jpg,860,20,264,284,64,107,True,10
8,20,kaist_dataset/Mixed/Digital_Camera/(C.S)C-outdoor1/2.JPG,char_data/8/2.JPG_0.jpg,220,11,558,569,396,416,True,10
8,26,kaist_dataset/Mixed/Digital_Camera/(C.S)C-outdoor1/063.JPG,char_data/8/063.JPG_0.jpg,416,16,362,378,261,287,True,10
8,42,kaist_dataset/Mixed/Digital_Camera/(C.S)C-outdoor1/DSC02322.JPG,char_data/8/DSC02322.JPG_0.jpg,1470,35,154,189,365,407,True,10
8,54,kaist_dataset/Mixed/Digital_Camera/(C.S)C-outdoor1/1.JPG,char_data/8/1.JPG_0.jpg,1350,25,167,192,457,511,True,10
8,27,kaist_dataset/Mixed/Digital_Camera/(C.S)C-outdoor1/014.JPG,char_data/8/014.JPG_0.jpg,378,14,153,167,272,299,True,10
8,56,kaist_dataset/Mixed/Digital_Camera/(C.S)C-outdoor1/2007-12-08-day-091.jpg,char_data/8/2007-12-08-day-091.jpg_0.jpg,2520,45,1085,1130,636,692,True,10
8,70,kaist_dataset/Mixed/Digital_Camera/(C.S)C-outdoor1/2007-12-08-day-091.jpg,char_data/8/2007-12-08-day-091.jpg_0.jpg,2870,41,1270,1311,621,691,True,10
8,39,kaist_dataset/Mixed/Digital_Camera/(C.S)F-others/DSC02504.JPG,char_data/8/DSC02504.JPG_0.jpg,1560,40,204,244,325,364,True,10
8,45,kaist_dataset/Mixed/Digital_Camera/(C.S)F-others/2007-12-08-day-113.jpg,char_data/8/2007-12-08-day-113.jpg_0.jpg,1035,23,826,849,395,440,True,10
8,90,kaist_dataset/Mixed/Digital_Camera/(C.S)F-others/DSC03224.JPG,char_data/8/DSC03224.JPG_0.jpg,3870,43,137,180,255,345,True,10
8,35,kaist_dataset/Mixed/Digital_Camera/(C.S)F-others/2007-12-08-day-044.jpg,char_data/8/2007-12-08-day-044.jpg_0.jpg,665,19,1025,1044,825,860,True,10
8,52,kaist_dataset/Mixed/Digital_Camera/(C.S)F-others/DSC02893.JPG,char_data/8/DSC02893.JPG_0.jpg,1664,32,298,330,336,388,True,10
8,45,kaist_dataset/Mixed/Digital_Camera/(C.S)F-others/DSC02893.JPG,char_data/8/DSC02893.JPG_0.jpg,1710,38,379,417,332,377,True,10
8,45,kaist_dataset/Mixed/Digital_Camera/(C.S)F-others/DSC02893.JPG,char_data/8/DSC02893.JPG_0.jpg,1485,33,451,484,325,370,True,10
8,52,kaist_dataset/Mixed/Digital_Camera/(C.S)F-others/2007-12-09-day-exterior-023.jpg,char_data/8/2007-12-09-day-exterior-023.jpg_0.jpg,2184,42,853,895,577,629,True,10
8,51,kaist_dataset/Mixed/Digital_Camera/(C.S)F-others/2007-12-09-day-exterior-023.jpg,char_data/8/2007-12-09-day-exterior-023.jpg_0.jpg,2040,40,1083,1123,602,653,True,10
8,37,kaist_dataset/Mixed/Digital_Camera/(C.S)E-night/DSC02660.JPG,char_data/8/DSC02660.JPG_0.jpg,814,22,200,222,416,453,True,10
8,43,kaist_dataset/Mixed/Digital_Camera/(C.S)E-night/DSC02647.JPG,char_data/8/DSC02647.JPG_0.jpg,1118,26,194,220,285,328,True,10
8,31,kaist_dataset/Mixed/Digital_Camera/(C.S)E-night/P1010156.JPG,char_data/8/P1010156.JPG_0.jpg,682,22,320,342,244,275,True,10
8,28,kaist_dataset/Mixed/Digital_Camera/(C.S)E-night/P1010156.JPG,char_data/8/P1010156.JPG_0.jpg,672,24,379,403,243,271,True,10
8,27,kaist_dataset/Mixed/Digital_Camera/(C.S)E-night/P1010156.JPG,char_data/8/P1010156.JPG_0.jpg,567,21,404,425,243,270,True,10
8,63,kaist_dataset/Mixed/Digital_Camera/(C.S)E-night/DSC02574.JPG,char_data/8/DSC02574.JPG_0.jpg,2205,35,280,315,410,473,True,10
8,37,kaist_dataset/Mixed/Digital_Camera/(C.S)E-night/DSC02585.JPG,char_data/8/DSC02585.JPG_0.jpg,481,13,331,344,412,449,True,10
8,30,kaist_dataset/Mixed/Digital_Camera/(C.S)E-night/DSC03840.JPG,char_data/8/DSC03840.JPG_0.jpg,390,13,451,464,207,237,True,10
8,31,kaist_dataset/Mixed/Digital_Camera/(C.S)E-night/DSC03840.JPG,char_data/8/DSC03840.JPG_0.jpg,496,16,465,481,207,238,True,10
8,31,kaist_dataset/Mixed/Digital_Camera/(C.S)E-night/DSC03840.JPG,char_data/8/DSC03840.JPG_0.jpg,651,21,500,521,209,240,True,10
8,39,kaist_dataset/Mixed/Digital_Camera/(C.S)E-night/DSC02644.JPG,char_data/8/DSC02644.JPG_0.jpg,858,22,298,320,400,439,True,10
8,36,kaist_dataset/Mixed/Digital_Camera/(C.S)E-night/DSC02586.JPG,char_data/8/DSC02586.JPG_0.jpg,612,17,308,325,394,430,True,10
8,43,kaist_dataset/Mixed/Digital_Camera/(C.S)E-night/DSC02575.JPG,char_data/8/DSC02575.JPG_0.jpg,1290,30,263,293,358,401,True,10
8,30,kaist_dataset/Mixed/Digital_Camera/(C.S)E-night/DSC02678.JPG,char_data/8/DSC02678.JPG_0.jpg,420,14,371,385,396,426,True,10
8,33,kaist_dataset/Mixed/Digital_Camera/(C.S)E-night/DSC02673.JPG,char_data/8/DSC02673.JPG_0.jpg,594,18,281,299,306,339,True,10
8,34,kaist_dataset/Mixed/Digital_Camera/(C.S)E-night/DSC02673.JPG,char_data/8/DSC02673.JPG_0.jpg,612,18,449,467,302,336,True,10
8,51,kaist_dataset/Mixed/Digital_Camera/(C.S)E-night/DSC02595.JPG,char_data/8/DSC02595.JPG_0.jpg,1785,35,450,485,344,395,True,10
8,48,kaist_dataset/Mixed/Digital_Camera/(C.S)E-night/DSC03561.JPG,char_data/8/DSC03561.JPG_0.jpg,1632,34,257,291,257,305,True,10
8,51,kaist_dataset/Mixed/Digital_Camera/(C.S)E-night/DSC03561.JPG,char_data/8/DSC03561.JPG_0.jpg,1734,34,399,433,249,300,True,10
8,33,kaist_dataset/Mixed/Digital_Camera/(C.S)E-night/DSC02569.JPG,char_data/8/DSC02569.JPG_0.jpg,594,18,333,351,415,448,True,10
8,44,kaist_dataset/Mixed/Digital_Camera/(C.S)E-night/DSC02623.JPG,char_data/8/DSC02623.JPG_0.jpg,792,18,88,106,395,439,True,10
8,36,kaist_dataset/Mixed/Digital_Camera/(C.S)E-night/DSC02903.JPG,char_data/8/DSC02903.JPG_0.jpg,648,18,320,338,265,301,True,10
8,53,kaist_dataset/Mixed/Digital_Camera/(C.S)E-night/DSC02573.JPG,char_data/8/DSC02573.JPG_0.jpg,1802,34,311,345,175,228,True,10
8,55,kaist_dataset/Mixed/Digital_Camera/(C.S)E-night/DSC02573.JPG,char_data/8/DSC02573.JPG_0.jpg,1925,35,560,595,143,198,True,10
8,60,kaist_dataset/Mixed/Digital_Camera/(C.S)E-night/P1010147.JPG,char_data/8/P1010147.JPG_0.jpg,2220,37,233,270,253,313,True,10
8,35,kaist_dataset/Mixed/Digital_Camera/(C.S)B-light/DSC03298.JPG,char_data/8/DSC03298.JPG_0.jpg,455,13,373,386,286,321,True,10
8,26,kaist_dataset/Mixed/Digital_Camera/(C.S)D-indoor1/DSC04005.JPG,char_data/8/DSC04005.JPG_0.jpg,468,18,260,278,442,468,True,10
8,25,kaist_dataset/Mixed/Digital_Camera/(C.S)D-indoor1/DSC04005.JPG,char_data/8/DSC04005.JPG_0.jpg,600,24,362,386,440,465,True,10
8,24,kaist_dataset/Mixed/Digital_Camera/(C.S)D-indoor1/DSC04005.JPG,char_data/8/DSC04005.JPG_0.jpg,408,17,424,441,440,464,True,10
8,70,kaist_dataset/Mixed/Digital_Camera/(C.S)D-indoor1/DSC03998.JPG,char_data/8/DSC03998.JPG_0.jpg,2380,34,378,412,410,480,True,10
8,67,kaist_dataset/Mixed/Digital_Camera/(C.S)D-indoor1/DSC03998.JPG,char_data/8/DSC03998.JPG_0.jpg,2278,34,545,579,417,484,True,10
8,105,kaist_dataset/Mixed/Digital_Camera/(C.S)D-indoor1/DSC04002.JPG,char_data/8/DSC04002.JPG_0.jpg,7035,67,128,195,347,452,True,10
8,94,kaist_dataset/Mixed/Digital_Camera/(C.S)D-indoor1/DSC04002.JPG,char_data/8/DSC04002.JPG_0.jpg,4794,51,449,500,347,441,True,10
8,50,kaist_dataset/Mixed/Digital_Camera/(C.S)D-indoor1/DSC03986.JPG,char_data/8/DSC03986.JPG_0.jpg,1050,21,61,82,161,211,True,10
8,53,kaist_dataset/Mixed/Digital_Camera/(C.S)D-indoor1/DSC03986.JPG,char_data/8/DSC03986.JPG_0.jpg,1113,21,159,180,159,212,True,10
8,47,kaist_dataset/Mixed/Digital_Camera/(C.S)D-indoor1/DSC02733.JPG,char_data/8/DSC02733.JPG_0.jpg,1457,31,229,260,400,447,True,10
8,45,kaist_dataset/Mixed/Digital_Camera/(C.S)D-indoor1/DSC03980.JPG,char_data/8/DSC03980.JPG_0.jpg,1710,38,245,283,303,348,True,10
8,45,kaist_dataset/Mixed/Digital_Camera/(C.S)D-indoor1/DSC03980.JPG,char_data/8/DSC03980.JPG_0.jpg,2115,47,382,429,311,356,True,10
8,36,kaist_dataset/Mixed/Digital_Camera/(C.S)C-outdoor5/DSC04098.JPG,char_data/8/DSC04098.JPG_0.jpg,504,14,449,463,313,349,True,10
8,32,kaist_dataset/Mixed/Digital_Camera/(C.S)C-outdoor5/DSC04098.JPG,char_data/8/DSC04098.JPG_0.jpg,480,15,490,505,315,347,True,10
8,41,kaist_dataset/Mixed/Digital_Camera/(C.S)C-outdoor5/DSC04098.JPG,char_data/8/DSC04098.JPG_0.jpg,656,16,521,537,310,351,True,10
8,38,kaist_dataset/Mixed/Digital_Camera/(C.S)C-outdoor5/DSC04098.JPG,char_data/8/DSC04098.JPG_0.jpg,722,19,537,556,312,350,True,10
8,54,kaist_dataset/Mixed/Digital_Camera/(C.S)C-outdoor5/DSC03847.JPG,char_data/8/DSC03847.JPG_0.jpg,1134,21,452,473,16,70,True,10
8,52,kaist_dataset/Mixed/Digital_Camera/(C.S)C-outdoor5/DSC03847.JPG,char_data/8/DSC03847.JPG_0.jpg,1404,27,473,500,15,67,True,10
8,114,kaist_dataset/Mixed/Digital_Camera/(C.S)C-outdoor5/DSC04449.JPG,char_data/8/DSC04449.JPG_0.jpg,6954,61,90,151,38,152,True,10
8,134,kaist_dataset/Mixed/Digital_Camera/(C.S)C-outdoor5/DSC04449.JPG,char_data/8/DSC04449.JPG_0.jpg,9916,74,550,624,34,168,True,10
8,40,kaist_dataset/Mixed/Digital_Camera/(C.S)C-outdoor5/P1010007.JPG,char_data/8/P1010007.JPG_0.jpg,1120,28,259,287,271,311,True,10
8,41,kaist_dataset/Mixed/Digital_Camera/(C.S)C-outdoor5/DSC04144.JPG,char_data/8/DSC04144.JPG_0.jpg,697,17,268,285,416,457,True,10
8,51,kaist_dataset/Mixed/Digital_Camera/(C.S)C-outdoor5/DSC04094.JPG,char_data/8/DSC04094.JPG_0.jpg,2346,46,236,282,385,436,True,10
8,65,kaist_dataset/Mixed/Digital_Camera/(C.S)C-outdoor5/DSC04108.JPG,char_data/8/DSC04108.JPG_0.jpg,2080,32,357,389,239,304,True,10
8,22,kaist_dataset/Mixed/Digital_Camera/(C.S)C-outdoor5/DSC04086.JPG,char_data/8/DSC04086.JPG_0.jpg,286,13,378,391,374,396,True,10
8,32,kaist_dataset/Mixed/Digital_Camera/(C.S)C-outdoor5/DSC04155.JPG,char_data/8/DSC04155.JPG_0.jpg,384,12,499,511,263,295,True,10
8,35,kaist_dataset/Mixed/Digital_Camera/(C.S)C-outdoor5/DSC03839.JPG,char_data/8/DSC03839.JPG_0.jpg,630,18,286,304,366,401,True,10
8,31,kaist_dataset/Mixed/Digital_Camera/(C.S)C-outdoor5/DSC03839.JPG,char_data/8/DSC03839.JPG_0.jpg,558,18,303,321,368,399,True,10
8,106,kaist_dataset/Mixed/Digital_Camera/(C.S)C-outdoor5/DSC03824.JPG,char_data/8/DSC03824.JPG_0.jpg,5512,52,503,555,90,196,True,10
8,35,kaist_dataset/Mixed/Digital_Camera/(C.S)C-outdoor5/DSC04337.JPG,char_data/8/DSC04337.JPG_0.jpg,1085,31,320,351,319,354,True,10
8,43,kaist_dataset/Mixed/Digital_Camera/(C.S)C-outdoor5/DSC04337.JPG,char_data/8/DSC04337.JPG_0.jpg,1118,26,444,470,317,360,True,10
8,36,kaist_dataset/Mixed/Digital_Camera/(C.S)C-outdoor5/DSC04330.JPG,char_data/8/DSC04330.JPG_0.jpg,828,23,351,374,182,218,True,10
8,37,kaist_dataset/Mixed/Digital_Camera/(C.S)C-outdoor5/DSC04330.JPG,char_data/8/DSC04330.JPG_0.jpg,1110,30,373,403,178,215,True,10
8,52,kaist_dataset/Mixed/Digital_Camera/(C.S)C-outdoor5/DSC04330.JPG,char_data/8/DSC04330.JPG_0.jpg,1352,26,362,388,369,421,True,10
8,77,kaist_dataset/Mixed/Digital_Camera/(C.S)C-outdoor5/DSC04016.JPG,char_data/8/DSC04016.JPG_0.jpg,3619,47,216,263,107,184,True,10
8,73,kaist_dataset/Mixed/Digital_Camera/(C.S)C-outdoor5/DSC04016.JPG,char_data/8/DSC04016.JPG_0.jpg,2847,39,404,443,323,396,True,10
8,28,kaist_dataset/Mixed/Digital_Camera/(C.S)C-outdoor5/DSC04151.JPG,char_data/8/DSC04151.JPG_0.jpg,476,17,448,465,346,374,True,10
8,63,kaist_dataset/Mixed/Digital_Camera/(C.S)C-outdoor5/DSC04364.JPG,char_data/8/DSC04364.JPG_0.jpg,2268,36,146,182,392,455,True,10
8,38,kaist_dataset/Mixed/Digital_Camera/(C.S)C-outdoor5/DSC04140.JPG,char_data/8/DSC04140.JPG_0.jpg,456,12,518,530,345,383,True,10
8,35,kaist_dataset/Mixed/Digital_Camera/(C.S)C-outdoor5/DSC04140.JPG,char_data/8/DSC04140.JPG_0.jpg,455,13,550,563,345,380,True,10
8,38,kaist_dataset/Mixed/Digital_Camera/(C.S)C-outdoor5/DSC04140.JPG,char_data/8/DSC04140.JPG_0.jpg,532,14,574,588,342,380,True,10
8,31,kaist_dataset/Mixed/Digital_Camera/(C.S)C-outdoor5/DSC04124.JPG,char_data/8/DSC04124.JPG_0.jpg,465,15,418,433,308,339,True,10
8,61,kaist_dataset/Mixed/Digital_Camera/(C.S)C-outdoor5/DSC04401.JPG,char_data/8/DSC04401.JPG_0.jpg,2440,40,356,396,245,306,True,10
8,36,kaist_dataset/Mixed/Digital_Camera/(C.S)C-outdoor5/DSC04071.JPG,char_data/8/DSC04071.JPG_0.jpg,576,16,433,449,366,402,True,10
8,36,kaist_dataset/Mixed/Digital_Camera/(C.S)C-outdoor5/DSC04071.JPG,char_data/8/DSC04071.JPG_0.jpg,684,19,449,468,364,400,True,10
8,40,kaist_dataset/Mixed/Digital_Camera/(C.S)C-outdoor5/DSC04071.JPG,char_data/8/DSC04071.JPG_0.jpg,840,21,528,549,363,403,True,10
8,54,kaist_dataset/Mixed/Digital_Camera/(C.S)C-outdoor5/DSC04033.JPG,char_data/8/DSC04033.JPG_0.jpg,2052,38,144,182,283,337,True,10
8,112,kaist_dataset/Mixed/Digital_Camera/(C.S)C-outdoor5/DSC03821.JPG,char_data/8/DSC03821.JPG_0.jpg,8512,76,494,570,127,239,True,10
8,39,kaist_dataset/Mixed/Digital_Camera/(C.S)C-outdoor5/DSC03821.JPG,char_data/8/DSC03821.JPG_0.jpg,780,20,308,328,81,120,True,10
8,41,kaist_dataset/Mixed/Digital_Camera/(C.S)C-outdoor5/DSC03821.JPG,char_data/8/DSC03821.JPG_0.jpg,902,22,403,425,83,124,True,10
8,24,kaist_dataset/Mixed/Digital_Camera/(C.S)C-outdoor5/P1010004.JPG,char_data/8/P1010004.JPG_0.jpg,360,15,269,284,312,336,True,10
8,45,kaist_dataset/Mixed/Digital_Camera/(C.S)C-outdoor5/DSC04125.JPG,char_data/8/DSC04125.JPG_0.jpg,990,22,69,91,175,220,True,10
8,38,kaist_dataset/Mixed/Digital_Camera/(C.S)C-outdoor5/DSC04125.JPG,char_data/8/DSC04125.JPG_0.jpg,722,19,449,468,417,455,True,10
8,42,kaist_dataset/Mixed/Digital_Camera/(C.S)C-outdoor5/DSC04125.JPG,char_data/8/DSC04125.JPG_0.jpg,840,20,551,571,414,456,True,10
8,39,kaist_dataset/Mixed/Digital_Camera/(C.S)C-outdoor5/DSC04070.JPG,char_data/8/DSC04070.JPG_0.jpg,780,20,384,404,105,144,True,10
8,36,kaist_dataset/Mixed/Digital_Camera/(C.S)C-outdoor5/DSC04070.JPG,char_data/8/DSC04070.JPG_0.jpg,720,20,419,439,106,142,True,10
8,22,kaist_dataset/Mixed/Digital_Camera/(C.S)C-outdoor5/DSC04031.JPG,char_data/8/DSC04031.JPG_0.jpg,220,10,474,484,381,403,True,10
8,26,kaist_dataset/Mixed/Digital_Camera/(C.S)C-outdoor5/DSC04031.JPG,char_data/8/DSC04031.JPG_0.jpg,286,11,168,179,379,405,True,10
8,28,kaist_dataset/Mixed/Digital_Camera/(C.S)C-outdoor5/DSC04150.JPG,char_data/8/DSC04150.JPG_0.jpg,392,14,568,582,368,396,True,10
8,54,kaist_dataset/Mixed/Digital_Camera/(C.S)C-outdoor5/DSC04017.JPG,char_data/8/DSC04017.JPG_0.jpg,1728,32,244,276,424,478,True,10
8,35,kaist_dataset/Mixed/Digital_Camera/(C.S)C-outdoor5/P1010002.JPG,char_data/8/P1010002.JPG_0.jpg,980,28,436,464,283,318,True,10
8,43,kaist_dataset/Mixed/Digital_Camera/(C.S)C-outdoor5/P1010002.JPG,char_data/8/P1010002.JPG_0.jpg,1333,31,518,549,280,323,True,10
8,40,kaist_dataset/Mixed/Digital_Camera/(C.S)C-outdoor5/P1010002.JPG,char_data/8/P1010002.JPG_0.jpg,960,24,575,599,279,319,True,10
8,45,kaist_dataset/Mixed/Digital_Camera/(C.S)C-outdoor5/DSC04139.JPG,char_data/8/DSC04139.JPG_0.jpg,540,12,298,310,394,439,True,10
8,97,kaist_dataset/Mixed/Digital_Camera/(C.S)C-outdoor5/DSC04054.JPG,char_data/8/DSC04054.JPG_0.jpg,8924,92,422,514,66,163,True,10
8,40,kaist_dataset/Mixed/Digital_Camera/(C.S)C-outdoor5/DSC04055.JPG,char_data/8/DSC04055.JPG_0.jpg,1240,31,140,171,369,409,True,10
8,35,kaist_dataset/Mixed/Digital_Camera/(C.S)C-outdoor5/DSC04056.JPG,char_data/8/DSC04056.JPG_0.jpg,910,26,429,455,261,296,True,10
8,35,kaist_dataset/Mixed/Digital_Camera/(C.S)C-outdoor5/DSC04056.JPG,char_data/8/DSC04056.JPG_0.jpg,1015,29,568,597,257,292,True,10
8,30,kaist_dataset/Mixed/Digital_Camera/(C.S)C-outdoor5/DSC04056.JPG,char_data/8/DSC04056.JPG_0.jpg,570,19,437,456,300,330,True,10
8,30,kaist_dataset/Mixed/Digital_Camera/(C.S)C-outdoor5/DSC04056.JPG,char_data/8/DSC04056.JPG_0.jpg,720,24,455,479,300,330,True,10
8,44,kaist_dataset/Mixed/Digital_Camera/(C.S)C-outdoor5/DSC04115.JPG,char_data/8/DSC04115.JPG_0.jpg,1144,26,373,399,353,397,True,10
8,42,kaist_dataset/Mixed/Digital_Camera/(C.S)C-outdoor5/DSC04115.JPG,char_data/8/DSC04115.JPG_0.jpg,1050,25,517,542,350,392,True,10
8,51,kaist_dataset/Mixed/Digital_Camera/(C.S)C-outdoor3/DSC03189.JPG,char_data/8/DSC03189.JPG_0.jpg,1632,32,471,503,298,349,True,10
8,30,kaist_dataset/Mixed/Digital_Camera/(C.S)C-outdoor3/DSC03316.JPG,char_data/8/DSC03316.JPG_0.jpg,390,13,231,244,90,120,True,10
8,36,kaist_dataset/Mixed/Digital_Camera/(C.S)C-outdoor3/DSC03316.JPG,char_data/8/DSC03316.JPG_0.jpg,432,12,281,293,85,121,True,10
8,33,kaist_dataset/Mixed/Digital_Camera/(C.S)C-outdoor3/DSC03316.JPG,char_data/8/DSC03316.JPG_0.jpg,396,12,387,399,83,116,True,10
8,34,kaist_dataset/Mixed/Digital_Camera/(C.S)C-outdoor3/DSC03316.JPG,char_data/8/DSC03316.JPG_0.jpg,612,18,436,454,83,117,True,10
8,24,kaist_dataset/Mixed/Digital_Camera/(C.S)C-outdoor3/DSC03292.JPG,char_data/8/DSC03292.JPG_0.jpg,312,13,513,526,120,144,True,10
8,57,kaist_dataset/Mixed/Digital_Camera/(C.S)C-outdoor3/DSC03177.JPG,char_data/8/DSC03177.JPG_0.jpg,1995,35,171,206,186,243,True,10
8,63,kaist_dataset/Mixed/Digital_Camera/(C.S)C-outdoor3/DSC03177.JPG,char_data/8/DSC03177.JPG_0.jpg,2016,32,207,239,184,247,True,10
8,52,kaist_dataset/Mixed/Digital_Camera/(C.S)C-outdoor3/DSC03177.JPG,char_data/8/DSC03177.JPG_0.jpg,1716,33,321,354,194,246,True,10
8,57,kaist_dataset/Mixed/Digital_Camera/(C.S)C-outdoor3/DSC03177.JPG,char_data/8/DSC03177.JPG_0.jpg,1995,35,355,390,193,250,True,10
8,44,kaist_dataset/Mixed/Digital_Camera/(C.S)C-outdoor3/DSC02958.JPG,char_data/8/DSC02958.JPG_0.jpg,1144,26,360,386,400,444,True,10
8,39,kaist_dataset/Mixed/Digital_Camera/(C.S)C-outdoor3/DSC02958.JPG,char_data/8/DSC02958.JPG_0.jpg,1209,31,384,415,403,442,True,10
8,31,kaist_dataset/Mixed/Digital_Camera/(C.S)C-outdoor3/DSC03062.JPG,char_data/8/DSC03062.JPG_0.jpg,527,17,263,280,248,279,True,10
8,31,kaist_dataset/Mixed/Digital_Camera/(C.S)C-outdoor3/DSC03062.JPG,char_data/8/DSC03062.JPG_0.jpg,527,17,324,341,245,276,True,10
8,30,kaist_dataset/Mixed/Digital_Camera/(C.S)C-outdoor3/DSC03051.JPG,char_data/8/DSC03051.JPG_0.jpg,690,23,243,266,325,355,True,10
8,37,kaist_dataset/Mixed/Digital_Camera/(C.S)C-outdoor3/DSC03051.JPG,char_data/8/DSC03051.JPG_0.jpg,888,24,377,401,314,351,True,10
8,28,kaist_dataset/Mixed/Digital_Camera/(C.S)C-outdoor3/DSC03255.JPG,char_data/8/DSC03255.JPG_0.jpg,532,19,231,250,186,214,True,10
8,44,kaist_dataset/Mixed/Digital_Camera/(C.S)C-outdoor3/DSC03323.JPG,char_data/8/DSC03323.JPG_0.jpg,1056,24,294,318,294,338,True,10
8,34,kaist_dataset/Mixed/Digital_Camera/(C.S)C-outdoor3/DSC03187.JPG,char_data/8/DSC03187.JPG_0.jpg,884,26,287,313,389,423,True,10
8,38,kaist_dataset/Mixed/Digital_Camera/(C.S)C-outdoor3/DSC03187.JPG,char_data/8/DSC03187.JPG_0.jpg,950,25,313,338,390,428,True,10
8,38,kaist_dataset/Mixed/Digital_Camera/(C.S)C-outdoor3/DSC03328.JPG,char_data/8/DSC03328.JPG_0.jpg,494,13,161,174,401,439,True,10
8,41,kaist_dataset/Mixed/Digital_Camera/(C.S)C-outdoor3/DSC03328.JPG,char_data/8/DSC03328.JPG_0.jpg,656,16,338,354,398,439,True,10
8,49,kaist_dataset/Mixed/Digital_Camera/(C.S)C-outdoor3/DSC03236.JPG,char_data/8/DSC03236.JPG_0.jpg,1323,27,244,271,418,467,True,10
8,47,kaist_dataset/Mixed/Digital_Camera/(C.S)C-outdoor3/DSC03236.JPG,char_data/8/DSC03236.JPG_0.jpg,1363,29,273,302,417,464,True,10
8,44,kaist_dataset/Mixed/Digital_Camera/(C.S)C-outdoor3/DSC03236.JPG,char_data/8/DSC03236.JPG_0.jpg,1276,29,419,448,422,466,True,10
8,43,kaist_dataset/Mixed/Digital_Camera/(C.S)C-outdoor3/DSC03185.JPG,char_data/8/DSC03185.JPG_0.jpg,2064,48,241,289,147,190,True,10
8,64,kaist_dataset/Mixed/Digital_Camera/(C.S)C-outdoor3/DSC03332.JPG,char_data/8/DSC03332.JPG_0.jpg,2304,36,78,114,342,406,True,10
8,67,kaist_dataset/Mixed/Digital_Camera/(C.S)C-outdoor3/DSC03332.JPG,char_data/8/DSC03332.JPG_0.jpg,2345,35,176,211,335,402,True,10
8,65,kaist_dataset/Mixed/Digital_Camera/(C.S)C-outdoor3/DSC03332.JPG,char_data/8/DSC03332.JPG_0.jpg,2470,38,245,283,333,398,True,10
8,68,kaist_dataset/Mixed/Digital_Camera/(C.S)C-outdoor3/DSC03332.JPG,char_data/8/DSC03332.JPG_0.jpg,2720,40,281,321,332,400,True,10
8,62,kaist_dataset/Mixed/Digital_Camera/(C.S)C-outdoor3/DSC03067.JPG,char_data/8/DSC03067.JPG_0.jpg,2356,38,202,240,192,254,True,10
8,60,kaist_dataset/Mixed/Digital_Camera/(C.S)C-outdoor3/DSC03067.JPG,char_data/8/DSC03067.JPG_0.jpg,2040,34,240,274,191,251,True,10
8,49,kaist_dataset/Mixed/Digital_Camera/(C.S)C-outdoor3/DSC03309.JPG,char_data/8/DSC03309.JPG_0.jpg,1176,24,241,265,255,304,True,10
8,39,kaist_dataset/Mixed/Digital_Camera/(C.S)C-outdoor3/DSC03309.JPG,char_data/8/DSC03309.JPG_0.jpg,741,19,266,285,261,300,True,10
8,36,kaist_dataset/Mixed/Digital_Camera/(C.S)C-outdoor3/DSC03309.JPG,char_data/8/DSC03309.JPG_0.jpg,756,21,306,327,260,296,True,10
8,33,kaist_dataset/Mixed/Digital_Camera/(C.S)C-outdoor3/DSC03250.JPG,char_data/8/DSC03250.JPG_0.jpg,693,21,464,485,399,432,True,10
8,35,kaist_dataset/Mixed/Digital_Camera/(C.S)C-outdoor3/DSC03259.JPG,char_data/8/DSC03259.JPG_0.jpg,490,14,366,380,361,396,True,10
8,40,kaist_dataset/Mixed/Digital_Camera/(C.S)C-outdoor3/DSC03259.JPG,char_data/8/DSC03259.JPG_0.jpg,600,15,430,445,355,395,True,10
8,40,kaist_dataset/Mixed/Digital_Camera/(C.S)C-outdoor3/DSC03259.JPG,char_data/8/DSC03259.JPG_0.jpg,840,21,463,484,355,395,True,10
8,36,kaist_dataset/Mixed/Digital_Camera/(C.S)C-outdoor3/DSC03061.JPG,char_data/8/DSC03061.JPG_0.jpg,756,21,284,305,253,289,True,10
8,46,kaist_dataset/Mixed/Digital_Camera/(C.S)C-outdoor3/DSC02989.JPG,char_data/8/DSC02989.JPG_0.jpg,1058,23,511,534,351,397,True,10
8,32,kaist_dataset/Mixed/Digital_Camera/(C.S)C-outdoor6/P1010082.JPG,char_data/8/P1010082.JPG_0.jpg,544,17,200,217,230,262,True,10
8,34,kaist_dataset/Mixed/Digital_Camera/(C.S)C-outdoor6/P1010082.JPG,char_data/8/P1010082.JPG_0.jpg,748,22,325,347,229,263,True,10
8,38,kaist_dataset/Mixed/Digital_Camera/(C.S)C-outdoor6/P1010075.JPG,char_data/8/P1010075.JPG_0.jpg,646,17,450,467,307,345,True,10
8,28,kaist_dataset/Mixed/Digital_Camera/(C.S)C-outdoor6/DSC03324.JPG,char_data/8/DSC03324.JPG_0.jpg,364,13,408,421,153,181,True,10
8,25,kaist_dataset/Mixed/Digital_Camera/(C.S)C-outdoor6/DSC03324.JPG,char_data/8/DSC03324.JPG_0.jpg,325,13,449,462,153,178,True,10
8,24,kaist_dataset/Mixed/Digital_Camera/(C.S)C-outdoor6/P1010099.JPG,char_data/8/P1010099.JPG_0.jpg,312,13,474,487,208,232,True,10
8,31,kaist_dataset/Mixed/Digital_Camera/(C.S)C-outdoor6/P1010073.JPG,char_data/8/P1010073.JPG_0.jpg,341,11,348,359,242,273,True,10
8,37,kaist_dataset/Mixed/Digital_Camera/(C.S)C-outdoor6/P1010069.JPG,char_data/8/P1010069.JPG_0.jpg,962,26,420,446,303,340,True,10
8,35,kaist_dataset/Mixed/Digital_Camera/(C.S)C-outdoor6/P1010069.JPG,char_data/8/P1010069.JPG_0.jpg,875,25,447,472,305,340,True,10
8,24,kaist_dataset/Mixed/Digital_Camera/(C.S)C-outdoor6/P1010094.JPG,char_data/8/P1010094.JPG_0.jpg,504,21,482,503,219,243,True,10
8,25,kaist_dataset/Mixed/Digital_Camera/(C.S)C-outdoor6/P1010088.JPG,char_data/8/P1010088.JPG_0.jpg,350,14,323,337,221,246,True,10
8,41,kaist_dataset/Mixed/Digital_Camera/(C.S)C-outdoor6/P1010120.JPG,char_data/8/P1010120.JPG_0.jpg,902,22,330,352,192,233,True,10
8,29,kaist_dataset/Mixed/Digital_Camera/(C.S)C-outdoor6/P1010020.JPG,char_data/8/P1010020.JPG_0.jpg,696,24,193,217,233,262,True,10
8,32,kaist_dataset/Mixed/Digital_Camera/(C.S)C-outdoor6/P1010111.JPG,char_data/8/P1010111.JPG_0.jpg,800,25,264,289,210,242,True,10
8,34,kaist_dataset/Mixed/Digital_Camera/(C.S)C-outdoor6/P1010080.JPG,char_data/8/P1010080.JPG_0.jpg,1190,35,394,429,246,280,True,10
8,29,kaist_dataset/Mixed/Digital_Camera/(C.S)C-outdoor6/P1010138.JPG,char_data/8/P1010138.JPG_0.jpg,667,23,369,392,184,213,True,10
8,39,kaist_dataset/Mixed/Digital_Camera/(C.S)C-outdoor6/P1010098.JPG,char_data/8/P1010098.JPG_0.jpg,936,24,403,427,55,94,True,10
8,35,kaist_dataset/Mixed/Digital_Camera/(C.S)C-outdoor6/P1010098.JPG,char_data/8/P1010098.JPG_0.jpg,840,24,429,453,57,92,True,10
8,40,kaist_dataset/Mixed/Digital_Camera/(C.S)C-outdoor6/P1010098.JPG,char_data/8/P1010098.JPG_0.jpg,920,23,466,489,55,95,True,10
8,45,kaist_dataset/Mixed/Digital_Camera/(C.S)C-outdoor6/P1010098.JPG,char_data/8/P1010098.JPG_0.jpg,990,22,514,536,49,94,True,10
8,42,kaist_dataset/Mixed/Digital_Camera/(C.S)C-outdoor6/P1010098.JPG,char_data/8/P1010098.JPG_0.jpg,1260,30,536,566,52,94,True,10
8,64,kaist_dataset/Mixed/Digital_Camera/(C.S)C-outdoor6/P1010017.JPG,char_data/8/P1010017.JPG_0.jpg,1664,26,282,308,178,242,True,10
8,24,kaist_dataset/Mixed/Digital_Camera/(C.S)C-outdoor6/P1010085.JPG,char_data/8/P1010085.JPG_0.jpg,384,16,332,348,158,182,True,10
8,21,kaist_dataset/Mixed/Digital_Camera/(C.S)C-outdoor6/P1010085.JPG,char_data/8/P1010085.JPG_0.jpg,357,17,397,414,158,179,True,10
8,35,kaist_dataset/Mixed/Digital_Camera/(C.S)C-outdoor6/P1010093.JPG,char_data/8/P1010093.JPG_0.jpg,560,16,512,528,242,277,True,10
8,30,kaist_dataset/Mixed/Digital_Camera/(C.S)C-outdoor6/P1010093.JPG,char_data/8/P1010093.JPG_0.jpg,420,14,531,545,245,275,True,10
8,61,kaist_dataset/Mixed/Digital_Camera/(C.S)C-outdoor6/080116-0057.jpg,char_data/8/080116-0057.jpg_0.jpg,1952,32,654,686,819,880,True,10
8,40,kaist_dataset/Mixed/Digital_Camera/(C.S)C-outdoor6/P1010021.JPG,char_data/8/P1010021.JPG_0.jpg,1120,28,110,138,210,250,True,10
8,36,kaist_dataset/Mixed/Digital_Camera/(C.S)C-outdoor6/P1010021.JPG,char_data/8/P1010021.JPG_0.jpg,1008,28,562,590,205,241,True,10
8,24,kaist_dataset/Mixed/Digital_Camera/(C.S)C-outdoor6/P1010129.JPG,char_data/8/P1010129.JPG_0.jpg,360,15,399,414,236,260,True,10
8,22,kaist_dataset/Mixed/Digital_Camera/(C.S)C-outdoor6/P1010129.JPG,char_data/8/P1010129.JPG_0.jpg,374,17,446,463,236,258,True,10
8,26,kaist_dataset/Mixed/Digital_Camera/(C.S)C-outdoor6/P1010129.JPG,char_data/8/P1010129.JPG_0.jpg,416,16,482,498,234,260,True,10
8,26,kaist_dataset/Mixed/Digital_Camera/(C.S)C-outdoor6/P1010114.JPG,char_data/8/P1010114.JPG_0.jpg,624,24,448,472,219,245,True,10
8,42,kaist_dataset/Mixed/Digital_Camera/(C.S)C-outdoor6/P1010018.JPG,char_data/8/P1010018.JPG_0.jpg,1008,24,137,161,239,281,True,10
8,34,kaist_dataset/Mixed/Digital_Camera/(C.S)C-outdoor6/P1010018.JPG,char_data/8/P1010018.JPG_0.jpg,748,22,432,454,245,279,True,10
8,54,kaist_dataset/Mixed/Digital_Camera/(C.S)C-outdoor6/P1010067.JPG,char_data/8/P1010067.JPG_0.jpg,2160,40,379,419,311,365,True,10
8,54,kaist_dataset/Mixed/Digital_Camera/(C.S)C-outdoor6/P1010067.JPG,char_data/8/P1010067.JPG_0.jpg,2106,39,420,459,310,364,True,10
8,57,kaist_dataset/Mixed/Digital_Camera/(C.S)C-outdoor6/P1010067.JPG,char_data/8/P1010067.JPG_0.jpg,2622,46,482,528,306,363,True,10
8,36,kaist_dataset/Mixed/Digital_Camera/(C.S)C-outdoor6/P1010137.JPG,char_data/8/P1010137.JPG_0.jpg,756,21,71,92,72,108,True,10
8,31,kaist_dataset/Mixed/Digital_Camera/(C.S)C-outdoor6/P1010097.JPG,char_data/8/P1010097.JPG_0.jpg,651,21,63,84,177,208,True,10
8,23,kaist_dataset/Mixed/Digital_Camera/(C.S)C-outdoor6/P1010097.JPG,char_data/8/P1010097.JPG_0.jpg,368,16,435,451,190,213,True,10
8,60,kaist_dataset/Mixed/Digital_Camera/(C.S)C-outdoor6/P1010087.JPG,char_data/8/P1010087.JPG_0.jpg,2100,35,269,304,174,234,True,10
8,66,kaist_dataset/Mixed/Digital_Camera/(C.S)C-outdoor6/P1010087.JPG,char_data/8/P1010087.JPG_0.jpg,2640,40,434,474,174,240,True,10
8,27,kaist_dataset/Mixed/Digital_Camera/(C.S)C-outdoor6/117.JPG,char_data/8/117.JPG_0.jpg,324,12,426,438,263,290,True,10
8,22,kaist_dataset/Mixed/Digital_Camera/(C.S)C-outdoor6/117.JPG,char_data/8/117.JPG_0.jpg,396,18,264,282,263,285,True,10
8,31,kaist_dataset/Mixed/Digital_Camera/(C.S)C-outdoor6/P1010074.JPG,char_data/8/P1010074.JPG_0.jpg,1023,33,201,234,311,342,True,10
8,52,kaist_dataset/Mixed/Digital_Camera/(C.S)C-outdoor4/DSC03651.JPG,char_data/8/DSC03651.JPG_0.jpg,1404,27,239,266,355,407,True,10
8,33,kaist_dataset/Mixed/Digital_Camera/(C.S)C-outdoor4/DSC03730.JPG,char_data/8/DSC03730.JPG_0.jpg,726,22,352,374,254,287,True,10
8,44,kaist_dataset/Mixed/Digital_Camera/(C.S)C-outdoor4/DSC03633.JPG,char_data/8/DSC03633.JPG_0.jpg,1320,30,151,181,266,310,True,10
8,30,kaist_dataset/Mixed/Digital_Camera/(C.S)C-outdoor4/DSC03716.JPG,char_data/8/DSC03716.JPG_0.jpg,360,12,552,564,253,283,True,10
8,31,kaist_dataset/Mixed/Digital_Camera/(C.S)C-outdoor4/DSC03716.JPG,char_data/8/DSC03716.JPG_0.jpg,558,18,588,606,254,285,True,10
8,29,kaist_dataset/Mixed/Digital_Camera/(C.S)C-outdoor4/DSC03719.JPG,char_data/8/DSC03719.JPG_0.jpg,464,16,482,498,184,213,True,10
8,42,kaist_dataset/Mixed/Digital_Camera/(C.S)C-outdoor4/DSC03738.JPG,char_data/8/DSC03738.JPG_0.jpg,1554,37,525,562,239,281,True,10
8,50,kaist_dataset/Mixed/Digital_Camera/(C.S)C-outdoor4/DSC03613.JPG,char_data/8/DSC03613.JPG_0.jpg,1050,21,473,494,25,75,True,10
8,38,kaist_dataset/Mixed/Digital_Camera/(C.S)C-outdoor4/DSC03656.JPG,char_data/8/DSC03656.JPG_0.jpg,1102,29,525,554,414,452,True,10
8,37,kaist_dataset/Mixed/Digital_Camera/(C.S)C-outdoor4/DSC03656.JPG,char_data/8/DSC03656.JPG_0.jpg,1036,28,555,583,413,450,True,10
8,31,kaist_dataset/Mixed/Digital_Camera/(C.S)C-outdoor4/DSC03570.JPG,char_data/8/DSC03570.JPG_0.jpg,589,19,269,288,424,455,True,10
8,31,kaist_dataset/Mixed/Digital_Camera/(C.S)C-outdoor4/DSC03733.JPG,char_data/8/DSC03733.JPG_0.jpg,372,12,505,517,178,209,True,10
8,69,kaist_dataset/Mixed/Digital_Camera/(C.S)C-outdoor4/DSC03702.JPG,char_data/8/DSC03702.JPG_0.jpg,3588,52,122,174,333,402,True,10
8,44,kaist_dataset/Mixed/Digital_Camera/(C.S)C-outdoor4/DSC03674.JPG,char_data/8/DSC03674.JPG_0.jpg,1364,31,492,523,358,402,True,10
8,30,kaist_dataset/Mixed/Digital_Camera/(C.S)C-outdoor4/DSC03674.JPG,char_data/8/DSC03674.JPG_0.jpg,330,11,522,533,419,449,True,10
8,28,kaist_dataset/Mixed/Digital_Camera/(C.S)C-outdoor4/DSC03674.JPG,char_data/8/DSC03674.JPG_0.jpg,420,15,589,604,422,450,True,10
8,31,kaist_dataset/Mixed/Digital_Camera/(C.S)C-outdoor4/DSC03616.JPG,char_data/8/DSC03616.JPG_0.jpg,496,16,569,585,153,184,True,10
8,35,kaist_dataset/Mixed/Digital_Camera/(C.S)C-outdoor4/DSC03677.JPG,char_data/8/DSC03677.JPG_0.jpg,420,12,547,559,311,346,True,10
8,30,kaist_dataset/Mixed/Digital_Camera/(C.S)C-outdoor4/DSC03642.JPG,char_data/8/DSC03642.JPG_0.jpg,480,16,447,463,400,430,True,10
8,53,kaist_dataset/Mixed/Digital_Camera/(C.S)C-outdoor4/DSC03693.JPG,char_data/8/DSC03693.JPG_0.jpg,1166,22,428,450,352,405,True,10
8,38,kaist_dataset/Mixed/Digital_Camera/(C.S)C-outdoor4/DSC03435.JPG,char_data/8/DSC03435.JPG_0.jpg,684,18,225,243,411,449,True,10
8,37,kaist_dataset/Mixed/Digital_Camera/(C.S)C-outdoor4/DSC03435.JPG,char_data/8/DSC03435.JPG_0.jpg,814,22,243,265,412,449,True,10
8,38,kaist_dataset/Mixed/Digital_Camera/(C.S)C-outdoor4/DSC03435.JPG,char_data/8/DSC03435.JPG_0.jpg,798,21,266,287,412,450,True,10
8,39,kaist_dataset/Mixed/Digital_Camera/(C.S)C-outdoor4/DSC03435.JPG,char_data/8/DSC03435.JPG_0.jpg,741,19,290,309,412,451,True,10
8,36,kaist_dataset/Mixed/Digital_Camera/(C.S)C-outdoor4/DSC03658.JPG,char_data/8/DSC03658.JPG_0.jpg,576,16,321,337,416,452,True,10
8,31,kaist_dataset/Mixed/Digital_Camera/(C.S)C-outdoor4/DSC03637.JPG,char_data/8/DSC03637.JPG_0.jpg,403,13,261,274,297,328,True,10
8,30,kaist_dataset/Mixed/Digital_Camera/(C.S)C-outdoor4/DSC03552.JPG,char_data/8/DSC03552.JPG_0.jpg,480,16,371,387,319,349,True,10
8,27,kaist_dataset/Mixed/Digital_Camera/(C.S)C-outdoor4/DSC03552.JPG,char_data/8/DSC03552.JPG_0.jpg,459,17,430,447,320,347,True,10
8,29,kaist_dataset/Mixed/Digital_Camera/(C.S)C-outdoor4/DSC03552.JPG,char_data/8/DSC03552.JPG_0.jpg,493,17,461,478,318,347,True,10
8,29,kaist_dataset/Mixed/Digital_Camera/(C.S)C-outdoor4/DSC03769.JPG,char_data/8/DSC03769.JPG_0.jpg,377,13,180,193,417,446,True,10
8,22,kaist_dataset/Mixed/Digital_Camera/(C.S)C-outdoor4/DSC03769.JPG,char_data/8/DSC03769.JPG_0.jpg,286,13,243,256,421,443,True,10
8,34,kaist_dataset/Mixed/Digital_Camera/(C.S)C-outdoor4/DSC03769.JPG,char_data/8/DSC03769.JPG_0.jpg,612,18,256,274,413,447,True,10
8,88,kaist_dataset/Mixed/Digital_Camera/(C.S)C-outdoor4/DSC03544.JPG,char_data/8/DSC03544.JPG_0.jpg,3872,44,254,298,167,255,True,10
8,35,kaist_dataset/Mixed/Digital_Camera/(C.S)C-outdoor4/DSC03660.JPG,char_data/8/DSC03660.JPG_0.jpg,910,26,309,335,94,129,True,10
8,39,kaist_dataset/Mixed/Digital_Camera/(C.S)C-outdoor4/DSC03660.JPG,char_data/8/DSC03660.JPG_0.jpg,1053,27,404,431,95,134,True,10
8,33,kaist_dataset/Mixed/Digital_Camera/(C.S)C-outdoor4/DSC03640.JPG,char_data/8/DSC03640.JPG_0.jpg,693,21,170,191,396,429,True,10
8,46,kaist_dataset/Mixed/Digital_Camera/(C.S)C-outdoor4/DSC03548.JPG,char_data/8/DSC03548.JPG_0.jpg,2162,47,145,192,394,440,True,10
8,42,kaist_dataset/Mixed/Digital_Camera/(C.S)C-outdoor4/DSC03675.JPG,char_data/8/DSC03675.JPG_0.jpg,882,21,450,471,341,383,True,10
8,43,kaist_dataset/Mixed/Digital_Camera/(C.S)C-outdoor4/DSC03675.JPG,char_data/8/DSC03675.JPG_0.jpg,817,19,478,497,340,383,True,10
8,33,kaist_dataset/Mixed/Digital_Camera/(C.S)C-outdoor4/DSC03691.JPG,char_data/8/DSC03691.JPG_0.jpg,528,16,395,411,222,255,True,10
8,35,kaist_dataset/Mixed/Digital_Camera/(C.S)C-outdoor4/DSC03691.JPG,char_data/8/DSC03691.JPG_0.jpg,490,14,411,425,221,256,False,10
8,31,kaist_dataset/Mixed/Digital_Camera/(C.S)C-outdoor4/DSC03691.JPG,char_data/8/DSC03691.JPG_0.jpg,403,13,549,562,223,254,False,10
8,46,kaist_dataset/Mixed/Digital_Camera/(C.S)C-outdoor4/DSC03617.JPG,char_data/8/DSC03617.JPG_0.jpg,1242,27,244,271,377,423,False,10
8,41,kaist_dataset/Mixed/Digital_Camera/(C.S)C-outdoor4/DSC03617.JPG,char_data/8/DSC03617.JPG_0.jpg,1558,38,404,442,383,424,False,10
8,38,kaist_dataset/Mixed/Digital_Camera/(C.S)C-outdoor4/DSC03617.JPG,char_data/8/DSC03617.JPG_0.jpg,1596,42,442,484,383,421,False,10
8,24,kaist_dataset/Mixed/Digital_Camera/(C.S)C-outdoor4/DSC03657.JPG,char_data/8/DSC03657.JPG_0.jpg,432,18,292,310,423,447,False,10
8,31,kaist_dataset/Mixed/Digital_Camera/(C.S)C-outdoor4/DSC03657.JPG,char_data/8/DSC03657.JPG_0.jpg,558,18,335,353,423,454,False,10
8,31,kaist_dataset/Mixed/Digital_Camera/(C.S)C-outdoor4/DSC03618.JPG,char_data/8/DSC03618.JPG_0.jpg,775,25,262,287,407,438,False,10
8,30,kaist_dataset/Mixed/Digital_Camera/(C.S)C-outdoor4/DSC03618.JPG,char_data/8/DSC03618.JPG_0.jpg,690,23,381,404,412,442,False,10
8,92,kaist_dataset/Mixed/Digital_Camera/(C.S)C-outdoor4/DSC03654.JPG,char_data/8/DSC03654.JPG_0.jpg,3312,36,501,537,151,243,False,10
8,86,kaist_dataset/Mixed/Digital_Camera/(C.S)C-outdoor4/DSC03654.JPG,char_data/8/DSC03654.JPG_0.jpg,2408,28,536,564,151,237,False,10
8,27,kaist_dataset/Mixed/Digital_Camera/(C.S)C-outdoor4/DSC03764.JPG,char_data/8/DSC03764.JPG_0.jpg,540,20,242,262,271,298,False,10
8,29,kaist_dataset/Mixed/Digital_Camera/(C.S)C-outdoor4/DSC03718.JPG,char_data/8/DSC03718.JPG_0.jpg,551,19,477,496,402,431,False,10
8,31,kaist_dataset/Mixed/Digital_Camera/(C.S)C-outdoor4/DSC03745.JPG,char_data/8/DSC03745.JPG_0.jpg,651,21,137,158,271,302,False,10
8,35,kaist_dataset/Mixed/Digital_Camera/(C.S)C-outdoor4/DSC03745.JPG,char_data/8/DSC03745.JPG_0.jpg,875,25,276,301,271,306,False,10
8,33,kaist_dataset/Mixed/Digital_Camera/(C.S)C-outdoor4/DSC03745.JPG,char_data/8/DSC03745.JPG_0.jpg,462,14,494,508,272,305,False,10
8,31,kaist_dataset/Mixed/Digital_Camera/(C.S)C-outdoor4/DSC03745.JPG,char_data/8/DSC03745.JPG_0.jpg,620,20,508,528,274,305,False,10
8,30,kaist_dataset/Mixed/Digital_Camera/(C.S)C-outdoor4/DSC03737.JPG,char_data/8/DSC03737.JPG_0.jpg,510,17,172,189,161,191,False,10
8,31,kaist_dataset/Mixed/Digital_Camera/(C.S)C-outdoor4/DSC03737.JPG,char_data/8/DSC03737.JPG_0.jpg,589,19,189,208,159,190,False,10
8,28,kaist_dataset/Mixed/Digital_Camera/(C.S)C-outdoor4/DSC03737.JPG,char_data/8/DSC03737.JPG_0.jpg,560,20,269,289,164,192,False,10
8,25,kaist_dataset/Mixed/Digital_Camera/(C.S)C-outdoor4/DSC03737.JPG,char_data/8/DSC03737.JPG_0.jpg,500,20,342,362,167,192,False,10
8,33,kaist_dataset/Mixed/Digital_Camera/(C.S)C-outdoor4/DSC03737.JPG,char_data/8/DSC03737.JPG_0.jpg,660,20,362,382,166,199,False,10
8,29,kaist_dataset/Mixed/Digital_Camera/(C.S)C-outdoor4/DSC03737.JPG,char_data/8/DSC03737.JPG_0.jpg,493,17,441,458,169,198,False,10
8,55,kaist_dataset/Mixed/Digital_Camera/(C.S)C-outdoor4/DSC03655.JPG,char_data/8/DSC03655.JPG_0.jpg,1265,23,245,268,384,439,False,10
8,35,kaist_dataset/Mixed/Digital_Camera/(C.S)C-outdoor4/DSC03655.JPG,char_data/8/DSC03655.JPG_0.jpg,735,21,471,492,403,438,False,10
8,48,kaist_dataset/Mixed/Digital_Camera/(C.S)C-outdoor4/DSC03569.JPG,char_data/8/DSC03569.JPG_0.jpg,1440,30,397,427,167,215,False,10
8,42,kaist_dataset/Mixed/Digital_Camera/(C.S)C-outdoor4/DSC03569.JPG,char_data/8/DSC03569.JPG_0.jpg,1428,34,581,615,167,209,False,10
8,44,kaist_dataset/Mixed/Digital_Camera/(C.S)C-outdoor4/DSC03549.JPG,char_data/8/DSC03549.JPG_0.jpg,748,17,560,577,176,220,False,10
8,31,kaist_dataset/Mixed/Digital_Camera/(C.S)C-outdoor4/DSC03549.JPG,char_data/8/DSC03549.JPG_0.jpg,434,14,305,319,423,454,False,10
8,31,kaist_dataset/Mixed/Digital_Camera/(C.S)C-outdoor4/DSC03446.JPG,char_data/8/DSC03446.JPG_0.jpg,558,18,249,267,290,321,False,10
8,33,kaist_dataset/Mixed/Digital_Camera/(C.S)C-outdoor4/DSC03446.JPG,char_data/8/DSC03446.JPG_0.jpg,693,21,349,370,290,323,False,10
8,32,kaist_dataset/Mixed/Digital_Camera/(C.S)C-outdoor4/DSC03734.JPG,char_data/8/DSC03734.JPG_0.jpg,384,12,514,526,348,380,False,10
8,42,kaist_dataset/Mixed/Digital_Camera/(C.S)C-outdoor4/DSC03732.JPG,char_data/8/DSC03732.JPG_0.jpg,1050,25,348,373,392,434,False,10
8,20,kaist_dataset/Mixed/Digital_Camera/(C.S)C-outdoor4/DSC03643.JPG,char_data/8/DSC03643.JPG_0.jpg,340,17,487,504,329,349,False,10
8,30,kaist_dataset/Mixed/Digital_Camera/(C.S)C-outdoor4/DSC03723.JPG,char_data/8/DSC03723.JPG_0.jpg,690,23,416,439,198,228,False,10
8,28,kaist_dataset/Mixed/Digital_Camera/(C.S)C-outdoor4/DSC03723.JPG,char_data/8/DSC03723.JPG_0.jpg,644,23,539,562,198,226,False,10
8,89,kaist_dataset/Mixed/Digital_Camera/(C.S)C-outdoor4/DSC03787.JPG,char_data/8/DSC03787.JPG_0.jpg,2581,29,508,537,135,224,False,10
8,79,kaist_dataset/Mixed/Digital_Camera/(C.S)C-outdoor4/DSC03787.JPG,char_data/8/DSC03787.JPG_0.jpg,2054,26,539,565,145,224,False,10
8,33,kaist_dataset/Mixed/Digital_Camera/(C.S)C-outdoor4/DSC03676.JPG,char_data/8/DSC03676.JPG_0.jpg,495,15,96,111,270,303,False,10
8,32,kaist_dataset/Mixed/Digital_Camera/(C.S)C-outdoor4/DSC03676.JPG,char_data/8/DSC03676.JPG_0.jpg,512,16,111,127,270,302,False,10
8,36,kaist_dataset/Mixed/Digital_Camera/(C.S)C-outdoor4/DSC03676.JPG,char_data/8/DSC03676.JPG_0.jpg,504,14,168,182,271,307,False,10
8,28,kaist_dataset/Mixed/Digital_Camera/(C.S)C-outdoor4/DSC03676.JPG,char_data/8/DSC03676.JPG_0.jpg,420,15,183,198,275,303,False,10
8,27,kaist_dataset/Mixed/Digital_Camera/(C.S)C-outdoor4/DSC03689.JPG,char_data/8/DSC03689.JPG_0.jpg,270,10,540,550,132,159,False,10
8,28,kaist_dataset/Mixed/Digital_Camera/(C.S)C-outdoor4/DSC03689.JPG,char_data/8/DSC03689.JPG_0.jpg,280,10,571,581,135,163,False,10
8,37,kaist_dataset/Mixed/Digital_Camera/(C.S)C-outdoor4/DSC03665.JPG,char_data/8/DSC03665.JPG_0.jpg,1369,37,283,320,156,193,False,10
8,44,kaist_dataset/Mixed/Digital_Camera/(C.S)C-outdoor4/DSC03679.JPG,char_data/8/DSC03679.JPG_0.jpg,1144,26,236,262,273,317,False,10
8,41,kaist_dataset/Mixed/Digital_Camera/(C.S)C-outdoor4/DSC03679.JPG,char_data/8/DSC03679.JPG_0.jpg,902,22,338,360,281,322,False,10
8,37,kaist_dataset/Mixed/Digital_Camera/(C.S)C-outdoor4/DSC03634.JPG,char_data/8/DSC03634.JPG_0.jpg,814,22,528,550,424,461,False,10
8,41,kaist_dataset/Mixed/Digital_Camera/(C.S)C-outdoor4/DSC03662.JPG,char_data/8/DSC03662.JPG_0.jpg,779,19,459,478,422,463,False,10
8,28,kaist_dataset/Mixed/Digital_Camera/(C.S)C-outdoor4/DSC03757.JPG,char_data/8/DSC03757.JPG_0.jpg,308,11,329,340,340,368,False,10
8,37,kaist_dataset/Mixed/Digital_Camera/(C.S)C-outdoor4/DSC03757.JPG,char_data/8/DSC03757.JPG_0.jpg,555,15,499,514,338,375,False,10
8,49,kaist_dataset/Mixed/Digital_Camera/(C.S)C-outdoor4/DSC03621.JPG,char_data/8/DSC03621.JPG_0.jpg,1176,24,385,409,335,384,False,10
8,30,kaist_dataset/Mixed/Digital_Camera/(C.S)C-outdoor4/DSC03687.JPG,char_data/8/DSC03687.JPG_0.jpg,390,13,432,445,398,428,False,10
8,30,kaist_dataset/Mixed/Digital_Camera/(C.S)C-outdoor4/DSC03735.JPG,char_data/8/DSC03735.JPG_0.jpg,510,17,470,487,148,178,False,10
8,30,kaist_dataset/Mixed/Digital_Camera/(C.S)C-outdoor4/DSC03670.JPG,char_data/8/DSC03670.JPG_0.jpg,360,12,441,453,445,475,False,10
8,30,kaist_dataset/Mixed/Digital_Camera/(C.S)C-outdoor4/DSC03722.JPG,char_data/8/DSC03722.JPG_0.jpg,690,23,248,271,205,235,False,10
8,28,kaist_dataset/Mixed/Digital_Camera/(C.S)C-outdoor4/DSC03758.JPG,char_data/8/DSC03758.JPG_0.jpg,420,15,280,295,305,333,False,10
8,37,kaist_dataset/Mixed/Digital_Camera/(C.S)C-outdoor2/DSC02912.JPG,char_data/8/DSC02912.JPG_0.jpg,1258,34,201,235,439,476,False,10
8,36,kaist_dataset/Mixed/Digital_Camera/(C.S)C-outdoor2/DSC02912.JPG,char_data/8/DSC02912.JPG_0.jpg,1296,36,305,341,441,477,False,10
8,31,kaist_dataset/Mixed/Digital_Camera/(C.S)C-outdoor2/DSC02624.JPG,char_data/8/DSC02624.JPG_0.jpg,527,17,426,443,398,429,False,10
8,37,kaist_dataset/Mixed/Digital_Camera/(C.S)C-outdoor2/DSC02419.JPG,char_data/8/DSC02419.JPG_0.jpg,851,23,455,478,212,249,False,10
8,29,kaist_dataset/Mixed/Digital_Camera/(C.S)C-outdoor2/DSC02917.JPG,char_data/8/DSC02917.JPG_0.jpg,522,18,577,595,227,256,False,10
8,29,kaist_dataset/Mixed/Digital_Camera/(C.S)C-outdoor2/DSC02917.JPG,char_data/8/DSC02917.JPG_0.jpg,609,21,595,616,228,257,False,10
8,98,kaist_dataset/Mixed/Digital_Camera/(C.S)C-outdoor2/DSC02865.JPG,char_data/8/DSC02865.JPG_0.jpg,5292,54,166,220,304,402,False,10
8,98,kaist_dataset/Mixed/Digital_Camera/(C.S)C-outdoor2/DSC02865.JPG,char_data/8/DSC02865.JPG_0.jpg,5978,61,218,279,307,405,False,10
8,34,kaist_dataset/Mixed/Digital_Camera/(C.S)C-outdoor2/DSC02492.JPG,char_data/8/DSC02492.JPG_0.jpg,714,21,353,374,325,359,False,10
8,29,kaist_dataset/Mixed/Digital_Camera/(C.S)C-outdoor2/DSC02447.JPG,char_data/8/DSC02447.JPG_0.jpg,435,15,473,488,227,256,False,10
8,32,kaist_dataset/Mixed/Digital_Camera/(C.S)C-outdoor2/DSC02447.JPG,char_data/8/DSC02447.JPG_0.jpg,416,13,529,542,224,256,False,10
8,38,kaist_dataset/Mixed/Digital_Camera/(C.S)C-outdoor2/DSC02954.JPG,char_data/8/DSC02954.JPG_0.jpg,950,25,118,143,254,292,False,10
8,38,kaist_dataset/Mixed/Digital_Camera/(C.S)C-outdoor2/DSC02954.JPG,char_data/8/DSC02954.JPG_0.jpg,760,20,219,239,258,296,False,10
8,39,kaist_dataset/Mixed/Digital_Camera/(C.S)C-outdoor2/DSC02954.JPG,char_data/8/DSC02954.JPG_0.jpg,858,22,467,489,265,304,False,10
8,36,kaist_dataset/Mixed/Digital_Camera/(C.S)C-outdoor2/DSC02954.JPG,char_data/8/DSC02954.JPG_0.jpg,720,20,558,578,267,303,False,10
8,25,kaist_dataset/Mixed/Digital_Camera/(C.S)C-outdoor2/DSC02555.JPG,char_data/8/DSC02555.JPG_0.jpg,675,27,62,89,252,277,False,10
8,27,kaist_dataset/Mixed/Digital_Camera/(C.S)C-outdoor2/DSC02555.JPG,char_data/8/DSC02555.JPG_0.jpg,756,28,317,345,251,278,False,10
8,24,kaist_dataset/Mixed/Digital_Camera/(C.S)C-outdoor2/DSC02555.JPG,char_data/8/DSC02555.JPG_0.jpg,576,24,442,466,251,275,False,10
8,30,kaist_dataset/Mixed/Digital_Camera/(C.S)C-outdoor2/DSC02397.JPG,char_data/8/DSC02397.JPG_0.jpg,690,23,419,442,209,239,False,10
8,33,kaist_dataset/Mixed/Digital_Camera/(C.S)C-outdoor2/DSC02397.JPG,char_data/8/DSC02397.JPG_0.jpg,726,22,555,577,204,237,False,10
8,25,kaist_dataset/Mixed/Digital_Camera/(C.S)C-outdoor2/DSC02477.JPG,char_data/8/DSC02477.JPG_0.jpg,450,18,59,77,256,281,False,10
8,27,kaist_dataset/Mixed/Digital_Camera/(C.S)C-outdoor2/DSC02477.JPG,char_data/8/DSC02477.JPG_0.jpg,594,22,281,303,248,275,False,10
8,26,kaist_dataset/Mixed/Digital_Camera/(C.S)C-outdoor2/DSC02477.JPG,char_data/8/DSC02477.JPG_0.jpg,702,27,398,425,244,270,False,10
8,36,kaist_dataset/Mixed/Digital_Camera/(C.S)C-outdoor2/DSC02361.JPG,char_data/8/DSC02361.JPG_0.jpg,612,17,498,515,376,412,False,10
8,49,kaist_dataset/Mixed/Digital_Camera/(C.S)C-outdoor2/DSC02400.JPG,char_data/8/DSC02400.JPG_0.jpg,1568,32,179,211,397,446,False,10
8,68,kaist_dataset/Mixed/Digital_Camera/(C.S)C-outdoor2/DSC02502.JPG,char_data/8/DSC02502.JPG_0.jpg,3128,46,82,128,350,418,False,10
8,42,kaist_dataset/Mixed/Digital_Camera/(C.S)C-outdoor2/DSC02411.JPG,char_data/8/DSC02411.JPG_0.jpg,1134,27,373,400,349,391,False,10
8,44,kaist_dataset/Mixed/Digital_Camera/(C.S)C-outdoor2/DSC02413.JPG,char_data/8/DSC02413.JPG_0.jpg,1496,34,318,352,208,252,False,10
8,38,kaist_dataset/Mixed/Digital_Camera/(C.S)C-outdoor2/DSC02413.JPG,char_data/8/DSC02413.JPG_0.jpg,988,26,469,495,208,246,False,10
8,42,kaist_dataset/Mixed/Digital_Camera/(C.S)C-outdoor2/DSC02374.JPG,char_data/8/DSC02374.JPG_0.jpg,798,19,244,263,301,343,False,10
8,41,kaist_dataset/Mixed/Digital_Camera/(C.S)C-outdoor2/DSC02374.JPG,char_data/8/DSC02374.JPG_0.jpg,984,24,391,415,294,335,False,10
8,82,kaist_dataset/Mixed/Digital_Camera/(C.S)C-outdoor2/DSC02513.JPG,char_data/8/DSC02513.JPG_0.jpg,4838,59,133,192,140,222,False,10
8,31,kaist_dataset/Mixed/Digital_Camera/(C.S)C-outdoor2/DSC02479.JPG,char_data/8/DSC02479.JPG_0.jpg,620,20,444,464,222,253,False,10
8,33,kaist_dataset/Mixed/Digital_Camera/(C.S)C-outdoor2/DSC02887.JPG,char_data/8/DSC02887.JPG_0.jpg,660,20,262,282,121,154,False,10
8,37,kaist_dataset/Mixed/Digital_Camera/(C.S)C-outdoor2/DSC02887.JPG,char_data/8/DSC02887.JPG_0.jpg,925,25,375,400,115,152,False,10
8,32,kaist_dataset/Mixed/Digital_Camera/(C.S)C-outdoor2/DSC02368.JPG,char_data/8/DSC02368.JPG_0.jpg,448,14,127,141,385,417,False,10
8,29,kaist_dataset/Mixed/Digital_Camera/(C.S)C-outdoor2/DSC02947.JPG,char_data/8/DSC02947.JPG_0.jpg,609,21,481,502,235,264,False,10
8,24,kaist_dataset/Mixed/Digital_Camera/(C.S)C-outdoor2/DSC02947.JPG,char_data/8/DSC02947.JPG_0.jpg,360,15,502,517,240,264,False,10
8,31,kaist_dataset/Mixed/Digital_Camera/(C.S)C-outdoor2/DSC02947.JPG,char_data/8/DSC02947.JPG_0.jpg,682,22,516,538,237,268,False,10
8,37,kaist_dataset/Mixed/Digital_Camera/(C.S)C-outdoor2/DSC02545.JPG,char_data/8/DSC02545.JPG_0.jpg,1147,31,216,247,402,439,False,10
8,48,kaist_dataset/Mixed/Digital_Camera/(C.S)C-outdoor2/P1010013.JPG,char_data/8/P1010013.JPG_0.jpg,1392,29,251,280,365,413,False,10
8,36,kaist_dataset/Mixed/Digital_Camera/(C.S)C-outdoor2/DSC02894.JPG,char_data/8/DSC02894.JPG_0.jpg,1008,28,385,413,245,281,False,10
8,39,kaist_dataset/Mixed/Digital_Camera/(C.S)C-outdoor2/DSC02894.JPG,char_data/8/DSC02894.JPG_0.jpg,1092,28,283,311,256,295,False,10
8,69,kaist_dataset/Mixed/Digital_Camera/(C.S)C-outdoor2/DSC02503.JPG,char_data/8/DSC02503.JPG_0.jpg,3381,49,315,364,348,417,False,10
8,60,kaist_dataset/Mixed/Digital_Camera/(C.S)C-outdoor2/DSC02503.JPG,char_data/8/DSC02503.JPG_0.jpg,2880,48,416,464,349,409,False,10
8,34,kaist_dataset/Mixed/Digital_Camera/(C.S)C-outdoor2/DSC02895.JPG,char_data/8/DSC02895.JPG_0.jpg,646,19,219,238,360,394,False,10
8,40,kaist_dataset/Mixed/Digital_Camera/(C.S)C-outdoor2/DSC02490.JPG,char_data/8/DSC02490.JPG_0.jpg,840,21,274,295,342,382,False,10
8,39,kaist_dataset/Mixed/Digital_Camera/(C.S)C-outdoor2/DSC02482.JPG,char_data/8/DSC02482.JPG_0.jpg,1053,27,345,372,324,363,False,10
8,43,kaist_dataset/Mixed/Digital_Camera/(C.S)C-outdoor2/DSC02482.JPG,char_data/8/DSC02482.JPG_0.jpg,1462,34,483,517,321,364,False,10
8,44,kaist_dataset/Mixed/Digital_Camera/(C.S)C-outdoor2/DSC02937.JPG,char_data/8/DSC02937.JPG_0.jpg,1012,23,126,149,202,246,False,10
8,33,kaist_dataset/Mixed/Digital_Camera/(C.S)C-outdoor2/DSC02930.JPG,char_data/8/DSC02930.JPG_0.jpg,594,18,392,410,192,225,False,10
8,35,kaist_dataset/Mixed/Digital_Camera/(C.S)C-outdoor2/DSC02930.JPG,char_data/8/DSC02930.JPG_0.jpg,805,23,409,432,191,226,False,10
8,56,kaist_dataset/Mixed/Digital_Camera/(C.S)C-outdoor2/DSC02359.JPG,char_data/8/DSC02359.JPG_0.jpg,1288,23,235,258,411,467,False,10
8,53,kaist_dataset/Mixed/Digital_Camera/(C.S)C-outdoor2/DSC02359.JPG,char_data/8/DSC02359.JPG_0.jpg,1590,30,331,361,414,467,False,10
8,51,kaist_dataset/Mixed/Digital_Camera/(C.S)C-outdoor2/DSC02359.JPG,char_data/8/DSC02359.JPG_0.jpg,1071,21,363,384,414,465,False,10
8,38,kaist_dataset/Mixed/Digital_Camera/(C.S)C-outdoor2/DSC02376.JPG,char_data/8/DSC02376.JPG_0.jpg,950,25,420,445,338,376,False,10
8,40,kaist_dataset/Mixed/Digital_Camera/(C.S)C-outdoor2/DSC02376.JPG,char_data/8/DSC02376.JPG_0.jpg,1000,25,530,555,336,376,False,10
8,34,kaist_dataset/Mixed/Digital_Camera/(C.S)C-outdoor2/DSC02489.JPG,char_data/8/DSC02489.JPG_0.jpg,612,18,262,280,262,296,False,10
8,41,kaist_dataset/Mixed/Digital_Camera/(C.S)C-outdoor2/DSC02489.JPG,char_data/8/DSC02489.JPG_0.jpg,984,24,396,420,258,299,False,10
8,31,kaist_dataset/Mixed/Digital_Camera/(C.S)C-outdoor2/DSC02422.JPG,char_data/8/DSC02422.JPG_0.jpg,589,19,344,363,223,254,False,10
8,37,kaist_dataset/Mixed/Digital_Camera/(C.S)C-outdoor2/DSC02933.JPG,char_data/8/DSC02933.JPG_0.jpg,666,18,495,513,242,279,False,10
8,34,kaist_dataset/Mixed/Digital_Camera/(C.S)C-outdoor2/DSC02933.JPG,char_data/8/DSC02933.JPG_0.jpg,612,18,585,603,245,279,False,10
8,34,kaist_dataset/Mixed/Digital_Camera/(C.S)C-outdoor2/DSC02511.JPG,char_data/8/DSC02511.JPG_0.jpg,748,22,289,311,209,243,False,10
8,40,kaist_dataset/Mixed/Digital_Camera/(C.S)C-outdoor2/DSC02511.JPG,char_data/8/DSC02511.JPG_0.jpg,1000,25,240,265,393,433,False,10
8,35,kaist_dataset/Mixed/Digital_Camera/(C.S)C-outdoor2/DSC02466.JPG,char_data/8/DSC02466.JPG_0.jpg,1260,36,156,192,258,293,False,10
8,36,kaist_dataset/Mixed/Digital_Camera/(C.S)C-outdoor2/DSC02466.JPG,char_data/8/DSC02466.JPG_0.jpg,1116,31,283,314,255,291,False,10
8,33,kaist_dataset/Mixed/Digital_Camera/(C.S)C-outdoor2/DSC02556.JPG,char_data/8/DSC02556.JPG_0.jpg,924,28,279,307,341,374,False,10
8,34,kaist_dataset/Mixed/Digital_Camera/(C.S)C-outdoor2/DSC02556.JPG,char_data/8/DSC02556.JPG_0.jpg,918,27,429,456,343,377,False,10
8,35,kaist_dataset/Mixed/Digital_Camera/(C.S)C-outdoor2/DSC02553.JPG,char_data/8/DSC02553.JPG_0.jpg,770,22,303,325,298,333,False,10
8,27,kaist_dataset/Mixed/Digital_Camera/(C.S)C-outdoor2/DSC02877.JPG,char_data/8/DSC02877.JPG_0.jpg,351,13,517,530,218,245,False,10
8,32,kaist_dataset/Mixed/Digital_Camera/(C.S)C-outdoor2/DSC02460.JPG,char_data/8/DSC02460.JPG_0.jpg,704,22,301,323,305,337,False,10
8,37,kaist_dataset/Mixed/Digital_Camera/(C.S)C-outdoor2/DSC02557.JPG,char_data/8/DSC02557.JPG_0.jpg,999,27,363,390,212,249,False,10
8,48,kaist_dataset/Mixed/Digital_Camera/(C.S)C-outdoor2/DSC02567.JPG,char_data/8/DSC02567.JPG_0.jpg,2064,43,178,221,143,191,False,10
8,25,kaist_dataset/Mixed/Digital_Camera/(C.S)C-outdoor2/DSC02879.JPG,char_data/8/DSC02879.JPG_0.jpg,300,12,285,297,280,305,False,10
8,36,kaist_dataset/Mixed/Digital_Camera/(C.S)C-outdoor2/DSC02543.JPG,char_data/8/DSC02543.JPG_0.jpg,828,23,312,335,350,386,False,10
8,49,kaist_dataset/Mixed/Digital_Camera/(C.S)C-outdoor2/DSC02461.JPG,char_data/8/DSC02461.JPG_0.jpg,3185,65,102,167,286,335,False,10
8,31,kaist_dataset/Mixed/Digital_Camera/(C.S)C-outdoor2/DSC02379.JPG,char_data/8/DSC02379.JPG_0.jpg,651,21,388,409,289,320,False,10
8,32,kaist_dataset/Mixed/Digital_Camera/(C.S)C-outdoor2/DSC02560.JPG,char_data/8/DSC02560.JPG_0.jpg,832,26,502,528,304,336,False,10
8,44,kaist_dataset/Mixed/Digital_Camera/(C.S)C-outdoor2/DSC02389.JPG,char_data/8/DSC02389.JPG_0.jpg,1320,30,219,249,46,90,False,10
8,36,kaist_dataset/Mixed/Digital_Camera/(C.S)C-outdoor2/DSC02389.JPG,char_data/8/DSC02389.JPG_0.jpg,1764,49,125,174,259,295,False,10
8,41,kaist_dataset/Mixed/Digital_Camera/(C.S)C-outdoor2/DSC02391.JPG,char_data/8/DSC02391.JPG_0.jpg,902,22,191,213,332,373,False,10
8,36,kaist_dataset/Mixed/Digital_Camera/(C.S)C-outdoor2/DSC02377.JPG,char_data/8/DSC02377.JPG_0.jpg,828,23,423,446,354,390,False,10
8,38,kaist_dataset/Mixed/Digital_Camera/(C.S)C-outdoor2/DSC02377.JPG,char_data/8/DSC02377.JPG_0.jpg,988,26,531,557,352,390,False,10
8,21,kaist_dataset/Mixed/Digital_Camera/(C.S)C-outdoor2/P1010015.JPG,char_data/8/P1010015.JPG_0.jpg,252,12,356,368,189,210,False,10
8,31,kaist_dataset/Mixed/Digital_Camera/(C.S)A-shadow/DSC02624.JPG,char_data/8/DSC02624.JPG_0.jpg,527,17,426,443,398,429,False,10
8,34,kaist_dataset/Mixed/Digital_Camera/(C.S)A-shadow/DSC03257.JPG,char_data/8/DSC03257.JPG_0.jpg,680,20,277,297,384,418,False,10
8,39,kaist_dataset/Mixed/Digital_Camera/(C.S)A-shadow/DSC03257.JPG,char_data/8/DSC03257.JPG_0.jpg,897,23,337,360,383,422,False,10
8,39,kaist_dataset/Mixed/Digital_Camera/(C.S)A-shadow/DSC03257.JPG,char_data/8/DSC03257.JPG_0.jpg,858,22,384,406,380,419,False,10
8,31,kaist_dataset/Mixed/Digital_Camera/(C.S)A-shadow/DSC04306.JPG,char_data/8/DSC04306.JPG_0.jpg,558,18,236,254,412,443,False,10
8,59,kaist_dataset/Mixed/Digital_Camera/(C.S)A-shadow/DSC04304.JPG,char_data/8/DSC04304.JPG_0.jpg,2360,40,332,372,282,341,False,10
8,60,kaist_dataset/Mixed/Digital_Camera/(C.S)A-shadow/DSC04304.JPG,char_data/8/DSC04304.JPG_0.jpg,1980,33,542,575,278,338,False,10
8,58,kaist_dataset/Mixed/Digital_Camera/(C.S)A-shadow/DSC04326.JPG,char_data/8/DSC04326.JPG_0.jpg,1914,33,319,352,20,78,False,10
8,67,kaist_dataset/Mixed/Digital_Camera/(C.S)A-shadow/DSC04326.JPG,char_data/8/DSC04326.JPG_0.jpg,2010,30,507,537,15,82,False,10
8,48,kaist_dataset/Mixed/Digital_Camera/(C.S)A-shadow/DSC02567.JPG,char_data/8/DSC02567.JPG_0.jpg,2064,43,178,221,143,191,False,10
8,38,kaist_dataset/Mixed/Digital_Camera/(C.S)A-shadow/DSC02579.JPG,char_data/8/DSC02579.JPG_0.jpg,988,26,211,237,399,437,False,10
8,42,kaist_dataset/Mixed/Digital_Camera/(C.S)A-shadow/DSC02581.JPG,char_data/8/DSC02581.JPG_0.jpg,798,19,231,250,385,427,False,10
8,36,kaist_dataset/Mixed/Digital_Camera/(C.S)A-shadow/DSC02581.JPG,char_data/8/DSC02581.JPG_0.jpg,720,20,372,392,385,421,False,10
8,59,kaist_dataset/English/Digital_Camera/(E.S)E-night/DSC02610.JPG,char_data/8/DSC02610.JPG_0.jpg,2006,34,50,84,388,447,False,10
8,52,kaist_dataset/English/Digital_Camera/(E.S)E-night/DSC02610.JPG,char_data/8/DSC02610.JPG_0.jpg,2132,41,265,306,378,430,False,10
8,44,kaist_dataset/English/Digital_Camera/(E.S)C-outdoor2/DSC03053.JPG,char_data/8/DSC03053.JPG_0.jpg,1188,27,335,362,128,172,False,10
8,42,kaist_dataset/English/Digital_Camera/(E.S)C-outdoor2/DSC03053.JPG,char_data/8/DSC03053.JPG_0.jpg,1176,28,513,541,128,170,False,10
8,33,kaist_dataset/English/Digital_Camera/(E.S)C-outdoor2/DSC03436.JPG,char_data/8/DSC03436.JPG_0.jpg,825,25,221,246,126,159,False,10
8,54,kaist_dataset/English/Digital_Camera/(E.S)C-outdoor2/DSC03161.JPG,char_data/8/DSC03161.JPG_0.jpg,1674,31,138,169,221,275,False,10
8,50,kaist_dataset/English/Digital_Camera/(E.S)C-outdoor2/DSC03161.JPG,char_data/8/DSC03161.JPG_0.jpg,1650,33,200,233,223,273,False,10
8,58,kaist_dataset/English/Digital_Camera/(E.S)C-outdoor2/DSC03201.JPG,char_data/8/DSC03201.JPG_0.jpg,2146,37,364,401,11,69,False,10
8,65,kaist_dataset/English/Digital_Camera/(E.S)C-outdoor2/DSC04163.JPG,char_data/8/DSC04163.JPG_0.jpg,2535,39,194,233,316,381,False,10
8,32,kaist_dataset/English/Digital_Camera/(E.S)C-outdoor2/DSC03162.JPG,char_data/8/DSC03162.JPG_0.jpg,448,14,425,439,149,181,False,10
8,32,kaist_dataset/English/Digital_Camera/(E.S)C-outdoor1/077.JPG,char_data/8/077.JPG_0.jpg,544,17,276,293,248,280,False,10
8,42,kaist_dataset/English/Digital_Camera/(E.S)C-outdoor1/DSC02450.JPG,char_data/8/DSC02450.JPG_0.jpg,1386,33,109,142,222,264,False,10
8,43,kaist_dataset/English/Digital_Camera/(E.S)C-outdoor1/DSC02450.JPG,char_data/8/DSC02450.JPG_0.jpg,1462,34,265,299,222,265,False,10
8,41,kaist_dataset/English/Digital_Camera/(E.S)C-outdoor1/DSC02450.JPG,char_data/8/DSC02450.JPG_0.jpg,1189,29,353,382,221,262,False,10
8,27,kaist_dataset/English/Digital_Camera/(E.S)C-outdoor1/056.JPG,char_data/8/056.JPG_0.jpg,432,16,513,529,249,276,False,10
8,44,kaist_dataset/English/Digital_Camera/(E.S)C-outdoor1/DSC02415.JPG,char_data/8/DSC02415.JPG_0.jpg,1144,26,393,419,250,294,False,10
8,24,kaist_dataset/English/Digital_Camera/(E.S)C-outdoor1/042.JPG,char_data/8/042.JPG_0.jpg,456,19,485,504,321,345,False,10
8,37,kaist_dataset/English/Digital_Camera/(E.S)C-outdoor1/DSC02364.JPG,char_data/8/DSC02364.JPG_0.jpg,518,14,325,339,350,387,False,10
8,36,kaist_dataset/English/Digital_Camera/(E.S)C-outdoor1/DSC02364.JPG,char_data/8/DSC02364.JPG_0.jpg,756,21,486,507,353,389,False,10
8,34,kaist_dataset/English/Digital_Camera/(E.S)C-outdoor1/DSC02364.JPG,char_data/8/DSC02364.JPG_0.jpg,544,16,549,565,353,387,False,10
8,82,kaist_dataset/English/Digital_Camera/(E.S)C-outdoor1/DSC02491.JPG,char_data/8/DSC02491.JPG_0.jpg,3772,46,238,284,315,397,False,10
8,42,kaist_dataset/English/Digital_Camera/(E.S)F-others/m.jpg,char_data/8/m.jpg_0.jpg,672,16,111,127,171,213,False,10
8,30,kaist_dataset/English/Digital_Camera/(E.S)F-others/DSC02923.JPG,char_data/8/DSC02923.JPG_0.jpg,360,12,295,307,401,431,False,10
8,31,kaist_dataset/English/Digital_Camera/(E.S)F-others/DSC02923.JPG,char_data/8/DSC02923.JPG_0.jpg,589,19,338,357,395,426,False,10
8,50,kaist_dataset/English/Digital_Camera/(E.S)C-outdoor3/P1010086.JPG,char_data/8/P1010086.JPG_0.jpg,1550,31,423,454,96,146,False,10
8,49,kaist_dataset/English/Digital_Camera/(E.S)C-outdoor3/P1010086.JPG,char_data/8/P1010086.JPG_0.jpg,1323,27,453,480,96,145,False,10
8,22,kaist_dataset/English/Digital_Camera/(E.S)C-outdoor3/크기변환_P1010076.JPG,char_data/8/크기변환_P1010076.JPG_0.jpg,242,11,581,592,181,203,False,10
8,23,kaist_dataset/English/Digital_Camera/(E.S)C-outdoor3/크기변환_P1010076.JPG,char_data/8/크기변환_P1010076.JPG_0.jpg,207,9,595,604,182,205,False,10
8,24,kaist_dataset/English/Digital_Camera/(E.S)C-outdoor3/크기변환_P1010076.JPG,char_data/8/크기변환_P1010076.JPG_0.jpg,360,15,611,626,179,203,False,10
2,79,"kaist_dataset/Korean/Mobile_Phone/(M,K)E-bookCover/P090831047.jpg",char_data/2/P090831047.jpg_2.jpg,4108,52,7,59,144,223,True,4
2,162,"kaist_dataset/Korean/Mobile_Phone/(M,K)E-bookCover/P090831132.jpg",char_data/2/P090831132.jpg_2.jpg,23652,146,55,201,294,456,True,4
2,78,"kaist_dataset/Korean/Mobile_Phone/(M,K)E-bookCover/P090903085.jpg",char_data/2/P090903085.jpg_2.jpg,6318,81,505,586,330,408,True,4
2,118,"kaist_dataset/Korean/Mobile_Phone/(M,K)E-bookCover/P090911010.jpg",char_data/2/P090911010.jpg_2.jpg,11210,95,269,364,130,248,True,4
2,33,"kaist_dataset/Korean/Mobile_Phone/(M,K)F-others/P090912070.jpg",char_data/2/P090912070.jpg_2.jpg,891,27,239,266,289,322,True,4
2,29,"kaist_dataset/Korean/Mobile_Phone/(M,K)C-outdoor/P090912042.jpg",char_data/2/P090912042.jpg_2.jpg,377,13,366,379,256,285,True,4
2,52,"kaist_dataset/Korean/Mobile_Phone/(M,K)C-outdoor/P090912033.jpg",char_data/2/P090912033.jpg_4.jpg,1924,37,244,281,351,403,True,4
2,57,"kaist_dataset/Korean/Mobile_Phone/(M,K)C-outdoor/P090912033.jpg",char_data/2/P090912033.jpg_4.jpg,2280,40,398,438,355,412,True,4
2,43,"kaist_dataset/Korean/Mobile_Phone/(M,K)C-outdoor/P090912034.jpg",char_data/2/P090912034.jpg_2.jpg,1204,28,123,151,259,302,True,4
2,69,kaist_dataset/Korean/Digital_Camera/F-bookCover/DSC02815.JPG,char_data/2/DSC02815.JPG_2.jpg,2829,41,346,387,35,104,True,4
2,92,kaist_dataset/Korean/Digital_Camera/F-bookCover/DSC02814.JPG,char_data/2/DSC02814.JPG_2.jpg,4784,52,364,416,27,119,True,4
2,164,kaist_dataset/Korean/Digital_Camera/F-bookCover/DSC02836.JPG,char_data/2/DSC02836.JPG_2.jpg,17220,105,8,113,154,318,True,4
2,92,kaist_dataset/Korean/Digital_Camera/F-bookCover/DSC02812.JPG,char_data/2/DSC02812.JPG_2.jpg,5796,63,389,452,27,119,True,4
2,98,kaist_dataset/Korean/Digital_Camera/F-bookCover/DSC02827.JPG,char_data/2/DSC02827.JPG_2.jpg,6664,68,134,202,43,141,True,4
2,93,kaist_dataset/Korean/Digital_Camera/F-bookCover/DSC02833.JPG,char_data/2/DSC02833.JPG_2.jpg,5673,61,135,196,45,138,True,4
2,145,kaist_dataset/Korean/Digital_Camera/F-bookCover/DSC02826.JPG,char_data/2/DSC02826.JPG_2.jpg,13630,94,31,125,225,370,True,4
2,110,kaist_dataset/Korean/Digital_Camera/F-bookCover/DSC02832.JPG,char_data/2/DSC02832.JPG_2.jpg,7920,72,124,196,29,139,True,4
2,87,kaist_dataset/Korean/Digital_Camera/F-bookCover/P090911043.jpg,char_data/2/P090911043.jpg_4.jpg,5916,68,292,360,222,309,True,4
2,43,kaist_dataset/Korean/Digital_Camera/F-bookCover/P090911043.jpg,char_data/2/P090911043.jpg_4.jpg,1591,37,558,595,205,248,True,4
2,89,kaist_dataset/Korean/Digital_Camera/F-bookCover/DSC02813.JPG,char_data/2/DSC02813.JPG_2.jpg,5340,60,349,409,28,117,True,4
2,84,kaist_dataset/Korean/Digital_Camera/outdoor5/DSC03790.JPG,char_data/2/DSC03790.JPG_2.jpg,4872,58,439,497,143,227,True,4
2,36,kaist_dataset/Korean/Digital_Camera/outdoor5/DSC03996.JPG,char_data/2/DSC03996.JPG_4.jpg,1080,30,255,285,286,322,True,4
2,35,kaist_dataset/Korean/Digital_Camera/outdoor5/DSC03996.JPG,char_data/2/DSC03996.JPG_4.jpg,1015,29,345,374,281,316,True,4
2,31,kaist_dataset/Korean/Digital_Camera/outdoor5/DSC03627.JPG,char_data/2/DSC03627.JPG_2.jpg,992,32,266,298,226,257,True,4
2,35,kaist_dataset/Korean/Digital_Camera/outdoor5/DSC03768.JPG,char_data/2/DSC03768.JPG_4.jpg,805,23,547,570,240,275,True,4
2,39,kaist_dataset/Korean/Digital_Camera/outdoor5/DSC03768.JPG,char_data/2/DSC03768.JPG_4.jpg,897,23,570,593,241,280,True,4
2,28,kaist_dataset/Korean/Digital_Camera/outdoor5/DSC03744.JPG,char_data/2/DSC03744.JPG_2.jpg,756,27,383,410,303,331,True,4
2,32,kaist_dataset/Korean/Digital_Camera/outdoor5/DSC03779.JPG,char_data/2/DSC03779.JPG_2.jpg,736,23,578,601,244,276,True,4
2,33,kaist_dataset/Korean/Digital_Camera/outdoor5/DSC03736.JPG,char_data/2/DSC03736.JPG_2.jpg,495,15,326,341,405,438,True,4
2,75,kaist_dataset/Korean/Digital_Camera/outdoor5/DSC03646.JPG,char_data/2/DSC03646.JPG_2.jpg,2925,39,478,517,194,269,True,4
2,35,kaist_dataset/Korean/Digital_Camera/outdoor5/DSC03834.JPG,char_data/2/DSC03834.JPG_2.jpg,1015,29,154,183,305,340,True,4
2,30,kaist_dataset/Korean/Digital_Camera/outdoor5/DSC04027.JPG,char_data/2/DSC04027.JPG_6.jpg,480,16,193,209,389,419,True,4
2,40,kaist_dataset/Korean/Digital_Camera/outdoor5/DSC04027.JPG,char_data/2/DSC04027.JPG_6.jpg,480,12,266,278,381,421,True,4
2,40,kaist_dataset/Korean/Digital_Camera/outdoor5/DSC04027.JPG,char_data/2/DSC04027.JPG_6.jpg,520,13,478,491,380,420,True,4
2,38,kaist_dataset/Korean/Digital_Camera/outdoor5/DSC03671.JPG,char_data/2/DSC03671.JPG_2.jpg,684,18,212,230,408,446,True,4
2,39,kaist_dataset/Korean/Digital_Camera/outdoor5/DSC03685.JPG,char_data/2/DSC03685.JPG_8.jpg,897,23,133,156,186,225,True,4
2,40,kaist_dataset/Korean/Digital_Camera/outdoor5/DSC03685.JPG,char_data/2/DSC03685.JPG_8.jpg,880,22,193,215,185,225,True,4
2,31,kaist_dataset/Korean/Digital_Camera/outdoor5/DSC03685.JPG,char_data/2/DSC03685.JPG_8.jpg,620,20,385,405,191,222,True,4
2,37,kaist_dataset/Korean/Digital_Camera/outdoor5/DSC03685.JPG,char_data/2/DSC03685.JPG_8.jpg,703,19,442,461,187,224,True,4
2,49,kaist_dataset/Korean/Digital_Camera/outdoor5/DSC03838.JPG,char_data/2/DSC03838.JPG_2.jpg,1323,27,295,322,196,245,True,4
2,40,kaist_dataset/Korean/Digital_Camera/outdoor5/DSC03770.JPG,char_data/2/DSC03770.JPG_4.jpg,1000,25,570,595,420,460,True,4
2,36,kaist_dataset/Korean/Digital_Camera/outdoor5/DSC03770.JPG,char_data/2/DSC03770.JPG_4.jpg,720,20,596,616,424,460,True,4
2,36,kaist_dataset/Korean/Digital_Camera/outdoor5/DSC04040.JPG,char_data/2/DSC04040.JPG_2.jpg,1260,35,475,510,342,378,True,4
2,39,kaist_dataset/Korean/Digital_Camera/outdoor5/DSC03794.JPG,char_data/2/DSC03794.JPG_2.jpg,819,21,424,445,360,399,True,4
2,47,kaist_dataset/Korean/Digital_Camera/outdoor5/DSC03709.JPG,char_data/2/DSC03709.JPG_4.jpg,658,14,516,530,359,406,True,4
2,34,kaist_dataset/Korean/Digital_Camera/outdoor5/DSC03709.JPG,char_data/2/DSC03709.JPG_4.jpg,680,20,575,595,369,403,True,4
2,41,kaist_dataset/Korean/Digital_Camera/outdoor5/DSC03789.JPG,char_data/2/DSC03789.JPG_4.jpg,902,22,268,290,169,210,True,4
2,37,kaist_dataset/Korean/Digital_Camera/outdoor5/DSC03789.JPG,char_data/2/DSC03789.JPG_4.jpg,629,17,270,287,212,249,True,4
2,42,kaist_dataset/Korean/Digital_Camera/outdoor5/DSC03626.JPG,char_data/2/DSC03626.JPG_6.jpg,1008,24,264,288,293,335,True,4
2,41,kaist_dataset/Korean/Digital_Camera/outdoor5/DSC03626.JPG,char_data/2/DSC03626.JPG_6.jpg,1435,35,426,461,298,339,True,4
2,49,kaist_dataset/Korean/Digital_Camera/outdoor5/DSC03626.JPG,char_data/2/DSC03626.JPG_6.jpg,1421,29,558,587,295,344,True,4
2,47,kaist_dataset/Korean/Digital_Camera/outdoor5/DSC03970.JPG,char_data/2/DSC03970.JPG_4.jpg,1551,33,133,166,93,140,True,4
2,44,kaist_dataset/Korean/Digital_Camera/outdoor5/DSC03970.JPG,char_data/2/DSC03970.JPG_4.jpg,1320,30,238,268,94,138,True,4
2,42,kaist_dataset/Korean/Digital_Camera/outdoor5/DSC03740.JPG,char_data/2/DSC03740.JPG_2.jpg,1008,24,319,343,287,329,True,4
2,38,kaist_dataset/Korean/Digital_Camera/outdoor5/DSC03641.JPG,char_data/2/DSC03641.JPG_2.jpg,722,19,400,419,419,457,True,4
2,21,kaist_dataset/Korean/Digital_Camera/outdoor5/DSC03776.JPG,char_data/2/DSC03776.JPG_2.jpg,189,9,512,521,438,459,True,4
2,85,kaist_dataset/Korean/Digital_Camera/outdoor5/DSC03864.JPG,char_data/2/DSC03864.JPG_4.jpg,4080,48,218,266,162,247,True,4
2,91,kaist_dataset/Korean/Digital_Camera/outdoor5/DSC03864.JPG,char_data/2/DSC03864.JPG_4.jpg,4459,49,434,483,165,256,True,4
2,55,kaist_dataset/Korean/Digital_Camera/outdoor4/DSC03598.JPG,char_data/2/DSC03598.JPG_2.jpg,1980,36,236,272,200,255,True,4
2,34,kaist_dataset/Korean/Digital_Camera/outdoor4/DSC03293.JPG,char_data/2/DSC03293.JPG_2.jpg,578,17,257,274,289,323,True,4
2,63,kaist_dataset/Korean/Digital_Camera/outdoor4/DSC03599.JPG,char_data/2/DSC03599.JPG_2.jpg,2331,37,266,303,234,297,True,4
2,74,kaist_dataset/Korean/Digital_Camera/outdoor4/DSC03542.JPG,char_data/2/DSC03542.JPG_2.jpg,2738,37,120,157,258,332,True,4
2,78,kaist_dataset/Korean/Digital_Camera/outdoor4/DSC03608.JPG,char_data/2/DSC03608.JPG_2.jpg,3900,50,506,556,296,374,True,4
2,41,kaist_dataset/Korean/Digital_Camera/outdoor4/DSC03416.JPG,char_data/2/DSC03416.JPG_2.jpg,1107,27,44,71,307,348,True,4
2,57,kaist_dataset/Korean/Digital_Camera/outdoor4/DSC03592.JPG,char_data/2/DSC03592.JPG_14.jpg,2223,39,24,63,55,112,True,4
2,51,kaist_dataset/Korean/Digital_Camera/outdoor4/DSC03592.JPG,char_data/2/DSC03592.JPG_14.jpg,1377,27,594,621,67,118,True,4
2,51,kaist_dataset/Korean/Digital_Camera/outdoor4/DSC03592.JPG,char_data/2/DSC03592.JPG_14.jpg,1683,33,480,513,63,114,True,4
2,51,kaist_dataset/Korean/Digital_Camera/outdoor4/DSC03592.JPG,char_data/2/DSC03592.JPG_14.jpg,1734,34,365,399,60,111,True,4
2,58,kaist_dataset/Korean/Digital_Camera/outdoor4/DSC03592.JPG,char_data/2/DSC03592.JPG_14.jpg,1682,29,257,286,53,111,True,4
2,55,kaist_dataset/Korean/Digital_Camera/outdoor4/DSC03592.JPG,char_data/2/DSC03592.JPG_14.jpg,1485,27,318,345,57,112,True,4
2,51,kaist_dataset/Korean/Digital_Camera/outdoor4/DSC03592.JPG,char_data/2/DSC03592.JPG_14.jpg,1938,38,146,184,56,107,True,4
2,31,kaist_dataset/Korean/Digital_Camera/outdoor4/DSC03295.JPG,char_data/2/DSC03295.JPG_4.jpg,682,22,260,282,400,431,True,4
2,31,kaist_dataset/Korean/Digital_Camera/outdoor4/DSC03295.JPG,char_data/2/DSC03295.JPG_4.jpg,558,18,293,311,402,433,True,4
2,50,kaist_dataset/Korean/Digital_Camera/outdoor4/DSC03607.JPG,char_data/2/DSC03607.JPG_2.jpg,1600,32,69,101,162,212,True,4
2,48,kaist_dataset/Korean/Digital_Camera/outdoor4/DSC03614.JPG,char_data/2/DSC03614.JPG_4.jpg,1008,21,362,383,392,440,True,4
2,36,kaist_dataset/Korean/Digital_Camera/outdoor4/DSC03614.JPG,char_data/2/DSC03614.JPG_4.jpg,648,18,538,556,384,420,True,4
2,49,kaist_dataset/Korean/Digital_Camera/outdoor4/DSC03319.JPG,char_data/2/DSC03319.JPG_6.jpg,1617,33,244,277,389,438,True,4
2,48,kaist_dataset/Korean/Digital_Camera/outdoor4/DSC03319.JPG,char_data/2/DSC03319.JPG_6.jpg,1152,24,148,172,83,131,True,4
2,44,kaist_dataset/Korean/Digital_Camera/outdoor4/DSC03319.JPG,char_data/2/DSC03319.JPG_6.jpg,1276,29,190,219,83,127,True,4
2,83,kaist_dataset/Korean/Digital_Camera/outdoor4/DSC03320.JPG,char_data/2/DSC03320.JPG_2.jpg,5063,61,169,230,379,462,True,4
2,96,kaist_dataset/Korean/Digital_Camera/outdoor4/DSC03566.JPG,char_data/2/DSC03566.JPG_8.jpg,5664,59,449,508,144,240,True,4
2,93,kaist_dataset/Korean/Digital_Camera/outdoor4/DSC03566.JPG,char_data/2/DSC03566.JPG_8.jpg,5115,55,510,565,144,237,True,4
2,42,kaist_dataset/Korean/Digital_Camera/outdoor4/DSC03566.JPG,char_data/2/DSC03566.JPG_8.jpg,2814,67,421,488,88,130,True,4
2,38,kaist_dataset/Korean/Digital_Camera/outdoor4/DSC03566.JPG,char_data/2/DSC03566.JPG_8.jpg,2736,72,486,558,89,127,True,4
2,40,kaist_dataset/Korean/Digital_Camera/outdoor4/DSC03545.JPG,char_data/2/DSC03545.JPG_2.jpg,720,18,130,148,40,80,True,4
2,55,kaist_dataset/Korean/Digital_Camera/outdoor4/DSC03313.JPG,char_data/2/DSC03313.JPG_6.jpg,1870,34,338,372,316,371,True,4
2,37,kaist_dataset/Korean/Digital_Camera/outdoor4/DSC03313.JPG,char_data/2/DSC03313.JPG_6.jpg,999,27,469,496,74,111,True,4
2,38,kaist_dataset/Korean/Digital_Camera/outdoor4/DSC03313.JPG,char_data/2/DSC03313.JPG_6.jpg,836,22,514,536,72,110,True,4
2,44,kaist_dataset/Korean/Digital_Camera/outdoor4/DSC03601.JPG,char_data/2/DSC03601.JPG_2.jpg,1144,26,294,320,298,342,True,4
2,80,kaist_dataset/Korean/Digital_Camera/outdoor4/DSC03553.JPG,char_data/2/DSC03553.JPG_2.jpg,5920,74,227,301,180,260,True,4
2,64,kaist_dataset/Korean/Digital_Camera/outdoor4/DSC03537.JPG,char_data/2/DSC03537.JPG_4.jpg,2688,42,203,245,132,196,True,4
2,61,kaist_dataset/Korean/Digital_Camera/outdoor4/DSC03537.JPG,char_data/2/DSC03537.JPG_4.jpg,2379,39,465,504,125,186,True,4
2,54,kaist_dataset/Korean/Digital_Camera/outdoor4/DSC03580.JPG,char_data/2/DSC03580.JPG_2.jpg,1458,27,276,303,208,262,True,4
2,90,kaist_dataset/Korean/Digital_Camera/outdoor4/DSC03452.JPG,char_data/2/DSC03452.JPG_2.jpg,3330,37,325,362,276,366,True,4
2,71,kaist_dataset/Korean/Digital_Camera/outdoor4/DSC03555.JPG,char_data/2/DSC03555.JPG_4.jpg,2840,40,209,249,354,425,True,4
2,32,kaist_dataset/Korean/Digital_Camera/outdoor4/DSC03555.JPG,char_data/2/DSC03555.JPG_4.jpg,960,30,461,491,428,460,True,4
2,31,kaist_dataset/Korean/Digital_Camera/outdoor2/DSC02467.JPG,char_data/2/DSC02467.JPG_4.jpg,651,21,339,360,258,289,True,4
2,37,kaist_dataset/Korean/Digital_Camera/outdoor2/DSC02467.JPG,char_data/2/DSC02467.JPG_4.jpg,814,22,360,382,256,293,True,4
2,33,kaist_dataset/Korean/Digital_Camera/outdoor2/DSC02476.JPG,char_data/2/DSC02476.JPG_2.jpg,825,25,279,304,276,309,True,4
2,22,kaist_dataset/Korean/Digital_Camera/outdoor2/DSC02314.JPG,char_data/2/DSC02314.JPG_6.jpg,286,13,344,357,203,225,True,4
2,24,kaist_dataset/Korean/Digital_Camera/outdoor2/DSC02314.JPG,char_data/2/DSC02314.JPG_6.jpg,336,14,357,371,204,228,True,4
2,21,kaist_dataset/Korean/Digital_Camera/outdoor2/DSC02314.JPG,char_data/2/DSC02314.JPG_6.jpg,273,13,384,397,205,226,True,4
2,65,kaist_dataset/Korean/Digital_Camera/outdoor2/2007-12-08-day-101.jpg,char_data/2/2007-12-08-day-101.jpg_4.jpg,2210,34,770,804,638,703,True,4
2,62,kaist_dataset/Korean/Digital_Camera/outdoor2/2007-12-08-day-101.jpg,char_data/2/2007-12-08-day-101.jpg_4.jpg,2232,36,905,941,643,705,True,4
2,34,kaist_dataset/Korean/Digital_Camera/outdoor2/DSC02308.JPG,char_data/2/DSC02308.JPG_2.jpg,952,28,258,286,239,273,True,4
2,33,kaist_dataset/Korean/Digital_Camera/outdoor2/2007-12-08-day-122.jpg,char_data/2/2007-12-08-day-122.jpg_1.jpg,1584,48,889,937,172,205,True,4
2,54,kaist_dataset/Korean/Digital_Camera/outdoor2/2007-12-09-day-exterior-033.jpg,char_data/2/2007-12-09-day-exterior-033.jpg_0.jpg,4158,77,590,667,731,785,True,4
2,48,kaist_dataset/Korean/Digital_Camera/outdoor2/DSC02305.JPG,char_data/2/DSC02305.JPG_0.jpg,2160,45,365,410,252,300,True,4
2,54,kaist_dataset/Korean/Digital_Camera/outdoor2/DSC02305.JPG,char_data/2/DSC02305.JPG_0.jpg,2268,42,522,564,250,304,True,4
2,55,kaist_dataset/Korean/Digital_Camera/outdoor2/DSC02305.JPG,char_data/2/DSC02305.JPG_0.jpg,1760,32,606,638,249,304,True,4
2,24,kaist_dataset/Korean/Digital_Camera/outdoor2/DSC02326.JPG,char_data/2/DSC02326.JPG_0.jpg,336,14,383,397,339,363,True,4
2,25,kaist_dataset/Korean/Digital_Camera/outdoor2/DSC02326.JPG,char_data/2/DSC02326.JPG_0.jpg,350,14,399,413,338,363,True,4
2,32,kaist_dataset/Korean/Digital_Camera/outdoor2/DSC02326.JPG,char_data/2/DSC02326.JPG_0.jpg,608,19,39,58,325,357,True,4
2,33,kaist_dataset/Korean/Digital_Camera/outdoor2/DSC02426.JPG,char_data/2/DSC02426.JPG_0.jpg,891,27,388,415,221,254,True,4
2,34,kaist_dataset/Korean/Digital_Camera/outdoor2/DSC02426.JPG,char_data/2/DSC02426.JPG_0.jpg,850,25,466,491,217,251,True,4
2,41,kaist_dataset/Korean/Digital_Camera/outdoor2/080119-0031.jpg,char_data/2/080119-0031.jpg_0.jpg,861,21,524,545,1107,1148,True,4
2,38,kaist_dataset/Korean/Digital_Camera/outdoor2/080119-0031.jpg,char_data/2/080119-0031.jpg_0.jpg,798,21,641,662,1114,1152,True,4
2,37,kaist_dataset/Korean/Digital_Camera/outdoor2/080119-0031.jpg,char_data/2/080119-0031.jpg_0.jpg,962,26,728,754,1119,1156,True,4
2,40,kaist_dataset/Korean/Digital_Camera/outdoor2/080119-0031.jpg,char_data/2/080119-0031.jpg_0.jpg,1080,27,913,940,1121,1161,True,4
2,31,kaist_dataset/Korean/Digital_Camera/outdoor2/DSC02441.JPG,char_data/2/DSC02441.JPG_0.jpg,496,16,443,459,199,230,True,4
2,27,kaist_dataset/Korean/Digital_Camera/outdoor2/DSC02424.JPG,char_data/2/DSC02424.JPG_0.jpg,378,14,471,485,244,271,True,4
2,31,kaist_dataset/Korean/Digital_Camera/outdoor2/DSC02393.JPG,char_data/2/DSC02393.JPG_0.jpg,527,17,476,493,309,340,True,4
2,34,kaist_dataset/Korean/Digital_Camera/outdoor2/DSC02393.JPG,char_data/2/DSC02393.JPG_0.jpg,680,20,567,587,305,339,True,4
2,34,kaist_dataset/Korean/Digital_Camera/outdoor2/DSC02381.JPG,char_data/2/DSC02381.JPG_0.jpg,884,26,228,254,316,350,True,4
2,42,kaist_dataset/Korean/Digital_Camera/outdoor2/DSC02381.JPG,char_data/2/DSC02381.JPG_0.jpg,1008,24,315,339,317,359,True,4
2,46,kaist_dataset/Korean/Digital_Camera/outdoor2/DSC02414.JPG,char_data/2/DSC02414.JPG_0.jpg,1564,34,250,284,238,284,True,4
2,39,kaist_dataset/Korean/Digital_Camera/outdoor2/DSC02380.JPG,char_data/2/DSC02380.JPG_0.jpg,507,13,361,374,233,272,True,4
2,35,kaist_dataset/Korean/Digital_Camera/outdoor2/DSC02311.JPG,char_data/2/DSC02311.JPG_0.jpg,770,22,470,492,252,287,True,4
2,37,kaist_dataset/Korean/Digital_Camera/outdoor2/DSC02311.JPG,char_data/2/DSC02311.JPG_0.jpg,851,23,557,580,251,288,True,4
2,26,kaist_dataset/Korean/Digital_Camera/outdoor2/DSC02435.JPG,char_data/2/DSC02435.JPG_0.jpg,338,13,488,501,246,272,True,4
2,81,kaist_dataset/Korean/Digital_Camera/outdoor2/DSC02451.JPG,char_data/2/DSC02451.JPG_0.jpg,4941,61,117,178,329,410,True,4
2,81,kaist_dataset/Korean/Digital_Camera/outdoor2/DSC02451.JPG,char_data/2/DSC02451.JPG_0.jpg,4617,57,177,234,326,407,True,4
2,31,kaist_dataset/Korean/Digital_Camera/outdoor2/DSC02383.JPG,char_data/2/DSC02383.JPG_0.jpg,372,12,48,60,297,328,True,4
2,33,kaist_dataset/Korean/Digital_Camera/outdoor2/DSC02383.JPG,char_data/2/DSC02383.JPG_0.jpg,396,12,208,220,290,323,True,4
2,23,kaist_dataset/Korean/Digital_Camera/outdoor2/DSC02373.JPG,char_data/2/DSC02373.JPG_0.jpg,322,14,356,370,337,360,True,4
2,24,kaist_dataset/Korean/Digital_Camera/outdoor2/DSC02373.JPG,char_data/2/DSC02373.JPG_0.jpg,384,16,370,386,335,359,True,4
2,31,kaist_dataset/Korean/Digital_Camera/outdoor2/DSC02321.JPG,char_data/2/DSC02321.JPG_0.jpg,713,23,208,231,377,408,True,4
2,35,kaist_dataset/Korean/Digital_Camera/outdoor2/DSC02321.JPG,char_data/2/DSC02321.JPG_0.jpg,735,21,233,254,377,412,True,4
2,31,kaist_dataset/Korean/Digital_Camera/outdoor2/DSC02386.JPG,char_data/2/DSC02386.JPG_0.jpg,589,19,447,466,258,289,True,4
2,25,kaist_dataset/Korean/Digital_Camera/outdoor2/DSC02299.JPG,char_data/2/DSC02299.JPG_0.jpg,350,14,581,595,212,237,True,4
2,28,kaist_dataset/Korean/Digital_Camera/outdoor2/DSC02299.JPG,char_data/2/DSC02299.JPG_0.jpg,364,13,595,608,210,238,True,4
2,35,kaist_dataset/Korean/Digital_Camera/outdoor2/DSC02371.JPG,char_data/2/DSC02371.JPG_0.jpg,700,20,138,158,241,276,True,4
2,37,kaist_dataset/Korean/Digital_Camera/outdoor2/DSC02371.JPG,char_data/2/DSC02371.JPG_0.jpg,703,19,157,176,240,277,True,4
2,47,kaist_dataset/Korean/Digital_Camera/outdoor2/2007-12-09-day-exterior-035.jpg,char_data/2/2007-12-09-day-exterior-035.jpg_0.jpg,1598,34,476,510,709,756,True,4
2,51,kaist_dataset/Korean/Digital_Camera/outdoor2/2007-12-09-day-exterior-035.jpg,char_data/2/2007-12-09-day-exterior-035.jpg_0.jpg,1785,35,808,843,721,772,True,4
2,71,kaist_dataset/Korean/Digital_Camera/outdoor2/2007-12-09-day-exterior-009.jpg,char_data/2/2007-12-09-day-exterior-009.jpg_0.jpg,2911,41,778,819,673,744,True,4
2,33,kaist_dataset/Korean/Digital_Camera/outdoor2/DSC02327.JPG,char_data/2/DSC02327.JPG_0.jpg,957,29,183,212,357,390,True,4
2,55,kaist_dataset/Korean/Digital_Camera/outdoor2/DSC02515.JPG,char_data/2/DSC02515.JPG_0.jpg,2145,39,455,494,335,390,True,4
2,49,kaist_dataset/Korean/Digital_Camera/outdoor2/DSC02515.JPG,char_data/2/DSC02515.JPG_0.jpg,1862,38,495,533,340,389,True,4
2,34,kaist_dataset/Korean/Digital_Camera/outdoor2/DSC02488.JPG,char_data/2/DSC02488.JPG_0.jpg,578,17,529,546,372,406,True,4
2,27,kaist_dataset/Korean/Digital_Camera/outdoor2/DSC02304.JPG,char_data/2/DSC02304.JPG_0.jpg,729,27,251,278,264,291,True,4
2,28,kaist_dataset/Korean/Digital_Camera/outdoor2/DSC02304.JPG,char_data/2/DSC02304.JPG_0.jpg,896,32,275,307,265,293,True,4
2,31,kaist_dataset/Korean/Digital_Camera/outdoor2/DSC02470.JPG,char_data/2/DSC02470.JPG_0.jpg,682,22,221,243,182,213,True,4
2,65,kaist_dataset/Korean/Digital_Camera/outdoor2/DSC02470.JPG,char_data/2/DSC02470.JPG_0.jpg,2210,34,327,361,373,438,True,4
2,32,kaist_dataset/Korean/Digital_Camera/outdoor2/DSC02310.JPG,char_data/2/DSC02310.JPG_0.jpg,1024,32,347,379,211,243,True,4
2,36,kaist_dataset/Korean/Digital_Camera/outdoor2/DSC02310.JPG,char_data/2/DSC02310.JPG_0.jpg,1404,39,409,448,209,245,True,4
2,30,kaist_dataset/Korean/Digital_Camera/outdoor2/DSC02310.JPG,char_data/2/DSC02310.JPG_0.jpg,840,28,231,259,209,239,True,4
2,26,kaist_dataset/Korean/Digital_Camera/outdoor2/DSC02372.JPG,char_data/2/DSC02372.JPG_0.jpg,390,15,475,490,294,320,True,4
2,28,kaist_dataset/Korean/Digital_Camera/outdoor2/DSC02372.JPG,char_data/2/DSC02372.JPG_0.jpg,336,12,490,502,289,317,True,4
2,37,kaist_dataset/Korean/Digital_Camera/outdoor2/DSC02523.JPG,char_data/2/DSC02523.JPG_0.jpg,555,15,428,443,338,375,True,4
2,46,kaist_dataset/Korean/Digital_Camera/E-night/DSC02645.JPG,char_data/2/DSC02645.JPG_0.jpg,1242,27,423,450,332,378,True,4
2,38,kaist_dataset/Korean/Digital_Camera/E-night/DSC03850.JPG,char_data/2/DSC03850.JPG_0.jpg,722,19,354,373,425,463,True,4
2,25,kaist_dataset/Korean/Digital_Camera/E-night/P1010149.JPG,char_data/2/P1010149.JPG_0.jpg,425,17,612,629,242,267,True,4
2,29,kaist_dataset/Korean/Digital_Camera/E-night/P1010146.JPG,char_data/2/P1010146.JPG_0.jpg,522,18,342,360,246,275,True,4
2,24,kaist_dataset/Korean/Digital_Camera/E-night/DSC03870.JPG,char_data/2/DSC03870.JPG_0.jpg,288,12,394,406,222,246,True,4
2,48,kaist_dataset/Korean/Digital_Camera/E-night/DSC02649.JPG,char_data/2/DSC02649.JPG_0.jpg,960,20,491,511,391,439,True,4
2,78,kaist_dataset/Korean/Digital_Camera/E-night/DSC02631.JPG,char_data/2/DSC02631.JPG_0.jpg,5226,67,166,233,186,264,True,4
2,22,kaist_dataset/Korean/Digital_Camera/E-night/103.jpg,char_data/2/103.jpg_0.jpg,176,8,168,176,314,336,True,4
2,21,kaist_dataset/Korean/Digital_Camera/E-night/103.jpg,char_data/2/103.jpg_0.jpg,168,8,210,218,314,335,True,4
2,35,kaist_dataset/Korean/Digital_Camera/E-night/DSC02658.JPG,char_data/2/DSC02658.JPG_0.jpg,945,27,302,329,357,392,True,4
2,59,kaist_dataset/Korean/Digital_Camera/E-night/DSC02594.JPG,char_data/2/DSC02594.JPG_0.jpg,2773,47,279,326,375,434,True,4
2,60,kaist_dataset/Korean/Digital_Camera/E-night/DSC02594.JPG,char_data/2/DSC02594.JPG_0.jpg,2280,38,380,418,370,430,True,4
2,29,kaist_dataset/Korean/Digital_Camera/E-night/DSC02626.JPG,char_data/2/DSC02626.JPG_0.jpg,377,13,64,77,380,409,True,4
2,30,kaist_dataset/Korean/Digital_Camera/E-night/DSC02626.JPG,char_data/2/DSC02626.JPG_0.jpg,450,15,114,129,377,407,True,4
2,35,kaist_dataset/Korean/Digital_Camera/E-night/DSC02626.JPG,char_data/2/DSC02626.JPG_0.jpg,420,12,153,165,373,408,True,4
2,48,kaist_dataset/Korean/Digital_Camera/E-night/DSC02597.JPG,char_data/2/DSC02597.JPG_0.jpg,1392,29,481,510,289,337,True,4
2,47,kaist_dataset/Korean/Digital_Camera/E-night/DSC02597.JPG,char_data/2/DSC02597.JPG_0.jpg,1410,30,540,570,290,337,True,4
2,43,kaist_dataset/Korean/Digital_Camera/E-night/DSC03515.JPG,char_data/2/DSC03515.JPG_0.jpg,731,17,454,471,274,317,True,4
2,87,kaist_dataset/Korean/Digital_Camera/indoor1/DSC03364.JPG,char_data/2/DSC03364.JPG_0.jpg,5568,64,262,326,236,323,True,4
2,116,kaist_dataset/Korean/Digital_Camera/indoor1/DSC03375.JPG,char_data/2/DSC03375.JPG_0.jpg,13340,115,134,249,164,280,True,4
2,95,kaist_dataset/Korean/Digital_Camera/indoor1/080119-0029.jpg,char_data/2/080119-0029.jpg_0.jpg,4085,43,479,522,573,668,True,4
2,43,kaist_dataset/Korean/Digital_Camera/indoor1/080119-0029.jpg,char_data/2/080119-0029.jpg_0.jpg,989,23,1230,1253,619,662,True,4
2,88,kaist_dataset/Korean/Digital_Camera/indoor1/080119-0029.jpg,char_data/2/080119-0029.jpg_0.jpg,3608,41,658,699,971,1059,True,4
2,27,kaist_dataset/Korean/Digital_Camera/indoor1/080119-0030.jpg,char_data/2/080119-0030.jpg_0.jpg,432,16,745,761,868,895,True,4
2,32,kaist_dataset/Korean/Digital_Camera/indoor1/DSC03362.JPG,char_data/2/DSC03362.JPG_0.jpg,544,17,68,85,280,312,True,4
2,60,kaist_dataset/Korean/Digital_Camera/indoor1/080119-0018.jpg,char_data/2/080119-0018.jpg_0.jpg,2520,42,916,958,443,503,True,4
2,47,kaist_dataset/Korean/Digital_Camera/indoor1/080119-0018.jpg,char_data/2/080119-0018.jpg_0.jpg,1128,24,946,970,939,986,True,4
2,46,kaist_dataset/Korean/Digital_Camera/indoor1/080119-0018.jpg,char_data/2/080119-0018.jpg_0.jpg,1426,31,1004,1035,940,986,True,4
2,42,kaist_dataset/Korean/Digital_Camera/outdoor7/P1010012.JPG,char_data/2/P1010012.JPG_0.jpg,1176,28,250,278,220,262,True,4
2,40,kaist_dataset/Korean/Digital_Camera/outdoor7/P1010012.JPG,char_data/2/P1010012.JPG_0.jpg,1000,25,389,414,220,260,True,4
2,28,kaist_dataset/Korean/Digital_Camera/outdoor7/P1010091.JPG,char_data/2/P1010091.JPG_0.jpg,700,25,438,463,240,268,True,4
2,36,kaist_dataset/Korean/Digital_Camera/outdoor7/P1010054.JPG,char_data/2/P1010054.JPG_0.jpg,504,14,611,625,225,261,True,4
2,30,kaist_dataset/Korean/Digital_Camera/outdoor7/P1010054.JPG,char_data/2/P1010054.JPG_0.jpg,480,16,624,640,226,256,True,4
2,29,kaist_dataset/Korean/Digital_Camera/outdoor7/P1010107.JPG,char_data/2/P1010107.JPG_0.jpg,580,20,380,400,227,256,True,4
2,47,kaist_dataset/Korean/Digital_Camera/outdoor7/P1010069.JPG,char_data/2/P1010069.JPG_0.jpg,1175,25,293,318,311,358,True,4
2,48,kaist_dataset/Korean/Digital_Camera/outdoor7/P1010069.JPG,char_data/2/P1010069.JPG_0.jpg,1344,28,363,391,314,362,True,4
2,31,kaist_dataset/Korean/Digital_Camera/outdoor7/P1010136.JPG,char_data/2/P1010136.JPG_0.jpg,465,15,187,202,262,293,True,4
2,40,kaist_dataset/Korean/Digital_Camera/outdoor7/P1010138.JPG,char_data/2/P1010138.JPG_0.jpg,680,17,226,243,285,325,True,4
2,60,kaist_dataset/Korean/Digital_Camera/outdoor7/P1010068.JPG,char_data/2/P1010068.JPG_0.jpg,1860,31,326,357,273,333,True,4
2,68,kaist_dataset/Korean/Digital_Camera/outdoor7/P1010068.JPG,char_data/2/P1010068.JPG_0.jpg,2312,34,436,470,270,338,True,4
2,49,kaist_dataset/Korean/Digital_Camera/outdoor7/P1010085.JPG,char_data/2/P1010085.JPG_0.jpg,1568,32,283,315,268,317,True,4
2,52,kaist_dataset/Korean/Digital_Camera/outdoor7/P1010077.JPG,char_data/2/P1010077.JPG_0.jpg,1560,30,262,292,247,299,True,4
2,51,kaist_dataset/Korean/Digital_Camera/outdoor7/P1010077.JPG,char_data/2/P1010077.JPG_0.jpg,1479,29,324,353,247,298,True,4
2,29,kaist_dataset/Korean/Digital_Camera/outdoor7/P1010055.JPG,char_data/2/P1010055.JPG_0.jpg,638,22,67,89,208,237,True,4
2,33,kaist_dataset/Korean/Digital_Camera/outdoor7/P1010055.JPG,char_data/2/P1010055.JPG_0.jpg,627,19,90,109,206,239,True,4
2,50,kaist_dataset/Korean/Digital_Camera/outdoor7/P1010011.JPG,char_data/2/P1010011.JPG_0.jpg,2250,45,305,350,228,278,True,4
2,74,kaist_dataset/Korean/Digital_Camera/outdoor7/P1010086.JPG,char_data/2/P1010086.JPG_0.jpg,4366,59,177,236,255,329,True,4
2,27,kaist_dataset/Korean/Digital_Camera/outdoor7/P1010112.JPG,char_data/2/P1010112.JPG_0.jpg,378,14,500,514,360,387,True,4
2,26,kaist_dataset/Korean/Digital_Camera/outdoor7/P1010112.JPG,char_data/2/P1010112.JPG_0.jpg,442,17,563,580,359,385,True,4
2,40,kaist_dataset/Korean/Digital_Camera/outdoor7/P1010009.JPG,char_data/2/P1010009.JPG_0.jpg,1240,31,411,442,267,307,True,4
2,37,kaist_dataset/Korean/Digital_Camera/outdoor7/P1010004.JPG,char_data/2/P1010004.JPG_0.jpg,444,12,570,582,294,331,True,4
2,36,kaist_dataset/Korean/Digital_Camera/outdoor7/P1010004.JPG,char_data/2/P1010004.JPG_0.jpg,648,18,591,609,289,325,True,4
2,56,kaist_dataset/Korean/Digital_Camera/outdoor7/P1010023.JPG,char_data/2/P1010023.JPG_0.jpg,1736,31,167,198,291,347,True,4
2,52,kaist_dataset/Korean/Digital_Camera/outdoor7/P1010023.JPG,char_data/2/P1010023.JPG_0.jpg,1508,29,418,447,285,337,True,4
2,56,kaist_dataset/Korean/Digital_Camera/outdoor7/P1010023.JPG,char_data/2/P1010023.JPG_0.jpg,1456,26,570,596,281,337,True,4
2,71,kaist_dataset/Korean/Digital_Camera/outdoor7/DSC04483.JPG,char_data/2/DSC04483.JPG_0.jpg,3550,50,45,95,361,432,True,4
2,158,kaist_dataset/Korean/Digital_Camera/outdoor7/DSC04470.JPG,char_data/2/DSC04470.JPG_0.jpg,13272,84,90,174,143,301,True,4
2,32,kaist_dataset/Korean/Digital_Camera/outdoor7/P1010056.JPG,char_data/2/P1010056.JPG_0.jpg,544,17,434,451,267,299,True,4
2,29,kaist_dataset/Korean/Digital_Camera/outdoor7/P1010056.JPG,char_data/2/P1010056.JPG_0.jpg,580,20,468,488,268,297,True,4
2,27,kaist_dataset/Korean/Digital_Camera/outdoor7/P1010056.JPG,char_data/2/P1010056.JPG_0.jpg,513,19,487,506,269,296,True,4
2,28,kaist_dataset/Korean/Digital_Camera/outdoor7/P1010056.JPG,char_data/2/P1010056.JPG_0.jpg,672,24,524,548,270,298,True,4
2,135,kaist_dataset/Korean/Digital_Camera/outdoor7/P1010002.JPG,char_data/2/P1010002.JPG_0.jpg,18495,137,306,443,104,239,True,4
2,43,kaist_dataset/Korean/Digital_Camera/outdoor7/P1010029.JPG,char_data/2/P1010029.JPG_0.jpg,1376,32,511,543,392,435,True,4
2,39,kaist_dataset/Korean/Digital_Camera/outdoor7/P1010067.JPG,char_data/2/P1010067.JPG_0.jpg,1209,31,202,233,314,353,True,4
2,40,kaist_dataset/Korean/Digital_Camera/outdoor7/P1010067.JPG,char_data/2/P1010067.JPG_0.jpg,1200,30,273,303,313,353,True,4
2,39,kaist_dataset/Korean/Digital_Camera/outdoor7/P1010035.JPG,char_data/2/P1010035.JPG_0.jpg,624,16,122,138,203,242,True,4
2,33,kaist_dataset/Korean/Digital_Camera/outdoor7/P1010057.JPG,char_data/2/P1010057.JPG_0.jpg,693,21,545,566,227,260,True,4
2,108,kaist_dataset/Korean/Digital_Camera/outdoor7/P1010079.JPG,char_data/2/P1010079.JPG_0.jpg,7020,65,222,287,338,446,True,4
2,96,kaist_dataset/Korean/Digital_Camera/outdoor7/P1010079.JPG,char_data/2/P1010079.JPG_0.jpg,6336,66,389,455,342,438,True,4
2,69,kaist_dataset/Korean/Digital_Camera/outdoor8/P1010181.JPG,char_data/2/P1010181.JPG_0.jpg,2277,33,373,406,197,266,True,4
2,94,kaist_dataset/Korean/Digital_Camera/outdoor8/P1010181.JPG,char_data/2/P1010181.JPG_0.jpg,2820,30,383,413,293,387,True,4
2,41,kaist_dataset/Korean/Digital_Camera/outdoor8/P1010142.JPG,char_data/2/P1010142.JPG_0.jpg,861,21,223,244,279,320,True,4
2,36,kaist_dataset/Korean/Digital_Camera/outdoor8/P1010170.JPG,char_data/2/P1010170.JPG_0.jpg,828,23,377,400,276,312,True,4
2,53,kaist_dataset/Korean/Digital_Camera/outdoor8/DSC02950.JPG,char_data/2/DSC02950.JPG_0.jpg,2438,46,449,495,302,355,True,4
2,60,kaist_dataset/Korean/Digital_Camera/outdoor8/DSC02950.JPG,char_data/2/DSC02950.JPG_0.jpg,3420,57,494,551,305,365,True,4
2,30,kaist_dataset/Korean/Digital_Camera/outdoor8/P090912069.jpg,char_data/2/P090912069.jpg_0.jpg,810,27,298,325,249,279,True,4
2,35,kaist_dataset/Korean/Digital_Camera/outdoor8/P090912069.jpg,char_data/2/P090912069.jpg_0.jpg,945,27,327,354,243,278,True,4
2,71,kaist_dataset/Korean/Digital_Camera/outdoor8/P1010172.JPG,char_data/2/P1010172.JPG_0.jpg,2982,42,237,279,227,298,True,4
2,71,kaist_dataset/Korean/Digital_Camera/outdoor8/P1010160.JPG,char_data/2/P1010160.JPG_0.jpg,4331,61,378,439,223,294,True,4
2,53,kaist_dataset/Korean/Digital_Camera/outdoor8/P1010171.JPG,char_data/2/P1010171.JPG_0.jpg,1590,30,426,456,232,285,True,4
2,31,kaist_dataset/Korean/Digital_Camera/outdoor8/P1010178.JPG,char_data/2/P1010178.JPG_0.jpg,589,19,351,370,391,422,True,4
2,33,kaist_dataset/Korean/Digital_Camera/outdoor8/P1010178.JPG,char_data/2/P1010178.JPG_0.jpg,528,16,372,388,390,423,True,4
2,34,kaist_dataset/Korean/Digital_Camera/outdoor8/P1010178.JPG,char_data/2/P1010178.JPG_0.jpg,748,22,406,428,393,427,True,4
2,32,kaist_dataset/Korean/Digital_Camera/outdoor8/P1010178.JPG,char_data/2/P1010178.JPG_0.jpg,736,23,345,368,307,339,True,4
2,36,kaist_dataset/Korean/Digital_Camera/outdoor8/P1011112.JPG,char_data/2/P1011112.JPG_0.jpg,576,16,376,392,215,251,True,4
2,35,kaist_dataset/Korean/Digital_Camera/outdoor8/P1011112.JPG,char_data/2/P1011112.JPG_0.jpg,595,17,575,592,223,258,True,4
2,34,kaist_dataset/Korean/Digital_Camera/outdoor8/P1011112.JPG,char_data/2/P1011112.JPG_0.jpg,442,13,610,623,231,265,True,4
2,74,kaist_dataset/Korean/Digital_Camera/indoor2/DSC04006.JPG,char_data/2/DSC04006.JPG_0.jpg,2442,33,214,247,151,225,True,4
2,75,kaist_dataset/Korean/Digital_Camera/indoor2/DSC04006.JPG,char_data/2/DSC04006.JPG_0.jpg,2100,28,308,336,146,221,True,4
2,78,kaist_dataset/Korean/Digital_Camera/indoor2/DSC04006.JPG,char_data/2/DSC04006.JPG_0.jpg,2964,38,367,405,146,224,True,4
2,55,kaist_dataset/Korean/Digital_Camera/indoor2/DSC03563.JPG,char_data/2/DSC03563.JPG_0.jpg,2750,50,433,483,260,315,True,4
2,57,kaist_dataset/Korean/Digital_Camera/indoor2/DSC03474.JPG,char_data/2/DSC03474.JPG_0.jpg,2052,36,171,207,153,210,True,4
2,55,kaist_dataset/Korean/Digital_Camera/indoor2/DSC03475.JPG,char_data/2/DSC03475.JPG_0.jpg,2420,44,154,198,91,146,True,4
2,41,kaist_dataset/Korean/Digital_Camera/indoor2/DSC03530.JPG,char_data/2/DSC03530.JPG_0.jpg,943,23,209,232,217,258,True,4
2,39,kaist_dataset/Korean/Digital_Camera/indoor2/DSC04204.JPG,char_data/2/DSC04204.JPG_0.jpg,936,24,347,371,280,319,True,4
2,44,kaist_dataset/Korean/Digital_Camera/indoor2/DSC04204.JPG,char_data/2/DSC04204.JPG_0.jpg,836,19,373,392,278,322,True,4
2,38,kaist_dataset/Korean/Digital_Camera/indoor2/DSC03975.JPG,char_data/2/DSC03975.JPG_0.jpg,494,13,182,195,289,327,True,4
2,91,kaist_dataset/Korean/Digital_Camera/indoor2/DSC03565.JPG,char_data/2/DSC03565.JPG_0.jpg,5733,63,393,456,269,360,True,4
2,95,kaist_dataset/Korean/Digital_Camera/indoor2/DSC03565.JPG,char_data/2/DSC03565.JPG_0.jpg,6555,69,508,577,263,358,True,4
2,49,kaist_dataset/Korean/Digital_Camera/indoor2/DSC03497.JPG,char_data/2/DSC03497.JPG_0.jpg,1519,31,221,252,4,53,True,4
2,26,kaist_dataset/Korean/Digital_Camera/G-others/DSC03863.JPG,char_data/2/DSC03863.JPG_0.jpg,338,13,215,228,408,434,True,4
2,109,kaist_dataset/Korean/Digital_Camera/G-others/2007-12-09-day-exterior-062.jpg,char_data/2/2007-12-09-day-exterior-062.jpg_0.jpg,3379,31,536,567,1396,1505,True,4
2,66,kaist_dataset/Korean/Digital_Camera/G-others/DSC02584.JPG,char_data/2/DSC02584.JPG_0.jpg,3828,58,430,488,240,306,True,4
2,84,kaist_dataset/Korean/Digital_Camera/G-others/2007-12-08-day-108.jpg,char_data/2/2007-12-08-day-108.jpg_0.jpg,3444,41,653,694,607,691,True,4
2,86,kaist_dataset/Korean/Digital_Camera/G-others/2007-12-08-day-108.jpg,char_data/2/2007-12-08-day-108.jpg_0.jpg,3440,40,770,810,647,733,True,4
2,80,kaist_dataset/Korean/Digital_Camera/G-others/2007-12-08-day-108.jpg,char_data/2/2007-12-08-day-108.jpg_0.jpg,3440,43,801,844,662,742,True,4
2,75,kaist_dataset/Korean/Digital_Camera/outdoor6/DSC04359.JPG,char_data/2/DSC04359.JPG_0.jpg,3375,45,143,188,114,189,True,4
2,55,kaist_dataset/Korean/Digital_Camera/outdoor6/DSC04308.JPG,char_data/2/DSC04308.JPG_0.jpg,1540,28,219,247,384,439,True,4
2,55,kaist_dataset/Korean/Digital_Camera/outdoor6/DSC04308.JPG,char_data/2/DSC04308.JPG_0.jpg,1650,30,297,327,383,438,True,4
2,54,kaist_dataset/Korean/Digital_Camera/outdoor6/DSC04308.JPG,char_data/2/DSC04308.JPG_0.jpg,1458,27,326,353,384,438,True,4
2,26,kaist_dataset/Korean/Digital_Camera/outdoor6/DSC04132.JPG,char_data/2/DSC04132.JPG_0.jpg,468,18,314,332,156,182,True,4
2,44,kaist_dataset/Korean/Digital_Camera/outdoor6/DSC04400.JPG,char_data/2/DSC04400.JPG_0.jpg,1056,24,280,304,222,266,True,4
2,42,kaist_dataset/Korean/Digital_Camera/outdoor6/DSC04400.JPG,char_data/2/DSC04400.JPG_0.jpg,1134,27,274,301,398,440,True,4
2,31,kaist_dataset/Korean/Digital_Camera/outdoor6/DSC04041.JPG,char_data/2/DSC04041.JPG_0.jpg,527,17,514,531,142,173,True,4
2,29,kaist_dataset/Korean/Digital_Camera/outdoor6/DSC04343.JPG,char_data/2/DSC04343.JPG_0.jpg,725,25,299,324,206,235,True,4
2,40,kaist_dataset/Korean/Digital_Camera/outdoor6/DSC04339.JPG,char_data/2/DSC04339.JPG_0.jpg,800,20,298,318,210,250,True,4
2,41,kaist_dataset/Korean/Digital_Camera/outdoor6/DSC04339.JPG,char_data/2/DSC04339.JPG_0.jpg,1025,25,316,341,208,249,True,4
2,40,kaist_dataset/Korean/Digital_Camera/outdoor6/DSC04339.JPG,char_data/2/DSC04339.JPG_0.jpg,920,23,375,398,207,247,True,4
2,45,kaist_dataset/Korean/Digital_Camera/outdoor6/DSC04339.JPG,char_data/2/DSC04339.JPG_0.jpg,1305,29,417,446,206,251,True,4
2,49,kaist_dataset/Korean/Digital_Camera/outdoor6/DSC04352.JPG,char_data/2/DSC04352.JPG_0.jpg,1372,28,509,537,280,329,True,4
2,36,kaist_dataset/Korean/Digital_Camera/outdoor6/DSC04099.JPG,char_data/2/DSC04099.JPG_0.jpg,972,27,481,508,413,449,True,4
2,25,kaist_dataset/Korean/Digital_Camera/outdoor6/DSC04341.JPG,char_data/2/DSC04341.JPG_0.jpg,400,16,501,517,223,248,True,4
2,27,kaist_dataset/Korean/Digital_Camera/outdoor6/DSC04341.JPG,char_data/2/DSC04341.JPG_0.jpg,540,20,515,535,222,249,True,4
2,37,kaist_dataset/Korean/Digital_Camera/outdoor6/DSC04121.JPG,char_data/2/DSC04121.JPG_0.jpg,1036,28,262,290,181,218,True,4
2,38,kaist_dataset/Korean/Digital_Camera/outdoor6/DSC04121.JPG,char_data/2/DSC04121.JPG_0.jpg,1064,28,356,384,180,218,True,4
2,73,kaist_dataset/Korean/Digital_Camera/outdoor6/DSC04301.JPG,char_data/2/DSC04301.JPG_0.jpg,4964,68,124,192,362,435,True,4
2,30,kaist_dataset/Korean/Digital_Camera/outdoor6/DSC04113.JPG,char_data/2/DSC04113.JPG_0.jpg,930,31,206,237,443,473,True,4
2,82,kaist_dataset/Korean/Digital_Camera/outdoor6/DSC04096.JPG,char_data/2/DSC04096.JPG_0.jpg,3854,47,374,421,225,307,True,4
2,36,kaist_dataset/Korean/Digital_Camera/outdoor6/DSC04112.JPG,char_data/2/DSC04112.JPG_0.jpg,540,15,320,335,270,306,True,4
2,36,kaist_dataset/Korean/Digital_Camera/outdoor6/DSC04112.JPG,char_data/2/DSC04112.JPG_0.jpg,504,14,442,456,273,309,True,4
2,52,kaist_dataset/Korean/Digital_Camera/outdoor6/DSC04296.JPG,char_data/2/DSC04296.JPG_0.jpg,936,18,286,304,316,368,True,4
2,56,kaist_dataset/Korean/Digital_Camera/outdoor6/DSC04296.JPG,char_data/2/DSC04296.JPG_0.jpg,1008,18,326,344,310,366,True,4
2,53,kaist_dataset/Korean/Digital_Camera/outdoor6/DSC04100.JPG,char_data/2/DSC04100.JPG_0.jpg,1113,21,480,501,57,110,True,4
2,67,kaist_dataset/Korean/Digital_Camera/outdoor6/DSC04073.JPG,char_data/2/DSC04073.JPG_0.jpg,1876,28,395,423,30,97,True,4
2,28,kaist_dataset/Korean/Digital_Camera/outdoor6/DSC04046.JPG,char_data/2/DSC04046.JPG_0.jpg,476,17,300,317,262,290,True,4
2,27,kaist_dataset/Korean/Digital_Camera/outdoor6/DSC04046.JPG,char_data/2/DSC04046.JPG_0.jpg,351,13,529,542,264,291,True,4
2,30,kaist_dataset/Korean/Digital_Camera/outdoor6/DSC04046.JPG,char_data/2/DSC04046.JPG_0.jpg,570,19,557,576,262,292,True,4
2,55,kaist_dataset/Korean/Digital_Camera/outdoor6/DSC04370.JPG,char_data/2/DSC04370.JPG_0.jpg,3135,57,170,227,318,373,True,4
2,52,kaist_dataset/Korean/Digital_Camera/outdoor6/DSC04332.JPG,char_data/2/DSC04332.JPG_0.jpg,2600,50,136,186,349,401,True,4
2,48,kaist_dataset/Korean/Digital_Camera/outdoor6/DSC04118.JPG,char_data/2/DSC04118.JPG_0.jpg,1440,30,398,428,256,304,True,4
2,51,kaist_dataset/Korean/Digital_Camera/outdoor6/DSC04118.JPG,char_data/2/DSC04118.JPG_0.jpg,1581,31,454,485,255,306,True,4
2,32,kaist_dataset/Korean/Digital_Camera/outdoor6/DSC04138.JPG,char_data/2/DSC04138.JPG_0.jpg,864,27,409,436,153,185,True,4
2,44,kaist_dataset/Korean/Digital_Camera/A-shadow/2007-12-09-day-exterior-040.jpg,char_data/2/2007-12-09-day-exterior-040.jpg_0.jpg,1012,23,1098,1121,812,856,True,4
2,54,kaist_dataset/Korean/Digital_Camera/A-shadow/DSC04315.JPG,char_data/2/DSC04315.JPG_0.jpg,1458,27,141,168,408,462,True,4
2,67,kaist_dataset/Korean/Digital_Camera/A-shadow/DSC03755.JPG,char_data/2/DSC03755.JPG_0.jpg,1943,29,385,414,210,277,True,4
2,78,kaist_dataset/Korean/Digital_Camera/A-shadow/DSC03755.JPG,char_data/2/DSC03755.JPG_0.jpg,2496,32,548,580,207,285,True,4
2,82,kaist_dataset/Korean/Digital_Camera/A-shadow/DSC04311.JPG,char_data/2/DSC04311.JPG_0.jpg,4100,50,355,405,259,341,True,4
2,66,kaist_dataset/Korean/Digital_Camera/A-shadow/2007-12-09-day-exterior-026.jpg,char_data/2/2007-12-09-day-exterior-026.jpg_0.jpg,2772,42,1033,1075,759,825,True,4
2,39,kaist_dataset/Korean/Digital_Camera/A-shadow/DSC02598.JPG,char_data/2/DSC02598.JPG_0.jpg,741,19,541,560,414,453,True,4
2,128,kaist_dataset/Korean/Digital_Camera/A-shadow/DSC04300.JPG,char_data/2/DSC04300.JPG_0.jpg,6272,49,161,210,222,350,True,4
2,125,kaist_dataset/Korean/Digital_Camera/A-shadow/DSC04300.JPG,char_data/2/DSC04300.JPG_0.jpg,6625,53,350,403,239,364,True,4
2,81,kaist_dataset/Korean/Digital_Camera/A-shadow/2007-12-09-day-exterior-031.jpg,char_data/2/2007-12-09-day-exterior-031.jpg_0.jpg,3564,44,645,689,665,746,True,4
2,35,kaist_dataset/Korean/Digital_Camera/outdoor3/DSC02999.JPG,char_data/2/DSC02999.JPG_0.jpg,595,17,226,243,431,466,True,4
2,36,kaist_dataset/Korean/Digital_Camera/outdoor3/DSC02999.JPG,char_data/2/DSC02999.JPG_0.jpg,612,17,299,316,431,467,True,4
2,54,kaist_dataset/Korean/Digital_Camera/outdoor3/DSC02546.JPG,char_data/2/DSC02546.JPG_0.jpg,2430,45,429,474,356,410,True,4
2,33,kaist_dataset/Korean/Digital_Camera/outdoor3/DSC02546.JPG,char_data/2/DSC02546.JPG_0.jpg,363,11,194,205,427,460,True,4
2,32,kaist_dataset/Korean/Digital_Camera/outdoor3/DSC02546.JPG,char_data/2/DSC02546.JPG_0.jpg,512,16,255,271,427,459,True,4
2,40,kaist_dataset/Korean/Digital_Camera/outdoor3/DSC02686.JPG,char_data/2/DSC02686.JPG_0.jpg,1000,25,442,467,225,265,True,4
2,35,kaist_dataset/Korean/Digital_Camera/outdoor3/DSC02899.JPG,char_data/2/DSC02899.JPG_0.jpg,1190,34,518,552,230,265,True,4
2,44,kaist_dataset/Korean/Digital_Camera/outdoor3/DSC02528.JPG,char_data/2/DSC02528.JPG_0.jpg,1496,34,241,275,413,457,True,4
2,26,kaist_dataset/Korean/Digital_Camera/outdoor3/DSC02891.JPG,char_data/2/DSC02891.JPG_0.jpg,312,12,562,574,300,326,True,4
2,47,kaist_dataset/Korean/Digital_Camera/outdoor3/DSC03237.JPG,char_data/2/DSC03237.JPG_0.jpg,1363,29,350,379,397,444,True,4
2,50,kaist_dataset/Korean/Digital_Camera/outdoor3/DSC03237.JPG,char_data/2/DSC03237.JPG_0.jpg,1650,33,379,412,396,446,True,4
2,39,kaist_dataset/Korean/Digital_Camera/outdoor3/DSC02598.JPG,char_data/2/DSC02598.JPG_0.jpg,741,19,541,560,414,453,True,4
2,44,kaist_dataset/Korean/Digital_Camera/outdoor3/DSC02994.JPG,char_data/2/DSC02994.JPG_0.jpg,968,22,76,98,66,110,True,4
2,53,kaist_dataset/Korean/Digital_Camera/outdoor3/DSC02697.JPG,char_data/2/DSC02697.JPG_0.jpg,1908,36,387,423,376,429,True,4
2,38,kaist_dataset/Korean/Digital_Camera/outdoor3/DSC03219.JPG,char_data/2/DSC03219.JPG_0.jpg,1102,29,468,497,407,445,True,4
2,35,kaist_dataset/Korean/Digital_Camera/outdoor3/DSC02939.JPG,char_data/2/DSC02939.JPG_0.jpg,805,23,287,310,364,399,True,4
2,41,kaist_dataset/Korean/Digital_Camera/outdoor3/DSC02939.JPG,char_data/2/DSC02939.JPG_0.jpg,1025,25,378,403,366,407,True,4
2,36,kaist_dataset/Korean/Digital_Camera/outdoor3/DSC02561.JPG,char_data/2/DSC02561.JPG_0.jpg,864,24,346,370,355,391,True,4
2,18,kaist_dataset/Korean/Digital_Camera/outdoor1/017.JPG,char_data/2/017.JPG_0.jpg,324,18,445,463,274,292,True,4
2,16,kaist_dataset/Korean/Digital_Camera/outdoor1/070.JPG,char_data/2/070.JPG_0.jpg,176,11,387,398,254,270,True,4
2,35,kaist_dataset/Korean/Digital_Camera/outdoor1/091.JPG,char_data/2/091.JPG_0.jpg,980,28,231,259,288,323,True,4
2,36,kaist_dataset/Korean/Digital_Camera/outdoor1/091.JPG,char_data/2/091.JPG_0.jpg,972,27,257,284,286,322,True,4
2,42,kaist_dataset/Korean/Digital_Camera/outdoor1/052.JPG,char_data/2/052.JPG_0.jpg,1008,24,350,374,321,363,True,4
2,28,kaist_dataset/Korean/Digital_Camera/outdoor1/102.JPG,char_data/2/102.JPG_0.jpg,560,20,270,290,309,337,True,4
2,29,kaist_dataset/Korean/Digital_Camera/outdoor1/102.JPG,char_data/2/102.JPG_0.jpg,551,19,290,309,311,340,True,4
2,32,kaist_dataset/Korean/Digital_Camera/outdoor1/029.JPG,char_data/2/029.JPG_0.jpg,832,26,312,338,287,319,True,4
2,40,kaist_dataset/Korean/Digital_Camera/outdoor1/127.JPG,char_data/2/127.JPG_0.jpg,1040,26,241,267,270,310,True,4
2,43,kaist_dataset/Korean/Digital_Camera/outdoor1/127.JPG,char_data/2/127.JPG_0.jpg,1247,29,267,296,269,312,True,4
2,30,kaist_dataset/Korean/Digital_Camera/outdoor1/069.JPG,char_data/2/069.JPG_0.jpg,510,17,300,317,268,298,True,4
2,20,kaist_dataset/Korean/Digital_Camera/outdoor1/126.JPG,char_data/2/126.JPG_0.jpg,500,25,246,271,267,287,True,4
2,20,kaist_dataset/Korean/Digital_Camera/outdoor1/126.JPG,char_data/2/126.JPG_0.jpg,560,28,397,425,268,288,True,4
2,26,kaist_dataset/Korean/Digital_Camera/outdoor1/126.JPG,char_data/2/126.JPG_0.jpg,286,11,470,481,255,281,True,4
2,27,kaist_dataset/Korean/Digital_Camera/outdoor1/126.JPG,char_data/2/126.JPG_0.jpg,297,11,504,515,256,283,True,4
2,33,kaist_dataset/Korean/Digital_Camera/outdoor1/023.JPG,char_data/2/023.JPG_0.jpg,759,23,256,279,266,299,True,4
2,25,kaist_dataset/Korean/Digital_Camera/outdoor1/002.JPG,char_data/2/002.JPG_0.jpg,450,18,305,323,375,400,True,4
2,44,kaist_dataset/Korean/Digital_Camera/outdoor1/098.JPG,char_data/2/098.JPG_0.jpg,1760,40,64,104,358,402,True,4
2,46,kaist_dataset/Korean/Digital_Camera/outdoor1/098.JPG,char_data/2/098.JPG_0.jpg,1564,34,104,138,355,401,True,4
2,49,kaist_dataset/Korean/Digital_Camera/outdoor1/098.JPG,char_data/2/098.JPG_0.jpg,1421,29,173,202,354,403,True,4
2,36,kaist_dataset/Korean/Digital_Camera/outdoor1/54.JPG,char_data/2/54.JPG_0.jpg,936,26,576,602,368,404,True,4
2,35,kaist_dataset/Korean/Digital_Camera/outdoor1/032.JPG,char_data/2/032.JPG_0.jpg,700,20,106,126,255,290,True,4
2,29,kaist_dataset/Korean/Digital_Camera/outdoor1/032.JPG,char_data/2/032.JPG_0.jpg,464,16,316,332,259,288,True,4
2,27,kaist_dataset/Korean/Digital_Camera/outdoor1/125.JPG,char_data/2/125.JPG_0.jpg,594,22,289,311,257,284,True,4
2,30,kaist_dataset/Korean/Digital_Camera/outdoor1/125.JPG,char_data/2/125.JPG_0.jpg,600,20,351,371,256,286,True,4
2,33,kaist_dataset/Korean/Digital_Camera/outdoor1/123.JPG,char_data/2/123.JPG_0.jpg,594,18,364,382,273,306,True,4
2,36,kaist_dataset/Korean/Digital_Camera/outdoor1/123.JPG,char_data/2/123.JPG_0.jpg,756,21,431,452,272,308,True,4
2,30,kaist_dataset/Korean/Digital_Camera/outdoor1/123.JPG,char_data/2/123.JPG_0.jpg,570,19,191,210,278,308,True,4
2,38,kaist_dataset/Korean/Digital_Camera/outdoor1/059.JPG,char_data/2/059.JPG_0.jpg,646,17,432,449,320,358,True,4
2,26,kaist_dataset/Korean/Digital_Camera/outdoor1/035.JPG,char_data/2/035.JPG_0.jpg,390,15,273,288,292,318,True,4
2,26,kaist_dataset/Korean/Digital_Camera/outdoor1/035.JPG,char_data/2/035.JPG_0.jpg,390,15,491,506,292,318,True,4
2,40,kaist_dataset/Korean/Digital_Camera/outdoor1/120.JPG,char_data/2/120.JPG_0.jpg,1520,38,239,277,296,336,True,4
2,32,kaist_dataset/Korean/Digital_Camera/outdoor1/120.JPG,char_data/2/120.JPG_0.jpg,1728,54,432,486,299,331,True,4
2,36,kaist_dataset/Mixed/Mobile_Phone/(C.M)A-outdoor/P090908006.jpg,char_data/2/P090908006.jpg_0.jpg,504,14,354,368,367,403,True,4
2,33,kaist_dataset/Mixed/Mobile_Phone/(C.M)A-outdoor/P090912040.jpg,char_data/2/P090912040.jpg_0.jpg,660,20,158,178,189,222,True,4
2,26,kaist_dataset/Mixed/Mobile_Phone/(C.M)A-outdoor/P090912040.jpg,char_data/2/P090912040.jpg_0.jpg,572,22,178,200,193,219,True,4
2,35,kaist_dataset/Mixed/Mobile_Phone/(C.M)A-outdoor/P090912038.jpg,char_data/2/P090912038.jpg_0.jpg,630,18,393,411,159,194,True,4
2,38,kaist_dataset/Mixed/Mobile_Phone/(C.M)A-outdoor/P090912047.jpg,char_data/2/P090912047.jpg_0.jpg,760,20,251,271,277,315,True,4
2,40,kaist_dataset/Mixed/Mobile_Phone/(C.M)A-outdoor/P090912047.jpg,char_data/2/P090912047.jpg_0.jpg,800,20,272,292,279,319,True,4
2,63,kaist_dataset/Mixed/Mobile_Phone/(C.M)B-indoor/P090831007.jpg,char_data/2/P090831007.jpg_0.jpg,2835,45,123,168,200,263,True,4
2,61,kaist_dataset/Mixed/Mobile_Phone/(C.M)B-indoor/P090831007.jpg,char_data/2/P090831007.jpg_0.jpg,2562,42,315,357,207,268,True,4
2,68,kaist_dataset/Mixed/Mobile_Phone/(C.M)B-indoor/P090831007.jpg,char_data/2/P090831007.jpg_0.jpg,2924,43,440,483,203,271,True,4
2,42,kaist_dataset/Mixed/Mobile_Phone/(C.M)C-bookCover/P090904004.jpg,char_data/2/P090904004.jpg_0.jpg,1260,30,578,608,399,441,True,4
2,120,kaist_dataset/Mixed/Mobile_Phone/(C.M)C-bookCover/P090831124.jpg,char_data/2/P090831124.jpg_0.jpg,9600,80,421,501,245,365,True,4
2,95,kaist_dataset/Mixed/Mobile_Phone/(C.M)C-bookCover/P090902019.jpg,char_data/2/P090902019.jpg_0.jpg,4750,50,36,86,74,169,True,4
2,75,kaist_dataset/Mixed/Mobile_Phone/(C.M)C-bookCover/P090902019.jpg,char_data/2/P090902019.jpg_0.jpg,3000,40,3,43,272,347,True,4
2,49,kaist_dataset/Mixed/Digital_Camera/(C.S)C-outdoor1/P1010012.JPG,char_data/2/P1010012.JPG_0.jpg,1617,33,489,522,235,284,True,4
2,118,kaist_dataset/Mixed/Digital_Camera/(C.S)C-outdoor1/113.JPG,char_data/2/113.JPG_0.jpg,8260,70,423,493,231,349,True,4
2,31,kaist_dataset/Mixed/Digital_Camera/(C.S)C-outdoor1/048.JPG,char_data/2/048.JPG_0.jpg,558,18,282,300,257,288,True,4
2,44,kaist_dataset/Mixed/Digital_Camera/(C.S)C-outdoor1/133.JPG,char_data/2/133.JPG_0.jpg,1056,24,18,42,221,265,True,4
2,49,kaist_dataset/Mixed/Digital_Camera/(C.S)C-outdoor1/2007-12-09-day-exterior-078.jpg,char_data/2/2007-12-09-day-exterior-078.jpg_0.jpg,1323,27,471,498,595,644,True,4
2,99,kaist_dataset/Mixed/Digital_Camera/(C.S)C-outdoor1/2007-12-08-day-092.jpg,char_data/2/2007-12-08-day-092.jpg_0.jpg,6534,66,612,678,663,762,True,4
2,96,kaist_dataset/Mixed/Digital_Camera/(C.S)C-outdoor1/2007-12-08-day-092.jpg,char_data/2/2007-12-08-day-092.jpg_0.jpg,6336,66,679,745,664,760,True,4
2,66,kaist_dataset/Mixed/Digital_Camera/(C.S)C-outdoor1/2007-12-09-day-exterior-086.jpg,char_data/2/2007-12-09-day-exterior-086.jpg_0.jpg,4290,65,1032,1097,725,791,True,4
2,52,kaist_dataset/Mixed/Digital_Camera/(C.S)C-outdoor1/080116-0084.jpg,char_data/2/080116-0084.jpg_0.jpg,1664,32,536,568,301,353,True,4
2,21,kaist_dataset/Mixed/Digital_Camera/(C.S)C-outdoor1/114.jpg,char_data/2/114.jpg_0.jpg,294,14,341,355,375,396,True,4
2,32,kaist_dataset/Mixed/Digital_Camera/(C.S)C-outdoor1/118.JPG,char_data/2/118.JPG_0.jpg,704,22,353,375,361,393,True,4
2,36,kaist_dataset/Mixed/Digital_Camera/(C.S)C-outdoor1/118.JPG,char_data/2/118.JPG_0.jpg,936,26,600,626,359,395,True,4
2,30,kaist_dataset/Mixed/Digital_Camera/(C.S)C-outdoor1/121.JPG,char_data/2/121.JPG_0.jpg,480,16,291,307,273,303,True,4
2,31,kaist_dataset/Mixed/Digital_Camera/(C.S)C-outdoor1/121.JPG,char_data/2/121.JPG_0.jpg,558,18,308,326,274,305,True,4
2,24,kaist_dataset/Mixed/Digital_Camera/(C.S)C-outdoor1/121.JPG,char_data/2/121.JPG_0.jpg,408,17,426,443,278,302,True,4
2,36,kaist_dataset/Mixed/Digital_Camera/(C.S)C-outdoor1/009.JPG,char_data/2/009.JPG_0.jpg,756,21,305,326,319,355,True,4
2,55,kaist_dataset/Mixed/Digital_Camera/(C.S)C-outdoor1/2007-12-08-day-118.jpg,char_data/2/2007-12-08-day-118.jpg_0.jpg,4290,78,1316,1394,496,551,True,4
2,60,kaist_dataset/Mixed/Digital_Camera/(C.S)C-outdoor1/2007-12-08-day-118.jpg,char_data/2/2007-12-08-day-118.jpg_0.jpg,3780,63,1486,1549,495,555,True,4
2,37,kaist_dataset/Mixed/Digital_Camera/(C.S)C-outdoor1/P1010011.JPG,char_data/2/P1010011.JPG_0.jpg,740,20,464,484,308,345,True,4
2,39,kaist_dataset/Mixed/Digital_Camera/(C.S)C-outdoor1/P1010011.JPG,char_data/2/P1010011.JPG_0.jpg,897,23,482,505,309,348,True,4
2,24,kaist_dataset/Mixed/Digital_Camera/(C.S)C-outdoor1/008.JPG,char_data/2/008.JPG_0.jpg,384,16,502,518,268,292,True,4
2,22,kaist_dataset/Mixed/Digital_Camera/(C.S)C-outdoor1/48.JPG,char_data/2/48.JPG_0.jpg,264,12,231,243,342,364,True,4
2,24,kaist_dataset/Mixed/Digital_Camera/(C.S)C-outdoor1/48.JPG,char_data/2/48.JPG_0.jpg,312,13,423,436,343,367,True,4
2,41,kaist_dataset/Mixed/Digital_Camera/(C.S)C-outdoor1/56.JPG,char_data/2/56.JPG_0.jpg,1394,34,475,509,299,340,True,4
2,22,kaist_dataset/Mixed/Digital_Camera/(C.S)C-outdoor1/047.JPG,char_data/2/047.JPG_0.jpg,242,11,562,573,173,195,True,4
2,39,kaist_dataset/Mixed/Digital_Camera/(C.S)C-outdoor1/45.JPG,char_data/2/45.JPG_0.jpg,1365,35,446,481,369,408,True,4
2,39,kaist_dataset/Mixed/Digital_Camera/(C.S)C-outdoor1/45.JPG,char_data/2/45.JPG_0.jpg,1482,38,509,547,369,408,True,4
2,44,kaist_dataset/Mixed/Digital_Camera/(C.S)C-outdoor1/P1010009.JPG,char_data/2/P1010009.JPG_0.jpg,1100,25,117,142,234,278,True,4
2,32,kaist_dataset/Mixed/Digital_Camera/(C.S)C-outdoor1/DSC02349.JPG,char_data/2/DSC02349.JPG_0.jpg,736,23,292,315,200,232,True,4
2,38,kaist_dataset/Mixed/Digital_Camera/(C.S)C-outdoor1/DSC02349.JPG,char_data/2/DSC02349.JPG_0.jpg,722,19,370,389,426,464,True,4
2,24,kaist_dataset/Mixed/Digital_Camera/(C.S)C-outdoor1/57.JPG,char_data/2/57.JPG_0.jpg,336,14,356,370,296,320,True,4
2,25,kaist_dataset/Mixed/Digital_Camera/(C.S)C-outdoor1/57.JPG,char_data/2/57.JPG_0.jpg,575,23,435,458,296,321,True,4
2,25,kaist_dataset/Mixed/Digital_Camera/(C.S)C-outdoor1/57.JPG,char_data/2/57.JPG_0.jpg,425,17,606,623,300,325,True,4
2,24,kaist_dataset/Mixed/Digital_Camera/(C.S)C-outdoor1/57.JPG,char_data/2/57.JPG_0.jpg,384,16,656,672,302,326,True,4
2,26,kaist_dataset/Mixed/Digital_Camera/(C.S)C-outdoor1/57.JPG,char_data/2/57.JPG_0.jpg,338,13,436,449,455,481,True,4
2,23,kaist_dataset/Mixed/Digital_Camera/(C.S)C-outdoor1/57.JPG,char_data/2/57.JPG_0.jpg,299,13,478,491,459,482,True,4
2,19,kaist_dataset/Mixed/Digital_Camera/(C.S)C-outdoor1/054.JPG,char_data/2/054.JPG_0.jpg,342,18,534,552,308,327,True,4
2,40,kaist_dataset/Mixed/Digital_Camera/(C.S)C-outdoor1/DSC02312.JPG,char_data/2/DSC02312.JPG_0.jpg,1280,32,166,198,219,259,True,4
2,42,kaist_dataset/Mixed/Digital_Camera/(C.S)C-outdoor1/DSC02312.JPG,char_data/2/DSC02312.JPG_0.jpg,1638,39,331,370,221,263,True,4
2,36,kaist_dataset/Mixed/Digital_Camera/(C.S)C-outdoor1/DSC02312.JPG,char_data/2/DSC02312.JPG_0.jpg,1692,47,426,473,223,259,True,4
2,56,kaist_dataset/Mixed/Digital_Camera/(C.S)C-outdoor1/080119-0003.jpg,char_data/2/080119-0003.jpg_0.jpg,1904,34,553,587,1397,1453,True,4
2,54,kaist_dataset/Mixed/Digital_Camera/(C.S)C-outdoor1/080119-0003.jpg,char_data/2/080119-0003.jpg_0.jpg,1674,31,608,639,1398,1452,True,4
2,37,kaist_dataset/Mixed/Digital_Camera/(C.S)C-outdoor1/DSC02350.JPG,char_data/2/DSC02350.JPG_0.jpg,962,26,267,293,399,436,True,4
2,43,kaist_dataset/Mixed/Digital_Camera/(C.S)C-outdoor1/DSC02350.JPG,char_data/2/DSC02350.JPG_0.jpg,1204,28,292,320,398,441,True,4
2,39,kaist_dataset/Mixed/Digital_Camera/(C.S)C-outdoor1/DSC02350.JPG,char_data/2/DSC02350.JPG_0.jpg,1092,28,342,370,396,435,True,4
2,44,kaist_dataset/Mixed/Digital_Camera/(C.S)C-outdoor1/DSC02350.JPG,char_data/2/DSC02350.JPG_0.jpg,1144,26,371,397,396,440,True,4
2,43,kaist_dataset/Mixed/Digital_Camera/(C.S)C-outdoor1/2007-12-09-day-exterior-037.jpg,char_data/2/2007-12-09-day-exterior-037.jpg_0.jpg,1763,41,739,780,707,750,True,4
2,50,kaist_dataset/Mixed/Digital_Camera/(C.S)C-outdoor1/2007-12-09-day-exterior-037.jpg,char_data/2/2007-12-09-day-exterior-037.jpg_0.jpg,2000,40,842,882,701,751,True,4
2,44,kaist_dataset/Mixed/Digital_Camera/(C.S)C-outdoor1/2007-12-09-day-exterior-037.jpg,char_data/2/2007-12-09-day-exterior-037.jpg_0.jpg,1628,37,885,922,706,750,True,4
2,61,kaist_dataset/Mixed/Digital_Camera/(C.S)C-outdoor1/105.jpg,char_data/2/105.jpg_0.jpg,2379,39,402,441,365,426,True,4
2,109,kaist_dataset/Mixed/Digital_Camera/(C.S)C-outdoor1/DSC02244.JPG,char_data/2/DSC02244.JPG_0.jpg,7848,72,267,339,113,222,True,4
2,37,kaist_dataset/Mixed/Digital_Camera/(C.S)C-outdoor1/2007-12-08-day-130.jpg,char_data/2/2007-12-08-day-130.jpg_0.jpg,1110,30,1071,1101,759,796,True,4
2,52,kaist_dataset/Mixed/Digital_Camera/(C.S)C-outdoor1/025.JPG,char_data/2/025.JPG_0.jpg,1404,27,436,463,342,394,True,4
2,22,kaist_dataset/Mixed/Digital_Camera/(C.S)C-outdoor1/2.JPG,char_data/2/2.JPG_0.jpg,242,11,570,581,397,419,True,4
2,42,kaist_dataset/Mixed/Digital_Camera/(C.S)C-outdoor1/DSC02322.JPG,char_data/2/DSC02322.JPG_0.jpg,1092,26,190,216,364,406,True,4
2,56,kaist_dataset/Mixed/Digital_Camera/(C.S)C-outdoor1/2007-12-08-day-091.jpg,char_data/2/2007-12-08-day-091.jpg_0.jpg,2016,36,1133,1169,634,690,True,4
2,62,kaist_dataset/Mixed/Digital_Camera/(C.S)C-outdoor1/2007-12-08-day-091.jpg,char_data/2/2007-12-08-day-091.jpg_0.jpg,2356,38,1174,1212,630,692,True,4
2,26,kaist_dataset/Mixed/Digital_Camera/(C.S)C-outdoor1/090.JPG,char_data/2/090.JPG_0.jpg,598,23,350,373,396,422,True,4
2,29,kaist_dataset/Mixed/Digital_Camera/(C.S)C-outdoor1/090.JPG,char_data/2/090.JPG_0.jpg,609,21,373,394,394,423,True,4
2,36,kaist_dataset/Mixed/Digital_Camera/(C.S)F-others/DSC02504.JPG,char_data/2/DSC02504.JPG_0.jpg,1152,32,323,355,350,386,True,4
2,49,kaist_dataset/Mixed/Digital_Camera/(C.S)F-others/2007-12-08-day-113.jpg,char_data/2/2007-12-08-day-113.jpg_0.jpg,1176,24,919,943,422,471,True,4
2,98,kaist_dataset/Mixed/Digital_Camera/(C.S)F-others/097.jpg,char_data/2/097.jpg_0.jpg,6860,70,449,519,167,265,True,4
2,88,kaist_dataset/Mixed/Digital_Camera/(C.S)F-others/DSC03224.JPG,char_data/2/DSC03224.JPG_0.jpg,6160,70,186,256,341,429,True,4
2,43,kaist_dataset/Mixed/Digital_Camera/(C.S)D-indoor2/DSC04256.JPG,char_data/2/DSC04256.JPG_0.jpg,903,21,516,537,107,150,True,4
2,45,kaist_dataset/Mixed/Digital_Camera/(C.S)D-indoor2/DSC04256.JPG,char_data/2/DSC04256.JPG_0.jpg,900,20,475,495,142,187,True,4
2,64,kaist_dataset/Mixed/Digital_Camera/(C.S)D-indoor2/DSC04409.JPG,char_data/2/DSC04409.JPG_0.jpg,1600,25,499,524,156,220,True,4
2,23,kaist_dataset/Mixed/Digital_Camera/(C.S)E-night/P1010155.JPG,char_data/2/P1010155.JPG_0.jpg,299,13,462,475,286,309,True,4
2,23,kaist_dataset/Mixed/Digital_Camera/(C.S)E-night/P1010155.JPG,char_data/2/P1010155.JPG_0.jpg,299,13,493,506,288,311,True,4
2,67,kaist_dataset/Mixed/Digital_Camera/(C.S)E-night/DSC02574.JPG,char_data/2/DSC02574.JPG_0.jpg,2144,32,441,473,409,476,True,4
2,36,kaist_dataset/Mixed/Digital_Camera/(C.S)E-night/DSC02585.JPG,char_data/2/DSC02585.JPG_0.jpg,612,17,481,498,417,453,True,4
2,32,kaist_dataset/Mixed/Digital_Camera/(C.S)E-night/DSC02644.JPG,char_data/2/DSC02644.JPG_0.jpg,544,17,395,412,401,433,True,4
2,72,kaist_dataset/Mixed/Digital_Camera/(C.S)E-night/P1010151.JPG,char_data/2/P1010151.JPG_0.jpg,4104,57,275,332,355,427,True,4
2,50,kaist_dataset/Mixed/Digital_Camera/(C.S)E-night/DSC02575.JPG,char_data/2/DSC02575.JPG_0.jpg,1350,27,324,351,356,406,True,4
2,47,kaist_dataset/Mixed/Digital_Camera/(C.S)E-night/DSC02575.JPG,char_data/2/DSC02575.JPG_0.jpg,1504,32,496,528,363,410,True,4
2,31,kaist_dataset/Mixed/Digital_Camera/(C.S)E-night/DSC02678.JPG,char_data/2/DSC02678.JPG_0.jpg,527,17,461,478,389,420,True,4
2,40,kaist_dataset/Mixed/Digital_Camera/(C.S)E-night/DSC02673.JPG,char_data/2/DSC02673.JPG_0.jpg,600,15,314,329,301,341,True,4
2,28,kaist_dataset/Mixed/Digital_Camera/(C.S)E-night/DSC02673.JPG,char_data/2/DSC02673.JPG_0.jpg,476,17,482,499,305,333,True,4
2,36,kaist_dataset/Mixed/Digital_Camera/(C.S)E-night/DSC02673.JPG,char_data/2/DSC02673.JPG_0.jpg,612,17,507,524,304,340,True,4
2,51,kaist_dataset/Mixed/Digital_Camera/(C.S)E-night/DSC03561.JPG,char_data/2/DSC03561.JPG_0.jpg,1938,38,291,329,252,303,True,4
2,39,kaist_dataset/Mixed/Digital_Camera/(C.S)E-night/DSC02569.JPG,char_data/2/DSC02569.JPG_0.jpg,819,21,292,313,412,451,True,4
2,39,kaist_dataset/Mixed/Digital_Camera/(C.S)E-night/DSC02623.JPG,char_data/2/DSC02623.JPG_0.jpg,585,15,129,144,398,437,True,4
2,36,kaist_dataset/Mixed/Digital_Camera/(C.S)E-night/DSC02623.JPG,char_data/2/DSC02623.JPG_0.jpg,1188,33,571,604,406,442,True,4
2,68,kaist_dataset/Mixed/Digital_Camera/(C.S)E-night/DSC02600.JPG,char_data/2/DSC02600.JPG_0.jpg,5916,87,108,195,191,259,True,4
2,29,kaist_dataset/Mixed/Digital_Camera/(C.S)E-night/DSC02903.JPG,char_data/2/DSC02903.JPG_0.jpg,522,18,336,354,269,298,True,4
2,66,kaist_dataset/Mixed/Digital_Camera/(C.S)E-night/DSC02573.JPG,char_data/2/DSC02573.JPG_0.jpg,2574,39,518,557,147,213,True,4
2,34,kaist_dataset/Mixed/Digital_Camera/(C.S)B-light/DSC03298.JPG,char_data/2/DSC03298.JPG_0.jpg,510,15,425,440,289,323,True,4
2,96,kaist_dataset/Mixed/Digital_Camera/(C.S)D-indoor1/DSC04003.JPG,char_data/2/DSC04003.JPG_0.jpg,6624,69,264,333,87,183,True,4
2,26,kaist_dataset/Mixed/Digital_Camera/(C.S)D-indoor1/DSC04005.JPG,char_data/2/DSC04005.JPG_0.jpg,442,17,440,457,439,465,True,4
2,75,kaist_dataset/Mixed/Digital_Camera/(C.S)D-indoor1/DSC03999.JPG,char_data/2/DSC03999.JPG_0.jpg,3225,43,501,544,288,363,True,4
2,43,kaist_dataset/Mixed/Digital_Camera/(C.S)D-indoor1/DSC02785.JPG,char_data/2/DSC02785.JPG_0.jpg,1376,32,39,71,293,336,True,4
2,58,kaist_dataset/Mixed/Digital_Camera/(C.S)D-indoor1/DSC04002.JPG,char_data/2/DSC04002.JPG_0.jpg,2436,42,0,42,303,361,True,4
2,49,kaist_dataset/Mixed/Digital_Camera/(C.S)D-indoor1/DSC03986.JPG,char_data/2/DSC03986.JPG_0.jpg,784,16,181,197,161,210,True,4
2,45,kaist_dataset/Mixed/Digital_Camera/(C.S)D-indoor1/DSC03986.JPG,char_data/2/DSC03986.JPG_0.jpg,720,16,456,472,164,209,True,4
2,83,kaist_dataset/Mixed/Digital_Camera/(C.S)D-indoor1/DSC03466.JPG,char_data/2/DSC03466.JPG_0.jpg,6225,75,57,132,129,212,True,4
2,47,kaist_dataset/Mixed/Digital_Camera/(C.S)D-indoor1/DSC02733.JPG,char_data/2/DSC02733.JPG_0.jpg,1410,30,261,291,396,443,True,4
2,49,kaist_dataset/Mixed/Digital_Camera/(C.S)D-indoor1/DSC02733.JPG,char_data/2/DSC02733.JPG_0.jpg,1568,32,289,321,396,445,True,4
2,59,kaist_dataset/Mixed/Digital_Camera/(C.S)D-indoor1/DSC03980.JPG,char_data/2/DSC03980.JPG_0.jpg,2714,46,42,88,296,355,True,4
2,41,kaist_dataset/Mixed/Digital_Camera/(C.S)D-indoor1/DSC02782.JPG,char_data/2/DSC02782.JPG_0.jpg,1476,36,47,83,233,274,True,4
2,38,kaist_dataset/Mixed/Digital_Camera/(C.S)D-indoor1/DSC02718.JPG,char_data/2/DSC02718.JPG_0.jpg,760,20,95,115,188,226,True,4
2,38,kaist_dataset/Mixed/Digital_Camera/(C.S)C-outdoor5/DSC04098.JPG,char_data/2/DSC04098.JPG_0.jpg,532,14,506,520,311,349,True,4
2,53,kaist_dataset/Mixed/Digital_Camera/(C.S)C-outdoor5/DSC03847.JPG,char_data/2/DSC03847.JPG_0.jpg,1431,27,382,409,16,69,True,4
2,114,kaist_dataset/Mixed/Digital_Camera/(C.S)C-outdoor5/DSC04449.JPG,char_data/2/DSC04449.JPG_0.jpg,8550,75,142,217,37,151,True,4
2,42,kaist_dataset/Mixed/Digital_Camera/(C.S)C-outdoor5/P1010007.JPG,char_data/2/P1010007.JPG_0.jpg,1218,29,288,317,269,311,True,4
2,38,kaist_dataset/Mixed/Digital_Camera/(C.S)C-outdoor5/P1010007.JPG,char_data/2/P1010007.JPG_0.jpg,988,26,441,467,273,311,True,4
2,39,kaist_dataset/Mixed/Digital_Camera/(C.S)C-outdoor5/P1010007.JPG,char_data/2/P1010007.JPG_0.jpg,1209,31,467,498,268,307,True,4
2,30,kaist_dataset/Mixed/Digital_Camera/(C.S)C-outdoor5/DSC04146.JPG,char_data/2/DSC04146.JPG_0.jpg,510,17,306,323,406,436,True,4
2,28,kaist_dataset/Mixed/Digital_Camera/(C.S)C-outdoor5/DSC04146.JPG,char_data/2/DSC04146.JPG_0.jpg,532,19,332,351,409,437,True,4
2,80,kaist_dataset/Mixed/Digital_Camera/(C.S)C-outdoor5/DSC04111.JPG,char_data/2/DSC04111.JPG_0.jpg,4400,55,473,528,103,183,True,4
2,41,kaist_dataset/Mixed/Digital_Camera/(C.S)C-outdoor5/DSC04144.JPG,char_data/2/DSC04144.JPG_0.jpg,820,20,284,304,414,455,True,4
2,44,kaist_dataset/Mixed/Digital_Camera/(C.S)C-outdoor5/DSC04094.JPG,char_data/2/DSC04094.JPG_0.jpg,1716,39,196,235,387,431,True,4
2,30,kaist_dataset/Mixed/Digital_Camera/(C.S)C-outdoor5/DSC04155.JPG,char_data/2/DSC04155.JPG_0.jpg,450,15,557,572,264,294,True,4
2,36,kaist_dataset/Mixed/Digital_Camera/(C.S)C-outdoor5/DSC03839.JPG,char_data/2/DSC03839.JPG_0.jpg,720,20,383,403,366,402,True,4
2,42,kaist_dataset/Mixed/Digital_Camera/(C.S)C-outdoor5/DSC04337.JPG,char_data/2/DSC04337.JPG_0.jpg,882,21,352,373,318,360,True,4
2,41,kaist_dataset/Mixed/Digital_Camera/(C.S)C-outdoor5/DSC04337.JPG,char_data/2/DSC04337.JPG_0.jpg,1107,27,373,400,318,359,True,4
2,139,kaist_dataset/Mixed/Digital_Camera/(C.S)C-outdoor5/DSC04330.JPG,char_data/2/DSC04330.JPG_0.jpg,8201,59,82,141,242,381,True,4
2,39,kaist_dataset/Mixed/Digital_Camera/(C.S)C-outdoor5/DSC04330.JPG,char_data/2/DSC04330.JPG_0.jpg,1092,28,421,449,171,210,True,4
2,51,kaist_dataset/Mixed/Digital_Camera/(C.S)C-outdoor5/DSC04330.JPG,char_data/2/DSC04330.JPG_0.jpg,1632,32,386,418,368,419,True,4
2,63,kaist_dataset/Mixed/Digital_Camera/(C.S)C-outdoor5/DSC04330.JPG,char_data/2/DSC04330.JPG_0.jpg,1638,26,461,487,360,423,True,4
2,80,kaist_dataset/Mixed/Digital_Camera/(C.S)C-outdoor5/DSC04016.JPG,char_data/2/DSC04016.JPG_0.jpg,4240,53,478,531,105,185,True,4
2,25,kaist_dataset/Mixed/Digital_Camera/(C.S)C-outdoor5/DSC04151.JPG,char_data/2/DSC04151.JPG_0.jpg,425,17,512,529,349,374,True,4
2,59,kaist_dataset/Mixed/Digital_Camera/(C.S)C-outdoor5/DSC03819.JPG,char_data/2/DSC03819.JPG_0.jpg,2478,42,223,265,118,177,True,4
2,36,kaist_dataset/Mixed/Digital_Camera/(C.S)C-outdoor5/DSC03819.JPG,char_data/2/DSC03819.JPG_0.jpg,432,12,454,466,373,409,True,4
2,67,kaist_dataset/Mixed/Digital_Camera/(C.S)C-outdoor5/DSC04364.JPG,char_data/2/DSC04364.JPG_0.jpg,2345,35,182,217,391,458,True,4
2,35,kaist_dataset/Mixed/Digital_Camera/(C.S)C-outdoor5/DSC04122.JPG,char_data/2/DSC04122.JPG_0.jpg,420,12,359,371,413,448,True,4
2,32,kaist_dataset/Mixed/Digital_Camera/(C.S)C-outdoor5/DSC04124.JPG,char_data/2/DSC04124.JPG_0.jpg,512,16,493,509,307,339,True,4
2,63,kaist_dataset/Mixed/Digital_Camera/(C.S)C-outdoor5/DSC04401.JPG,char_data/2/DSC04401.JPG_0.jpg,2079,33,397,430,244,307,True,4
2,43,kaist_dataset/Mixed/Digital_Camera/(C.S)C-outdoor5/DSC04071.JPG,char_data/2/DSC04071.JPG_0.jpg,1118,26,142,168,360,403,True,4
2,45,kaist_dataset/Mixed/Digital_Camera/(C.S)C-outdoor5/DSC04071.JPG,char_data/2/DSC04071.JPG_0.jpg,1080,24,212,236,358,403,True,4
2,34,kaist_dataset/Mixed/Digital_Camera/(C.S)C-outdoor5/DSC04071.JPG,char_data/2/DSC04071.JPG_0.jpg,646,19,510,529,366,400,True,4
2,44,kaist_dataset/Mixed/Digital_Camera/(C.S)C-outdoor5/DSC04014.JPG,char_data/2/DSC04014.JPG_0.jpg,792,18,246,264,300,344,True,4
2,38,kaist_dataset/Mixed/Digital_Camera/(C.S)C-outdoor5/DSC04014.JPG,char_data/2/DSC04014.JPG_0.jpg,950,25,421,446,303,341,True,4
2,41,kaist_dataset/Mixed/Digital_Camera/(C.S)C-outdoor5/DSC03821.JPG,char_data/2/DSC03821.JPG_0.jpg,984,24,254,278,78,119,True,4
2,67,kaist_dataset/Mixed/Digital_Camera/(C.S)C-outdoor5/DSC03837.JPG,char_data/2/DSC03837.JPG_0.jpg,2546,38,162,200,296,363,True,4
2,26,kaist_dataset/Mixed/Digital_Camera/(C.S)C-outdoor5/P1010004.JPG,char_data/2/P1010004.JPG_0.jpg,364,14,321,335,308,334,True,4
2,31,kaist_dataset/Mixed/Digital_Camera/(C.S)C-outdoor5/P1010004.JPG,char_data/2/P1010004.JPG_0.jpg,713,23,394,417,308,339,True,4
2,45,kaist_dataset/Mixed/Digital_Camera/(C.S)C-outdoor5/DSC04125.JPG,char_data/2/DSC04125.JPG_0.jpg,1080,24,90,114,175,220,True,4
2,37,kaist_dataset/Mixed/Digital_Camera/(C.S)C-outdoor5/DSC04125.JPG,char_data/2/DSC04125.JPG_0.jpg,851,23,466,489,417,454,True,4
2,42,kaist_dataset/Mixed/Digital_Camera/(C.S)C-outdoor5/DSC04125.JPG,char_data/2/DSC04125.JPG_0.jpg,1218,29,569,598,413,455,True,4
2,67,kaist_dataset/Mixed/Digital_Camera/(C.S)C-outdoor5/DSC04450.JPG,char_data/2/DSC04450.JPG_0.jpg,4556,68,251,319,264,331,True,4
2,29,kaist_dataset/Mixed/Digital_Camera/(C.S)C-outdoor5/DSC04150.JPG,char_data/2/DSC04150.JPG_0.jpg,348,12,518,530,364,393,True,4
2,55,kaist_dataset/Mixed/Digital_Camera/(C.S)C-outdoor5/DSC04017.JPG,char_data/2/DSC04017.JPG_0.jpg,3850,70,110,180,3,58,True,4
2,50,kaist_dataset/Mixed/Digital_Camera/(C.S)C-outdoor5/DSC04017.JPG,char_data/2/DSC04017.JPG_0.jpg,1850,37,436,473,425,475,True,4
2,34,kaist_dataset/Mixed/Digital_Camera/(C.S)C-outdoor5/DSC04048.JPG,char_data/2/DSC04048.JPG_0.jpg,578,17,340,357,170,204,True,4
2,46,kaist_dataset/Mixed/Digital_Camera/(C.S)C-outdoor5/DSC04135.JPG,char_data/2/DSC04135.JPG_0.jpg,1242,27,449,476,384,430,True,4
2,41,kaist_dataset/Mixed/Digital_Camera/(C.S)C-outdoor5/DSC04135.JPG,char_data/2/DSC04135.JPG_0.jpg,1025,25,487,512,392,433,True,4
2,28,kaist_dataset/Mixed/Digital_Camera/(C.S)C-outdoor5/DSC04054.JPG,char_data/2/DSC04054.JPG_0.jpg,812,29,549,578,158,186,True,4
2,43,kaist_dataset/Mixed/Digital_Camera/(C.S)C-outdoor5/DSC04055.JPG,char_data/2/DSC04055.JPG_0.jpg,1505,35,540,575,373,416,True,4
2,43,kaist_dataset/Mixed/Digital_Camera/(C.S)C-outdoor5/DSC04057.JPG,char_data/2/DSC04057.JPG_0.jpg,1376,32,502,534,323,366,True,4
2,36,kaist_dataset/Mixed/Digital_Camera/(C.S)C-outdoor5/DSC04056.JPG,char_data/2/DSC04056.JPG_0.jpg,1008,28,453,481,259,295,True,4
2,30,kaist_dataset/Mixed/Digital_Camera/(C.S)C-outdoor5/DSC04056.JPG,char_data/2/DSC04056.JPG_0.jpg,600,20,506,526,303,333,True,4
2,48,kaist_dataset/Mixed/Digital_Camera/(C.S)C-outdoor3/DSC03241.JPG,char_data/2/DSC03241.JPG_0.jpg,1728,36,302,338,308,356,True,4
2,53,kaist_dataset/Mixed/Digital_Camera/(C.S)C-outdoor3/DSC03189.JPG,char_data/2/DSC03189.JPG_0.jpg,1484,28,413,441,300,353,True,4
2,51,kaist_dataset/Mixed/Digital_Camera/(C.S)C-outdoor3/DSC03189.JPG,char_data/2/DSC03189.JPG_0.jpg,1632,32,503,535,301,352,True,4
2,42,kaist_dataset/Mixed/Digital_Camera/(C.S)C-outdoor3/DSC03316.JPG,char_data/2/DSC03316.JPG_0.jpg,882,21,545,566,77,119,True,4
2,23,kaist_dataset/Mixed/Digital_Camera/(C.S)C-outdoor3/DSC03292.JPG,char_data/2/DSC03292.JPG_0.jpg,276,12,579,591,121,144,True,4
2,41,kaist_dataset/Mixed/Digital_Camera/(C.S)C-outdoor3/DSC02958.JPG,char_data/2/DSC02958.JPG_0.jpg,1107,27,284,311,401,442,True,4
2,40,kaist_dataset/Mixed/Digital_Camera/(C.S)C-outdoor3/DSC02958.JPG,char_data/2/DSC02958.JPG_0.jpg,1040,26,336,362,400,440,True,4
2,42,kaist_dataset/Mixed/Digital_Camera/(C.S)C-outdoor3/DSC02958.JPG,char_data/2/DSC02958.JPG_0.jpg,1176,28,412,440,402,444,True,4
2,48,kaist_dataset/Mixed/Digital_Camera/(C.S)C-outdoor3/DSC03310.JPG,char_data/2/DSC03310.JPG_0.jpg,2592,54,525,579,323,371,True,4
2,19,kaist_dataset/Mixed/Digital_Camera/(C.S)C-outdoor3/DSC03303.JPG,char_data/2/DSC03303.JPG_0.jpg,456,24,565,589,109,128,True,4
2,24,kaist_dataset/Mixed/Digital_Camera/(C.S)C-outdoor3/DSC03303.JPG,char_data/2/DSC03303.JPG_0.jpg,624,26,297,323,280,304,True,4
2,31,kaist_dataset/Mixed/Digital_Camera/(C.S)C-outdoor3/DSC03303.JPG,char_data/2/DSC03303.JPG_0.jpg,899,29,574,603,273,304,True,4
2,30,kaist_dataset/Mixed/Digital_Camera/(C.S)C-outdoor3/DSC03062.JPG,char_data/2/DSC03062.JPG_0.jpg,540,18,296,314,247,277,True,4
2,35,kaist_dataset/Mixed/Digital_Camera/(C.S)C-outdoor3/DSC03312.JPG,char_data/2/DSC03312.JPG_0.jpg,1365,39,189,228,285,320,True,4
2,26,kaist_dataset/Mixed/Digital_Camera/(C.S)C-outdoor3/DSC03255.JPG,char_data/2/DSC03255.JPG_0.jpg,442,17,314,331,184,210,True,4
2,28,kaist_dataset/Mixed/Digital_Camera/(C.S)C-outdoor3/DSC03255.JPG,char_data/2/DSC03255.JPG_0.jpg,644,23,330,353,182,210,True,4
2,44,kaist_dataset/Mixed/Digital_Camera/(C.S)C-outdoor3/DSC03323.JPG,char_data/2/DSC03323.JPG_0.jpg,1100,25,244,269,299,343,True,4
2,48,kaist_dataset/Mixed/Digital_Camera/(C.S)C-outdoor3/DSC03323.JPG,char_data/2/DSC03323.JPG_0.jpg,1296,27,317,344,291,339,True,4
2,45,kaist_dataset/Mixed/Digital_Camera/(C.S)C-outdoor3/DSC03323.JPG,char_data/2/DSC03323.JPG_0.jpg,1440,32,371,403,291,336,True,4
2,50,kaist_dataset/Mixed/Digital_Camera/(C.S)C-outdoor3/DSC03164.JPG,char_data/2/DSC03164.JPG_0.jpg,1900,38,368,406,211,261,True,4
2,47,kaist_dataset/Mixed/Digital_Camera/(C.S)C-outdoor3/DSC03212.JPG,char_data/2/DSC03212.JPG_0.jpg,846,18,375,393,248,295,True,4
2,44,kaist_dataset/Mixed/Digital_Camera/(C.S)C-outdoor3/DSC03212.JPG,char_data/2/DSC03212.JPG_0.jpg,1056,24,498,522,252,296,True,4
2,34,kaist_dataset/Mixed/Digital_Camera/(C.S)C-outdoor3/DSC03328.JPG,char_data/2/DSC03328.JPG_0.jpg,544,16,233,249,403,437,True,4
2,39,kaist_dataset/Mixed/Digital_Camera/(C.S)C-outdoor3/DSC03328.JPG,char_data/2/DSC03328.JPG_0.jpg,741,19,420,439,399,438,True,4
2,47,kaist_dataset/Mixed/Digital_Camera/(C.S)C-outdoor3/DSC03236.JPG,char_data/2/DSC03236.JPG_0.jpg,940,20,62,82,186,233,True,4
2,51,kaist_dataset/Mixed/Digital_Camera/(C.S)C-outdoor3/DSC03004.JPG,char_data/2/DSC03004.JPG_0.jpg,1530,30,569,599,356,407,True,4
2,26,kaist_dataset/Mixed/Digital_Camera/(C.S)C-outdoor3/DSC03315.JPG,char_data/2/DSC03315.JPG_0.jpg,468,18,378,396,124,150,True,4
2,25,kaist_dataset/Mixed/Digital_Camera/(C.S)C-outdoor3/DSC03315.JPG,char_data/2/DSC03315.JPG_0.jpg,400,16,541,557,121,146,True,4
2,37,kaist_dataset/Mixed/Digital_Camera/(C.S)C-outdoor3/DSC03301.JPG,char_data/2/DSC03301.JPG_0.jpg,814,22,438,460,139,176,True,4
2,33,kaist_dataset/Mixed/Digital_Camera/(C.S)C-outdoor3/DSC03301.JPG,char_data/2/DSC03301.JPG_0.jpg,693,21,479,500,138,171,True,4
2,42,kaist_dataset/Mixed/Digital_Camera/(C.S)C-outdoor3/DSC02956.JPG,char_data/2/DSC02956.JPG_0.jpg,1050,25,275,300,398,440,True,4
2,56,kaist_dataset/Mixed/Digital_Camera/(C.S)C-outdoor3/DSC03314.JPG,char_data/2/DSC03314.JPG_0.jpg,1904,34,294,328,362,418,True,4
2,57,kaist_dataset/Mixed/Digital_Camera/(C.S)C-outdoor3/DSC03314.JPG,char_data/2/DSC03314.JPG_0.jpg,1938,34,397,431,361,418,True,4
2,57,kaist_dataset/Mixed/Digital_Camera/(C.S)C-outdoor3/DSC03269.JPG,char_data/2/DSC03269.JPG_0.jpg,2451,43,396,439,360,417,True,4
2,33,kaist_dataset/Mixed/Digital_Camera/(C.S)C-outdoor3/DSC03311.JPG,char_data/2/DSC03311.JPG_0.jpg,462,14,320,334,370,403,True,4
2,170,kaist_dataset/Mixed/Digital_Camera/(C.S)C-outdoor3/DSC03010.JPG,char_data/2/DSC03010.JPG_0.jpg,16830,99,182,281,171,341,True,4
2,37,kaist_dataset/Mixed/Digital_Camera/(C.S)C-outdoor3/DSC02969.JPG,char_data/2/DSC02969.JPG_0.jpg,925,25,312,337,231,268,True,4
2,30,kaist_dataset/Mixed/Digital_Camera/(C.S)C-outdoor3/DSC03250.JPG,char_data/2/DSC03250.JPG_0.jpg,570,19,485,504,403,433,True,4
2,35,kaist_dataset/Mixed/Digital_Camera/(C.S)C-outdoor3/DSC03250.JPG,char_data/2/DSC03250.JPG_0.jpg,735,21,533,554,402,437,True,4
2,33,kaist_dataset/Mixed/Digital_Camera/(C.S)C-outdoor3/DSC03250.JPG,char_data/2/DSC03250.JPG_0.jpg,726,22,553,575,403,436,True,4
2,38,kaist_dataset/Mixed/Digital_Camera/(C.S)C-outdoor3/DSC03259.JPG,char_data/2/DSC03259.JPG_0.jpg,684,18,445,463,352,390,True,4
2,54,kaist_dataset/Mixed/Digital_Camera/(C.S)C-outdoor3/DSC03242.JPG,char_data/2/DSC03242.JPG_0.jpg,3510,65,199,264,367,421,True,4
2,35,kaist_dataset/Mixed/Digital_Camera/(C.S)C-outdoor3/DSC03308.JPG,char_data/2/DSC03308.JPG_0.jpg,805,23,251,274,248,283,True,4
2,27,kaist_dataset/Mixed/Digital_Camera/(C.S)C-outdoor6/P1010062.JPG,char_data/2/P1010062.JPG_0.jpg,729,27,570,597,259,286,True,4
2,24,kaist_dataset/Mixed/Digital_Camera/(C.S)C-outdoor6/P1010063.JPG,char_data/2/P1010063.JPG_0.jpg,480,20,165,185,455,479,True,4
2,31,kaist_dataset/Mixed/Digital_Camera/(C.S)C-outdoor6/P1010069.JPG,char_data/2/P1010069.JPG_0.jpg,992,32,496,528,313,344,True,4
2,28,kaist_dataset/Mixed/Digital_Camera/(C.S)C-outdoor6/P1010088.JPG,char_data/2/P1010088.JPG_0.jpg,336,12,386,398,215,243,True,4
2,27,kaist_dataset/Mixed/Digital_Camera/(C.S)C-outdoor6/P1010088.JPG,char_data/2/P1010088.JPG_0.jpg,567,21,398,419,217,244,True,4
2,41,kaist_dataset/Mixed/Digital_Camera/(C.S)C-outdoor6/P1010120.JPG,char_data/2/P1010120.JPG_0.jpg,1148,28,395,423,192,233,True,4
2,33,kaist_dataset/Mixed/Digital_Camera/(C.S)C-outdoor6/P1010020.JPG,char_data/2/P1010020.JPG_0.jpg,561,17,172,189,339,372,True,4
2,37,kaist_dataset/Mixed/Digital_Camera/(C.S)C-outdoor6/P1010020.JPG,char_data/2/P1010020.JPG_0.jpg,777,21,263,284,333,370,True,4
2,33,kaist_dataset/Mixed/Digital_Camera/(C.S)C-outdoor6/P1010020.JPG,char_data/2/P1010020.JPG_0.jpg,726,22,218,240,232,265,True,4
2,33,kaist_dataset/Mixed/Digital_Camera/(C.S)C-outdoor6/P1010080.JPG,char_data/2/P1010080.JPG_0.jpg,1122,34,584,618,247,280,True,4
2,39,kaist_dataset/Mixed/Digital_Camera/(C.S)C-outdoor6/P1010098.JPG,char_data/2/P1010098.JPG_0.jpg,1014,26,489,515,52,91,True,4
2,62,kaist_dataset/Mixed/Digital_Camera/(C.S)C-outdoor6/P1010017.JPG,char_data/2/P1010017.JPG_0.jpg,1798,29,389,418,181,243,True,4
2,67,kaist_dataset/Mixed/Digital_Camera/(C.S)C-outdoor6/P1010017.JPG,char_data/2/P1010017.JPG_0.jpg,1809,27,444,471,178,245,True,4
2,28,kaist_dataset/Mixed/Digital_Camera/(C.S)C-outdoor6/P1010085.JPG,char_data/2/P1010085.JPG_0.jpg,448,16,414,430,158,186,True,4
2,32,kaist_dataset/Mixed/Digital_Camera/(C.S)C-outdoor6/P1010093.JPG,char_data/2/P1010093.JPG_0.jpg,480,15,554,569,243,275,True,4
2,50,kaist_dataset/Mixed/Digital_Camera/(C.S)C-outdoor6/P1010127.JPG,char_data/2/P1010127.JPG_0.jpg,2400,48,434,482,283,333,True,4
2,42,kaist_dataset/Mixed/Digital_Camera/(C.S)C-outdoor6/P1010021.JPG,char_data/2/P1010021.JPG_0.jpg,1092,26,140,166,210,252,True,4
2,39,kaist_dataset/Mixed/Digital_Camera/(C.S)C-outdoor6/P1010021.JPG,char_data/2/P1010021.JPG_0.jpg,936,24,589,613,201,240,True,4
2,49,kaist_dataset/Mixed/Digital_Camera/(C.S)C-outdoor6/P1010084.JPG,char_data/2/P1010084.JPG_0.jpg,1911,39,378,417,188,237,True,4
2,25,kaist_dataset/Mixed/Digital_Camera/(C.S)C-outdoor6/P1010129.JPG,char_data/2/P1010129.JPG_0.jpg,700,28,548,576,234,259,True,4
2,26,kaist_dataset/Mixed/Digital_Camera/(C.S)C-outdoor6/P1010103.JPG,char_data/2/P1010103.JPG_0.jpg,494,19,492,511,202,228,True,4
2,33,kaist_dataset/Mixed/Digital_Camera/(C.S)C-outdoor6/P1010103.JPG,char_data/2/P1010103.JPG_0.jpg,825,25,566,591,198,231,True,4
2,27,kaist_dataset/Mixed/Digital_Camera/(C.S)C-outdoor6/P1010114.JPG,char_data/2/P1010114.JPG_0.jpg,513,19,472,491,216,243,True,4
2,32,kaist_dataset/Mixed/Digital_Camera/(C.S)C-outdoor6/P1010065.JPG,char_data/2/P1010065.JPG_0.jpg,608,19,367,386,236,268,True,4
2,26,kaist_dataset/Mixed/Digital_Camera/(C.S)C-outdoor6/P1010065.JPG,char_data/2/P1010065.JPG_0.jpg,572,22,472,494,233,259,True,4
2,38,kaist_dataset/Mixed/Digital_Camera/(C.S)C-outdoor6/P1010018.JPG,char_data/2/P1010018.JPG_0.jpg,950,25,160,185,240,278,True,4
2,40,kaist_dataset/Mixed/Digital_Camera/(C.S)C-outdoor6/P1010018.JPG,char_data/2/P1010018.JPG_0.jpg,920,23,184,207,239,279,True,4
2,18,kaist_dataset/Mixed/Digital_Camera/(C.S)C-outdoor6/P1010096.JPG,char_data/2/P1010096.JPG_0.jpg,288,16,433,449,207,225,True,4
2,39,kaist_dataset/Mixed/Digital_Camera/(C.S)C-outdoor6/P1010097.JPG,char_data/2/P1010097.JPG_0.jpg,741,19,158,177,174,213,True,4
2,32,kaist_dataset/Mixed/Digital_Camera/(C.S)C-outdoor6/P1010097.JPG,char_data/2/P1010097.JPG_0.jpg,864,27,175,202,177,209,True,4
2,30,kaist_dataset/Mixed/Digital_Camera/(C.S)C-outdoor6/P1010097.JPG,char_data/2/P1010097.JPG_0.jpg,600,20,553,573,182,212,True,4
2,60,kaist_dataset/Mixed/Digital_Camera/(C.S)C-outdoor6/P1010087.JPG,char_data/2/P1010087.JPG_0.jpg,2580,43,304,347,171,231,True,4
2,25,kaist_dataset/Mixed/Digital_Camera/(C.S)C-outdoor6/117.JPG,char_data/2/117.JPG_0.jpg,375,15,282,297,263,288,True,4
2,25,kaist_dataset/Mixed/Digital_Camera/(C.S)C-outdoor6/117.JPG,char_data/2/117.JPG_0.jpg,375,15,299,314,263,288,True,4
2,23,kaist_dataset/Mixed/Digital_Camera/(C.S)C-outdoor6/117.JPG,char_data/2/117.JPG_0.jpg,391,17,333,350,267,290,True,4
2,24,kaist_dataset/Mixed/Digital_Camera/(C.S)C-outdoor6/117.JPG,char_data/2/117.JPG_0.jpg,360,15,351,366,266,290,True,4
2,27,kaist_dataset/Mixed/Digital_Camera/(C.S)C-outdoor6/117.JPG,char_data/2/117.JPG_0.jpg,405,15,450,465,264,291,True,4
2,23,kaist_dataset/Mixed/Digital_Camera/(C.S)C-outdoor6/117.JPG,char_data/2/117.JPG_0.jpg,322,14,478,492,265,288,True,4
2,22,kaist_dataset/Mixed/Digital_Camera/(C.S)C-outdoor6/117.JPG,char_data/2/117.JPG_0.jpg,308,14,492,506,265,287,True,4
2,19,kaist_dataset/Mixed/Digital_Camera/(C.S)C-outdoor6/117.JPG,char_data/2/117.JPG_0.jpg,342,18,375,393,265,284,True,4
2,20,kaist_dataset/Mixed/Digital_Camera/(C.S)C-outdoor6/117.JPG,char_data/2/117.JPG_0.jpg,240,12,439,451,266,286,True,4
2,48,kaist_dataset/Mixed/Digital_Camera/(C.S)C-outdoor6/P1010027.JPG,char_data/2/P1010027.JPG_0.jpg,1680,35,493,528,326,374,True,4
2,53,kaist_dataset/Mixed/Digital_Camera/(C.S)C-outdoor4/DSC03651.JPG,char_data/2/DSC03651.JPG_0.jpg,1590,30,266,296,356,409,True,4
2,35,kaist_dataset/Mixed/Digital_Camera/(C.S)C-outdoor4/DSC03730.JPG,char_data/2/DSC03730.JPG_0.jpg,840,24,529,553,247,282,True,4
2,71,kaist_dataset/Mixed/Digital_Camera/(C.S)C-outdoor4/DSC03730.JPG,char_data/2/DSC03730.JPG_0.jpg,4118,58,312,370,325,396,True,4
2,45,kaist_dataset/Mixed/Digital_Camera/(C.S)C-outdoor4/DSC03633.JPG,char_data/2/DSC03633.JPG_0.jpg,1215,27,258,285,266,311,True,4
2,51,kaist_dataset/Mixed/Digital_Camera/(C.S)C-outdoor4/DSC03738.JPG,char_data/2/DSC03738.JPG_0.jpg,1734,34,371,405,232,283,True,4
2,49,kaist_dataset/Mixed/Digital_Camera/(C.S)C-outdoor4/DSC03738.JPG,char_data/2/DSC03738.JPG_0.jpg,1470,30,496,526,236,285,True,4
2,46,kaist_dataset/Mixed/Digital_Camera/(C.S)C-outdoor4/DSC03613.JPG,char_data/2/DSC03613.JPG_0.jpg,874,19,417,436,26,72,True,4
2,46,kaist_dataset/Mixed/Digital_Camera/(C.S)C-outdoor4/DSC03702.JPG,char_data/2/DSC03702.JPG_0.jpg,1472,32,496,528,357,403,True,4
2,27,kaist_dataset/Mixed/Digital_Camera/(C.S)C-outdoor4/DSC03674.JPG,char_data/2/DSC03674.JPG_0.jpg,324,12,564,576,423,450,True,4
2,31,kaist_dataset/Mixed/Digital_Camera/(C.S)C-outdoor4/DSC03677.JPG,char_data/2/DSC03677.JPG_0.jpg,279,9,560,569,312,343,True,4
2,32,kaist_dataset/Mixed/Digital_Camera/(C.S)C-outdoor4/DSC03677.JPG,char_data/2/DSC03677.JPG_0.jpg,320,10,580,590,309,341,True,4
2,30,kaist_dataset/Mixed/Digital_Camera/(C.S)C-outdoor4/DSC03642.JPG,char_data/2/DSC03642.JPG_0.jpg,600,20,527,547,397,427,True,4
2,47,kaist_dataset/Mixed/Digital_Camera/(C.S)C-outdoor4/DSC03693.JPG,char_data/2/DSC03693.JPG_0.jpg,1222,26,549,575,351,398,True,4
2,36,kaist_dataset/Mixed/Digital_Camera/(C.S)C-outdoor4/DSC03693.JPG,char_data/2/DSC03693.JPG_0.jpg,432,12,590,602,357,393,True,4
2,89,kaist_dataset/Mixed/Digital_Camera/(C.S)C-outdoor4/DSC03711.JPG,char_data/2/DSC03711.JPG_0.jpg,5429,61,467,528,99,188,True,4
2,36,kaist_dataset/Mixed/Digital_Camera/(C.S)C-outdoor4/DSC03637.JPG,char_data/2/DSC03637.JPG_0.jpg,576,16,298,314,293,329,True,4
2,32,kaist_dataset/Mixed/Digital_Camera/(C.S)C-outdoor4/DSC03637.JPG,char_data/2/DSC03637.JPG_0.jpg,448,14,314,328,295,327,True,4
2,27,kaist_dataset/Mixed/Digital_Camera/(C.S)C-outdoor4/DSC03637.JPG,char_data/2/DSC03637.JPG_0.jpg,459,17,344,361,299,326,True,4
2,26,kaist_dataset/Mixed/Digital_Camera/(C.S)C-outdoor4/DSC03769.JPG,char_data/2/DSC03769.JPG_0.jpg,390,15,229,244,417,443,True,4
2,86,kaist_dataset/Mixed/Digital_Camera/(C.S)C-outdoor4/DSC03544.JPG,char_data/2/DSC03544.JPG_0.jpg,3440,40,506,546,171,257,True,4
2,34,kaist_dataset/Mixed/Digital_Camera/(C.S)C-outdoor4/DSC03660.JPG,char_data/2/DSC03660.JPG_0.jpg,986,29,456,485,96,130,True,4
2,37,kaist_dataset/Mixed/Digital_Camera/(C.S)C-outdoor4/DSC03640.JPG,char_data/2/DSC03640.JPG_0.jpg,888,24,192,216,400,437,True,4
2,31,kaist_dataset/Mixed/Digital_Camera/(C.S)C-outdoor4/DSC03640.JPG,char_data/2/DSC03640.JPG_0.jpg,558,18,382,400,398,429,True,4
2,26,kaist_dataset/Mixed/Digital_Camera/(C.S)C-outdoor4/DSC03640.JPG,char_data/2/DSC03640.JPG_0.jpg,702,27,401,428,401,427,True,4
2,25,kaist_dataset/Mixed/Digital_Camera/(C.S)C-outdoor4/DSC03640.JPG,char_data/2/DSC03640.JPG_0.jpg,525,21,461,482,400,425,True,4
2,49,kaist_dataset/Mixed/Digital_Camera/(C.S)C-outdoor4/DSC03548.JPG,char_data/2/DSC03548.JPG_0.jpg,2303,47,488,535,392,441,False,4
2,44,kaist_dataset/Mixed/Digital_Camera/(C.S)C-outdoor4/DSC03675.JPG,char_data/2/DSC03675.JPG_0.jpg,836,19,504,523,341,385,False,4
2,41,kaist_dataset/Mixed/Digital_Camera/(C.S)C-outdoor4/DSC03675.JPG,char_data/2/DSC03675.JPG_0.jpg,902,22,553,575,346,387,False,4
2,25,kaist_dataset/Mixed/Digital_Camera/(C.S)C-outdoor4/DSC03657.JPG,char_data/2/DSC03657.JPG_0.jpg,400,16,310,326,425,450,False,4
2,38,kaist_dataset/Mixed/Digital_Camera/(C.S)C-outdoor4/DSC03618.JPG,char_data/2/DSC03618.JPG_0.jpg,1862,49,552,601,413,451,False,4
2,46,kaist_dataset/Mixed/Digital_Camera/(C.S)C-outdoor4/DSC03534.JPG,char_data/2/DSC03534.JPG_0.jpg,1518,33,259,292,284,330,False,4
2,29,kaist_dataset/Mixed/Digital_Camera/(C.S)C-outdoor4/DSC03764.JPG,char_data/2/DSC03764.JPG_0.jpg,464,16,271,287,270,299,False,4
2,30,kaist_dataset/Mixed/Digital_Camera/(C.S)C-outdoor4/DSC03764.JPG,char_data/2/DSC03764.JPG_0.jpg,570,19,370,389,272,302,False,4
2,36,kaist_dataset/Mixed/Digital_Camera/(C.S)C-outdoor4/DSC03745.JPG,char_data/2/DSC03745.JPG_0.jpg,828,23,159,182,271,307,False,4
2,48,kaist_dataset/Mixed/Digital_Camera/(C.S)C-outdoor4/DSC03631.JPG,char_data/2/DSC03631.JPG_0.jpg,1488,31,173,204,354,402,False,4
2,36,kaist_dataset/Mixed/Digital_Camera/(C.S)C-outdoor4/DSC03655.JPG,char_data/2/DSC03655.JPG_0.jpg,936,26,445,471,399,435,False,4
2,40,kaist_dataset/Mixed/Digital_Camera/(C.S)C-outdoor4/DSC03439.JPG,char_data/2/DSC03439.JPG_0.jpg,1040,26,329,355,419,459,False,4
2,41,kaist_dataset/Mixed/Digital_Camera/(C.S)C-outdoor4/DSC03439.JPG,char_data/2/DSC03439.JPG_0.jpg,902,22,362,384,418,459,False,4
2,39,kaist_dataset/Mixed/Digital_Camera/(C.S)C-outdoor4/DSC03569.JPG,char_data/2/DSC03569.JPG_0.jpg,1170,30,146,176,181,220,False,4
2,37,kaist_dataset/Mixed/Digital_Camera/(C.S)C-outdoor4/DSC03549.JPG,char_data/2/DSC03549.JPG_0.jpg,777,21,592,613,218,255,False,4
2,31,kaist_dataset/Mixed/Digital_Camera/(C.S)C-outdoor4/DSC03446.JPG,char_data/2/DSC03446.JPG_0.jpg,744,24,372,396,290,321,False,4
2,38,kaist_dataset/Mixed/Digital_Camera/(C.S)C-outdoor4/DSC03732.JPG,char_data/2/DSC03732.JPG_0.jpg,912,24,560,584,389,427,False,4
2,22,kaist_dataset/Mixed/Digital_Camera/(C.S)C-outdoor4/DSC03643.JPG,char_data/2/DSC03643.JPG_0.jpg,330,15,561,576,330,352,False,4
2,50,kaist_dataset/Mixed/Digital_Camera/(C.S)C-outdoor4/DSC03571.JPG,char_data/2/DSC03571.JPG_0.jpg,1350,27,450,477,298,348,False,4
2,29,kaist_dataset/Mixed/Digital_Camera/(C.S)C-outdoor4/DSC03689.JPG,char_data/2/DSC03689.JPG_0.jpg,377,13,604,617,133,162,False,4
2,32,kaist_dataset/Mixed/Digital_Camera/(C.S)C-outdoor4/DSC03634.JPG,char_data/2/DSC03634.JPG_0.jpg,672,21,450,471,428,460,False,4
2,47,kaist_dataset/Mixed/Digital_Camera/(C.S)C-outdoor4/DSC03662.JPG,char_data/2/DSC03662.JPG_0.jpg,1034,22,477,499,417,464,False,4
2,34,kaist_dataset/Mixed/Digital_Camera/(C.S)C-outdoor4/DSC03757.JPG,char_data/2/DSC03757.JPG_0.jpg,374,11,255,266,337,371,False,4
2,29,kaist_dataset/Mixed/Digital_Camera/(C.S)C-outdoor4/DSC03757.JPG,char_data/2/DSC03757.JPG_0.jpg,319,11,280,291,339,368,False,4
2,32,kaist_dataset/Mixed/Digital_Camera/(C.S)C-outdoor4/DSC03757.JPG,char_data/2/DSC03757.JPG_0.jpg,352,11,440,451,339,371,False,4
2,33,kaist_dataset/Mixed/Digital_Camera/(C.S)C-outdoor4/DSC03667.JPG,char_data/2/DSC03667.JPG_0.jpg,528,16,459,475,379,412,False,4
2,36,kaist_dataset/Mixed/Digital_Camera/(C.S)C-outdoor4/DSC03667.JPG,char_data/2/DSC03667.JPG_0.jpg,792,22,534,556,373,409,False,4
2,26,kaist_dataset/Mixed/Digital_Camera/(C.S)C-outdoor4/DSC03687.JPG,char_data/2/DSC03687.JPG_0.jpg,390,15,484,499,404,430,False,4
2,26,kaist_dataset/Mixed/Digital_Camera/(C.S)C-outdoor4/DSC03687.JPG,char_data/2/DSC03687.JPG_0.jpg,312,12,501,513,404,430,False,4
2,43,kaist_dataset/Mixed/Digital_Camera/(C.S)C-outdoor4/DSC03724.JPG,char_data/2/DSC03724.JPG_0.jpg,1032,24,400,424,275,318,False,4
2,35,kaist_dataset/Mixed/Digital_Camera/(C.S)C-outdoor4/DSC03722.JPG,char_data/2/DSC03722.JPG_0.jpg,1085,31,346,377,203,238,False,4
2,28,kaist_dataset/Mixed/Digital_Camera/(C.S)C-outdoor4/DSC03581.JPG,char_data/2/DSC03581.JPG_0.jpg,476,17,524,541,122,150,False,4
2,23,kaist_dataset/Mixed/Digital_Camera/(C.S)C-outdoor4/DSC03581.JPG,char_data/2/DSC03581.JPG_0.jpg,575,25,105,130,147,170,False,4
2,23,kaist_dataset/Mixed/Digital_Camera/(C.S)C-outdoor4/DSC03758.JPG,char_data/2/DSC03758.JPG_0.jpg,322,14,303,317,308,331,False,4
2,29,kaist_dataset/Mixed/Digital_Camera/(C.S)C-outdoor4/DSC03758.JPG,char_data/2/DSC03758.JPG_0.jpg,522,18,390,408,312,341,False,4
2,33,kaist_dataset/Mixed/Digital_Camera/(C.S)C-outdoor2/DSC02912.JPG,char_data/2/DSC02912.JPG_0.jpg,495,15,333,348,9,42,False,4
2,33,kaist_dataset/Mixed/Digital_Camera/(C.S)C-outdoor2/DSC02624.JPG,char_data/2/DSC02624.JPG_0.jpg,495,15,453,468,398,431,False,4
2,28,kaist_dataset/Mixed/Digital_Camera/(C.S)C-outdoor2/DSC02624.JPG,char_data/2/DSC02624.JPG_0.jpg,392,14,502,516,401,429,False,4
2,36,kaist_dataset/Mixed/Digital_Camera/(C.S)C-outdoor2/DSC02419.JPG,char_data/2/DSC02419.JPG_0.jpg,648,18,478,496,214,250,False,4
2,43,kaist_dataset/Mixed/Digital_Camera/(C.S)C-outdoor2/DSC02419.JPG,char_data/2/DSC02419.JPG_0.jpg,1118,26,525,551,208,251,False,4
2,38,kaist_dataset/Mixed/Digital_Camera/(C.S)C-outdoor2/DSC02419.JPG,char_data/2/DSC02419.JPG_0.jpg,456,12,552,564,216,254,False,4
2,29,kaist_dataset/Mixed/Digital_Camera/(C.S)C-outdoor2/DSC02419.JPG,char_data/2/DSC02419.JPG_0.jpg,435,15,566,581,217,246,False,4
2,36,kaist_dataset/Mixed/Digital_Camera/(C.S)C-outdoor2/DSC02492.JPG,char_data/2/DSC02492.JPG_0.jpg,756,21,392,413,323,359,False,4
2,31,kaist_dataset/Mixed/Digital_Camera/(C.S)C-outdoor2/DSC02492.JPG,char_data/2/DSC02492.JPG_0.jpg,589,19,446,465,324,355,False,4
2,35,kaist_dataset/Mixed/Digital_Camera/(C.S)C-outdoor2/DSC02492.JPG,char_data/2/DSC02492.JPG_0.jpg,945,27,483,510,323,358,False,4
2,35,kaist_dataset/Mixed/Digital_Camera/(C.S)C-outdoor2/DSC02447.JPG,char_data/2/DSC02447.JPG_0.jpg,595,17,488,505,223,258,False,4
2,36,kaist_dataset/Mixed/Digital_Camera/(C.S)C-outdoor2/DSC02954.JPG,char_data/2/DSC02954.JPG_0.jpg,972,27,39,66,86,122,False,4
2,31,kaist_dataset/Mixed/Digital_Camera/(C.S)C-outdoor2/DSC02555.JPG,char_data/2/DSC02555.JPG_0.jpg,744,24,199,223,253,284,False,4
2,23,kaist_dataset/Mixed/Digital_Camera/(C.S)C-outdoor2/DSC02555.JPG,char_data/2/DSC02555.JPG_0.jpg,644,28,224,252,255,278,False,4
2,34,kaist_dataset/Mixed/Digital_Camera/(C.S)C-outdoor2/DSC02397.JPG,char_data/2/DSC02397.JPG_0.jpg,646,19,442,461,208,242,False,4
2,32,kaist_dataset/Mixed/Digital_Camera/(C.S)C-outdoor2/DSC02397.JPG,char_data/2/DSC02397.JPG_0.jpg,608,19,534,553,206,238,False,4
2,36,kaist_dataset/Mixed/Digital_Camera/(C.S)C-outdoor2/DSC02397.JPG,char_data/2/DSC02397.JPG_0.jpg,864,24,607,631,206,242,False,4
2,23,kaist_dataset/Mixed/Digital_Camera/(C.S)C-outdoor2/DSC02477.JPG,char_data/2/DSC02477.JPG_0.jpg,552,24,173,197,253,276,False,4
2,23,kaist_dataset/Mixed/Digital_Camera/(C.S)C-outdoor2/DSC02477.JPG,char_data/2/DSC02477.JPG_0.jpg,575,25,196,221,254,277,False,4
2,34,kaist_dataset/Mixed/Digital_Camera/(C.S)C-outdoor2/DSC02361.JPG,char_data/2/DSC02361.JPG_0.jpg,510,15,516,531,374,408,False,4
2,41,kaist_dataset/Mixed/Digital_Camera/(C.S)C-outdoor2/DSC02361.JPG,char_data/2/DSC02361.JPG_0.jpg,615,15,532,547,375,416,False,4
2,49,kaist_dataset/Mixed/Digital_Camera/(C.S)C-outdoor2/DSC02400.JPG,char_data/2/DSC02400.JPG_0.jpg,1470,30,213,243,398,447,False,4
2,58,kaist_dataset/Mixed/Digital_Camera/(C.S)C-outdoor2/DSC02400.JPG,char_data/2/DSC02400.JPG_0.jpg,2262,39,336,375,397,455,False,4
2,52,kaist_dataset/Mixed/Digital_Camera/(C.S)C-outdoor2/DSC02400.JPG,char_data/2/DSC02400.JPG_0.jpg,1976,38,407,445,396,448,False,4
2,41,kaist_dataset/Mixed/Digital_Camera/(C.S)C-outdoor2/DSC02411.JPG,char_data/2/DSC02411.JPG_0.jpg,943,23,402,425,350,391,False,4
2,40,kaist_dataset/Mixed/Digital_Camera/(C.S)C-outdoor2/DSC02413.JPG,char_data/2/DSC02413.JPG_0.jpg,800,20,355,375,208,248,False,4
2,37,kaist_dataset/Mixed/Digital_Camera/(C.S)C-outdoor2/DSC02413.JPG,char_data/2/DSC02413.JPG_0.jpg,1110,30,552,582,211,248,False,4
2,43,kaist_dataset/Mixed/Digital_Camera/(C.S)C-outdoor2/DSC02374.JPG,char_data/2/DSC02374.JPG_0.jpg,903,21,265,286,300,343,False,4
2,45,kaist_dataset/Mixed/Digital_Camera/(C.S)C-outdoor2/DSC02374.JPG,char_data/2/DSC02374.JPG_0.jpg,1215,27,287,314,299,344,False,4
2,78,kaist_dataset/Mixed/Digital_Camera/(C.S)C-outdoor2/DSC02513.JPG,char_data/2/DSC02513.JPG_0.jpg,3744,48,371,419,143,221,False,4
2,76,kaist_dataset/Mixed/Digital_Camera/(C.S)C-outdoor2/DSC02513.JPG,char_data/2/DSC02513.JPG_0.jpg,4028,53,467,520,143,219,False,4
2,36,kaist_dataset/Mixed/Digital_Camera/(C.S)C-outdoor2/DSC02887.JPG,char_data/2/DSC02887.JPG_0.jpg,828,23,405,428,114,150,False,4
2,35,kaist_dataset/Mixed/Digital_Camera/(C.S)C-outdoor2/DSC02368.JPG,char_data/2/DSC02368.JPG_0.jpg,525,15,141,156,385,420,False,4
2,26,kaist_dataset/Mixed/Digital_Camera/(C.S)C-outdoor2/DSC02947.JPG,char_data/2/DSC02947.JPG_0.jpg,494,19,566,585,244,270,False,4
2,36,kaist_dataset/Mixed/Digital_Camera/(C.S)C-outdoor2/DSC02545.JPG,char_data/2/DSC02545.JPG_0.jpg,1260,35,132,167,405,441,False,4
2,33,kaist_dataset/Mixed/Digital_Camera/(C.S)C-outdoor2/DSC02545.JPG,char_data/2/DSC02545.JPG_0.jpg,1188,36,353,389,399,432,False,4
2,34,kaist_dataset/Mixed/Digital_Camera/(C.S)C-outdoor2/DSC02545.JPG,char_data/2/DSC02545.JPG_0.jpg,1054,31,433,464,399,433,False,4
2,34,kaist_dataset/Mixed/Digital_Camera/(C.S)C-outdoor2/DSC02545.JPG,char_data/2/DSC02545.JPG_0.jpg,1122,33,463,496,398,432,False,4
2,33,kaist_dataset/Mixed/Digital_Camera/(C.S)C-outdoor2/DSC02894.JPG,char_data/2/DSC02894.JPG_0.jpg,825,25,413,438,243,276,False,4
2,67,kaist_dataset/Mixed/Digital_Camera/(C.S)C-outdoor2/DSC02503.JPG,char_data/2/DSC02503.JPG_0.jpg,5025,75,45,120,360,427,False,4
2,57,kaist_dataset/Mixed/Digital_Camera/(C.S)C-outdoor2/DSC02895.JPG,char_data/2/DSC02895.JPG_0.jpg,1710,30,73,103,352,409,False,4
2,41,kaist_dataset/Mixed/Digital_Camera/(C.S)C-outdoor2/DSC02490.JPG,char_data/2/DSC02490.JPG_0.jpg,861,21,357,378,343,384,False,4
2,43,kaist_dataset/Mixed/Digital_Camera/(C.S)C-outdoor2/DSC02482.JPG,char_data/2/DSC02482.JPG_0.jpg,1591,37,516,553,320,363,False,4
2,40,kaist_dataset/Mixed/Digital_Camera/(C.S)C-outdoor2/DSC02482.JPG,char_data/2/DSC02482.JPG_0.jpg,1480,37,556,593,324,364,False,4
2,42,kaist_dataset/Mixed/Digital_Camera/(C.S)C-outdoor2/DSC02482.JPG,char_data/2/DSC02482.JPG_0.jpg,1596,38,479,517,157,199,False,4
2,37,kaist_dataset/Mixed/Digital_Camera/(C.S)C-outdoor2/DSC02930.JPG,char_data/2/DSC02930.JPG_0.jpg,888,24,323,347,192,229,False,4
2,32,kaist_dataset/Mixed/Digital_Camera/(C.S)C-outdoor2/DSC02930.JPG,char_data/2/DSC02930.JPG_0.jpg,672,21,369,390,193,225,False,4
2,37,kaist_dataset/Mixed/Digital_Camera/(C.S)C-outdoor2/DSC02930.JPG,char_data/2/DSC02930.JPG_0.jpg,962,26,434,460,191,228,False,4
2,55,kaist_dataset/Mixed/Digital_Camera/(C.S)C-outdoor2/DSC02359.JPG,char_data/2/DSC02359.JPG_0.jpg,1375,25,262,287,412,467,False,4
2,36,kaist_dataset/Mixed/Digital_Camera/(C.S)C-outdoor2/DSC02376.JPG,char_data/2/DSC02376.JPG_0.jpg,792,22,447,469,338,374,False,4
2,34,kaist_dataset/Mixed/Digital_Camera/(C.S)C-outdoor2/DSC02422.JPG,char_data/2/DSC02422.JPG_0.jpg,748,22,173,195,222,256,False,4
2,31,kaist_dataset/Mixed/Digital_Camera/(C.S)C-outdoor2/DSC02422.JPG,char_data/2/DSC02422.JPG_0.jpg,589,19,366,385,223,254,False,4
2,38,kaist_dataset/Mixed/Digital_Camera/(C.S)C-outdoor2/DSC02422.JPG,char_data/2/DSC02422.JPG_0.jpg,950,25,385,410,218,256,False,4
2,29,kaist_dataset/Mixed/Digital_Camera/(C.S)C-outdoor2/DSC02936.JPG,char_data/2/DSC02936.JPG_0.jpg,406,14,522,536,227,256,False,4
2,37,kaist_dataset/Mixed/Digital_Camera/(C.S)C-outdoor2/DSC02466.JPG,char_data/2/DSC02466.JPG_0.jpg,1073,29,222,251,255,292,False,4
2,34,kaist_dataset/Mixed/Digital_Camera/(C.S)C-outdoor2/DSC02466.JPG,char_data/2/DSC02466.JPG_0.jpg,1054,31,369,400,254,288,False,4
2,34,kaist_dataset/Mixed/Digital_Camera/(C.S)C-outdoor2/DSC02466.JPG,char_data/2/DSC02466.JPG_0.jpg,1326,39,450,489,257,291,False,4
2,30,kaist_dataset/Mixed/Digital_Camera/(C.S)C-outdoor2/DSC02556.JPG,char_data/2/DSC02556.JPG_0.jpg,690,23,336,359,344,374,False,4
2,36,kaist_dataset/Mixed/Digital_Camera/(C.S)C-outdoor2/DSC02553.JPG,char_data/2/DSC02553.JPG_0.jpg,792,22,349,371,297,333,False,4
2,37,kaist_dataset/Mixed/Digital_Camera/(C.S)C-outdoor2/DSC02553.JPG,char_data/2/DSC02553.JPG_0.jpg,777,21,410,431,298,335,False,4
2,37,kaist_dataset/Mixed/Digital_Camera/(C.S)C-outdoor2/DSC02553.JPG,char_data/2/DSC02553.JPG_0.jpg,925,25,456,481,298,335,False,4
2,39,kaist_dataset/Mixed/Digital_Camera/(C.S)C-outdoor2/DSC02557.JPG,char_data/2/DSC02557.JPG_0.jpg,897,23,492,515,207,246,False,4
2,47,kaist_dataset/Mixed/Digital_Camera/(C.S)C-outdoor2/DSC02567.JPG,char_data/2/DSC02567.JPG_0.jpg,1692,36,251,287,141,188,False,4
2,47,kaist_dataset/Mixed/Digital_Camera/(C.S)C-outdoor2/DSC02567.JPG,char_data/2/DSC02567.JPG_0.jpg,1363,29,345,374,141,188,False,4
2,48,kaist_dataset/Mixed/Digital_Camera/(C.S)C-outdoor2/DSC02567.JPG,char_data/2/DSC02567.JPG_0.jpg,1632,34,400,434,138,186,False,4
2,30,kaist_dataset/Mixed/Digital_Camera/(C.S)C-outdoor2/DSC02926.JPG,char_data/2/DSC02926.JPG_0.jpg,660,22,465,487,151,181,False,4
2,29,kaist_dataset/Mixed/Digital_Camera/(C.S)C-outdoor2/DSC02926.JPG,char_data/2/DSC02926.JPG_0.jpg,725,25,505,530,152,181,False,4
2,67,kaist_dataset/Mixed/Digital_Camera/(C.S)C-outdoor2/DSC02407.JPG,char_data/2/DSC02407.JPG_0.jpg,3082,46,61,107,79,146,False,4
2,47,kaist_dataset/Mixed/Digital_Camera/(C.S)C-outdoor2/DSC02461.JPG,char_data/2/DSC02461.JPG_0.jpg,2679,57,230,287,286,333,False,4
2,55,kaist_dataset/Mixed/Digital_Camera/(C.S)C-outdoor2/DSC02461.JPG,char_data/2/DSC02461.JPG_0.jpg,3520,64,401,465,272,327,False,4
2,55,kaist_dataset/Mixed/Digital_Camera/(C.S)C-outdoor2/DSC02461.JPG,char_data/2/DSC02461.JPG_0.jpg,3630,66,522,588,269,324,False,4
2,42,kaist_dataset/Mixed/Digital_Camera/(C.S)C-outdoor2/DSC02938.JPG,char_data/2/DSC02938.JPG_0.jpg,924,22,521,543,243,285,False,4
2,33,kaist_dataset/Mixed/Digital_Camera/(C.S)C-outdoor2/DSC02379.JPG,char_data/2/DSC02379.JPG_0.jpg,627,19,409,428,290,323,False,4
2,31,kaist_dataset/Mixed/Digital_Camera/(C.S)C-outdoor2/DSC02560.JPG,char_data/2/DSC02560.JPG_0.jpg,589,19,544,563,303,334,False,4
2,49,kaist_dataset/Mixed/Digital_Camera/(C.S)C-outdoor2/DSC02389.JPG,char_data/2/DSC02389.JPG_0.jpg,1960,40,513,553,22,71,False,4
2,45,kaist_dataset/Mixed/Digital_Camera/(C.S)C-outdoor2/DSC02389.JPG,char_data/2/DSC02389.JPG_0.jpg,1260,28,250,278,42,87,False,4
2,37,kaist_dataset/Mixed/Digital_Camera/(C.S)C-outdoor2/DSC02389.JPG,char_data/2/DSC02389.JPG_0.jpg,1184,32,173,205,260,297,False,4
2,56,kaist_dataset/Mixed/Digital_Camera/(C.S)C-outdoor2/DSC02389.JPG,char_data/2/DSC02389.JPG_0.jpg,4480,80,592,672,314,370,False,4
2,38,kaist_dataset/Mixed/Digital_Camera/(C.S)C-outdoor2/DSC02377.JPG,char_data/2/DSC02377.JPG_0.jpg,836,22,445,467,354,392,False,4
2,40,kaist_dataset/Mixed/Digital_Camera/(C.S)C-outdoor2/DSC02377.JPG,char_data/2/DSC02377.JPG_0.jpg,1080,27,467,494,351,391,False,4
2,33,kaist_dataset/Mixed/Digital_Camera/(C.S)A-shadow/DSC02624.JPG,char_data/2/DSC02624.JPG_0.jpg,495,15,453,468,398,431,False,4
2,28,kaist_dataset/Mixed/Digital_Camera/(C.S)A-shadow/DSC02624.JPG,char_data/2/DSC02624.JPG_0.jpg,392,14,502,516,401,429,False,4
2,34,kaist_dataset/Mixed/Digital_Camera/(C.S)A-shadow/DSC03257.JPG,char_data/2/DSC03257.JPG_0.jpg,816,24,360,384,384,418,False,4
2,33,kaist_dataset/Mixed/Digital_Camera/(C.S)A-shadow/DSC04306.JPG,char_data/2/DSC04306.JPG_0.jpg,693,21,258,279,412,445,False,4
2,58,kaist_dataset/Mixed/Digital_Camera/(C.S)A-shadow/DSC04304.JPG,char_data/2/DSC04304.JPG_0.jpg,2494,43,367,410,280,338,False,4
2,60,kaist_dataset/Mixed/Digital_Camera/(C.S)A-shadow/DSC04304.JPG,char_data/2/DSC04304.JPG_0.jpg,2220,37,576,613,278,338,False,4
2,60,kaist_dataset/Mixed/Digital_Camera/(C.S)A-shadow/DSC04326.JPG,char_data/2/DSC04326.JPG_0.jpg,1800,30,353,383,20,80,False,4
2,54,kaist_dataset/Mixed/Digital_Camera/(C.S)A-shadow/DSC03305.JPG,char_data/2/DSC03305.JPG_0.jpg,1782,33,461,494,347,401,False,4
2,47,kaist_dataset/Mixed/Digital_Camera/(C.S)A-shadow/DSC02567.JPG,char_data/2/DSC02567.JPG_0.jpg,1692,36,251,287,141,188,False,4
2,47,kaist_dataset/Mixed/Digital_Camera/(C.S)A-shadow/DSC02567.JPG,char_data/2/DSC02567.JPG_0.jpg,1363,29,345,374,141,188,False,4
2,48,kaist_dataset/Mixed/Digital_Camera/(C.S)A-shadow/DSC02567.JPG,char_data/2/DSC02567.JPG_0.jpg,1632,34,400,434,138,186,False,4
2,39,kaist_dataset/Mixed/Digital_Camera/(C.S)A-shadow/DSC02579.JPG,char_data/2/DSC02579.JPG_0.jpg,1092,28,265,293,397,436,False,4
2,38,kaist_dataset/Mixed/Digital_Camera/(C.S)A-shadow/P1010019.JPG,char_data/2/P1010019.JPG_0.jpg,1026,27,339,366,202,240,False,4
2,33,kaist_dataset/English/Digital_Camera/(E.S)C-outdoor2/DSC03294.JPG,char_data/2/DSC03294.JPG_0.jpg,693,21,268,289,397,430,False,4
2,56,kaist_dataset/English/Digital_Camera/(E.S)C-outdoor2/DSC03201.JPG,char_data/2/DSC03201.JPG_0.jpg,2632,47,225,272,9,65,False,4
2,68,kaist_dataset/English/Digital_Camera/(E.S)C-outdoor2/DSC04163.JPG,char_data/2/DSC04163.JPG_0.jpg,2380,35,306,341,316,384,False,4
2,85,kaist_dataset/English/Digital_Camera/(E.S)C-outdoor2/DSC03731.JPG,char_data/2/DSC03731.JPG_0.jpg,6035,71,314,385,27,112,False,4
2,26,kaist_dataset/English/Digital_Camera/(E.S)C-outdoor2/DSC03731.JPG,char_data/2/DSC03731.JPG_0.jpg,364,14,565,579,119,145,False,4
2,39,kaist_dataset/English/Digital_Camera/(E.S)C-outdoor2/DSC03160.JPG,char_data/2/DSC03160.JPG_0.jpg,975,25,294,319,399,438,False,4
2,42,kaist_dataset/English/Digital_Camera/(E.S)C-outdoor2/DSC03160.JPG,char_data/2/DSC03160.JPG_0.jpg,966,23,364,387,398,440,False,4
2,128,kaist_dataset/English/Digital_Camera/(E.S)C-outdoor1/108.JPG,char_data/2/108.JPG_0.jpg,10752,84,381,465,198,326,False,4
2,44,kaist_dataset/English/Digital_Camera/(E.S)C-outdoor1/DSC02450.JPG,char_data/2/DSC02450.JPG_0.jpg,1452,33,154,187,222,266,False,4
2,43,kaist_dataset/English/Digital_Camera/(E.S)C-outdoor1/DSC02450.JPG,char_data/2/DSC02450.JPG_0.jpg,1204,28,205,233,221,264,False,4
2,51,kaist_dataset/English/Digital_Camera/(E.S)C-outdoor1/DSC02415.JPG,char_data/2/DSC02415.JPG_0.jpg,1581,31,419,450,246,297,False,4
2,36,kaist_dataset/English/Digital_Camera/(E.S)C-outdoor1/DSC02415.JPG,char_data/2/DSC02415.JPG_0.jpg,1044,29,452,481,252,288,False,4
2,40,kaist_dataset/English/Digital_Camera/(E.S)C-outdoor1/080116-0065.jpg,char_data/2/080116-0065.jpg_0.jpg,1160,29,340,369,201,241,False,4
2,41,kaist_dataset/English/Digital_Camera/(E.S)C-outdoor1/080116-0065.jpg,char_data/2/080116-0065.jpg_0.jpg,943,23,183,206,364,405,False,4
2,44,kaist_dataset/English/Digital_Camera/(E.S)C-outdoor1/080116-0065.jpg,char_data/2/080116-0065.jpg_0.jpg,1144,26,325,351,376,420,False,4
2,47,kaist_dataset/English/Digital_Camera/(E.S)C-outdoor1/080116-0065.jpg,char_data/2/080116-0065.jpg_0.jpg,1363,29,397,426,383,430,False,4
2,33,kaist_dataset/English/Digital_Camera/(E.S)C-outdoor1/2007-12-08-day-015.jpg,char_data/2/2007-12-08-day-015.jpg_0.jpg,858,26,1007,1033,814,847,False,4
2,36,kaist_dataset/English/Digital_Camera/(E.S)C-outdoor1/107.jpg,char_data/2/107.jpg_0.jpg,1224,34,424,458,331,367,False,4
2,73,kaist_dataset/English/Digital_Camera/(E.S)C-outdoor1/080119-0020.jpg,char_data/2/080119-0020.jpg_0.jpg,3504,48,762,810,418,491,False,4
2,37,kaist_dataset/English/Digital_Camera/(E.S)C-outdoor1/DSC02364.JPG,char_data/2/DSC02364.JPG_0.jpg,740,20,377,397,350,387,False,4
2,36,kaist_dataset/English/Digital_Camera/(E.S)C-outdoor1/DSC02364.JPG,char_data/2/DSC02364.JPG_0.jpg,432,12,510,522,352,388,False,4
2,34,kaist_dataset/English/Digital_Camera/(E.S)C-outdoor1/DSC02364.JPG,char_data/2/DSC02364.JPG_0.jpg,442,13,526,539,353,387,False,4
2,93,kaist_dataset/English/Digital_Camera/(E.S)C-outdoor1/DSC02491.JPG,char_data/2/DSC02491.JPG_0.jpg,4743,51,338,389,308,401,False,4
2,76,kaist_dataset/English/Digital_Camera/(E.S)C-outdoor1/DSC02491.JPG,char_data/2/DSC02491.JPG_0.jpg,4028,53,472,525,313,389,False,4
2,48,kaist_dataset/English/Digital_Camera/(E.S)F-others/080119-0007.jpg,char_data/2/080119-0007.jpg_0.jpg,1104,23,1079,1102,224,272,False,4
2,45,kaist_dataset/English/Digital_Camera/(E.S)F-others/080119-0007.jpg,char_data/2/080119-0007.jpg_0.jpg,1260,28,1102,1130,223,268,False,4
2,56,kaist_dataset/English/Digital_Camera/(E.S)F-others/080116-0058.jpg,char_data/2/080116-0058.jpg_0.jpg,1344,24,1230,1254,1019,1075,False,4
2,31,kaist_dataset/English/Digital_Camera/(E.S)D-indoor/DSC03943.JPG,char_data/2/DSC03943.JPG_0.jpg,496,16,390,406,312,343,False,4
2,98,kaist_dataset/English/Digital_Camera/(E.S)D-indoor/DSC02719.JPG,char_data/2/DSC02719.JPG_0.jpg,7448,76,223,299,168,266,False,4
2,23,kaist_dataset/English/Digital_Camera/(E.S)C-outdoor3/크기변환_P1010076.JPG,char_data/2/크기변환_P1010076.JPG_0.jpg,253,11,544,555,180,203,False,4
2,96,kaist_dataset/English/Digital_Camera/(E.S)C-outdoor3/P1010123.JPG,char_data/2/P1010123.JPG_0.jpg,8736,91,273,364,57,153,False,4
0,79,"kaist_dataset/Korean/Mobile_Phone/(M,K)E-bookCover/P090831091.jpg",char_data/0/P090831091.jpg_4.jpg,3318,42,450,492,26,105,True,2
0,80,"kaist_dataset/Korean/Mobile_Phone/(M,K)E-bookCover/P090831091.jpg",char_data/0/P090831091.jpg_4.jpg,3920,49,494,543,27,107,True,2
0,63,"kaist_dataset/Korean/Mobile_Phone/(M,K)E-bookCover/P090831088.jpg",char_data/0/P090831088.jpg_4.jpg,2142,34,379,413,18,81,True,2
0,66,"kaist_dataset/Korean/Mobile_Phone/(M,K)E-bookCover/P090831088.jpg",char_data/0/P090831088.jpg_4.jpg,2574,39,413,452,13,79,True,2
0,77,"kaist_dataset/Korean/Mobile_Phone/(M,K)E-bookCover/P090831100.jpg",char_data/0/P090831100.jpg_4.jpg,3157,41,451,492,45,122,True,2
0,71,"kaist_dataset/Korean/Mobile_Phone/(M,K)E-bookCover/P090831100.jpg",char_data/0/P090831100.jpg_4.jpg,2485,35,499,534,47,118,True,2
0,70,"kaist_dataset/Korean/Mobile_Phone/(M,K)E-bookCover/P090831087.jpg",char_data/0/P090831087.jpg_4.jpg,2240,32,388,420,22,92,True,2
0,66,"kaist_dataset/Korean/Mobile_Phone/(M,K)E-bookCover/P090831087.jpg",char_data/0/P090831087.jpg_4.jpg,2310,35,426,461,28,94,True,2
0,82,"kaist_dataset/Korean/Mobile_Phone/(M,K)E-bookCover/P090831094.jpg",char_data/0/P090831094.jpg_4.jpg,3772,46,433,479,34,116,True,2
0,76,"kaist_dataset/Korean/Mobile_Phone/(M,K)E-bookCover/P090831094.jpg",char_data/0/P090831094.jpg_4.jpg,3344,44,480,524,40,116,True,2
0,84,"kaist_dataset/Korean/Mobile_Phone/(M,K)E-bookCover/P090831097.jpg",char_data/0/P090831097.jpg_4.jpg,3696,44,447,491,35,119,True,2
0,78,"kaist_dataset/Korean/Mobile_Phone/(M,K)E-bookCover/P090831097.jpg",char_data/0/P090831097.jpg_4.jpg,3354,43,496,539,37,115,True,2
0,67,"kaist_dataset/Korean/Mobile_Phone/(M,K)E-bookCover/P090831082.jpg",char_data/0/P090831082.jpg_4.jpg,2546,38,379,417,38,105,True,2
0,67,"kaist_dataset/Korean/Mobile_Phone/(M,K)E-bookCover/P090831082.jpg",char_data/0/P090831082.jpg_4.jpg,2546,38,420,458,37,104,True,2
0,84,"kaist_dataset/Korean/Mobile_Phone/(M,K)E-bookCover/P090831098.jpg",char_data/0/P090831098.jpg_4.jpg,3528,42,456,498,30,114,True,2
0,78,"kaist_dataset/Korean/Mobile_Phone/(M,K)E-bookCover/P090831098.jpg",char_data/0/P090831098.jpg_4.jpg,3120,40,498,538,30,108,True,2
0,64,"kaist_dataset/Korean/Mobile_Phone/(M,K)E-bookCover/P090831084.jpg",char_data/0/P090831084.jpg_4.jpg,2432,38,343,381,43,107,True,2
0,65,"kaist_dataset/Korean/Mobile_Phone/(M,K)E-bookCover/P090831084.jpg",char_data/0/P090831084.jpg_4.jpg,2340,36,381,417,42,107,True,2
0,64,"kaist_dataset/Korean/Mobile_Phone/(M,K)E-bookCover/P090831086.jpg",char_data/0/P090831086.jpg_4.jpg,2240,35,377,412,40,104,True,2
0,69,"kaist_dataset/Korean/Mobile_Phone/(M,K)E-bookCover/P090831086.jpg",char_data/0/P090831086.jpg_4.jpg,2967,43,411,454,40,109,True,2
0,110,"kaist_dataset/Korean/Mobile_Phone/(M,K)E-bookCover/P090831105.jpg",char_data/0/P090831105.jpg_2.jpg,5940,54,563,617,96,206,True,2
0,79,"kaist_dataset/Korean/Mobile_Phone/(M,K)E-bookCover/P090831096.jpg",char_data/0/P090831096.jpg_4.jpg,3397,43,436,479,38,117,True,2
0,72,"kaist_dataset/Korean/Mobile_Phone/(M,K)E-bookCover/P090831096.jpg",char_data/0/P090831096.jpg_4.jpg,3240,45,481,526,43,115,True,2
0,74,"kaist_dataset/Korean/Mobile_Phone/(M,K)E-bookCover/P090831089.jpg",char_data/0/P090831089.jpg_4.jpg,2886,39,419,458,26,100,True,2
0,74,"kaist_dataset/Korean/Mobile_Phone/(M,K)E-bookCover/P090831089.jpg",char_data/0/P090831089.jpg_4.jpg,3626,49,455,504,27,101,True,2
0,87,"kaist_dataset/Korean/Mobile_Phone/(M,K)E-bookCover/P090831095.jpg",char_data/0/P090831095.jpg_4.jpg,3654,42,462,504,36,123,True,2
0,92,"kaist_dataset/Korean/Mobile_Phone/(M,K)E-bookCover/P090831095.jpg",char_data/0/P090831095.jpg_4.jpg,4232,46,505,551,35,127,True,2
0,77,"kaist_dataset/Korean/Mobile_Phone/(M,K)E-bookCover/P090831035.jpg",char_data/0/P090831035.jpg_2.jpg,3003,39,55,94,48,125,True,2
0,81,"kaist_dataset/Korean/Mobile_Phone/(M,K)E-bookCover/P090831099.jpg",char_data/0/P090831099.jpg_4.jpg,3483,43,457,500,19,100,True,2
0,83,"kaist_dataset/Korean/Mobile_Phone/(M,K)E-bookCover/P090831099.jpg",char_data/0/P090831099.jpg_4.jpg,3984,48,501,549,18,101,True,2
0,67,"kaist_dataset/Korean/Mobile_Phone/(M,K)E-bookCover/P090831090.jpg",char_data/0/P090831090.jpg_4.jpg,3216,48,458,506,36,103,True,2
0,70,"kaist_dataset/Korean/Mobile_Phone/(M,K)E-bookCover/P090831090.jpg",char_data/0/P090831090.jpg_4.jpg,3220,46,505,551,33,103,True,2
0,48,"kaist_dataset/Korean/Mobile_Phone/(M,K)C-outdoor/P090912034.jpg",char_data/0/P090912034.jpg_4.jpg,1536,32,205,237,253,301,True,2
0,40,"kaist_dataset/Korean/Mobile_Phone/(M,K)C-outdoor/P090912034.jpg",char_data/0/P090912034.jpg_4.jpg,1200,30,285,315,262,302,True,2
0,120,kaist_dataset/Korean/Digital_Camera/F-bookCover/DSC04229.JPG,char_data/0/DSC04229.JPG_6.jpg,11040,92,125,217,165,285,True,2
0,129,kaist_dataset/Korean/Digital_Camera/F-bookCover/DSC04229.JPG,char_data/0/DSC04229.JPG_6.jpg,10062,78,220,298,164,293,True,2
0,130,kaist_dataset/Korean/Digital_Camera/F-bookCover/DSC04229.JPG,char_data/0/DSC04229.JPG_6.jpg,10270,79,297,376,165,295,True,2
0,103,kaist_dataset/Korean/Digital_Camera/outdoor5/DSC03760.JPG,char_data/0/DSC03760.JPG_4.jpg,6901,67,381,448,69,172,True,2
0,106,kaist_dataset/Korean/Digital_Camera/outdoor5/DSC03760.JPG,char_data/0/DSC03760.JPG_4.jpg,7526,71,451,522,68,174,True,2
0,31,kaist_dataset/Korean/Digital_Camera/outdoor5/DSC03627.JPG,char_data/0/DSC03627.JPG_4.jpg,961,31,325,356,225,256,True,2
0,32,kaist_dataset/Korean/Digital_Camera/outdoor5/DSC03627.JPG,char_data/0/DSC03627.JPG_4.jpg,960,30,418,448,223,255,True,2
0,28,kaist_dataset/Korean/Digital_Camera/outdoor5/DSC03744.JPG,char_data/0/DSC03744.JPG_4.jpg,812,29,353,382,303,331,True,2
0,32,kaist_dataset/Korean/Digital_Camera/outdoor5/DSC03744.JPG,char_data/0/DSC03744.JPG_4.jpg,768,24,412,436,298,330,True,2
0,23,kaist_dataset/Korean/Digital_Camera/outdoor5/DSC03780.JPG,char_data/0/DSC03780.JPG_2.jpg,414,18,229,247,438,461,True,2
0,32,kaist_dataset/Korean/Digital_Camera/outdoor5/DSC03692.JPG,char_data/0/DSC03692.JPG_4.jpg,672,21,385,406,186,218,True,2
0,36,kaist_dataset/Korean/Digital_Camera/outdoor5/DSC03692.JPG,char_data/0/DSC03692.JPG_4.jpg,576,16,475,491,188,224,True,2
0,33,kaist_dataset/Korean/Digital_Camera/outdoor5/DSC04027.JPG,char_data/0/DSC04027.JPG_8.jpg,561,17,278,295,386,419,True,2
0,34,kaist_dataset/Korean/Digital_Camera/outdoor5/DSC04027.JPG,char_data/0/DSC04027.JPG_8.jpg,748,22,312,334,387,421,True,2
0,36,kaist_dataset/Korean/Digital_Camera/outdoor5/DSC04027.JPG,char_data/0/DSC04027.JPG_8.jpg,612,17,347,364,384,420,True,2
0,36,kaist_dataset/Korean/Digital_Camera/outdoor5/DSC04027.JPG,char_data/0/DSC04027.JPG_8.jpg,684,19,492,511,382,418,True,2
0,37,kaist_dataset/Korean/Digital_Camera/outdoor5/DSC03671.JPG,char_data/0/DSC03671.JPG_4.jpg,555,15,178,193,408,445,True,2
0,33,kaist_dataset/Korean/Digital_Camera/outdoor5/DSC03671.JPG,char_data/0/DSC03671.JPG_4.jpg,726,22,391,413,413,446,True,2
0,90,kaist_dataset/Korean/Digital_Camera/outdoor5/DSC03715.JPG,char_data/0/DSC03715.JPG_4.jpg,3960,44,459,503,79,169,True,2
0,96,kaist_dataset/Korean/Digital_Camera/outdoor5/DSC03715.JPG,char_data/0/DSC03715.JPG_4.jpg,5184,54,547,601,77,173,True,2
0,62,kaist_dataset/Korean/Digital_Camera/outdoor5/DSC03694.JPG,char_data/0/DSC03694.JPG_6.jpg,1488,24,548,572,116,178,True,2
0,57,kaist_dataset/Korean/Digital_Camera/outdoor5/DSC03694.JPG,char_data/0/DSC03694.JPG_6.jpg,1482,26,599,625,118,175,True,2
0,63,kaist_dataset/Korean/Digital_Camera/outdoor5/DSC03694.JPG,char_data/0/DSC03694.JPG_6.jpg,1764,28,315,343,248,311,True,2
0,30,kaist_dataset/Korean/Digital_Camera/outdoor5/DSC03752.JPG,char_data/0/DSC03752.JPG_2.jpg,450,15,186,201,410,440,True,2
0,54,kaist_dataset/Korean/Digital_Camera/outdoor5/DSC03838.JPG,char_data/0/DSC03838.JPG_2.jpg,1242,23,373,396,201,255,True,2
0,65,kaist_dataset/Korean/Digital_Camera/outdoor5/DSC03749.JPG,char_data/0/DSC03749.JPG_4.jpg,1755,27,484,511,408,473,True,2
0,70,kaist_dataset/Korean/Digital_Camera/outdoor5/DSC03749.JPG,char_data/0/DSC03749.JPG_4.jpg,2380,34,512,546,404,474,True,2
0,49,kaist_dataset/Korean/Digital_Camera/outdoor5/DSC03626.JPG,char_data/0/DSC03626.JPG_4.jpg,1764,36,227,263,292,341,True,2
0,44,kaist_dataset/Korean/Digital_Camera/outdoor5/DSC03626.JPG,char_data/0/DSC03626.JPG_4.jpg,1276,29,289,318,295,339,True,2
0,30,kaist_dataset/Korean/Digital_Camera/outdoor5/DSC03777.JPG,char_data/0/DSC03777.JPG_2.jpg,540,18,71,89,342,372,True,2
0,38,kaist_dataset/Korean/Digital_Camera/outdoor5/DSC03669.JPG,char_data/0/DSC03669.JPG_2.jpg,1102,29,371,400,311,349,True,2
0,37,kaist_dataset/Korean/Digital_Camera/outdoor5/DSC03636.JPG,char_data/0/DSC03636.JPG_6.jpg,925,25,69,94,335,372,True,2
0,40,kaist_dataset/Korean/Digital_Camera/outdoor5/DSC03636.JPG,char_data/0/DSC03636.JPG_6.jpg,920,23,93,116,332,372,True,2
0,34,kaist_dataset/Korean/Digital_Camera/outdoor5/DSC03636.JPG,char_data/0/DSC03636.JPG_6.jpg,646,19,343,362,396,430,True,2
0,29,kaist_dataset/Korean/Digital_Camera/outdoor5/DSC04028.JPG,char_data/0/DSC04028.JPG_4.jpg,696,24,416,440,344,373,True,2
0,26,kaist_dataset/Korean/Digital_Camera/outdoor5/DSC04028.JPG,char_data/0/DSC04028.JPG_4.jpg,676,26,441,467,344,370,True,2
0,36,kaist_dataset/Korean/Digital_Camera/outdoor5/DSC03740.JPG,char_data/0/DSC03740.JPG_2.jpg,864,24,274,298,288,324,True,2
0,21,kaist_dataset/Korean/Digital_Camera/outdoor5/DSC03776.JPG,char_data/0/DSC03776.JPG_2.jpg,231,11,543,554,422,443,True,2
0,89,kaist_dataset/Korean/Digital_Camera/outdoor5/DSC03864.JPG,char_data/0/DSC03864.JPG_2.jpg,4272,48,483,531,163,252,True,2
0,57,kaist_dataset/Korean/Digital_Camera/outdoor5/DSC03858.JPG,char_data/0/DSC03858.JPG_8.jpg,2622,46,181,227,397,454,True,2
0,64,kaist_dataset/Korean/Digital_Camera/outdoor5/DSC03858.JPG,char_data/0/DSC03858.JPG_8.jpg,3008,47,230,277,398,462,True,2
0,71,kaist_dataset/Korean/Digital_Camera/outdoor5/DSC03858.JPG,char_data/0/DSC03858.JPG_8.jpg,3408,48,279,327,394,465,True,2
0,42,kaist_dataset/Korean/Digital_Camera/outdoor5/DSC03858.JPG,char_data/0/DSC03858.JPG_8.jpg,966,23,488,511,413,455,True,2
0,57,kaist_dataset/Korean/Digital_Camera/outdoor4/DSC03598.JPG,char_data/0/DSC03598.JPG_2.jpg,2508,44,295,339,200,257,True,2
0,80,kaist_dataset/Korean/Digital_Camera/outdoor4/DSC03542.JPG,char_data/0/DSC03542.JPG_2.jpg,4080,51,30,81,254,334,True,2
0,59,kaist_dataset/Korean/Digital_Camera/outdoor4/DSC03592.JPG,char_data/0/DSC03592.JPG_14.jpg,1947,33,60,93,53,112,True,2
0,58,kaist_dataset/Korean/Digital_Camera/outdoor4/DSC03592.JPG,char_data/0/DSC03592.JPG_14.jpg,1856,32,91,123,57,115,True,2
0,53,kaist_dataset/Korean/Digital_Camera/outdoor4/DSC03592.JPG,char_data/0/DSC03592.JPG_14.jpg,1272,24,620,644,63,116,True,2
0,52,kaist_dataset/Korean/Digital_Camera/outdoor4/DSC03592.JPG,char_data/0/DSC03592.JPG_14.jpg,1560,30,513,543,63,115,True,2
0,52,kaist_dataset/Korean/Digital_Camera/outdoor4/DSC03592.JPG,char_data/0/DSC03592.JPG_14.jpg,1716,33,398,431,58,110,True,2
0,60,kaist_dataset/Korean/Digital_Camera/outdoor4/DSC03592.JPG,char_data/0/DSC03592.JPG_14.jpg,1920,32,285,317,49,109,True,2
0,59,kaist_dataset/Korean/Digital_Camera/outdoor4/DSC03592.JPG,char_data/0/DSC03592.JPG_14.jpg,1947,33,184,217,52,111,True,2
0,31,kaist_dataset/Korean/Digital_Camera/outdoor4/DSC03295.JPG,char_data/0/DSC03295.JPG_4.jpg,713,23,312,335,400,431,True,2
0,31,kaist_dataset/Korean/Digital_Camera/outdoor4/DSC03295.JPG,char_data/0/DSC03295.JPG_4.jpg,775,25,359,384,403,434,True,2
0,55,kaist_dataset/Korean/Digital_Camera/outdoor4/DSC03607.JPG,char_data/0/DSC03607.JPG_2.jpg,1925,35,588,623,102,157,True,2
0,58,kaist_dataset/Korean/Digital_Camera/outdoor4/DSC03319.JPG,char_data/0/DSC03319.JPG_4.jpg,2146,37,409,446,384,442,True,2
0,49,kaist_dataset/Korean/Digital_Camera/outdoor4/DSC03319.JPG,char_data/0/DSC03319.JPG_4.jpg,1470,30,269,299,81,130,True,2
0,70,kaist_dataset/Korean/Digital_Camera/outdoor4/DSC03550.JPG,char_data/0/DSC03550.JPG_4.jpg,3990,57,392,449,304,374,True,2
0,73,kaist_dataset/Korean/Digital_Camera/outdoor4/DSC03550.JPG,char_data/0/DSC03550.JPG_4.jpg,4307,59,446,505,303,376,True,2
0,84,kaist_dataset/Korean/Digital_Camera/outdoor4/DSC03320.JPG,char_data/0/DSC03320.JPG_2.jpg,5208,62,229,291,379,463,True,2
0,39,kaist_dataset/Korean/Digital_Camera/outdoor4/DSC03545.JPG,char_data/0/DSC03545.JPG_2.jpg,819,21,165,186,39,78,True,2
0,53,kaist_dataset/Korean/Digital_Camera/outdoor4/DSC03313.JPG,char_data/0/DSC03313.JPG_4.jpg,1855,35,451,486,315,368,True,2
0,38,kaist_dataset/Korean/Digital_Camera/outdoor4/DSC03313.JPG,char_data/0/DSC03313.JPG_4.jpg,684,18,496,514,74,112,True,2
0,64,kaist_dataset/Korean/Digital_Camera/outdoor4/DSC03537.JPG,char_data/0/DSC03537.JPG_2.jpg,2880,45,119,164,134,198,True,2
0,85,kaist_dataset/Korean/Digital_Camera/outdoor4/DSC03452.JPG,char_data/0/DSC03452.JPG_6.jpg,3400,40,423,463,284,369,True,2
0,76,kaist_dataset/Korean/Digital_Camera/outdoor4/DSC03452.JPG,char_data/0/DSC03452.JPG_6.jpg,2280,30,498,528,284,360,True,2
0,76,kaist_dataset/Korean/Digital_Camera/outdoor4/DSC03452.JPG,char_data/0/DSC03452.JPG_6.jpg,2888,38,528,566,288,364,True,2
0,35,kaist_dataset/Korean/Digital_Camera/outdoor4/DSC03555.JPG,char_data/0/DSC03555.JPG_2.jpg,945,27,390,417,425,460,True,2
0,45,kaist_dataset/Korean/Digital_Camera/outdoor4/DSC03603.JPG,char_data/0/DSC03603.JPG_4.jpg,1710,38,224,262,53,98,True,2
0,53,kaist_dataset/Korean/Digital_Camera/outdoor4/DSC03603.JPG,char_data/0/DSC03603.JPG_4.jpg,2226,42,224,266,385,438,True,2
0,64,kaist_dataset/Korean/Digital_Camera/outdoor4/DSC03261.JPG,char_data/0/DSC03261.JPG_4.jpg,2560,40,388,428,393,457,True,2
0,58,kaist_dataset/Korean/Digital_Camera/outdoor4/DSC03261.JPG,char_data/0/DSC03261.JPG_4.jpg,2088,36,467,503,404,462,True,2
0,30,kaist_dataset/Korean/Digital_Camera/outdoor2/DSC02467.JPG,char_data/0/DSC02467.JPG_2.jpg,780,26,295,321,256,286,True,2
0,32,kaist_dataset/Korean/Digital_Camera/outdoor2/DSC02476.JPG,char_data/0/DSC02476.JPG_2.jpg,768,24,395,419,271,303,True,2
0,68,kaist_dataset/Korean/Digital_Camera/outdoor2/2007-12-08-day-101.jpg,char_data/0/2007-12-08-day-101.jpg_6.jpg,2720,40,858,898,638,706,True,2
0,41,kaist_dataset/Korean/Digital_Camera/outdoor2/2007-12-08-day-101.jpg,char_data/0/2007-12-08-day-101.jpg_6.jpg,820,20,770,790,741,782,True,2
0,41,kaist_dataset/Korean/Digital_Camera/outdoor2/2007-12-08-day-101.jpg,char_data/0/2007-12-08-day-101.jpg_6.jpg,738,18,790,808,743,784,True,2
0,38,kaist_dataset/Korean/Digital_Camera/outdoor2/2007-12-09-day-exterior-036.jpg,char_data/0/2007-12-09-day-exterior-036.jpg_4.jpg,836,22,1518,1540,630,668,True,2
0,39,kaist_dataset/Korean/Digital_Camera/outdoor2/2007-12-09-day-exterior-036.jpg,char_data/0/2007-12-09-day-exterior-036.jpg_4.jpg,819,21,1536,1557,630,669,True,2
0,32,kaist_dataset/Korean/Digital_Camera/outdoor2/2007-12-08-day-122.jpg,char_data/0/2007-12-08-day-122.jpg_1.jpg,1888,59,883,942,230,262,True,2
0,42,kaist_dataset/Korean/Digital_Camera/outdoor2/2007-12-08-day-122.jpg,char_data/0/2007-12-08-day-122.jpg_1.jpg,1050,25,1299,1324,556,598,True,2
0,34,kaist_dataset/Korean/Digital_Camera/outdoor2/DSC02426.JPG,char_data/0/DSC02426.JPG_0.jpg,1156,34,330,364,219,253,True,2
0,34,kaist_dataset/Korean/Digital_Camera/outdoor2/DSC02426.JPG,char_data/0/DSC02426.JPG_0.jpg,986,29,531,560,215,249,True,2
0,35,kaist_dataset/Korean/Digital_Camera/outdoor2/DSC02396.JPG,char_data/0/DSC02396.JPG_0.jpg,735,21,191,212,184,219,True,2
0,30,kaist_dataset/Korean/Digital_Camera/outdoor2/DSC02396.JPG,char_data/0/DSC02396.JPG_0.jpg,480,16,215,231,186,216,True,2
0,38,kaist_dataset/Korean/Digital_Camera/outdoor2/DSC02396.JPG,char_data/0/DSC02396.JPG_0.jpg,798,21,457,478,368,406,True,2
0,42,kaist_dataset/Korean/Digital_Camera/outdoor2/DSC02396.JPG,char_data/0/DSC02396.JPG_0.jpg,966,23,477,500,363,405,True,2
0,28,kaist_dataset/Korean/Digital_Camera/outdoor2/080119-0031.jpg,char_data/0/080119-0031.jpg_0.jpg,560,20,546,566,1114,1142,True,2
0,33,kaist_dataset/Korean/Digital_Camera/outdoor2/080119-0031.jpg,char_data/0/080119-0031.jpg_0.jpg,759,23,569,592,1113,1146,True,2
0,24,kaist_dataset/Korean/Digital_Camera/outdoor2/DSC02424.JPG,char_data/0/DSC02424.JPG_0.jpg,480,20,554,574,245,269,True,2
0,104,kaist_dataset/Korean/Digital_Camera/outdoor2/DSC02486.JPG,char_data/0/DSC02486.JPG_0.jpg,3536,34,111,145,235,339,True,2
0,108,kaist_dataset/Korean/Digital_Camera/outdoor2/DSC02486.JPG,char_data/0/DSC02486.JPG_0.jpg,3996,37,145,182,234,342,True,2
0,113,kaist_dataset/Korean/Digital_Camera/outdoor2/DSC02486.JPG,char_data/0/DSC02486.JPG_0.jpg,4407,39,296,335,232,345,True,2
0,115,kaist_dataset/Korean/Digital_Camera/outdoor2/DSC02486.JPG,char_data/0/DSC02486.JPG_0.jpg,4370,38,333,371,231,346,True,2
0,47,kaist_dataset/Korean/Digital_Camera/outdoor2/DSC02414.JPG,char_data/0/DSC02414.JPG_0.jpg,2021,43,103,146,241,288,True,2
0,44,kaist_dataset/Korean/Digital_Camera/outdoor2/DSC02414.JPG,char_data/0/DSC02414.JPG_0.jpg,1892,43,402,445,242,286,True,2
0,30,kaist_dataset/Korean/Digital_Camera/outdoor2/DSC02380.JPG,char_data/0/DSC02380.JPG_0.jpg,510,17,400,417,236,266,True,2
0,30,kaist_dataset/Korean/Digital_Camera/outdoor2/DSC02380.JPG,char_data/0/DSC02380.JPG_0.jpg,510,17,446,463,236,266,True,2
0,31,kaist_dataset/Korean/Digital_Camera/outdoor2/DSC02435.JPG,char_data/0/DSC02435.JPG_0.jpg,434,14,412,426,245,276,True,2
0,24,kaist_dataset/Korean/Digital_Camera/outdoor2/DSC02435.JPG,char_data/0/DSC02435.JPG_0.jpg,408,17,439,456,247,271,True,2
0,30,kaist_dataset/Korean/Digital_Camera/outdoor2/DSC02383.JPG,char_data/0/DSC02383.JPG_0.jpg,480,16,145,161,293,323,True,2
0,37,kaist_dataset/Korean/Digital_Camera/outdoor2/DSC02383.JPG,char_data/0/DSC02383.JPG_0.jpg,444,12,223,235,286,323,True,2
0,34,kaist_dataset/Korean/Digital_Camera/outdoor2/DSC02383.JPG,char_data/0/DSC02383.JPG_0.jpg,544,16,262,278,288,322,True,2
0,31,kaist_dataset/Korean/Digital_Camera/outdoor2/DSC02299.JPG,char_data/0/DSC02299.JPG_0.jpg,496,16,613,629,211,242,True,2
0,46,kaist_dataset/Korean/Digital_Camera/outdoor2/DSC02512.JPG,char_data/0/DSC02512.JPG_0.jpg,1518,33,542,575,290,336,True,2
0,48,kaist_dataset/Korean/Digital_Camera/outdoor2/DSC02512.JPG,char_data/0/DSC02512.JPG_0.jpg,1488,31,575,606,292,340,True,2
0,38,kaist_dataset/Korean/Digital_Camera/outdoor2/DSC02327.JPG,char_data/0/DSC02327.JPG_0.jpg,1102,29,281,310,358,396,True,2
0,28,kaist_dataset/Korean/Digital_Camera/outdoor2/DSC02327.JPG,char_data/0/DSC02327.JPG_0.jpg,840,30,476,506,368,396,True,2
0,33,kaist_dataset/Korean/Digital_Camera/outdoor2/DSC02327.JPG,char_data/0/DSC02327.JPG_0.jpg,1122,34,506,540,367,400,True,2
0,34,kaist_dataset/Korean/Digital_Camera/outdoor2/DSC02506.JPG,char_data/0/DSC02506.JPG_0.jpg,986,29,333,362,434,468,True,2
0,35,kaist_dataset/Korean/Digital_Camera/outdoor2/DSC02506.JPG,char_data/0/DSC02506.JPG_0.jpg,980,28,387,415,432,467,True,2
0,33,kaist_dataset/Korean/Digital_Camera/outdoor2/DSC02488.JPG,char_data/0/DSC02488.JPG_0.jpg,528,16,547,563,373,406,True,2
0,127,kaist_dataset/Korean/Digital_Camera/outdoor2/DSC02520.JPG,char_data/0/DSC02520.JPG_0.jpg,5461,43,247,290,300,427,True,2
0,118,kaist_dataset/Korean/Digital_Camera/outdoor2/DSC02520.JPG,char_data/0/DSC02520.JPG_0.jpg,3894,33,314,347,303,421,True,2
0,55,kaist_dataset/Korean/Digital_Camera/outdoor2/DSC02470.JPG,char_data/0/DSC02470.JPG_0.jpg,1815,33,361,394,376,431,True,2
0,29,kaist_dataset/Korean/Digital_Camera/outdoor2/DSC02310.JPG,char_data/0/DSC02310.JPG_0.jpg,783,27,321,348,211,240,True,2
0,36,kaist_dataset/Korean/Digital_Camera/outdoor2/DSC02523.JPG,char_data/0/DSC02523.JPG_0.jpg,1008,28,379,407,338,374,True,2
0,37,kaist_dataset/Korean/Digital_Camera/outdoor2/DSC02523.JPG,char_data/0/DSC02523.JPG_0.jpg,814,22,557,579,339,376,True,2
0,41,kaist_dataset/Korean/Digital_Camera/E-night/DSC03850.JPG,char_data/0/DSC03850.JPG_0.jpg,615,15,405,420,422,463,True,2
0,26,kaist_dataset/Korean/Digital_Camera/E-night/P1010146.JPG,char_data/0/P1010146.JPG_0.jpg,702,27,179,206,251,277,True,2
0,26,kaist_dataset/Korean/Digital_Camera/E-night/P1010146.JPG,char_data/0/P1010146.JPG_0.jpg,442,17,217,234,252,278,True,2
0,31,kaist_dataset/Korean/Digital_Camera/E-night/P1010146.JPG,char_data/0/P1010146.JPG_0.jpg,403,13,261,274,247,278,True,2
0,42,kaist_dataset/Korean/Digital_Camera/E-night/DSC03870.JPG,char_data/0/DSC03870.JPG_0.jpg,1008,24,275,299,154,196,True,2
0,44,kaist_dataset/Korean/Digital_Camera/E-night/DSC03870.JPG,char_data/0/DSC03870.JPG_0.jpg,1144,26,299,325,150,194,True,2
0,46,kaist_dataset/Korean/Digital_Camera/E-night/DSC02649.JPG,char_data/0/DSC02649.JPG_0.jpg,966,21,525,546,392,438,True,2
0,45,kaist_dataset/Korean/Digital_Camera/E-night/DSC02649.JPG,char_data/0/DSC02649.JPG_0.jpg,1125,25,581,606,390,435,True,2
0,32,kaist_dataset/Korean/Digital_Camera/E-night/DSC02626.JPG,char_data/0/DSC02626.JPG_0.jpg,512,16,33,49,382,414,True,2
0,27,kaist_dataset/Korean/Digital_Camera/E-night/DSC02626.JPG,char_data/0/DSC02626.JPG_0.jpg,378,14,216,230,372,399,True,2
0,50,kaist_dataset/Korean/Digital_Camera/E-night/DSC03019.JPG,char_data/0/DSC03019.JPG_0.jpg,2000,40,351,391,185,235,True,2
0,51,kaist_dataset/Korean/Digital_Camera/E-night/DSC03019.JPG,char_data/0/DSC03019.JPG_0.jpg,2499,49,457,506,180,231,True,2
0,41,kaist_dataset/Korean/Digital_Camera/E-night/DSC03515.JPG,char_data/0/DSC03515.JPG_0.jpg,902,22,380,402,274,315,True,2
0,45,kaist_dataset/Korean/Digital_Camera/E-night/DSC03515.JPG,char_data/0/DSC03515.JPG_0.jpg,1125,25,576,601,270,315,True,2
0,88,kaist_dataset/Korean/Digital_Camera/indoor1/DSC03364.JPG,char_data/0/DSC03364.JPG_0.jpg,5456,62,417,479,237,325,True,2
0,88,kaist_dataset/Korean/Digital_Camera/indoor1/DSC03364.JPG,char_data/0/DSC03364.JPG_0.jpg,5192,59,478,537,236,324,True,2
0,126,kaist_dataset/Korean/Digital_Camera/indoor1/DSC03375.JPG,char_data/0/DSC03375.JPG_0.jpg,9702,77,368,445,158,284,True,2
0,121,kaist_dataset/Korean/Digital_Camera/indoor1/DSC03375.JPG,char_data/0/DSC03375.JPG_0.jpg,9075,75,446,521,159,280,True,2
0,81,kaist_dataset/Korean/Digital_Camera/indoor1/080119-0030.jpg,char_data/0/080119-0030.jpg_0.jpg,4212,52,1010,1062,439,520,True,2
0,148,kaist_dataset/Korean/Digital_Camera/indoor1/DSC02700.JPG,char_data/0/DSC02700.JPG_0.jpg,14652,99,342,441,215,363,True,2
0,146,kaist_dataset/Korean/Digital_Camera/indoor1/DSC02700.JPG,char_data/0/DSC02700.JPG_0.jpg,13724,94,441,535,215,361,True,2
0,32,kaist_dataset/Korean/Digital_Camera/indoor1/DSC02700.JPG,char_data/0/DSC02700.JPG_0.jpg,544,17,287,304,423,455,True,2
0,34,kaist_dataset/Korean/Digital_Camera/indoor1/DSC03362.JPG,char_data/0/DSC03362.JPG_0.jpg,408,12,85,97,281,315,True,2
0,36,kaist_dataset/Korean/Digital_Camera/indoor1/DSC03362.JPG,char_data/0/DSC03362.JPG_0.jpg,504,14,107,121,276,312,True,2
0,69,kaist_dataset/Korean/Digital_Camera/indoor1/080119-0018.jpg,char_data/0/080119-0018.jpg_0.jpg,2415,35,818,853,432,501,True,2
0,57,kaist_dataset/Korean/Digital_Camera/indoor1/080119-0018.jpg,char_data/0/080119-0018.jpg_0.jpg,1995,35,1014,1049,770,827,True,2
0,53,kaist_dataset/Korean/Digital_Camera/indoor1/080119-0018.jpg,char_data/0/080119-0018.jpg_0.jpg,1696,32,1050,1082,774,827,True,2
0,49,kaist_dataset/Korean/Digital_Camera/indoor1/080119-0018.jpg,char_data/0/080119-0018.jpg_0.jpg,1421,29,1083,1112,776,825,True,2
0,50,kaist_dataset/Korean/Digital_Camera/indoor1/080119-0018.jpg,char_data/0/080119-0018.jpg_0.jpg,1750,35,1129,1164,777,827,True,2
0,49,kaist_dataset/Korean/Digital_Camera/indoor1/080119-0018.jpg,char_data/0/080119-0018.jpg_0.jpg,1421,29,1163,1192,777,826,True,2
0,49,kaist_dataset/Korean/Digital_Camera/indoor1/080119-0018.jpg,char_data/0/080119-0018.jpg_0.jpg,1519,31,1194,1225,775,824,True,2
0,48,kaist_dataset/Korean/Digital_Camera/indoor1/080119-0018.jpg,char_data/0/080119-0018.jpg_0.jpg,1632,34,912,946,934,982,True,2
0,195,kaist_dataset/Korean/Digital_Camera/indoor1/DSC02699.JPG,char_data/0/DSC02699.JPG_0.jpg,21645,111,273,384,229,424,True,2
0,191,kaist_dataset/Korean/Digital_Camera/indoor1/DSC02699.JPG,char_data/0/DSC02699.JPG_0.jpg,20055,105,385,490,229,420,True,2
0,123,kaist_dataset/Korean/Digital_Camera/indoor1/DSC03374.JPG,char_data/0/DSC03374.JPG_0.jpg,9102,74,213,287,292,415,True,2
0,114,kaist_dataset/Korean/Digital_Camera/indoor1/DSC03374.JPG,char_data/0/DSC03374.JPG_0.jpg,8664,76,289,365,290,404,True,2
0,120,kaist_dataset/Korean/Digital_Camera/indoor1/DSC03374.JPG,char_data/0/DSC03374.JPG_0.jpg,10560,88,366,454,289,409,True,2
0,28,kaist_dataset/Korean/Digital_Camera/outdoor7/P1010054.JPG,char_data/0/P1010054.JPG_0.jpg,672,24,564,588,227,255,True,2
0,46,kaist_dataset/Korean/Digital_Camera/outdoor7/k.jpg,char_data/0/k.jpg_0.jpg,1518,33,122,155,147,193,True,2
0,41,kaist_dataset/Korean/Digital_Camera/outdoor7/P1010069.JPG,char_data/0/P1010069.JPG_0.jpg,902,22,555,577,316,357,True,2
0,33,kaist_dataset/Korean/Digital_Camera/outdoor7/P1010003.JPG,char_data/0/P1010003.JPG_0.jpg,825,25,397,422,277,310,True,2
0,33,kaist_dataset/Korean/Digital_Camera/outdoor7/P1010136.JPG,char_data/0/P1010136.JPG_0.jpg,396,12,203,215,262,295,True,2
0,32,kaist_dataset/Korean/Digital_Camera/outdoor7/P1010136.JPG,char_data/0/P1010136.JPG_0.jpg,512,16,340,356,266,298,True,2
0,45,kaist_dataset/Korean/Digital_Camera/outdoor7/P1010111.JPG,char_data/0/P1010111.JPG_0.jpg,1620,36,564,600,223,268,True,2
0,50,kaist_dataset/Korean/Digital_Camera/outdoor7/P1010111.JPG,char_data/0/P1010111.JPG_0.jpg,1950,39,600,639,222,272,True,2
0,65,kaist_dataset/Korean/Digital_Camera/outdoor7/P1010080.JPG,char_data/0/P1010080.JPG_0.jpg,2535,39,417,456,195,260,True,2
0,33,kaist_dataset/Korean/Digital_Camera/outdoor7/P1010138.JPG,char_data/0/P1010138.JPG_0.jpg,726,22,186,208,286,319,True,2
0,53,kaist_dataset/Korean/Digital_Camera/outdoor7/P1010068.JPG,char_data/0/P1010068.JPG_0.jpg,1590,30,263,293,279,332,True,2
0,35,kaist_dataset/Korean/Digital_Camera/outdoor7/P1010055.JPG,char_data/0/P1010055.JPG_0.jpg,770,22,26,48,204,239,True,2
0,39,kaist_dataset/Korean/Digital_Camera/outdoor7/P1010009.JPG,char_data/0/P1010009.JPG_0.jpg,1092,28,516,544,267,306,True,2
0,39,kaist_dataset/Korean/Digital_Camera/outdoor7/P1010009.JPG,char_data/0/P1010009.JPG_0.jpg,1209,31,577,608,265,304,True,2
0,30,kaist_dataset/Korean/Digital_Camera/outdoor7/P1010004.JPG,char_data/0/P1010004.JPG_0.jpg,420,14,455,469,297,327,True,2
0,28,kaist_dataset/Korean/Digital_Camera/outdoor7/P1010004.JPG,char_data/0/P1010004.JPG_0.jpg,336,12,480,492,298,326,True,2
0,34,kaist_dataset/Korean/Digital_Camera/outdoor7/P1010004.JPG,char_data/0/P1010004.JPG_0.jpg,272,8,518,526,295,329,True,2
0,53,kaist_dataset/Korean/Digital_Camera/outdoor7/P1010023.JPG,char_data/0/P1010023.JPG_0.jpg,1590,30,313,343,289,342,True,2
0,66,kaist_dataset/Korean/Digital_Camera/outdoor7/DSC04483.JPG,char_data/0/DSC04483.JPG_0.jpg,2376,36,94,130,363,429,True,2
0,67,kaist_dataset/Korean/Digital_Camera/outdoor7/DSC04483.JPG,char_data/0/DSC04483.JPG_0.jpg,2546,38,129,167,364,431,True,2
0,59,kaist_dataset/Korean/Digital_Camera/outdoor7/P1010081.JPG,char_data/0/P1010081.JPG_0.jpg,2655,45,290,335,212,271,True,2
0,55,kaist_dataset/Korean/Digital_Camera/outdoor7/P1010081.JPG,char_data/0/P1010081.JPG_0.jpg,2640,48,429,477,213,268,True,2
0,40,kaist_dataset/Korean/Digital_Camera/outdoor7/P1010061.JPG,char_data/0/P1010061.JPG_0.jpg,1000,25,493,518,317,357,True,2
0,35,kaist_dataset/Korean/Digital_Camera/outdoor8/P1010143.JPG,char_data/0/P1010143.JPG_0.jpg,910,26,409,435,271,306,True,2
0,33,kaist_dataset/Korean/Digital_Camera/outdoor8/P1010143.JPG,char_data/0/P1010143.JPG_0.jpg,726,22,436,458,274,307,True,2
0,41,kaist_dataset/Korean/Digital_Camera/outdoor8/P1010189.JPG,char_data/0/P1010189.JPG_0.jpg,1353,33,143,176,232,273,True,2
0,35,kaist_dataset/Korean/Digital_Camera/outdoor8/P1010189.JPG,char_data/0/P1010189.JPG_0.jpg,1225,35,487,522,232,267,True,2
0,73,kaist_dataset/Korean/Digital_Camera/outdoor8/P1010181.JPG,char_data/0/P1010181.JPG_0.jpg,2628,36,404,440,194,267,True,2
0,93,kaist_dataset/Korean/Digital_Camera/outdoor8/P1010181.JPG,char_data/0/P1010181.JPG_0.jpg,2976,32,413,445,292,385,True,2
0,38,kaist_dataset/Korean/Digital_Camera/outdoor8/P1010142.JPG,char_data/0/P1010142.JPG_0.jpg,874,23,177,200,282,320,True,2
0,31,kaist_dataset/Korean/Digital_Camera/outdoor8/P090912069.jpg,char_data/0/P090912069.jpg_0.jpg,806,26,426,452,226,257,True,2
0,29,kaist_dataset/Korean/Digital_Camera/outdoor8/P090912069.jpg,char_data/0/P090912069.jpg_0.jpg,870,30,454,484,220,249,True,2
0,30,kaist_dataset/Korean/Digital_Camera/outdoor8/P1010178.JPG,char_data/0/P1010178.JPG_0.jpg,660,22,367,389,308,338,True,2
0,47,kaist_dataset/Korean/Digital_Camera/outdoor8/P1010147.JPG,char_data/0/P1010147.JPG_0.jpg,1363,29,522,551,315,362,True,2
0,49,kaist_dataset/Korean/Digital_Camera/outdoor8/P1010147.JPG,char_data/0/P1010147.JPG_0.jpg,1519,31,551,582,311,360,True,2
0,32,kaist_dataset/Korean/Digital_Camera/outdoor8/P1011112.JPG,char_data/0/P1011112.JPG_0.jpg,672,21,452,473,221,253,True,2
0,35,kaist_dataset/Korean/Digital_Camera/outdoor8/P1011112.JPG,char_data/0/P1011112.JPG_0.jpg,665,19,548,567,224,259,True,2
0,30,kaist_dataset/Korean/Digital_Camera/indoor2/DSC03564.JPG,char_data/0/DSC03564.JPG_0.jpg,600,20,255,275,410,440,True,2
0,27,kaist_dataset/Korean/Digital_Camera/indoor2/DSC03564.JPG,char_data/0/DSC03564.JPG_0.jpg,270,10,342,352,404,431,True,2
0,32,kaist_dataset/Korean/Digital_Camera/indoor2/DSC03564.JPG,char_data/0/DSC03564.JPG_0.jpg,480,15,421,436,401,433,True,2
0,26,kaist_dataset/Korean/Digital_Camera/indoor2/DSC03564.JPG,char_data/0/DSC03564.JPG_0.jpg,468,18,436,454,401,427,True,2
0,70,kaist_dataset/Korean/Digital_Camera/indoor2/DSC03902.JPG,char_data/0/DSC03902.JPG_0.jpg,3220,46,114,160,130,200,True,2
0,71,kaist_dataset/Korean/Digital_Camera/indoor2/DSC03902.JPG,char_data/0/DSC03902.JPG_0.jpg,3337,47,159,206,127,198,True,2
0,58,kaist_dataset/Korean/Digital_Camera/indoor2/DSC03474.JPG,char_data/0/DSC03474.JPG_0.jpg,2378,41,95,136,157,215,True,2
0,64,kaist_dataset/Korean/Digital_Camera/indoor2/DSC03475.JPG,char_data/0/DSC03475.JPG_0.jpg,3328,52,63,115,95,159,True,2
0,50,kaist_dataset/Korean/Digital_Camera/indoor2/DSC03560.JPG,char_data/0/DSC03560.JPG_0.jpg,1350,27,368,395,60,110,True,2
0,39,kaist_dataset/Korean/Digital_Camera/indoor2/DSC03530.JPG,char_data/0/DSC03530.JPG_0.jpg,702,18,232,250,216,255,True,2
0,41,kaist_dataset/Korean/Digital_Camera/indoor2/DSC03530.JPG,char_data/0/DSC03530.JPG_0.jpg,902,22,249,271,219,260,True,2
0,53,kaist_dataset/Korean/Digital_Camera/indoor2/DSC04204.JPG,char_data/0/DSC04204.JPG_0.jpg,1643,31,444,475,204,257,True,2
0,55,kaist_dataset/Korean/Digital_Camera/indoor2/DSC04204.JPG,char_data/0/DSC04204.JPG_0.jpg,1815,33,475,508,205,260,True,2
0,38,kaist_dataset/Korean/Digital_Camera/indoor2/DSC04204.JPG,char_data/0/DSC04204.JPG_0.jpg,760,20,415,435,281,319,True,2
0,43,kaist_dataset/Korean/Digital_Camera/indoor2/DSC03995.JPG,char_data/0/DSC03995.JPG_0.jpg,1161,27,495,522,267,310,True,2
0,42,kaist_dataset/Korean/Digital_Camera/indoor2/DSC03995.JPG,char_data/0/DSC03995.JPG_0.jpg,1092,26,546,572,263,305,True,2
0,52,kaist_dataset/Korean/Digital_Camera/indoor2/DSC03994.JPG,char_data/0/DSC03994.JPG_0.jpg,1560,30,428,458,288,340,True,2
0,52,kaist_dataset/Korean/Digital_Camera/indoor2/DSC03994.JPG,char_data/0/DSC03994.JPG_0.jpg,1456,28,487,515,290,342,True,2
0,33,kaist_dataset/Korean/Digital_Camera/indoor2/DSC03975.JPG,char_data/0/DSC03975.JPG_0.jpg,660,20,207,227,289,322,True,2
0,50,kaist_dataset/Korean/Digital_Camera/indoor2/DSC03497.JPG,char_data/0/DSC03497.JPG_0.jpg,1500,30,270,300,2,52,True,2
0,52,kaist_dataset/Korean/Digital_Camera/indoor2/DSC03497.JPG,char_data/0/DSC03497.JPG_0.jpg,1612,31,301,332,2,54,True,2
0,53,kaist_dataset/Korean/Digital_Camera/indoor2/DSC03497.JPG,char_data/0/DSC03497.JPG_0.jpg,1537,29,334,363,5,58,True,2
0,107,kaist_dataset/Korean/Digital_Camera/G-others/2007-12-09-day-exterior-062.jpg,char_data/0/2007-12-09-day-exterior-062.jpg_0.jpg,3638,34,597,631,1400,1507,True,2
0,47,kaist_dataset/Korean/Digital_Camera/G-others/2007-12-08-day-045.jpg,char_data/0/2007-12-08-day-045.jpg_0.jpg,658,14,31,45,803,850,True,2
0,46,kaist_dataset/Korean/Digital_Camera/G-others/005.JPG,char_data/0/005.JPG_0.jpg,1012,22,348,370,394,440,True,2
0,50,kaist_dataset/Korean/Digital_Camera/G-others/005.JPG,char_data/0/005.JPG_0.jpg,1050,21,365,386,378,428,True,2
0,18,kaist_dataset/Korean/Digital_Camera/G-others/2007-12-08-day-112.jpg,char_data/0/2007-12-08-day-112.jpg_0.jpg,180,10,427,437,1183,1201,True,2
0,45,kaist_dataset/Korean/Digital_Camera/G-others/DSC03862.JPG,char_data/0/DSC03862.JPG_0.jpg,900,20,353,373,351,396,True,2
0,42,kaist_dataset/Korean/Digital_Camera/G-others/DSC03862.JPG,char_data/0/DSC03862.JPG_0.jpg,882,21,373,394,354,396,True,2
0,90,kaist_dataset/Korean/Digital_Camera/G-others/2007-12-08-day-108.jpg,char_data/0/2007-12-08-day-108.jpg_0.jpg,4680,52,559,611,574,664,True,2
0,80,kaist_dataset/Korean/Digital_Camera/G-others/2007-12-08-day-108.jpg,char_data/0/2007-12-08-day-108.jpg_0.jpg,3120,39,858,897,678,758,True,2
0,101,kaist_dataset/Korean/Digital_Camera/G-others/2007-12-08-day-108.jpg,char_data/0/2007-12-08-day-108.jpg_0.jpg,5656,56,568,624,676,777,True,2
0,82,kaist_dataset/Korean/Digital_Camera/G-others/2007-12-08-day-108.jpg,char_data/0/2007-12-08-day-108.jpg_0.jpg,3198,39,870,909,761,843,True,2
0,127,kaist_dataset/Korean/Digital_Camera/outdoor6/DSC04445.JPG,char_data/0/DSC04445.JPG_0.jpg,11811,93,271,364,258,385,True,2
0,54,kaist_dataset/Korean/Digital_Camera/outdoor6/DSC04308.JPG,char_data/0/DSC04308.JPG_0.jpg,1674,31,162,193,385,439,True,2
0,53,kaist_dataset/Korean/Digital_Camera/outdoor6/DSC04308.JPG,char_data/0/DSC04308.JPG_0.jpg,1537,29,443,472,387,440,True,2
0,57,kaist_dataset/Korean/Digital_Camera/outdoor6/DSC04308.JPG,char_data/0/DSC04308.JPG_0.jpg,1995,35,470,505,387,444,True,2
0,28,kaist_dataset/Korean/Digital_Camera/outdoor6/DSC04062.JPG,char_data/0/DSC04062.JPG_0.jpg,364,13,576,589,306,334,True,2
0,28,kaist_dataset/Korean/Digital_Camera/outdoor6/DSC04062.JPG,char_data/0/DSC04062.JPG_0.jpg,336,12,596,608,305,333,True,2
0,43,kaist_dataset/Korean/Digital_Camera/outdoor6/DSC04400.JPG,char_data/0/DSC04400.JPG_0.jpg,946,22,376,398,221,264,True,2
0,45,kaist_dataset/Korean/Digital_Camera/outdoor6/DSC04400.JPG,char_data/0/DSC04400.JPG_0.jpg,1125,25,397,422,221,266,True,2
0,45,kaist_dataset/Korean/Digital_Camera/outdoor6/DSC04400.JPG,char_data/0/DSC04400.JPG_0.jpg,990,22,394,416,394,439,True,2
0,26,kaist_dataset/Korean/Digital_Camera/outdoor6/DSC04343.JPG,char_data/0/DSC04343.JPG_0.jpg,598,23,385,408,207,233,True,2
0,30,kaist_dataset/Korean/Digital_Camera/outdoor6/DSC04343.JPG,char_data/0/DSC04343.JPG_0.jpg,510,17,409,426,204,234,True,2
0,44,kaist_dataset/Korean/Digital_Camera/outdoor6/DSC04352.JPG,char_data/0/DSC04352.JPG_0.jpg,1056,24,462,486,284,328,True,2
0,155,kaist_dataset/Korean/Digital_Camera/outdoor6/DSC04446.JPG,char_data/0/DSC04446.JPG_0.jpg,14725,95,317,412,268,423,True,2
0,32,kaist_dataset/Korean/Digital_Camera/outdoor6/DSC04148.JPG,char_data/0/DSC04148.JPG_0.jpg,512,16,463,479,257,289,True,2
0,40,kaist_dataset/Korean/Digital_Camera/outdoor6/DSC04116.JPG,char_data/0/DSC04116.JPG_0.jpg,680,17,238,255,318,358,True,2
0,31,kaist_dataset/Korean/Digital_Camera/outdoor6/DSC04113.JPG,char_data/0/DSC04113.JPG_0.jpg,992,32,338,370,441,472,True,2
0,38,kaist_dataset/Korean/Digital_Camera/outdoor6/DSC04112.JPG,char_data/0/DSC04112.JPG_0.jpg,532,14,306,320,270,308,True,2
0,33,kaist_dataset/Korean/Digital_Camera/outdoor6/DSC04112.JPG,char_data/0/DSC04112.JPG_0.jpg,429,13,360,373,274,307,True,2
0,32,kaist_dataset/Korean/Digital_Camera/outdoor6/DSC04112.JPG,char_data/0/DSC04112.JPG_0.jpg,416,13,374,387,273,305,True,2
0,55,kaist_dataset/Korean/Digital_Camera/outdoor6/DSC04296.JPG,char_data/0/DSC04296.JPG_0.jpg,1210,22,189,211,317,372,True,2
0,59,kaist_dataset/Korean/Digital_Camera/outdoor6/DSC04296.JPG,char_data/0/DSC04296.JPG_0.jpg,1062,18,228,246,316,375,True,2
0,58,kaist_dataset/Korean/Digital_Camera/outdoor6/DSC04296.JPG,char_data/0/DSC04296.JPG_0.jpg,1102,19,404,423,304,362,True,2
0,56,kaist_dataset/Korean/Digital_Camera/outdoor6/DSC04100.JPG,char_data/0/DSC04100.JPG_0.jpg,1960,35,254,289,50,106,True,2
0,53,kaist_dataset/Korean/Digital_Camera/outdoor6/DSC04100.JPG,char_data/0/DSC04100.JPG_0.jpg,1325,25,456,481,55,108,True,2
0,59,kaist_dataset/Korean/Digital_Camera/outdoor6/DSC04073.JPG,char_data/0/DSC04073.JPG_0.jpg,2006,34,481,515,35,94,True,2
0,66,kaist_dataset/Korean/Digital_Camera/outdoor6/DSC04073.JPG,char_data/0/DSC04073.JPG_0.jpg,2046,31,540,571,33,99,True,2
0,69,kaist_dataset/Korean/Digital_Camera/outdoor6/DSC04073.JPG,char_data/0/DSC04073.JPG_0.jpg,2139,31,572,603,32,101,True,2
0,79,kaist_dataset/Korean/Digital_Camera/outdoor6/DSC04147.JPG,char_data/0/DSC04147.JPG_0.jpg,3318,42,307,349,175,254,True,2
0,30,kaist_dataset/Korean/Digital_Camera/outdoor6/DSC04046.JPG,char_data/0/DSC04046.JPG_0.jpg,600,20,405,425,261,291,True,2
0,28,kaist_dataset/Korean/Digital_Camera/outdoor6/DSC04046.JPG,char_data/0/DSC04046.JPG_0.jpg,392,14,441,455,261,289,True,2
0,32,kaist_dataset/Korean/Digital_Camera/outdoor6/DSC04046.JPG,char_data/0/DSC04046.JPG_0.jpg,512,16,483,499,256,288,True,2
0,48,kaist_dataset/Korean/Digital_Camera/A-shadow/2007-12-09-day-exterior-040.jpg,char_data/0/2007-12-09-day-exterior-040.jpg_0.jpg,912,19,1056,1075,809,857,True,2
0,75,kaist_dataset/Korean/Digital_Camera/A-shadow/DSC03755.JPG,char_data/0/DSC03755.JPG_0.jpg,2025,27,185,212,208,283,True,2
0,75,kaist_dataset/Korean/Digital_Camera/A-shadow/DSC03755.JPG,char_data/0/DSC03755.JPG_0.jpg,2850,38,245,283,209,284,True,2
0,43,kaist_dataset/Korean/Digital_Camera/A-shadow/2007-12-09-day-exterior-025.jpg,char_data/0/2007-12-09-day-exterior-025.jpg_0.jpg,1161,27,1093,1120,741,784,True,2
0,50,kaist_dataset/Korean/Digital_Camera/A-shadow/2007-12-09-day-exterior-025.jpg,char_data/0/2007-12-09-day-exterior-025.jpg_0.jpg,1650,33,1122,1155,741,791,True,2
0,44,kaist_dataset/Korean/Digital_Camera/A-shadow/DSC03536.JPG,char_data/0/DSC03536.JPG_0.jpg,1144,26,70,96,274,318,True,2
0,40,kaist_dataset/Korean/Digital_Camera/A-shadow/DSC03536.JPG,char_data/0/DSC03536.JPG_0.jpg,1120,28,124,152,274,314,True,2
0,25,kaist_dataset/Korean/Digital_Camera/A-shadow/DSC04297.JPG,char_data/0/DSC04297.JPG_0.jpg,425,17,330,347,210,235,True,2
0,34,kaist_dataset/Korean/Digital_Camera/A-shadow/DSC04297.JPG,char_data/0/DSC04297.JPG_0.jpg,612,18,492,510,207,241,True,2
0,124,kaist_dataset/Korean/Digital_Camera/A-shadow/DSC04300.JPG,char_data/0/DSC04300.JPG_0.jpg,6200,50,403,453,240,364,True,2
0,37,kaist_dataset/Korean/Digital_Camera/outdoor3/DSC02999.JPG,char_data/0/DSC02999.JPG_0.jpg,925,25,181,206,429,466,True,2
0,37,kaist_dataset/Korean/Digital_Camera/outdoor3/DSC02999.JPG,char_data/0/DSC02999.JPG_0.jpg,777,21,387,408,430,467,True,2
0,29,kaist_dataset/Korean/Digital_Camera/outdoor3/DSC02546.JPG,char_data/0/DSC02546.JPG_0.jpg,464,16,220,236,427,456,True,2
0,29,kaist_dataset/Korean/Digital_Camera/outdoor3/DSC02546.JPG,char_data/0/DSC02546.JPG_0.jpg,377,13,278,291,429,458,True,2
0,35,kaist_dataset/Korean/Digital_Camera/outdoor3/DSC02546.JPG,char_data/0/DSC02546.JPG_0.jpg,455,13,291,304,427,462,True,2
0,66,kaist_dataset/Korean/Digital_Camera/outdoor3/DSC03198.JPG,char_data/0/DSC03198.JPG_0.jpg,3498,53,265,318,199,265,True,2
0,59,kaist_dataset/Korean/Digital_Camera/outdoor3/DSC03198.JPG,char_data/0/DSC03198.JPG_0.jpg,3127,53,319,372,206,265,True,2
0,54,kaist_dataset/Korean/Digital_Camera/outdoor3/DSC03198.JPG,char_data/0/DSC03198.JPG_0.jpg,2970,55,373,428,204,258,True,2
0,38,kaist_dataset/Korean/Digital_Camera/outdoor3/DSC02944.JPG,char_data/0/DSC02944.JPG_0.jpg,912,24,340,364,228,266,True,2
0,30,kaist_dataset/Korean/Digital_Camera/outdoor3/DSC02944.JPG,char_data/0/DSC02944.JPG_0.jpg,630,21,367,388,232,262,True,2
0,75,kaist_dataset/Korean/Digital_Camera/outdoor3/DSC02900.JPG,char_data/0/DSC02900.JPG_0.jpg,3525,47,423,470,247,322,True,2
0,30,kaist_dataset/Korean/Digital_Camera/outdoor3/DSC02698.JPG,char_data/0/DSC02698.JPG_0.jpg,540,18,365,383,406,436,True,2
0,73,kaist_dataset/Korean/Digital_Camera/outdoor3/DSC02562.JPG,char_data/0/DSC02562.JPG_0.jpg,2555,35,330,365,360,433,True,2
0,80,kaist_dataset/Korean/Digital_Camera/outdoor3/DSC02562.JPG,char_data/0/DSC02562.JPG_0.jpg,2880,36,365,401,357,437,True,2
0,25,kaist_dataset/Korean/Digital_Camera/outdoor3/DSC02529.JPG,char_data/0/DSC02529.JPG_0.jpg,325,13,493,506,373,398,True,2
0,40,kaist_dataset/Korean/Digital_Camera/outdoor3/DSC02941.JPG,char_data/0/DSC02941.JPG_0.jpg,1120,28,422,450,256,296,True,2
0,47,kaist_dataset/Korean/Digital_Camera/outdoor3/DSC02941.JPG,char_data/0/DSC02941.JPG_0.jpg,987,21,451,472,255,302,True,2
0,45,kaist_dataset/Korean/Digital_Camera/outdoor3/DSC02994.JPG,char_data/0/DSC02994.JPG_0.jpg,1395,31,338,369,286,331,True,2
0,34,kaist_dataset/Korean/Digital_Camera/outdoor3/DSC03219.JPG,char_data/0/DSC03219.JPG_0.jpg,748,22,426,448,411,445,True,2
0,32,kaist_dataset/Korean/Digital_Camera/outdoor3/DSC03219.JPG,char_data/0/DSC03219.JPG_0.jpg,608,19,449,468,411,443,True,2
0,57,kaist_dataset/Korean/Digital_Camera/outdoor3/DSC03195.JPG,char_data/0/DSC03195.JPG_0.jpg,1824,32,315,347,252,309,True,2
0,61,kaist_dataset/Korean/Digital_Camera/outdoor3/DSC03195.JPG,char_data/0/DSC03195.JPG_0.jpg,2379,39,344,383,251,312,True,2
0,166,kaist_dataset/Korean/Digital_Camera/outdoor3/DSC03066.JPG,char_data/0/DSC03066.JPG_0.jpg,26560,160,337,497,235,401,True,2
0,114,kaist_dataset/Korean/Digital_Camera/outdoor3/DSC03159.JPG,char_data/0/DSC03159.JPG_0.jpg,5244,46,341,387,223,337,True,2
0,122,kaist_dataset/Korean/Digital_Camera/outdoor3/DSC03159.JPG,char_data/0/DSC03159.JPG_0.jpg,5734,47,389,436,221,343,True,2
0,31,kaist_dataset/Korean/Digital_Camera/outdoor3/DSC02888.JPG,char_data/0/DSC02888.JPG_0.jpg,713,23,278,301,421,452,True,2
0,33,kaist_dataset/Korean/Digital_Camera/outdoor3/DSC02939.JPG,char_data/0/DSC02939.JPG_0.jpg,990,30,232,262,367,400,True,2
0,37,kaist_dataset/Korean/Digital_Camera/outdoor3/DSC02561.JPG,char_data/0/DSC02561.JPG_0.jpg,999,27,368,395,353,390,True,2
0,19,kaist_dataset/Korean/Digital_Camera/outdoor1/017.JPG,char_data/0/017.JPG_0.jpg,399,21,522,543,273,292,True,2
0,35,kaist_dataset/Korean/Digital_Camera/outdoor1/091.JPG,char_data/0/091.JPG_0.jpg,875,25,361,386,286,321,True,2
0,34,kaist_dataset/Korean/Digital_Camera/outdoor1/128.JPG,char_data/0/128.JPG_0.jpg,442,13,394,407,116,150,True,2
0,29,kaist_dataset/Korean/Digital_Camera/outdoor1/126.JPG,char_data/0/126.JPG_0.jpg,348,12,445,457,257,286,True,2
0,16,kaist_dataset/Korean/Digital_Camera/outdoor1/126.JPG,char_data/0/126.JPG_0.jpg,272,17,578,595,259,275,True,2
0,27,kaist_dataset/Korean/Digital_Camera/outdoor1/023.JPG,char_data/0/023.JPG_0.jpg,864,32,302,334,270,297,True,2
0,17,kaist_dataset/Korean/Digital_Camera/outdoor1/006.JPG,char_data/0/006.JPG_0.jpg,289,17,424,441,254,271,True,2
0,20,kaist_dataset/Korean/Digital_Camera/outdoor1/013.JPG,char_data/0/013.JPG_0.jpg,160,8,419,427,249,269,True,2
0,31,kaist_dataset/Korean/Digital_Camera/outdoor1/032.JPG,char_data/0/032.JPG_0.jpg,651,21,157,178,257,288,True,2
0,33,kaist_dataset/Korean/Digital_Camera/outdoor1/125.JPG,char_data/0/125.JPG_0.jpg,792,24,370,394,255,288,True,2
0,35,kaist_dataset/Korean/Digital_Camera/outdoor1/123.JPG,char_data/0/123.JPG_0.jpg,700,20,310,330,273,308,True,2
0,36,kaist_dataset/Korean/Digital_Camera/outdoor1/123.JPG,char_data/0/123.JPG_0.jpg,792,22,474,496,273,309,True,2
0,36,kaist_dataset/Korean/Digital_Camera/outdoor1/123.JPG,char_data/0/123.JPG_0.jpg,756,21,245,266,276,312,True,2
0,26,kaist_dataset/Korean/Digital_Camera/outdoor1/035.JPG,char_data/0/035.JPG_0.jpg,520,20,559,579,291,317,True,2
0,25,kaist_dataset/Mixed/Mobile_Phone/(C.M)A-outdoor/P090912040.jpg,char_data/0/P090912040.jpg_0.jpg,550,22,285,307,194,219,True,2
0,37,kaist_dataset/Mixed/Mobile_Phone/(C.M)A-outdoor/P090912038.jpg,char_data/0/P090912038.jpg_0.jpg,814,22,276,298,159,196,True,2
0,36,kaist_dataset/Mixed/Mobile_Phone/(C.M)A-outdoor/P090912038.jpg,char_data/0/P090912038.jpg_0.jpg,828,23,312,335,160,196,True,2
0,42,kaist_dataset/Mixed/Mobile_Phone/(C.M)A-outdoor/P090912038.jpg,char_data/0/P090912038.jpg_0.jpg,798,19,450,469,153,195,True,2
0,31,kaist_dataset/Mixed/Mobile_Phone/(C.M)A-outdoor/P090912036.jpg,char_data/0/P090912036.jpg_0.jpg,558,18,303,321,191,222,True,2
0,31,kaist_dataset/Mixed/Mobile_Phone/(C.M)A-outdoor/P090912036.jpg,char_data/0/P090912036.jpg_0.jpg,434,14,373,387,191,222,True,2
0,43,kaist_dataset/Mixed/Mobile_Phone/(C.M)A-outdoor/P090912047.jpg,char_data/0/P090912047.jpg_0.jpg,903,21,353,374,271,314,True,2
0,112,kaist_dataset/Mixed/Mobile_Phone/(C.M)A-outdoor/P090911087.jpg,char_data/0/P090911087.jpg_0.jpg,7616,68,223,291,38,150,True,2
0,111,kaist_dataset/Mixed/Mobile_Phone/(C.M)A-outdoor/P090911087.jpg,char_data/0/P090911087.jpg_0.jpg,8325,75,289,364,37,148,True,2
0,58,kaist_dataset/Mixed/Mobile_Phone/(C.M)B-indoor/P090831007.jpg,char_data/0/P090831007.jpg_0.jpg,2668,46,205,251,129,187,True,2
0,58,kaist_dataset/Mixed/Mobile_Phone/(C.M)B-indoor/P090831007.jpg,char_data/0/P090831007.jpg_0.jpg,2610,45,211,256,200,258,True,2
0,57,kaist_dataset/Mixed/Mobile_Phone/(C.M)B-indoor/P090831007.jpg,char_data/0/P090831007.jpg_0.jpg,2565,45,205,250,270,327,True,2
0,96,kaist_dataset/Mixed/Mobile_Phone/(C.M)C-bookCover/P090902019.jpg,char_data/0/P090902019.jpg_0.jpg,3936,41,169,210,74,170,True,2
0,65,kaist_dataset/Mixed/Mobile_Phone/(C.M)C-bookCover/P090902019.jpg,char_data/0/P090902019.jpg_0.jpg,2730,42,109,151,280,345,True,2
0,24,kaist_dataset/Mixed/Digital_Camera/(C.S)C-outdoor1/027.JPG,char_data/0/027.JPG_0.jpg,384,16,449,465,279,303,True,2
0,47,kaist_dataset/Mixed/Digital_Camera/(C.S)C-outdoor1/2007-12-09-day-exterior-078.jpg,char_data/0/2007-12-09-day-exterior-078.jpg_0.jpg,1175,25,558,583,592,639,True,2
0,48,kaist_dataset/Mixed/Digital_Camera/(C.S)C-outdoor1/2007-12-09-day-exterior-078.jpg,char_data/0/2007-12-09-day-exterior-078.jpg_0.jpg,960,20,676,696,589,637,True,2
0,49,kaist_dataset/Mixed/Digital_Camera/(C.S)C-outdoor1/2007-12-09-day-exterior-078.jpg,char_data/0/2007-12-09-day-exterior-078.jpg_0.jpg,1029,21,760,781,583,632,True,2
0,50,kaist_dataset/Mixed/Digital_Camera/(C.S)C-outdoor1/2007-12-09-day-exterior-078.jpg,char_data/0/2007-12-09-day-exterior-078.jpg_0.jpg,900,18,848,866,580,630,True,2
0,43,kaist_dataset/Mixed/Digital_Camera/(C.S)C-outdoor1/P1010010.JPG,char_data/0/P1010010.JPG_0.jpg,1892,44,372,416,213,256,True,2
0,50,kaist_dataset/Mixed/Digital_Camera/(C.S)C-outdoor1/P1010010.JPG,char_data/0/P1010010.JPG_0.jpg,1050,21,390,411,359,409,True,2
0,65,kaist_dataset/Mixed/Digital_Camera/(C.S)C-outdoor1/2007-12-09-day-exterior-086.jpg,char_data/0/2007-12-09-day-exterior-086.jpg_0.jpg,4745,73,1167,1240,724,789,True,2
0,51,kaist_dataset/Mixed/Digital_Camera/(C.S)C-outdoor1/080116-0084.jpg,char_data/0/080116-0084.jpg_0.jpg,1836,36,651,687,305,356,True,2
0,40,kaist_dataset/Mixed/Digital_Camera/(C.S)C-outdoor1/DSC02344.JPG,char_data/0/DSC02344.JPG_0.jpg,760,19,599,618,259,299,True,2
0,303,kaist_dataset/Mixed/Digital_Camera/(C.S)C-outdoor1/2007-12-08-day-137.jpg,char_data/0/2007-12-08-day-137.jpg_0.jpg,73932,244,647,891,383,686,True,2
0,27,kaist_dataset/Mixed/Digital_Camera/(C.S)C-outdoor1/121.JPG,char_data/0/121.JPG_0.jpg,459,17,387,404,275,302,True,2
0,146,kaist_dataset/Mixed/Digital_Camera/(C.S)C-outdoor1/080118-0007.jpg,char_data/0/080118-0007.jpg_0.jpg,13870,95,272,367,194,340,True,2
0,153,kaist_dataset/Mixed/Digital_Camera/(C.S)C-outdoor1/080118-0007.jpg,char_data/0/080118-0007.jpg_0.jpg,15453,101,366,467,190,343,True,2
0,154,kaist_dataset/Mixed/Digital_Camera/(C.S)C-outdoor1/080118-0007.jpg,char_data/0/080118-0007.jpg_0.jpg,15862,103,467,570,189,343,True,2
0,51,kaist_dataset/Mixed/Digital_Camera/(C.S)C-outdoor1/2007-12-08-day-118.jpg,char_data/0/2007-12-08-day-118.jpg_0.jpg,2397,47,1390,1437,493,544,True,2
0,51,kaist_dataset/Mixed/Digital_Camera/(C.S)C-outdoor1/2007-12-08-day-118.jpg,char_data/0/2007-12-08-day-118.jpg_0.jpg,2295,45,1438,1483,496,547,True,2
0,26,kaist_dataset/Mixed/Digital_Camera/(C.S)C-outdoor1/48.JPG,char_data/0/48.JPG_0.jpg,468,18,319,337,340,366,True,2
0,25,kaist_dataset/Mixed/Digital_Camera/(C.S)C-outdoor1/48.JPG,char_data/0/48.JPG_0.jpg,300,12,388,400,341,366,True,2
0,20,kaist_dataset/Mixed/Digital_Camera/(C.S)C-outdoor1/48.JPG,char_data/0/48.JPG_0.jpg,220,11,449,460,344,364,True,2
0,40,kaist_dataset/Mixed/Digital_Camera/(C.S)C-outdoor1/56.JPG,char_data/0/56.JPG_0.jpg,1400,35,437,472,299,339,True,2
0,21,kaist_dataset/Mixed/Digital_Camera/(C.S)C-outdoor1/047.JPG,char_data/0/047.JPG_0.jpg,210,10,619,629,174,195,True,2
0,23,kaist_dataset/Mixed/Digital_Camera/(C.S)C-outdoor1/047.JPG,char_data/0/047.JPG_0.jpg,322,14,512,526,240,263,True,2
0,22,kaist_dataset/Mixed/Digital_Camera/(C.S)C-outdoor1/047.JPG,char_data/0/047.JPG_0.jpg,264,12,572,584,240,262,True,2
0,24,kaist_dataset/Mixed/Digital_Camera/(C.S)C-outdoor1/047.JPG,char_data/0/047.JPG_0.jpg,192,8,604,612,239,263,True,2
0,44,kaist_dataset/Mixed/Digital_Camera/(C.S)C-outdoor1/45.JPG,char_data/0/45.JPG_0.jpg,1628,37,407,444,363,407,True,2
0,41,kaist_dataset/Mixed/Digital_Camera/(C.S)C-outdoor1/3.JPG,char_data/0/3.JPG_0.jpg,943,23,476,499,419,460,True,2
0,47,kaist_dataset/Mixed/Digital_Camera/(C.S)C-outdoor1/3.JPG,char_data/0/3.JPG_0.jpg,940,20,565,585,415,462,True,2
0,41,kaist_dataset/Mixed/Digital_Camera/(C.S)C-outdoor1/P1010009.JPG,char_data/0/P1010009.JPG_0.jpg,1230,30,62,92,233,274,True,2
0,43,kaist_dataset/Mixed/Digital_Camera/(C.S)C-outdoor1/DSC02349.JPG,char_data/0/DSC02349.JPG_0.jpg,817,19,412,431,195,238,True,2
0,37,kaist_dataset/Mixed/Digital_Camera/(C.S)C-outdoor1/DSC02349.JPG,char_data/0/DSC02349.JPG_0.jpg,962,26,434,460,197,234,True,2
0,34,kaist_dataset/Mixed/Digital_Camera/(C.S)C-outdoor1/DSC02349.JPG,char_data/0/DSC02349.JPG_0.jpg,714,21,456,477,429,463,True,2
0,30,kaist_dataset/Mixed/Digital_Camera/(C.S)C-outdoor1/DSC02349.JPG,char_data/0/DSC02349.JPG_0.jpg,750,25,476,501,427,457,True,2
0,26,kaist_dataset/Mixed/Digital_Camera/(C.S)C-outdoor1/57.JPG,char_data/0/57.JPG_0.jpg,598,23,475,498,296,322,True,2
0,24,kaist_dataset/Mixed/Digital_Camera/(C.S)C-outdoor1/57.JPG,char_data/0/57.JPG_0.jpg,336,14,320,334,456,480,True,2
0,352,kaist_dataset/Mixed/Digital_Camera/(C.S)C-outdoor1/080119-0003.jpg,char_data/0/080119-0003.jpg_0.jpg,84128,239,619,858,651,1003,True,2
0,44,kaist_dataset/Mixed/Digital_Camera/(C.S)C-outdoor1/DSC02350.JPG,char_data/0/DSC02350.JPG_0.jpg,1056,24,399,423,395,439,True,2
0,60,kaist_dataset/Mixed/Digital_Camera/(C.S)C-outdoor1/2007-12-09-day-exterior-037.jpg,char_data/0/2007-12-09-day-exterior-037.jpg_0.jpg,3360,56,925,981,707,767,True,2
0,35,kaist_dataset/Mixed/Digital_Camera/(C.S)C-outdoor1/DSC02242.JPG,char_data/0/DSC02242.JPG_0.jpg,560,16,615,631,257,292,True,2
0,38,kaist_dataset/Mixed/Digital_Camera/(C.S)C-outdoor1/105.jpg,char_data/0/105.jpg_0.jpg,1216,32,364,396,384,422,True,2
0,91,kaist_dataset/Mixed/Digital_Camera/(C.S)C-outdoor1/DSC02244.JPG,char_data/0/DSC02244.JPG_0.jpg,4368,48,411,459,342,433,True,2
0,83,kaist_dataset/Mixed/Digital_Camera/(C.S)C-outdoor1/DSC02244.JPG,char_data/0/DSC02244.JPG_0.jpg,4067,49,458,507,349,432,True,2
0,35,kaist_dataset/Mixed/Digital_Camera/(C.S)C-outdoor1/DSC02320.JPG,char_data/0/DSC02320.JPG_0.jpg,665,19,526,545,355,390,True,2
0,44,kaist_dataset/Mixed/Digital_Camera/(C.S)C-outdoor1/2.JPG,char_data/0/2.JPG_0.jpg,1012,23,186,209,64,108,True,2
0,43,kaist_dataset/Mixed/Digital_Camera/(C.S)C-outdoor1/2.JPG,char_data/0/2.JPG_0.jpg,1118,26,222,248,64,107,True,2
0,41,kaist_dataset/Mixed/Digital_Camera/(C.S)C-outdoor1/2.JPG,char_data/0/2.JPG_0.jpg,738,18,325,343,67,108,True,2
0,40,kaist_dataset/Mixed/Digital_Camera/(C.S)C-outdoor1/2.JPG,char_data/0/2.JPG_0.jpg,840,21,400,421,64,104,True,2
0,27,kaist_dataset/Mixed/Digital_Camera/(C.S)C-outdoor1/2.JPG,char_data/0/2.JPG_0.jpg,270,10,604,614,393,420,True,2
0,26,kaist_dataset/Mixed/Digital_Camera/(C.S)C-outdoor1/2.JPG,char_data/0/2.JPG_0.jpg,286,11,624,635,393,419,True,2
0,22,kaist_dataset/Mixed/Digital_Camera/(C.S)C-outdoor1/2.JPG,char_data/0/2.JPG_0.jpg,352,16,636,652,395,417,True,2
0,39,kaist_dataset/Mixed/Digital_Camera/(C.S)C-outdoor1/DSC02322.JPG,char_data/0/DSC02322.JPG_0.jpg,1170,30,351,381,366,405,True,2
0,30,kaist_dataset/Mixed/Digital_Camera/(C.S)C-outdoor1/090.JPG,char_data/0/090.JPG_0.jpg,510,17,472,489,395,425,True,2
0,39,kaist_dataset/Mixed/Digital_Camera/(C.S)F-others/DSC02504.JPG,char_data/0/DSC02504.JPG_0.jpg,1209,31,355,386,358,397,True,2
0,33,kaist_dataset/Mixed/Digital_Camera/(C.S)F-others/DSC02504.JPG,char_data/0/DSC02504.JPG_0.jpg,1155,35,418,453,374,407,True,2
0,57,kaist_dataset/Mixed/Digital_Camera/(C.S)F-others/DSC02777.JPG,char_data/0/DSC02777.JPG_0.jpg,1824,32,84,116,312,369,True,2
0,57,kaist_dataset/Mixed/Digital_Camera/(C.S)F-others/DSC02777.JPG,char_data/0/DSC02777.JPG_0.jpg,1938,34,114,148,308,365,True,2
0,58,kaist_dataset/Mixed/Digital_Camera/(C.S)F-others/DSC02777.JPG,char_data/0/DSC02777.JPG_0.jpg,2494,43,144,187,306,364,True,2
0,44,kaist_dataset/Mixed/Digital_Camera/(C.S)F-others/DSC02799.JPG,char_data/0/DSC02799.JPG_0.jpg,792,18,84,102,393,437,True,2
0,43,kaist_dataset/Mixed/Digital_Camera/(C.S)F-others/DSC02799.JPG,char_data/0/DSC02799.JPG_0.jpg,903,21,100,121,390,433,True,2
0,41,kaist_dataset/Mixed/Digital_Camera/(C.S)F-others/DSC02799.JPG,char_data/0/DSC02799.JPG_0.jpg,943,23,120,143,387,428,True,2
0,51,kaist_dataset/Mixed/Digital_Camera/(C.S)F-others/DSC02793.JPG,char_data/0/DSC02793.JPG_0.jpg,1326,26,87,113,350,401,True,2
0,50,kaist_dataset/Mixed/Digital_Camera/(C.S)F-others/DSC02793.JPG,char_data/0/DSC02793.JPG_0.jpg,1250,25,112,137,348,398,True,2
0,41,kaist_dataset/Mixed/Digital_Camera/(C.S)F-others/DSC02793.JPG,char_data/0/DSC02793.JPG_0.jpg,1189,29,137,166,348,389,True,2
0,52,kaist_dataset/Mixed/Digital_Camera/(C.S)F-others/2007-12-08-day-044.jpg,char_data/0/2007-12-08-day-044.jpg_0.jpg,1144,22,99,121,729,781,True,2
0,49,kaist_dataset/Mixed/Digital_Camera/(C.S)F-others/2007-12-08-day-044.jpg,char_data/0/2007-12-08-day-044.jpg_0.jpg,1617,33,122,155,735,784,True,2
0,51,kaist_dataset/Mixed/Digital_Camera/(C.S)F-others/2007-12-09-day-exterior-023.jpg,char_data/0/2007-12-09-day-exterior-023.jpg_0.jpg,2652,52,1121,1173,605,656,True,2
0,37,kaist_dataset/Mixed/Digital_Camera/(C.S)F-others/DSC02803.JPG,char_data/0/DSC02803.JPG_0.jpg,888,24,169,193,355,392,True,2
0,38,kaist_dataset/Mixed/Digital_Camera/(C.S)F-others/DSC02803.JPG,char_data/0/DSC02803.JPG_0.jpg,950,25,195,220,353,391,True,2
0,48,kaist_dataset/Mixed/Digital_Camera/(C.S)F-others/DSC02803.JPG,char_data/0/DSC02803.JPG_0.jpg,3120,65,151,216,298,346,True,2
0,45,kaist_dataset/Mixed/Digital_Camera/(C.S)F-others/DSC02800.JPG,char_data/0/DSC02800.JPG_0.jpg,1305,29,73,102,269,314,True,2
0,46,kaist_dataset/Mixed/Digital_Camera/(C.S)F-others/DSC02800.JPG,char_data/0/DSC02800.JPG_0.jpg,1196,26,103,129,266,312,True,2
0,50,kaist_dataset/Mixed/Digital_Camera/(C.S)F-others/DSC02800.JPG,char_data/0/DSC02800.JPG_0.jpg,1400,28,131,159,259,309,True,2
0,41,kaist_dataset/Mixed/Digital_Camera/(C.S)D-indoor2/DSC04256.JPG,char_data/0/DSC04256.JPG_0.jpg,1025,25,489,514,106,147,True,2
0,32,kaist_dataset/Mixed/Digital_Camera/(C.S)E-night/DSC02660.JPG,char_data/0/DSC02660.JPG_0.jpg,736,23,314,337,416,448,True,2
0,34,kaist_dataset/Mixed/Digital_Camera/(C.S)E-night/DSC02660.JPG,char_data/0/DSC02660.JPG_0.jpg,918,27,369,396,416,450,True,2
0,31,kaist_dataset/Mixed/Digital_Camera/(C.S)E-night/P1010156.JPG,char_data/0/P1010156.JPG_0.jpg,961,31,447,478,240,271,True,2
0,35,kaist_dataset/Mixed/Digital_Camera/(C.S)E-night/DSC02585.JPG,char_data/0/DSC02585.JPG_0.jpg,595,17,313,330,413,448,True,2
0,34,kaist_dataset/Mixed/Digital_Camera/(C.S)E-night/DSC02585.JPG,char_data/0/DSC02585.JPG_0.jpg,544,16,345,361,412,446,True,2
0,37,kaist_dataset/Mixed/Digital_Camera/(C.S)E-night/DSC02585.JPG,char_data/0/DSC02585.JPG_0.jpg,740,20,432,452,417,454,True,2
0,36,kaist_dataset/Mixed/Digital_Camera/(C.S)E-night/DSC02585.JPG,char_data/0/DSC02585.JPG_0.jpg,432,12,453,465,418,454,True,2
0,52,kaist_dataset/Mixed/Digital_Camera/(C.S)E-night/DSC02575.JPG,char_data/0/DSC02575.JPG_0.jpg,1560,30,412,442,355,407,True,2
0,46,kaist_dataset/Mixed/Digital_Camera/(C.S)E-night/DSC03561.JPG,char_data/0/DSC03561.JPG_0.jpg,1794,39,472,511,249,295,True,2
0,36,kaist_dataset/Mixed/Digital_Camera/(C.S)E-night/DSC02569.JPG,char_data/0/DSC02569.JPG_0.jpg,792,22,250,272,412,448,True,2
0,45,kaist_dataset/Mixed/Digital_Camera/(C.S)E-night/DSC02569.JPG,char_data/0/DSC02569.JPG_0.jpg,900,20,458,478,407,452,True,2
0,68,kaist_dataset/Mixed/Digital_Camera/(C.S)E-night/DSC02600.JPG,char_data/0/DSC02600.JPG_0.jpg,4488,66,312,378,194,262,True,2
0,66,kaist_dataset/Mixed/Digital_Camera/(C.S)E-night/DSC02600.JPG,char_data/0/DSC02600.JPG_0.jpg,4554,69,379,448,196,262,True,2
0,80,kaist_dataset/Mixed/Digital_Camera/(C.S)E-night/DSC02600.JPG,char_data/0/DSC02600.JPG_0.jpg,5120,64,310,374,392,472,True,2
0,77,kaist_dataset/Mixed/Digital_Camera/(C.S)E-night/DSC02600.JPG,char_data/0/DSC02600.JPG_0.jpg,5236,68,378,446,398,475,True,2
0,55,kaist_dataset/Mixed/Digital_Camera/(C.S)D-indoor1/DSC02775.JPG,char_data/0/DSC02775.JPG_0.jpg,2145,39,48,87,229,284,True,2
0,57,kaist_dataset/Mixed/Digital_Camera/(C.S)D-indoor1/DSC02775.JPG,char_data/0/DSC02775.JPG_0.jpg,1710,30,90,120,229,286,True,2
0,56,kaist_dataset/Mixed/Digital_Camera/(C.S)D-indoor1/DSC02775.JPG,char_data/0/DSC02775.JPG_0.jpg,2072,37,122,159,229,285,True,2
0,47,kaist_dataset/Mixed/Digital_Camera/(C.S)D-indoor1/DSC02747.JPG,char_data/0/DSC02747.JPG_0.jpg,1692,36,43,79,333,380,True,2
0,43,kaist_dataset/Mixed/Digital_Camera/(C.S)D-indoor1/DSC02747.JPG,char_data/0/DSC02747.JPG_0.jpg,1462,34,78,112,333,376,True,2
0,44,kaist_dataset/Mixed/Digital_Camera/(C.S)D-indoor1/DSC02747.JPG,char_data/0/DSC02747.JPG_0.jpg,1672,38,112,150,335,379,True,2
0,49,kaist_dataset/Mixed/Digital_Camera/(C.S)D-indoor1/DSC02776.JPG,char_data/0/DSC02776.JPG_0.jpg,1715,35,71,106,268,317,True,2
0,50,kaist_dataset/Mixed/Digital_Camera/(C.S)D-indoor1/DSC02776.JPG,char_data/0/DSC02776.JPG_0.jpg,1800,36,107,143,266,316,True,2
0,45,kaist_dataset/Mixed/Digital_Camera/(C.S)D-indoor1/DSC02776.JPG,char_data/0/DSC02776.JPG_0.jpg,1800,40,141,181,263,308,True,2
0,47,kaist_dataset/Mixed/Digital_Camera/(C.S)D-indoor1/DSC02796.JPG,char_data/0/DSC02796.JPG_0.jpg,1269,27,65,92,247,294,True,2
0,45,kaist_dataset/Mixed/Digital_Camera/(C.S)D-indoor1/DSC02796.JPG,char_data/0/DSC02796.JPG_0.jpg,1260,28,92,120,248,293,True,2
0,45,kaist_dataset/Mixed/Digital_Camera/(C.S)D-indoor1/DSC02796.JPG,char_data/0/DSC02796.JPG_0.jpg,1395,31,118,149,248,293,True,2
0,24,kaist_dataset/Mixed/Digital_Camera/(C.S)D-indoor1/DSC04005.JPG,char_data/0/DSC04005.JPG_0.jpg,432,18,345,363,441,465,True,2
0,54,kaist_dataset/Mixed/Digital_Camera/(C.S)D-indoor1/DSC02771.JPG,char_data/0/DSC02771.JPG_0.jpg,1728,32,69,101,251,305,True,2
0,52,kaist_dataset/Mixed/Digital_Camera/(C.S)D-indoor1/DSC02771.JPG,char_data/0/DSC02771.JPG_0.jpg,1352,26,102,128,252,304,True,2
0,53,kaist_dataset/Mixed/Digital_Camera/(C.S)D-indoor1/DSC02771.JPG,char_data/0/DSC02771.JPG_0.jpg,1696,32,131,163,258,311,True,2
0,40,kaist_dataset/Mixed/Digital_Camera/(C.S)D-indoor1/DSC02752.JPG,char_data/0/DSC02752.JPG_0.jpg,1240,31,57,88,260,300,True,2
0,44,kaist_dataset/Mixed/Digital_Camera/(C.S)D-indoor1/DSC02752.JPG,char_data/0/DSC02752.JPG_0.jpg,1188,27,92,119,254,298,True,2
0,39,kaist_dataset/Mixed/Digital_Camera/(C.S)D-indoor1/DSC02752.JPG,char_data/0/DSC02752.JPG_0.jpg,1443,37,119,156,258,297,True,2
0,73,kaist_dataset/Mixed/Digital_Camera/(C.S)D-indoor1/DSC03998.JPG,char_data/0/DSC03998.JPG_0.jpg,2628,36,480,516,411,484,True,2
0,47,kaist_dataset/Mixed/Digital_Camera/(C.S)D-indoor1/DSC02780.JPG,char_data/0/DSC02780.JPG_0.jpg,1269,27,106,133,268,315,True,2
0,47,kaist_dataset/Mixed/Digital_Camera/(C.S)D-indoor1/DSC02780.JPG,char_data/0/DSC02780.JPG_0.jpg,1269,27,133,160,265,312,True,2
0,43,kaist_dataset/Mixed/Digital_Camera/(C.S)D-indoor1/DSC02780.JPG,char_data/0/DSC02780.JPG_0.jpg,1032,24,162,186,265,308,True,2
0,42,kaist_dataset/Mixed/Digital_Camera/(C.S)D-indoor1/DSC02755.JPG,char_data/0/DSC02755.JPG_0.jpg,1134,27,65,92,255,297,True,2
0,38,kaist_dataset/Mixed/Digital_Camera/(C.S)D-indoor1/DSC02755.JPG,char_data/0/DSC02755.JPG_0.jpg,1140,30,92,122,257,295,True,2
0,38,kaist_dataset/Mixed/Digital_Camera/(C.S)D-indoor1/DSC02755.JPG,char_data/0/DSC02755.JPG_0.jpg,1368,36,122,158,255,293,True,2
0,44,kaist_dataset/Mixed/Digital_Camera/(C.S)D-indoor1/DSC02785.JPG,char_data/0/DSC02785.JPG_0.jpg,1188,27,71,98,291,335,True,2
0,40,kaist_dataset/Mixed/Digital_Camera/(C.S)D-indoor1/DSC02785.JPG,char_data/0/DSC02785.JPG_0.jpg,1160,29,98,127,290,330,True,2
0,39,kaist_dataset/Mixed/Digital_Camera/(C.S)D-indoor1/DSC02785.JPG,char_data/0/DSC02785.JPG_0.jpg,1248,32,126,158,292,331,True,2
0,78,kaist_dataset/Mixed/Digital_Camera/(C.S)D-indoor1/DSC03909.JPG,char_data/0/DSC03909.JPG_0.jpg,3432,44,36,80,99,177,True,2
0,48,kaist_dataset/Mixed/Digital_Camera/(C.S)D-indoor1/DSC03909.JPG,char_data/0/DSC03909.JPG_0.jpg,864,18,436,454,297,345,True,2
0,53,kaist_dataset/Mixed/Digital_Camera/(C.S)D-indoor1/DSC02801.JPG,char_data/0/DSC02801.JPG_0.jpg,1590,30,60,90,270,323,True,2
0,42,kaist_dataset/Mixed/Digital_Camera/(C.S)D-indoor1/DSC02801.JPG,char_data/0/DSC02801.JPG_0.jpg,1218,29,90,119,272,314,True,2
0,40,kaist_dataset/Mixed/Digital_Camera/(C.S)D-indoor1/DSC02801.JPG,char_data/0/DSC02801.JPG_0.jpg,1480,37,118,155,270,310,True,2
0,100,kaist_dataset/Mixed/Digital_Camera/(C.S)D-indoor1/DSC04002.JPG,char_data/0/DSC04002.JPG_0.jpg,7000,70,319,389,347,447,True,2
0,39,kaist_dataset/Mixed/Digital_Camera/(C.S)D-indoor1/DSC02749.JPG,char_data/0/DSC02749.JPG_0.jpg,1014,26,93,119,367,406,True,2
0,39,kaist_dataset/Mixed/Digital_Camera/(C.S)D-indoor1/DSC02749.JPG,char_data/0/DSC02749.JPG_0.jpg,1092,28,117,145,367,406,True,2
0,36,kaist_dataset/Mixed/Digital_Camera/(C.S)D-indoor1/DSC02749.JPG,char_data/0/DSC02749.JPG_0.jpg,1152,32,146,178,368,404,True,2
0,49,kaist_dataset/Mixed/Digital_Camera/(C.S)D-indoor1/DSC02802.JPG,char_data/0/DSC02802.JPG_0.jpg,1519,31,60,91,268,317,True,2
0,52,kaist_dataset/Mixed/Digital_Camera/(C.S)D-indoor1/DSC02802.JPG,char_data/0/DSC02802.JPG_0.jpg,1716,33,92,125,267,319,True,2
0,50,kaist_dataset/Mixed/Digital_Camera/(C.S)D-indoor1/DSC02802.JPG,char_data/0/DSC02802.JPG_0.jpg,1750,35,126,161,268,318,True,2
0,53,kaist_dataset/Mixed/Digital_Camera/(C.S)D-indoor1/DSC02791.JPG,char_data/0/DSC02791.JPG_0.jpg,1431,27,82,109,323,376,True,2
0,60,kaist_dataset/Mixed/Digital_Camera/(C.S)D-indoor1/DSC02791.JPG,char_data/0/DSC02791.JPG_0.jpg,1500,25,112,137,319,379,True,2
0,61,kaist_dataset/Mixed/Digital_Camera/(C.S)D-indoor1/DSC02791.JPG,char_data/0/DSC02791.JPG_0.jpg,1647,27,141,168,313,374,True,2
0,46,kaist_dataset/Mixed/Digital_Camera/(C.S)D-indoor1/DSC03986.JPG,char_data/0/DSC03986.JPG_0.jpg,874,19,260,279,163,209,True,2
0,50,kaist_dataset/Mixed/Digital_Camera/(C.S)D-indoor1/DSC03986.JPG,char_data/0/DSC03986.JPG_0.jpg,1050,21,290,311,163,213,True,2
0,45,kaist_dataset/Mixed/Digital_Camera/(C.S)D-indoor1/DSC03986.JPG,char_data/0/DSC03986.JPG_0.jpg,540,12,410,422,163,208,True,2
0,47,kaist_dataset/Mixed/Digital_Camera/(C.S)D-indoor1/DSC02789.JPG,char_data/0/DSC02789.JPG_0.jpg,1598,34,67,101,224,271,True,2
0,43,kaist_dataset/Mixed/Digital_Camera/(C.S)D-indoor1/DSC02789.JPG,char_data/0/DSC02789.JPG_0.jpg,1247,29,103,132,224,267,True,2
0,46,kaist_dataset/Mixed/Digital_Camera/(C.S)D-indoor1/DSC02789.JPG,char_data/0/DSC02789.JPG_0.jpg,1794,39,131,170,222,268,True,2
0,39,kaist_dataset/Mixed/Digital_Camera/(C.S)D-indoor1/DSC02746.JPG,char_data/0/DSC02746.JPG_0.jpg,1131,29,95,124,295,334,True,2
0,36,kaist_dataset/Mixed/Digital_Camera/(C.S)D-indoor1/DSC02746.JPG,char_data/0/DSC02746.JPG_0.jpg,864,24,123,147,296,332,True,2
0,38,kaist_dataset/Mixed/Digital_Camera/(C.S)D-indoor1/DSC02746.JPG,char_data/0/DSC02746.JPG_0.jpg,1178,31,149,180,293,331,True,2
0,45,kaist_dataset/Mixed/Digital_Camera/(C.S)D-indoor1/DSC02794.JPG,char_data/0/DSC02794.JPG_0.jpg,1035,23,80,103,320,365,True,2
0,45,kaist_dataset/Mixed/Digital_Camera/(C.S)D-indoor1/DSC02794.JPG,char_data/0/DSC02794.JPG_0.jpg,990,22,104,126,318,363,True,2
0,50,kaist_dataset/Mixed/Digital_Camera/(C.S)D-indoor1/DSC02794.JPG,char_data/0/DSC02794.JPG_0.jpg,1200,24,128,152,317,367,True,2
0,42,kaist_dataset/Mixed/Digital_Camera/(C.S)D-indoor1/DSC02751.JPG,char_data/0/DSC02751.JPG_0.jpg,1092,26,86,112,254,296,True,2
0,42,kaist_dataset/Mixed/Digital_Camera/(C.S)D-indoor1/DSC02751.JPG,char_data/0/DSC02751.JPG_0.jpg,1386,33,107,140,253,295,True,2
0,41,kaist_dataset/Mixed/Digital_Camera/(C.S)D-indoor1/DSC02751.JPG,char_data/0/DSC02751.JPG_0.jpg,1517,37,140,177,256,297,True,2
0,34,kaist_dataset/Mixed/Digital_Camera/(C.S)D-indoor1/DSC02750.JPG,char_data/0/DSC02750.JPG_0.jpg,918,27,80,107,273,307,True,2
0,30,kaist_dataset/Mixed/Digital_Camera/(C.S)D-indoor1/DSC02750.JPG,char_data/0/DSC02750.JPG_0.jpg,780,26,108,134,274,304,True,2
0,33,kaist_dataset/Mixed/Digital_Camera/(C.S)D-indoor1/DSC02750.JPG,char_data/0/DSC02750.JPG_0.jpg,924,28,137,165,269,302,True,2
0,50,kaist_dataset/Mixed/Digital_Camera/(C.S)D-indoor1/DSC02797.JPG,char_data/0/DSC02797.JPG_0.jpg,1350,27,109,136,277,327,True,2
0,48,kaist_dataset/Mixed/Digital_Camera/(C.S)D-indoor1/DSC02797.JPG,char_data/0/DSC02797.JPG_0.jpg,1344,28,136,164,275,323,True,2
0,51,kaist_dataset/Mixed/Digital_Camera/(C.S)D-indoor1/DSC02797.JPG,char_data/0/DSC02797.JPG_0.jpg,1428,28,166,194,271,322,True,2
0,43,kaist_dataset/Mixed/Digital_Camera/(C.S)D-indoor1/DSC02782.JPG,char_data/0/DSC02782.JPG_0.jpg,1505,35,80,115,230,273,True,2
0,44,kaist_dataset/Mixed/Digital_Camera/(C.S)D-indoor1/DSC02782.JPG,char_data/0/DSC02782.JPG_0.jpg,1496,34,111,145,226,270,True,2
0,47,kaist_dataset/Mixed/Digital_Camera/(C.S)D-indoor1/DSC02782.JPG,char_data/0/DSC02782.JPG_0.jpg,2021,43,144,187,225,272,True,2
0,46,kaist_dataset/Mixed/Digital_Camera/(C.S)D-indoor1/DSC02772.JPG,char_data/0/DSC02772.JPG_0.jpg,1426,31,133,164,328,374,True,2
0,44,kaist_dataset/Mixed/Digital_Camera/(C.S)D-indoor1/DSC02772.JPG,char_data/0/DSC02772.JPG_0.jpg,1408,32,163,195,329,373,True,2
0,48,kaist_dataset/Mixed/Digital_Camera/(C.S)D-indoor1/DSC02772.JPG,char_data/0/DSC02772.JPG_0.jpg,1584,33,197,230,328,376,True,2
0,42,kaist_dataset/Mixed/Digital_Camera/(C.S)D-indoor1/DSC02748.JPG,char_data/0/DSC02748.JPG_0.jpg,1260,30,67,97,340,382,True,2
0,43,kaist_dataset/Mixed/Digital_Camera/(C.S)D-indoor1/DSC02748.JPG,char_data/0/DSC02748.JPG_0.jpg,1462,34,97,131,339,382,True,2
0,42,kaist_dataset/Mixed/Digital_Camera/(C.S)D-indoor1/DSC02748.JPG,char_data/0/DSC02748.JPG_0.jpg,1386,33,132,165,342,384,True,2
0,60,kaist_dataset/Mixed/Digital_Camera/(C.S)C-outdoor5/DSC03847.JPG,char_data/0/DSC03847.JPG_0.jpg,1800,30,333,363,14,74,True,2
0,40,kaist_dataset/Mixed/Digital_Camera/(C.S)C-outdoor5/DSC04395.JPG,char_data/0/DSC04395.JPG_0.jpg,920,23,185,208,290,330,True,2
0,46,kaist_dataset/Mixed/Digital_Camera/(C.S)C-outdoor5/DSC04395.JPG,char_data/0/DSC04395.JPG_0.jpg,828,18,209,227,287,333,True,2
0,44,kaist_dataset/Mixed/Digital_Camera/(C.S)C-outdoor5/DSC04395.JPG,char_data/0/DSC04395.JPG_0.jpg,880,20,227,247,286,330,True,2
0,39,kaist_dataset/Mixed/Digital_Camera/(C.S)C-outdoor5/DSC04144.JPG,char_data/0/DSC04144.JPG_0.jpg,858,22,345,367,416,455,True,2
0,39,kaist_dataset/Mixed/Digital_Camera/(C.S)C-outdoor5/DSC04144.JPG,char_data/0/DSC04144.JPG_0.jpg,897,23,385,408,418,457,True,2
0,160,kaist_dataset/Mixed/Digital_Camera/(C.S)C-outdoor5/DSC04451.JPG,char_data/0/DSC04451.JPG_0.jpg,13600,85,122,207,283,443,True,2
0,27,kaist_dataset/Mixed/Digital_Camera/(C.S)C-outdoor5/DSC04086.JPG,char_data/0/DSC04086.JPG_0.jpg,459,17,420,437,373,400,True,2
0,29,kaist_dataset/Mixed/Digital_Camera/(C.S)C-outdoor5/DSC04086.JPG,char_data/0/DSC04086.JPG_0.jpg,348,12,438,450,371,400,True,2
0,29,kaist_dataset/Mixed/Digital_Camera/(C.S)C-outdoor5/DSC04155.JPG,char_data/0/DSC04155.JPG_0.jpg,493,17,538,555,265,294,True,2
0,28,kaist_dataset/Mixed/Digital_Camera/(C.S)C-outdoor5/DSC04072.JPG,char_data/0/DSC04072.JPG_0.jpg,420,15,445,460,353,381,True,2
0,30,kaist_dataset/Mixed/Digital_Camera/(C.S)C-outdoor5/DSC04072.JPG,char_data/0/DSC04072.JPG_0.jpg,330,11,472,483,349,379,True,2
0,35,kaist_dataset/Mixed/Digital_Camera/(C.S)C-outdoor5/DSC04072.JPG,char_data/0/DSC04072.JPG_0.jpg,455,13,540,553,347,382,True,2
0,29,kaist_dataset/Mixed/Digital_Camera/(C.S)C-outdoor5/DSC04357.JPG,char_data/0/DSC04357.JPG_0.jpg,493,17,202,219,380,409,True,2
0,33,kaist_dataset/Mixed/Digital_Camera/(C.S)C-outdoor5/DSC04357.JPG,char_data/0/DSC04357.JPG_0.jpg,495,15,241,256,377,410,True,2
0,31,kaist_dataset/Mixed/Digital_Camera/(C.S)C-outdoor5/DSC04357.JPG,char_data/0/DSC04357.JPG_0.jpg,434,14,256,270,377,408,True,2
0,28,kaist_dataset/Mixed/Digital_Camera/(C.S)C-outdoor5/DSC04357.JPG,char_data/0/DSC04357.JPG_0.jpg,560,20,223,243,382,410,True,2
0,72,kaist_dataset/Mixed/Digital_Camera/(C.S)C-outdoor5/DSC04016.JPG,char_data/0/DSC04016.JPG_0.jpg,3024,42,362,404,321,393,True,2
0,41,kaist_dataset/Mixed/Digital_Camera/(C.S)C-outdoor5/DSC04122.JPG,char_data/0/DSC04122.JPG_0.jpg,615,15,425,440,411,452,True,2
0,35,kaist_dataset/Mixed/Digital_Camera/(C.S)C-outdoor5/DSC04061.JPG,char_data/0/DSC04061.JPG_0.jpg,630,18,547,565,144,179,True,2
0,35,kaist_dataset/Mixed/Digital_Camera/(C.S)C-outdoor5/DSC04061.JPG,char_data/0/DSC04061.JPG_0.jpg,525,15,580,595,139,174,True,2
0,58,kaist_dataset/Mixed/Digital_Camera/(C.S)C-outdoor5/DSC04401.JPG,char_data/0/DSC04401.JPG_0.jpg,2204,38,561,599,247,305,True,2
0,41,kaist_dataset/Mixed/Digital_Camera/(C.S)C-outdoor5/DSC04014.JPG,char_data/0/DSC04014.JPG_0.jpg,779,19,205,224,300,341,True,2
0,41,kaist_dataset/Mixed/Digital_Camera/(C.S)C-outdoor5/DSC04014.JPG,char_data/0/DSC04014.JPG_0.jpg,820,20,341,361,300,341,True,2
0,36,kaist_dataset/Mixed/Digital_Camera/(C.S)C-outdoor5/DSC04014.JPG,char_data/0/DSC04014.JPG_0.jpg,900,25,376,401,302,338,True,2
0,59,kaist_dataset/Mixed/Digital_Camera/(C.S)C-outdoor5/DSC04033.JPG,char_data/0/DSC04033.JPG_0.jpg,2065,35,423,458,267,326,True,2
0,39,kaist_dataset/Mixed/Digital_Camera/(C.S)C-outdoor5/DSC03821.JPG,char_data/0/DSC03821.JPG_0.jpg,897,23,381,404,85,124,True,2
0,37,kaist_dataset/Mixed/Digital_Camera/(C.S)C-outdoor5/DSC03821.JPG,char_data/0/DSC03821.JPG_0.jpg,851,23,425,448,86,123,True,2
0,44,kaist_dataset/Mixed/Digital_Camera/(C.S)C-outdoor5/DSC03821.JPG,char_data/0/DSC03821.JPG_0.jpg,968,22,212,234,72,116,True,2
0,63,kaist_dataset/Mixed/Digital_Camera/(C.S)C-outdoor5/DSC03837.JPG,char_data/0/DSC03837.JPG_0.jpg,2394,38,85,123,297,360,True,2
0,59,kaist_dataset/Mixed/Digital_Camera/(C.S)C-outdoor5/DSC03837.JPG,char_data/0/DSC03837.JPG_0.jpg,2242,38,360,398,307,366,True,2
0,60,kaist_dataset/Mixed/Digital_Camera/(C.S)C-outdoor5/DSC03837.JPG,char_data/0/DSC03837.JPG_0.jpg,2160,36,397,433,307,367,True,2
0,56,kaist_dataset/Mixed/Digital_Camera/(C.S)C-outdoor5/DSC03837.JPG,char_data/0/DSC03837.JPG_0.jpg,2072,37,466,503,311,367,True,2
0,43,kaist_dataset/Mixed/Digital_Camera/(C.S)C-outdoor5/DSC04125.JPG,char_data/0/DSC04125.JPG_0.jpg,1118,26,140,166,181,224,True,2
0,40,kaist_dataset/Mixed/Digital_Camera/(C.S)C-outdoor5/DSC04070.JPG,char_data/0/DSC04070.JPG_0.jpg,720,18,452,470,103,143,True,2
0,66,kaist_dataset/Mixed/Digital_Camera/(C.S)C-outdoor5/DSC04450.JPG,char_data/0/DSC04450.JPG_0.jpg,2178,33,351,384,133,199,True,2
0,34,kaist_dataset/Mixed/Digital_Camera/(C.S)C-outdoor5/DSC04048.JPG,char_data/0/DSC04048.JPG_0.jpg,442,13,366,379,170,204,True,2
0,42,kaist_dataset/Mixed/Digital_Camera/(C.S)C-outdoor5/DSC04135.JPG,char_data/0/DSC04135.JPG_0.jpg,924,22,513,535,393,435,True,2
0,44,kaist_dataset/Mixed/Digital_Camera/(C.S)C-outdoor5/DSC04135.JPG,char_data/0/DSC04135.JPG_0.jpg,1232,28,562,590,394,438,True,2
0,88,kaist_dataset/Mixed/Digital_Camera/(C.S)C-outdoor5/DSC04054.JPG,char_data/0/DSC04054.JPG_0.jpg,7128,81,343,424,68,156,True,2
0,93,kaist_dataset/Mixed/Digital_Camera/(C.S)C-outdoor5/DSC04054.JPG,char_data/0/DSC04054.JPG_0.jpg,7905,85,515,600,67,160,True,2
0,44,kaist_dataset/Mixed/Digital_Camera/(C.S)C-outdoor5/DSC04055.JPG,char_data/0/DSC04055.JPG_0.jpg,1408,32,108,140,369,413,True,2
0,38,kaist_dataset/Mixed/Digital_Camera/(C.S)C-outdoor5/DSC04055.JPG,char_data/0/DSC04055.JPG_0.jpg,1368,36,171,207,371,409,True,2
0,41,kaist_dataset/Mixed/Digital_Camera/(C.S)C-outdoor5/DSC03842.JPG,char_data/0/DSC03842.JPG_0.jpg,902,22,299,321,228,269,True,2
0,38,kaist_dataset/Mixed/Digital_Camera/(C.S)C-outdoor5/DSC03842.JPG,char_data/0/DSC03842.JPG_0.jpg,874,23,322,345,228,266,True,2
0,42,kaist_dataset/Mixed/Digital_Camera/(C.S)C-outdoor5/DSC03842.JPG,char_data/0/DSC03842.JPG_0.jpg,966,23,367,390,228,270,True,2
0,30,kaist_dataset/Mixed/Digital_Camera/(C.S)C-outdoor5/DSC04056.JPG,char_data/0/DSC04056.JPG_0.jpg,630,21,562,583,301,331,True,2
0,39,kaist_dataset/Mixed/Digital_Camera/(C.S)C-outdoor5/DSC04115.JPG,char_data/0/DSC04115.JPG_0.jpg,936,24,435,459,354,393,True,2
0,103,kaist_dataset/Mixed/Digital_Camera/(C.S)C-outdoor5/P1010006.JPG,char_data/0/P1010006.JPG_0.jpg,6695,65,212,277,202,305,True,2
0,108,kaist_dataset/Mixed/Digital_Camera/(C.S)C-outdoor5/P1010006.JPG,char_data/0/P1010006.JPG_0.jpg,7020,65,279,344,192,300,True,2
0,33,kaist_dataset/Mixed/Digital_Camera/(C.S)C-outdoor3/DSC03316.JPG,char_data/0/DSC03316.JPG_0.jpg,726,22,468,490,81,114,True,2
0,36,kaist_dataset/Mixed/Digital_Camera/(C.S)C-outdoor3/DSC03316.JPG,char_data/0/DSC03316.JPG_0.jpg,540,15,565,580,79,115,True,2
0,25,kaist_dataset/Mixed/Digital_Camera/(C.S)C-outdoor3/DSC03292.JPG,char_data/0/DSC03292.JPG_0.jpg,325,13,553,566,120,145,True,2
0,18,kaist_dataset/Mixed/Digital_Camera/(C.S)C-outdoor3/DSC03292.JPG,char_data/0/DSC03292.JPG_0.jpg,234,13,566,579,124,142,True,2
0,42,kaist_dataset/Mixed/Digital_Camera/(C.S)C-outdoor3/DSC03199.JPG,char_data/0/DSC03199.JPG_0.jpg,840,20,452,472,383,425,True,2
0,57,kaist_dataset/Mixed/Digital_Camera/(C.S)C-outdoor3/DSC03199.JPG,char_data/0/DSC03199.JPG_0.jpg,2166,38,280,318,324,381,True,2
0,56,kaist_dataset/Mixed/Digital_Camera/(C.S)C-outdoor3/DSC03199.JPG,char_data/0/DSC03199.JPG_0.jpg,2184,39,549,588,320,376,True,2
0,27,kaist_dataset/Mixed/Digital_Camera/(C.S)C-outdoor3/DSC03303.JPG,char_data/0/DSC03303.JPG_0.jpg,729,27,373,400,277,304,True,2
0,25,kaist_dataset/Mixed/Digital_Camera/(C.S)C-outdoor3/DSC03303.JPG,char_data/0/DSC03303.JPG_0.jpg,650,26,424,450,277,302,True,2
0,36,kaist_dataset/Mixed/Digital_Camera/(C.S)C-outdoor3/DSC03051.JPG,char_data/0/DSC03051.JPG_0.jpg,720,20,357,377,315,351,True,2
0,37,kaist_dataset/Mixed/Digital_Camera/(C.S)C-outdoor3/DSC03187.JPG,char_data/0/DSC03187.JPG_0.jpg,1147,31,443,474,392,429,True,2
0,37,kaist_dataset/Mixed/Digital_Camera/(C.S)C-outdoor3/DSC02970.JPG,char_data/0/DSC02970.JPG_0.jpg,1406,38,279,317,363,400,True,2
0,43,kaist_dataset/Mixed/Digital_Camera/(C.S)C-outdoor3/DSC02970.JPG,char_data/0/DSC02970.JPG_0.jpg,1333,31,347,378,358,401,True,2
0,45,kaist_dataset/Mixed/Digital_Camera/(C.S)C-outdoor3/DSC03212.JPG,char_data/0/DSC03212.JPG_0.jpg,1170,26,432,458,252,297,True,2
0,31,kaist_dataset/Mixed/Digital_Camera/(C.S)C-outdoor3/DSC03328.JPG,char_data/0/DSC03328.JPG_0.jpg,775,25,250,275,404,435,True,2
0,41,kaist_dataset/Mixed/Digital_Camera/(C.S)C-outdoor3/DSC03236.JPG,char_data/0/DSC03236.JPG_0.jpg,1271,31,329,360,422,463,True,2
0,40,kaist_dataset/Mixed/Digital_Camera/(C.S)C-outdoor3/DSC03236.JPG,char_data/0/DSC03236.JPG_0.jpg,1240,31,386,417,422,462,True,2
0,32,kaist_dataset/Mixed/Digital_Camera/(C.S)C-outdoor3/DSC03315.JPG,char_data/0/DSC03315.JPG_0.jpg,576,18,449,467,120,152,True,2
0,59,kaist_dataset/Mixed/Digital_Camera/(C.S)C-outdoor3/DSC03314.JPG,char_data/0/DSC03314.JPG_0.jpg,1534,26,433,459,362,421,True,2
0,41,kaist_dataset/Mixed/Digital_Camera/(C.S)C-outdoor3/DSC03185.JPG,char_data/0/DSC03185.JPG_0.jpg,1968,48,379,427,155,196,True,2
0,47,kaist_dataset/Mixed/Digital_Camera/(C.S)C-outdoor3/DSC03185.JPG,char_data/0/DSC03185.JPG_0.jpg,2162,46,425,471,152,199,True,2
0,64,kaist_dataset/Mixed/Digital_Camera/(C.S)C-outdoor3/DSC03267.JPG,char_data/0/DSC03267.JPG_0.jpg,2688,42,288,330,57,121,True,2
0,59,kaist_dataset/Mixed/Digital_Camera/(C.S)C-outdoor3/DSC03267.JPG,char_data/0/DSC03267.JPG_0.jpg,2891,49,328,377,57,116,True,2
0,53,kaist_dataset/Mixed/Digital_Camera/(C.S)C-outdoor3/DSC03067.JPG,char_data/0/DSC03067.JPG_0.jpg,1961,37,378,415,195,248,True,2
0,56,kaist_dataset/Mixed/Digital_Camera/(C.S)C-outdoor3/DSC03067.JPG,char_data/0/DSC03067.JPG_0.jpg,2016,36,415,451,196,252,True,2
0,34,kaist_dataset/Mixed/Digital_Camera/(C.S)C-outdoor3/DSC03311.JPG,char_data/0/DSC03311.JPG_0.jpg,646,19,285,304,372,406,True,2
0,28,kaist_dataset/Mixed/Digital_Camera/(C.S)C-outdoor3/DSC03311.JPG,char_data/0/DSC03311.JPG_0.jpg,476,17,407,424,371,399,True,2
0,94,kaist_dataset/Mixed/Digital_Camera/(C.S)C-outdoor3/DSC03340.JPG,char_data/0/DSC03340.JPG_0.jpg,9494,101,372,473,245,339,True,2
0,40,kaist_dataset/Mixed/Digital_Camera/(C.S)C-outdoor3/DSC02969.JPG,char_data/0/DSC02969.JPG_0.jpg,800,20,347,367,227,267,True,2
0,35,kaist_dataset/Mixed/Digital_Camera/(C.S)C-outdoor3/DSC02969.JPG,char_data/0/DSC02969.JPG_0.jpg,665,19,442,461,231,266,True,2
0,40,kaist_dataset/Mixed/Digital_Camera/(C.S)C-outdoor3/DSC03309.JPG,char_data/0/DSC03309.JPG_0.jpg,760,19,329,348,257,297,True,2
0,36,kaist_dataset/Mixed/Digital_Camera/(C.S)C-outdoor3/DSC03309.JPG,char_data/0/DSC03309.JPG_0.jpg,720,20,372,392,259,295,True,2
0,30,kaist_dataset/Mixed/Digital_Camera/(C.S)C-outdoor3/DSC03308.JPG,char_data/0/DSC03308.JPG_0.jpg,630,21,294,315,248,278,True,2
0,82,kaist_dataset/Mixed/Digital_Camera/(C.S)C-outdoor6/P1010063.JPG,char_data/0/P1010063.JPG_0.jpg,5576,68,264,332,140,222,True,2
0,90,kaist_dataset/Mixed/Digital_Camera/(C.S)C-outdoor6/P1010063.JPG,char_data/0/P1010063.JPG_0.jpg,5850,65,334,399,138,228,True,2
0,92,kaist_dataset/Mixed/Digital_Camera/(C.S)C-outdoor6/P1010063.JPG,char_data/0/P1010063.JPG_0.jpg,6532,71,399,470,139,231,True,2
0,23,kaist_dataset/Mixed/Digital_Camera/(C.S)C-outdoor6/P1010063.JPG,char_data/0/P1010063.JPG_0.jpg,276,12,185,197,452,475,True,2
0,23,kaist_dataset/Mixed/Digital_Camera/(C.S)C-outdoor6/P1010063.JPG,char_data/0/P1010063.JPG_0.jpg,184,8,197,205,450,473,True,2
0,26,kaist_dataset/Mixed/Digital_Camera/(C.S)C-outdoor6/P1010082.JPG,char_data/0/P1010082.JPG_0.jpg,468,18,484,502,231,257,True,2
0,24,kaist_dataset/Mixed/Digital_Camera/(C.S)C-outdoor6/P1010075.JPG,char_data/0/P1010075.JPG_0.jpg,552,23,548,571,311,335,True,2
0,31,kaist_dataset/Mixed/Digital_Camera/(C.S)C-outdoor6/P1010073.JPG,char_data/0/P1010073.JPG_0.jpg,465,15,383,398,241,272,True,2
0,131,kaist_dataset/Mixed/Digital_Camera/(C.S)C-outdoor6/P1010045.JPG,char_data/0/P1010045.JPG_0.jpg,14148,108,286,394,147,278,True,2
0,31,kaist_dataset/Mixed/Digital_Camera/(C.S)C-outdoor6/P1010069.JPG,char_data/0/P1010069.JPG_0.jpg,837,27,586,613,315,346,True,2
0,21,kaist_dataset/Mixed/Digital_Camera/(C.S)C-outdoor6/P1010094.JPG,char_data/0/P1010094.JPG_0.jpg,483,23,558,581,220,241,True,2
0,22,kaist_dataset/Mixed/Digital_Camera/(C.S)C-outdoor6/P1010094.JPG,char_data/0/P1010094.JPG_0.jpg,374,17,581,598,218,240,True,2
0,24,kaist_dataset/Mixed/Digital_Camera/(C.S)C-outdoor6/P1010088.JPG,char_data/0/P1010088.JPG_0.jpg,288,12,374,386,220,244,True,2
0,35,kaist_dataset/Mixed/Digital_Camera/(C.S)C-outdoor6/P1010020.JPG,char_data/0/P1010020.JPG_0.jpg,700,20,206,226,336,371,True,2
0,42,kaist_dataset/Mixed/Digital_Camera/(C.S)C-outdoor6/P1010111.JPG,char_data/0/P1010111.JPG_0.jpg,1554,37,353,390,200,242,True,2
0,36,kaist_dataset/Mixed/Digital_Camera/(C.S)C-outdoor6/P1010111.JPG,char_data/0/P1010111.JPG_0.jpg,1296,36,420,456,204,240,True,2
0,33,kaist_dataset/Mixed/Digital_Camera/(C.S)C-outdoor6/P1010080.JPG,char_data/0/P1010080.JPG_0.jpg,924,28,478,506,247,280,True,2
0,29,kaist_dataset/Mixed/Digital_Camera/(C.S)C-outdoor6/P1010093.JPG,char_data/0/P1010093.JPG_0.jpg,522,18,568,586,246,275,True,2
0,28,kaist_dataset/Mixed/Digital_Camera/(C.S)C-outdoor6/P1010093.JPG,char_data/0/P1010093.JPG_0.jpg,588,21,600,621,248,276,True,2
0,39,kaist_dataset/Mixed/Digital_Camera/(C.S)C-outdoor6/P1010021.JPG,char_data/0/P1010021.JPG_0.jpg,1053,27,285,312,208,247,True,2
0,41,kaist_dataset/Mixed/Digital_Camera/(C.S)C-outdoor6/P1010021.JPG,char_data/0/P1010021.JPG_0.jpg,1189,29,314,343,206,247,True,2
0,37,kaist_dataset/Mixed/Digital_Camera/(C.S)C-outdoor6/P1010084.JPG,char_data/0/P1010084.JPG_0.jpg,851,23,28,51,186,223,True,2
0,43,kaist_dataset/Mixed/Digital_Camera/(C.S)C-outdoor6/P1010084.JPG,char_data/0/P1010084.JPG_0.jpg,1462,34,492,526,188,231,True,2
0,20,kaist_dataset/Mixed/Digital_Camera/(C.S)C-outdoor6/P1010129.JPG,char_data/0/P1010129.JPG_0.jpg,400,20,463,483,237,257,False,2
0,41,kaist_dataset/Mixed/Digital_Camera/(C.S)C-outdoor6/P1010103.JPG,char_data/0/P1010103.JPG_0.jpg,779,19,535,554,194,235,False,2
0,26,kaist_dataset/Mixed/Digital_Camera/(C.S)C-outdoor6/P1010114.JPG,char_data/0/P1010114.JPG_0.jpg,494,19,516,535,216,242,False,2
0,38,kaist_dataset/Mixed/Digital_Camera/(C.S)C-outdoor6/P1010056.JPG,char_data/0/P1010056.JPG_0.jpg,608,16,402,418,227,265,False,2
0,42,kaist_dataset/Mixed/Digital_Camera/(C.S)C-outdoor6/P1010018.JPG,char_data/0/P1010018.JPG_0.jpg,1176,28,296,324,237,279,False,2
0,39,kaist_dataset/Mixed/Digital_Camera/(C.S)C-outdoor6/P1010018.JPG,char_data/0/P1010018.JPG_0.jpg,1092,28,547,575,240,279,False,2
0,58,kaist_dataset/Mixed/Digital_Camera/(C.S)C-outdoor6/P1010067.JPG,char_data/0/P1010067.JPG_0.jpg,2726,47,586,633,306,364,False,2
0,37,kaist_dataset/Mixed/Digital_Camera/(C.S)C-outdoor6/P1010137.JPG,char_data/0/P1010137.JPG_0.jpg,851,23,20,43,70,107,False,2
0,36,kaist_dataset/Mixed/Digital_Camera/(C.S)C-outdoor6/P1010137.JPG,char_data/0/P1010137.JPG_0.jpg,1188,33,89,122,69,105,False,2
0,32,kaist_dataset/Mixed/Digital_Camera/(C.S)C-outdoor6/P1010074.JPG,char_data/0/P1010074.JPG_0.jpg,1152,36,350,386,304,336,False,2
0,70,kaist_dataset/Mixed/Digital_Camera/(C.S)C-outdoor4/DSC03730.JPG,char_data/0/DSC03730.JPG_0.jpg,3990,57,365,422,323,393,False,2
0,68,kaist_dataset/Mixed/Digital_Camera/(C.S)C-outdoor4/DSC03730.JPG,char_data/0/DSC03730.JPG_0.jpg,4828,71,416,487,322,390,False,2
0,41,kaist_dataset/Mixed/Digital_Camera/(C.S)C-outdoor4/DSC03604.JPG,char_data/0/DSC03604.JPG_0.jpg,1148,28,301,329,86,127,False,2
0,40,kaist_dataset/Mixed/Digital_Camera/(C.S)C-outdoor4/DSC03604.JPG,char_data/0/DSC03604.JPG_0.jpg,1120,28,329,357,85,125,False,2
0,48,kaist_dataset/Mixed/Digital_Camera/(C.S)C-outdoor4/DSC03613.JPG,char_data/0/DSC03613.JPG_0.jpg,1008,21,377,398,26,74,False,2
0,29,kaist_dataset/Mixed/Digital_Camera/(C.S)C-outdoor4/DSC03570.JPG,char_data/0/DSC03570.JPG_0.jpg,493,17,324,341,425,454,False,2
0,31,kaist_dataset/Mixed/Digital_Camera/(C.S)C-outdoor4/DSC03733.JPG,char_data/0/DSC03733.JPG_0.jpg,558,18,535,553,176,207,False,2
0,31,kaist_dataset/Mixed/Digital_Camera/(C.S)C-outdoor4/DSC03733.JPG,char_data/0/DSC03733.JPG_0.jpg,496,16,566,582,175,206,False,2
0,63,kaist_dataset/Mixed/Digital_Camera/(C.S)C-outdoor4/DSC03702.JPG,char_data/0/DSC03702.JPG_0.jpg,3024,48,310,358,340,403,False,2
0,63,kaist_dataset/Mixed/Digital_Camera/(C.S)C-outdoor4/DSC03702.JPG,char_data/0/DSC03702.JPG_0.jpg,2709,43,359,402,339,402,False,2
0,40,kaist_dataset/Mixed/Digital_Camera/(C.S)C-outdoor4/DSC03674.JPG,char_data/0/DSC03674.JPG_0.jpg,960,24,524,548,354,394,False,2
0,37,kaist_dataset/Mixed/Digital_Camera/(C.S)C-outdoor4/DSC03674.JPG,char_data/0/DSC03674.JPG_0.jpg,666,18,547,565,354,391,False,2
0,42,kaist_dataset/Mixed/Digital_Camera/(C.S)C-outdoor4/DSC03674.JPG,char_data/0/DSC03674.JPG_0.jpg,966,23,564,587,344,386,False,2
0,30,kaist_dataset/Mixed/Digital_Camera/(C.S)C-outdoor4/DSC03677.JPG,char_data/0/DSC03677.JPG_0.jpg,330,11,508,519,314,344,False,2
0,30,kaist_dataset/Mixed/Digital_Camera/(C.S)C-outdoor4/DSC03677.JPG,char_data/0/DSC03677.JPG_0.jpg,300,10,530,540,314,344,False,2
0,28,kaist_dataset/Mixed/Digital_Camera/(C.S)C-outdoor4/DSC03677.JPG,char_data/0/DSC03677.JPG_0.jpg,308,11,568,579,311,339,False,2
0,33,kaist_dataset/Mixed/Digital_Camera/(C.S)C-outdoor4/DSC03677.JPG,char_data/0/DSC03677.JPG_0.jpg,429,13,597,610,310,343,False,2
0,39,kaist_dataset/Mixed/Digital_Camera/(C.S)C-outdoor4/DSC03677.JPG,char_data/0/DSC03677.JPG_0.jpg,429,11,620,631,307,346,False,2
0,44,kaist_dataset/Mixed/Digital_Camera/(C.S)C-outdoor4/DSC03693.JPG,char_data/0/DSC03693.JPG_0.jpg,1100,25,485,510,354,398,False,2
0,42,kaist_dataset/Mixed/Digital_Camera/(C.S)C-outdoor4/DSC03435.JPG,char_data/0/DSC03435.JPG_0.jpg,924,22,168,190,410,452,False,2
0,35,kaist_dataset/Mixed/Digital_Camera/(C.S)C-outdoor4/DSC03435.JPG,char_data/0/DSC03435.JPG_0.jpg,490,14,512,526,416,451,False,2
0,39,kaist_dataset/Mixed/Digital_Camera/(C.S)C-outdoor4/DSC03435.JPG,char_data/0/DSC03435.JPG_0.jpg,429,11,527,538,413,452,False,2
0,38,kaist_dataset/Mixed/Digital_Camera/(C.S)C-outdoor4/DSC03435.JPG,char_data/0/DSC03435.JPG_0.jpg,722,19,99,118,233,271,False,2
0,35,kaist_dataset/Mixed/Digital_Camera/(C.S)C-outdoor4/DSC03658.JPG,char_data/0/DSC03658.JPG_0.jpg,805,23,376,399,414,449,False,2
0,40,kaist_dataset/Mixed/Digital_Camera/(C.S)C-outdoor4/DSC03658.JPG,char_data/0/DSC03658.JPG_0.jpg,760,19,399,418,411,451,False,2
0,29,kaist_dataset/Mixed/Digital_Camera/(C.S)C-outdoor4/DSC03637.JPG,char_data/0/DSC03637.JPG_0.jpg,435,15,328,343,297,326,False,2
0,89,kaist_dataset/Mixed/Digital_Camera/(C.S)C-outdoor4/DSC03544.JPG,char_data/0/DSC03544.JPG_0.jpg,4094,46,384,430,169,258,False,2
0,38,kaist_dataset/Mixed/Digital_Camera/(C.S)C-outdoor4/DSC03660.JPG,char_data/0/DSC03660.JPG_0.jpg,1064,28,377,405,97,135,False,2
0,32,kaist_dataset/Mixed/Digital_Camera/(C.S)C-outdoor4/DSC03640.JPG,char_data/0/DSC03640.JPG_0.jpg,544,17,233,250,398,430,False,2
0,44,kaist_dataset/Mixed/Digital_Camera/(C.S)C-outdoor4/DSC03548.JPG,char_data/0/DSC03548.JPG_0.jpg,2156,49,375,424,397,441,False,2
0,49,kaist_dataset/Mixed/Digital_Camera/(C.S)C-outdoor4/DSC03548.JPG,char_data/0/DSC03548.JPG_0.jpg,2401,49,422,471,394,443,False,2
0,30,kaist_dataset/Mixed/Digital_Camera/(C.S)C-outdoor4/DSC03661.JPG,char_data/0/DSC03661.JPG_0.jpg,570,19,376,395,336,366,False,2
0,33,kaist_dataset/Mixed/Digital_Camera/(C.S)C-outdoor4/DSC03661.JPG,char_data/0/DSC03661.JPG_0.jpg,627,19,408,427,334,367,False,2
0,37,kaist_dataset/Mixed/Digital_Camera/(C.S)C-outdoor4/DSC03691.JPG,char_data/0/DSC03691.JPG_0.jpg,444,12,628,640,216,253,False,2
0,35,kaist_dataset/Mixed/Digital_Camera/(C.S)C-outdoor4/DSC03657.JPG,char_data/0/DSC03657.JPG_0.jpg,665,19,352,371,421,456,False,2
0,35,kaist_dataset/Mixed/Digital_Camera/(C.S)C-outdoor4/DSC03618.JPG,char_data/0/DSC03618.JPG_0.jpg,1085,31,331,362,411,446,False,2
0,46,kaist_dataset/Mixed/Digital_Camera/(C.S)C-outdoor4/DSC03534.JPG,char_data/0/DSC03534.JPG_0.jpg,1380,30,319,349,286,332,False,2
0,36,kaist_dataset/Mixed/Digital_Camera/(C.S)C-outdoor4/DSC03745.JPG,char_data/0/DSC03745.JPG_0.jpg,756,21,540,561,270,306,False,2
0,52,kaist_dataset/Mixed/Digital_Camera/(C.S)C-outdoor4/DSC03655.JPG,char_data/0/DSC03655.JPG_0.jpg,1404,27,294,321,388,440,False,2
0,49,kaist_dataset/Mixed/Digital_Camera/(C.S)C-outdoor4/DSC03655.JPG,char_data/0/DSC03655.JPG_0.jpg,1029,21,322,343,388,437,False,2
0,51,kaist_dataset/Mixed/Digital_Camera/(C.S)C-outdoor4/DSC03569.JPG,char_data/0/DSC03569.JPG_0.jpg,1836,36,513,549,162,213,False,2
0,32,kaist_dataset/Mixed/Digital_Camera/(C.S)C-outdoor4/DSC03549.JPG,char_data/0/DSC03549.JPG_0.jpg,352,11,372,383,423,455,False,2
0,33,kaist_dataset/Mixed/Digital_Camera/(C.S)C-outdoor4/DSC03549.JPG,char_data/0/DSC03549.JPG_0.jpg,528,16,385,401,422,455,False,2
0,29,kaist_dataset/Mixed/Digital_Camera/(C.S)C-outdoor4/DSC03446.JPG,char_data/0/DSC03446.JPG_0.jpg,754,26,323,349,292,321,False,2
0,44,kaist_dataset/Mixed/Digital_Camera/(C.S)C-outdoor4/DSC03673.JPG,char_data/0/DSC03673.JPG_0.jpg,1408,32,87,119,304,348,False,2
0,50,kaist_dataset/Mixed/Digital_Camera/(C.S)C-outdoor4/DSC03571.JPG,char_data/0/DSC03571.JPG_0.jpg,1250,25,384,409,299,349,False,2
0,37,kaist_dataset/Mixed/Digital_Camera/(C.S)C-outdoor4/DSC03679.JPG,char_data/0/DSC03679.JPG_0.jpg,814,22,383,405,282,319,False,2
0,43,kaist_dataset/Mixed/Digital_Camera/(C.S)C-outdoor4/DSC03556.JPG,char_data/0/DSC03556.JPG_0.jpg,860,20,550,570,256,299,False,2
0,36,kaist_dataset/Mixed/Digital_Camera/(C.S)C-outdoor4/DSC03556.JPG,char_data/0/DSC03556.JPG_0.jpg,468,13,41,54,314,350,False,2
0,33,kaist_dataset/Mixed/Digital_Camera/(C.S)C-outdoor4/DSC03556.JPG,char_data/0/DSC03556.JPG_0.jpg,396,12,81,93,318,351,False,2
0,36,kaist_dataset/Mixed/Digital_Camera/(C.S)C-outdoor4/DSC03556.JPG,char_data/0/DSC03556.JPG_0.jpg,504,14,94,108,314,350,False,2
0,33,kaist_dataset/Mixed/Digital_Camera/(C.S)C-outdoor4/DSC03556.JPG,char_data/0/DSC03556.JPG_0.jpg,561,17,108,125,314,347,False,2
0,37,kaist_dataset/Mixed/Digital_Camera/(C.S)C-outdoor4/DSC03634.JPG,char_data/0/DSC03634.JPG_0.jpg,1073,29,571,600,429,466,False,2
0,31,kaist_dataset/Mixed/Digital_Camera/(C.S)C-outdoor4/DSC03634.JPG,char_data/0/DSC03634.JPG_0.jpg,775,25,292,317,245,276,False,2
0,78,kaist_dataset/Mixed/Digital_Camera/(C.S)C-outdoor4/DSC03634.JPG,char_data/0/DSC03634.JPG_0.jpg,5070,65,328,393,279,357,False,2
0,91,kaist_dataset/Mixed/Digital_Camera/(C.S)C-outdoor4/DSC03634.JPG,char_data/0/DSC03634.JPG_0.jpg,6006,66,394,460,273,364,False,2
0,28,kaist_dataset/Mixed/Digital_Camera/(C.S)C-outdoor4/DSC03757.JPG,char_data/0/DSC03757.JPG_0.jpg,420,15,189,204,340,368,False,2
0,28,kaist_dataset/Mixed/Digital_Camera/(C.S)C-outdoor4/DSC03757.JPG,char_data/0/DSC03757.JPG_0.jpg,336,12,216,228,339,367,False,2
0,30,kaist_dataset/Mixed/Digital_Camera/(C.S)C-outdoor4/DSC03757.JPG,char_data/0/DSC03757.JPG_0.jpg,420,14,364,378,338,368,False,2
0,28,kaist_dataset/Mixed/Digital_Camera/(C.S)C-outdoor4/DSC03757.JPG,char_data/0/DSC03757.JPG_0.jpg,336,12,390,402,338,366,False,2
0,36,kaist_dataset/Mixed/Digital_Camera/(C.S)C-outdoor4/DSC03667.JPG,char_data/0/DSC03667.JPG_0.jpg,792,22,364,386,376,412,False,2
0,44,kaist_dataset/Mixed/Digital_Camera/(C.S)C-outdoor4/DSC03724.JPG,char_data/0/DSC03724.JPG_0.jpg,1364,31,529,560,275,319,False,2
0,28,kaist_dataset/Mixed/Digital_Camera/(C.S)C-outdoor4/DSC03670.JPG,char_data/0/DSC03670.JPG_0.jpg,336,12,468,480,448,476,False,2
0,33,kaist_dataset/Mixed/Digital_Camera/(C.S)C-outdoor2/DSC02912.JPG,char_data/0/DSC02912.JPG_0.jpg,627,19,349,368,9,42,False,2
0,34,kaist_dataset/Mixed/Digital_Camera/(C.S)C-outdoor2/DSC02912.JPG,char_data/0/DSC02912.JPG_0.jpg,850,25,368,393,11,45,False,2
0,31,kaist_dataset/Mixed/Digital_Camera/(C.S)C-outdoor2/DSC02624.JPG,char_data/0/DSC02624.JPG_0.jpg,434,14,478,492,398,429,False,2
0,96,kaist_dataset/Mixed/Digital_Camera/(C.S)C-outdoor2/DSC02865.JPG,char_data/0/DSC02865.JPG_0.jpg,4992,52,411,463,307,403,False,2
0,95,kaist_dataset/Mixed/Digital_Camera/(C.S)C-outdoor2/DSC02865.JPG,char_data/0/DSC02865.JPG_0.jpg,5320,56,465,521,307,402,False,2
0,38,kaist_dataset/Mixed/Digital_Camera/(C.S)C-outdoor2/DSC02954.JPG,char_data/0/DSC02954.JPG_0.jpg,1064,28,261,289,259,297,False,2
0,37,kaist_dataset/Mixed/Digital_Camera/(C.S)C-outdoor2/DSC02954.JPG,char_data/0/DSC02954.JPG_0.jpg,888,24,371,395,263,300,False,2
0,41,kaist_dataset/Mixed/Digital_Camera/(C.S)C-outdoor2/DSC02954.JPG,char_data/0/DSC02954.JPG_0.jpg,656,16,491,507,263,304,False,2
0,36,kaist_dataset/Mixed/Digital_Camera/(C.S)C-outdoor2/DSC02954.JPG,char_data/0/DSC02954.JPG_0.jpg,720,20,590,610,269,305,False,2
0,28,kaist_dataset/Mixed/Digital_Camera/(C.S)C-outdoor2/DSC02555.JPG,char_data/0/DSC02555.JPG_0.jpg,700,25,293,318,252,280,False,2
0,27,kaist_dataset/Mixed/Digital_Camera/(C.S)C-outdoor2/DSC02555.JPG,char_data/0/DSC02555.JPG_0.jpg,621,23,345,368,252,279,False,2
0,22,kaist_dataset/Mixed/Digital_Camera/(C.S)C-outdoor2/DSC02555.JPG,char_data/0/DSC02555.JPG_0.jpg,462,21,516,537,252,274,False,2
0,28,kaist_dataset/Mixed/Digital_Camera/(C.S)C-outdoor2/DSC02555.JPG,char_data/0/DSC02555.JPG_0.jpg,700,25,538,563,250,278,False,2
0,31,kaist_dataset/Mixed/Digital_Camera/(C.S)C-outdoor2/DSC02555.JPG,char_data/0/DSC02555.JPG_0.jpg,837,27,563,590,247,278,False,2
0,27,kaist_dataset/Mixed/Digital_Camera/(C.S)C-outdoor2/DSC02477.JPG,char_data/0/DSC02477.JPG_0.jpg,729,27,254,281,250,277,False,2
0,32,kaist_dataset/Mixed/Digital_Camera/(C.S)C-outdoor2/DSC02477.JPG,char_data/0/DSC02477.JPG_0.jpg,928,29,300,329,244,276,False,2
0,26,kaist_dataset/Mixed/Digital_Camera/(C.S)C-outdoor2/DSC02477.JPG,char_data/0/DSC02477.JPG_0.jpg,624,24,472,496,243,269,False,2
0,24,kaist_dataset/Mixed/Digital_Camera/(C.S)C-outdoor2/DSC02477.JPG,char_data/0/DSC02477.JPG_0.jpg,672,28,496,524,243,267,False,2
0,26,kaist_dataset/Mixed/Digital_Camera/(C.S)C-outdoor2/DSC02477.JPG,char_data/0/DSC02477.JPG_0.jpg,780,30,524,554,241,267,False,2
0,68,kaist_dataset/Mixed/Digital_Camera/(C.S)C-outdoor2/DSC02502.JPG,char_data/0/DSC02502.JPG_0.jpg,2720,40,228,268,344,412,False,2
0,37,kaist_dataset/Mixed/Digital_Camera/(C.S)C-outdoor2/DSC02413.JPG,char_data/0/DSC02413.JPG_0.jpg,1221,33,493,526,207,244,False,2
0,30,kaist_dataset/Mixed/Digital_Camera/(C.S)C-outdoor2/DSC02479.JPG,char_data/0/DSC02479.JPG_0.jpg,540,18,558,576,223,253,False,2
0,36,kaist_dataset/Mixed/Digital_Camera/(C.S)C-outdoor2/DSC02368.JPG,char_data/0/DSC02368.JPG_0.jpg,576,16,398,414,382,418,False,2
0,36,kaist_dataset/Mixed/Digital_Camera/(C.S)C-outdoor2/DSC02368.JPG,char_data/0/DSC02368.JPG_0.jpg,612,17,473,490,378,414,False,2
0,29,kaist_dataset/Mixed/Digital_Camera/(C.S)C-outdoor2/DSC02947.JPG,char_data/0/DSC02947.JPG_0.jpg,580,20,461,481,236,265,False,2
0,34,kaist_dataset/Mixed/Digital_Camera/(C.S)C-outdoor2/DSC02545.JPG,char_data/0/DSC02545.JPG_0.jpg,1564,46,52,98,404,438,False,2
0,33,kaist_dataset/Mixed/Digital_Camera/(C.S)C-outdoor2/DSC02545.JPG,char_data/0/DSC02545.JPG_0.jpg,1485,45,387,432,403,436,False,2
0,56,kaist_dataset/Mixed/Digital_Camera/(C.S)C-outdoor2/P1010013.JPG,char_data/0/P1010013.JPG_0.jpg,1680,30,404,434,363,419,False,2
0,56,kaist_dataset/Mixed/Digital_Camera/(C.S)C-outdoor2/P1010013.JPG,char_data/0/P1010013.JPG_0.jpg,1736,31,434,465,364,420,False,2
0,65,kaist_dataset/Mixed/Digital_Camera/(C.S)C-outdoor2/DSC02503.JPG,char_data/0/DSC02503.JPG_0.jpg,3315,51,494,545,343,408,False,2
0,38,kaist_dataset/Mixed/Digital_Camera/(C.S)C-outdoor2/DSC02376.JPG,char_data/0/DSC02376.JPG_0.jpg,988,26,577,603,335,373,False,2
0,37,kaist_dataset/Mixed/Digital_Camera/(C.S)C-outdoor2/DSC02489.JPG,char_data/0/DSC02489.JPG_0.jpg,777,21,338,359,260,297,False,2
0,36,kaist_dataset/Mixed/Digital_Camera/(C.S)C-outdoor2/DSC02489.JPG,char_data/0/DSC02489.JPG_0.jpg,720,20,359,379,260,296,False,2
0,38,kaist_dataset/Mixed/Digital_Camera/(C.S)C-outdoor2/DSC02933.JPG,char_data/0/DSC02933.JPG_0.jpg,684,18,540,558,246,284,False,2
0,30,kaist_dataset/Mixed/Digital_Camera/(C.S)C-outdoor2/DSC02936.JPG,char_data/0/DSC02936.JPG_0.jpg,390,13,579,592,226,256,False,2
0,32,kaist_dataset/Mixed/Digital_Camera/(C.S)C-outdoor2/DSC02511.JPG,char_data/0/DSC02511.JPG_0.jpg,896,28,381,409,215,247,False,2
0,29,kaist_dataset/Mixed/Digital_Camera/(C.S)C-outdoor2/DSC02556.JPG,char_data/0/DSC02556.JPG_0.jpg,1160,40,456,496,346,375,False,2
0,39,kaist_dataset/Mixed/Digital_Camera/(C.S)C-outdoor2/DSC02557.JPG,char_data/0/DSC02557.JPG_0.jpg,1092,28,514,542,208,247,False,2
0,34,kaist_dataset/Mixed/Digital_Camera/(C.S)C-outdoor2/DSC02926.JPG,char_data/0/DSC02926.JPG_0.jpg,952,28,531,559,146,180,False,2
0,41,kaist_dataset/Mixed/Digital_Camera/(C.S)C-outdoor2/DSC02938.JPG,char_data/0/DSC02938.JPG_0.jpg,984,24,496,520,245,286,False,2
0,90,kaist_dataset/Mixed/Digital_Camera/(C.S)C-outdoor2/DSC02430.JPG,char_data/0/DSC02430.JPG_0.jpg,9000,100,497,597,59,149,False,2
0,24,kaist_dataset/Mixed/Digital_Camera/(C.S)C-outdoor2/DSC02430.JPG,char_data/0/DSC02430.JPG_0.jpg,264,11,67,78,27,51,False,2
0,32,kaist_dataset/Mixed/Digital_Camera/(C.S)C-outdoor2/DSC02430.JPG,char_data/0/DSC02430.JPG_0.jpg,640,20,578,598,308,340,False,2
0,40,kaist_dataset/Mixed/Digital_Camera/(C.S)C-outdoor2/DSC02377.JPG,char_data/0/DSC02377.JPG_0.jpg,1040,26,504,530,354,394,False,2
0,31,kaist_dataset/Mixed/Digital_Camera/(C.S)A-shadow/DSC02624.JPG,char_data/0/DSC02624.JPG_0.jpg,434,14,478,492,398,429,False,2
0,34,kaist_dataset/Mixed/Digital_Camera/(C.S)A-shadow/DSC04306.JPG,char_data/0/DSC04306.JPG_0.jpg,714,21,343,364,412,446,False,2
0,36,kaist_dataset/Mixed/Digital_Camera/(C.S)A-shadow/DSC04306.JPG,char_data/0/DSC04306.JPG_0.jpg,648,18,365,383,409,445,False,2
0,62,kaist_dataset/Mixed/Digital_Camera/(C.S)A-shadow/DSC03305.JPG,char_data/0/DSC03305.JPG_0.jpg,1922,31,493,524,343,405,False,2
0,46,kaist_dataset/English/Digital_Camera/(E.S)C-outdoor2/DSC03053.JPG,char_data/0/DSC03053.JPG_0.jpg,1150,25,487,512,126,172,False,2
0,194,kaist_dataset/English/Digital_Camera/(E.S)C-outdoor2/DSC02949.JPG,char_data/0/DSC02949.JPG_0.jpg,5626,29,390,419,58,252,False,2
0,54,kaist_dataset/English/Digital_Camera/(E.S)C-outdoor2/DSC03650.JPG,char_data/0/DSC03650.JPG_0.jpg,1782,33,359,392,292,346,False,2
0,39,kaist_dataset/English/Digital_Camera/(E.S)C-outdoor2/DSC03436.JPG,char_data/0/DSC03436.JPG_0.jpg,975,25,335,360,119,158,False,2
0,56,kaist_dataset/English/Digital_Camera/(E.S)C-outdoor2/DSC03161.JPG,char_data/0/DSC03161.JPG_0.jpg,1792,32,169,201,223,279,False,2
0,55,kaist_dataset/English/Digital_Camera/(E.S)C-outdoor2/DSC03161.JPG,char_data/0/DSC03161.JPG_0.jpg,1925,35,233,268,221,276,False,2
0,53,kaist_dataset/English/Digital_Camera/(E.S)C-outdoor2/DSC03201.JPG,char_data/0/DSC03201.JPG_0.jpg,2332,44,271,315,9,62,False,2
0,50,kaist_dataset/English/Digital_Camera/(E.S)C-outdoor2/DSC03201.JPG,char_data/0/DSC03201.JPG_0.jpg,2100,42,319,361,11,61,False,2
0,78,kaist_dataset/English/Digital_Camera/(E.S)C-outdoor2/DSC03731.JPG,char_data/0/DSC03731.JPG_0.jpg,5850,75,380,455,29,107,False,2
0,81,kaist_dataset/English/Digital_Camera/(E.S)C-outdoor2/DSC03731.JPG,char_data/0/DSC03731.JPG_0.jpg,6723,83,441,524,26,107,False,2
0,26,kaist_dataset/English/Digital_Camera/(E.S)C-outdoor2/DSC03731.JPG,char_data/0/DSC03731.JPG_0.jpg,286,11,579,590,116,142,False,2
0,28,kaist_dataset/English/Digital_Camera/(E.S)C-outdoor2/DSC03731.JPG,char_data/0/DSC03731.JPG_0.jpg,252,9,591,600,117,145,False,2
0,40,kaist_dataset/English/Digital_Camera/(E.S)C-outdoor2/DSC03160.JPG,char_data/0/DSC03160.JPG_0.jpg,880,22,320,342,397,437,False,2
0,39,kaist_dataset/English/Digital_Camera/(E.S)C-outdoor2/DSC03160.JPG,char_data/0/DSC03160.JPG_0.jpg,858,22,342,364,399,438,False,2
0,34,kaist_dataset/English/Digital_Camera/(E.S)C-outdoor2/DSC03162.JPG,char_data/0/DSC03162.JPG_0.jpg,612,18,502,520,146,180,False,2
0,36,kaist_dataset/English/Digital_Camera/(E.S)C-outdoor2/DSC03162.JPG,char_data/0/DSC03162.JPG_0.jpg,648,18,522,540,146,182,False,2
0,37,kaist_dataset/English/Digital_Camera/(E.S)C-outdoor1/DSC02450.JPG,char_data/0/DSC02450.JPG_0.jpg,1147,31,394,425,224,261,False,2
0,28,kaist_dataset/English/Digital_Camera/(E.S)C-outdoor1/056.JPG,char_data/0/056.JPG_0.jpg,252,9,570,579,248,276,False,2
0,33,kaist_dataset/English/Digital_Camera/(E.S)C-outdoor1/056.JPG,char_data/0/056.JPG_0.jpg,363,11,578,589,246,279,False,2
0,45,kaist_dataset/English/Digital_Camera/(E.S)C-outdoor1/DSC02415.JPG,char_data/0/DSC02415.JPG_0.jpg,1350,30,604,634,248,293,False,2
0,37,kaist_dataset/English/Digital_Camera/(E.S)C-outdoor1/042.JPG,char_data/0/042.JPG_0.jpg,666,18,537,555,317,354,False,2
0,39,kaist_dataset/English/Digital_Camera/(E.S)C-outdoor1/080116-0065.jpg,char_data/0/080116-0065.jpg_0.jpg,975,25,369,394,203,242,False,2
0,39,kaist_dataset/English/Digital_Camera/(E.S)C-outdoor1/080116-0065.jpg,char_data/0/080116-0065.jpg_0.jpg,975,25,395,420,204,243,False,2
0,41,kaist_dataset/English/Digital_Camera/(E.S)C-outdoor1/080116-0065.jpg,char_data/0/080116-0065.jpg_0.jpg,902,22,352,374,380,421,False,2
0,26,kaist_dataset/English/Digital_Camera/(E.S)B-light/080116-0059.jpg,char_data/0/080116-0059.jpg_0.jpg,286,11,646,657,955,981,False,2
0,26,kaist_dataset/English/Digital_Camera/(E.S)B-light/080116-0059.jpg,char_data/0/080116-0059.jpg_0.jpg,338,13,656,669,953,979,False,2
0,37,kaist_dataset/English/Digital_Camera/(E.S)F-others/m.jpg,char_data/0/m.jpg_0.jpg,555,15,181,196,162,199,False,2
0,40,kaist_dataset/English/Digital_Camera/(E.S)F-others/m.jpg,char_data/0/m.jpg_0.jpg,720,18,162,180,165,205,False,2
0,30,kaist_dataset/English/Digital_Camera/(E.S)F-others/m.jpg,char_data/0/m.jpg_0.jpg,630,21,197,218,163,193,False,2
0,56,kaist_dataset/English/Digital_Camera/(E.S)F-others/080116-0058.jpg,char_data/0/080116-0058.jpg_0.jpg,896,16,1255,1271,1019,1075,False,2
0,54,kaist_dataset/English/Digital_Camera/(E.S)D-indoor/080119-0009.jpg,char_data/0/080119-0009.jpg_0.jpg,1296,24,346,370,1147,1201,False,2
0,53,kaist_dataset/English/Digital_Camera/(E.S)D-indoor/080119-0009.jpg,char_data/0/080119-0009.jpg_0.jpg,1219,23,371,394,1125,1178,False,2
0,47,kaist_dataset/English/Digital_Camera/(E.S)C-outdoor3/P1010086.JPG,char_data/0/P1010086.JPG_0.jpg,1504,32,493,525,95,142,False,2
0,51,kaist_dataset/English/Digital_Camera/(E.S)C-outdoor3/P1010086.JPG,char_data/0/P1010086.JPG_0.jpg,1224,24,549,573,94,145,False,2
0,23,kaist_dataset/English/Digital_Camera/(E.S)C-outdoor3/크기변환_P1010076.JPG,char_data/0/크기변환_P1010076.JPG_0.jpg,414,18,512,530,182,205,False,2
4,114,"kaist_dataset/Korean/Mobile_Phone/(M,K)D-indoor/P090911066.jpg",char_data/4/P090911066.jpg_2.jpg,12540,110,240,350,317,431,True,6
4,75,"kaist_dataset/Korean/Mobile_Phone/(M,K)E-bookCover/P090831154.jpg",char_data/4/P090831154.jpg_2.jpg,4275,57,460,517,137,212,True,6
4,40,"kaist_dataset/Korean/Mobile_Phone/(M,K)C-outdoor/P090912033.jpg",char_data/4/P090912033.jpg_4.jpg,1160,29,441,470,305,345,True,6
4,56,"kaist_dataset/Korean/Mobile_Phone/(M,K)C-outdoor/P090912033.jpg",char_data/4/P090912033.jpg_4.jpg,2744,49,440,489,356,412,True,6
4,93,kaist_dataset/Korean/Digital_Camera/F-bookCover/DSC02833.JPG,char_data/4/DSC02833.JPG_2.jpg,6696,72,130,202,365,458,True,6
4,85,kaist_dataset/Korean/Digital_Camera/F-bookCover/DSC02835.JPG,char_data/4/DSC02835.JPG_2.jpg,4760,56,206,262,336,421,True,6
4,166,kaist_dataset/Korean/Digital_Camera/F-bookCover/DSC02824.JPG,char_data/4/DSC02824.JPG_2.jpg,16102,97,28,125,140,306,True,6
4,82,kaist_dataset/Korean/Digital_Camera/F-bookCover/DSC02832.JPG,char_data/4/DSC02832.JPG_2.jpg,5576,68,130,198,352,434,True,6
4,36,kaist_dataset/Korean/Digital_Camera/outdoor5/DSC03996.JPG,char_data/4/DSC03996.JPG_2.jpg,1152,32,192,224,288,324,True,6
4,33,kaist_dataset/Korean/Digital_Camera/outdoor5/DSC03627.JPG,char_data/4/DSC03627.JPG_2.jpg,1023,31,206,237,224,257,True,6
4,37,kaist_dataset/Korean/Digital_Camera/outdoor5/DSC03768.JPG,char_data/4/DSC03768.JPG_2.jpg,1073,29,413,442,240,277,True,6
4,24,kaist_dataset/Korean/Digital_Camera/outdoor5/DSC03688.JPG,char_data/4/DSC03688.JPG_2.jpg,408,17,537,554,233,257,True,6
4,23,kaist_dataset/Korean/Digital_Camera/outdoor5/DSC03744.JPG,char_data/4/DSC03744.JPG_2.jpg,713,31,253,284,308,331,True,6
4,24,kaist_dataset/Korean/Digital_Camera/outdoor5/DSC03780.JPG,char_data/4/DSC03780.JPG_2.jpg,624,26,134,160,443,467,True,6
4,42,kaist_dataset/Korean/Digital_Camera/outdoor5/DSC03717.JPG,char_data/4/DSC03717.JPG_6.jpg,1512,36,164,200,349,391,True,6
4,40,kaist_dataset/Korean/Digital_Camera/outdoor5/DSC03717.JPG,char_data/4/DSC03717.JPG_6.jpg,1520,38,326,364,349,389,True,6
4,44,kaist_dataset/Korean/Digital_Camera/outdoor5/DSC03717.JPG,char_data/4/DSC03717.JPG_6.jpg,1760,40,397,437,348,392,True,6
4,34,kaist_dataset/Korean/Digital_Camera/outdoor5/DSC03779.JPG,char_data/4/DSC03779.JPG_2.jpg,850,25,460,485,241,275,True,6
4,28,kaist_dataset/Korean/Digital_Camera/outdoor5/DSC03736.JPG,char_data/4/DSC03736.JPG_2.jpg,420,15,296,311,407,435,True,6
4,38,kaist_dataset/Korean/Digital_Camera/outdoor5/DSC03692.JPG,char_data/4/DSC03692.JPG_2.jpg,532,14,442,456,184,222,True,6
4,34,kaist_dataset/Korean/Digital_Camera/outdoor5/DSC04027.JPG,char_data/4/DSC04027.JPG_4.jpg,476,14,390,404,382,416,True,6
4,36,kaist_dataset/Korean/Digital_Camera/outdoor5/DSC04027.JPG,char_data/4/DSC04027.JPG_4.jpg,648,18,404,422,382,418,True,6
4,41,kaist_dataset/Korean/Digital_Camera/outdoor5/DSC03671.JPG,char_data/4/DSC03671.JPG_6.jpg,779,19,193,212,408,449,True,6
4,34,kaist_dataset/Korean/Digital_Camera/outdoor5/DSC03671.JPG,char_data/4/DSC03671.JPG_6.jpg,578,17,242,259,410,444,True,6
4,31,kaist_dataset/Korean/Digital_Camera/outdoor5/DSC03671.JPG,char_data/4/DSC03671.JPG_6.jpg,589,19,456,475,409,440,True,6
4,91,kaist_dataset/Korean/Digital_Camera/outdoor5/DSC03715.JPG,char_data/4/DSC03715.JPG_2.jpg,4914,54,218,272,77,168,True,6
4,58,kaist_dataset/Korean/Digital_Camera/outdoor5/DSC03694.JPG,char_data/4/DSC03694.JPG_2.jpg,2030,35,405,440,117,175,True,6
4,26,kaist_dataset/Korean/Digital_Camera/outdoor5/DSC03752.JPG,char_data/4/DSC03752.JPG_4.jpg,390,15,92,107,411,437,True,6
4,28,kaist_dataset/Korean/Digital_Camera/outdoor5/DSC03752.JPG,char_data/4/DSC03752.JPG_4.jpg,420,15,137,152,411,439,True,6
4,34,kaist_dataset/Korean/Digital_Camera/outdoor5/DSC03685.JPG,char_data/4/DSC03685.JPG_4.jpg,1190,35,75,110,189,223,True,6
4,34,kaist_dataset/Korean/Digital_Camera/outdoor5/DSC03685.JPG,char_data/4/DSC03685.JPG_4.jpg,782,23,338,361,187,221,True,6
4,50,kaist_dataset/Korean/Digital_Camera/outdoor5/DSC03838.JPG,char_data/4/DSC03838.JPG_2.jpg,1500,30,243,273,200,250,True,6
4,52,kaist_dataset/Korean/Digital_Camera/outdoor5/DSC03708.JPG,char_data/4/DSC03708.JPG_4.jpg,1768,34,322,356,264,316,True,6
4,49,kaist_dataset/Korean/Digital_Camera/outdoor5/DSC03708.JPG,char_data/4/DSC03708.JPG_4.jpg,1470,30,382,412,263,312,True,6
4,30,kaist_dataset/Korean/Digital_Camera/outdoor5/DSC03778.JPG,char_data/4/DSC03778.JPG_2.jpg,540,18,303,321,343,373,True,6
4,33,kaist_dataset/Korean/Digital_Camera/outdoor5/DSC03770.JPG,char_data/4/DSC03770.JPG_2.jpg,990,30,430,460,424,457,True,6
4,39,kaist_dataset/Korean/Digital_Camera/outdoor5/DSC04040.JPG,char_data/4/DSC04040.JPG_4.jpg,1482,38,272,310,339,378,True,6
4,36,kaist_dataset/Korean/Digital_Camera/outdoor5/DSC04040.JPG,char_data/4/DSC04040.JPG_4.jpg,1404,39,400,439,341,377,True,6
4,67,kaist_dataset/Korean/Digital_Camera/outdoor5/DSC03749.JPG,char_data/4/DSC03749.JPG_2.jpg,2412,36,333,369,402,469,True,6
4,39,kaist_dataset/Korean/Digital_Camera/outdoor5/DSC03709.JPG,char_data/4/DSC03709.JPG_6.jpg,780,20,429,449,363,402,True,6
4,39,kaist_dataset/Korean/Digital_Camera/outdoor5/DSC03709.JPG,char_data/4/DSC03709.JPG_6.jpg,741,19,462,481,363,402,True,6
4,47,kaist_dataset/Korean/Digital_Camera/outdoor5/DSC03709.JPG,char_data/4/DSC03709.JPG_6.jpg,1081,23,546,569,360,407,True,6
4,32,kaist_dataset/Korean/Digital_Camera/outdoor5/DSC03710.JPG,char_data/4/DSC03710.JPG_6.jpg,1216,38,245,283,411,443,True,6
4,32,kaist_dataset/Korean/Digital_Camera/outdoor5/DSC03710.JPG,char_data/4/DSC03710.JPG_6.jpg,960,30,396,426,411,443,True,6
4,34,kaist_dataset/Korean/Digital_Camera/outdoor5/DSC03710.JPG,char_data/4/DSC03710.JPG_6.jpg,1054,31,459,490,408,442,True,6
4,45,kaist_dataset/Korean/Digital_Camera/outdoor5/DSC03626.JPG,char_data/4/DSC03626.JPG_4.jpg,1395,31,127,158,293,338,True,6
4,41,kaist_dataset/Korean/Digital_Camera/outdoor5/DSC03626.JPG,char_data/4/DSC03626.JPG_4.jpg,1640,40,363,403,295,336,True,6
4,28,kaist_dataset/Korean/Digital_Camera/outdoor5/DSC03751.JPG,char_data/4/DSC03751.JPG_4.jpg,728,26,216,242,413,441,True,6
4,28,kaist_dataset/Korean/Digital_Camera/outdoor5/DSC03751.JPG,char_data/4/DSC03751.JPG_4.jpg,728,26,263,289,411,439,True,6
4,31,kaist_dataset/Korean/Digital_Camera/outdoor5/DSC03777.JPG,char_data/4/DSC03777.JPG_2.jpg,465,15,125,140,344,375,True,6
4,37,kaist_dataset/Korean/Digital_Camera/outdoor5/DSC03669.JPG,char_data/4/DSC03669.JPG_4.jpg,1036,28,212,240,317,354,True,6
4,43,kaist_dataset/Korean/Digital_Camera/outdoor5/DSC03669.JPG,char_data/4/DSC03669.JPG_4.jpg,1075,25,270,295,310,353,True,6
4,30,kaist_dataset/Korean/Digital_Camera/outdoor5/DSC03636.JPG,char_data/4/DSC03636.JPG_4.jpg,420,14,357,371,159,189,True,6
4,30,kaist_dataset/Korean/Digital_Camera/outdoor5/DSC03636.JPG,char_data/4/DSC03636.JPG_4.jpg,720,24,228,252,400,430,True,6
4,26,kaist_dataset/Korean/Digital_Camera/outdoor5/DSC04028.JPG,char_data/4/DSC04028.JPG_2.jpg,624,24,280,304,345,371,True,6
4,61,kaist_dataset/Korean/Digital_Camera/outdoor5/DSC03860.JPG,char_data/4/DSC03860.JPG_2.jpg,2745,45,395,440,279,340,True,6
4,38,kaist_dataset/Korean/Digital_Camera/outdoor5/DSC03740.JPG,char_data/4/DSC03740.JPG_4.jpg,874,23,297,320,287,325,True,6
4,39,kaist_dataset/Korean/Digital_Camera/outdoor5/DSC03740.JPG,char_data/4/DSC03740.JPG_4.jpg,819,21,355,376,286,325,True,6
4,31,kaist_dataset/Korean/Digital_Camera/outdoor5/DSC03641.JPG,char_data/4/DSC03641.JPG_2.jpg,589,19,362,381,424,455,True,6
4,23,kaist_dataset/Korean/Digital_Camera/outdoor5/DSC03776.JPG,char_data/4/DSC03776.JPG_6.jpg,368,16,483,499,437,460,True,6
4,19,kaist_dataset/Korean/Digital_Camera/outdoor5/DSC03776.JPG,char_data/4/DSC03776.JPG_6.jpg,209,11,485,496,421,440,True,6
4,21,kaist_dataset/Korean/Digital_Camera/outdoor5/DSC03776.JPG,char_data/4/DSC03776.JPG_6.jpg,273,13,507,520,420,441,True,6
4,44,kaist_dataset/Korean/Digital_Camera/outdoor5/DSC03645.JPG,char_data/4/DSC03645.JPG_2.jpg,1540,35,318,353,348,392,True,6
4,35,kaist_dataset/Korean/Digital_Camera/outdoor4/DSC03293.JPG,char_data/4/DSC03293.JPG_4.jpg,770,22,220,242,286,321,True,6
4,38,kaist_dataset/Korean/Digital_Camera/outdoor4/DSC03293.JPG,char_data/4/DSC03293.JPG_4.jpg,836,22,285,307,285,323,True,6
4,62,kaist_dataset/Korean/Digital_Camera/outdoor4/DSC03599.JPG,char_data/4/DSC03599.JPG_2.jpg,1922,31,302,333,232,294,True,6
4,57,kaist_dataset/Korean/Digital_Camera/outdoor4/DSC03605.JPG,char_data/4/DSC03605.JPG_4.jpg,2280,40,80,120,228,285,True,6
4,53,kaist_dataset/Korean/Digital_Camera/outdoor4/DSC03605.JPG,char_data/4/DSC03605.JPG_4.jpg,1749,33,128,161,147,200,True,6
4,49,kaist_dataset/Korean/Digital_Camera/outdoor4/DSC03538.JPG,char_data/4/DSC03538.JPG_2.jpg,784,16,110,126,113,162,True,6
4,77,kaist_dataset/Korean/Digital_Camera/outdoor4/DSC03542.JPG,char_data/4/DSC03542.JPG_2.jpg,2849,37,81,118,256,333,True,6
4,77,kaist_dataset/Korean/Digital_Camera/outdoor4/DSC03608.JPG,char_data/4/DSC03608.JPG_2.jpg,3927,51,554,605,294,371,True,6
4,43,kaist_dataset/Korean/Digital_Camera/outdoor4/DSC03416.JPG,char_data/4/DSC03416.JPG_2.jpg,774,18,71,89,295,338,True,6
4,26,kaist_dataset/Korean/Digital_Camera/outdoor4/DSC03600.JPG,char_data/4/DSC03600.JPG_2.jpg,442,17,326,343,328,354,True,6
4,56,kaist_dataset/Korean/Digital_Camera/outdoor4/DSC03592.JPG,char_data/4/DSC03592.JPG_10.jpg,1736,31,541,572,62,118,True,6
4,46,kaist_dataset/Korean/Digital_Camera/outdoor4/DSC03592.JPG,char_data/4/DSC03592.JPG_10.jpg,1288,28,56,84,112,158,True,6
4,35,kaist_dataset/Korean/Digital_Camera/outdoor4/DSC03592.JPG,char_data/4/DSC03592.JPG_10.jpg,980,28,169,197,117,152,True,6
4,35,kaist_dataset/Korean/Digital_Camera/outdoor4/DSC03592.JPG,char_data/4/DSC03592.JPG_10.jpg,770,22,276,298,120,155,True,6
4,31,kaist_dataset/Korean/Digital_Camera/outdoor4/DSC03592.JPG,char_data/4/DSC03592.JPG_10.jpg,899,29,385,414,123,154,True,6
4,30,kaist_dataset/Korean/Digital_Camera/outdoor4/DSC03295.JPG,char_data/4/DSC03295.JPG_4.jpg,660,22,219,241,403,433,True,6
4,32,kaist_dataset/Korean/Digital_Camera/outdoor4/DSC03295.JPG,char_data/4/DSC03295.JPG_4.jpg,672,21,335,356,400,432,True,6
4,42,kaist_dataset/Korean/Digital_Camera/outdoor4/DSC03614.JPG,char_data/4/DSC03614.JPG_2.jpg,1050,25,314,339,396,438,True,6
4,53,kaist_dataset/Korean/Digital_Camera/outdoor4/DSC03319.JPG,char_data/4/DSC03319.JPG_4.jpg,2226,42,172,214,386,439,True,6
4,45,kaist_dataset/Korean/Digital_Camera/outdoor4/DSC03319.JPG,char_data/4/DSC03319.JPG_4.jpg,1485,33,90,123,82,127,True,6
4,62,kaist_dataset/Korean/Digital_Camera/outdoor4/DSC03550.JPG,char_data/4/DSC03550.JPG_2.jpg,3224,52,154,206,305,367,True,6
4,90,kaist_dataset/Korean/Digital_Camera/outdoor4/DSC03566.JPG,char_data/4/DSC03566.JPG_4.jpg,6030,67,83,150,154,244,True,6
4,32,kaist_dataset/Korean/Digital_Camera/outdoor4/DSC03566.JPG,char_data/4/DSC03566.JPG_4.jpg,2080,65,43,108,95,127,True,6
4,43,kaist_dataset/Korean/Digital_Camera/outdoor4/DSC03545.JPG,char_data/4/DSC03545.JPG_2.jpg,903,21,95,116,36,79,True,6
4,54,kaist_dataset/Korean/Digital_Camera/outdoor4/DSC03313.JPG,char_data/4/DSC03313.JPG_2.jpg,2106,39,264,303,315,369,True,6
4,72,kaist_dataset/Korean/Digital_Camera/outdoor4/DSC03553.JPG,char_data/4/DSC03553.JPG_2.jpg,5256,73,91,164,183,255,True,6
4,67,kaist_dataset/Korean/Digital_Camera/outdoor4/DSC03537.JPG,char_data/4/DSC03537.JPG_2.jpg,2747,41,162,203,132,199,True,6
4,45,kaist_dataset/Korean/Digital_Camera/outdoor4/DSC03580.JPG,char_data/4/DSC03580.JPG_4.jpg,1395,31,218,249,209,254,True,6
4,54,kaist_dataset/Korean/Digital_Camera/outdoor4/DSC03580.JPG,char_data/4/DSC03580.JPG_4.jpg,1458,27,366,393,203,257,True,6
4,87,kaist_dataset/Korean/Digital_Camera/outdoor4/DSC03452.JPG,char_data/4/DSC03452.JPG_4.jpg,3132,36,169,205,275,362,True,6
4,79,kaist_dataset/Korean/Digital_Camera/outdoor4/DSC03452.JPG,char_data/4/DSC03452.JPG_4.jpg,2923,37,462,499,284,363,True,6
4,29,kaist_dataset/Korean/Digital_Camera/outdoor4/DSC03555.JPG,char_data/4/DSC03555.JPG_2.jpg,725,25,294,319,427,456,True,6
4,45,kaist_dataset/Korean/Digital_Camera/outdoor4/DSC03603.JPG,char_data/4/DSC03603.JPG_2.jpg,945,21,301,322,281,326,True,6
4,56,kaist_dataset/Korean/Digital_Camera/outdoor4/DSC03261.JPG,char_data/4/DSC03261.JPG_2.jpg,2296,41,198,239,393,449,True,6
4,65,kaist_dataset/Korean/Digital_Camera/outdoor2/2007-12-09-day-exterior-016.jpg,char_data/4/2007-12-09-day-exterior-016.jpg_6.jpg,1625,25,0,25,355,420,True,6
4,60,kaist_dataset/Korean/Digital_Camera/outdoor2/2007-12-09-day-exterior-016.jpg,char_data/4/2007-12-09-day-exterior-016.jpg_6.jpg,2160,36,589,625,746,806,True,6
4,64,kaist_dataset/Korean/Digital_Camera/outdoor2/2007-12-09-day-exterior-016.jpg,char_data/4/2007-12-09-day-exterior-016.jpg_6.jpg,2944,46,773,819,746,810,True,6
4,67,kaist_dataset/Korean/Digital_Camera/outdoor2/2007-12-08-day-101.jpg,char_data/4/2007-12-08-day-101.jpg_2.jpg,2211,33,951,984,640,707,True,6
4,36,kaist_dataset/Korean/Digital_Camera/outdoor2/2007-12-08-day-122.jpg,char_data/4/2007-12-08-day-122.jpg_0.jpg,792,22,1244,1266,563,599,True,6
4,34,kaist_dataset/Korean/Digital_Camera/outdoor2/DSC02426.JPG,char_data/4/DSC02426.JPG_0.jpg,782,23,363,386,220,254,True,6
4,26,kaist_dataset/Korean/Digital_Camera/outdoor2/DSC02441.JPG,char_data/4/DSC02441.JPG_0.jpg,390,15,484,499,203,229,True,6
4,29,kaist_dataset/Korean/Digital_Camera/outdoor2/DSC02435.JPG,char_data/4/DSC02435.JPG_0.jpg,464,16,514,530,247,276,True,6
4,30,kaist_dataset/Korean/Digital_Camera/outdoor2/DSC02383.JPG,char_data/4/DSC02383.JPG_0.jpg,480,16,191,207,290,320,True,6
4,37,kaist_dataset/Korean/Digital_Camera/outdoor2/DSC02383.JPG,char_data/4/DSC02383.JPG_0.jpg,444,12,250,262,286,323,True,6
4,31,kaist_dataset/Korean/Digital_Camera/outdoor2/DSC02321.JPG,char_data/4/DSC02321.JPG_0.jpg,713,23,273,296,378,409,True,6
4,40,kaist_dataset/Korean/Digital_Camera/outdoor2/DSC02386.JPG,char_data/4/DSC02386.JPG_0.jpg,880,22,497,519,252,292,True,6
4,36,kaist_dataset/Korean/Digital_Camera/outdoor2/DSC02371.JPG,char_data/4/DSC02371.JPG_0.jpg,1044,29,258,287,239,275,True,6
4,58,kaist_dataset/Korean/Digital_Camera/outdoor2/2007-12-09-day-exterior-035.jpg,char_data/4/2007-12-09-day-exterior-035.jpg_0.jpg,1856,32,568,600,711,769,True,6
4,117,kaist_dataset/Korean/Digital_Camera/outdoor2/DSC02520.JPG,char_data/4/DSC02520.JPG_0.jpg,3627,31,402,433,299,416,True,6
4,115,kaist_dataset/Korean/Digital_Camera/outdoor2/DSC02520.JPG,char_data/4/DSC02520.JPG_0.jpg,4025,35,543,578,301,416,True,6
4,113,kaist_dataset/Korean/Digital_Camera/outdoor2/DSC02520.JPG,char_data/4/DSC02520.JPG_0.jpg,3503,31,603,634,301,414,True,6
4,67,kaist_dataset/Korean/Digital_Camera/outdoor2/DSC02470.JPG,char_data/4/DSC02470.JPG_0.jpg,2881,43,494,537,369,436,True,6
4,78,kaist_dataset/Korean/Digital_Camera/outdoor2/2007-12-09-day-exterior-012.jpg,char_data/4/2007-12-09-day-exterior-012.jpg_0.jpg,4446,57,1334,1391,619,697,True,6
4,38,kaist_dataset/Korean/Digital_Camera/outdoor2/DSC02521.JPG,char_data/4/DSC02521.JPG_0.jpg,950,25,395,420,324,362,True,6
4,37,kaist_dataset/Korean/Digital_Camera/outdoor2/DSC02523.JPG,char_data/4/DSC02523.JPG_0.jpg,740,20,406,426,338,375,True,6
4,36,kaist_dataset/Korean/Digital_Camera/outdoor2/DSC02523.JPG,char_data/4/DSC02523.JPG_0.jpg,828,23,597,620,339,375,True,6
4,39,kaist_dataset/Korean/Digital_Camera/E-night/DSC03850.JPG,char_data/4/DSC03850.JPG_0.jpg,780,20,319,339,430,469,True,6
4,30,kaist_dataset/Korean/Digital_Camera/E-night/P1010149.JPG,char_data/4/P1010149.JPG_0.jpg,480,16,533,549,241,271,True,6
4,25,kaist_dataset/Korean/Digital_Camera/E-night/DSC03870.JPG,char_data/4/DSC03870.JPG_0.jpg,400,16,329,345,225,250,True,6
4,42,kaist_dataset/Korean/Digital_Camera/E-night/DSC02658.JPG,char_data/4/DSC02658.JPG_0.jpg,1260,30,342,372,352,394,True,6
4,38,kaist_dataset/Korean/Digital_Camera/E-night/DSC02658.JPG,char_data/4/DSC02658.JPG_0.jpg,988,26,425,451,355,393,True,6
4,31,kaist_dataset/Korean/Digital_Camera/E-night/DSC02626.JPG,char_data/4/DSC02626.JPG_0.jpg,434,14,49,63,380,411,True,6
4,56,kaist_dataset/Korean/Digital_Camera/E-night/DSC03019.JPG,char_data/4/DSC03019.JPG_0.jpg,2296,41,392,433,178,234,True,6
4,121,kaist_dataset/Korean/Digital_Camera/indoor1/DSC03375.JPG,char_data/4/DSC03375.JPG_0.jpg,10890,90,277,367,159,280,True,6
4,75,kaist_dataset/Korean/Digital_Camera/indoor1/080119-0018.jpg,char_data/4/080119-0018.jpg_0.jpg,3450,46,312,358,423,498,True,6
4,47,kaist_dataset/Korean/Digital_Camera/indoor1/080119-0018.jpg,char_data/4/080119-0018.jpg_0.jpg,1175,25,1118,1143,698,745,True,6
4,38,kaist_dataset/Korean/Digital_Camera/outdoor7/P1010082.JPG,char_data/4/P1010082.JPG_0.jpg,1482,39,117,156,49,87,True,6
4,33,kaist_dataset/Korean/Digital_Camera/outdoor7/P1010054.JPG,char_data/4/P1010054.JPG_0.jpg,660,20,488,508,227,260,True,6
4,33,kaist_dataset/Korean/Digital_Camera/outdoor7/P1010107.JPG,char_data/4/P1010107.JPG_0.jpg,924,28,258,286,223,256,True,6
4,42,kaist_dataset/Korean/Digital_Camera/outdoor7/P1010069.JPG,char_data/4/P1010069.JPG_0.jpg,1470,35,226,261,313,355,True,6
4,36,kaist_dataset/Korean/Digital_Camera/outdoor7/P1010101.JPG,char_data/4/P1010101.JPG_0.jpg,864,24,324,348,230,266,True,6
4,38,kaist_dataset/Korean/Digital_Camera/outdoor7/P1010101.JPG,char_data/4/P1010101.JPG_0.jpg,798,21,423,444,233,271,True,6
4,34,kaist_dataset/Korean/Digital_Camera/outdoor7/P1010003.JPG,char_data/4/P1010003.JPG_0.jpg,952,28,251,279,277,311,True,6
4,52,kaist_dataset/Korean/Digital_Camera/outdoor7/P1010111.JPG,char_data/4/P1010111.JPG_0.jpg,1508,29,349,378,216,268,True,6
4,26,kaist_dataset/Korean/Digital_Camera/outdoor7/P1010005.JPG,char_data/4/P1010005.JPG_0.jpg,650,25,394,419,192,218,True,6
4,27,kaist_dataset/Korean/Digital_Camera/outdoor7/P1010005.JPG,char_data/4/P1010005.JPG_0.jpg,729,27,545,572,191,218,True,6
4,38,kaist_dataset/Korean/Digital_Camera/outdoor7/P1010138.JPG,char_data/4/P1010138.JPG_0.jpg,646,17,209,226,285,323,True,6
4,39,kaist_dataset/Korean/Digital_Camera/outdoor7/P1010138.JPG,char_data/4/P1010138.JPG_0.jpg,741,19,255,274,284,323,True,6
4,63,kaist_dataset/Korean/Digital_Camera/outdoor7/P1010068.JPG,char_data/4/P1010068.JPG_0.jpg,2079,33,294,327,276,339,True,6
4,58,kaist_dataset/Korean/Digital_Camera/outdoor7/P1010068.JPG,char_data/4/P1010068.JPG_0.jpg,1856,32,375,407,276,334,True,6
4,66,kaist_dataset/Korean/Digital_Camera/outdoor7/P1010068.JPG,char_data/4/P1010068.JPG_0.jpg,2244,34,521,555,271,337,True,6
4,57,kaist_dataset/Korean/Digital_Camera/outdoor7/P1010068.JPG,char_data/4/P1010068.JPG_0.jpg,1938,34,581,615,276,333,True,6
4,48,kaist_dataset/Korean/Digital_Camera/outdoor7/P1010085.JPG,char_data/4/P1010085.JPG_0.jpg,1440,30,215,245,268,316,True,6
4,54,kaist_dataset/Korean/Digital_Camera/outdoor7/P1010085.JPG,char_data/4/P1010085.JPG_0.jpg,1944,36,449,485,267,321,True,6
4,55,kaist_dataset/Korean/Digital_Camera/outdoor7/P1010077.JPG,char_data/4/P1010077.JPG_0.jpg,1925,35,198,233,246,301,True,6
4,52,kaist_dataset/Korean/Digital_Camera/outdoor7/P1010077.JPG,char_data/4/P1010077.JPG_0.jpg,1300,25,355,380,242,294,True,6
4,28,kaist_dataset/Korean/Digital_Camera/outdoor7/P1010121.JPG,char_data/4/P1010121.JPG_0.jpg,784,28,438,466,210,238,True,6
4,27,kaist_dataset/Korean/Digital_Camera/outdoor7/P1010121.JPG,char_data/4/P1010121.JPG_0.jpg,702,26,531,557,212,239,True,6
4,28,kaist_dataset/Korean/Digital_Camera/outdoor7/P1010121.JPG,char_data/4/P1010121.JPG_0.jpg,588,21,558,579,211,239,True,6
4,35,kaist_dataset/Korean/Digital_Camera/outdoor7/P1010078.JPG,char_data/4/P1010078.JPG_0.jpg,770,22,168,190,251,286,True,6
4,57,kaist_dataset/Korean/Digital_Camera/outdoor7/P1010011.JPG,char_data/4/P1010011.JPG_0.jpg,1881,33,444,477,227,284,True,6
4,77,kaist_dataset/Korean/Digital_Camera/outdoor7/P1010086.JPG,char_data/4/P1010086.JPG_0.jpg,4620,60,55,115,255,332,True,6
4,71,kaist_dataset/Korean/Digital_Camera/outdoor7/P1010086.JPG,char_data/4/P1010086.JPG_0.jpg,4970,70,467,537,256,327,True,6
4,23,kaist_dataset/Korean/Digital_Camera/outdoor7/P1010112.JPG,char_data/4/P1010112.JPG_0.jpg,414,18,466,484,359,382,True,6
4,24,kaist_dataset/Korean/Digital_Camera/outdoor7/P1010100.JPG,char_data/4/P1010100.JPG_0.jpg,648,27,205,232,225,249,True,6
4,24,kaist_dataset/Korean/Digital_Camera/outdoor7/P1010100.JPG,char_data/4/P1010100.JPG_0.jpg,480,20,281,301,223,247,True,6
4,26,kaist_dataset/Korean/Digital_Camera/outdoor7/P1010100.JPG,char_data/4/P1010100.JPG_0.jpg,468,18,375,393,219,245,True,6
4,27,kaist_dataset/Korean/Digital_Camera/outdoor7/P1010100.JPG,char_data/4/P1010100.JPG_0.jpg,432,16,410,426,219,246,True,6
4,21,kaist_dataset/Korean/Digital_Camera/outdoor7/P1010100.JPG,char_data/4/P1010100.JPG_0.jpg,357,17,463,480,218,239,True,6
4,24,kaist_dataset/Korean/Digital_Camera/outdoor7/P1010100.JPG,char_data/4/P1010100.JPG_0.jpg,360,15,481,496,221,245,True,6
4,47,kaist_dataset/Korean/Digital_Camera/outdoor7/P1010100.JPG,char_data/4/P1010100.JPG_0.jpg,1504,32,164,196,346,393,True,6
4,42,kaist_dataset/Korean/Digital_Camera/outdoor7/P1010100.JPG,char_data/4/P1010100.JPG_0.jpg,1428,34,289,323,349,391,True,6
4,23,kaist_dataset/Korean/Digital_Camera/outdoor7/P1010124.JPG,char_data/4/P1010124.JPG_0.jpg,460,20,283,303,156,179,True,6
4,33,kaist_dataset/Korean/Digital_Camera/outdoor7/P1010004.JPG,char_data/4/P1010004.JPG_0.jpg,330,10,540,550,294,327,True,6
4,58,kaist_dataset/Korean/Digital_Camera/outdoor7/P1010023.JPG,char_data/4/P1010023.JPG_0.jpg,2030,35,14,49,289,347,True,6
4,68,kaist_dataset/Korean/Digital_Camera/outdoor7/P1010081.JPG,char_data/4/P1010081.JPG_0.jpg,3332,49,110,159,223,291,True,6
4,61,kaist_dataset/Korean/Digital_Camera/outdoor7/P1010081.JPG,char_data/4/P1010081.JPG_0.jpg,2501,41,213,254,215,276,True,6
4,64,kaist_dataset/Korean/Digital_Camera/outdoor7/P1010081.JPG,char_data/4/P1010081.JPG_0.jpg,2560,40,387,427,206,270,True,6
4,54,kaist_dataset/Korean/Digital_Camera/outdoor7/P1010081.JPG,char_data/4/P1010081.JPG_0.jpg,2484,46,341,387,209,263,True,6
4,166,kaist_dataset/Korean/Digital_Camera/outdoor7/DSC04470.JPG,char_data/4/DSC04470.JPG_0.jpg,12948,78,175,253,139,305,True,6
4,29,kaist_dataset/Korean/Digital_Camera/outdoor7/P1010056.JPG,char_data/4/P1010056.JPG_0.jpg,725,25,390,415,268,297,True,6
4,32,kaist_dataset/Korean/Digital_Camera/outdoor7/P1010056.JPG,char_data/4/P1010056.JPG_0.jpg,608,19,506,525,268,300,True,6
4,38,kaist_dataset/Korean/Digital_Camera/outdoor7/P1010067.JPG,char_data/4/P1010067.JPG_0.jpg,1216,32,140,172,313,351,True,6
4,43,kaist_dataset/Korean/Digital_Camera/outdoor7/P1010067.JPG,char_data/4/P1010067.JPG_0.jpg,1462,34,303,337,311,354,True,6
4,37,kaist_dataset/Korean/Digital_Camera/outdoor7/P1010061.JPG,char_data/4/P1010061.JPG_0.jpg,1184,32,339,371,320,357,True,6
4,38,kaist_dataset/Korean/Digital_Camera/outdoor7/P1010035.JPG,char_data/4/P1010035.JPG_0.jpg,1140,30,24,54,200,238,True,6
4,30,kaist_dataset/Korean/Digital_Camera/outdoor7/P1010057.JPG,char_data/4/P1010057.JPG_0.jpg,750,25,499,524,229,259,True,6
4,107,kaist_dataset/Korean/Digital_Camera/outdoor7/P1010079.JPG,char_data/4/P1010079.JPG_0.jpg,6206,58,90,148,339,446,True,6
4,37,kaist_dataset/Korean/Digital_Camera/outdoor8/P1010143.JPG,char_data/4/P1010143.JPG_0.jpg,1073,29,304,333,263,300,True,6
4,38,kaist_dataset/Korean/Digital_Camera/outdoor8/P1010189.JPG,char_data/4/P1010189.JPG_0.jpg,1444,38,175,213,229,267,True,6
4,40,kaist_dataset/Korean/Digital_Camera/outdoor8/P1010189.JPG,char_data/4/P1010189.JPG_0.jpg,1320,33,308,341,232,272,True,6
4,37,kaist_dataset/Korean/Digital_Camera/outdoor8/P1010142.JPG,char_data/4/P1010142.JPG_0.jpg,888,24,199,223,281,318,True,6
4,39,kaist_dataset/Korean/Digital_Camera/outdoor8/P1010142.JPG,char_data/4/P1010142.JPG_0.jpg,975,25,260,285,281,320,True,6
4,44,kaist_dataset/Korean/Digital_Camera/outdoor8/P1010170.JPG,char_data/4/P1010170.JPG_0.jpg,1232,28,326,354,268,312,True,6
4,66,kaist_dataset/Korean/Digital_Camera/outdoor8/DSC02950.JPG,char_data/4/DSC02950.JPG_0.jpg,3630,55,137,192,265,331,True,6
4,57,kaist_dataset/Korean/Digital_Camera/outdoor8/DSC02950.JPG,char_data/4/DSC02950.JPG_0.jpg,2736,48,239,287,282,339,True,6
4,29,kaist_dataset/Korean/Digital_Camera/outdoor8/P090912069.jpg,char_data/4/P090912069.jpg_0.jpg,986,34,485,519,214,243,True,6
4,82,kaist_dataset/Korean/Digital_Camera/outdoor8/P1010172.JPG,char_data/4/P1010172.JPG_0.jpg,4592,56,134,190,220,302,True,6
4,74,kaist_dataset/Korean/Digital_Camera/outdoor8/P1010172.JPG,char_data/4/P1010172.JPG_0.jpg,3552,48,359,407,224,298,True,6
4,76,kaist_dataset/Korean/Digital_Camera/outdoor8/P1010172.JPG,char_data/4/P1010172.JPG_0.jpg,3268,43,407,450,224,300,True,6
4,60,kaist_dataset/Korean/Digital_Camera/outdoor8/P1010160.JPG,char_data/4/P1010160.JPG_0.jpg,3600,60,131,191,230,290,True,6
4,73,kaist_dataset/Korean/Digital_Camera/outdoor8/P1010160.JPG,char_data/4/P1010160.JPG_0.jpg,5110,70,490,560,220,293,True,6
4,51,kaist_dataset/Korean/Digital_Camera/outdoor8/P1010171.JPG,char_data/4/P1010171.JPG_0.jpg,1989,39,361,400,232,283,True,6
4,31,kaist_dataset/Korean/Digital_Camera/outdoor8/P1010178.JPG,char_data/4/P1010178.JPG_0.jpg,806,26,269,295,391,422,True,6
4,38,kaist_dataset/Korean/Digital_Camera/outdoor8/P1010178.JPG,char_data/4/P1010178.JPG_0.jpg,608,16,390,406,389,427,True,6
4,35,kaist_dataset/Korean/Digital_Camera/outdoor8/P1010178.JPG,char_data/4/P1010178.JPG_0.jpg,630,18,388,406,306,341,True,6
4,48,kaist_dataset/Korean/Digital_Camera/outdoor8/P1010147.JPG,char_data/4/P1010147.JPG_0.jpg,2112,44,341,385,313,361,True,6
4,31,kaist_dataset/Korean/Digital_Camera/outdoor8/P1011112.JPG,char_data/4/P1011112.JPG_0.jpg,589,19,510,529,226,257,True,6
4,38,kaist_dataset/Korean/Digital_Camera/outdoor8/P1011112.JPG,char_data/4/P1011112.JPG_0.jpg,760,20,279,299,206,244,True,6
4,58,kaist_dataset/Korean/Digital_Camera/indoor2/DSC04423.JPG,char_data/4/DSC04423.JPG_0.jpg,1856,32,517,549,239,297,True,6
4,71,kaist_dataset/Korean/Digital_Camera/indoor2/DSC04006.JPG,char_data/4/DSC04006.JPG_0.jpg,2911,41,139,180,151,222,True,6
4,33,kaist_dataset/Korean/Digital_Camera/indoor2/DSC03564.JPG,char_data/4/DSC03564.JPG_0.jpg,693,21,321,342,404,437,True,6
4,57,kaist_dataset/Korean/Digital_Camera/indoor2/DSC03474.JPG,char_data/4/DSC03474.JPG_0.jpg,2223,39,133,172,155,212,True,6
4,54,kaist_dataset/Korean/Digital_Camera/indoor2/DSC03474.JPG,char_data/4/DSC03474.JPG_0.jpg,1998,37,235,272,153,207,True,6
4,37,kaist_dataset/Korean/Digital_Camera/indoor2/DSC03983.JPG,char_data/4/DSC03983.JPG_0.jpg,888,24,371,395,322,359,True,6
4,57,kaist_dataset/Korean/Digital_Camera/indoor2/DSC03475.JPG,char_data/4/DSC03475.JPG_0.jpg,2280,40,114,154,94,151,True,6
4,54,kaist_dataset/Korean/Digital_Camera/indoor2/DSC03475.JPG,char_data/4/DSC03475.JPG_0.jpg,2592,48,242,290,93,147,True,6
4,56,kaist_dataset/Korean/Digital_Camera/indoor2/DSC04204.JPG,char_data/4/DSC04204.JPG_0.jpg,1624,29,417,446,205,261,True,6
4,43,kaist_dataset/Korean/Digital_Camera/indoor2/DSC03995.JPG,char_data/4/DSC03995.JPG_0.jpg,1419,33,394,427,266,309,True,6
4,49,kaist_dataset/Korean/Digital_Camera/indoor2/DSC03994.JPG,char_data/4/DSC03994.JPG_0.jpg,1470,30,313,343,286,335,True,6
4,88,kaist_dataset/Korean/Digital_Camera/indoor2/DSC03565.JPG,char_data/4/DSC03565.JPG_0.jpg,5456,62,168,230,279,367,True,6
4,90,kaist_dataset/Korean/Digital_Camera/indoor2/DSC03565.JPG,char_data/4/DSC03565.JPG_0.jpg,4860,54,580,634,261,351,True,6
4,25,kaist_dataset/Korean/Digital_Camera/G-others/DSC03863.JPG,char_data/4/DSC03863.JPG_0.jpg,475,19,160,179,411,436,True,6
4,56,kaist_dataset/Korean/Digital_Camera/G-others/DSC03434.JPG,char_data/4/DSC03434.JPG_0.jpg,1624,29,238,267,25,81,True,6
4,45,kaist_dataset/Korean/Digital_Camera/G-others/2007-12-08-day-045.jpg,char_data/4/2007-12-08-day-045.jpg_0.jpg,720,16,10,26,803,848,True,6
4,47,kaist_dataset/Korean/Digital_Camera/G-others/2007-12-08-day-045.jpg,char_data/4/2007-12-08-day-045.jpg_0.jpg,752,16,44,60,800,847,True,6
4,72,kaist_dataset/Korean/Digital_Camera/G-others/2007-12-09-day-exterior-005.jpg,char_data/4/2007-12-09-day-exterior-005.jpg_0.jpg,4248,59,6,65,1337,1409,True,6
4,42,kaist_dataset/Korean/Digital_Camera/G-others/DSC03862.JPG,char_data/4/DSC03862.JPG_0.jpg,714,17,259,276,352,394,True,6
4,36,kaist_dataset/Korean/Digital_Camera/G-others/DSC03862.JPG,char_data/4/DSC03862.JPG_0.jpg,648,18,319,337,355,391,True,6
4,93,kaist_dataset/Korean/Digital_Camera/G-others/2007-12-08-day-108.jpg,char_data/4/2007-12-08-day-108.jpg_0.jpg,3720,40,611,651,589,682,True,6
4,97,kaist_dataset/Korean/Digital_Camera/G-others/2007-12-08-day-108.jpg,char_data/4/2007-12-08-day-108.jpg_0.jpg,4171,43,725,768,716,813,True,6
4,91,kaist_dataset/Korean/Digital_Camera/G-others/2007-12-08-day-108.jpg,char_data/4/2007-12-08-day-108.jpg_0.jpg,3458,38,769,807,733,824,True,6
4,27,kaist_dataset/Korean/Digital_Camera/B-light/DSC02987.JPG,char_data/4/DSC02987.JPG_0.jpg,378,14,391,405,279,306,True,6
4,25,kaist_dataset/Korean/Digital_Camera/B-light/DSC02987.JPG,char_data/4/DSC02987.JPG_0.jpg,300,12,499,511,284,309,True,6
4,42,kaist_dataset/Korean/Digital_Camera/outdoor6/DSC04081.JPG,char_data/4/DSC04081.JPG_0.jpg,1890,45,208,253,321,363,True,6
4,94,kaist_dataset/Korean/Digital_Camera/outdoor6/DSC04090.JPG,char_data/4/DSC04090.JPG_0.jpg,7802,83,122,205,199,293,True,6
4,104,kaist_dataset/Korean/Digital_Camera/outdoor6/DSC04090.JPG,char_data/4/DSC04090.JPG_0.jpg,5824,56,330,386,188,292,True,6
4,106,kaist_dataset/Korean/Digital_Camera/outdoor6/DSC04090.JPG,char_data/4/DSC04090.JPG_0.jpg,5724,54,383,437,185,291,True,6
4,57,kaist_dataset/Korean/Digital_Camera/outdoor6/DSC04350.JPG,char_data/4/DSC04350.JPG_0.jpg,2280,40,559,599,325,382,True,6
4,59,kaist_dataset/Korean/Digital_Camera/outdoor6/DSC04143.JPG,char_data/4/DSC04143.JPG_0.jpg,2714,46,178,224,353,412,True,6
4,78,kaist_dataset/Korean/Digital_Camera/outdoor6/DSC04359.JPG,char_data/4/DSC04359.JPG_0.jpg,3900,50,437,487,106,184,True,6
4,51,kaist_dataset/Korean/Digital_Camera/outdoor6/DSC04308.JPG,char_data/4/DSC04308.JPG_0.jpg,1530,30,190,220,384,435,True,6
4,28,kaist_dataset/Korean/Digital_Camera/outdoor6/DSC04062.JPG,char_data/4/DSC04062.JPG_0.jpg,392,14,539,553,305,333,True,6
4,33,kaist_dataset/Korean/Digital_Camera/outdoor6/DSC04062.JPG,char_data/4/DSC04062.JPG_0.jpg,396,12,608,620,305,338,True,6
4,27,kaist_dataset/Korean/Digital_Camera/outdoor6/DSC04132.JPG,char_data/4/DSC04132.JPG_0.jpg,567,21,241,262,159,186,True,6
4,34,kaist_dataset/Korean/Digital_Camera/outdoor6/DSC04132.JPG,char_data/4/DSC04132.JPG_0.jpg,748,22,369,391,147,181,True,6
4,36,kaist_dataset/Korean/Digital_Camera/outdoor6/DSC04400.JPG,char_data/4/DSC04400.JPG_0.jpg,900,25,505,530,231,267,True,6
4,43,kaist_dataset/Korean/Digital_Camera/outdoor6/DSC04400.JPG,char_data/4/DSC04400.JPG_0.jpg,946,22,302,324,398,441,True,6
4,22,kaist_dataset/Korean/Digital_Camera/outdoor6/DSC04041.JPG,char_data/4/DSC04041.JPG_0.jpg,396,18,410,428,145,167,True,6
4,25,kaist_dataset/Korean/Digital_Camera/outdoor6/DSC04041.JPG,char_data/4/DSC04041.JPG_0.jpg,525,21,476,497,144,169,True,6
4,53,kaist_dataset/Korean/Digital_Camera/outdoor6/DSC04352.JPG,char_data/4/DSC04352.JPG_0.jpg,1007,19,382,401,282,335,True,6
4,52,kaist_dataset/Korean/Digital_Camera/outdoor6/DSC04352.JPG,char_data/4/DSC04352.JPG_0.jpg,1352,26,438,464,287,339,True,6
4,36,kaist_dataset/Korean/Digital_Camera/outdoor6/DSC04099.JPG,char_data/4/DSC04099.JPG_0.jpg,756,21,393,414,417,453,True,6
4,51,kaist_dataset/Korean/Digital_Camera/outdoor6/DSC04089.JPG,char_data/4/DSC04089.JPG_0.jpg,1479,29,299,328,271,322,True,6
4,43,kaist_dataset/Korean/Digital_Camera/outdoor6/DSC04089.JPG,char_data/4/DSC04089.JPG_0.jpg,860,20,446,466,280,323,True,6
4,41,kaist_dataset/Korean/Digital_Camera/outdoor6/DSC04121.JPG,char_data/4/DSC04121.JPG_0.jpg,1271,31,166,197,179,220,True,6
4,38,kaist_dataset/Korean/Digital_Camera/outdoor6/DSC04121.JPG,char_data/4/DSC04121.JPG_0.jpg,1064,28,405,433,179,217,True,6
4,26,kaist_dataset/Korean/Digital_Camera/outdoor6/DSC04042.JPG,char_data/4/DSC04042.JPG_0.jpg,468,18,53,71,333,359,True,6
4,36,kaist_dataset/Korean/Digital_Camera/outdoor6/DSC04116.JPG,char_data/4/DSC04116.JPG_0.jpg,792,22,168,190,318,354,True,6
4,37,kaist_dataset/Korean/Digital_Camera/outdoor6/DSC04116.JPG,char_data/4/DSC04116.JPG_0.jpg,592,16,256,272,320,357,True,6
4,41,kaist_dataset/Korean/Digital_Camera/outdoor6/DSC04116.JPG,char_data/4/DSC04116.JPG_0.jpg,779,19,288,307,317,358,True,6
4,34,kaist_dataset/Korean/Digital_Camera/outdoor6/DSC04116.JPG,char_data/4/DSC04116.JPG_0.jpg,646,19,323,342,320,354,True,6
4,40,kaist_dataset/Korean/Digital_Camera/outdoor6/DSC04116.JPG,char_data/4/DSC04116.JPG_0.jpg,1000,25,438,463,318,358,True,6
4,33,kaist_dataset/Korean/Digital_Camera/outdoor6/DSC04113.JPG,char_data/4/DSC04113.JPG_0.jpg,1023,31,144,175,441,474,True,6
4,77,kaist_dataset/Korean/Digital_Camera/outdoor6/DSC04096.JPG,char_data/4/DSC04096.JPG_0.jpg,3850,50,125,175,222,299,True,6
4,78,kaist_dataset/Korean/Digital_Camera/outdoor6/DSC04096.JPG,char_data/4/DSC04096.JPG_0.jpg,3822,49,291,340,224,302,True,6
4,37,kaist_dataset/Korean/Digital_Camera/outdoor6/DSC04112.JPG,char_data/4/DSC04112.JPG_0.jpg,666,18,288,306,271,308,True,6
4,31,kaist_dataset/Korean/Digital_Camera/outdoor6/DSC04112.JPG,char_data/4/DSC04112.JPG_0.jpg,434,14,414,428,275,306,True,6
4,53,kaist_dataset/Korean/Digital_Camera/outdoor6/DSC04100.JPG,char_data/4/DSC04100.JPG_0.jpg,1590,30,354,384,50,103,True,6
4,70,kaist_dataset/Korean/Digital_Camera/outdoor6/DSC04147.JPG,char_data/4/DSC04147.JPG_0.jpg,4130,59,136,195,179,249,True,6
4,33,kaist_dataset/Korean/Digital_Camera/outdoor6/DSC04046.JPG,char_data/4/DSC04046.JPG_0.jpg,627,19,265,284,258,291,True,6
4,62,kaist_dataset/Korean/Digital_Camera/outdoor6/DSC04332.JPG,char_data/4/DSC04332.JPG_0.jpg,3162,51,274,325,345,407,True,6
4,58,kaist_dataset/Korean/Digital_Camera/outdoor6/DSC04332.JPG,char_data/4/DSC04332.JPG_0.jpg,2726,47,372,419,351,409,True,6
4,55,kaist_dataset/Korean/Digital_Camera/outdoor6/DSC04332.JPG,char_data/4/DSC04332.JPG_0.jpg,2970,54,417,471,350,405,True,6
4,32,kaist_dataset/Korean/Digital_Camera/outdoor6/DSC04138.JPG,char_data/4/DSC04138.JPG_0.jpg,1056,33,241,274,153,185,True,6
4,30,kaist_dataset/Korean/Digital_Camera/outdoor6/DSC04138.JPG,char_data/4/DSC04138.JPG_0.jpg,840,28,381,409,155,185,True,6
4,49,kaist_dataset/Korean/Digital_Camera/A-shadow/DSC04315.JPG,char_data/4/DSC04315.JPG_0.jpg,1323,27,169,196,415,464,True,6
4,71,kaist_dataset/Korean/Digital_Camera/A-shadow/DSC03755.JPG,char_data/4/DSC03755.JPG_0.jpg,2059,29,353,382,206,277,True,6
4,75,kaist_dataset/Korean/Digital_Camera/A-shadow/DSC03755.JPG,char_data/4/DSC03755.JPG_0.jpg,2475,33,515,548,208,283,True,6
4,84,kaist_dataset/Korean/Digital_Camera/A-shadow/DSC04311.JPG,char_data/4/DSC04311.JPG_0.jpg,4368,52,173,225,263,347,True,6
4,70,kaist_dataset/Korean/Digital_Camera/A-shadow/DSC03536.JPG,char_data/4/DSC03536.JPG_0.jpg,2870,41,268,309,244,314,True,6
4,151,kaist_dataset/Korean/Digital_Camera/A-shadow/DSC02670.JPG,char_data/4/DSC02670.JPG_0.jpg,11476,76,198,274,20,171,True,6
4,134,kaist_dataset/Korean/Digital_Camera/A-shadow/DSC02670.JPG,char_data/4/DSC02670.JPG_0.jpg,6700,50,491,541,25,159,True,6
4,135,kaist_dataset/Korean/Digital_Camera/A-shadow/DSC02670.JPG,char_data/4/DSC02670.JPG_0.jpg,6750,50,556,606,25,160,True,6
4,35,kaist_dataset/Korean/Digital_Camera/A-shadow/DSC04297.JPG,char_data/4/DSC04297.JPG_0.jpg,525,15,391,406,205,240,True,6
4,36,kaist_dataset/Korean/Digital_Camera/A-shadow/DSC04297.JPG,char_data/4/DSC04297.JPG_0.jpg,540,15,421,436,204,240,True,6
4,33,kaist_dataset/Korean/Digital_Camera/A-shadow/DSC04297.JPG,char_data/4/DSC04297.JPG_0.jpg,462,14,464,478,206,239,True,6
4,41,kaist_dataset/Korean/Digital_Camera/outdoor3/DSC02999.JPG,char_data/4/DSC02999.JPG_0.jpg,902,22,203,225,427,468,True,6
4,30,kaist_dataset/Korean/Digital_Camera/outdoor3/DSC02999.JPG,char_data/4/DSC02999.JPG_0.jpg,540,18,260,278,435,465,True,6
4,32,kaist_dataset/Korean/Digital_Camera/outdoor3/DSC02971.JPG,char_data/4/DSC02971.JPG_0.jpg,768,24,252,276,297,329,True,6
4,32,kaist_dataset/Korean/Digital_Camera/outdoor3/DSC02531.JPG,char_data/4/DSC02531.JPG_0.jpg,576,18,289,307,347,379,True,6
4,30,kaist_dataset/Korean/Digital_Camera/outdoor3/DSC02943.JPG,char_data/4/DSC02943.JPG_0.jpg,630,21,301,322,429,459,True,6
4,67,kaist_dataset/Korean/Digital_Camera/outdoor3/DSC03198.JPG,char_data/4/DSC03198.JPG_0.jpg,3752,56,21,77,198,265,True,6
4,35,kaist_dataset/Korean/Digital_Camera/outdoor3/DSC02944.JPG,char_data/4/DSC02944.JPG_0.jpg,945,27,215,242,238,273,True,6
4,41,kaist_dataset/Korean/Digital_Camera/outdoor3/DSC02686.JPG,char_data/4/DSC02686.JPG_0.jpg,1066,26,223,249,224,265,True,6
4,40,kaist_dataset/Korean/Digital_Camera/outdoor3/DSC02686.JPG,char_data/4/DSC02686.JPG_0.jpg,1000,25,466,491,227,267,True,6
4,50,kaist_dataset/Korean/Digital_Camera/outdoor3/DSC02899.JPG,char_data/4/DSC02899.JPG_0.jpg,1700,34,346,380,229,279,True,6
4,38,kaist_dataset/Korean/Digital_Camera/outdoor3/DSC02899.JPG,char_data/4/DSC02899.JPG_0.jpg,1520,40,477,517,228,266,True,6
4,77,kaist_dataset/Korean/Digital_Camera/outdoor3/DSC02900.JPG,char_data/4/DSC02900.JPG_0.jpg,3619,47,468,515,241,318,True,6
4,73,kaist_dataset/Korean/Digital_Camera/outdoor3/DSC02900.JPG,char_data/4/DSC02900.JPG_0.jpg,3650,50,563,613,238,311,True,6
4,69,kaist_dataset/Korean/Digital_Camera/outdoor3/DSC02900.JPG,char_data/4/DSC02900.JPG_0.jpg,3450,50,244,294,260,329,True,6
4,53,kaist_dataset/Korean/Digital_Camera/outdoor3/DSC02953.JPG,char_data/4/DSC02953.JPG_0.jpg,2703,51,306,357,388,441,True,6
4,20,kaist_dataset/Korean/Digital_Camera/outdoor3/DSC02891.JPG,char_data/4/DSC02891.JPG_0.jpg,300,15,506,521,306,326,True,6
4,35,kaist_dataset/Korean/Digital_Camera/outdoor3/DSC02975.JPG,char_data/4/DSC02975.JPG_0.jpg,1050,30,296,326,240,275,True,6
4,45,kaist_dataset/Korean/Digital_Camera/outdoor3/DSC03237.JPG,char_data/4/DSC03237.JPG_0.jpg,1305,29,201,230,399,444,True,6
4,40,kaist_dataset/Korean/Digital_Camera/outdoor3/DSC03237.JPG,char_data/4/DSC03237.JPG_0.jpg,1000,25,257,282,400,440,True,6
4,47,kaist_dataset/Korean/Digital_Camera/outdoor3/DSC03237.JPG,char_data/4/DSC03237.JPG_0.jpg,1222,26,325,351,395,442,True,6
4,27,kaist_dataset/Korean/Digital_Camera/outdoor3/DSC02529.JPG,char_data/4/DSC02529.JPG_0.jpg,324,12,530,542,373,400,True,6
4,27,kaist_dataset/Korean/Digital_Camera/outdoor3/DSC02529.JPG,char_data/4/DSC02529.JPG_0.jpg,297,11,579,590,371,398,True,6
4,27,kaist_dataset/Korean/Digital_Camera/outdoor3/DSC02529.JPG,char_data/4/DSC02529.JPG_0.jpg,405,15,597,612,372,399,True,6
4,40,kaist_dataset/Korean/Digital_Camera/outdoor3/DSC02941.JPG,char_data/4/DSC02941.JPG_0.jpg,1160,29,326,355,254,294,True,6
4,45,kaist_dataset/Korean/Digital_Camera/outdoor3/DSC02941.JPG,char_data/4/DSC02941.JPG_0.jpg,900,20,377,397,251,296,True,6
4,46,kaist_dataset/Korean/Digital_Camera/outdoor3/DSC02994.JPG,char_data/4/DSC02994.JPG_0.jpg,966,21,98,119,63,109,True,6
4,46,kaist_dataset/Korean/Digital_Camera/outdoor3/DSC02994.JPG,char_data/4/DSC02994.JPG_0.jpg,1748,38,185,223,284,330,True,6
4,34,kaist_dataset/Korean/Digital_Camera/outdoor3/DSC03219.JPG,char_data/4/DSC03219.JPG_0.jpg,884,26,324,350,410,444,True,6
4,46,kaist_dataset/Korean/Digital_Camera/outdoor3/DSC02957.JPG,char_data/4/DSC02957.JPG_0.jpg,1656,36,215,251,398,444,True,6
4,41,kaist_dataset/Korean/Digital_Camera/outdoor3/DSC02957.JPG,char_data/4/DSC02957.JPG_0.jpg,1189,29,349,378,406,447,True,6
4,112,kaist_dataset/Korean/Digital_Camera/outdoor3/DSC02983.JPG,char_data/4/DSC02983.JPG_0.jpg,7840,70,77,147,294,406,True,6
4,98,kaist_dataset/Korean/Digital_Camera/outdoor3/DSC02983.JPG,char_data/4/DSC02983.JPG_0.jpg,5586,57,308,365,309,407,True,6
4,100,kaist_dataset/Korean/Digital_Camera/outdoor3/DSC02983.JPG,char_data/4/DSC02983.JPG_0.jpg,5100,51,413,464,314,414,True,6
4,123,kaist_dataset/Korean/Digital_Camera/outdoor3/DSC03159.JPG,char_data/4/DSC03159.JPG_0.jpg,7626,62,3,65,213,336,True,6
4,33,kaist_dataset/Korean/Digital_Camera/outdoor3/DSC02888.JPG,char_data/4/DSC02888.JPG_0.jpg,957,29,132,161,427,460,True,6
4,63,kaist_dataset/Korean/Digital_Camera/outdoor3/DSC02951.JPG,char_data/4/DSC02951.JPG_0.jpg,3654,58,65,123,390,453,True,6
4,35,kaist_dataset/Korean/Digital_Camera/outdoor3/DSC02939.JPG,char_data/4/DSC02939.JPG_0.jpg,840,24,263,287,367,402,True,6
4,34,kaist_dataset/Korean/Digital_Camera/outdoor3/DSC02939.JPG,char_data/4/DSC02939.JPG_0.jpg,782,23,333,356,371,405,True,6
4,37,kaist_dataset/Korean/Digital_Camera/outdoor3/DSC03232.JPG,char_data/4/DSC03232.JPG_0.jpg,1184,32,188,220,285,322,True,6
4,30,kaist_dataset/Korean/Digital_Camera/outdoor1/071.JPG,char_data/4/071.JPG_0.jpg,570,19,282,301,257,287,True,6
4,29,kaist_dataset/Korean/Digital_Camera/outdoor1/071.JPG,char_data/4/071.JPG_0.jpg,638,22,374,396,259,288,True,6
4,36,kaist_dataset/Korean/Digital_Camera/outdoor1/091.JPG,char_data/4/091.JPG_0.jpg,900,25,313,338,286,322,True,6
4,24,kaist_dataset/Korean/Digital_Camera/outdoor1/028.JPG,char_data/4/028.JPG_0.jpg,384,16,342,358,265,289,True,6
4,25,kaist_dataset/Korean/Digital_Camera/outdoor1/028.JPG,char_data/4/028.JPG_0.jpg,400,16,384,400,262,287,True,6
4,30,kaist_dataset/Korean/Digital_Camera/outdoor1/029.JPG,char_data/4/029.JPG_0.jpg,720,24,356,380,290,320,True,6
4,22,kaist_dataset/Korean/Digital_Camera/outdoor1/126.JPG,char_data/4/126.JPG_0.jpg,506,23,325,348,264,286,True,6
4,27,kaist_dataset/Korean/Digital_Camera/outdoor1/126.JPG,char_data/4/126.JPG_0.jpg,243,9,460,469,255,282,True,6
4,33,kaist_dataset/Korean/Digital_Camera/outdoor1/040.JPG,char_data/4/040.JPG_0.jpg,759,23,272,295,297,330,True,6
4,35,kaist_dataset/Korean/Digital_Camera/outdoor1/023.JPG,char_data/4/023.JPG_0.jpg,805,23,231,254,265,300,True,6
4,19,kaist_dataset/Korean/Digital_Camera/outdoor1/006.JPG,char_data/4/006.JPG_0.jpg,323,17,320,337,254,273,True,6
4,28,kaist_dataset/Korean/Digital_Camera/outdoor1/032.JPG,char_data/4/032.JPG_0.jpg,588,21,521,542,254,282,True,6
4,31,kaist_dataset/Korean/Digital_Camera/outdoor1/035.JPG,char_data/4/035.JPG_0.jpg,527,17,377,394,288,319,True,6
4,32,kaist_dataset/Mixed/Mobile_Phone/(C.M)A-outdoor/P090908006.jpg,char_data/4/P090908006.jpg_0.jpg,480,15,373,388,368,400,True,6
4,40,kaist_dataset/Mixed/Mobile_Phone/(C.M)A-outdoor/P090912066.jpg,char_data/4/P090912066.jpg_0.jpg,920,23,431,454,217,257,True,6
4,30,kaist_dataset/Mixed/Mobile_Phone/(C.M)A-outdoor/P090912036.jpg,char_data/4/P090912036.jpg_0.jpg,420,14,212,226,192,222,True,6
4,32,kaist_dataset/Mixed/Mobile_Phone/(C.M)A-outdoor/P090912036.jpg,char_data/4/P090912036.jpg_0.jpg,448,14,239,253,190,222,True,6
4,32,kaist_dataset/Mixed/Mobile_Phone/(C.M)A-outdoor/P090912036.jpg,char_data/4/P090912036.jpg_0.jpg,576,18,355,373,192,224,True,6
4,32,kaist_dataset/Mixed/Mobile_Phone/(C.M)A-outdoor/P090912036.jpg,char_data/4/P090912036.jpg_0.jpg,512,16,411,427,191,223,True,6
4,32,kaist_dataset/Mixed/Mobile_Phone/(C.M)A-outdoor/P090912036.jpg,char_data/4/P090912036.jpg_0.jpg,448,14,442,456,190,222,True,6
4,38,kaist_dataset/Mixed/Mobile_Phone/(C.M)A-outdoor/P090912047.jpg,char_data/4/P090912047.jpg_0.jpg,836,22,376,398,277,315,True,6
4,58,kaist_dataset/Mixed/Mobile_Phone/(C.M)B-indoor/P090831007.jpg,char_data/4/P090831007.jpg_0.jpg,2726,47,160,207,129,187,True,6
4,64,kaist_dataset/Mixed/Mobile_Phone/(C.M)B-indoor/P090831007.jpg,char_data/4/P090831007.jpg_0.jpg,2944,46,349,395,132,196,True,6
4,61,kaist_dataset/Mixed/Mobile_Phone/(C.M)B-indoor/P090831007.jpg,char_data/4/P090831007.jpg_0.jpg,2623,43,396,439,130,191,True,6
4,63,kaist_dataset/Mixed/Mobile_Phone/(C.M)B-indoor/P090831007.jpg,char_data/4/P090831007.jpg_0.jpg,2772,44,166,210,199,262,True,6
4,65,kaist_dataset/Mixed/Mobile_Phone/(C.M)B-indoor/P090831007.jpg,char_data/4/P090831007.jpg_0.jpg,2925,45,355,400,205,270,True,6
4,61,kaist_dataset/Mixed/Mobile_Phone/(C.M)B-indoor/P090831007.jpg,char_data/4/P090831007.jpg_0.jpg,2501,41,165,206,272,333,True,6
4,64,kaist_dataset/Mixed/Mobile_Phone/(C.M)B-indoor/P090831007.jpg,char_data/4/P090831007.jpg_0.jpg,2816,44,351,395,273,337,True,6
4,66,kaist_dataset/Mixed/Mobile_Phone/(C.M)B-indoor/P090831007.jpg,char_data/4/P090831007.jpg_0.jpg,2772,42,394,436,273,339,True,6
4,44,kaist_dataset/Mixed/Mobile_Phone/(C.M)C-bookCover/P090902016.jpg,char_data/4/P090902016.jpg_0.jpg,1100,25,58,83,200,244,True,6
4,95,kaist_dataset/Mixed/Mobile_Phone/(C.M)C-bookCover/P090902019.jpg,char_data/4/P090902019.jpg_0.jpg,3705,39,86,125,72,167,True,6
4,62,kaist_dataset/Mixed/Mobile_Phone/(C.M)C-bookCover/P090902019.jpg,char_data/4/P090902019.jpg_0.jpg,1984,32,41,73,277,339,True,6
4,47,kaist_dataset/Mixed/Digital_Camera/(C.S)C-outdoor1/P1010012.JPG,char_data/4/P1010012.JPG_0.jpg,1927,41,286,327,236,283,True,6
4,52,kaist_dataset/Mixed/Digital_Camera/(C.S)C-outdoor1/P1010012.JPG,char_data/4/P1010012.JPG_0.jpg,1716,33,456,489,235,287,True,6
4,40,kaist_dataset/Mixed/Digital_Camera/(C.S)C-outdoor1/51.JPG,char_data/4/51.JPG_0.jpg,1080,27,636,663,376,416,True,6
4,46,kaist_dataset/Mixed/Digital_Camera/(C.S)C-outdoor1/133.JPG,char_data/4/133.JPG_0.jpg,1196,26,40,66,218,264,True,6
4,51,kaist_dataset/Mixed/Digital_Camera/(C.S)C-outdoor1/2007-12-09-day-exterior-078.jpg,char_data/4/2007-12-09-day-exterior-078.jpg_0.jpg,1377,27,584,611,591,642,True,6
4,54,kaist_dataset/Mixed/Digital_Camera/(C.S)C-outdoor1/2007-12-09-day-exterior-078.jpg,char_data/4/2007-12-09-day-exterior-078.jpg_0.jpg,1080,20,739,759,581,635,True,6
4,51,kaist_dataset/Mixed/Digital_Camera/(C.S)C-outdoor1/2007-12-09-day-exterior-078.jpg,char_data/4/2007-12-09-day-exterior-078.jpg_0.jpg,918,18,782,800,583,634,True,6
4,55,kaist_dataset/Mixed/Digital_Camera/(C.S)C-outdoor1/2007-12-09-day-exterior-078.jpg,char_data/4/2007-12-09-day-exterior-078.jpg_0.jpg,1375,25,866,891,578,633,True,6
4,38,kaist_dataset/Mixed/Digital_Camera/(C.S)C-outdoor1/P1010010.JPG,char_data/4/P1010010.JPG_0.jpg,1140,30,222,252,218,256,True,6
4,45,kaist_dataset/Mixed/Digital_Camera/(C.S)C-outdoor1/P1010010.JPG,char_data/4/P1010010.JPG_0.jpg,1035,23,315,338,362,407,True,6
4,71,kaist_dataset/Mixed/Digital_Camera/(C.S)C-outdoor1/2007-12-09-day-exterior-086.jpg,char_data/4/2007-12-09-day-exterior-086.jpg_0.jpg,5396,76,832,908,721,792,True,6
4,50,kaist_dataset/Mixed/Digital_Camera/(C.S)C-outdoor1/080116-0084.jpg,char_data/4/080116-0084.jpg_0.jpg,1350,27,569,596,305,355,True,6
4,36,kaist_dataset/Mixed/Digital_Camera/(C.S)C-outdoor1/DSC02344.JPG,char_data/4/DSC02344.JPG_0.jpg,828,23,471,494,255,291,True,6
4,34,kaist_dataset/Mixed/Digital_Camera/(C.S)C-outdoor1/DSC02344.JPG,char_data/4/DSC02344.JPG_0.jpg,646,19,546,565,258,292,True,6
4,26,kaist_dataset/Mixed/Digital_Camera/(C.S)C-outdoor1/121.JPG,char_data/4/121.JPG_0.jpg,468,18,470,488,277,303,True,6
4,21,kaist_dataset/Mixed/Digital_Camera/(C.S)C-outdoor1/48.JPG,char_data/4/48.JPG_0.jpg,336,16,266,282,344,365,True,6
4,22,kaist_dataset/Mixed/Digital_Camera/(C.S)C-outdoor1/48.JPG,char_data/4/48.JPG_0.jpg,330,15,296,311,343,365,True,6
4,24,kaist_dataset/Mixed/Digital_Camera/(C.S)C-outdoor1/48.JPG,char_data/4/48.JPG_0.jpg,312,13,374,387,342,366,True,6
4,39,kaist_dataset/Mixed/Digital_Camera/(C.S)C-outdoor1/56.JPG,char_data/4/56.JPG_0.jpg,1716,44,543,587,299,338,True,6
4,22,kaist_dataset/Mixed/Digital_Camera/(C.S)C-outdoor1/047.JPG,char_data/4/047.JPG_0.jpg,198,9,554,563,240,262,True,6
4,47,kaist_dataset/Mixed/Digital_Camera/(C.S)C-outdoor1/P1010009.JPG,char_data/4/P1010009.JPG_0.jpg,1222,26,91,117,233,280,True,6
4,41,kaist_dataset/Mixed/Digital_Camera/(C.S)C-outdoor1/P1010009.JPG,char_data/4/P1010009.JPG_0.jpg,1107,27,155,182,238,279,True,6
4,41,kaist_dataset/Mixed/Digital_Camera/(C.S)C-outdoor1/DSC02349.JPG,char_data/4/DSC02349.JPG_0.jpg,1066,26,362,388,195,236,True,6
4,36,kaist_dataset/Mixed/Digital_Camera/(C.S)C-outdoor1/DSC02349.JPG,char_data/4/DSC02349.JPG_0.jpg,792,22,419,441,427,463,True,6
4,26,kaist_dataset/Mixed/Digital_Camera/(C.S)C-outdoor1/57.JPG,char_data/4/57.JPG_0.jpg,364,14,419,433,296,322,True,6
4,31,kaist_dataset/Mixed/Digital_Camera/(C.S)C-outdoor1/57.JPG,char_data/4/57.JPG_0.jpg,434,14,544,558,296,327,True,6
4,27,kaist_dataset/Mixed/Digital_Camera/(C.S)C-outdoor1/57.JPG,char_data/4/57.JPG_0.jpg,459,17,623,640,298,325,True,6
4,26,kaist_dataset/Mixed/Digital_Camera/(C.S)C-outdoor1/57.JPG,char_data/4/57.JPG_0.jpg,364,14,378,392,454,480,True,6
4,23,kaist_dataset/Mixed/Digital_Camera/(C.S)C-outdoor1/57.JPG,char_data/4/57.JPG_0.jpg,276,12,451,463,457,480,True,6
4,39,kaist_dataset/Mixed/Digital_Camera/(C.S)C-outdoor1/DSC02312.JPG,char_data/4/DSC02312.JPG_0.jpg,1248,32,300,332,219,258,True,6
4,72,kaist_dataset/Mixed/Digital_Camera/(C.S)C-outdoor1/080119-0003.jpg,char_data/4/080119-0003.jpg_0.jpg,2808,39,453,492,338,410,True,6
4,57,kaist_dataset/Mixed/Digital_Camera/(C.S)C-outdoor1/066.JPG,char_data/4/066.JPG_0.jpg,2166,38,471,509,176,233,True,6
4,43,kaist_dataset/Mixed/Digital_Camera/(C.S)C-outdoor1/DSC02350.JPG,char_data/4/DSC02350.JPG_0.jpg,1333,31,423,454,397,440,True,6
4,31,kaist_dataset/Mixed/Digital_Camera/(C.S)C-outdoor1/DSC02242.JPG,char_data/4/DSC02242.JPG_0.jpg,403,13,573,586,260,291,True,6
4,85,kaist_dataset/Mixed/Digital_Camera/(C.S)C-outdoor1/DSC02244.JPG,char_data/4/DSC02244.JPG_0.jpg,4165,49,273,322,347,432,True,6
4,89,kaist_dataset/Mixed/Digital_Camera/(C.S)C-outdoor1/DSC02244.JPG,char_data/4/DSC02244.JPG_0.jpg,4984,56,506,562,349,438,True,6
4,32,kaist_dataset/Mixed/Digital_Camera/(C.S)C-outdoor1/2.JPG,char_data/4/2.JPG_0.jpg,576,18,286,304,70,102,True,6
4,36,kaist_dataset/Mixed/Digital_Camera/(C.S)C-outdoor1/2.JPG,char_data/4/2.JPG_0.jpg,648,18,306,324,67,103,True,6
4,26,kaist_dataset/Mixed/Digital_Camera/(C.S)C-outdoor1/063.JPG,char_data/4/063.JPG_0.jpg,338,13,447,460,257,283,True,6
4,51,kaist_dataset/Mixed/Digital_Camera/(C.S)C-outdoor1/1.JPG,char_data/4/1.JPG_0.jpg,1275,25,262,287,458,509,True,6
4,20,kaist_dataset/Mixed/Digital_Camera/(C.S)C-outdoor1/014.JPG,char_data/4/014.JPG_0.jpg,340,17,181,198,279,299,True,6
4,14,kaist_dataset/Mixed/Digital_Camera/(C.S)C-outdoor1/014.JPG,char_data/4/014.JPG_0.jpg,224,16,225,241,283,297,True,6
4,19,kaist_dataset/Mixed/Digital_Camera/(C.S)C-outdoor1/014.JPG,char_data/4/014.JPG_0.jpg,342,18,241,259,280,299,True,6
4,50,kaist_dataset/Mixed/Digital_Camera/(C.S)F-others/2007-12-08-day-113.jpg,char_data/4/2007-12-08-day-113.jpg_0.jpg,1150,23,874,897,411,461,True,6
4,56,kaist_dataset/Mixed/Digital_Camera/(C.S)F-others/DSC02793.JPG,char_data/4/DSC02793.JPG_0.jpg,1568,28,59,87,350,406,True,6
4,88,kaist_dataset/Mixed/Digital_Camera/(C.S)F-others/DSC03224.JPG,char_data/4/DSC03224.JPG_0.jpg,4840,55,83,138,257,345,True,6
4,80,kaist_dataset/Mixed/Digital_Camera/(C.S)F-others/DSC03224.JPG,char_data/4/DSC03224.JPG_0.jpg,4080,51,179,230,248,328,True,6
4,79,kaist_dataset/Mixed/Digital_Camera/(C.S)F-others/DSC03224.JPG,char_data/4/DSC03224.JPG_0.jpg,4187,53,324,377,217,296,True,6
4,43,kaist_dataset/Mixed/Digital_Camera/(C.S)F-others/2007-12-08-day-044.jpg,char_data/4/2007-12-08-day-044.jpg_0.jpg,1075,25,71,96,736,779,True,6
4,44,kaist_dataset/Mixed/Digital_Camera/(C.S)F-others/DSC02893.JPG,char_data/4/DSC02893.JPG_0.jpg,1496,34,262,296,345,389,True,6
4,49,kaist_dataset/Mixed/Digital_Camera/(C.S)F-others/2007-12-09-day-exterior-023.jpg,char_data/4/2007-12-09-day-exterior-023.jpg_0.jpg,2205,45,937,982,591,640,True,6
4,22,kaist_dataset/Mixed/Digital_Camera/(C.S)E-night/P1010155.JPG,char_data/4/P1010155.JPG_0.jpg,264,12,439,451,287,309,True,6
4,36,kaist_dataset/Mixed/Digital_Camera/(C.S)E-night/DSC02647.JPG,char_data/4/DSC02647.JPG_0.jpg,972,27,329,356,272,308,True,6
4,39,kaist_dataset/Mixed/Digital_Camera/(C.S)E-night/DSC02647.JPG,char_data/4/DSC02647.JPG_0.jpg,975,25,378,403,268,307,True,6
4,75,kaist_dataset/Mixed/Digital_Camera/(C.S)E-night/P1010152.JPG,char_data/4/P1010152.JPG_0.jpg,5775,77,509,586,217,292,True,6
4,66,kaist_dataset/Mixed/Digital_Camera/(C.S)E-night/P1010152.JPG,char_data/4/P1010152.JPG_0.jpg,3432,52,194,246,228,294,True,6
4,36,kaist_dataset/Mixed/Digital_Camera/(C.S)E-night/P1010156.JPG,char_data/4/P1010156.JPG_0.jpg,756,21,299,320,242,278,True,6
4,58,kaist_dataset/Mixed/Digital_Camera/(C.S)E-night/DSC02574.JPG,char_data/4/DSC02574.JPG_0.jpg,2088,36,566,602,410,468,True,6
4,35,kaist_dataset/Mixed/Digital_Camera/(C.S)E-night/DSC02585.JPG,char_data/4/DSC02585.JPG_0.jpg,525,15,392,407,415,450,True,6
4,26,kaist_dataset/Mixed/Digital_Camera/(C.S)E-night/DSC03840.JPG,char_data/4/DSC03840.JPG_0.jpg,468,18,431,449,207,233,True,6
4,80,kaist_dataset/Mixed/Digital_Camera/(C.S)E-night/P1010151.JPG,char_data/4/P1010151.JPG_0.jpg,5360,67,155,222,349,429,True,6
4,83,kaist_dataset/Mixed/Digital_Camera/(C.S)E-night/P1010151.JPG,char_data/4/P1010151.JPG_0.jpg,4980,60,432,492,347,430,True,6
4,75,kaist_dataset/Mixed/Digital_Camera/(C.S)E-night/P1010151.JPG,char_data/4/P1010151.JPG_0.jpg,4200,56,490,546,356,431,True,6
4,71,kaist_dataset/Mixed/Digital_Camera/(C.S)E-night/P1010151.JPG,char_data/4/P1010151.JPG_0.jpg,4331,61,543,604,358,429,True,6
4,29,kaist_dataset/Mixed/Digital_Camera/(C.S)E-night/DSC02678.JPG,char_data/4/DSC02678.JPG_0.jpg,406,14,400,414,397,426,True,6
4,33,kaist_dataset/Mixed/Digital_Camera/(C.S)E-night/DSC02678.JPG,char_data/4/DSC02678.JPG_0.jpg,429,13,420,433,392,425,True,6
4,37,kaist_dataset/Mixed/Digital_Camera/(C.S)E-night/DSC02678.JPG,char_data/4/DSC02678.JPG_0.jpg,592,16,432,448,392,429,True,6
4,35,kaist_dataset/Mixed/Digital_Camera/(C.S)E-night/DSC02678.JPG,char_data/4/DSC02678.JPG_0.jpg,420,12,449,461,392,427,True,6
4,36,kaist_dataset/Mixed/Digital_Camera/(C.S)E-night/DSC02673.JPG,char_data/4/DSC02673.JPG_0.jpg,684,19,348,367,301,337,True,6
4,49,kaist_dataset/Mixed/Digital_Camera/(C.S)E-night/DSC03561.JPG,char_data/4/DSC03561.JPG_0.jpg,1715,35,220,255,255,304,True,6
4,41,kaist_dataset/Mixed/Digital_Camera/(C.S)E-night/DSC02569.JPG,char_data/4/DSC02569.JPG_0.jpg,779,19,273,292,410,451,True,6
4,43,kaist_dataset/Mixed/Digital_Camera/(C.S)E-night/DSC02569.JPG,char_data/4/DSC02569.JPG_0.jpg,774,18,422,440,405,448,True,6
4,67,kaist_dataset/Mixed/Digital_Camera/(C.S)E-night/DSC02600.JPG,char_data/4/DSC02600.JPG_0.jpg,5025,75,235,310,193,260,True,6
4,60,kaist_dataset/Mixed/Digital_Camera/(C.S)E-night/P1010147.JPG,char_data/4/P1010147.JPG_0.jpg,2520,42,191,233,254,314,True,6
4,32,kaist_dataset/Mixed/Digital_Camera/(C.S)B-light/DSC03298.JPG,char_data/4/DSC03298.JPG_0.jpg,576,18,355,373,287,319,True,6
4,49,kaist_dataset/Mixed/Digital_Camera/(C.S)D-indoor1/DSC02796.JPG,char_data/4/DSC02796.JPG_0.jpg,1568,32,33,65,243,292,True,6
4,25,kaist_dataset/Mixed/Digital_Camera/(C.S)D-indoor1/DSC04005.JPG,char_data/4/DSC04005.JPG_0.jpg,475,19,243,262,443,468,True,6
4,24,kaist_dataset/Mixed/Digital_Camera/(C.S)D-indoor1/DSC04005.JPG,char_data/4/DSC04005.JPG_0.jpg,456,19,406,425,440,464,True,6
4,65,kaist_dataset/Mixed/Digital_Camera/(C.S)D-indoor1/DSC03998.JPG,char_data/4/DSC03998.JPG_0.jpg,2860,44,334,378,410,475,True,6
4,109,kaist_dataset/Mixed/Digital_Camera/(C.S)D-indoor1/DSC04002.JPG,char_data/4/DSC04002.JPG_0.jpg,8393,77,51,128,346,455,True,6
4,59,kaist_dataset/Mixed/Digital_Camera/(C.S)D-indoor1/DSC02791.JPG,char_data/4/DSC02791.JPG_0.jpg,2124,36,45,81,323,382,True,6
4,47,kaist_dataset/Mixed/Digital_Camera/(C.S)D-indoor1/DSC03986.JPG,char_data/4/DSC03986.JPG_0.jpg,846,18,128,146,162,209,True,6
4,48,kaist_dataset/Mixed/Digital_Camera/(C.S)D-indoor1/DSC02789.JPG,char_data/4/DSC02789.JPG_0.jpg,1680,35,33,68,226,274,True,6
4,82,kaist_dataset/Mixed/Digital_Camera/(C.S)D-indoor1/DSC03466.JPG,char_data/4/DSC03466.JPG_0.jpg,5084,62,132,194,128,210,True,6
4,55,kaist_dataset/Mixed/Digital_Camera/(C.S)D-indoor1/DSC02733.JPG,char_data/4/DSC02733.JPG_0.jpg,1705,31,376,407,388,443,True,6
4,54,kaist_dataset/Mixed/Digital_Camera/(C.S)D-indoor1/DSC02733.JPG,char_data/4/DSC02733.JPG_0.jpg,1674,31,407,438,388,442,True,6
4,46,kaist_dataset/Mixed/Digital_Camera/(C.S)D-indoor1/DSC02794.JPG,char_data/4/DSC02794.JPG_0.jpg,1104,24,55,79,322,368,True,6
4,37,kaist_dataset/Mixed/Digital_Camera/(C.S)C-outdoor5/DSC04098.JPG,char_data/4/DSC04098.JPG_0.jpg,629,17,431,448,313,350,True,6
4,61,kaist_dataset/Mixed/Digital_Camera/(C.S)C-outdoor5/DSC03847.JPG,char_data/4/DSC03847.JPG_0.jpg,1403,23,359,382,12,73,True,6
4,53,kaist_dataset/Mixed/Digital_Camera/(C.S)C-outdoor5/DSC03847.JPG,char_data/4/DSC03847.JPG_0.jpg,1484,28,422,450,16,69,True,6
4,54,kaist_dataset/Mixed/Digital_Camera/(C.S)C-outdoor5/DSC03847.JPG,char_data/4/DSC03847.JPG_0.jpg,1512,28,543,571,10,64,True,6
4,60,kaist_dataset/Mixed/Digital_Camera/(C.S)C-outdoor5/DSC03847.JPG,char_data/4/DSC03847.JPG_0.jpg,1500,25,595,620,12,72,True,6
4,39,kaist_dataset/Mixed/Digital_Camera/(C.S)C-outdoor5/P1010007.JPG,char_data/4/P1010007.JPG_0.jpg,1287,33,315,348,270,309,True,6
4,41,kaist_dataset/Mixed/Digital_Camera/(C.S)C-outdoor5/P1010007.JPG,char_data/4/P1010007.JPG_0.jpg,1476,36,374,410,270,311,True,6
4,42,kaist_dataset/Mixed/Digital_Camera/(C.S)C-outdoor5/P1010007.JPG,char_data/4/P1010007.JPG_0.jpg,1302,31,409,440,269,311,True,6
4,27,kaist_dataset/Mixed/Digital_Camera/(C.S)C-outdoor5/DSC04146.JPG,char_data/4/DSC04146.JPG_0.jpg,621,23,263,286,408,435,True,6
4,38,kaist_dataset/Mixed/Digital_Camera/(C.S)C-outdoor5/DSC04144.JPG,char_data/4/DSC04144.JPG_0.jpg,988,26,240,266,417,455,True,6
4,64,kaist_dataset/Mixed/Digital_Camera/(C.S)C-outdoor5/DSC04108.JPG,char_data/4/DSC04108.JPG_0.jpg,2240,35,322,357,239,303,True,6
4,69,kaist_dataset/Mixed/Digital_Camera/(C.S)C-outdoor5/DSC04108.JPG,char_data/4/DSC04108.JPG_0.jpg,2346,34,523,557,234,303,True,6
4,68,kaist_dataset/Mixed/Digital_Camera/(C.S)C-outdoor5/DSC04108.JPG,char_data/4/DSC04108.JPG_0.jpg,2380,35,557,592,231,299,True,6
4,23,kaist_dataset/Mixed/Digital_Camera/(C.S)C-outdoor5/DSC04086.JPG,char_data/4/DSC04086.JPG_0.jpg,345,15,362,377,373,396,True,6
4,32,kaist_dataset/Mixed/Digital_Camera/(C.S)C-outdoor5/DSC04155.JPG,char_data/4/DSC04155.JPG_0.jpg,672,21,478,499,264,296,True,6
4,30,kaist_dataset/Mixed/Digital_Camera/(C.S)C-outdoor5/DSC04072.JPG,char_data/4/DSC04072.JPG_0.jpg,300,10,584,594,350,380,True,6
4,36,kaist_dataset/Mixed/Digital_Camera/(C.S)C-outdoor5/DSC04072.JPG,char_data/4/DSC04072.JPG_0.jpg,576,16,606,622,348,384,True,6
4,128,kaist_dataset/Mixed/Digital_Camera/(C.S)C-outdoor5/DSC04330.JPG,char_data/4/DSC04330.JPG_0.jpg,6912,54,122,176,245,373,True,6
4,37,kaist_dataset/Mixed/Digital_Camera/(C.S)C-outdoor5/DSC04330.JPG,char_data/4/DSC04330.JPG_0.jpg,1036,28,449,477,166,203,True,6
4,61,kaist_dataset/Mixed/Digital_Camera/(C.S)C-outdoor5/DSC04330.JPG,char_data/4/DSC04330.JPG_0.jpg,1891,31,485,516,356,417,True,6
4,67,kaist_dataset/Mixed/Digital_Camera/(C.S)C-outdoor5/DSC04016.JPG,char_data/4/DSC04016.JPG_0.jpg,2948,44,173,217,113,180,True,6
4,30,kaist_dataset/Mixed/Digital_Camera/(C.S)C-outdoor5/DSC04151.JPG,char_data/4/DSC04151.JPG_0.jpg,690,23,420,443,344,374,True,6
4,26,kaist_dataset/Mixed/Digital_Camera/(C.S)C-outdoor5/DSC04151.JPG,char_data/4/DSC04151.JPG_0.jpg,312,12,537,549,350,376,True,6
4,33,kaist_dataset/Mixed/Digital_Camera/(C.S)C-outdoor5/DSC04140.JPG,char_data/4/DSC04140.JPG_0.jpg,495,15,504,519,348,381,True,6
4,32,kaist_dataset/Mixed/Digital_Camera/(C.S)C-outdoor5/DSC04061.JPG,char_data/4/DSC04061.JPG_0.jpg,608,19,490,509,145,177,True,6
4,33,kaist_dataset/Mixed/Digital_Camera/(C.S)C-outdoor5/DSC04061.JPG,char_data/4/DSC04061.JPG_0.jpg,726,22,593,615,147,180,True,6
4,29,kaist_dataset/Mixed/Digital_Camera/(C.S)C-outdoor5/DSC04124.JPG,char_data/4/DSC04124.JPG_0.jpg,377,13,405,418,309,338,True,6
4,59,kaist_dataset/Mixed/Digital_Camera/(C.S)C-outdoor5/DSC04401.JPG,char_data/4/DSC04401.JPG_0.jpg,1652,28,238,266,248,307,True,6
4,61,kaist_dataset/Mixed/Digital_Camera/(C.S)C-outdoor5/DSC04401.JPG,char_data/4/DSC04401.JPG_0.jpg,2013,33,430,463,244,305,True,6
4,36,kaist_dataset/Mixed/Digital_Camera/(C.S)C-outdoor5/DSC04071.JPG,char_data/4/DSC04071.JPG_0.jpg,972,27,98,125,364,400,True,6
4,32,kaist_dataset/Mixed/Digital_Camera/(C.S)C-outdoor5/DSC04071.JPG,char_data/4/DSC04071.JPG_0.jpg,736,23,408,431,369,401,True,6
4,38,kaist_dataset/Mixed/Digital_Camera/(C.S)C-outdoor5/DSC04014.JPG,char_data/4/DSC04014.JPG_0.jpg,760,20,224,244,299,337,True,6
4,39,kaist_dataset/Mixed/Digital_Camera/(C.S)C-outdoor5/DSC04014.JPG,char_data/4/DSC04014.JPG_0.jpg,702,18,402,420,301,340,True,6
4,58,kaist_dataset/Mixed/Digital_Camera/(C.S)C-outdoor5/DSC04033.JPG,char_data/4/DSC04033.JPG_0.jpg,2494,43,101,144,283,341,True,6
4,58,kaist_dataset/Mixed/Digital_Camera/(C.S)C-outdoor5/DSC04033.JPG,char_data/4/DSC04033.JPG_0.jpg,1972,34,373,407,271,329,True,6
4,53,kaist_dataset/Mixed/Digital_Camera/(C.S)C-outdoor5/DSC04033.JPG,char_data/4/DSC04033.JPG_0.jpg,1961,37,492,529,264,317,True,6
4,41,kaist_dataset/Mixed/Digital_Camera/(C.S)C-outdoor5/DSC03821.JPG,char_data/4/DSC03821.JPG_0.jpg,861,21,233,254,78,119,True,6
4,40,kaist_dataset/Mixed/Digital_Camera/(C.S)C-outdoor5/DSC03821.JPG,char_data/4/DSC03821.JPG_0.jpg,880,22,285,307,80,120,True,6
4,37,kaist_dataset/Mixed/Digital_Camera/(C.S)C-outdoor5/DSC03837.JPG,char_data/4/DSC03837.JPG_0.jpg,925,25,317,342,379,416,True,6
4,64,kaist_dataset/Mixed/Digital_Camera/(C.S)C-outdoor5/DSC03837.JPG,char_data/4/DSC03837.JPG_0.jpg,2432,38,123,161,299,363,True,6
4,60,kaist_dataset/Mixed/Digital_Camera/(C.S)C-outdoor5/DSC03837.JPG,char_data/4/DSC03837.JPG_0.jpg,2280,38,221,259,304,364,True,6
4,64,kaist_dataset/Mixed/Digital_Camera/(C.S)C-outdoor5/DSC03837.JPG,char_data/4/DSC03837.JPG_0.jpg,2112,33,434,467,308,372,True,6
4,28,kaist_dataset/Mixed/Digital_Camera/(C.S)C-outdoor5/P1010004.JPG,char_data/4/P1010004.JPG_0.jpg,644,23,237,260,306,334,True,6
4,42,kaist_dataset/Mixed/Digital_Camera/(C.S)C-outdoor5/DSC04125.JPG,char_data/4/DSC04125.JPG_0.jpg,1218,29,41,70,178,220,True,6
4,39,kaist_dataset/Mixed/Digital_Camera/(C.S)C-outdoor5/DSC04125.JPG,char_data/4/DSC04125.JPG_0.jpg,936,24,425,449,415,454,True,6
4,39,kaist_dataset/Mixed/Digital_Camera/(C.S)C-outdoor5/DSC04070.JPG,char_data/4/DSC04070.JPG_0.jpg,819,21,349,370,105,144,True,6
4,38,kaist_dataset/Mixed/Digital_Camera/(C.S)C-outdoor5/DSC04070.JPG,char_data/4/DSC04070.JPG_0.jpg,950,25,556,581,105,143,True,6
4,25,kaist_dataset/Mixed/Digital_Camera/(C.S)C-outdoor5/DSC04031.JPG,char_data/4/DSC04031.JPG_0.jpg,375,15,460,475,382,407,True,6
4,22,kaist_dataset/Mixed/Digital_Camera/(C.S)C-outdoor5/DSC04031.JPG,char_data/4/DSC04031.JPG_0.jpg,330,15,153,168,380,402,True,6
4,25,kaist_dataset/Mixed/Digital_Camera/(C.S)C-outdoor5/DSC04150.JPG,char_data/4/DSC04150.JPG_0.jpg,375,15,490,505,365,390,True,6
4,28,kaist_dataset/Mixed/Digital_Camera/(C.S)C-outdoor5/DSC04150.JPG,char_data/4/DSC04150.JPG_0.jpg,420,15,542,557,366,394,True,6
4,29,kaist_dataset/Mixed/Digital_Camera/(C.S)C-outdoor5/DSC04150.JPG,char_data/4/DSC04150.JPG_0.jpg,319,11,557,568,365,394,True,6
4,50,kaist_dataset/Mixed/Digital_Camera/(C.S)C-outdoor5/DSC04017.JPG,char_data/4/DSC04017.JPG_0.jpg,1950,39,205,244,427,477,True,6
4,28,kaist_dataset/Mixed/Digital_Camera/(C.S)C-outdoor5/DSC04048.JPG,char_data/4/DSC04048.JPG_0.jpg,476,17,288,305,172,200,True,6
4,29,kaist_dataset/Mixed/Digital_Camera/(C.S)C-outdoor5/DSC04048.JPG,char_data/4/DSC04048.JPG_0.jpg,696,24,439,463,172,201,True,6
4,36,kaist_dataset/Mixed/Digital_Camera/(C.S)C-outdoor5/P1010002.JPG,char_data/4/P1010002.JPG_0.jpg,1152,32,403,435,282,318,True,6
4,40,kaist_dataset/Mixed/Digital_Camera/(C.S)C-outdoor5/P1010002.JPG,char_data/4/P1010002.JPG_0.jpg,1080,27,465,492,283,323,True,6
4,46,kaist_dataset/Mixed/Digital_Camera/(C.S)C-outdoor5/DSC04139.JPG,char_data/4/DSC04139.JPG_0.jpg,920,20,278,298,395,441,True,6
4,39,kaist_dataset/Mixed/Digital_Camera/(C.S)C-outdoor5/DSC04135.JPG,char_data/4/DSC04135.JPG_0.jpg,1092,28,397,425,387,426,True,6
4,41,kaist_dataset/Mixed/Digital_Camera/(C.S)C-outdoor5/DSC03842.JPG,char_data/4/DSC03842.JPG_0.jpg,1107,27,220,247,226,267,True,6
4,44,kaist_dataset/Mixed/Digital_Camera/(C.S)C-outdoor5/DSC03842.JPG,char_data/4/DSC03842.JPG_0.jpg,968,22,345,367,227,271,True,6
4,32,kaist_dataset/Mixed/Digital_Camera/(C.S)C-outdoor5/DSC04056.JPG,char_data/4/DSC04056.JPG_0.jpg,960,30,400,430,261,293,True,6
4,26,kaist_dataset/Mixed/Digital_Camera/(C.S)C-outdoor5/DSC04056.JPG,char_data/4/DSC04056.JPG_0.jpg,624,24,413,437,301,327,True,6
4,38,kaist_dataset/Mixed/Digital_Camera/(C.S)C-outdoor5/DSC04115.JPG,char_data/4/DSC04115.JPG_0.jpg,1140,30,341,371,356,394,True,6
4,49,kaist_dataset/Mixed/Digital_Camera/(C.S)C-outdoor3/DSC03189.JPG,char_data/4/DSC03189.JPG_0.jpg,1421,29,360,389,304,353,True,6
4,30,kaist_dataset/Mixed/Digital_Camera/(C.S)C-outdoor3/DSC03316.JPG,char_data/4/DSC03316.JPG_0.jpg,510,17,214,231,91,121,True,6
4,29,kaist_dataset/Mixed/Digital_Camera/(C.S)C-outdoor3/DSC03316.JPG,char_data/4/DSC03316.JPG_0.jpg,464,16,369,385,85,114,True,6
4,26,kaist_dataset/Mixed/Digital_Camera/(C.S)C-outdoor3/DSC03292.JPG,char_data/4/DSC03292.JPG_0.jpg,416,16,497,513,121,147,True,6
4,40,kaist_dataset/Mixed/Digital_Camera/(C.S)C-outdoor3/DSC02958.JPG,char_data/4/DSC02958.JPG_0.jpg,1040,26,234,260,402,442,True,6
4,29,kaist_dataset/Mixed/Digital_Camera/(C.S)C-outdoor3/DSC03303.JPG,char_data/4/DSC03303.JPG_0.jpg,986,34,241,275,278,307,True,6
4,37,kaist_dataset/Mixed/Digital_Camera/(C.S)C-outdoor3/DSC03051.JPG,char_data/4/DSC03051.JPG_0.jpg,703,19,338,357,317,354,True,6
4,36,kaist_dataset/Mixed/Digital_Camera/(C.S)C-outdoor3/DSC03312.JPG,char_data/4/DSC03312.JPG_0.jpg,1152,32,120,152,285,321,True,6
4,26,kaist_dataset/Mixed/Digital_Camera/(C.S)C-outdoor3/DSC03255.JPG,char_data/4/DSC03255.JPG_0.jpg,546,21,190,211,186,212,True,6
4,46,kaist_dataset/Mixed/Digital_Camera/(C.S)C-outdoor3/DSC03323.JPG,char_data/4/DSC03323.JPG_0.jpg,1794,39,182,221,300,346,True,6
4,45,kaist_dataset/Mixed/Digital_Camera/(C.S)C-outdoor3/DSC03323.JPG,char_data/4/DSC03323.JPG_0.jpg,1215,27,345,372,288,333,True,6
4,35,kaist_dataset/Mixed/Digital_Camera/(C.S)C-outdoor3/DSC03187.JPG,char_data/4/DSC03187.JPG_0.jpg,910,26,261,287,390,425,True,6
4,39,kaist_dataset/Mixed/Digital_Camera/(C.S)C-outdoor3/DSC03187.JPG,char_data/4/DSC03187.JPG_0.jpg,936,24,370,394,391,430,True,6
4,36,kaist_dataset/Mixed/Digital_Camera/(C.S)C-outdoor3/DSC03187.JPG,char_data/4/DSC03187.JPG_0.jpg,720,20,423,443,392,428,True,6
4,40,kaist_dataset/Mixed/Digital_Camera/(C.S)C-outdoor3/DSC02970.JPG,char_data/4/DSC02970.JPG_0.jpg,1360,34,107,141,362,402,True,6
4,33,kaist_dataset/Mixed/Digital_Camera/(C.S)C-outdoor3/DSC03328.JPG,char_data/4/DSC03328.JPG_0.jpg,693,21,139,160,404,437,True,6
4,33,kaist_dataset/Mixed/Digital_Camera/(C.S)C-outdoor3/DSC03328.JPG,char_data/4/DSC03328.JPG_0.jpg,561,17,216,233,403,436,True,6
4,40,kaist_dataset/Mixed/Digital_Camera/(C.S)C-outdoor3/DSC03328.JPG,char_data/4/DSC03328.JPG_0.jpg,920,23,315,338,398,438,True,6
4,36,kaist_dataset/Mixed/Digital_Camera/(C.S)C-outdoor3/DSC03328.JPG,char_data/4/DSC03328.JPG_0.jpg,648,18,404,422,399,435,True,6
4,40,kaist_dataset/Mixed/Digital_Camera/(C.S)C-outdoor3/DSC03236.JPG,char_data/4/DSC03236.JPG_0.jpg,880,22,82,104,187,227,True,6
4,43,kaist_dataset/Mixed/Digital_Camera/(C.S)C-outdoor3/DSC03236.JPG,char_data/4/DSC03236.JPG_0.jpg,1032,24,219,243,420,463,True,6
4,29,kaist_dataset/Mixed/Digital_Camera/(C.S)C-outdoor3/DSC03315.JPG,char_data/4/DSC03315.JPG_0.jpg,725,25,336,361,124,153,True,6
4,33,kaist_dataset/Mixed/Digital_Camera/(C.S)C-outdoor3/DSC03301.JPG,char_data/4/DSC03301.JPG_0.jpg,792,24,349,373,143,176,True,6
4,34,kaist_dataset/Mixed/Digital_Camera/(C.S)C-outdoor3/DSC02956.JPG,char_data/4/DSC02956.JPG_0.jpg,850,25,89,114,390,424,True,6
4,41,kaist_dataset/Mixed/Digital_Camera/(C.S)C-outdoor3/DSC03185.JPG,char_data/4/DSC03185.JPG_0.jpg,2091,51,192,243,148,189,True,6
4,70,kaist_dataset/Mixed/Digital_Camera/(C.S)C-outdoor3/DSC03332.JPG,char_data/4/DSC03332.JPG_0.jpg,3710,53,25,78,339,409,True,6
4,56,kaist_dataset/Mixed/Digital_Camera/(C.S)C-outdoor3/DSC03067.JPG,char_data/4/DSC03067.JPG_0.jpg,1960,35,344,379,193,249,True,6
4,34,kaist_dataset/Mixed/Digital_Camera/(C.S)C-outdoor3/DSC03311.JPG,char_data/4/DSC03311.JPG_0.jpg,544,16,305,321,371,405,True,6
4,25,kaist_dataset/Mixed/Digital_Camera/(C.S)C-outdoor3/DSC03311.JPG,char_data/4/DSC03311.JPG_0.jpg,400,16,343,359,373,398,True,6
4,33,kaist_dataset/Mixed/Digital_Camera/(C.S)C-outdoor3/DSC02969.JPG,char_data/4/DSC02969.JPG_0.jpg,792,24,251,275,233,266,True,6
4,39,kaist_dataset/Mixed/Digital_Camera/(C.S)C-outdoor3/DSC02969.JPG,char_data/4/DSC02969.JPG_0.jpg,702,18,381,399,226,265,True,6
4,31,kaist_dataset/Mixed/Digital_Camera/(C.S)C-outdoor3/DSC02969.JPG,char_data/4/DSC02969.JPG_0.jpg,713,23,408,431,234,265,True,6
4,41,kaist_dataset/Mixed/Digital_Camera/(C.S)C-outdoor3/DSC03309.JPG,char_data/4/DSC03309.JPG_0.jpg,943,23,220,243,259,300,True,6
4,28,kaist_dataset/Mixed/Digital_Camera/(C.S)C-outdoor3/DSC03017.JPG,char_data/4/DSC03017.JPG_0.jpg,616,22,367,389,245,273,True,6
4,29,kaist_dataset/Mixed/Digital_Camera/(C.S)C-outdoor3/DSC03250.JPG,char_data/4/DSC03250.JPG_0.jpg,580,20,443,463,405,434,True,6
4,35,kaist_dataset/Mixed/Digital_Camera/(C.S)C-outdoor3/DSC03259.JPG,char_data/4/DSC03259.JPG_0.jpg,630,18,345,363,358,393,True,6
4,43,kaist_dataset/Mixed/Digital_Camera/(C.S)C-outdoor3/DSC03259.JPG,char_data/4/DSC03259.JPG_0.jpg,774,18,412,430,354,397,True,6
4,45,kaist_dataset/Mixed/Digital_Camera/(C.S)C-outdoor3/DSC02989.JPG,char_data/4/DSC02989.JPG_0.jpg,900,20,490,510,347,392,True,6
4,53,kaist_dataset/Mixed/Digital_Camera/(C.S)C-outdoor3/DSC02989.JPG,char_data/4/DSC02989.JPG_0.jpg,901,17,620,637,347,400,True,6
4,33,kaist_dataset/Mixed/Digital_Camera/(C.S)C-outdoor3/DSC03308.JPG,char_data/4/DSC03308.JPG_0.jpg,957,29,199,228,249,282,True,6
4,29,kaist_dataset/Mixed/Digital_Camera/(C.S)C-outdoor3/DSC03308.JPG,char_data/4/DSC03308.JPG_0.jpg,638,22,343,365,250,279,True,6
4,33,kaist_dataset/Mixed/Digital_Camera/(C.S)C-outdoor3/DSC03308.JPG,char_data/4/DSC03308.JPG_0.jpg,990,30,363,393,250,283,True,6
4,30,kaist_dataset/Mixed/Digital_Camera/(C.S)C-outdoor6/P1010082.JPG,char_data/4/P1010082.JPG_0.jpg,690,23,176,199,228,258,True,6
4,39,kaist_dataset/Mixed/Digital_Camera/(C.S)C-outdoor6/P1010075.JPG,char_data/4/P1010075.JPG_0.jpg,585,15,435,450,308,347,True,6
4,28,kaist_dataset/Mixed/Digital_Camera/(C.S)C-outdoor6/P1010075.JPG,char_data/4/P1010075.JPG_0.jpg,448,16,533,549,312,340,True,6
4,28,kaist_dataset/Mixed/Digital_Camera/(C.S)C-outdoor6/DSC03324.JPG,char_data/4/DSC03324.JPG_0.jpg,448,16,391,407,154,182,True,6
4,22,kaist_dataset/Mixed/Digital_Camera/(C.S)C-outdoor6/P1010099.JPG,char_data/4/P1010099.JPG_0.jpg,374,17,455,472,208,230,True,6
4,21,kaist_dataset/Mixed/Digital_Camera/(C.S)C-outdoor6/P1010099.JPG,char_data/4/P1010099.JPG_0.jpg,315,15,489,504,210,231,True,6
4,30,kaist_dataset/Mixed/Digital_Camera/(C.S)C-outdoor6/P1010073.JPG,char_data/4/P1010073.JPG_0.jpg,420,14,361,375,242,272,True,6
4,34,kaist_dataset/Mixed/Digital_Camera/(C.S)C-outdoor6/P1010073.JPG,char_data/4/P1010073.JPG_0.jpg,578,17,424,441,240,274,True,6
4,32,kaist_dataset/Mixed/Digital_Camera/(C.S)C-outdoor6/P1010073.JPG,char_data/4/P1010073.JPG_0.jpg,608,19,326,345,239,271,True,6
4,29,kaist_dataset/Mixed/Digital_Camera/(C.S)C-outdoor6/P1010069.JPG,char_data/4/P1010069.JPG_0.jpg,725,25,393,418,306,335,True,6
4,21,kaist_dataset/Mixed/Digital_Camera/(C.S)C-outdoor6/P1010094.JPG,char_data/4/P1010094.JPG_0.jpg,483,23,459,482,219,240,True,6
4,26,kaist_dataset/Mixed/Digital_Camera/(C.S)C-outdoor6/P1010088.JPG,char_data/4/P1010088.JPG_0.jpg,416,16,307,323,222,248,True,6
4,31,kaist_dataset/Mixed/Digital_Camera/(C.S)C-outdoor6/P1010088.JPG,char_data/4/P1010088.JPG_0.jpg,465,15,336,351,217,248,True,6
4,42,kaist_dataset/Mixed/Digital_Camera/(C.S)C-outdoor6/P1010120.JPG,char_data/4/P1010120.JPG_0.jpg,1176,28,303,331,193,235,True,6
4,41,kaist_dataset/Mixed/Digital_Camera/(C.S)C-outdoor6/P1010120.JPG,char_data/4/P1010120.JPG_0.jpg,1025,25,448,473,192,233,True,6
4,30,kaist_dataset/Mixed/Digital_Camera/(C.S)C-outdoor6/P1010020.JPG,char_data/4/P1010020.JPG_0.jpg,480,16,138,154,336,366,True,6
4,33,kaist_dataset/Mixed/Digital_Camera/(C.S)C-outdoor6/P1010020.JPG,char_data/4/P1010020.JPG_0.jpg,594,18,227,245,337,370,True,6
4,32,kaist_dataset/Mixed/Digital_Camera/(C.S)C-outdoor6/P1010020.JPG,char_data/4/P1010020.JPG_0.jpg,832,26,95,121,230,262,True,6
4,31,kaist_dataset/Mixed/Digital_Camera/(C.S)C-outdoor6/P1010111.JPG,char_data/4/P1010111.JPG_0.jpg,1054,34,224,258,208,239,True,6
4,34,kaist_dataset/Mixed/Digital_Camera/(C.S)C-outdoor6/P1010080.JPG,char_data/4/P1010080.JPG_0.jpg,1020,30,355,385,247,281,True,6
4,27,kaist_dataset/Mixed/Digital_Camera/(C.S)C-outdoor6/P1010138.JPG,char_data/4/P1010138.JPG_0.jpg,621,23,332,355,184,211,True,6
4,43,kaist_dataset/Mixed/Digital_Camera/(C.S)C-outdoor6/P1010098.JPG,char_data/4/P1010098.JPG_0.jpg,860,20,385,405,55,98,True,6
4,63,kaist_dataset/Mixed/Digital_Camera/(C.S)C-outdoor6/P1010017.JPG,char_data/4/P1010017.JPG_0.jpg,1827,29,253,282,179,242,True,6
4,63,kaist_dataset/Mixed/Digital_Camera/(C.S)C-outdoor6/P1010017.JPG,char_data/4/P1010017.JPG_0.jpg,1827,29,308,337,177,240,True,6
4,26,kaist_dataset/Mixed/Digital_Camera/(C.S)C-outdoor6/P1010085.JPG,char_data/4/P1010085.JPG_0.jpg,624,24,307,331,158,184,True,6
4,32,kaist_dataset/Mixed/Digital_Camera/(C.S)C-outdoor6/P1010093.JPG,char_data/4/P1010093.JPG_0.jpg,448,14,497,511,242,274,True,6
4,63,kaist_dataset/Mixed/Digital_Camera/(C.S)C-outdoor6/080116-0057.jpg,char_data/4/080116-0057.jpg_0.jpg,2079,33,688,721,818,881,True,6
4,43,kaist_dataset/Mixed/Digital_Camera/(C.S)C-outdoor6/P1010084.JPG,char_data/4/P1010084.JPG_0.jpg,860,20,52,72,183,226,True,6
4,47,kaist_dataset/Mixed/Digital_Camera/(C.S)C-outdoor6/P1010084.JPG,char_data/4/P1010084.JPG_0.jpg,1551,33,305,338,190,237,True,6
4,43,kaist_dataset/Mixed/Digital_Camera/(C.S)C-outdoor6/P1010084.JPG,char_data/4/P1010084.JPG_0.jpg,1591,37,529,566,192,235,True,6
4,20,kaist_dataset/Mixed/Digital_Camera/(C.S)C-outdoor6/P1010129.JPG,char_data/4/P1010129.JPG_0.jpg,480,24,375,399,238,258,True,6
4,32,kaist_dataset/Mixed/Digital_Camera/(C.S)C-outdoor6/P1010103.JPG,char_data/4/P1010103.JPG_0.jpg,544,17,465,482,202,234,True,6
4,28,kaist_dataset/Mixed/Digital_Camera/(C.S)C-outdoor6/P1010114.JPG,char_data/4/P1010114.JPG_0.jpg,504,18,427,445,218,246,True,6
4,33,kaist_dataset/Mixed/Digital_Camera/(C.S)C-outdoor6/P1010114.JPG,char_data/4/P1010114.JPG_0.jpg,726,22,559,581,213,246,True,6
4,26,kaist_dataset/Mixed/Digital_Camera/(C.S)C-outdoor6/P1010065.JPG,char_data/4/P1010065.JPG_0.jpg,572,22,323,345,233,259,True,6
4,33,kaist_dataset/Mixed/Digital_Camera/(C.S)C-outdoor6/P1010056.JPG,char_data/4/P1010056.JPG_0.jpg,693,21,299,320,230,263,True,6
4,35,kaist_dataset/Mixed/Digital_Camera/(C.S)C-outdoor6/P1010018.JPG,char_data/4/P1010018.JPG_0.jpg,840,24,408,432,245,280,True,6
4,33,kaist_dataset/Mixed/Digital_Camera/(C.S)C-outdoor6/P1010018.JPG,char_data/4/P1010018.JPG_0.jpg,726,22,453,475,243,276,True,6
4,59,kaist_dataset/Mixed/Digital_Camera/(C.S)C-outdoor6/P1010067.JPG,char_data/4/P1010067.JPG_0.jpg,1711,29,351,380,308,367,True,6
4,33,kaist_dataset/Mixed/Digital_Camera/(C.S)C-outdoor6/P1010097.JPG,char_data/4/P1010097.JPG_0.jpg,957,29,34,63,172,205,True,6
4,20,kaist_dataset/Mixed/Digital_Camera/(C.S)C-outdoor6/P1010097.JPG,char_data/4/P1010097.JPG_0.jpg,460,23,409,432,191,211,True,6
4,58,kaist_dataset/Mixed/Digital_Camera/(C.S)C-outdoor6/P1010087.JPG,char_data/4/P1010087.JPG_0.jpg,2378,41,224,265,176,234,True,6
4,37,kaist_dataset/Mixed/Digital_Camera/(C.S)C-outdoor6/P1010074.JPG,char_data/4/P1010074.JPG_0.jpg,1184,32,165,197,308,345,True,6
4,50,kaist_dataset/Mixed/Digital_Camera/(C.S)C-outdoor4/DSC03651.JPG,char_data/4/DSC03651.JPG_0.jpg,1900,38,200,238,358,408,True,6
4,34,kaist_dataset/Mixed/Digital_Camera/(C.S)C-outdoor4/DSC03730.JPG,char_data/4/DSC03730.JPG_0.jpg,918,27,325,352,256,290,True,6
4,42,kaist_dataset/Mixed/Digital_Camera/(C.S)C-outdoor4/DSC03633.JPG,char_data/4/DSC03633.JPG_0.jpg,1260,30,120,150,269,311,True,6
4,47,kaist_dataset/Mixed/Digital_Camera/(C.S)C-outdoor4/DSC03633.JPG,char_data/4/DSC03633.JPG_0.jpg,1316,28,181,209,264,311,True,6
4,40,kaist_dataset/Mixed/Digital_Camera/(C.S)C-outdoor4/DSC03633.JPG,char_data/4/DSC03633.JPG_0.jpg,1040,26,232,258,269,309,True,6
4,34,kaist_dataset/Mixed/Digital_Camera/(C.S)C-outdoor4/DSC03716.JPG,char_data/4/DSC03716.JPG_0.jpg,782,23,528,551,253,287,True,6
4,35,kaist_dataset/Mixed/Digital_Camera/(C.S)C-outdoor4/DSC03716.JPG,char_data/4/DSC03716.JPG_0.jpg,665,19,562,581,251,286,True,6
4,28,kaist_dataset/Mixed/Digital_Camera/(C.S)C-outdoor4/DSC03719.JPG,char_data/4/DSC03719.JPG_0.jpg,476,17,464,481,185,213,True,6
4,28,kaist_dataset/Mixed/Digital_Camera/(C.S)C-outdoor4/DSC03719.JPG,char_data/4/DSC03719.JPG_0.jpg,420,15,500,515,186,214,True,6
4,45,kaist_dataset/Mixed/Digital_Camera/(C.S)C-outdoor4/DSC03738.JPG,char_data/4/DSC03738.JPG_0.jpg,1530,34,307,341,235,280,True,6
4,35,kaist_dataset/Mixed/Digital_Camera/(C.S)C-outdoor4/DSC03604.JPG,char_data/4/DSC03604.JPG_0.jpg,665,19,314,333,142,177,True,6
4,52,kaist_dataset/Mixed/Digital_Camera/(C.S)C-outdoor4/DSC03613.JPG,char_data/4/DSC03613.JPG_0.jpg,988,19,399,418,25,77,True,6
4,55,kaist_dataset/Mixed/Digital_Camera/(C.S)C-outdoor4/DSC03613.JPG,char_data/4/DSC03613.JPG_0.jpg,1540,28,445,473,21,76,True,6
4,55,kaist_dataset/Mixed/Digital_Camera/(C.S)C-outdoor4/DSC03613.JPG,char_data/4/DSC03613.JPG_0.jpg,1375,25,528,553,23,78,True,6
4,49,kaist_dataset/Mixed/Digital_Camera/(C.S)C-outdoor4/DSC03613.JPG,char_data/4/DSC03613.JPG_0.jpg,1225,25,596,621,31,80,True,6
4,32,kaist_dataset/Mixed/Digital_Camera/(C.S)C-outdoor4/DSC03656.JPG,char_data/4/DSC03656.JPG_0.jpg,864,27,388,415,417,449,True,6
4,36,kaist_dataset/Mixed/Digital_Camera/(C.S)C-outdoor4/DSC03656.JPG,char_data/4/DSC03656.JPG_0.jpg,1008,28,496,524,417,453,True,6
4,34,kaist_dataset/Mixed/Digital_Camera/(C.S)C-outdoor4/DSC03656.JPG,char_data/4/DSC03656.JPG_0.jpg,1122,33,582,615,414,448,True,6
4,27,kaist_dataset/Mixed/Digital_Camera/(C.S)C-outdoor4/DSC03570.JPG,char_data/4/DSC03570.JPG_0.jpg,567,21,248,269,426,453,True,6
4,27,kaist_dataset/Mixed/Digital_Camera/(C.S)C-outdoor4/DSC03570.JPG,char_data/4/DSC03570.JPG_0.jpg,432,16,289,305,424,451,True,6
4,31,kaist_dataset/Mixed/Digital_Camera/(C.S)C-outdoor4/DSC03733.JPG,char_data/4/DSC03733.JPG_0.jpg,589,19,486,505,179,210,True,6
4,65,kaist_dataset/Mixed/Digital_Camera/(C.S)C-outdoor4/DSC03702.JPG,char_data/4/DSC03702.JPG_0.jpg,3315,51,71,122,335,400,True,6
4,61,kaist_dataset/Mixed/Digital_Camera/(C.S)C-outdoor4/DSC03702.JPG,char_data/4/DSC03702.JPG_0.jpg,2867,47,403,450,338,399,True,6
4,29,kaist_dataset/Mixed/Digital_Camera/(C.S)C-outdoor4/DSC03674.JPG,char_data/4/DSC03674.JPG_0.jpg,435,15,506,521,420,449,True,6
4,31,kaist_dataset/Mixed/Digital_Camera/(C.S)C-outdoor4/DSC03616.JPG,char_data/4/DSC03616.JPG_0.jpg,620,20,549,569,153,184,True,6
4,33,kaist_dataset/Mixed/Digital_Camera/(C.S)C-outdoor4/DSC03642.JPG,char_data/4/DSC03642.JPG_0.jpg,693,21,425,446,397,430,True,6
4,47,kaist_dataset/Mixed/Digital_Camera/(C.S)C-outdoor4/DSC03693.JPG,char_data/4/DSC03693.JPG_0.jpg,1128,24,403,427,354,401,True,6
4,51,kaist_dataset/Mixed/Digital_Camera/(C.S)C-outdoor4/DSC03693.JPG,char_data/4/DSC03693.JPG_0.jpg,918,18,451,469,353,404,True,6
4,41,kaist_dataset/Mixed/Digital_Camera/(C.S)C-outdoor4/DSC03435.JPG,char_data/4/DSC03435.JPG_0.jpg,943,23,144,167,410,451,True,6
4,33,kaist_dataset/Mixed/Digital_Camera/(C.S)C-outdoor4/DSC03658.JPG,char_data/4/DSC03658.JPG_0.jpg,726,22,299,321,418,451,True,6
4,29,kaist_dataset/Mixed/Digital_Camera/(C.S)C-outdoor4/DSC03637.JPG,char_data/4/DSC03637.JPG_0.jpg,493,17,244,261,300,329,True,6
4,35,kaist_dataset/Mixed/Digital_Camera/(C.S)C-outdoor4/DSC03637.JPG,char_data/4/DSC03637.JPG_0.jpg,525,15,274,289,292,327,True,6
4,29,kaist_dataset/Mixed/Digital_Camera/(C.S)C-outdoor4/DSC03552.JPG,char_data/4/DSC03552.JPG_0.jpg,580,20,350,370,319,348,True,6
4,30,kaist_dataset/Mixed/Digital_Camera/(C.S)C-outdoor4/DSC03769.JPG,char_data/4/DSC03769.JPG_0.jpg,300,10,170,180,419,449,False,6
4,85,kaist_dataset/Mixed/Digital_Camera/(C.S)C-outdoor4/DSC03544.JPG,char_data/4/DSC03544.JPG_0.jpg,4505,53,200,253,168,253,False,6
4,30,kaist_dataset/Mixed/Digital_Camera/(C.S)C-outdoor4/DSC03660.JPG,char_data/4/DSC03660.JPG_0.jpg,990,33,277,310,99,129,False,6
4,36,kaist_dataset/Mixed/Digital_Camera/(C.S)C-outdoor4/DSC03640.JPG,char_data/4/DSC03640.JPG_0.jpg,792,22,148,170,399,435,False,6
4,23,kaist_dataset/Mixed/Digital_Camera/(C.S)C-outdoor4/DSC03640.JPG,char_data/4/DSC03640.JPG_0.jpg,437,19,442,461,401,424,False,6
4,30,kaist_dataset/Mixed/Digital_Camera/(C.S)C-outdoor4/DSC03640.JPG,char_data/4/DSC03640.JPG_0.jpg,420,14,485,499,399,429,False,6
4,30,kaist_dataset/Mixed/Digital_Camera/(C.S)C-outdoor4/DSC03640.JPG,char_data/4/DSC03640.JPG_0.jpg,630,21,500,521,398,428,False,6
4,43,kaist_dataset/Mixed/Digital_Camera/(C.S)C-outdoor4/DSC03548.JPG,char_data/4/DSC03548.JPG_0.jpg,1978,46,99,145,395,438,False,6
4,43,kaist_dataset/Mixed/Digital_Camera/(C.S)C-outdoor4/DSC03548.JPG,char_data/4/DSC03548.JPG_0.jpg,2064,48,327,375,396,439,False,6
4,40,kaist_dataset/Mixed/Digital_Camera/(C.S)C-outdoor4/DSC03675.JPG,char_data/4/DSC03675.JPG_0.jpg,1080,27,417,444,340,380,False,6
4,29,kaist_dataset/Mixed/Digital_Camera/(C.S)C-outdoor4/DSC03661.JPG,char_data/4/DSC03661.JPG_0.jpg,493,17,477,494,331,360,False,6
4,36,kaist_dataset/Mixed/Digital_Camera/(C.S)C-outdoor4/DSC03661.JPG,char_data/4/DSC03661.JPG_0.jpg,684,19,540,559,326,362,False,6
4,31,kaist_dataset/Mixed/Digital_Camera/(C.S)C-outdoor4/DSC03691.JPG,char_data/4/DSC03691.JPG_0.jpg,496,16,379,395,224,255,False,6
4,30,kaist_dataset/Mixed/Digital_Camera/(C.S)C-outdoor4/DSC03691.JPG,char_data/4/DSC03691.JPG_0.jpg,510,17,530,547,222,252,False,6
4,51,kaist_dataset/Mixed/Digital_Camera/(C.S)C-outdoor4/DSC03617.JPG,char_data/4/DSC03617.JPG_0.jpg,2091,41,202,243,377,428,False,6
4,25,kaist_dataset/Mixed/Digital_Camera/(C.S)C-outdoor4/DSC03657.JPG,char_data/4/DSC03657.JPG_0.jpg,500,20,272,292,422,447,False,6
4,30,kaist_dataset/Mixed/Digital_Camera/(C.S)C-outdoor4/DSC03657.JPG,char_data/4/DSC03657.JPG_0.jpg,510,17,369,386,422,452,False,6
4,31,kaist_dataset/Mixed/Digital_Camera/(C.S)C-outdoor4/DSC03657.JPG,char_data/4/DSC03657.JPG_0.jpg,713,23,385,408,419,450,False,6
4,30,kaist_dataset/Mixed/Digital_Camera/(C.S)C-outdoor4/DSC03618.JPG,char_data/4/DSC03618.JPG_0.jpg,780,26,236,262,410,440,False,6
4,78,kaist_dataset/Mixed/Digital_Camera/(C.S)C-outdoor4/DSC03654.JPG,char_data/4/DSC03654.JPG_0.jpg,2808,36,345,381,156,234,False,6
4,93,kaist_dataset/Mixed/Digital_Camera/(C.S)C-outdoor4/DSC03654.JPG,char_data/4/DSC03654.JPG_0.jpg,3069,33,467,500,150,243,False,6
4,87,kaist_dataset/Mixed/Digital_Camera/(C.S)C-outdoor4/DSC03654.JPG,char_data/4/DSC03654.JPG_0.jpg,3741,43,563,606,153,240,False,6
4,29,kaist_dataset/Mixed/Digital_Camera/(C.S)C-outdoor4/DSC03764.JPG,char_data/4/DSC03764.JPG_0.jpg,609,21,216,237,273,302,False,6
4,30,kaist_dataset/Mixed/Digital_Camera/(C.S)C-outdoor4/DSC03764.JPG,char_data/4/DSC03764.JPG_0.jpg,540,18,318,336,272,302,False,6
4,29,kaist_dataset/Mixed/Digital_Camera/(C.S)C-outdoor4/DSC03764.JPG,char_data/4/DSC03764.JPG_0.jpg,551,19,344,363,271,300,False,6
4,27,kaist_dataset/Mixed/Digital_Camera/(C.S)C-outdoor4/DSC03718.JPG,char_data/4/DSC03718.JPG_0.jpg,486,18,457,475,406,433,False,6
4,31,kaist_dataset/Mixed/Digital_Camera/(C.S)C-outdoor4/DSC03718.JPG,char_data/4/DSC03718.JPG_0.jpg,403,13,496,509,401,432,False,6
4,29,kaist_dataset/Mixed/Digital_Camera/(C.S)C-outdoor4/DSC03745.JPG,char_data/4/DSC03745.JPG_0.jpg,638,22,115,137,273,302,False,6
4,35,kaist_dataset/Mixed/Digital_Camera/(C.S)C-outdoor4/DSC03745.JPG,char_data/4/DSC03745.JPG_0.jpg,735,21,473,494,270,305,False,6
4,47,kaist_dataset/Mixed/Digital_Camera/(C.S)C-outdoor4/DSC03631.JPG,char_data/4/DSC03631.JPG_0.jpg,1269,27,205,232,356,403,False,6
4,46,kaist_dataset/Mixed/Digital_Camera/(C.S)C-outdoor4/DSC03631.JPG,char_data/4/DSC03631.JPG_0.jpg,1104,24,323,347,355,401,False,6
4,37,kaist_dataset/Mixed/Digital_Camera/(C.S)C-outdoor4/DSC03781.JPG,char_data/4/DSC03781.JPG_0.jpg,1665,45,186,231,379,416,False,6
4,37,kaist_dataset/Mixed/Digital_Camera/(C.S)C-outdoor4/DSC03781.JPG,char_data/4/DSC03781.JPG_0.jpg,1184,32,386,418,379,416,False,6
4,43,kaist_dataset/Mixed/Digital_Camera/(C.S)C-outdoor4/DSC03781.JPG,char_data/4/DSC03781.JPG_0.jpg,1806,42,419,461,379,422,False,6
4,29,kaist_dataset/Mixed/Digital_Camera/(C.S)C-outdoor4/DSC03737.JPG,char_data/4/DSC03737.JPG_0.jpg,522,18,152,170,161,190,False,6
4,27,kaist_dataset/Mixed/Digital_Camera/(C.S)C-outdoor4/DSC03737.JPG,char_data/4/DSC03737.JPG_0.jpg,459,17,290,307,165,192,False,6
4,27,kaist_dataset/Mixed/Digital_Camera/(C.S)C-outdoor4/DSC03737.JPG,char_data/4/DSC03737.JPG_0.jpg,594,22,320,342,168,195,False,6
4,60,kaist_dataset/Mixed/Digital_Camera/(C.S)C-outdoor4/DSC03655.JPG,char_data/4/DSC03655.JPG_0.jpg,1440,24,221,245,382,442,False,6
4,55,kaist_dataset/Mixed/Digital_Camera/(C.S)C-outdoor4/DSC03655.JPG,char_data/4/DSC03655.JPG_0.jpg,1320,24,363,387,387,442,False,6
4,48,kaist_dataset/Mixed/Digital_Camera/(C.S)C-outdoor4/DSC03569.JPG,char_data/4/DSC03569.JPG_0.jpg,1488,31,367,398,165,213,False,6
4,45,kaist_dataset/Mixed/Digital_Camera/(C.S)C-outdoor4/DSC03549.JPG,char_data/4/DSC03549.JPG_0.jpg,990,22,540,562,177,222,False,6
4,29,kaist_dataset/Mixed/Digital_Camera/(C.S)C-outdoor4/DSC03549.JPG,char_data/4/DSC03549.JPG_0.jpg,435,15,290,305,426,455,False,6
4,32,kaist_dataset/Mixed/Digital_Camera/(C.S)C-outdoor4/DSC03446.JPG,char_data/4/DSC03446.JPG_0.jpg,960,30,66,96,288,320,False,6
4,31,kaist_dataset/Mixed/Digital_Camera/(C.S)C-outdoor4/DSC03446.JPG,char_data/4/DSC03446.JPG_0.jpg,837,27,222,249,292,323,False,6
4,26,kaist_dataset/Mixed/Digital_Camera/(C.S)C-outdoor4/DSC03734.JPG,char_data/4/DSC03734.JPG_0.jpg,364,14,500,514,350,376,False,6
4,37,kaist_dataset/Mixed/Digital_Camera/(C.S)C-outdoor4/DSC03732.JPG,char_data/4/DSC03732.JPG_0.jpg,1147,31,315,346,394,431,False,6
4,22,kaist_dataset/Mixed/Digital_Camera/(C.S)C-outdoor4/DSC03643.JPG,char_data/4/DSC03643.JPG_0.jpg,418,19,470,489,329,351,False,6
4,35,kaist_dataset/Mixed/Digital_Camera/(C.S)C-outdoor4/DSC03673.JPG,char_data/4/DSC03673.JPG_0.jpg,770,22,176,198,308,343,False,6
4,28,kaist_dataset/Mixed/Digital_Camera/(C.S)C-outdoor4/DSC03723.JPG,char_data/4/DSC03723.JPG_0.jpg,700,25,392,417,198,226,False,6
4,24,kaist_dataset/Mixed/Digital_Camera/(C.S)C-outdoor4/DSC03723.JPG,char_data/4/DSC03723.JPG_0.jpg,504,21,477,498,200,224,False,6
4,88,kaist_dataset/Mixed/Digital_Camera/(C.S)C-outdoor4/DSC03787.JPG,char_data/4/DSC03787.JPG_0.jpg,3168,36,360,396,140,228,False,6
4,84,kaist_dataset/Mixed/Digital_Camera/(C.S)C-outdoor4/DSC03787.JPG,char_data/4/DSC03787.JPG_0.jpg,2856,34,473,507,138,222,False,6
4,91,kaist_dataset/Mixed/Digital_Camera/(C.S)C-outdoor4/DSC03787.JPG,char_data/4/DSC03787.JPG_0.jpg,2912,32,567,599,139,230,False,6
4,46,kaist_dataset/Mixed/Digital_Camera/(C.S)C-outdoor4/DSC03571.JPG,char_data/4/DSC03571.JPG_0.jpg,1380,30,290,320,305,351,False,6
4,29,kaist_dataset/Mixed/Digital_Camera/(C.S)C-outdoor4/DSC03676.JPG,char_data/4/DSC03676.JPG_0.jpg,580,20,76,96,271,300,False,6
4,25,kaist_dataset/Mixed/Digital_Camera/(C.S)C-outdoor4/DSC03689.JPG,char_data/4/DSC03689.JPG_0.jpg,350,14,526,540,132,157,False,6
4,28,kaist_dataset/Mixed/Digital_Camera/(C.S)C-outdoor4/DSC03689.JPG,char_data/4/DSC03689.JPG_0.jpg,336,12,592,604,133,161,False,6
4,37,kaist_dataset/Mixed/Digital_Camera/(C.S)C-outdoor4/DSC03665.JPG,char_data/4/DSC03665.JPG_0.jpg,1369,37,247,284,156,193,False,6
4,47,kaist_dataset/Mixed/Digital_Camera/(C.S)C-outdoor4/DSC03679.JPG,char_data/4/DSC03679.JPG_0.jpg,1504,32,206,238,276,323,False,6
4,37,kaist_dataset/Mixed/Digital_Camera/(C.S)C-outdoor4/DSC03679.JPG,char_data/4/DSC03679.JPG_0.jpg,740,20,317,337,281,318,False,6
4,44,kaist_dataset/Mixed/Digital_Camera/(C.S)C-outdoor4/DSC03741.JPG,char_data/4/DSC03741.JPG_0.jpg,1584,36,333,369,357,401,False,6
4,44,kaist_dataset/Mixed/Digital_Camera/(C.S)C-outdoor4/DSC03662.JPG,char_data/4/DSC03662.JPG_0.jpg,1232,28,431,459,420,464,False,6
4,30,kaist_dataset/Mixed/Digital_Camera/(C.S)C-outdoor4/DSC03757.JPG,char_data/4/DSC03757.JPG_0.jpg,360,12,317,329,338,368,False,6
4,30,kaist_dataset/Mixed/Digital_Camera/(C.S)C-outdoor4/DSC03757.JPG,char_data/4/DSC03757.JPG_0.jpg,330,11,490,501,340,370,False,6
4,33,kaist_dataset/Mixed/Digital_Camera/(C.S)C-outdoor4/DSC03667.JPG,char_data/4/DSC03667.JPG_0.jpg,594,18,422,440,376,409,False,6
4,33,kaist_dataset/Mixed/Digital_Camera/(C.S)C-outdoor4/DSC03667.JPG,char_data/4/DSC03667.JPG_0.jpg,660,20,485,505,376,409,False,6
4,47,kaist_dataset/Mixed/Digital_Camera/(C.S)C-outdoor4/DSC03621.JPG,char_data/4/DSC03621.JPG_0.jpg,1269,27,355,382,331,378,False,6
4,48,kaist_dataset/Mixed/Digital_Camera/(C.S)C-outdoor4/DSC03621.JPG,char_data/4/DSC03621.JPG_0.jpg,1104,23,515,538,332,380,False,6
4,30,kaist_dataset/Mixed/Digital_Camera/(C.S)C-outdoor4/DSC03687.JPG,char_data/4/DSC03687.JPG_0.jpg,510,17,415,432,399,429,False,6
4,34,kaist_dataset/Mixed/Digital_Camera/(C.S)C-outdoor4/DSC03735.JPG,char_data/4/DSC03735.JPG_0.jpg,646,19,454,473,147,181,False,6
4,40,kaist_dataset/Mixed/Digital_Camera/(C.S)C-outdoor4/DSC03735.JPG,char_data/4/DSC03735.JPG_0.jpg,760,19,571,590,152,192,False,6
4,41,kaist_dataset/Mixed/Digital_Camera/(C.S)C-outdoor4/DSC03724.JPG,char_data/4/DSC03724.JPG_0.jpg,1271,31,348,379,278,319,False,6
4,22,kaist_dataset/Mixed/Digital_Camera/(C.S)C-outdoor4/DSC03670.JPG,char_data/4/DSC03670.JPG_0.jpg,308,14,428,442,450,472,False,6
4,28,kaist_dataset/Mixed/Digital_Camera/(C.S)C-outdoor4/DSC03722.JPG,char_data/4/DSC03722.JPG_0.jpg,812,29,219,248,206,234,False,6
4,35,kaist_dataset/Mixed/Digital_Camera/(C.S)C-outdoor4/DSC03722.JPG,char_data/4/DSC03722.JPG_0.jpg,1015,29,375,404,202,237,False,6
4,26,kaist_dataset/Mixed/Digital_Camera/(C.S)C-outdoor4/DSC03758.JPG,char_data/4/DSC03758.JPG_0.jpg,442,17,255,272,305,331,False,6
4,27,kaist_dataset/Mixed/Digital_Camera/(C.S)C-outdoor4/DSC03758.JPG,char_data/4/DSC03758.JPG_0.jpg,513,19,344,363,309,336,False,6
4,26,kaist_dataset/Mixed/Digital_Camera/(C.S)C-outdoor4/DSC03758.JPG,char_data/4/DSC03758.JPG_0.jpg,390,15,370,385,313,339,False,6
4,39,kaist_dataset/Mixed/Digital_Camera/(C.S)C-outdoor2/DSC02912.JPG,char_data/4/DSC02912.JPG_0.jpg,1833,47,154,201,438,477,False,6
4,41,kaist_dataset/Mixed/Digital_Camera/(C.S)C-outdoor2/DSC02912.JPG,char_data/4/DSC02912.JPG_0.jpg,1271,31,377,408,437,478,False,6
4,25,kaist_dataset/Mixed/Digital_Camera/(C.S)C-outdoor2/DSC02917.JPG,char_data/4/DSC02917.JPG_0.jpg,450,18,559,577,230,255,False,6
4,39,kaist_dataset/Mixed/Digital_Camera/(C.S)C-outdoor2/DSC02954.JPG,char_data/4/DSC02954.JPG_0.jpg,1092,28,65,93,88,127,False,6
4,39,kaist_dataset/Mixed/Digital_Camera/(C.S)C-outdoor2/DSC02954.JPG,char_data/4/DSC02954.JPG_0.jpg,1170,30,88,118,252,291,False,6
4,37,kaist_dataset/Mixed/Digital_Camera/(C.S)C-outdoor2/DSC02954.JPG,char_data/4/DSC02954.JPG_0.jpg,666,18,509,527,269,306,False,6
4,28,kaist_dataset/Mixed/Digital_Camera/(C.S)C-outdoor2/DSC02555.JPG,char_data/4/DSC02555.JPG_0.jpg,672,24,392,416,251,279,False,6
4,34,kaist_dataset/Mixed/Digital_Camera/(C.S)C-outdoor2/DSC02477.JPG,char_data/4/DSC02477.JPG_0.jpg,816,24,348,372,244,278,False,6
4,39,kaist_dataset/Mixed/Digital_Camera/(C.S)C-outdoor2/DSC02411.JPG,char_data/4/DSC02411.JPG_0.jpg,1131,29,426,455,349,388,False,6
4,38,kaist_dataset/Mixed/Digital_Camera/(C.S)C-outdoor2/DSC02411.JPG,char_data/4/DSC02411.JPG_0.jpg,1216,32,556,588,348,386,False,6
4,40,kaist_dataset/Mixed/Digital_Camera/(C.S)C-outdoor2/DSC02374.JPG,char_data/4/DSC02374.JPG_0.jpg,880,22,337,359,296,336,False,6
4,34,kaist_dataset/Mixed/Digital_Camera/(C.S)C-outdoor2/DSC02887.JPG,char_data/4/DSC02887.JPG_0.jpg,782,23,239,262,122,156,False,6
4,37,kaist_dataset/Mixed/Digital_Camera/(C.S)C-outdoor2/DSC02368.JPG,char_data/4/DSC02368.JPG_0.jpg,592,16,457,473,380,417,False,6
4,27,kaist_dataset/Mixed/Digital_Camera/(C.S)C-outdoor2/DSC02947.JPG,char_data/4/DSC02947.JPG_0.jpg,648,24,396,420,231,258,False,6
4,34,kaist_dataset/Mixed/Digital_Camera/(C.S)C-outdoor2/DSC02545.JPG,char_data/4/DSC02545.JPG_0.jpg,1224,36,97,133,406,440,False,6
4,56,kaist_dataset/Mixed/Digital_Camera/(C.S)C-outdoor2/P1010013.JPG,char_data/4/P1010013.JPG_0.jpg,1960,35,216,251,363,419,False,6
4,56,kaist_dataset/Mixed/Digital_Camera/(C.S)C-outdoor2/P1010013.JPG,char_data/4/P1010013.JPG_0.jpg,1848,33,371,404,363,419,False,6
4,28,kaist_dataset/Mixed/Digital_Camera/(C.S)C-outdoor2/DSC02894.JPG,char_data/4/DSC02894.JPG_0.jpg,784,28,255,283,265,293,False,6
4,36,kaist_dataset/Mixed/Digital_Camera/(C.S)C-outdoor2/DSC02895.JPG,char_data/4/DSC02895.JPG_0.jpg,828,23,196,219,361,397,False,6
4,38,kaist_dataset/Mixed/Digital_Camera/(C.S)C-outdoor2/DSC02490.JPG,char_data/4/DSC02490.JPG_0.jpg,836,22,320,342,342,380,False,6
4,41,kaist_dataset/Mixed/Digital_Camera/(C.S)C-outdoor2/DSC02490.JPG,char_data/4/DSC02490.JPG_0.jpg,943,23,401,424,341,382,False,6
4,50,kaist_dataset/Mixed/Digital_Camera/(C.S)C-outdoor2/DSC02490.JPG,char_data/4/DSC02490.JPG_0.jpg,1400,28,389,417,400,450,False,6
4,40,kaist_dataset/Mixed/Digital_Camera/(C.S)C-outdoor2/DSC02937.JPG,char_data/4/DSC02937.JPG_0.jpg,960,24,103,127,202,242,False,6
4,34,kaist_dataset/Mixed/Digital_Camera/(C.S)C-outdoor2/DSC02930.JPG,char_data/4/DSC02930.JPG_0.jpg,850,25,275,300,194,228,False,6
4,33,kaist_dataset/Mixed/Digital_Camera/(C.S)C-outdoor2/DSC02422.JPG,char_data/4/DSC02422.JPG_0.jpg,825,25,435,460,221,254,False,6
4,26,kaist_dataset/Mixed/Digital_Camera/(C.S)C-outdoor2/DSC02422.JPG,char_data/4/DSC02422.JPG_0.jpg,624,24,481,505,225,251,False,6
4,36,kaist_dataset/Mixed/Digital_Camera/(C.S)C-outdoor2/DSC02933.JPG,char_data/4/DSC02933.JPG_0.jpg,684,19,476,495,241,277,False,6
4,25,kaist_dataset/Mixed/Digital_Camera/(C.S)C-outdoor2/DSC02936.JPG,char_data/4/DSC02936.JPG_0.jpg,450,18,487,505,230,255,False,6
4,46,kaist_dataset/Mixed/Digital_Camera/(C.S)C-outdoor2/DSC02511.JPG,char_data/4/DSC02511.JPG_0.jpg,1242,27,577,604,403,449,False,6
4,25,kaist_dataset/Mixed/Digital_Camera/(C.S)C-outdoor2/DSC02877.JPG,char_data/4/DSC02877.JPG_0.jpg,425,17,500,517,219,244,False,6
4,31,kaist_dataset/Mixed/Digital_Camera/(C.S)C-outdoor2/DSC02460.JPG,char_data/4/DSC02460.JPG_0.jpg,527,17,472,489,305,336,False,6
4,31,kaist_dataset/Mixed/Digital_Camera/(C.S)C-outdoor2/DSC02460.JPG,char_data/4/DSC02460.JPG_0.jpg,620,20,487,507,306,337,False,6
4,30,kaist_dataset/Mixed/Digital_Camera/(C.S)C-outdoor2/DSC02460.JPG,char_data/4/DSC02460.JPG_0.jpg,540,18,508,526,305,335,False,6
4,31,kaist_dataset/Mixed/Digital_Camera/(C.S)C-outdoor2/DSC02460.JPG,char_data/4/DSC02460.JPG_0.jpg,775,25,526,551,304,335,False,6
4,24,kaist_dataset/Mixed/Digital_Camera/(C.S)C-outdoor2/DSC02879.JPG,char_data/4/DSC02879.JPG_0.jpg,432,18,266,284,284,308,False,6
4,26,kaist_dataset/Mixed/Digital_Camera/(C.S)C-outdoor2/DSC02879.JPG,char_data/4/DSC02879.JPG_0.jpg,364,14,297,311,279,305,False,6
4,35,kaist_dataset/Mixed/Digital_Camera/(C.S)C-outdoor2/DSC02926.JPG,char_data/4/DSC02926.JPG_0.jpg,945,27,373,400,155,190,False,6
4,75,kaist_dataset/Mixed/Digital_Camera/(C.S)C-outdoor2/DSC02407.JPG,char_data/4/DSC02407.JPG_0.jpg,3450,46,110,156,77,152,False,6
4,44,kaist_dataset/Mixed/Digital_Camera/(C.S)C-outdoor2/DSC02938.JPG,char_data/4/DSC02938.JPG_0.jpg,1232,28,413,441,242,286,False,6
4,44,kaist_dataset/Mixed/Digital_Camera/(C.S)C-outdoor2/DSC02389.JPG,char_data/4/DSC02389.JPG_0.jpg,1760,40,276,316,38,82,False,6
4,46,kaist_dataset/Mixed/Digital_Camera/(C.S)C-outdoor2/DSC02389.JPG,char_data/4/DSC02389.JPG_0.jpg,1610,35,310,345,249,295,False,6
4,41,kaist_dataset/Mixed/Digital_Camera/(C.S)C-outdoor2/DSC02389.JPG,char_data/4/DSC02389.JPG_0.jpg,1394,34,344,378,248,289,False,6
4,37,kaist_dataset/Mixed/Digital_Camera/(C.S)C-outdoor2/DSC02391.JPG,char_data/4/DSC02391.JPG_0.jpg,777,21,134,155,334,371,False,6
4,22,kaist_dataset/Mixed/Digital_Camera/(C.S)C-outdoor2/P1010015.JPG,char_data/4/P1010015.JPG_0.jpg,308,14,427,441,190,212,False,6
4,17,kaist_dataset/Mixed/Digital_Camera/(C.S)C-outdoor2/P1010015.JPG,char_data/4/P1010015.JPG_0.jpg,187,11,345,356,189,206,False,6
4,33,kaist_dataset/Mixed/Digital_Camera/(C.S)A-shadow/DSC03257.JPG,char_data/4/DSC03257.JPG_0.jpg,858,26,249,275,384,417,False,6
4,34,kaist_dataset/Mixed/Digital_Camera/(C.S)A-shadow/DSC04306.JPG,char_data/4/DSC04306.JPG_0.jpg,714,21,280,301,410,444,False,6
4,53,kaist_dataset/Mixed/Digital_Camera/(C.S)A-shadow/DSC04304.JPG,char_data/4/DSC04304.JPG_0.jpg,1855,35,408,443,281,334,False,6
4,54,kaist_dataset/Mixed/Digital_Camera/(C.S)A-shadow/DSC04304.JPG,char_data/4/DSC04304.JPG_0.jpg,2052,38,504,542,281,335,False,6
4,40,kaist_dataset/Mixed/Digital_Camera/(C.S)A-shadow/P1010019.JPG,char_data/4/P1010019.JPG_0.jpg,1000,25,292,317,199,239,False,6
4,63,kaist_dataset/English/Mobile_Phone/(E.M)B-indoor/P090902018.jpg,char_data/4/P090902018.jpg_0.jpg,2772,44,112,156,173,236,False,6
4,41,kaist_dataset/English/Digital_Camera/(E.S)C-outdoor2/DSC03053.JPG,char_data/4/DSC03053.JPG_0.jpg,1230,30,457,487,129,170,False,6
4,62,kaist_dataset/English/Digital_Camera/(E.S)C-outdoor2/DSC03650.JPG,char_data/4/DSC03650.JPG_0.jpg,1922,31,148,179,285,347,False,6
4,33,kaist_dataset/English/Digital_Camera/(E.S)C-outdoor2/DSC03436.JPG,char_data/4/DSC03436.JPG_0.jpg,891,27,194,221,128,161,False,6
4,41,kaist_dataset/English/Digital_Camera/(E.S)C-outdoor2/DSC03436.JPG,char_data/4/DSC03436.JPG_0.jpg,984,24,247,271,121,162,False,6
4,36,kaist_dataset/English/Digital_Camera/(E.S)C-outdoor2/DSC03294.JPG,char_data/4/DSC03294.JPG_0.jpg,756,21,226,247,396,432,False,6
4,30,kaist_dataset/English/Digital_Camera/(E.S)C-outdoor2/DSC03294.JPG,char_data/4/DSC03294.JPG_0.jpg,720,24,310,334,399,429,False,6
4,34,kaist_dataset/English/Digital_Camera/(E.S)C-outdoor2/DSC03294.JPG,char_data/4/DSC03294.JPG_0.jpg,714,21,354,375,400,434,False,6
4,31,kaist_dataset/English/Digital_Camera/(E.S)C-outdoor2/DSC03294.JPG,char_data/4/DSC03294.JPG_0.jpg,682,22,376,398,400,431,False,6
4,71,kaist_dataset/English/Digital_Camera/(E.S)C-outdoor2/DSC04163.JPG,char_data/4/DSC04163.JPG_0.jpg,3621,51,143,194,313,384,False,6
4,63,kaist_dataset/English/Digital_Camera/(E.S)C-outdoor2/DSC04163.JPG,char_data/4/DSC04163.JPG_0.jpg,2583,41,380,421,316,379,False,6
4,31,kaist_dataset/English/Digital_Camera/(E.S)C-outdoor2/DSC03731.JPG,char_data/4/DSC03731.JPG_0.jpg,465,15,523,538,117,148,False,6
4,36,kaist_dataset/English/Digital_Camera/(E.S)C-outdoor2/DSC03162.JPG,char_data/4/DSC03162.JPG_0.jpg,720,20,404,424,147,183,False,6
4,27,kaist_dataset/English/Digital_Camera/(E.S)C-outdoor1/077.JPG,char_data/4/077.JPG_0.jpg,432,16,240,256,252,279,False,6
4,23,kaist_dataset/English/Digital_Camera/(E.S)C-outdoor1/042.JPG,char_data/4/042.JPG_0.jpg,345,15,555,570,324,347,False,6
4,27,kaist_dataset/English/Digital_Camera/(E.S)C-outdoor1/042.JPG,char_data/4/042.JPG_0.jpg,324,12,571,583,322,349,False,6
4,31,kaist_dataset/English/Digital_Camera/(E.S)C-outdoor1/042.JPG,char_data/4/042.JPG_0.jpg,589,19,583,602,318,349,False,6
4,50,kaist_dataset/English/Digital_Camera/(E.S)C-outdoor1/080116-0065.jpg,char_data/4/080116-0065.jpg_0.jpg,1150,23,256,279,367,417,False,6
4,42,kaist_dataset/English/Digital_Camera/(E.S)C-outdoor1/080116-0065.jpg,char_data/4/080116-0065.jpg_0.jpg,882,21,375,396,383,425,False,6
4,38,kaist_dataset/English/Digital_Camera/(E.S)C-outdoor1/DSC02364.JPG,char_data/4/DSC02364.JPG_0.jpg,646,17,256,273,347,385,False,6
4,41,kaist_dataset/English/Digital_Camera/(E.S)C-outdoor1/DSC02364.JPG,char_data/4/DSC02364.JPG_0.jpg,738,18,395,413,346,387,False,6
4,37,kaist_dataset/English/Digital_Camera/(E.S)C-outdoor1/DSC02364.JPG,char_data/4/DSC02364.JPG_0.jpg,555,15,565,580,351,388,False,6
4,36,kaist_dataset/English/Digital_Camera/(E.S)C-outdoor1/DSC02364.JPG,char_data/4/DSC02364.JPG_0.jpg,540,15,598,613,354,390,False,6
4,33,kaist_dataset/English/Digital_Camera/(E.S)F-others/DSC02923.JPG,char_data/4/DSC02923.JPG_0.jpg,726,22,272,294,402,435,False,6
4,33,kaist_dataset/English/Digital_Camera/(E.S)F-others/DSC02923.JPG,char_data/4/DSC02923.JPG_0.jpg,462,14,372,386,390,423,False,6
4,43,kaist_dataset/English/Digital_Camera/(E.S)C-outdoor3/P1010086.JPG,char_data/4/P1010086.JPG_0.jpg,1032,24,402,426,96,139,False,6
4,30,kaist_dataset/English/Digital_Camera/(E.S)C-outdoor3/크기변환_P1010076.JPG,char_data/4/크기변환_P1010076.JPG_0.jpg,360,12,531,543,179,209,False,6
4,21,kaist_dataset/English/Digital_Camera/(E.S)C-outdoor3/크기변환_P1010076.JPG,char_data/4/크기변환_P1010076.JPG_0.jpg,315,15,564,579,182,203,False,6
e,60,kaist_dataset/Korean/Digital_Camera/outdoor2/2007-12-08-day-101.jpg,char_data/e/2007-12-08-day-101.jpg_2.jpg,2820,47,622,669,385,445,True,34
e,60,kaist_dataset/Korean/Digital_Camera/outdoor2/080119-0031.jpg,char_data/e/080119-0031.jpg_0.jpg,2220,37,543,580,120,180,True,34
e,38,kaist_dataset/Korean/Digital_Camera/outdoor2/080118-0018.jpg,char_data/e/080118-0018.jpg_0.jpg,1330,35,684,719,689,727,True,34
e,35,kaist_dataset/Korean/Digital_Camera/outdoor2/080118-0018.jpg,char_data/e/080118-0018.jpg_0.jpg,1505,43,964,1007,694,729,True,34
e,35,kaist_dataset/Korean/Digital_Camera/outdoor2/080118-0018.jpg,char_data/e/080118-0018.jpg_0.jpg,1050,30,1059,1089,697,732,True,34
e,18,kaist_dataset/Korean/Digital_Camera/indoor1/080119-0029.jpg,char_data/e/080119-0029.jpg_0.jpg,270,15,321,336,588,606,True,34
e,19,kaist_dataset/Korean/Digital_Camera/indoor1/080119-0029.jpg,char_data/e/080119-0029.jpg_0.jpg,228,12,679,691,657,676,True,34
e,20,kaist_dataset/Korean/Digital_Camera/indoor1/080119-0029.jpg,char_data/e/080119-0029.jpg_0.jpg,240,12,753,765,659,679,True,34
e,21,kaist_dataset/Korean/Digital_Camera/indoor1/080119-0029.jpg,char_data/e/080119-0029.jpg_0.jpg,294,14,940,954,666,687,True,34
e,20,kaist_dataset/Korean/Digital_Camera/indoor1/145.JPG,char_data/e/145.JPG_0.jpg,200,10,292,302,307,327,True,34
e,45,kaist_dataset/Korean/Digital_Camera/G-others/2007-12-08-day-112.jpg,char_data/e/2007-12-08-day-112.jpg_0.jpg,720,16,663,679,590,635,True,34
e,24,kaist_dataset/Korean/Digital_Camera/B-light/DSC02987.JPG,char_data/e/DSC02987.JPG_0.jpg,216,9,369,378,279,303,True,34
e,26,kaist_dataset/Korean/Digital_Camera/A-shadow/2007-12-09-day-exterior-031.jpg,char_data/e/2007-12-09-day-exterior-031.jpg_0.jpg,390,15,369,384,622,648,True,34
e,23,kaist_dataset/Korean/Digital_Camera/A-shadow/2007-12-09-day-exterior-031.jpg,char_data/e/2007-12-09-day-exterior-031.jpg_0.jpg,253,11,455,466,620,643,True,34
e,31,kaist_dataset/Korean/Digital_Camera/outdoor1/2007-12-08-day-056.jpg,char_data/e/2007-12-08-day-056.jpg_0.jpg,930,30,874,904,408,439,True,34
e,29,kaist_dataset/Korean/Digital_Camera/outdoor1/2007-12-08-day-056.jpg,char_data/e/2007-12-08-day-056.jpg_0.jpg,841,29,903,932,407,436,True,34
e,29,kaist_dataset/Korean/Digital_Camera/outdoor1/2007-12-08-day-087.jpg,char_data/e/2007-12-08-day-087.jpg_0.jpg,464,16,28,44,516,545,True,34
e,18,kaist_dataset/Korean/Digital_Camera/outdoor1/001.JPG,char_data/e/001.JPG_0.jpg,216,12,473,485,240,258,True,34
e,34,kaist_dataset/Korean/Digital_Camera/outdoor1/023.JPG,char_data/e/023.JPG_0.jpg,850,25,535,560,37,71,True,34
e,35,kaist_dataset/Korean/Digital_Camera/outdoor1/023.JPG,char_data/e/023.JPG_0.jpg,1260,36,560,596,36,71,True,34
e,30,kaist_dataset/Mixed/Mobile_Phone/(C.M)A-outdoor/P090912078.jpg,char_data/e/P090912078.jpg_0.jpg,840,28,107,135,315,345,True,34
e,26,kaist_dataset/Mixed/Mobile_Phone/(C.M)A-outdoor/P090912062.jpg,char_data/e/P090912062.jpg_0.jpg,442,17,535,552,129,155,True,34
e,33,kaist_dataset/Mixed/Mobile_Phone/(C.M)B-indoor/P090831005.jpg,char_data/e/P090831005.jpg_0.jpg,561,17,198,215,239,272,True,34
e,29,kaist_dataset/Mixed/Mobile_Phone/(C.M)B-indoor/P090831005.jpg,char_data/e/P090831005.jpg_0.jpg,522,18,336,354,243,272,True,34
e,61,kaist_dataset/Mixed/Mobile_Phone/(C.M)B-indoor/P090831019.jpg,char_data/e/P090831019.jpg_0.jpg,3904,64,317,381,163,224,True,34
e,44,kaist_dataset/Mixed/Mobile_Phone/(C.M)B-indoor/P090831010.jpg,char_data/e/P090831010.jpg_0.jpg,1540,35,105,140,293,337,True,34
e,50,kaist_dataset/Mixed/Mobile_Phone/(C.M)B-indoor/P090831010.jpg,char_data/e/P090831010.jpg_0.jpg,1950,39,159,198,290,340,True,34
e,45,kaist_dataset/Mixed/Mobile_Phone/(C.M)B-indoor/P090831010.jpg,char_data/e/P090831010.jpg_0.jpg,1440,32,223,255,295,340,True,34
e,47,kaist_dataset/Mixed/Mobile_Phone/(C.M)B-indoor/P090831010.jpg,char_data/e/P090831010.jpg_0.jpg,1739,37,329,366,291,338,True,34
e,40,kaist_dataset/Mixed/Mobile_Phone/(C.M)B-indoor/P090831014.jpg,char_data/e/P090831014.jpg_0.jpg,1400,35,378,413,172,212,True,34
e,34,kaist_dataset/Mixed/Mobile_Phone/(C.M)B-indoor/P090831012.jpg,char_data/e/P090831012.jpg_0.jpg,1292,38,409,447,185,219,True,34
e,46,kaist_dataset/Mixed/Mobile_Phone/(C.M)B-indoor/P090831015.jpg,char_data/e/P090831015.jpg_0.jpg,2070,45,432,477,215,261,True,34
e,56,kaist_dataset/Mixed/Mobile_Phone/(C.M)B-indoor/P090831018.jpg,char_data/e/P090831018.jpg_0.jpg,2464,44,201,245,233,289,True,34
e,49,kaist_dataset/Mixed/Mobile_Phone/(C.M)B-indoor/P090831018.jpg,char_data/e/P090831018.jpg_0.jpg,2695,55,353,408,235,284,True,34
e,39,kaist_dataset/Mixed/Mobile_Phone/(C.M)B-indoor/P090831016.jpg,char_data/e/P090831016.jpg_0.jpg,1482,38,323,361,197,236,True,34
e,58,kaist_dataset/Mixed/Mobile_Phone/(C.M)B-indoor/P090831013.jpg,char_data/e/P090831013.jpg_0.jpg,2552,44,214,258,195,253,True,34
e,52,kaist_dataset/Mixed/Mobile_Phone/(C.M)B-indoor/P090831013.jpg,char_data/e/P090831013.jpg_0.jpg,2288,44,513,557,199,251,True,34
e,47,kaist_dataset/Mixed/Mobile_Phone/(C.M)B-indoor/P090831017.jpg,char_data/e/P090831017.jpg_0.jpg,2021,43,207,250,244,291,True,34
e,53,kaist_dataset/Mixed/Mobile_Phone/(C.M)B-indoor/P090831023.jpg,char_data/e/P090831023.jpg_0.jpg,2173,41,57,98,279,332,True,34
e,39,kaist_dataset/Mixed/Mobile_Phone/(C.M)C-bookCover/P090831113.jpg,char_data/e/P090831113.jpg_0.jpg,1443,37,287,324,253,292,True,34
e,30,kaist_dataset/Mixed/Mobile_Phone/(C.M)C-bookCover/P090902016.jpg,char_data/e/P090902016.jpg_0.jpg,660,22,463,485,278,308,True,34
e,32,kaist_dataset/Mixed/Mobile_Phone/(C.M)C-bookCover/P090904005.jpg,char_data/e/P090904005.jpg_0.jpg,704,22,476,498,128,160,True,34
e,46,kaist_dataset/Mixed/Mobile_Phone/(C.M)C-bookCover/P090831125.jpg,char_data/e/P090831125.jpg_0.jpg,1334,29,415,444,276,322,True,34
e,34,kaist_dataset/Mixed/Mobile_Phone/(C.M)C-bookCover/P090831080.jpg,char_data/e/P090831080.jpg_0.jpg,918,27,343,370,340,374,True,34
e,37,kaist_dataset/Mixed/Mobile_Phone/(C.M)C-bookCover/P090831080.jpg,char_data/e/P090831080.jpg_0.jpg,999,27,414,441,409,446,True,34
e,51,kaist_dataset/Mixed/Mobile_Phone/(C.M)C-bookCover/P090831121.jpg,char_data/e/P090831121.jpg_0.jpg,1887,37,361,398,327,378,True,34
e,31,kaist_dataset/Mixed/Mobile_Phone/(C.M)C-bookCover/P090831115.jpg,char_data/e/P090831115.jpg_0.jpg,496,16,267,283,177,208,True,34
e,31,kaist_dataset/Mixed/Mobile_Phone/(C.M)C-bookCover/P090831115.jpg,char_data/e/P090831115.jpg_0.jpg,589,19,393,412,173,204,True,34
e,39,kaist_dataset/Mixed/Mobile_Phone/(C.M)C-bookCover/P090831124.jpg,char_data/e/P090831124.jpg_0.jpg,780,20,334,354,405,444,True,34
e,59,kaist_dataset/Mixed/Mobile_Phone/(C.M)C-bookCover/P090902019.jpg,char_data/e/P090902019.jpg_0.jpg,2124,36,209,245,289,348,True,34
e,44,kaist_dataset/Mixed/Mobile_Phone/(C.M)C-bookCover/P090831122.jpg,char_data/e/P090831122.jpg_0.jpg,1540,35,425,460,269,313,True,34
e,51,kaist_dataset/Mixed/Mobile_Phone/(C.M)C-bookCover/P090903083.jpg,char_data/e/P090903083.jpg_0.jpg,1734,34,427,461,177,228,True,34
e,44,kaist_dataset/Mixed/Mobile_Phone/(C.M)C-bookCover/P090903083.jpg,char_data/e/P090903083.jpg_0.jpg,1804,41,204,245,176,220,True,34
e,39,kaist_dataset/Mixed/Mobile_Phone/(C.M)C-bookCover/P090831118.jpg,char_data/e/P090831118.jpg_0.jpg,897,23,451,474,218,257,True,34
e,63,kaist_dataset/Mixed/Mobile_Phone/(C.M)C-bookCover/P090831114.jpg,char_data/e/P090831114.jpg_0.jpg,2142,34,273,307,258,321,True,34
e,45,kaist_dataset/Mixed/Mobile_Phone/(C.M)C-bookCover/P090831114.jpg,char_data/e/P090831114.jpg_0.jpg,1665,37,414,451,276,321,True,34
e,45,kaist_dataset/Mixed/Mobile_Phone/(C.M)C-bookCover/P090903024.jpg,char_data/e/P090903024.jpg_0.jpg,1710,38,543,581,48,93,True,34
e,31,kaist_dataset/Mixed/Mobile_Phone/(C.M)C-bookCover/P090903024.jpg,char_data/e/P090903024.jpg_0.jpg,744,24,386,410,117,148,True,34
e,40,kaist_dataset/Mixed/Mobile_Phone/(C.M)C-bookCover/P090903024.jpg,char_data/e/P090903024.jpg_0.jpg,760,19,460,479,111,151,True,34
e,27,kaist_dataset/Mixed/Mobile_Phone/(C.M)C-bookCover/P090903024.jpg,char_data/e/P090903024.jpg_0.jpg,891,33,544,577,117,144,True,34
e,25,kaist_dataset/Mixed/Mobile_Phone/(C.M)C-bookCover/P090903024.jpg,char_data/e/P090903024.jpg_0.jpg,450,18,495,513,175,200,True,34
e,28,kaist_dataset/Mixed/Mobile_Phone/(C.M)C-bookCover/P090903024.jpg,char_data/e/P090903024.jpg_0.jpg,672,24,518,542,173,201,True,34
e,32,kaist_dataset/Mixed/Mobile_Phone/(C.M)C-bookCover/P090903024.jpg,char_data/e/P090903024.jpg_0.jpg,736,23,438,461,223,255,True,34
e,30,kaist_dataset/Mixed/Mobile_Phone/(C.M)C-bookCover/P090903024.jpg,char_data/e/P090903024.jpg_0.jpg,750,25,503,528,225,255,True,34
e,87,kaist_dataset/Mixed/Digital_Camera/(C.S)C-outdoor1/P1010008.JPG,char_data/e/P1010008.JPG_0.jpg,4176,48,221,269,113,200,True,34
e,43,kaist_dataset/Mixed/Digital_Camera/(C.S)C-outdoor1/133.JPG,char_data/e/133.JPG_0.jpg,817,19,607,626,338,381,True,34
e,55,kaist_dataset/Mixed/Digital_Camera/(C.S)C-outdoor1/080116-0084.jpg,char_data/e/080116-0084.jpg_0.jpg,2695,49,407,456,211,266,True,34
e,59,kaist_dataset/Mixed/Digital_Camera/(C.S)C-outdoor1/080116-0084.jpg,char_data/e/080116-0084.jpg_0.jpg,2891,49,492,541,212,271,True,34
e,66,kaist_dataset/Mixed/Digital_Camera/(C.S)C-outdoor1/DSC02344.JPG,char_data/e/DSC02344.JPG_0.jpg,3564,54,128,182,154,220,True,34
e,63,kaist_dataset/Mixed/Digital_Camera/(C.S)C-outdoor1/DSC02344.JPG,char_data/e/DSC02344.JPG_0.jpg,3717,59,552,611,167,230,True,34
e,26,kaist_dataset/Mixed/Digital_Camera/(C.S)C-outdoor1/115.JPG,char_data/e/115.JPG_0.jpg,520,20,341,361,279,305,True,34
e,26,kaist_dataset/Mixed/Digital_Camera/(C.S)C-outdoor1/115.JPG,char_data/e/115.JPG_0.jpg,494,19,420,439,277,303,True,34
e,30,kaist_dataset/Mixed/Digital_Camera/(C.S)C-outdoor1/086.JPG,char_data/e/086.JPG_0.jpg,390,13,202,215,335,365,True,34
e,26,kaist_dataset/Mixed/Digital_Camera/(C.S)C-outdoor1/086.JPG,char_data/e/086.JPG_0.jpg,468,18,284,302,337,363,True,34
e,57,kaist_dataset/Mixed/Digital_Camera/(C.S)C-outdoor1/2007-12-08-day-118.jpg,char_data/e/2007-12-08-day-118.jpg_0.jpg,3990,70,1406,1476,423,480,True,34
e,42,kaist_dataset/Mixed/Digital_Camera/(C.S)C-outdoor1/101.JPG,char_data/e/101.JPG_0.jpg,1638,39,326,365,251,293,True,34
e,25,kaist_dataset/Mixed/Digital_Camera/(C.S)C-outdoor1/47.JPG,char_data/e/47.JPG_0.jpg,600,24,389,413,187,212,True,34
e,52,kaist_dataset/Mixed/Digital_Camera/(C.S)C-outdoor1/2007-12-08-day-106.jpg,char_data/e/2007-12-08-day-106.jpg_0.jpg,2184,42,1209,1251,757,809,True,34
e,16,kaist_dataset/Mixed/Digital_Camera/(C.S)C-outdoor1/DSC02320.JPG,char_data/e/DSC02320.JPG_0.jpg,144,9,549,558,258,274,True,34
e,18,kaist_dataset/Mixed/Digital_Camera/(C.S)C-outdoor1/DSC02320.JPG,char_data/e/DSC02320.JPG_0.jpg,180,10,564,574,256,274,True,34
e,28,kaist_dataset/Mixed/Digital_Camera/(C.S)C-outdoor1/DSC02318.JPG,char_data/e/DSC02318.JPG_0.jpg,672,24,199,223,324,352,True,34
e,23,kaist_dataset/Mixed/Digital_Camera/(C.S)C-outdoor1/DSC02318.JPG,char_data/e/DSC02318.JPG_0.jpg,575,25,290,315,330,353,True,34
e,130,kaist_dataset/Mixed/Digital_Camera/(C.S)C-outdoor1/080118-0014.jpg,char_data/e/080118-0014.jpg_0.jpg,12090,93,767,860,755,885,True,34
e,212,kaist_dataset/Mixed/Digital_Camera/(C.S)C-outdoor1/080119-0008.jpg,char_data/e/080119-0008.jpg_0.jpg,44096,208,748,956,593,805,True,34
e,15,kaist_dataset/Mixed/Digital_Camera/(C.S)C-outdoor1/2.JPG,char_data/e/2.JPG_0.jpg,135,9,535,544,402,417,True,34
e,32,kaist_dataset/Mixed/Digital_Camera/(C.S)C-outdoor1/063.JPG,char_data/e/063.JPG_0.jpg,480,15,136,151,255,287,True,34
e,36,kaist_dataset/Mixed/Digital_Camera/(C.S)C-outdoor1/063.JPG,char_data/e/063.JPG_0.jpg,576,16,151,167,253,289,True,34
e,35,kaist_dataset/Mixed/Digital_Camera/(C.S)C-outdoor1/063.JPG,char_data/e/063.JPG_0.jpg,560,16,222,238,254,289,True,34
e,40,kaist_dataset/Mixed/Digital_Camera/(C.S)C-outdoor1/063.JPG,char_data/e/063.JPG_0.jpg,640,16,237,253,250,290,True,34
e,25,kaist_dataset/Mixed/Digital_Camera/(C.S)C-outdoor1/063.JPG,char_data/e/063.JPG_0.jpg,350,14,327,341,261,286,True,34
e,23,kaist_dataset/Mixed/Digital_Camera/(C.S)C-outdoor1/003.JPG,char_data/e/003.JPG_0.jpg,230,10,268,278,262,285,True,34
e,18,kaist_dataset/Mixed/Digital_Camera/(C.S)C-outdoor1/003.JPG,char_data/e/003.JPG_0.jpg,252,14,300,314,262,280,True,34
e,20,kaist_dataset/Mixed/Digital_Camera/(C.S)C-outdoor1/003.JPG,char_data/e/003.JPG_0.jpg,260,13,363,376,258,278,True,34
e,17,kaist_dataset/Mixed/Digital_Camera/(C.S)C-outdoor1/003.JPG,char_data/e/003.JPG_0.jpg,221,13,102,115,269,286,True,34
e,19,kaist_dataset/Mixed/Digital_Camera/(C.S)C-outdoor1/003.JPG,char_data/e/003.JPG_0.jpg,190,10,200,210,265,284,True,34
e,28,kaist_dataset/Mixed/Digital_Camera/(C.S)C-outdoor1/1.JPG,char_data/e/1.JPG_0.jpg,616,22,326,348,15,43,True,34
e,35,kaist_dataset/Mixed/Digital_Camera/(C.S)C-outdoor1/1.JPG,char_data/e/1.JPG_0.jpg,875,25,349,374,12,47,True,34
e,31,kaist_dataset/Mixed/Digital_Camera/(C.S)C-outdoor1/1.JPG,char_data/e/1.JPG_0.jpg,713,23,613,636,15,46,True,34
e,31,kaist_dataset/Mixed/Digital_Camera/(C.S)C-outdoor1/1.JPG,char_data/e/1.JPG_0.jpg,806,26,637,663,16,47,True,34
e,59,kaist_dataset/Mixed/Digital_Camera/(C.S)C-outdoor1/014.JPG,char_data/e/014.JPG_0.jpg,1475,25,31,56,197,256,True,34
e,58,kaist_dataset/Mixed/Digital_Camera/(C.S)C-outdoor1/014.JPG,char_data/e/014.JPG_0.jpg,1508,26,81,107,203,261,True,34
e,34,kaist_dataset/Mixed/Digital_Camera/(C.S)C-outdoor1/062.JPG,char_data/e/062.JPG_0.jpg,510,15,295,310,168,202,True,34
e,33,kaist_dataset/Mixed/Digital_Camera/(C.S)C-outdoor1/062.JPG,char_data/e/062.JPG_0.jpg,297,9,353,362,167,200,True,34
e,32,kaist_dataset/Mixed/Digital_Camera/(C.S)C-outdoor1/062.JPG,char_data/e/062.JPG_0.jpg,320,10,363,373,167,199,True,34
e,28,kaist_dataset/Mixed/Digital_Camera/(C.S)C-outdoor1/DSC02325.JPG,char_data/e/DSC02325.JPG_0.jpg,644,23,299,322,319,347,True,34
e,36,kaist_dataset/Mixed/Digital_Camera/(C.S)F-others/DSC02609.JPG,char_data/e/DSC02609.JPG_0.jpg,648,18,250,268,316,352,True,34
e,80,kaist_dataset/Mixed/Digital_Camera/(C.S)F-others/2007-12-08-day-044.jpg,char_data/e/2007-12-08-day-044.jpg_0.jpg,4240,53,434,487,456,536,True,34
e,35,kaist_dataset/Mixed/Digital_Camera/(C.S)F-others/2007-12-08-day-044.jpg,char_data/e/2007-12-08-day-044.jpg_0.jpg,595,17,887,904,817,852,True,34
e,32,kaist_dataset/Mixed/Digital_Camera/(C.S)F-others/2007-12-08-day-044.jpg,char_data/e/2007-12-08-day-044.jpg_0.jpg,544,17,904,921,815,847,True,34
e,28,kaist_dataset/Mixed/Digital_Camera/(C.S)F-others/2007-12-08-day-044.jpg,char_data/e/2007-12-08-day-044.jpg_0.jpg,364,13,980,993,825,853,True,34
e,30,kaist_dataset/Mixed/Digital_Camera/(C.S)F-others/2007-12-08-day-044.jpg,char_data/e/2007-12-08-day-044.jpg_0.jpg,480,16,993,1009,823,853,True,34
e,66,kaist_dataset/Mixed/Digital_Camera/(C.S)F-others/DSC03489.JPG,char_data/e/DSC03489.JPG_0.jpg,3630,55,533,588,375,441,True,34
e,24,kaist_dataset/Mixed/Digital_Camera/(C.S)F-others/2007-12-09-day-exterior-032.jpg,char_data/e/2007-12-09-day-exterior-032.jpg_0.jpg,504,21,668,689,355,379,True,34
e,27,kaist_dataset/Mixed/Digital_Camera/(C.S)F-others/2007-12-09-day-exterior-032.jpg,char_data/e/2007-12-09-day-exterior-032.jpg_0.jpg,513,19,692,711,354,381,True,34
e,37,kaist_dataset/Mixed/Digital_Camera/(C.S)F-others/2007-12-08-day-067.jpg,char_data/e/2007-12-08-day-067.jpg_0.jpg,1739,47,440,487,957,994,True,34
e,34,kaist_dataset/Mixed/Digital_Camera/(C.S)F-others/2007-12-08-day-067.jpg,char_data/e/2007-12-08-day-067.jpg_0.jpg,1802,53,430,483,1189,1223,True,34
e,36,kaist_dataset/Mixed/Digital_Camera/(C.S)F-others/2007-12-08-day-067.jpg,char_data/e/2007-12-08-day-067.jpg_0.jpg,1980,55,430,485,1080,1116,True,34
e,64,kaist_dataset/Mixed/Digital_Camera/(C.S)F-others/DSC02696.JPG,char_data/e/DSC02696.JPG_0.jpg,3392,53,260,313,314,378,True,34
e,38,kaist_dataset/Mixed/Digital_Camera/(C.S)D-indoor2/DSC04249.JPG,char_data/e/DSC04249.JPG_0.jpg,988,26,180,206,219,257,True,34
e,50,kaist_dataset/Mixed/Digital_Camera/(C.S)D-indoor2/DSC04421.JPG,char_data/e/DSC04421.JPG_0.jpg,1150,23,267,290,212,262,True,34
e,27,kaist_dataset/Mixed/Digital_Camera/(C.S)D-indoor2/DSC04254.JPG,char_data/e/DSC04254.JPG_0.jpg,594,22,300,322,349,376,True,34
e,28,kaist_dataset/Mixed/Digital_Camera/(C.S)D-indoor2/DSC04254.JPG,char_data/e/DSC04254.JPG_0.jpg,476,17,502,519,343,371,True,34
e,28,kaist_dataset/Mixed/Digital_Camera/(C.S)D-indoor2/DSC04254.JPG,char_data/e/DSC04254.JPG_0.jpg,448,16,549,565,341,369,True,34
e,29,kaist_dataset/Mixed/Digital_Camera/(C.S)D-indoor2/DSC04248.JPG,char_data/e/DSC04248.JPG_0.jpg,667,23,236,259,228,257,True,34
e,36,kaist_dataset/Mixed/Digital_Camera/(C.S)D-indoor2/DSC04248.JPG,char_data/e/DSC04248.JPG_0.jpg,684,19,279,298,223,259,True,34
e,36,kaist_dataset/Mixed/Digital_Camera/(C.S)D-indoor2/DSC04248.JPG,char_data/e/DSC04248.JPG_0.jpg,972,27,341,368,223,259,True,34
e,16,kaist_dataset/Mixed/Digital_Camera/(C.S)E-night/P1010155.JPG,char_data/e/P1010155.JPG_0.jpg,208,13,415,428,293,309,True,34
e,26,kaist_dataset/Mixed/Digital_Camera/(C.S)E-night/DSC02647.JPG,char_data/e/DSC02647.JPG_0.jpg,702,27,134,161,301,327,True,34
e,35,kaist_dataset/Mixed/Digital_Camera/(C.S)E-night/DSC02574.JPG,char_data/e/DSC02574.JPG_0.jpg,805,23,381,404,155,190,True,34
e,112,kaist_dataset/Mixed/Digital_Camera/(C.S)E-night/DSC02585.JPG,char_data/e/DSC02585.JPG_0.jpg,11984,107,339,446,264,376,True,34
e,30,kaist_dataset/Mixed/Digital_Camera/(C.S)E-night/DSC03031.JPG,char_data/e/DSC03031.JPG_0.jpg,450,15,172,187,26,56,True,34
e,27,kaist_dataset/Mixed/Digital_Camera/(C.S)E-night/DSC03031.JPG,char_data/e/DSC03031.JPG_0.jpg,459,17,292,309,27,54,True,34
e,28,kaist_dataset/Mixed/Digital_Camera/(C.S)E-night/DSC03031.JPG,char_data/e/DSC03031.JPG_0.jpg,392,14,310,324,28,56,True,34
e,106,kaist_dataset/Mixed/Digital_Camera/(C.S)E-night/DSC02586.JPG,char_data/e/DSC02586.JPG_0.jpg,10600,100,415,515,246,352,True,34
e,19,kaist_dataset/Mixed/Digital_Camera/(C.S)E-night/P1010151.JPG,char_data/e/P1010151.JPG_0.jpg,342,18,516,534,208,227,True,34
e,28,kaist_dataset/Mixed/Digital_Camera/(C.S)E-night/DSC02569.JPG,char_data/e/DSC02569.JPG_0.jpg,616,22,233,255,277,305,True,34
e,28,kaist_dataset/Mixed/Digital_Camera/(C.S)E-night/DSC02569.JPG,char_data/e/DSC02569.JPG_0.jpg,448,16,301,317,276,304,True,34
e,28,kaist_dataset/Mixed/Digital_Camera/(C.S)E-night/DSC02569.JPG,char_data/e/DSC02569.JPG_0.jpg,476,17,412,429,273,301,True,34
e,40,kaist_dataset/Mixed/Digital_Camera/(C.S)E-night/DSC02569.JPG,char_data/e/DSC02569.JPG_0.jpg,400,10,211,221,410,450,True,34
e,34,kaist_dataset/Mixed/Digital_Camera/(C.S)E-night/DSC02623.JPG,char_data/e/DSC02623.JPG_0.jpg,1020,30,457,487,401,435,True,34
e,34,kaist_dataset/Mixed/Digital_Camera/(C.S)E-night/DSC02623.JPG,char_data/e/DSC02623.JPG_0.jpg,952,28,488,516,399,433,True,34
e,38,kaist_dataset/Mixed/Digital_Camera/(C.S)D-indoor1/DSC03118.JPG,char_data/e/DSC03118.JPG_0.jpg,836,22,202,224,158,196,True,34
e,42,kaist_dataset/Mixed/Digital_Camera/(C.S)D-indoor1/DSC03118.JPG,char_data/e/DSC03118.JPG_0.jpg,924,22,230,252,231,273,True,34
e,39,kaist_dataset/Mixed/Digital_Camera/(C.S)D-indoor1/DSC03118.JPG,char_data/e/DSC03118.JPG_0.jpg,1014,26,457,483,229,268,True,34
e,31,kaist_dataset/Mixed/Digital_Camera/(C.S)D-indoor1/DSC03124.JPG,char_data/e/DSC03124.JPG_0.jpg,961,31,373,404,204,235,True,34
e,79,kaist_dataset/Mixed/Digital_Camera/(C.S)D-indoor1/DSC03501.JPG,char_data/e/DSC03501.JPG_0.jpg,5925,75,143,218,219,298,True,34
e,73,kaist_dataset/Mixed/Digital_Camera/(C.S)D-indoor1/DSC03501.JPG,char_data/e/DSC03501.JPG_0.jpg,4672,64,357,421,226,299,True,34
e,41,kaist_dataset/Mixed/Digital_Camera/(C.S)D-indoor1/DSC03119.JPG,char_data/e/DSC03119.JPG_0.jpg,1230,30,332,362,168,209,True,34
e,39,kaist_dataset/Mixed/Digital_Camera/(C.S)D-indoor1/DSC03134.JPG,char_data/e/DSC03134.JPG_0.jpg,897,23,282,305,172,211,True,34
e,39,kaist_dataset/Mixed/Digital_Camera/(C.S)D-indoor1/DSC03126.JPG,char_data/e/DSC03126.JPG_0.jpg,1131,29,370,399,224,263,True,34
e,85,kaist_dataset/Mixed/Digital_Camera/(C.S)D-indoor1/DSC03472.JPG,char_data/e/DSC03472.JPG_0.jpg,3315,39,280,319,19,104,True,34
e,80,kaist_dataset/Mixed/Digital_Camera/(C.S)D-indoor1/DSC03909.JPG,char_data/e/DSC03909.JPG_0.jpg,4080,51,248,299,104,184,True,34
e,81,kaist_dataset/Mixed/Digital_Camera/(C.S)D-indoor1/DSC03909.JPG,char_data/e/DSC03909.JPG_0.jpg,4536,56,401,457,102,183,True,34
e,78,kaist_dataset/Mixed/Digital_Camera/(C.S)D-indoor1/DSC03909.JPG,char_data/e/DSC03909.JPG_0.jpg,4212,54,324,378,201,279,True,34
e,63,kaist_dataset/Mixed/Digital_Camera/(C.S)D-indoor1/DSC03455.JPG,char_data/e/DSC03455.JPG_0.jpg,2457,39,205,244,396,459,True,34
e,58,kaist_dataset/Mixed/Digital_Camera/(C.S)D-indoor1/DSC03460.JPG,char_data/e/DSC03460.JPG_0.jpg,1856,32,210,242,387,445,True,34
e,36,kaist_dataset/Mixed/Digital_Camera/(C.S)D-indoor1/DSC04244.JPG,char_data/e/DSC04244.JPG_0.jpg,792,22,205,227,233,269,True,34
e,36,kaist_dataset/Mixed/Digital_Camera/(C.S)D-indoor1/DSC04244.JPG,char_data/e/DSC04244.JPG_0.jpg,792,22,342,364,238,274,True,34
e,35,kaist_dataset/Mixed/Digital_Camera/(C.S)D-indoor1/DSC04244.JPG,char_data/e/DSC04244.JPG_0.jpg,840,24,388,412,240,275,True,34
e,40,kaist_dataset/Mixed/Digital_Camera/(C.S)D-indoor1/DSC03123.JPG,char_data/e/DSC03123.JPG_0.jpg,1240,31,346,377,185,225,True,34
e,50,kaist_dataset/Mixed/Digital_Camera/(C.S)D-indoor1/DSC03121.JPG,char_data/e/DSC03121.JPG_0.jpg,1750,35,359,394,203,253,True,34
e,33,kaist_dataset/Mixed/Digital_Camera/(C.S)D-indoor1/DSC02787.JPG,char_data/e/DSC02787.JPG_0.jpg,429,13,71,84,394,427,True,34
e,36,kaist_dataset/Mixed/Digital_Camera/(C.S)D-indoor1/DSC02787.JPG,char_data/e/DSC02787.JPG_0.jpg,648,18,545,563,361,397,True,34
e,35,kaist_dataset/Mixed/Digital_Camera/(C.S)D-indoor1/DSC03466.JPG,char_data/e/DSC03466.JPG_0.jpg,840,24,279,303,233,268,True,34
e,49,kaist_dataset/Mixed/Digital_Camera/(C.S)D-indoor1/DSC03913.JPG,char_data/e/DSC03913.JPG_0.jpg,1715,35,397,432,117,166,True,34
e,40,kaist_dataset/Mixed/Digital_Camera/(C.S)D-indoor1/DSC03953.JPG,char_data/e/DSC03953.JPG_0.jpg,720,18,249,267,386,426,True,34
e,35,kaist_dataset/Mixed/Digital_Camera/(C.S)D-indoor1/DSC03073.JPG,char_data/e/DSC03073.JPG_0.jpg,665,19,339,358,340,375,True,34
e,32,kaist_dataset/Mixed/Digital_Camera/(C.S)D-indoor1/DSC02804.JPG,char_data/e/DSC02804.JPG_0.jpg,704,22,414,436,353,385,True,34
e,53,kaist_dataset/Mixed/Digital_Camera/(C.S)D-indoor1/DSC03925.JPG,char_data/e/DSC03925.JPG_0.jpg,2173,41,497,538,382,435,True,34
e,38,kaist_dataset/Mixed/Digital_Camera/(C.S)D-indoor1/DSC02711.JPG,char_data/e/DSC02711.JPG_0.jpg,1330,35,155,190,244,282,True,34
e,33,kaist_dataset/Mixed/Digital_Camera/(C.S)D-indoor1/DSC03132.JPG,char_data/e/DSC03132.JPG_0.jpg,924,28,242,270,184,217,True,34
e,40,kaist_dataset/Mixed/Digital_Camera/(C.S)D-indoor1/DSC03132.JPG,char_data/e/DSC03132.JPG_0.jpg,1120,28,143,171,248,288,True,34
e,37,kaist_dataset/Mixed/Digital_Camera/(C.S)D-indoor1/DSC03132.JPG,char_data/e/DSC03132.JPG_0.jpg,1110,30,341,371,253,290,True,34
e,45,kaist_dataset/Mixed/Digital_Camera/(C.S)D-indoor1/DSC04183.JPG,char_data/e/DSC04183.JPG_0.jpg,1035,23,200,223,246,291,True,34
e,31,kaist_dataset/Mixed/Digital_Camera/(C.S)D-indoor1/DSC04206.JPG,char_data/e/DSC04206.JPG_0.jpg,434,14,157,171,287,318,True,34
e,35,kaist_dataset/Mixed/Digital_Camera/(C.S)D-indoor1/DSC04206.JPG,char_data/e/DSC04206.JPG_0.jpg,560,16,355,371,293,328,True,34
e,45,kaist_dataset/Mixed/Digital_Camera/(C.S)D-indoor1/DSC03135.JPG,char_data/e/DSC03135.JPG_0.jpg,1440,32,246,278,183,228,True,34
e,26,kaist_dataset/Mixed/Digital_Camera/(C.S)D-indoor1/DSC04022.JPG,char_data/e/DSC04022.JPG_0.jpg,546,21,316,337,175,201,True,34
e,35,kaist_dataset/Mixed/Digital_Camera/(C.S)D-indoor1/DSC03122.JPG,char_data/e/DSC03122.JPG_0.jpg,700,20,303,323,152,187,True,34
e,41,kaist_dataset/Mixed/Digital_Camera/(C.S)D-indoor1/DSC03133.JPG,char_data/e/DSC03133.JPG_0.jpg,1148,28,232,260,155,196,True,34
e,46,kaist_dataset/Mixed/Digital_Camera/(C.S)D-indoor1/DSC03912.JPG,char_data/e/DSC03912.JPG_0.jpg,1104,24,344,368,45,91,True,34
e,46,kaist_dataset/Mixed/Digital_Camera/(C.S)D-indoor1/DSC03131.JPG,char_data/e/DSC03131.JPG_0.jpg,1380,30,283,313,133,179,True,34
e,32,kaist_dataset/Mixed/Digital_Camera/(C.S)D-indoor1/DSC02718.JPG,char_data/e/DSC02718.JPG_0.jpg,384,12,169,181,241,273,True,34
e,26,kaist_dataset/Mixed/Digital_Camera/(C.S)D-indoor1/DSC02718.JPG,char_data/e/DSC02718.JPG_0.jpg,364,14,203,217,249,275,True,34
e,41,kaist_dataset/Mixed/Digital_Camera/(C.S)D-indoor1/DSC03094.JPG,char_data/e/DSC03094.JPG_0.jpg,1148,28,270,298,146,187,True,34
e,52,kaist_dataset/Mixed/Digital_Camera/(C.S)D-indoor1/DSC02770.JPG,char_data/e/DSC02770.JPG_0.jpg,2184,42,304,346,358,410,True,34
e,55,kaist_dataset/Mixed/Digital_Camera/(C.S)D-indoor1/DSC02770.JPG,char_data/e/DSC02770.JPG_0.jpg,2530,46,497,543,360,415,True,34
e,27,kaist_dataset/Mixed/Digital_Camera/(C.S)D-indoor1/DSC03096.JPG,char_data/e/DSC03096.JPG_0.jpg,513,19,276,295,427,454,True,34
e,32,kaist_dataset/Mixed/Digital_Camera/(C.S)D-indoor1/DSC03096.JPG,char_data/e/DSC03096.JPG_0.jpg,512,16,521,537,425,457,True,34
e,46,kaist_dataset/Mixed/Digital_Camera/(C.S)D-indoor1/DSC03130.JPG,char_data/e/DSC03130.JPG_0.jpg,1380,30,315,345,180,226,True,34
e,32,kaist_dataset/Mixed/Digital_Camera/(C.S)D-indoor1/DSC04246.JPG,char_data/e/DSC04246.JPG_0.jpg,544,17,255,272,254,286,True,34
e,37,kaist_dataset/Mixed/Digital_Camera/(C.S)D-indoor1/DSC04246.JPG,char_data/e/DSC04246.JPG_0.jpg,703,19,403,422,250,287,True,34
e,38,kaist_dataset/Mixed/Digital_Camera/(C.S)C-outdoor5/DSC04162.JPG,char_data/e/DSC04162.JPG_0.jpg,1406,37,272,309,332,370,True,34
e,28,kaist_dataset/Mixed/Digital_Camera/(C.S)C-outdoor5/DSC04154.JPG,char_data/e/DSC04154.JPG_0.jpg,672,24,517,541,246,274,True,34
e,36,kaist_dataset/Mixed/Digital_Camera/(C.S)C-outdoor5/DSC04104.JPG,char_data/e/DSC04104.JPG_0.jpg,900,25,234,259,47,83,True,34
e,38,kaist_dataset/Mixed/Digital_Camera/(C.S)C-outdoor5/DSC04104.JPG,char_data/e/DSC04104.JPG_0.jpg,912,24,292,316,47,85,True,34
e,32,kaist_dataset/Mixed/Digital_Camera/(C.S)C-outdoor5/DSC04321.JPG,char_data/e/DSC04321.JPG_0.jpg,672,21,482,503,207,239,True,34
e,58,kaist_dataset/Mixed/Digital_Camera/(C.S)C-outdoor5/DSC03820.JPG,char_data/e/DSC03820.JPG_0.jpg,2146,37,141,178,377,435,True,34
e,35,kaist_dataset/Mixed/Digital_Camera/(C.S)C-outdoor5/DSC04076.JPG,char_data/e/DSC04076.JPG_0.jpg,1190,34,365,399,106,141,True,34
e,36,kaist_dataset/Mixed/Digital_Camera/(C.S)C-outdoor5/DSC04076.JPG,char_data/e/DSC04076.JPG_0.jpg,1260,35,463,498,100,136,True,34
e,38,kaist_dataset/Mixed/Digital_Camera/(C.S)C-outdoor5/DSC03839.JPG,char_data/e/DSC03839.JPG_0.jpg,684,18,193,211,37,75,True,34
e,32,kaist_dataset/Mixed/Digital_Camera/(C.S)C-outdoor5/DSC03839.JPG,char_data/e/DSC03839.JPG_0.jpg,544,17,394,411,41,73,True,34
e,27,kaist_dataset/Mixed/Digital_Camera/(C.S)C-outdoor5/DSC03839.JPG,char_data/e/DSC03839.JPG_0.jpg,378,14,223,237,372,399,True,34
e,26,kaist_dataset/Mixed/Digital_Camera/(C.S)C-outdoor5/DSC04357.JPG,char_data/e/DSC04357.JPG_0.jpg,442,17,429,446,353,379,True,34
e,24,kaist_dataset/Mixed/Digital_Camera/(C.S)C-outdoor5/DSC04357.JPG,char_data/e/DSC04357.JPG_0.jpg,456,19,512,531,355,379,True,34
e,34,kaist_dataset/Mixed/Digital_Camera/(C.S)C-outdoor5/DSC04151.JPG,char_data/e/DSC04151.JPG_0.jpg,782,23,130,153,337,371,True,34
e,32,kaist_dataset/Mixed/Digital_Camera/(C.S)C-outdoor5/DSC04069.JPG,char_data/e/DSC04069.JPG_0.jpg,864,27,83,110,391,423,True,34
e,35,kaist_dataset/Mixed/Digital_Camera/(C.S)C-outdoor5/DSC04069.JPG,char_data/e/DSC04069.JPG_0.jpg,700,20,132,152,387,422,True,34
e,28,kaist_dataset/Mixed/Digital_Camera/(C.S)C-outdoor5/DSC04069.JPG,char_data/e/DSC04069.JPG_0.jpg,504,18,232,250,387,415,True,34
e,35,kaist_dataset/Mixed/Digital_Camera/(C.S)C-outdoor5/DSC03821.JPG,char_data/e/DSC03821.JPG_0.jpg,700,20,85,105,34,69,True,34
e,32,kaist_dataset/Mixed/Digital_Camera/(C.S)C-outdoor5/DSC03821.JPG,char_data/e/DSC03821.JPG_0.jpg,672,21,247,268,39,71,True,34
e,38,kaist_dataset/Mixed/Digital_Camera/(C.S)C-outdoor5/DSC03821.JPG,char_data/e/DSC03821.JPG_0.jpg,912,24,469,493,44,82,True,34
e,42,kaist_dataset/Mixed/Digital_Camera/(C.S)C-outdoor5/DSC04097.JPG,char_data/e/DSC04097.JPG_0.jpg,1428,34,330,364,202,244,True,34
e,45,kaist_dataset/Mixed/Digital_Camera/(C.S)C-outdoor5/DSC04097.JPG,char_data/e/DSC04097.JPG_0.jpg,1485,33,518,551,202,247,True,34
e,45,kaist_dataset/Mixed/Digital_Camera/(C.S)C-outdoor5/DSC04097.JPG,char_data/e/DSC04097.JPG_0.jpg,1440,32,554,586,203,248,True,34
e,50,kaist_dataset/Mixed/Digital_Camera/(C.S)C-outdoor5/DSC04399.JPG,char_data/e/DSC04399.JPG_0.jpg,1850,37,547,584,281,331,True,34
e,28,kaist_dataset/Mixed/Digital_Camera/(C.S)C-outdoor5/DSC04125.JPG,char_data/e/DSC04125.JPG_0.jpg,448,16,95,111,431,459,True,34
e,28,kaist_dataset/Mixed/Digital_Camera/(C.S)C-outdoor5/DSC04125.JPG,char_data/e/DSC04125.JPG_0.jpg,448,16,124,140,430,458,True,34
e,29,kaist_dataset/Mixed/Digital_Camera/(C.S)C-outdoor5/DSC04125.JPG,char_data/e/DSC04125.JPG_0.jpg,435,15,205,220,428,457,True,34
e,33,kaist_dataset/Mixed/Digital_Camera/(C.S)C-outdoor5/DSC04070.JPG,char_data/e/DSC04070.JPG_0.jpg,429,13,234,247,111,144,True,34
e,39,kaist_dataset/Mixed/Digital_Camera/(C.S)C-outdoor5/DSC04015.JPG,char_data/e/DSC04015.JPG_0.jpg,1014,26,307,333,128,167,True,34
e,36,kaist_dataset/Mixed/Digital_Camera/(C.S)C-outdoor5/DSC04129.JPG,char_data/e/DSC04129.JPG_0.jpg,864,24,87,111,411,447,True,34
e,32,kaist_dataset/Mixed/Digital_Camera/(C.S)C-outdoor5/DSC04323.JPG,char_data/e/DSC04323.JPG_0.jpg,672,21,230,251,206,238,True,34
e,37,kaist_dataset/Mixed/Digital_Camera/(C.S)C-outdoor5/DSC04323.JPG,char_data/e/DSC04323.JPG_0.jpg,777,21,284,305,203,240,True,34
e,36,kaist_dataset/Mixed/Digital_Camera/(C.S)C-outdoor5/DSC04323.JPG,char_data/e/DSC04323.JPG_0.jpg,648,18,327,345,204,240,True,34
e,36,kaist_dataset/Mixed/Digital_Camera/(C.S)C-outdoor5/DSC04323.JPG,char_data/e/DSC04323.JPG_0.jpg,612,17,442,459,207,243,True,34
e,39,kaist_dataset/Mixed/Digital_Camera/(C.S)C-outdoor5/DSC04323.JPG,char_data/e/DSC04323.JPG_0.jpg,702,18,494,512,207,246,True,34
e,78,kaist_dataset/Mixed/Digital_Camera/(C.S)C-outdoor5/DSC04128.JPG,char_data/e/DSC04128.JPG_0.jpg,5070,65,283,348,211,289,True,34
e,73,kaist_dataset/Mixed/Digital_Camera/(C.S)C-outdoor5/DSC04128.JPG,char_data/e/DSC04128.JPG_0.jpg,4818,66,347,413,210,283,True,34
e,84,kaist_dataset/Mixed/Digital_Camera/(C.S)C-outdoor5/DSC04128.JPG,char_data/e/DSC04128.JPG_0.jpg,5880,70,473,543,206,290,True,34
e,55,kaist_dataset/Mixed/Digital_Camera/(C.S)C-outdoor5/DSC04029.JPG,char_data/e/DSC04029.JPG_0.jpg,1925,35,268,303,176,231,True,34
e,50,kaist_dataset/Mixed/Digital_Camera/(C.S)C-outdoor5/DSC04029.JPG,char_data/e/DSC04029.JPG_0.jpg,1500,30,419,449,180,230,True,34
e,41,kaist_dataset/Mixed/Digital_Camera/(C.S)C-outdoor5/DSC04338.JPG,char_data/e/DSC04338.JPG_0.jpg,902,22,383,405,197,238,True,34
e,43,kaist_dataset/Mixed/Digital_Camera/(C.S)C-outdoor5/DSC04322.JPG,char_data/e/DSC04322.JPG_0.jpg,1075,25,179,204,218,261,True,34
e,35,kaist_dataset/Mixed/Digital_Camera/(C.S)C-outdoor5/DSC04322.JPG,char_data/e/DSC04322.JPG_0.jpg,805,23,252,275,226,261,True,34
e,37,kaist_dataset/Mixed/Digital_Camera/(C.S)C-outdoor5/DSC04322.JPG,char_data/e/DSC04322.JPG_0.jpg,999,27,302,329,222,259,True,34
e,27,kaist_dataset/Mixed/Digital_Camera/(C.S)C-outdoor5/DSC04057.JPG,char_data/e/DSC04057.JPG_0.jpg,459,17,114,131,125,152,True,34
e,28,kaist_dataset/Mixed/Digital_Camera/(C.S)C-outdoor5/DSC04057.JPG,char_data/e/DSC04057.JPG_0.jpg,532,19,131,150,125,153,True,34
e,27,kaist_dataset/Mixed/Digital_Camera/(C.S)C-outdoor5/DSC04057.JPG,char_data/e/DSC04057.JPG_0.jpg,459,17,221,238,122,149,True,34
e,75,kaist_dataset/Mixed/Digital_Camera/(C.S)C-outdoor5/DSC04115.JPG,char_data/e/DSC04115.JPG_0.jpg,5250,70,419,489,199,274,True,34
e,76,kaist_dataset/Mixed/Digital_Camera/(C.S)C-outdoor5/DSC04115.JPG,char_data/e/DSC04115.JPG_0.jpg,5472,72,487,559,199,275,True,34
e,76,kaist_dataset/Mixed/Digital_Camera/(C.S)C-outdoor5/P1010006.JPG,char_data/e/P1010006.JPG_0.jpg,3420,45,402,447,222,298,True,34
e,73,kaist_dataset/Mixed/Digital_Camera/(C.S)C-outdoor5/P1010006.JPG,char_data/e/P1010006.JPG_0.jpg,3212,44,448,492,227,300,True,34
e,41,kaist_dataset/Mixed/Digital_Camera/(C.S)C-outdoor3/DSC03177.JPG,char_data/e/DSC03177.JPG_0.jpg,1189,29,332,361,146,187,True,34
e,43,kaist_dataset/Mixed/Digital_Camera/(C.S)C-outdoor3/DSC03310.JPG,char_data/e/DSC03310.JPG_0.jpg,731,17,461,478,125,168,True,34
e,42,kaist_dataset/Mixed/Digital_Camera/(C.S)C-outdoor3/DSC03310.JPG,char_data/e/DSC03310.JPG_0.jpg,840,20,479,499,126,168,True,34
e,40,kaist_dataset/Mixed/Digital_Camera/(C.S)C-outdoor3/DSC03310.JPG,char_data/e/DSC03310.JPG_0.jpg,600,15,540,555,125,165,True,34
e,39,kaist_dataset/Mixed/Digital_Camera/(C.S)C-outdoor3/DSC03310.JPG,char_data/e/DSC03310.JPG_0.jpg,780,20,555,575,128,167,True,34
e,69,kaist_dataset/Mixed/Digital_Camera/(C.S)C-outdoor3/DSC03260.JPG,char_data/e/DSC03260.JPG_0.jpg,3519,51,188,239,83,152,True,34
e,73,kaist_dataset/Mixed/Digital_Camera/(C.S)C-outdoor3/DSC03299.JPG,char_data/e/DSC03299.JPG_0.jpg,4088,56,399,455,386,459,True,34
e,74,kaist_dataset/Mixed/Digital_Camera/(C.S)C-outdoor3/DSC03299.JPG,char_data/e/DSC03299.JPG_0.jpg,3774,51,456,507,387,461,True,34
e,44,kaist_dataset/Mixed/Digital_Camera/(C.S)C-outdoor3/DSC02962.JPG,char_data/e/DSC02962.JPG_0.jpg,1804,41,319,360,256,300,True,34
e,59,kaist_dataset/Mixed/Digital_Camera/(C.S)C-outdoor3/DSC02962.JPG,char_data/e/DSC02962.JPG_0.jpg,2891,49,521,570,215,274,True,34
e,45,kaist_dataset/Mixed/Digital_Camera/(C.S)C-outdoor3/DSC02962.JPG,char_data/e/DSC02962.JPG_0.jpg,1620,36,355,391,179,224,True,34
e,43,kaist_dataset/Mixed/Digital_Camera/(C.S)C-outdoor3/DSC02962.JPG,char_data/e/DSC02962.JPG_0.jpg,1419,33,101,134,228,271,True,34
e,77,kaist_dataset/Mixed/Digital_Camera/(C.S)C-outdoor3/DSC03421.JPG,char_data/e/DSC03421.JPG_0.jpg,2695,35,98,133,231,308,True,34
e,71,kaist_dataset/Mixed/Digital_Camera/(C.S)C-outdoor3/DSC03421.JPG,char_data/e/DSC03421.JPG_0.jpg,2556,36,393,429,248,319,True,34
e,92,kaist_dataset/Mixed/Digital_Camera/(C.S)C-outdoor3/DSC03421.JPG,char_data/e/DSC03421.JPG_0.jpg,6072,66,182,248,90,182,True,34
e,70,kaist_dataset/Mixed/Digital_Camera/(C.S)C-outdoor3/P1010016.JPG,char_data/e/P1010016.JPG_0.jpg,2660,38,396,434,183,253,True,34
e,30,kaist_dataset/Mixed/Digital_Camera/(C.S)C-outdoor3/DSC03187.JPG,char_data/e/DSC03187.JPG_0.jpg,720,24,203,227,396,426,True,34
e,25,kaist_dataset/Mixed/Digital_Camera/(C.S)C-outdoor3/DSC02970.JPG,char_data/e/DSC02970.JPG_0.jpg,325,13,264,277,310,335,True,34
e,43,kaist_dataset/Mixed/Digital_Camera/(C.S)C-outdoor3/DSC02978.JPG,char_data/e/DSC02978.JPG_0.jpg,1161,27,125,152,166,209,True,34
e,29,kaist_dataset/Mixed/Digital_Camera/(C.S)C-outdoor3/DSC03328.JPG,char_data/e/DSC03328.JPG_0.jpg,406,14,359,373,242,271,True,34
e,26,kaist_dataset/Mixed/Digital_Camera/(C.S)C-outdoor3/DSC03209.JPG,char_data/e/DSC03209.JPG_0.jpg,676,26,301,327,426,452,True,34
e,46,kaist_dataset/Mixed/Digital_Camera/(C.S)C-outdoor3/DSC03063.JPG,char_data/e/DSC03063.JPG_0.jpg,1196,26,179,205,279,325,True,34
e,26,kaist_dataset/Mixed/Digital_Camera/(C.S)C-outdoor3/DSC03186.JPG,char_data/e/DSC03186.JPG_0.jpg,598,23,189,212,111,137,True,34
e,37,kaist_dataset/Mixed/Digital_Camera/(C.S)C-outdoor3/DSC03332.JPG,char_data/e/DSC03332.JPG_0.jpg,1258,34,333,367,231,268,True,34
e,102,kaist_dataset/Mixed/Digital_Camera/(C.S)C-outdoor3/DSC03210.JPG,char_data/e/DSC03210.JPG_0.jpg,5202,51,412,463,237,339,True,34
e,67,kaist_dataset/Mixed/Digital_Camera/(C.S)C-outdoor3/DSC03422.JPG,char_data/e/DSC03422.JPG_0.jpg,2345,35,203,238,253,320,True,34
e,56,kaist_dataset/Mixed/Digital_Camera/(C.S)C-outdoor3/DSC03422.JPG,char_data/e/DSC03422.JPG_0.jpg,1400,25,399,424,264,320,True,34
e,58,kaist_dataset/Mixed/Digital_Camera/(C.S)C-outdoor3/DSC03409.JPG,char_data/e/DSC03409.JPG_0.jpg,2610,45,303,348,139,197,True,34
e,61,kaist_dataset/Mixed/Digital_Camera/(C.S)C-outdoor3/DSC03409.JPG,char_data/e/DSC03409.JPG_0.jpg,2867,47,369,416,137,198,True,34
e,76,kaist_dataset/Mixed/Digital_Camera/(C.S)C-outdoor3/DSC03017.JPG,char_data/e/DSC03017.JPG_0.jpg,6232,82,401,483,161,237,True,34
e,29,kaist_dataset/Mixed/Digital_Camera/(C.S)C-outdoor3/DSC03020.JPG,char_data/e/DSC03020.JPG_0.jpg,348,12,466,478,304,333,True,34
e,35,kaist_dataset/Mixed/Digital_Camera/(C.S)C-outdoor3/DSC02989.JPG,char_data/e/DSC02989.JPG_0.jpg,595,17,430,447,355,390,True,34
e,28,kaist_dataset/Mixed/Digital_Camera/(C.S)C-outdoor3/DSC03271.JPG,char_data/e/DSC03271.JPG_0.jpg,784,28,358,386,82,110,True,34
e,50,kaist_dataset/Mixed/Digital_Camera/(C.S)C-outdoor3/DSC03242.JPG,char_data/e/DSC03242.JPG_0.jpg,2650,53,323,376,177,227,True,34
e,28,kaist_dataset/Mixed/Digital_Camera/(C.S)C-outdoor6/P1010075.JPG,char_data/e/P1010075.JPG_0.jpg,336,12,405,417,311,339,True,34
e,24,kaist_dataset/Mixed/Digital_Camera/(C.S)C-outdoor6/P1010020.JPG,char_data/e/P1010020.JPG_0.jpg,312,13,103,116,341,365,True,34
e,22,kaist_dataset/Mixed/Digital_Camera/(C.S)C-outdoor6/P1010138.JPG,char_data/e/P1010138.JPG_0.jpg,352,16,113,129,183,205,True,34
e,29,kaist_dataset/Mixed/Digital_Camera/(C.S)C-outdoor6/090.jpg,char_data/e/090.jpg_0.jpg,667,23,277,300,161,190,True,34
e,28,kaist_dataset/Mixed/Digital_Camera/(C.S)C-outdoor6/090.jpg,char_data/e/090.jpg_0.jpg,560,20,326,346,161,189,True,34
e,25,kaist_dataset/Mixed/Digital_Camera/(C.S)C-outdoor6/090.jpg,char_data/e/090.jpg_0.jpg,550,22,417,439,165,190,True,34
e,38,kaist_dataset/Mixed/Digital_Camera/(C.S)C-outdoor6/090.jpg,char_data/e/090.jpg_0.jpg,1178,31,439,470,157,195,True,34
e,37,kaist_dataset/Mixed/Digital_Camera/(C.S)C-outdoor6/P1010085.JPG,char_data/e/P1010085.JPG_0.jpg,851,23,146,169,129,166,True,34
e,150,kaist_dataset/Mixed/Digital_Camera/(C.S)C-outdoor6/080116-0057.jpg,char_data/e/080116-0057.jpg_0.jpg,18450,123,532,655,355,505,True,34
e,151,kaist_dataset/Mixed/Digital_Camera/(C.S)C-outdoor6/080116-0057.jpg,char_data/e/080116-0057.jpg_0.jpg,18271,121,1280,1401,351,502,True,34
e,51,kaist_dataset/Mixed/Digital_Camera/(C.S)C-outdoor6/080116-0057.jpg,char_data/e/080116-0057.jpg_0.jpg,1632,32,1171,1203,826,877,True,34
e,43,kaist_dataset/Mixed/Digital_Camera/(C.S)C-outdoor6/080116-0057.jpg,char_data/e/080116-0057.jpg_0.jpg,1376,32,328,360,925,968,True,34
e,31,kaist_dataset/Mixed/Digital_Camera/(C.S)C-outdoor6/P1010021.JPG,char_data/e/P1010021.JPG_0.jpg,775,25,50,75,223,254,True,34
e,63,kaist_dataset/Mixed/Digital_Camera/(C.S)C-outdoor6/P1010116.JPG,char_data/e/P1010116.JPG_0.jpg,1134,18,284,302,197,260,True,34
e,67,kaist_dataset/Mixed/Digital_Camera/(C.S)C-outdoor6/025.jpg,char_data/e/025.jpg_0.jpg,4757,71,203,274,61,128,True,34
e,65,kaist_dataset/Mixed/Digital_Camera/(C.S)C-outdoor6/025.jpg,char_data/e/025.jpg_0.jpg,3770,58,328,386,73,138,True,34
e,23,kaist_dataset/Mixed/Digital_Camera/(C.S)C-outdoor6/P1010065.JPG,char_data/e/P1010065.JPG_0.jpg,322,14,209,223,236,259,True,34
e,16,kaist_dataset/Mixed/Digital_Camera/(C.S)C-outdoor6/P1010065.JPG,char_data/e/P1010065.JPG_0.jpg,144,9,233,242,239,255,True,34
e,17,kaist_dataset/Mixed/Digital_Camera/(C.S)C-outdoor6/P1010065.JPG,char_data/e/P1010065.JPG_0.jpg,221,13,296,309,237,254,True,34
e,23,kaist_dataset/Mixed/Digital_Camera/(C.S)C-outdoor6/P1010132.JPG,char_data/e/P1010132.JPG_0.jpg,368,16,168,184,108,131,True,34
e,46,kaist_dataset/Mixed/Digital_Camera/(C.S)C-outdoor6/117.JPG,char_data/e/117.JPG_0.jpg,2116,46,575,621,202,248,True,34
e,73,kaist_dataset/Mixed/Digital_Camera/(C.S)C-outdoor4/DSC03651.JPG,char_data/e/DSC03651.JPG_0.jpg,5402,74,473,547,180,253,True,34
e,66,kaist_dataset/Mixed/Digital_Camera/(C.S)C-outdoor4/DSC03572.JPG,char_data/e/DSC03572.JPG_0.jpg,3498,53,525,578,132,198,True,34
e,26,kaist_dataset/Mixed/Digital_Camera/(C.S)C-outdoor4/DSC03677.JPG,char_data/e/DSC03677.JPG_0.jpg,234,9,486,495,318,344,True,34
e,49,kaist_dataset/Mixed/Digital_Camera/(C.S)C-outdoor4/DSC03642.JPG,char_data/e/DSC03642.JPG_0.jpg,1225,25,176,201,251,300,True,34
e,41,kaist_dataset/Mixed/Digital_Camera/(C.S)C-outdoor4/DSC03642.JPG,char_data/e/DSC03642.JPG_0.jpg,1148,28,460,488,245,286,True,34
e,44,kaist_dataset/Mixed/Digital_Camera/(C.S)C-outdoor4/DSC03642.JPG,char_data/e/DSC03642.JPG_0.jpg,1232,28,529,557,243,287,True,34
e,24,kaist_dataset/Mixed/Digital_Camera/(C.S)C-outdoor4/DSC03552.JPG,char_data/e/DSC03552.JPG_0.jpg,312,13,322,335,324,348,True,34
e,69,kaist_dataset/Mixed/Digital_Camera/(C.S)C-outdoor4/DSC03544.JPG,char_data/e/DSC03544.JPG_0.jpg,2553,37,118,155,185,254,True,34
e,28,kaist_dataset/Mixed/Digital_Camera/(C.S)C-outdoor4/DSC03661.JPG,char_data/e/DSC03661.JPG_0.jpg,420,15,120,135,276,304,True,34
e,60,kaist_dataset/Mixed/Digital_Camera/(C.S)C-outdoor4/DSC03784.JPG,char_data/e/DSC03784.JPG_0.jpg,1860,31,184,215,321,381,True,34
e,58,kaist_dataset/Mixed/Digital_Camera/(C.S)C-outdoor4/DSC03784.JPG,char_data/e/DSC03784.JPG_0.jpg,2030,35,242,277,319,377,True,34
e,56,kaist_dataset/Mixed/Digital_Camera/(C.S)C-outdoor4/DSC03784.JPG,char_data/e/DSC03784.JPG_0.jpg,1848,33,344,377,324,380,True,34
e,45,kaist_dataset/Mixed/Digital_Camera/(C.S)C-outdoor4/DSC03781.JPG,char_data/e/DSC03781.JPG_0.jpg,2250,50,385,435,315,360,True,34
e,36,kaist_dataset/Mixed/Digital_Camera/(C.S)C-outdoor4/DSC03781.JPG,char_data/e/DSC03781.JPG_0.jpg,1440,40,359,399,228,264,True,34
e,32,kaist_dataset/Mixed/Digital_Camera/(C.S)C-outdoor4/DSC03672.JPG,char_data/e/DSC03672.JPG_0.jpg,832,26,275,301,413,445,True,34
e,39,kaist_dataset/Mixed/Digital_Camera/(C.S)C-outdoor4/DSC03569.JPG,char_data/e/DSC03569.JPG_0.jpg,1053,27,294,321,180,219,True,34
e,56,kaist_dataset/Mixed/Digital_Camera/(C.S)C-outdoor4/DSC03643.JPG,char_data/e/DSC03643.JPG_0.jpg,2576,46,34,80,248,304,True,34
e,45,kaist_dataset/Mixed/Digital_Camera/(C.S)C-outdoor4/DSC03643.JPG,char_data/e/DSC03643.JPG_0.jpg,1575,35,434,469,278,323,True,34
e,44,kaist_dataset/Mixed/Digital_Camera/(C.S)C-outdoor4/DSC03643.JPG,char_data/e/DSC03643.JPG_0.jpg,1452,33,529,562,282,326,True,34
e,29,kaist_dataset/Mixed/Digital_Camera/(C.S)C-outdoor4/DSC03682.JPG,char_data/e/DSC03682.JPG_0.jpg,493,17,419,436,328,357,True,34
e,24,kaist_dataset/Mixed/Digital_Camera/(C.S)C-outdoor4/DSC03682.JPG,char_data/e/DSC03682.JPG_0.jpg,504,21,549,570,334,358,True,34
e,30,kaist_dataset/Mixed/Digital_Camera/(C.S)C-outdoor4/DSC03556.JPG,char_data/e/DSC03556.JPG_0.jpg,330,11,205,216,322,352,True,34
e,24,kaist_dataset/Mixed/Digital_Camera/(C.S)C-outdoor4/DSC03556.JPG,char_data/e/DSC03556.JPG_0.jpg,288,12,400,412,325,349,True,34
e,21,kaist_dataset/Mixed/Digital_Camera/(C.S)C-outdoor4/DSC03556.JPG,char_data/e/DSC03556.JPG_0.jpg,168,8,502,510,328,349,True,34
e,25,kaist_dataset/Mixed/Digital_Camera/(C.S)C-outdoor4/DSC03556.JPG,char_data/e/DSC03556.JPG_0.jpg,300,12,518,530,324,349,True,34
e,24,kaist_dataset/Mixed/Digital_Camera/(C.S)C-outdoor4/DSC03556.JPG,char_data/e/DSC03556.JPG_0.jpg,240,10,602,612,324,348,True,34
e,21,kaist_dataset/Mixed/Digital_Camera/(C.S)C-outdoor4/DSC03670.JPG,char_data/e/DSC03670.JPG_0.jpg,252,12,425,437,325,346,True,34
e,34,kaist_dataset/Mixed/Digital_Camera/(C.S)C-outdoor4/DSC03586.JPG,char_data/e/DSC03586.JPG_0.jpg,782,23,235,258,158,192,True,34
e,30,kaist_dataset/Mixed/Digital_Camera/(C.S)C-outdoor4/DSC03758.JPG,char_data/e/DSC03758.JPG_0.jpg,420,14,220,234,233,263,True,34
e,24,kaist_dataset/Mixed/Digital_Camera/(C.S)C-outdoor4/DSC03758.JPG,char_data/e/DSC03758.JPG_0.jpg,360,15,234,249,237,261,True,34
e,23,kaist_dataset/Mixed/Digital_Camera/(C.S)C-outdoor4/DSC03758.JPG,char_data/e/DSC03758.JPG_0.jpg,299,13,204,217,280,303,True,34
e,21,kaist_dataset/Mixed/Digital_Camera/(C.S)C-outdoor4/DSC03758.JPG,char_data/e/DSC03758.JPG_0.jpg,231,11,218,229,279,300,True,34
e,25,kaist_dataset/Mixed/Digital_Camera/(C.S)C-outdoor2/DSC02421.JPG,char_data/e/DSC02421.JPG_0.jpg,525,21,84,105,213,238,True,34
e,21,kaist_dataset/Mixed/Digital_Camera/(C.S)C-outdoor2/DSC02421.JPG,char_data/e/DSC02421.JPG_0.jpg,441,21,365,386,213,234,True,34
e,16,kaist_dataset/Mixed/Digital_Camera/(C.S)C-outdoor2/DSC02421.JPG,char_data/e/DSC02421.JPG_0.jpg,320,20,504,524,214,230,True,34
e,27,kaist_dataset/Mixed/Digital_Camera/(C.S)C-outdoor2/DSC02912.JPG,char_data/e/DSC02912.JPG_0.jpg,540,20,291,311,16,43,True,34
e,52,kaist_dataset/Mixed/Digital_Camera/(C.S)C-outdoor2/DSC02418.JPG,char_data/e/DSC02418.JPG_0.jpg,2964,57,404,461,174,226,True,34
e,62,kaist_dataset/Mixed/Digital_Camera/(C.S)C-outdoor2/DSC02940.JPG,char_data/e/DSC02940.JPG_0.jpg,3782,61,117,178,245,307,True,34
e,73,kaist_dataset/Mixed/Digital_Camera/(C.S)C-outdoor2/DSC02940.JPG,char_data/e/DSC02940.JPG_0.jpg,4526,62,251,313,241,314,True,34
e,66,kaist_dataset/Mixed/Digital_Camera/(C.S)C-outdoor2/DSC02940.JPG,char_data/e/DSC02940.JPG_0.jpg,4092,62,478,540,259,325,True,34
e,28,kaist_dataset/Mixed/Digital_Camera/(C.S)C-outdoor2/DSC02886.JPG,char_data/e/DSC02886.JPG_0.jpg,728,26,573,599,128,156,True,34
e,40,kaist_dataset/Mixed/Digital_Camera/(C.S)C-outdoor2/DSC02400.JPG,char_data/e/DSC02400.JPG_0.jpg,1400,35,153,188,329,369,True,34
e,38,kaist_dataset/Mixed/Digital_Camera/(C.S)C-outdoor2/DSC02400.JPG,char_data/e/DSC02400.JPG_0.jpg,1330,35,189,224,327,365,True,34
e,38,kaist_dataset/Mixed/Digital_Camera/(C.S)C-outdoor2/DSC02400.JPG,char_data/e/DSC02400.JPG_0.jpg,1102,29,319,348,326,364,True,34
e,40,kaist_dataset/Mixed/Digital_Camera/(C.S)C-outdoor2/DSC02400.JPG,char_data/e/DSC02400.JPG_0.jpg,1440,36,569,605,330,370,True,34
e,34,kaist_dataset/Mixed/Digital_Camera/(C.S)C-outdoor2/DSC02927.JPG,char_data/e/DSC02927.JPG_0.jpg,646,19,198,217,370,404,True,34
e,41,kaist_dataset/Mixed/Digital_Camera/(C.S)C-outdoor2/DSC02869.JPG,char_data/e/DSC02869.JPG_0.jpg,656,16,187,203,142,183,True,34
e,32,kaist_dataset/Mixed/Digital_Camera/(C.S)C-outdoor2/DSC02385.JPG,char_data/e/DSC02385.JPG_0.jpg,416,13,532,545,133,165,True,34
e,49,kaist_dataset/Mixed/Digital_Camera/(C.S)C-outdoor2/DSC02382.JPG,char_data/e/DSC02382.JPG_0.jpg,2303,47,117,164,262,311,True,34
e,19,kaist_dataset/Mixed/Digital_Camera/(C.S)C-outdoor2/DSC02439.JPG,char_data/e/DSC02439.JPG_0.jpg,304,16,469,485,112,131,True,34
e,28,kaist_dataset/Mixed/Digital_Camera/(C.S)C-outdoor2/DSC02479.JPG,char_data/e/DSC02479.JPG_0.jpg,728,26,400,426,224,252,True,34
e,55,kaist_dataset/Mixed/Digital_Camera/(C.S)C-outdoor2/DSC02416.JPG,char_data/e/DSC02416.JPG_0.jpg,3410,62,179,241,215,270,True,34
e,49,kaist_dataset/Mixed/Digital_Camera/(C.S)C-outdoor2/DSC02519.JPG,char_data/e/DSC02519.JPG_0.jpg,2107,43,430,473,206,255,True,34
e,114,kaist_dataset/Mixed/Digital_Camera/(C.S)C-outdoor2/DSC02919.JPG,char_data/e/DSC02919.JPG_0.jpg,16188,142,354,496,353,467,True,34
e,33,kaist_dataset/Mixed/Digital_Camera/(C.S)C-outdoor2/DSC02864.JPG,char_data/e/DSC02864.JPG_0.jpg,891,27,439,466,267,300,True,34
e,30,kaist_dataset/Mixed/Digital_Camera/(C.S)C-outdoor2/DSC02545.JPG,char_data/e/DSC02545.JPG_0.jpg,900,30,349,379,368,398,True,34
e,27,kaist_dataset/Mixed/Digital_Camera/(C.S)C-outdoor2/DSC02894.JPG,char_data/e/DSC02894.JPG_0.jpg,540,20,199,219,275,302,True,34
e,71,kaist_dataset/Mixed/Digital_Camera/(C.S)C-outdoor2/DSC02701.JPG,char_data/e/DSC02701.JPG_0.jpg,4189,59,282,341,98,169,True,34
e,51,kaist_dataset/Mixed/Digital_Camera/(C.S)C-outdoor2/DSC02936.JPG,char_data/e/DSC02936.JPG_0.jpg,1938,38,404,442,139,190,True,34
e,35,kaist_dataset/Mixed/Digital_Camera/(C.S)C-outdoor2/DSC02936.JPG,char_data/e/DSC02936.JPG_0.jpg,630,18,230,248,81,116,True,34
e,31,kaist_dataset/Mixed/Digital_Camera/(C.S)C-outdoor2/DSC02936.JPG,char_data/e/DSC02936.JPG_0.jpg,341,11,344,355,90,121,True,34
e,30,kaist_dataset/Mixed/Digital_Camera/(C.S)C-outdoor2/DSC02511.JPG,char_data/e/DSC02511.JPG_0.jpg,540,18,106,124,208,238,True,34
e,24,kaist_dataset/Mixed/Digital_Camera/(C.S)C-outdoor2/DSC02511.JPG,char_data/e/DSC02511.JPG_0.jpg,432,18,141,159,212,236,True,34
e,27,kaist_dataset/Mixed/Digital_Camera/(C.S)C-outdoor2/DSC02511.JPG,char_data/e/DSC02511.JPG_0.jpg,702,26,253,279,215,242,True,34
e,79,kaist_dataset/Mixed/Digital_Camera/(C.S)C-outdoor2/DSC02493.JPG,char_data/e/DSC02493.JPG_0.jpg,5609,71,90,161,286,365,True,34
e,71,kaist_dataset/Mixed/Digital_Camera/(C.S)C-outdoor2/DSC02493.JPG,char_data/e/DSC02493.JPG_0.jpg,4615,65,398,463,299,370,True,34
e,43,kaist_dataset/Mixed/Digital_Camera/(C.S)C-outdoor2/DSC02926.JPG,char_data/e/DSC02926.JPG_0.jpg,1376,32,44,76,148,191,True,34
e,41,kaist_dataset/Mixed/Digital_Camera/(C.S)C-outdoor2/DSC02928.JPG,char_data/e/DSC02928.JPG_0.jpg,1148,28,334,362,390,431,True,34
e,31,kaist_dataset/Mixed/Digital_Camera/(C.S)C-outdoor2/DSC02560.JPG,char_data/e/DSC02560.JPG_0.jpg,682,22,296,318,304,335,True,34
e,27,kaist_dataset/Mixed/Digital_Camera/(C.S)C-outdoor2/DSC02560.JPG,char_data/e/DSC02560.JPG_0.jpg,594,22,318,340,304,331,True,34
e,25,kaist_dataset/Mixed/Digital_Camera/(C.S)C-outdoor2/DSC02560.JPG,char_data/e/DSC02560.JPG_0.jpg,625,25,381,406,306,331,True,34
e,25,kaist_dataset/Mixed/Digital_Camera/(C.S)C-outdoor2/DSC02560.JPG,char_data/e/DSC02560.JPG_0.jpg,425,17,408,425,307,332,True,34
e,22,kaist_dataset/Mixed/Digital_Camera/(C.S)C-outdoor2/DSC02430.JPG,char_data/e/DSC02430.JPG_0.jpg,374,17,150,167,188,210,True,34
e,37,kaist_dataset/Mixed/Digital_Camera/(C.S)C-outdoor2/DSC02867.JPG,char_data/e/DSC02867.JPG_0.jpg,888,24,226,250,402,439,True,34
e,73,kaist_dataset/Mixed/Digital_Camera/(C.S)C-outdoor2/DSC02434.JPG,char_data/e/DSC02434.JPG_0.jpg,4088,56,454,510,200,273,True,34
e,77,kaist_dataset/Mixed/Digital_Camera/(C.S)C-outdoor2/DSC02434.JPG,char_data/e/DSC02434.JPG_0.jpg,4697,61,508,569,202,279,True,34
e,36,kaist_dataset/Mixed/Digital_Camera/(C.S)A-shadow/DSC02609.JPG,char_data/e/DSC02609.JPG_0.jpg,648,18,250,268,316,352,True,34
e,57,kaist_dataset/Mixed/Digital_Camera/(C.S)A-shadow/DSC03207.JPG,char_data/e/DSC03207.JPG_0.jpg,2052,36,239,275,204,261,True,34
e,75,kaist_dataset/English/Mobile_Phone/(E.M)A-outdoor/P090912059.jpg,char_data/e/P090912059.jpg_0.jpg,6975,93,34,127,154,229,True,34
e,79,kaist_dataset/English/Mobile_Phone/(E.M)A-outdoor/P090912059.jpg,char_data/e/P090912059.jpg_0.jpg,5925,75,212,287,156,235,True,34
e,45,kaist_dataset/English/Mobile_Phone/(E.M)A-outdoor/P090912072.jpg,char_data/e/P090912072.jpg_0.jpg,1620,36,173,209,127,172,True,34
e,45,kaist_dataset/English/Mobile_Phone/(E.M)A-outdoor/P090912072.jpg,char_data/e/P090912072.jpg_0.jpg,2025,45,209,254,127,172,True,34
e,48,kaist_dataset/English/Mobile_Phone/(E.M)A-outdoor/P090912072.jpg,char_data/e/P090912072.jpg_0.jpg,1776,37,87,124,187,235,True,34
e,48,kaist_dataset/English/Mobile_Phone/(E.M)A-outdoor/P090912072.jpg,char_data/e/P090912072.jpg_0.jpg,1632,34,126,160,195,243,True,34
e,108,kaist_dataset/English/Mobile_Phone/(E.M)B-indoor/P090911075.jpg,char_data/e/P090911075.jpg_0.jpg,12960,120,355,475,115,223,True,34
e,69,kaist_dataset/English/Mobile_Phone/(E.M)B-indoor/P090831011.jpg,char_data/e/P090831011.jpg_0.jpg,3174,46,72,118,137,206,True,34
e,66,kaist_dataset/English/Mobile_Phone/(E.M)B-indoor/P090831011.jpg,char_data/e/P090831011.jpg_0.jpg,2904,44,237,281,139,205,True,34
e,65,kaist_dataset/English/Mobile_Phone/(E.M)B-indoor/P090831011.jpg,char_data/e/P090831011.jpg_0.jpg,3120,48,566,614,139,204,True,34
e,53,kaist_dataset/English/Mobile_Phone/(E.M)B-indoor/P090902018.jpg,char_data/e/P090902018.jpg_0.jpg,2173,41,151,192,311,364,True,34
e,119,kaist_dataset/English/Mobile_Phone/(E.M)B-indoor/P090903001.jpg,char_data/e/P090903001.jpg_0.jpg,11900,100,404,504,140,259,True,34
e,87,kaist_dataset/English/Mobile_Phone/(E.M)B-indoor/P090911086.jpg,char_data/e/P090911086.jpg_0.jpg,4698,54,582,636,369,456,True,34
e,84,kaist_dataset/English/Mobile_Phone/(E.M)B-indoor/P090911086.jpg,char_data/e/P090911086.jpg_0.jpg,4032,48,256,304,244,328,True,34
e,78,kaist_dataset/English/Mobile_Phone/(E.M)B-indoor/P090903004.jpg,char_data/e/P090903004.jpg_0.jpg,5148,66,207,273,258,336,True,34
e,78,kaist_dataset/English/Mobile_Phone/(E.M)B-indoor/P090903004.jpg,char_data/e/P090903004.jpg_0.jpg,5538,71,527,598,256,334,True,34
e,101,kaist_dataset/English/Mobile_Phone/(E.M)B-indoor/P090903003.jpg,char_data/e/P090903003.jpg_0.jpg,7777,77,384,461,260,361,True,34
e,45,kaist_dataset/English/Mobile_Phone/(E.M)B-indoor/P090911084.jpg,char_data/e/P090911084.jpg_0.jpg,1215,27,257,284,163,208,True,34
e,47,kaist_dataset/English/Mobile_Phone/(E.M)B-indoor/P090911084.jpg,char_data/e/P090911084.jpg_0.jpg,1128,24,348,372,159,206,True,34
e,49,kaist_dataset/English/Mobile_Phone/(E.M)B-indoor/P090911084.jpg,char_data/e/P090911084.jpg_0.jpg,1176,24,472,496,158,207,True,34
e,41,kaist_dataset/English/Mobile_Phone/(E.M)B-indoor/P090911084.jpg,char_data/e/P090911084.jpg_0.jpg,1107,27,542,569,160,201,True,34
e,56,kaist_dataset/English/Mobile_Phone/(E.M)B-indoor/P090903008.jpg,char_data/e/P090903008.jpg_0.jpg,2464,44,198,242,37,93,True,34
e,58,kaist_dataset/English/Mobile_Phone/(E.M)B-indoor/P090903008.jpg,char_data/e/P090903008.jpg_0.jpg,2378,41,378,419,39,97,True,34
e,51,kaist_dataset/English/Mobile_Phone/(E.M)B-indoor/P090903008.jpg,char_data/e/P090903008.jpg_0.jpg,1938,38,578,616,44,95,True,34
e,57,kaist_dataset/English/Mobile_Phone/(E.M)B-indoor/P090903007.jpg,char_data/e/P090903007.jpg_0.jpg,2850,50,299,349,267,324,True,34
e,59,kaist_dataset/English/Mobile_Phone/(E.M)B-indoor/P090903007.jpg,char_data/e/P090903007.jpg_0.jpg,2596,44,493,537,261,320,True,34
e,106,kaist_dataset/English/Mobile_Phone/(E.M)C-bookCover/P090831077.jpg,char_data/e/P090831077.jpg_0.jpg,7738,73,159,232,91,197,True,34
e,108,kaist_dataset/English/Mobile_Phone/(E.M)C-bookCover/P090831077.jpg,char_data/e/P090831077.jpg_0.jpg,7344,68,546,614,88,196,True,34
e,68,kaist_dataset/English/Mobile_Phone/(E.M)C-bookCover/P090831039.jpg,char_data/e/P090831039.jpg_0.jpg,4012,59,207,266,42,110,True,34
e,69,kaist_dataset/English/Mobile_Phone/(E.M)C-bookCover/P090831039.jpg,char_data/e/P090831039.jpg_0.jpg,4140,60,166,226,131,200,True,34
e,80,kaist_dataset/English/Mobile_Phone/(E.M)C-bookCover/P090903054.jpg,char_data/e/P090903054.jpg_0.jpg,6320,79,239,318,229,309,True,34
e,88,kaist_dataset/English/Mobile_Phone/(E.M)C-bookCover/P090903054.jpg,char_data/e/P090903054.jpg_0.jpg,6952,79,539,618,227,315,True,34
e,37,kaist_dataset/English/Mobile_Phone/(E.M)C-bookCover/P090903030.jpg,char_data/e/P090903030.jpg_0.jpg,851,23,134,157,79,116,True,34
e,42,kaist_dataset/English/Mobile_Phone/(E.M)C-bookCover/P090903030.jpg,char_data/e/P090903030.jpg_0.jpg,1176,28,224,252,74,116,True,34
e,33,kaist_dataset/English/Mobile_Phone/(E.M)C-bookCover/P090903030.jpg,char_data/e/P090903030.jpg_0.jpg,627,19,593,612,75,108,True,34
e,69,kaist_dataset/English/Digital_Camera/(E.S)E-night/크기변환_P1010163.JPG,char_data/e/크기변환_P1010163.JPG_0.jpg,3726,54,237,291,104,173,True,34
e,61,kaist_dataset/English/Digital_Camera/(E.S)E-night/DSC02676.JPG,char_data/e/DSC02676.JPG_0.jpg,2379,39,139,178,231,292,True,34
e,122,kaist_dataset/English/Digital_Camera/(E.S)E-night/068.jpg,char_data/e/068.jpg_0.jpg,6466,53,329,382,285,407,True,34
e,126,kaist_dataset/English/Digital_Camera/(E.S)E-night/068.jpg,char_data/e/068.jpg_0.jpg,7434,59,381,440,282,408,True,34
e,101,kaist_dataset/English/Digital_Camera/(E.S)E-night/080116-0056.jpg,char_data/e/080116-0056.jpg_0.jpg,9393,93,936,1029,527,628,True,34
e,74,kaist_dataset/English/Digital_Camera/(E.S)E-night/DSC02981.JPG,char_data/e/DSC02981.JPG_0.jpg,2146,29,353,382,379,453,True,34
e,71,kaist_dataset/English/Digital_Camera/(E.S)E-night/DSC02981.JPG,char_data/e/DSC02981.JPG_0.jpg,2698,38,383,421,379,450,True,34
e,95,kaist_dataset/English/Digital_Camera/(E.S)E-night/DSC02981.JPG,char_data/e/DSC02981.JPG_0.jpg,4370,46,385,431,194,289,True,34
e,98,kaist_dataset/English/Digital_Camera/(E.S)E-night/DSC02604.JPG,char_data/e/DSC02604.JPG_0.jpg,10094,103,268,371,240,338,True,34
e,99,kaist_dataset/English/Digital_Camera/(E.S)E-night/DSC02604.JPG,char_data/e/DSC02604.JPG_0.jpg,8910,90,369,459,239,338,True,34
e,35,kaist_dataset/English/Digital_Camera/(E.S)C-outdoor2/DSC04079.JPG,char_data/e/DSC04079.JPG_0.jpg,875,25,190,215,159,194,True,34
e,33,kaist_dataset/English/Digital_Camera/(E.S)C-outdoor2/DSC04079.JPG,char_data/e/DSC04079.JPG_0.jpg,924,28,66,94,202,235,True,34
e,41,kaist_dataset/English/Digital_Camera/(E.S)C-outdoor2/DSC04079.JPG,char_data/e/DSC04079.JPG_0.jpg,1025,25,118,143,198,239,True,34
e,36,kaist_dataset/English/Digital_Camera/(E.S)C-outdoor2/DSC04079.JPG,char_data/e/DSC04079.JPG_0.jpg,936,26,212,238,199,235,True,34
e,36,kaist_dataset/English/Digital_Camera/(E.S)C-outdoor2/DSC04079.JPG,char_data/e/DSC04079.JPG_0.jpg,864,24,267,291,200,236,True,34
e,33,kaist_dataset/English/Digital_Camera/(E.S)C-outdoor2/DSC03053.JPG,char_data/e/DSC03053.JPG_0.jpg,792,24,264,288,139,172,True,34
e,93,kaist_dataset/English/Digital_Camera/(E.S)C-outdoor2/DSC04430.JPG,char_data/e/DSC04430.JPG_0.jpg,8742,94,167,261,300,393,True,34
e,98,kaist_dataset/English/Digital_Camera/(E.S)C-outdoor2/DSC04430.JPG,char_data/e/DSC04430.JPG_0.jpg,9310,95,456,551,305,403,True,34
e,53,kaist_dataset/English/Digital_Camera/(E.S)C-outdoor2/DSC03277.JPG,char_data/e/DSC03277.JPG_0.jpg,2438,46,170,216,189,242,True,34
e,53,kaist_dataset/English/Digital_Camera/(E.S)C-outdoor2/DSC03277.JPG,char_data/e/DSC03277.JPG_0.jpg,2385,45,216,261,194,247,True,34
e,47,kaist_dataset/English/Digital_Camera/(E.S)C-outdoor2/DSC03277.JPG,char_data/e/DSC03277.JPG_0.jpg,2115,45,558,603,205,252,True,34
e,52,kaist_dataset/English/Digital_Camera/(E.S)C-outdoor2/DSC04066.JPG,char_data/e/DSC04066.JPG_0.jpg,1612,31,290,321,347,399,True,34
e,53,kaist_dataset/English/Digital_Camera/(E.S)C-outdoor2/DSC04066.JPG,char_data/e/DSC04066.JPG_0.jpg,1696,32,352,384,343,396,True,34
e,66,kaist_dataset/English/Digital_Camera/(E.S)C-outdoor2/DSC03200.JPG,char_data/e/DSC03200.JPG_0.jpg,3300,50,363,413,246,312,True,34
e,61,kaist_dataset/English/Digital_Camera/(E.S)C-outdoor2/DSC04160.JPG,char_data/e/DSC04160.JPG_0.jpg,2989,49,157,206,276,337,True,34
e,78,kaist_dataset/English/Digital_Camera/(E.S)C-outdoor2/DSC02990.JPG,char_data/e/DSC02990.JPG_0.jpg,4758,61,266,327,170,248,True,34
e,73,kaist_dataset/English/Digital_Camera/(E.S)C-outdoor2/DSC02990.JPG,char_data/e/DSC02990.JPG_0.jpg,4599,63,561,624,196,269,True,34
e,63,kaist_dataset/English/Digital_Camera/(E.S)C-outdoor2/DSC03436.JPG,char_data/e/DSC03436.JPG_0.jpg,3339,53,275,328,44,107,True,34
e,76,kaist_dataset/English/Digital_Camera/(E.S)C-outdoor2/DSC03281.JPG,char_data/e/DSC03281.JPG_0.jpg,3724,49,414,463,215,291,True,34
e,125,kaist_dataset/English/Digital_Camera/(E.S)C-outdoor2/DSC04431.JPG,char_data/e/DSC04431.JPG_0.jpg,12125,97,278,375,115,240,True,34
e,122,kaist_dataset/English/Digital_Camera/(E.S)C-outdoor2/DSC04431.JPG,char_data/e/DSC04431.JPG_0.jpg,11468,94,371,465,115,237,True,34
e,105,kaist_dataset/English/Digital_Camera/(E.S)C-outdoor2/DSC04431.JPG,char_data/e/DSC04431.JPG_0.jpg,10920,104,184,288,288,393,True,34
e,116,kaist_dataset/English/Digital_Camera/(E.S)C-outdoor2/DSC04431.JPG,char_data/e/DSC04431.JPG_0.jpg,12296,106,466,572,281,397,True,34
e,55,kaist_dataset/English/Digital_Camera/(E.S)C-outdoor2/DSC04251.JPG,char_data/e/DSC04251.JPG_0.jpg,2255,41,198,239,80,135,True,34
e,42,kaist_dataset/English/Digital_Camera/(E.S)C-outdoor2/DSC03169.JPG,char_data/e/DSC03169.JPG_0.jpg,1554,37,212,249,295,337,True,34
e,48,kaist_dataset/English/Digital_Camera/(E.S)C-outdoor2/DSC03290.JPG,char_data/e/DSC03290.JPG_0.jpg,1392,29,335,364,203,251,True,34
e,38,kaist_dataset/English/Digital_Camera/(E.S)C-outdoor2/DSC03203.JPG,char_data/e/DSC03203.JPG_0.jpg,1216,32,180,212,379,417,True,34
e,39,kaist_dataset/English/Digital_Camera/(E.S)C-outdoor2/DSC03203.JPG,char_data/e/DSC03203.JPG_0.jpg,1248,32,167,199,431,470,True,34
e,42,kaist_dataset/English/Digital_Camera/(E.S)C-outdoor2/DSC03203.JPG,char_data/e/DSC03203.JPG_0.jpg,1470,35,197,232,429,471,True,34
e,37,kaist_dataset/English/Digital_Camera/(E.S)C-outdoor2/DSC03203.JPG,char_data/e/DSC03203.JPG_0.jpg,1332,36,257,293,431,468,True,34
e,33,kaist_dataset/English/Digital_Camera/(E.S)C-outdoor2/DSC03865.JPG,char_data/e/DSC03865.JPG_0.jpg,858,26,50,76,102,135,True,34
e,40,kaist_dataset/English/Digital_Camera/(E.S)C-outdoor2/DSC03865.JPG,char_data/e/DSC03865.JPG_0.jpg,960,24,98,122,55,95,True,34
e,77,kaist_dataset/English/Digital_Camera/(E.S)C-outdoor2/IMG_2618.JPG,char_data/e/IMG_2618.JPG_0.jpg,3542,46,49,95,183,260,True,34
e,81,kaist_dataset/English/Digital_Camera/(E.S)C-outdoor2/IMG_2618.JPG,char_data/e/IMG_2618.JPG_0.jpg,2187,27,560,587,183,264,True,34
e,100,kaist_dataset/English/Digital_Camera/(E.S)C-outdoor2/DSC03300.JPG,char_data/e/DSC03300.JPG_0.jpg,8500,85,397,482,147,247,True,34
e,50,kaist_dataset/English/Digital_Camera/(E.S)C-outdoor2/DSC03000.JPG,char_data/e/DSC03000.JPG_0.jpg,1500,30,381,411,288,338,True,34
e,49,kaist_dataset/English/Digital_Camera/(E.S)C-outdoor2/DSC03000.JPG,char_data/e/DSC03000.JPG_0.jpg,1862,38,412,450,292,341,True,34
e,42,kaist_dataset/English/Digital_Camera/(E.S)C-outdoor2/DSC03167.JPG,char_data/e/DSC03167.JPG_0.jpg,1554,37,264,301,306,348,True,34
e,37,kaist_dataset/English/Digital_Camera/(E.S)C-outdoor2/DSC03294.JPG,char_data/e/DSC03294.JPG_0.jpg,925,25,441,466,313,350,True,34
e,59,kaist_dataset/English/Digital_Camera/(E.S)C-outdoor2/DSC03001.JPG,char_data/e/DSC03001.JPG_0.jpg,2419,41,565,606,178,237,True,34
e,53,kaist_dataset/English/Digital_Camera/(E.S)C-outdoor2/DSC03001.JPG,char_data/e/DSC03001.JPG_0.jpg,1643,31,607,638,180,233,True,34
e,119,kaist_dataset/English/Digital_Camera/(E.S)C-outdoor2/DSC04458.JPG,char_data/e/DSC04458.JPG_0.jpg,10948,92,314,406,299,418,True,34
e,120,kaist_dataset/English/Digital_Camera/(E.S)C-outdoor2/DSC04458.JPG,char_data/e/DSC04458.JPG_0.jpg,10800,90,182,272,142,262,True,34
e,44,kaist_dataset/English/Digital_Camera/(E.S)C-outdoor2/DSC03201.JPG,char_data/e/DSC03201.JPG_0.jpg,1408,32,218,250,83,127,True,34
e,44,kaist_dataset/English/Digital_Camera/(E.S)C-outdoor2/DSC03201.JPG,char_data/e/DSC03201.JPG_0.jpg,1276,29,334,363,147,191,True,34
e,100,kaist_dataset/English/Digital_Camera/(E.S)C-outdoor2/DSC03786.JPG,char_data/e/DSC03786.JPG_0.jpg,9700,97,471,568,334,434,True,34
e,90,kaist_dataset/English/Digital_Camera/(E.S)C-outdoor2/DSC03786.JPG,char_data/e/DSC03786.JPG_0.jpg,7560,84,428,512,63,153,True,34
e,126,kaist_dataset/English/Digital_Camera/(E.S)C-outdoor2/DSC04433.JPG,char_data/e/DSC04433.JPG_0.jpg,13482,107,448,555,143,269,True,34
e,46,kaist_dataset/English/Digital_Camera/(E.S)C-outdoor2/DSC03262.JPG,char_data/e/DSC03262.JPG_0.jpg,1702,37,345,382,148,194,True,34
e,36,kaist_dataset/English/Digital_Camera/(E.S)C-outdoor2/DSC03307.JPG,char_data/e/DSC03307.JPG_0.jpg,648,18,282,300,172,208,True,34
e,48,kaist_dataset/English/Digital_Camera/(E.S)C-outdoor2/DSC03297.JPG,char_data/e/DSC03297.JPG_0.jpg,1632,34,495,529,259,307,True,34
e,55,kaist_dataset/English/Digital_Camera/(E.S)C-outdoor2/DSC03192.JPG,char_data/e/DSC03192.JPG_0.jpg,2420,44,383,427,163,218,True,34
e,47,kaist_dataset/English/Digital_Camera/(E.S)C-outdoor2/DSC03765.JPG,char_data/e/DSC03765.JPG_0.jpg,1504,32,382,414,93,140,True,34
e,46,kaist_dataset/English/Digital_Camera/(E.S)C-outdoor2/DSC04035.JPG,char_data/e/DSC04035.JPG_0.jpg,1840,40,579,619,204,250,True,34
e,39,kaist_dataset/English/Digital_Camera/(E.S)C-outdoor2/DSC03225.JPG,char_data/e/DSC03225.JPG_0.jpg,975,25,528,553,87,126,True,34
e,38,kaist_dataset/English/Digital_Camera/(E.S)C-outdoor2/DSC03160.JPG,char_data/e/DSC03160.JPG_0.jpg,874,23,170,193,155,193,True,34
e,30,kaist_dataset/English/Digital_Camera/(E.S)C-outdoor2/DSC03160.JPG,char_data/e/DSC03160.JPG_0.jpg,660,22,194,216,155,185,True,34
e,31,kaist_dataset/English/Digital_Camera/(E.S)C-outdoor2/DSC03160.JPG,char_data/e/DSC03160.JPG_0.jpg,651,21,342,363,156,187,True,34
e,50,kaist_dataset/English/Digital_Camera/(E.S)C-outdoor2/DSC03440.JPG,char_data/e/DSC03440.JPG_0.jpg,1950,39,462,501,34,84,True,34
e,78,kaist_dataset/English/Digital_Camera/(E.S)C-outdoor2/DSC03408.JPG,char_data/e/DSC03408.JPG_0.jpg,4134,53,286,339,342,420,True,34
e,73,kaist_dataset/English/Digital_Camera/(E.S)C-outdoor2/DSC03408.JPG,char_data/e/DSC03408.JPG_0.jpg,4015,55,369,424,346,419,True,34
e,53,kaist_dataset/English/Digital_Camera/(E.S)C-outdoor2/DSC04047.JPG,char_data/e/DSC04047.JPG_0.jpg,2756,52,140,192,233,286,True,34
e,50,kaist_dataset/English/Digital_Camera/(E.S)C-outdoor2/DSC04047.JPG,char_data/e/DSC04047.JPG_0.jpg,2450,49,193,242,234,284,True,34
e,59,kaist_dataset/English/Digital_Camera/(E.S)C-outdoor2/DSC04047.JPG,char_data/e/DSC04047.JPG_0.jpg,3245,55,534,589,236,295,True,34
e,32,kaist_dataset/English/Digital_Camera/(E.S)C-outdoor2/DSC03664.JPG,char_data/e/DSC03664.JPG_0.jpg,896,28,244,272,35,67,True,34
e,36,kaist_dataset/English/Digital_Camera/(E.S)C-outdoor2/DSC03664.JPG,char_data/e/DSC03664.JPG_0.jpg,972,27,404,431,30,66,True,34
e,40,kaist_dataset/English/Digital_Camera/(E.S)C-outdoor2/DSC03664.JPG,char_data/e/DSC03664.JPG_0.jpg,1120,28,432,460,29,69,True,34
e,103,kaist_dataset/English/Digital_Camera/(E.S)C-outdoor2/DSC03663.JPG,char_data/e/DSC03663.JPG_0.jpg,7519,73,321,394,177,280,True,34
e,104,kaist_dataset/English/Digital_Camera/(E.S)C-outdoor2/DSC03663.JPG,char_data/e/DSC03663.JPG_0.jpg,8216,79,453,532,179,283,True,34
e,24,kaist_dataset/English/Digital_Camera/(E.S)C-outdoor2/DSC04437.JPG,char_data/e/DSC04437.JPG_0.jpg,312,13,268,281,80,104,True,34
e,21,kaist_dataset/English/Digital_Camera/(E.S)C-outdoor2/DSC04437.JPG,char_data/e/DSC04437.JPG_0.jpg,252,12,328,340,82,103,True,34
e,21,kaist_dataset/English/Digital_Camera/(E.S)C-outdoor2/DSC04437.JPG,char_data/e/DSC04437.JPG_0.jpg,231,11,354,365,82,103,True,34
e,26,kaist_dataset/English/Digital_Camera/(E.S)C-outdoor2/DSC04437.JPG,char_data/e/DSC04437.JPG_0.jpg,364,14,394,408,80,106,True,34
e,21,kaist_dataset/English/Digital_Camera/(E.S)C-outdoor2/DSC04437.JPG,char_data/e/DSC04437.JPG_0.jpg,210,10,424,434,83,104,True,34
e,125,kaist_dataset/English/Digital_Camera/(E.S)C-outdoor2/DSC03406.JPG,char_data/e/DSC03406.JPG_0.jpg,13625,109,334,443,46,171,True,34
e,33,kaist_dataset/English/Digital_Camera/(E.S)C-outdoor1/077.JPG,char_data/e/077.JPG_0.jpg,1155,35,290,325,209,242,True,34
e,34,kaist_dataset/English/Digital_Camera/(E.S)C-outdoor1/077.JPG,char_data/e/077.JPG_0.jpg,1224,36,440,476,207,241,True,34
e,35,kaist_dataset/English/Digital_Camera/(E.S)C-outdoor1/077.JPG,char_data/e/077.JPG_0.jpg,1365,39,475,514,206,241,True,34
e,66,kaist_dataset/English/Digital_Camera/(E.S)C-outdoor1/DSC02524.JPG,char_data/e/DSC02524.JPG_0.jpg,3432,52,530,582,335,401,True,34
e,76,kaist_dataset/English/Digital_Camera/(E.S)C-outdoor1/DSC02524.JPG,char_data/e/DSC02524.JPG_0.jpg,4104,54,579,633,330,406,True,34
e,36,kaist_dataset/English/Digital_Camera/(E.S)C-outdoor1/DSC02356.JPG,char_data/e/DSC02356.JPG_0.jpg,828,23,111,134,310,346,True,34
e,31,kaist_dataset/English/Digital_Camera/(E.S)C-outdoor1/DSC02356.JPG,char_data/e/DSC02356.JPG_0.jpg,558,18,216,234,312,343,True,34
e,34,kaist_dataset/English/Digital_Camera/(E.S)C-outdoor1/DSC02356.JPG,char_data/e/DSC02356.JPG_0.jpg,476,14,453,467,314,348,True,34
e,34,kaist_dataset/English/Digital_Camera/(E.S)C-outdoor1/DSC02356.JPG,char_data/e/DSC02356.JPG_0.jpg,782,23,467,490,312,346,True,34
e,34,kaist_dataset/English/Digital_Camera/(E.S)C-outdoor1/DSC02356.JPG,char_data/e/DSC02356.JPG_0.jpg,612,18,537,555,313,347,True,34
e,27,kaist_dataset/English/Digital_Camera/(E.S)C-outdoor1/DSC02427.JPG,char_data/e/DSC02427.JPG_0.jpg,567,21,406,427,374,401,True,34
e,25,kaist_dataset/English/Digital_Camera/(E.S)C-outdoor1/DSC02427.JPG,char_data/e/DSC02427.JPG_0.jpg,525,21,589,610,371,396,True,34
e,29,kaist_dataset/English/Digital_Camera/(E.S)C-outdoor1/DSC02427.JPG,char_data/e/DSC02427.JPG_0.jpg,667,23,610,633,371,400,True,34
e,45,kaist_dataset/English/Digital_Camera/(E.S)C-outdoor1/DSC02442.JPG,char_data/e/DSC02442.JPG_0.jpg,1485,33,220,253,176,221,True,34
e,42,kaist_dataset/English/Digital_Camera/(E.S)C-outdoor1/DSC02442.JPG,char_data/e/DSC02442.JPG_0.jpg,1470,35,276,311,178,220,True,34
e,82,kaist_dataset/English/Digital_Camera/(E.S)C-outdoor1/DSC02387.JPG,char_data/e/DSC02387.JPG_0.jpg,5658,69,308,377,210,292,True,34
e,23,kaist_dataset/English/Digital_Camera/(E.S)C-outdoor1/DSC02387.JPG,char_data/e/DSC02387.JPG_0.jpg,460,20,374,394,303,326,True,34
e,38,kaist_dataset/English/Digital_Camera/(E.S)C-outdoor1/137.JPG,char_data/e/137.JPG_0.jpg,684,18,254,272,262,300,True,34
e,84,kaist_dataset/English/Digital_Camera/(E.S)C-outdoor1/DSC02914.JPG,char_data/e/DSC02914.JPG_0.jpg,7980,95,521,616,196,280,True,34
e,39,kaist_dataset/English/Digital_Camera/(E.S)C-outdoor1/DSC02480.JPG,char_data/e/DSC02480.JPG_0.jpg,1365,35,301,336,127,166,True,34
e,42,kaist_dataset/English/Digital_Camera/(E.S)C-outdoor1/DSC02480.JPG,char_data/e/DSC02480.JPG_0.jpg,1050,25,129,154,415,457,True,34
e,23,kaist_dataset/English/Digital_Camera/(E.S)C-outdoor1/056.JPG,char_data/e/056.JPG_0.jpg,184,8,292,300,241,264,True,34
e,194,kaist_dataset/English/Digital_Camera/(E.S)C-outdoor1/080119-0036.jpg,char_data/e/080119-0036.jpg_0.jpg,19400,100,1363,1463,367,561,True,34
e,27,kaist_dataset/English/Digital_Camera/(E.S)C-outdoor1/036.jpg,char_data/e/036.jpg_0.jpg,864,32,150,182,80,107,True,34
e,33,kaist_dataset/English/Digital_Camera/(E.S)C-outdoor1/036.jpg,char_data/e/036.jpg_0.jpg,1122,34,241,275,79,112,True,34
e,39,kaist_dataset/English/Digital_Camera/(E.S)C-outdoor1/DSC02355.JPG,char_data/e/DSC02355.JPG_0.jpg,819,21,216,237,306,345,True,34
e,34,kaist_dataset/English/Digital_Camera/(E.S)C-outdoor1/DSC02355.JPG,char_data/e/DSC02355.JPG_0.jpg,578,17,277,294,308,342,True,34
e,60,kaist_dataset/English/Digital_Camera/(E.S)C-outdoor1/033.jpg,char_data/e/033.jpg_0.jpg,2820,47,69,116,58,118,False,34
e,54,kaist_dataset/English/Digital_Camera/(E.S)C-outdoor1/033.jpg,char_data/e/033.jpg_0.jpg,2538,47,181,228,62,116,False,34
e,42,kaist_dataset/English/Digital_Camera/(E.S)C-outdoor1/080119-0012.jpg,char_data/e/080119-0012.jpg_0.jpg,2184,52,893,945,572,614,False,34
e,57,kaist_dataset/English/Digital_Camera/(E.S)C-outdoor1/027.jpg,char_data/e/027.jpg_0.jpg,2907,51,146,197,123,180,False,34
e,56,kaist_dataset/English/Digital_Camera/(E.S)C-outdoor1/027.jpg,char_data/e/027.jpg_0.jpg,3360,60,400,460,109,165,False,34
e,44,kaist_dataset/English/Digital_Camera/(E.S)C-outdoor1/109.jpg,char_data/e/109.jpg_0.jpg,1672,38,265,303,189,233,False,34
e,72,kaist_dataset/English/Digital_Camera/(E.S)C-outdoor1/2007-12-08-day-111.jpg,char_data/e/2007-12-08-day-111.jpg_0.jpg,6408,89,593,682,518,590,False,34
e,61,kaist_dataset/English/Digital_Camera/(E.S)C-outdoor1/2007-12-08-day-111.jpg,char_data/e/2007-12-08-day-111.jpg_0.jpg,4575,75,727,802,522,583,False,34
e,38,kaist_dataset/English/Digital_Camera/(E.S)C-outdoor1/DSC02559.JPG,char_data/e/DSC02559.JPG_0.jpg,836,22,217,239,127,165,False,34
e,58,kaist_dataset/English/Digital_Camera/(E.S)C-outdoor1/107.jpg,char_data/e/107.jpg_0.jpg,3306,57,369,426,258,316,False,34
e,31,kaist_dataset/English/Digital_Camera/(E.S)C-outdoor1/2007-12-09-day-exterior-063.jpg,char_data/e/2007-12-09-day-exterior-063.jpg_0.jpg,651,21,223,244,552,583,False,34
e,30,kaist_dataset/English/Digital_Camera/(E.S)C-outdoor1/2007-12-09-day-exterior-063.jpg,char_data/e/2007-12-09-day-exterior-063.jpg_0.jpg,840,28,245,273,555,585,False,34
e,23,kaist_dataset/English/Digital_Camera/(E.S)C-outdoor1/DSC02417.JPG,char_data/e/DSC02417.JPG_0.jpg,460,20,501,521,186,209,False,34
e,53,kaist_dataset/English/Digital_Camera/(E.S)C-outdoor1/138.JPG,char_data/e/138.JPG_0.jpg,1643,31,279,310,255,308,False,34
e,58,kaist_dataset/English/Digital_Camera/(E.S)C-outdoor1/080116-0064.jpg,char_data/e/080116-0064.jpg_0.jpg,1914,33,356,389,252,310,False,34
e,38,kaist_dataset/English/Digital_Camera/(E.S)C-outdoor1/080116-0066.jpg,char_data/e/080116-0066.jpg_0.jpg,1368,36,442,478,360,398,False,34
e,31,kaist_dataset/English/Digital_Camera/(E.S)C-outdoor1/031.JPG,char_data/e/031.JPG_0.jpg,1364,44,302,346,435,466,False,34
e,69,kaist_dataset/English/Digital_Camera/(E.S)C-outdoor1/129.JPG,char_data/e/129.JPG_0.jpg,3036,44,347,391,224,293,False,34
e,80,kaist_dataset/English/Digital_Camera/(E.S)C-outdoor1/129.JPG,char_data/e/129.JPG_0.jpg,4000,50,410,460,213,293,False,34
e,40,kaist_dataset/English/Digital_Camera/(E.S)C-outdoor1/055.JPG,char_data/e/055.JPG_0.jpg,1600,40,103,143,207,247,False,34
e,197,kaist_dataset/English/Digital_Camera/(E.S)C-outdoor1/080119-0035.jpg,char_data/e/080119-0035.jpg_0.jpg,24034,122,1143,1265,770,967,False,34
e,43,kaist_dataset/English/Digital_Camera/(E.S)C-outdoor1/001.jpg,char_data/e/001.jpg_0.jpg,1763,41,88,129,113,156,False,34
e,63,kaist_dataset/English/Digital_Camera/(E.S)C-outdoor1/001.jpg,char_data/e/001.jpg_0.jpg,2835,45,310,355,91,154,False,34
e,53,kaist_dataset/English/Digital_Camera/(E.S)C-outdoor1/076.JPG,char_data/e/076.JPG_0.jpg,2279,43,423,466,212,265,False,34
e,21,kaist_dataset/English/Digital_Camera/(E.S)C-outdoor1/076.JPG,char_data/e/076.JPG_0.jpg,210,10,599,609,318,339,False,34
e,36,kaist_dataset/English/Digital_Camera/(E.S)C-outdoor1/DSC02918.JPG,char_data/e/DSC02918.JPG_0.jpg,972,27,130,157,236,272,False,34
e,32,kaist_dataset/English/Digital_Camera/(E.S)C-outdoor1/DSC02918.JPG,char_data/e/DSC02918.JPG_0.jpg,832,26,430,456,231,263,False,34
e,62,kaist_dataset/English/Digital_Camera/(E.S)C-outdoor1/DSC02491.JPG,char_data/e/DSC02491.JPG_0.jpg,2666,43,140,183,338,400,False,34
e,67,kaist_dataset/English/Digital_Camera/(E.S)C-outdoor1/DSC02491.JPG,char_data/e/DSC02491.JPG_0.jpg,3417,51,208,259,144,211,False,34
e,28,kaist_dataset/English/Digital_Camera/(E.S)B-light/크기변환_%B0%A3%C6%C74_fabdent.jpg,char_data/e/크기변환_%B0%A3%C6%C74_fabdent.jpg_0.jpg,392,14,242,256,261,289,False,34
e,81,kaist_dataset/English/Digital_Camera/(E.S)B-light/DSC02587.JPG,char_data/e/DSC02587.JPG_0.jpg,4860,60,200,260,198,279,False,34
e,85,kaist_dataset/English/Digital_Camera/(E.S)B-light/DSC02587.JPG,char_data/e/DSC02587.JPG_0.jpg,5950,70,467,537,338,423,False,34
e,85,kaist_dataset/English/Digital_Camera/(E.S)B-light/DSC02980.JPG,char_data/e/DSC02980.JPG_0.jpg,5865,69,513,582,182,267,False,34
e,46,kaist_dataset/English/Digital_Camera/(E.S)F-others/080119-0007.jpg,char_data/e/080119-0007.jpg_0.jpg,1564,34,861,895,825,871,False,34
e,55,kaist_dataset/English/Digital_Camera/(E.S)F-others/080119-0007.jpg,char_data/e/080119-0007.jpg_0.jpg,1705,31,144,175,740,795,False,34
e,38,kaist_dataset/English/Digital_Camera/(E.S)F-others/080119-0007.jpg,char_data/e/080119-0007.jpg_0.jpg,646,17,860,877,897,935,False,34
e,35,kaist_dataset/English/Digital_Camera/(E.S)F-others/080119-0007.jpg,char_data/e/080119-0007.jpg_0.jpg,735,21,965,986,876,911,False,34
e,45,kaist_dataset/English/Digital_Camera/(E.S)F-others/080119-0007.jpg,char_data/e/080119-0007.jpg_0.jpg,1710,38,983,1021,733,778,False,34
e,82,kaist_dataset/English/Digital_Camera/(E.S)F-others/크기변환_%B0%A3%C6%C72_ktimt007.jpg,char_data/e/크기변환_%B0%A3%C6%C72_ktimt007.jpg_0.jpg,4100,50,242,292,229,311,False,34
e,125,kaist_dataset/English/Digital_Camera/(E.S)F-others/080119-0014.jpg,char_data/e/080119-0014.jpg_0.jpg,8000,64,862,926,594,719,False,34
e,41,kaist_dataset/English/Digital_Camera/(E.S)F-others/080116-0058.jpg,char_data/e/080116-0058.jpg_0.jpg,1312,32,105,137,640,681,False,34
e,87,kaist_dataset/English/Digital_Camera/(E.S)F-others/DSC02923.JPG,char_data/e/DSC02923.JPG_0.jpg,7134,82,488,570,266,353,False,34
e,74,kaist_dataset/English/Digital_Camera/(E.S)F-others/DSC02925.JPG,char_data/e/DSC02925.JPG_0.jpg,5254,71,108,179,289,363,False,34
e,35,kaist_dataset/English/Digital_Camera/(E.S)A-shadow/DSC03075.JPG,char_data/e/DSC03075.JPG_0.jpg,1050,30,363,393,362,397,False,34
e,39,kaist_dataset/English/Digital_Camera/(E.S)A-shadow/DSC03075.JPG,char_data/e/DSC03075.JPG_0.jpg,1326,34,494,528,356,395,False,34
e,42,kaist_dataset/English/Digital_Camera/(E.S)A-shadow/DSC03082.JPG,char_data/e/DSC03082.JPG_0.jpg,756,18,169,187,387,429,False,34
e,81,kaist_dataset/English/Digital_Camera/(E.S)A-shadow/DSC02858.JPG,char_data/e/DSC02858.JPG_0.jpg,4131,51,519,570,318,399,False,34
e,85,kaist_dataset/English/Digital_Camera/(E.S)A-shadow/DSC03077.JPG,char_data/e/DSC03077.JPG_0.jpg,6885,81,271,352,351,436,False,34
e,83,kaist_dataset/English/Digital_Camera/(E.S)A-shadow/DSC03077.JPG,char_data/e/DSC03077.JPG_0.jpg,6640,80,498,578,353,436,False,34
e,68,kaist_dataset/English/Digital_Camera/(E.S)A-shadow/DSC02857.JPG,char_data/e/DSC02857.JPG_0.jpg,3128,46,539,585,209,277,False,34
e,46,kaist_dataset/English/Digital_Camera/(E.S)A-shadow/P090912074.jpg,char_data/e/P090912074.jpg_0.jpg,1518,33,459,492,85,131,False,34
e,48,kaist_dataset/English/Digital_Camera/(E.S)A-shadow/P090912074.jpg,char_data/e/P090912074.jpg_0.jpg,1392,29,521,550,85,133,False,34
e,61,kaist_dataset/English/Digital_Camera/(E.S)A-shadow/DSC03084.JPG,char_data/e/DSC03084.JPG_0.jpg,1647,27,422,449,369,430,False,34
e,62,kaist_dataset/English/Digital_Camera/(E.S)A-shadow/DSC03084.JPG,char_data/e/DSC03084.JPG_0.jpg,1860,30,549,579,369,431,False,34
e,54,kaist_dataset/English/Digital_Camera/(E.S)A-shadow/DSC03079.JPG,char_data/e/DSC03079.JPG_0.jpg,1350,25,231,256,338,392,False,34
e,51,kaist_dataset/English/Digital_Camera/(E.S)A-shadow/IMG_2647.JPG,char_data/e/IMG_2647.JPG_0.jpg,2346,46,292,338,261,312,False,34
e,55,kaist_dataset/English/Digital_Camera/(E.S)A-shadow/IMG_2647.JPG,char_data/e/IMG_2647.JPG_0.jpg,2530,46,231,277,335,390,False,34
e,50,kaist_dataset/English/Digital_Camera/(E.S)A-shadow/IMG_2647.JPG,char_data/e/IMG_2647.JPG_0.jpg,2150,43,242,285,111,161,False,34
e,54,kaist_dataset/English/Digital_Camera/(E.S)D-indoor/DSC02862.JPG,char_data/e/DSC02862.JPG_0.jpg,3240,60,133,193,249,303,False,34
e,69,kaist_dataset/English/Digital_Camera/(E.S)D-indoor/DSC02862.JPG,char_data/e/DSC02862.JPG_0.jpg,3381,49,242,291,243,312,False,34
e,51,kaist_dataset/English/Digital_Camera/(E.S)D-indoor/DSC03093.JPG,char_data/e/DSC03093.JPG_0.jpg,1785,35,279,314,142,193,False,34
e,39,kaist_dataset/English/Digital_Camera/(E.S)D-indoor/DSC03093.JPG,char_data/e/DSC03093.JPG_0.jpg,1209,31,520,551,216,255,False,34
e,34,kaist_dataset/English/Digital_Camera/(E.S)D-indoor/DSC03144.JPG,char_data/e/DSC03144.JPG_0.jpg,612,18,286,304,238,272,False,34
e,34,kaist_dataset/English/Digital_Camera/(E.S)D-indoor/DSC03144.JPG,char_data/e/DSC03144.JPG_0.jpg,680,20,280,300,291,325,False,34
e,59,kaist_dataset/English/Digital_Camera/(E.S)D-indoor/DSC03136.JPG,char_data/e/DSC03136.JPG_0.jpg,1888,32,473,505,264,323,False,34
e,42,kaist_dataset/English/Digital_Camera/(E.S)D-indoor/DSC03150.JPG,char_data/e/DSC03150.JPG_0.jpg,1470,35,153,188,40,82,False,34
e,51,kaist_dataset/English/Digital_Camera/(E.S)D-indoor/DSC03150.JPG,char_data/e/DSC03150.JPG_0.jpg,2040,40,520,560,25,76,False,34
e,35,kaist_dataset/English/Digital_Camera/(E.S)D-indoor/DSC03146.JPG,char_data/e/DSC03146.JPG_0.jpg,665,19,355,374,234,269,False,34
e,44,kaist_dataset/English/Digital_Camera/(E.S)D-indoor/DSC03345.JPG,char_data/e/DSC03345.JPG_0.jpg,1584,36,208,244,108,152,False,34
e,46,kaist_dataset/English/Digital_Camera/(E.S)D-indoor/DSC03345.JPG,char_data/e/DSC03345.JPG_0.jpg,1564,34,380,414,102,148,False,34
e,36,kaist_dataset/English/Digital_Camera/(E.S)D-indoor/DSC03090.JPG,char_data/e/DSC03090.JPG_0.jpg,900,25,247,272,243,279,False,34
e,36,kaist_dataset/English/Digital_Camera/(E.S)D-indoor/DSC03090.JPG,char_data/e/DSC03090.JPG_0.jpg,756,21,307,328,245,281,False,34
e,36,kaist_dataset/English/Digital_Camera/(E.S)D-indoor/DSC03090.JPG,char_data/e/DSC03090.JPG_0.jpg,648,18,358,376,296,332,False,34
e,59,kaist_dataset/English/Digital_Camera/(E.S)D-indoor/DSC03441.JPG,char_data/e/DSC03441.JPG_0.jpg,2537,43,282,325,390,449,False,34
e,48,kaist_dataset/English/Digital_Camera/(E.S)D-indoor/크기변환_%B0%A3%C6%C76_fabdent.jpg,char_data/e/크기변환_%B0%A3%C6%C76_fabdent.jpg_0.jpg,1008,21,198,219,191,239,False,34
e,42,kaist_dataset/English/Digital_Camera/(E.S)D-indoor/DSC03149.JPG,char_data/e/DSC03149.JPG_0.jpg,1218,29,535,564,398,440,False,34
e,30,kaist_dataset/English/Digital_Camera/(E.S)D-indoor/DSC03147.JPG,char_data/e/DSC03147.JPG_0.jpg,720,24,184,208,302,332,False,34
e,32,kaist_dataset/English/Digital_Camera/(E.S)D-indoor/DSC03147.JPG,char_data/e/DSC03147.JPG_0.jpg,864,27,187,214,241,273,False,34
e,39,kaist_dataset/English/Digital_Camera/(E.S)D-indoor/DSC02859.JPG,char_data/e/DSC02859.JPG_0.jpg,1482,38,145,183,344,383,False,34
e,49,kaist_dataset/English/Digital_Camera/(E.S)D-indoor/DSC02859.JPG,char_data/e/DSC02859.JPG_0.jpg,1813,37,513,550,349,398,False,34
e,33,kaist_dataset/English/Digital_Camera/(E.S)D-indoor/DSC03142.JPG,char_data/e/DSC03142.JPG_0.jpg,825,25,290,315,428,461,False,34
e,38,kaist_dataset/English/Digital_Camera/(E.S)D-indoor/DSC03142.JPG,char_data/e/DSC03142.JPG_0.jpg,836,22,328,350,427,465,False,34
e,36,kaist_dataset/English/Digital_Camera/(E.S)D-indoor/DSC03142.JPG,char_data/e/DSC03142.JPG_0.jpg,900,25,209,234,367,403,False,34
e,31,kaist_dataset/English/Digital_Camera/(E.S)D-indoor/DSC04023.JPG,char_data/e/DSC04023.JPG_0.jpg,961,31,94,125,308,339,False,34
e,30,kaist_dataset/English/Digital_Camera/(E.S)D-indoor/DSC04023.JPG,char_data/e/DSC04023.JPG_0.jpg,720,24,294,318,320,350,False,34
e,34,kaist_dataset/English/Digital_Camera/(E.S)D-indoor/DSC04023.JPG,char_data/e/DSC04023.JPG_0.jpg,850,25,458,483,325,359,False,34
e,30,kaist_dataset/English/Digital_Camera/(E.S)D-indoor/DSC04023.JPG,char_data/e/DSC04023.JPG_0.jpg,750,25,532,557,332,362,False,34
e,62,kaist_dataset/English/Digital_Camera/(E.S)D-indoor/DSC03074.JPG,char_data/e/DSC03074.JPG_0.jpg,1364,22,397,419,260,322,False,34
e,62,kaist_dataset/English/Digital_Camera/(E.S)D-indoor/DSC03074.JPG,char_data/e/DSC03074.JPG_0.jpg,1364,22,453,475,260,322,False,34
e,43,kaist_dataset/English/Digital_Camera/(E.S)D-indoor/DSC03376.JPG,char_data/e/DSC03376.JPG_0.jpg,1075,25,331,356,407,450,False,34
e,55,kaist_dataset/English/Digital_Camera/(E.S)D-indoor/DSC02719.JPG,char_data/e/DSC02719.JPG_0.jpg,1925,35,424,459,287,342,False,34
e,52,kaist_dataset/English/Digital_Camera/(E.S)D-indoor/DSC02719.JPG,char_data/e/DSC02719.JPG_0.jpg,1872,36,518,554,290,342,False,34
e,63,kaist_dataset/English/Digital_Camera/(E.S)D-indoor/DSC03076.JPG,char_data/e/DSC03076.JPG_0.jpg,1953,31,255,286,300,363,False,34
e,64,kaist_dataset/English/Digital_Camera/(E.S)D-indoor/DSC03076.JPG,char_data/e/DSC03076.JPG_0.jpg,2688,42,361,403,295,359,False,34
e,49,kaist_dataset/English/Digital_Camera/(E.S)D-indoor/DSC03085.JPG,char_data/e/DSC03085.JPG_0.jpg,1470,30,293,323,384,433,False,34
e,55,kaist_dataset/English/Digital_Camera/(E.S)D-indoor/DSC03085.JPG,char_data/e/DSC03085.JPG_0.jpg,1430,26,374,400,379,434,False,34
e,58,kaist_dataset/English/Digital_Camera/(E.S)D-indoor/DSC03091.JPG,char_data/e/DSC03091.JPG_0.jpg,2436,42,181,223,132,190,False,34
e,57,kaist_dataset/English/Digital_Camera/(E.S)D-indoor/DSC03091.JPG,char_data/e/DSC03091.JPG_0.jpg,2280,40,283,323,128,185,False,34
e,58,kaist_dataset/English/Digital_Camera/(E.S)D-indoor/DSC02860.JPG,char_data/e/DSC02860.JPG_0.jpg,3306,57,477,534,89,147,False,34
e,50,kaist_dataset/English/Digital_Camera/(E.S)D-indoor/DSC03395.JPG,char_data/e/DSC03395.JPG_0.jpg,1950,39,274,313,418,468,False,34
e,46,kaist_dataset/English/Digital_Camera/(E.S)D-indoor/DSC02854.JPG,char_data/e/DSC02854.JPG_0.jpg,1840,40,211,251,155,201,False,34
e,57,kaist_dataset/English/Digital_Camera/(E.S)D-indoor/DSC02854.JPG,char_data/e/DSC02854.JPG_0.jpg,1938,34,422,456,150,207,False,34
e,45,kaist_dataset/English/Digital_Camera/(E.S)D-indoor/DSC03936.JPG,char_data/e/DSC03936.JPG_0.jpg,1485,33,390,423,175,220,False,34
e,47,kaist_dataset/English/Digital_Camera/(E.S)D-indoor/DSC03936.JPG,char_data/e/DSC03936.JPG_0.jpg,1645,35,449,484,167,214,False,34
e,37,kaist_dataset/English/Digital_Camera/(E.S)D-indoor/DSC03145.JPG,char_data/e/DSC03145.JPG_0.jpg,814,22,175,197,179,216,False,34
e,29,kaist_dataset/English/Digital_Camera/(E.S)D-indoor/DSC03145.JPG,char_data/e/DSC03145.JPG_0.jpg,638,22,179,201,127,156,False,34
e,54,kaist_dataset/English/Digital_Camera/(E.S)D-indoor/DSC03087.JPG,char_data/e/DSC03087.JPG_0.jpg,2214,41,180,221,376,430,False,34
e,47,kaist_dataset/English/Digital_Camera/(E.S)D-indoor/DSC03151.JPG,char_data/e/DSC03151.JPG_0.jpg,1551,33,175,208,108,155,False,34
e,43,kaist_dataset/English/Digital_Camera/(E.S)D-indoor/DSC03151.JPG,char_data/e/DSC03151.JPG_0.jpg,1376,32,589,621,111,154,False,34
e,29,kaist_dataset/English/Digital_Camera/(E.S)D-indoor/080119-0009.jpg,char_data/e/080119-0009.jpg_0.jpg,1073,37,791,828,688,717,False,34
e,29,kaist_dataset/English/Digital_Camera/(E.S)D-indoor/080119-0009.jpg,char_data/e/080119-0009.jpg_0.jpg,1015,35,970,1005,699,728,False,34
e,29,kaist_dataset/English/Digital_Camera/(E.S)D-indoor/080119-0009.jpg,char_data/e/080119-0009.jpg_0.jpg,406,14,678,692,1050,1079,False,34
e,36,kaist_dataset/English/Digital_Camera/(E.S)D-indoor/080119-0009.jpg,char_data/e/080119-0009.jpg_0.jpg,648,18,647,665,1082,1118,False,34
e,33,kaist_dataset/English/Digital_Camera/(E.S)D-indoor/080119-0009.jpg,char_data/e/080119-0009.jpg_0.jpg,660,20,770,790,1117,1150,False,34
e,34,kaist_dataset/English/Digital_Camera/(E.S)D-indoor/080119-0009.jpg,char_data/e/080119-0009.jpg_0.jpg,510,15,746,761,997,1031,False,34
e,40,kaist_dataset/English/Digital_Camera/(E.S)D-indoor/080119-0009.jpg,char_data/e/080119-0009.jpg_0.jpg,680,17,802,819,1004,1044,False,34
e,39,kaist_dataset/English/Digital_Camera/(E.S)D-indoor/080119-0009.jpg,char_data/e/080119-0009.jpg_0.jpg,780,20,851,871,1012,1051,False,34
e,64,kaist_dataset/English/Digital_Camera/(E.S)D-indoor/DSC03141.JPG,char_data/e/DSC03141.JPG_0.jpg,3456,54,287,341,212,276,False,34
e,43,kaist_dataset/English/Digital_Camera/(E.S)D-indoor/DSC03532.JPG,char_data/e/DSC03532.JPG_0.jpg,1720,40,357,397,433,476,False,34
e,27,kaist_dataset/English/Digital_Camera/(E.S)D-indoor/DSC03532.JPG,char_data/e/DSC03532.JPG_0.jpg,432,16,229,245,386,413,False,34
e,24,kaist_dataset/English/Digital_Camera/(E.S)D-indoor/DSC03532.JPG,char_data/e/DSC03532.JPG_0.jpg,360,15,402,417,387,411,False,34
e,27,kaist_dataset/English/Digital_Camera/(E.S)D-indoor/DSC03532.JPG,char_data/e/DSC03532.JPG_0.jpg,405,15,484,499,381,408,False,34
e,37,kaist_dataset/English/Digital_Camera/(E.S)D-indoor/DSC03396.JPG,char_data/e/DSC03396.JPG_0.jpg,851,23,292,315,341,378,False,34
e,37,kaist_dataset/English/Digital_Camera/(E.S)D-indoor/DSC03112.JPG,char_data/e/DSC03112.JPG_0.jpg,962,26,447,473,213,250,False,34
e,62,kaist_dataset/English/Digital_Camera/(E.S)C-outdoor3/P1010064.JPG,char_data/e/P1010064.JPG_0.jpg,2666,43,436,479,331,393,False,34
e,43,kaist_dataset/English/Digital_Camera/(E.S)C-outdoor3/DSC03038.JPG,char_data/e/DSC03038.JPG_0.jpg,989,23,193,216,327,370,False,34
e,33,kaist_dataset/English/Digital_Camera/(E.S)C-outdoor3/DSC03038.JPG,char_data/e/DSC03038.JPG_0.jpg,990,30,326,356,318,351,False,34
e,23,kaist_dataset/English/Digital_Camera/(E.S)C-outdoor3/P1010123.JPG,char_data/e/P1010123.JPG_0.jpg,207,9,532,541,72,95,False,34
e,24,kaist_dataset/English/Digital_Camera/(E.S)C-outdoor3/P1010123.JPG,char_data/e/P1010123.JPG_0.jpg,312,13,541,554,104,128,False,34
e,19,kaist_dataset/English/Digital_Camera/(E.S)C-outdoor3/P1010123.JPG,char_data/e/P1010123.JPG_0.jpg,266,14,35,49,80,99,False,34
e,23,kaist_dataset/English/Digital_Camera/(E.S)C-outdoor3/P1010123.JPG,char_data/e/P1010123.JPG_0.jpg,322,14,40,54,112,135,False,34
1,87,"kaist_dataset/Korean/Mobile_Phone/(M,K)E-bookCover/P090831091.jpg",char_data/1/P090831091.jpg_2.jpg,3480,40,410,450,25,112,True,3
1,66,"kaist_dataset/Korean/Mobile_Phone/(M,K)E-bookCover/P090831088.jpg",char_data/1/P090831088.jpg_2.jpg,2112,32,346,378,14,80,True,3
1,82,"kaist_dataset/Korean/Mobile_Phone/(M,K)E-bookCover/P090831100.jpg",char_data/1/P090831100.jpg_2.jpg,3444,42,405,447,44,126,True,3
1,70,"kaist_dataset/Korean/Mobile_Phone/(M,K)E-bookCover/P090831087.jpg",char_data/1/P090831087.jpg_2.jpg,2310,33,352,385,24,94,True,3
1,86,"kaist_dataset/Korean/Mobile_Phone/(M,K)E-bookCover/P090831047.jpg",char_data/1/P090831047.jpg_2.jpg,1548,18,59,77,145,231,True,3
1,86,"kaist_dataset/Korean/Mobile_Phone/(M,K)E-bookCover/P090831094.jpg",char_data/1/P090831094.jpg_2.jpg,3096,36,397,433,33,119,True,3
1,88,"kaist_dataset/Korean/Mobile_Phone/(M,K)E-bookCover/P090831097.jpg",char_data/1/P090831097.jpg_2.jpg,3080,35,411,446,35,123,True,3
1,74,"kaist_dataset/Korean/Mobile_Phone/(M,K)E-bookCover/P090831082.jpg",char_data/1/P090831082.jpg_2.jpg,2442,33,342,375,34,108,True,3
1,79,"kaist_dataset/Korean/Mobile_Phone/(M,K)E-bookCover/P090831098.jpg",char_data/1/P090831098.jpg_2.jpg,2449,31,424,455,31,110,True,3
1,66,"kaist_dataset/Korean/Mobile_Phone/(M,K)E-bookCover/P090831084.jpg",char_data/1/P090831084.jpg_2.jpg,1914,29,312,341,42,108,True,3
1,72,"kaist_dataset/Korean/Mobile_Phone/(M,K)E-bookCover/P090831086.jpg",char_data/1/P090831086.jpg_2.jpg,2376,33,341,374,35,107,True,3
1,104,"kaist_dataset/Korean/Mobile_Phone/(M,K)E-bookCover/P090831105.jpg",char_data/1/P090831105.jpg_2.jpg,4056,39,521,560,97,201,True,3
1,81,"kaist_dataset/Korean/Mobile_Phone/(M,K)E-bookCover/P090831154.jpg",char_data/1/P090831154.jpg_2.jpg,3078,38,419,457,137,218,True,3
1,41,"kaist_dataset/Korean/Mobile_Phone/(M,K)E-bookCover/P090831033.jpg",char_data/1/P090831033.jpg_2.jpg,656,16,267,283,408,449,True,3
1,102,"kaist_dataset/Korean/Mobile_Phone/(M,K)E-bookCover/P090831056.jpg",char_data/1/P090831056.jpg_2.jpg,3060,30,599,629,168,270,True,3
1,77,"kaist_dataset/Korean/Mobile_Phone/(M,K)E-bookCover/P090903084.jpg",char_data/1/P090903084.jpg_2.jpg,3234,42,512,554,331,408,True,3
1,83,"kaist_dataset/Korean/Mobile_Phone/(M,K)E-bookCover/P090831096.jpg",char_data/1/P090831096.jpg_2.jpg,3154,38,399,437,41,124,True,3
1,76,"kaist_dataset/Korean/Mobile_Phone/(M,K)E-bookCover/P090831089.jpg",char_data/1/P090831089.jpg_2.jpg,3116,41,378,419,25,101,True,3
1,90,"kaist_dataset/Korean/Mobile_Phone/(M,K)E-bookCover/P090831095.jpg",char_data/1/P090831095.jpg_2.jpg,3240,36,425,461,34,124,True,3
1,81,"kaist_dataset/Korean/Mobile_Phone/(M,K)E-bookCover/P090831099.jpg",char_data/1/P090831099.jpg_2.jpg,2916,36,421,457,23,104,True,3
1,82,"kaist_dataset/Korean/Mobile_Phone/(M,K)E-bookCover/P090831090.jpg",char_data/1/P090831090.jpg_2.jpg,2952,36,422,458,30,112,True,3
1,130,"kaist_dataset/Korean/Mobile_Phone/(M,K)E-bookCover/P090911010.jpg",char_data/1/P090911010.jpg_2.jpg,8710,67,199,266,124,254,True,3
1,49,"kaist_dataset/Korean/Mobile_Phone/(M,K)C-outdoor/P090912033.jpg",char_data/1/P090912033.jpg_4.jpg,833,17,357,374,303,352,True,3
1,57,"kaist_dataset/Korean/Mobile_Phone/(M,K)C-outdoor/P090912033.jpg",char_data/1/P090912033.jpg_4.jpg,1254,22,376,398,353,410,True,3
1,126,kaist_dataset/Korean/Digital_Camera/F-bookCover/DSC04229.JPG,char_data/1/DSC04229.JPG_2.jpg,9450,75,52,127,169,295,True,3
1,152,kaist_dataset/Korean/Digital_Camera/F-bookCover/P090911043.jpg,char_data/1/P090911043.jpg_4.jpg,11248,74,12,86,147,299,True,3
1,92,kaist_dataset/Korean/Digital_Camera/F-bookCover/P090911043.jpg,char_data/1/P090911043.jpg_4.jpg,4600,50,226,276,141,233,True,3
1,79,kaist_dataset/Korean/Digital_Camera/outdoor5/DSC03790.JPG,char_data/1/DSC03790.JPG_2.jpg,3160,40,400,440,144,223,True,3
1,110,kaist_dataset/Korean/Digital_Camera/outdoor5/DSC03760.JPG,char_data/1/DSC03760.JPG_2.jpg,4180,38,343,381,65,175,True,3
1,37,kaist_dataset/Korean/Digital_Camera/outdoor5/DSC03996.JPG,char_data/1/DSC03996.JPG_2.jpg,888,24,404,428,277,314,True,3
1,43,kaist_dataset/Korean/Digital_Camera/outdoor5/DSC03979.JPG,char_data/1/DSC03979.JPG_2.jpg,1032,24,584,608,357,400,True,3
1,27,kaist_dataset/Korean/Digital_Camera/outdoor5/DSC03688.JPG,char_data/1/DSC03688.JPG_2.jpg,189,7,611,618,227,254,True,3
1,28,kaist_dataset/Korean/Digital_Camera/outdoor5/DSC03780.JPG,char_data/1/DSC03780.JPG_2.jpg,448,16,264,280,435,463,True,3
1,40,kaist_dataset/Korean/Digital_Camera/outdoor5/DSC03717.JPG,char_data/1/DSC03717.JPG_2.jpg,1040,26,233,259,350,390,True,3
1,34,kaist_dataset/Korean/Digital_Camera/outdoor5/DSC03779.JPG,char_data/1/DSC03779.JPG_4.jpg,306,9,569,578,242,276,True,3
1,32,kaist_dataset/Korean/Digital_Camera/outdoor5/DSC03779.JPG,char_data/1/DSC03779.JPG_4.jpg,608,19,601,620,246,278,True,3
1,35,kaist_dataset/Korean/Digital_Camera/outdoor5/DSC03692.JPG,char_data/1/DSC03692.JPG_4.jpg,315,9,409,418,186,221,True,3
1,36,kaist_dataset/Korean/Digital_Camera/outdoor5/DSC03692.JPG,char_data/1/DSC03692.JPG_4.jpg,432,12,420,432,186,222,True,3
1,33,kaist_dataset/Korean/Digital_Camera/outdoor5/DSC04027.JPG,char_data/1/DSC04027.JPG_6.jpg,363,11,210,221,386,419,True,3
1,32,kaist_dataset/Korean/Digital_Camera/outdoor5/DSC04027.JPG,char_data/1/DSC04027.JPG_6.jpg,320,10,335,345,386,418,True,3
1,35,kaist_dataset/Korean/Digital_Camera/outdoor5/DSC04027.JPG,char_data/1/DSC04027.JPG_6.jpg,315,9,422,431,382,417,True,3
1,36,kaist_dataset/Korean/Digital_Camera/outdoor5/DSC03671.JPG,char_data/1/DSC03671.JPG_6.jpg,540,15,322,337,410,446,True,3
1,33,kaist_dataset/Korean/Digital_Camera/outdoor5/DSC03671.JPG,char_data/1/DSC03671.JPG_6.jpg,429,13,413,426,411,444,True,3
1,38,kaist_dataset/Korean/Digital_Camera/outdoor5/DSC03671.JPG,char_data/1/DSC03671.JPG_6.jpg,570,15,543,558,408,446,True,3
1,68,kaist_dataset/Korean/Digital_Camera/outdoor5/DSC03694.JPG,char_data/1/DSC03694.JPG_4.jpg,2244,33,65,98,255,323,True,3
1,65,kaist_dataset/Korean/Digital_Camera/outdoor5/DSC03694.JPG,char_data/1/DSC03694.JPG_4.jpg,1690,26,287,313,248,313,True,3
1,29,kaist_dataset/Korean/Digital_Camera/outdoor5/DSC03752.JPG,char_data/1/DSC03752.JPG_2.jpg,232,8,204,212,411,440,True,3
1,47,kaist_dataset/Korean/Digital_Camera/outdoor5/DSC03708.JPG,char_data/1/DSC03708.JPG_4.jpg,1175,25,457,482,263,310,True,3
1,49,kaist_dataset/Korean/Digital_Camera/outdoor5/DSC03708.JPG,char_data/1/DSC03708.JPG_4.jpg,1568,32,508,540,261,310,True,3
1,35,kaist_dataset/Korean/Digital_Camera/outdoor5/DSC03778.JPG,char_data/1/DSC03778.JPG_4.jpg,490,14,374,388,342,377,True,3
1,36,kaist_dataset/Korean/Digital_Camera/outdoor5/DSC03778.JPG,char_data/1/DSC03778.JPG_4.jpg,540,15,387,402,339,375,True,3
1,33,kaist_dataset/Korean/Digital_Camera/outdoor5/DSC03794.JPG,char_data/1/DSC03794.JPG_2.jpg,462,14,270,284,367,400,True,3
1,62,kaist_dataset/Korean/Digital_Camera/outdoor5/DSC03749.JPG,char_data/1/DSC03749.JPG_2.jpg,1240,20,462,482,409,471,True,3
1,39,kaist_dataset/Korean/Digital_Camera/outdoor5/DSC03789.JPG,char_data/1/DSC03789.JPG_6.jpg,858,22,229,251,165,204,True,3
1,37,kaist_dataset/Korean/Digital_Camera/outdoor5/DSC03789.JPG,char_data/1/DSC03789.JPG_6.jpg,592,16,251,267,167,204,True,3
1,37,kaist_dataset/Korean/Digital_Camera/outdoor5/DSC03789.JPG,char_data/1/DSC03789.JPG_6.jpg,740,20,229,249,212,249,True,3
1,38,kaist_dataset/Korean/Digital_Camera/outdoor5/DSC03710.JPG,char_data/1/DSC03710.JPG_2.jpg,912,24,316,340,405,443,True,3
1,59,kaist_dataset/Korean/Digital_Camera/outdoor5/DSC03848.JPG,char_data/1/DSC03848.JPG_2.jpg,1003,17,433,450,196,255,True,3
1,39,kaist_dataset/Korean/Digital_Camera/outdoor5/DSC03777.JPG,char_data/1/DSC03777.JPG_10.jpg,429,11,90,101,338,377,True,3
1,34,kaist_dataset/Korean/Digital_Camera/outdoor5/DSC03777.JPG,char_data/1/DSC03777.JPG_10.jpg,340,10,101,111,341,375,True,3
1,33,kaist_dataset/Korean/Digital_Camera/outdoor5/DSC03777.JPG,char_data/1/DSC03777.JPG_10.jpg,429,13,183,196,343,376,True,3
1,29,kaist_dataset/Korean/Digital_Camera/outdoor5/DSC03777.JPG,char_data/1/DSC03777.JPG_10.jpg,261,9,196,205,342,371,True,3
1,29,kaist_dataset/Korean/Digital_Camera/outdoor5/DSC03777.JPG,char_data/1/DSC03777.JPG_10.jpg,232,8,206,214,341,370,True,3
1,35,kaist_dataset/Korean/Digital_Camera/outdoor5/DSC03669.JPG,char_data/1/DSC03669.JPG_2.jpg,560,16,353,369,312,347,True,3
1,29,kaist_dataset/Korean/Digital_Camera/outdoor5/DSC03636.JPG,char_data/1/DSC03636.JPG_4.jpg,290,10,303,313,158,187,True,3
1,41,kaist_dataset/Korean/Digital_Camera/outdoor5/DSC03636.JPG,char_data/1/DSC03636.JPG_4.jpg,820,20,49,69,333,374,True,3
1,35,kaist_dataset/Korean/Digital_Camera/outdoor5/DSC03641.JPG,char_data/1/DSC03641.JPG_2.jpg,490,14,496,510,421,456,True,3
1,16,kaist_dataset/Korean/Digital_Camera/outdoor5/DSC03776.JPG,char_data/1/DSC03776.JPG_4.jpg,144,9,534,543,443,459,True,3
1,17,kaist_dataset/Korean/Digital_Camera/outdoor5/DSC03776.JPG,char_data/1/DSC03776.JPG_4.jpg,153,9,557,566,442,459,True,3
1,30,kaist_dataset/Korean/Digital_Camera/outdoor4/DSC03598.JPG,char_data/1/DSC03598.JPG_2.jpg,660,22,261,283,270,300,True,3
1,58,kaist_dataset/Korean/Digital_Camera/outdoor4/DSC03592.JPG,char_data/1/DSC03592.JPG_4.jpg,1566,27,215,242,53,111,True,3
1,36,kaist_dataset/Korean/Digital_Camera/outdoor4/DSC03592.JPG,char_data/1/DSC03592.JPG_4.jpg,612,17,414,431,122,158,True,3
1,65,kaist_dataset/Korean/Digital_Camera/outdoor4/DSC03607.JPG,char_data/1/DSC03607.JPG_2.jpg,1755,27,561,588,98,163,True,3
1,48,kaist_dataset/Korean/Digital_Camera/outdoor4/DSC03614.JPG,char_data/1/DSC03614.JPG_2.jpg,960,20,475,495,382,430,True,3
1,50,kaist_dataset/Korean/Digital_Camera/outdoor4/DSC03319.JPG,char_data/1/DSC03319.JPG_4.jpg,1600,32,307,339,386,436,True,3
1,54,kaist_dataset/Korean/Digital_Camera/outdoor4/DSC03319.JPG,char_data/1/DSC03319.JPG_4.jpg,1350,25,485,510,381,435,True,3
1,48,kaist_dataset/Korean/Digital_Camera/outdoor4/DSC03602.JPG,char_data/1/DSC03602.JPG_4.jpg,1488,31,214,245,248,296,True,3
1,55,kaist_dataset/Korean/Digital_Camera/outdoor4/DSC03602.JPG,char_data/1/DSC03602.JPG_4.jpg,2035,37,274,311,249,304,True,3
1,81,kaist_dataset/Korean/Digital_Camera/outdoor4/DSC03320.JPG,char_data/1/DSC03320.JPG_2.jpg,2754,34,381,415,383,464,True,3
1,45,kaist_dataset/Korean/Digital_Camera/outdoor4/DSC03545.JPG,char_data/1/DSC03545.JPG_2.jpg,450,10,204,214,38,83,True,3
1,74,kaist_dataset/Korean/Digital_Camera/outdoor4/DSC03553.JPG,char_data/1/DSC03553.JPG_4.jpg,3552,48,343,391,175,249,True,3
1,75,kaist_dataset/Korean/Digital_Camera/outdoor4/DSC03553.JPG,char_data/1/DSC03553.JPG_4.jpg,3600,48,467,515,175,250,True,3
1,52,kaist_dataset/Korean/Digital_Camera/outdoor4/DSC03580.JPG,char_data/1/DSC03580.JPG_2.jpg,780,15,351,366,202,254,True,3
1,76,kaist_dataset/Korean/Digital_Camera/outdoor4/DSC03555.JPG,char_data/1/DSC03555.JPG_2.jpg,2888,38,154,192,348,424,True,3
1,51,kaist_dataset/Korean/Digital_Camera/outdoor4/DSC03603.JPG,char_data/1/DSC03603.JPG_6.jpg,867,17,202,219,50,101,True,3
1,41,kaist_dataset/Korean/Digital_Camera/outdoor4/DSC03603.JPG,char_data/1/DSC03603.JPG_6.jpg,1558,38,319,357,237,278,True,3
1,48,kaist_dataset/Korean/Digital_Camera/outdoor4/DSC03603.JPG,char_data/1/DSC03603.JPG_6.jpg,1728,36,188,224,384,432,True,3
1,61,kaist_dataset/Korean/Digital_Camera/outdoor2/2007-12-09-day-exterior-016.jpg,char_data/1/2007-12-09-day-exterior-016.jpg_4.jpg,1769,29,92,121,352,413,True,3
1,62,kaist_dataset/Korean/Digital_Camera/outdoor2/2007-12-09-day-exterior-016.jpg,char_data/1/2007-12-09-day-exterior-016.jpg_4.jpg,1860,30,659,689,743,805,True,3
1,21,kaist_dataset/Korean/Digital_Camera/outdoor2/DSC02314.JPG,char_data/1/DSC02314.JPG_2.jpg,252,12,413,425,205,226,True,3
1,42,kaist_dataset/Korean/Digital_Camera/outdoor2/2007-12-08-day-122.jpg,char_data/1/2007-12-08-day-122.jpg_0.jpg,798,19,1353,1372,554,596,True,3
1,51,kaist_dataset/Korean/Digital_Camera/outdoor2/2007-12-08-day-122.jpg,char_data/1/2007-12-08-day-122.jpg_0.jpg,1275,25,1373,1398,553,604,True,3
1,46,kaist_dataset/Korean/Digital_Camera/outdoor2/2007-12-09-day-exterior-084.jpg,char_data/1/2007-12-09-day-exterior-084.jpg_0.jpg,1610,35,981,1016,791,837,True,3
1,39,kaist_dataset/Korean/Digital_Camera/outdoor2/DSC02396.JPG,char_data/1/DSC02396.JPG_0.jpg,624,16,175,191,182,221,True,3
1,37,kaist_dataset/Korean/Digital_Camera/outdoor2/080119-0031.jpg,char_data/1/080119-0031.jpg_0.jpg,407,11,621,632,1113,1150,True,3
1,39,kaist_dataset/Korean/Digital_Camera/outdoor2/080119-0031.jpg,char_data/1/080119-0031.jpg_0.jpg,507,13,662,675,1113,1152,True,3
1,42,kaist_dataset/Korean/Digital_Camera/outdoor2/080119-0031.jpg,char_data/1/080119-0031.jpg_0.jpg,462,11,761,772,1118,1160,True,3
1,37,kaist_dataset/Korean/Digital_Camera/outdoor2/080119-0031.jpg,char_data/1/080119-0031.jpg_0.jpg,555,15,774,789,1121,1158,True,3
1,40,kaist_dataset/Korean/Digital_Camera/outdoor2/080119-0031.jpg,char_data/1/080119-0031.jpg_0.jpg,840,21,1168,1189,1123,1163,True,3
1,28,kaist_dataset/Korean/Digital_Camera/outdoor2/DSC02424.JPG,char_data/1/DSC02424.JPG_0.jpg,336,12,545,557,244,272,True,3
1,105,kaist_dataset/Korean/Digital_Camera/outdoor2/DSC02486.JPG,char_data/1/DSC02486.JPG_0.jpg,3465,33,38,71,240,345,True,3
1,104,kaist_dataset/Korean/Digital_Camera/outdoor2/DSC02486.JPG,char_data/1/DSC02486.JPG_0.jpg,3016,29,69,98,239,343,True,3
1,109,kaist_dataset/Korean/Digital_Camera/outdoor2/DSC02486.JPG,char_data/1/DSC02486.JPG_0.jpg,3052,28,219,247,238,347,True,3
1,36,kaist_dataset/Korean/Digital_Camera/outdoor2/DSC02381.JPG,char_data/1/DSC02381.JPG_0.jpg,936,26,357,383,321,357,True,3
1,48,kaist_dataset/Korean/Digital_Camera/outdoor2/DSC02414.JPG,char_data/1/DSC02414.JPG_0.jpg,1536,32,142,174,239,287,True,3
1,47,kaist_dataset/Korean/Digital_Camera/outdoor2/DSC02414.JPG,char_data/1/DSC02414.JPG_0.jpg,1316,28,174,202,241,288,True,3
1,43,kaist_dataset/Korean/Digital_Camera/outdoor2/DSC02414.JPG,char_data/1/DSC02414.JPG_0.jpg,1634,38,516,554,242,285,True,3
1,34,kaist_dataset/Korean/Digital_Camera/outdoor2/DSC02311.JPG,char_data/1/DSC02311.JPG_0.jpg,884,26,598,624,252,286,True,3
1,34,kaist_dataset/Korean/Digital_Camera/outdoor2/DSC02383.JPG,char_data/1/DSC02383.JPG_0.jpg,408,12,81,93,294,328,True,3
1,33,kaist_dataset/Korean/Digital_Camera/outdoor2/DSC02383.JPG,char_data/1/DSC02383.JPG_0.jpg,264,8,93,101,295,328,True,3
1,26,kaist_dataset/Korean/Digital_Camera/outdoor2/DSC02383.JPG,char_data/1/DSC02383.JPG_0.jpg,234,9,163,172,294,320,True,3
1,29,kaist_dataset/Korean/Digital_Camera/outdoor2/DSC02383.JPG,char_data/1/DSC02383.JPG_0.jpg,261,9,174,183,293,322,True,3
1,29,kaist_dataset/Korean/Digital_Camera/outdoor2/DSC02373.JPG,char_data/1/DSC02373.JPG_0.jpg,319,11,393,404,334,363,True,3
1,59,kaist_dataset/Korean/Digital_Camera/outdoor2/DSC02512.JPG,char_data/1/DSC02512.JPG_0.jpg,1475,25,606,631,290,349,True,3
1,65,kaist_dataset/Korean/Digital_Camera/outdoor2/2007-12-09-day-exterior-035.jpg,char_data/1/2007-12-09-day-exterior-035.jpg_0.jpg,1885,29,633,662,705,770,True,3
1,71,kaist_dataset/Korean/Digital_Camera/outdoor2/2007-12-09-day-exterior-009.jpg,char_data/1/2007-12-09-day-exterior-009.jpg_0.jpg,2272,32,865,897,661,732,True,3
1,83,kaist_dataset/Korean/Digital_Camera/outdoor2/2007-12-09-day-exterior-009.jpg,char_data/1/2007-12-09-day-exterior-009.jpg_0.jpg,1992,24,937,961,652,735,True,3
1,28,kaist_dataset/Korean/Digital_Camera/outdoor2/DSC02506.JPG,char_data/1/DSC02506.JPG_0.jpg,504,18,300,318,437,465,True,3
1,44,kaist_dataset/Korean/Digital_Camera/outdoor2/DSC02488.JPG,char_data/1/DSC02488.JPG_0.jpg,484,11,596,607,368,412,True,3
1,35,kaist_dataset/Korean/Digital_Camera/outdoor2/DSC02488.JPG,char_data/1/DSC02488.JPG_0.jpg,560,16,607,623,371,406,True,3
1,127,kaist_dataset/Korean/Digital_Camera/outdoor2/DSC02520.JPG,char_data/1/DSC02520.JPG_0.jpg,3429,27,288,315,302,429,True,3
1,29,kaist_dataset/Korean/Digital_Camera/outdoor2/DSC02470.JPG,char_data/1/DSC02470.JPG_0.jpg,406,14,520,534,164,193,True,3
1,37,kaist_dataset/Korean/Digital_Camera/outdoor2/DSC02521.JPG,char_data/1/DSC02521.JPG_0.jpg,592,16,420,436,324,361,True,3
1,48,kaist_dataset/Korean/Digital_Camera/outdoor2/DSC02523.JPG,char_data/1/DSC02523.JPG_0.jpg,960,20,496,516,334,382,True,3
1,46,kaist_dataset/Korean/Digital_Camera/E-night/DSC03861.JPG,char_data/1/DSC03861.JPG_0.jpg,1196,26,270,296,417,463,True,3
1,44,kaist_dataset/Korean/Digital_Camera/E-night/DSC03523.JPG,char_data/1/DSC03523.JPG_0.jpg,880,20,550,570,333,377,True,3
1,42,kaist_dataset/Korean/Digital_Camera/E-night/DSC02662.JPG,char_data/1/DSC02662.JPG_0.jpg,840,20,508,528,370,412,True,3
1,27,kaist_dataset/Korean/Digital_Camera/E-night/P1010146.JPG,char_data/1/P1010146.JPG_0.jpg,324,12,205,217,251,278,True,3
1,35,kaist_dataset/Korean/Digital_Camera/E-night/P1010146.JPG,char_data/1/P1010146.JPG_0.jpg,770,22,359,381,248,283,True,3
1,71,kaist_dataset/Korean/Digital_Camera/E-night/DSC03870.JPG,char_data/1/DSC03870.JPG_0.jpg,1349,19,254,273,126,197,True,3
1,45,kaist_dataset/Korean/Digital_Camera/E-night/DSC03870.JPG,char_data/1/DSC03870.JPG_0.jpg,810,18,324,342,149,194,True,3
1,20,kaist_dataset/Korean/Digital_Camera/E-night/DSC03870.JPG,char_data/1/DSC03870.JPG_0.jpg,260,13,359,372,226,246,True,3
1,24,kaist_dataset/Korean/Digital_Camera/E-night/DSC03870.JPG,char_data/1/DSC03870.JPG_0.jpg,264,11,383,394,225,249,True,3
1,95,kaist_dataset/Korean/Digital_Camera/E-night/DSC02631.JPG,char_data/1/DSC02631.JPG_0.jpg,3705,39,33,72,197,292,True,3
1,44,kaist_dataset/Korean/Digital_Camera/E-night/DSC02658.JPG,char_data/1/DSC02658.JPG_0.jpg,792,18,388,406,350,394,True,3
1,41,kaist_dataset/Korean/Digital_Camera/E-night/DSC02658.JPG,char_data/1/DSC02658.JPG_0.jpg,820,20,470,490,354,395,True,3
1,30,kaist_dataset/Korean/Digital_Camera/E-night/DSC02626.JPG,char_data/1/DSC02626.JPG_0.jpg,390,13,231,244,369,399,True,3
1,37,kaist_dataset/Korean/Digital_Camera/E-night/DSC02626.JPG,char_data/1/DSC02626.JPG_0.jpg,481,13,286,299,364,401,True,3
1,37,kaist_dataset/Korean/Digital_Camera/E-night/DSC02626.JPG,char_data/1/DSC02626.JPG_0.jpg,740,20,297,317,364,401,True,3
1,34,kaist_dataset/Korean/Digital_Camera/E-night/DSC02626.JPG,char_data/1/DSC02626.JPG_0.jpg,442,13,362,375,363,397,True,3
1,34,kaist_dataset/Korean/Digital_Camera/E-night/DSC02626.JPG,char_data/1/DSC02626.JPG_0.jpg,1054,31,373,404,362,396,True,3
1,60,kaist_dataset/Korean/Digital_Camera/E-night/DSC03019.JPG,char_data/1/DSC03019.JPG_0.jpg,1560,26,432,458,177,237,True,3
1,42,kaist_dataset/Korean/Digital_Camera/E-night/DSC03515.JPG,char_data/1/DSC03515.JPG_0.jpg,714,17,403,420,272,314,True,3
1,45,kaist_dataset/Korean/Digital_Camera/E-night/DSC03515.JPG,char_data/1/DSC03515.JPG_0.jpg,810,18,420,438,269,314,True,3
1,38,kaist_dataset/Korean/Digital_Camera/E-night/DSC03515.JPG,char_data/1/DSC03515.JPG_0.jpg,608,16,491,507,274,312,True,3
1,40,kaist_dataset/Korean/Digital_Camera/indoor1/DSC03375.JPG,char_data/1/DSC03375.JPG_0.jpg,840,21,154,175,38,78,True,3
1,94,kaist_dataset/Korean/Digital_Camera/indoor1/080119-0030.jpg,char_data/1/080119-0030.jpg_0.jpg,3572,38,848,886,429,523,True,3
1,35,kaist_dataset/Korean/Digital_Camera/indoor1/DSC02700.JPG,char_data/1/DSC02700.JPG_0.jpg,525,15,158,173,423,458,True,3
1,34,kaist_dataset/Korean/Digital_Camera/indoor1/DSC03362.JPG,char_data/1/DSC03362.JPG_0.jpg,340,10,97,107,278,312,True,3
1,63,kaist_dataset/Korean/Digital_Camera/indoor1/080119-0018.jpg,char_data/1/080119-0018.jpg_0.jpg,1575,25,887,912,438,501,True,3
1,50,kaist_dataset/Korean/Digital_Camera/indoor1/080119-0018.jpg,char_data/1/080119-0018.jpg_0.jpg,1100,22,1035,1057,934,984,True,3
1,43,kaist_dataset/Korean/Digital_Camera/indoor1/080119-0018.jpg,char_data/1/080119-0018.jpg_0.jpg,860,20,1159,1179,940,983,True,3
1,45,kaist_dataset/Korean/Digital_Camera/indoor1/080119-0018.jpg,char_data/1/080119-0018.jpg_0.jpg,1080,24,1181,1205,936,981,True,3
1,40,kaist_dataset/Korean/Digital_Camera/outdoor7/P1010091.JPG,char_data/1/P1010091.JPG_0.jpg,680,17,399,416,227,267,True,3
1,25,kaist_dataset/Korean/Digital_Camera/outdoor7/P1010107.JPG,char_data/1/P1010107.JPG_0.jpg,425,17,331,348,229,254,True,3
1,25,kaist_dataset/Korean/Digital_Camera/outdoor7/P1010107.JPG,char_data/1/P1010107.JPG_0.jpg,400,16,363,379,229,254,True,3
1,39,kaist_dataset/Korean/Digital_Camera/outdoor7/P1010069.JPG,char_data/1/P1010069.JPG_0.jpg,585,15,542,557,315,354,True,3
1,34,kaist_dataset/Korean/Digital_Camera/outdoor7/P1010003.JPG,char_data/1/P1010003.JPG_0.jpg,714,21,375,396,278,312,True,3
1,66,kaist_dataset/Korean/Digital_Camera/outdoor7/P1010080.JPG,char_data/1/P1010080.JPG_0.jpg,1848,28,390,418,191,257,True,3
1,64,kaist_dataset/Korean/Digital_Camera/outdoor7/P1010068.JPG,char_data/1/P1010068.JPG_0.jpg,1856,29,141,170,272,336,True,3
1,34,kaist_dataset/Korean/Digital_Camera/outdoor7/P1010004.JPG,char_data/1/P1010004.JPG_0.jpg,408,12,468,480,295,329,True,3
1,33,kaist_dataset/Korean/Digital_Camera/outdoor7/P1010004.JPG,char_data/1/P1010004.JPG_0.jpg,495,15,556,571,296,329,True,3
1,33,kaist_dataset/Korean/Digital_Camera/outdoor7/P1010004.JPG,char_data/1/P1010004.JPG_0.jpg,297,9,582,591,293,326,True,3
1,52,kaist_dataset/Korean/Digital_Camera/outdoor7/P1010023.JPG,char_data/1/P1010023.JPG_0.jpg,1404,27,79,106,292,344,True,3
1,57,kaist_dataset/Korean/Digital_Camera/outdoor7/P1010023.JPG,char_data/1/P1010023.JPG_0.jpg,1539,27,343,370,285,342,True,3
1,56,kaist_dataset/Korean/Digital_Camera/outdoor7/P1010023.JPG,char_data/1/P1010023.JPG_0.jpg,1232,22,370,392,283,339,True,3
1,39,kaist_dataset/Korean/Digital_Camera/outdoor7/P1010061.JPG,char_data/1/P1010061.JPG_0.jpg,858,22,443,465,319,358,True,3
1,35,kaist_dataset/Korean/Digital_Camera/outdoor8/P1010189.JPG,char_data/1/P1010189.JPG_0.jpg,770,22,120,142,232,267,True,3
1,70,kaist_dataset/Korean/Digital_Camera/outdoor8/P1010181.JPG,char_data/1/P1010181.JPG_0.jpg,1610,23,440,463,195,265,True,3
1,88,kaist_dataset/Korean/Digital_Camera/outdoor8/P1010181.JPG,char_data/1/P1010181.JPG_0.jpg,2992,34,445,479,293,381,True,3
1,64,kaist_dataset/Korean/Digital_Camera/outdoor8/P1010172.JPG,char_data/1/P1010172.JPG_0.jpg,1728,27,331,358,226,290,True,3
1,71,kaist_dataset/Korean/Digital_Camera/outdoor8/P1010160.JPG,char_data/1/P1010160.JPG_0.jpg,2485,35,339,374,224,295,True,3
1,52,kaist_dataset/Korean/Digital_Camera/outdoor8/P1010171.JPG,char_data/1/P1010171.JPG_0.jpg,1196,23,517,540,227,279,True,3
1,54,kaist_dataset/Korean/Digital_Camera/outdoor8/P1010171.JPG,char_data/1/P1010171.JPG_0.jpg,1296,24,569,593,228,282,True,3
1,49,kaist_dataset/Korean/Digital_Camera/outdoor8/P1010147.JPG,char_data/1/P1010147.JPG_0.jpg,1078,22,467,489,314,363,True,3
1,34,kaist_dataset/Korean/Digital_Camera/outdoor8/P1011112.JPG,char_data/1/P1011112.JPG_0.jpg,442,13,473,486,222,256,True,3
1,39,kaist_dataset/Korean/Digital_Camera/outdoor8/P1011112.JPG,char_data/1/P1011112.JPG_0.jpg,468,12,486,498,221,260,True,3
1,34,kaist_dataset/Korean/Digital_Camera/indoor2/DSC03564.JPG,char_data/1/DSC03564.JPG_0.jpg,408,12,275,287,405,439,True,3
1,53,kaist_dataset/Korean/Digital_Camera/indoor2/DSC03563.JPG,char_data/1/DSC03563.JPG_0.jpg,1325,25,482,507,257,310,True,3
1,78,kaist_dataset/Korean/Digital_Camera/indoor2/DSC03902.JPG,char_data/1/DSC03902.JPG_0.jpg,2106,27,90,117,128,206,True,3
1,37,kaist_dataset/Korean/Digital_Camera/indoor2/DSC03983.JPG,char_data/1/DSC03983.JPG_0.jpg,629,17,326,343,323,360,True,3
1,34,kaist_dataset/Korean/Digital_Camera/indoor2/DSC03983.JPG,char_data/1/DSC03983.JPG_0.jpg,714,21,351,372,324,358,True,3
1,51,kaist_dataset/Korean/Digital_Camera/indoor2/DSC03560.JPG,char_data/1/DSC03560.JPG_0.jpg,1224,24,344,368,66,117,True,3
1,69,kaist_dataset/Korean/Digital_Camera/indoor2/P071209063.jpg,char_data/1/P071209063.jpg_0.jpg,3381,49,1075,1124,1069,1138,True,3
1,73,kaist_dataset/Korean/Digital_Camera/indoor2/P071209063.jpg,char_data/1/P071209063.jpg_0.jpg,3504,48,1181,1229,1062,1135,True,3
1,77,kaist_dataset/Korean/Digital_Camera/indoor2/P071209063.jpg,char_data/1/P071209063.jpg_0.jpg,3696,48,1339,1387,1055,1132,True,3
1,50,kaist_dataset/Korean/Digital_Camera/indoor2/DSC04204.JPG,char_data/1/DSC04204.JPG_0.jpg,1400,28,223,251,203,253,True,3
1,45,kaist_dataset/Korean/Digital_Camera/indoor2/DSC03995.JPG,char_data/1/DSC03995.JPG_0.jpg,855,19,456,475,266,311,True,3
1,49,kaist_dataset/Korean/Digital_Camera/indoor2/DSC03994.JPG,char_data/1/DSC03994.JPG_0.jpg,1274,26,372,398,285,334,True,3
1,32,kaist_dataset/Korean/Digital_Camera/indoor2/DSC03975.JPG,char_data/1/DSC03975.JPG_0.jpg,384,12,258,270,287,319,True,3
1,54,kaist_dataset/Korean/Digital_Camera/G-others/2007-12-09-day-exterior-083.jpg,char_data/1/2007-12-09-day-exterior-083.jpg_0.jpg,1944,36,564,600,118,172,True,3
1,31,kaist_dataset/Korean/Digital_Camera/G-others/DSC03863.JPG,char_data/1/DSC03863.JPG_0.jpg,527,17,254,271,408,439,True,3
1,44,kaist_dataset/Korean/Digital_Camera/G-others/2007-12-08-day-045.jpg,char_data/1/2007-12-08-day-045.jpg_0.jpg,616,14,56,70,801,845,True,3
1,57,kaist_dataset/Korean/Digital_Camera/G-others/005.JPG,char_data/1/005.JPG_0.jpg,2451,43,219,262,315,372,True,3
1,21,kaist_dataset/Korean/Digital_Camera/G-others/2007-12-08-day-112.jpg,char_data/1/2007-12-08-day-112.jpg_0.jpg,294,14,371,385,1168,1189,True,3
1,48,kaist_dataset/Korean/Digital_Camera/G-others/DSC03862.JPG,char_data/1/DSC03862.JPG_0.jpg,528,11,292,303,349,397,True,3
1,91,kaist_dataset/Korean/Digital_Camera/G-others/2007-12-08-day-108.jpg,char_data/1/2007-12-08-day-108.jpg_0.jpg,2730,30,623,653,687,778,True,3
1,28,kaist_dataset/Korean/Digital_Camera/B-light/DSC02987.JPG,char_data/1/DSC02987.JPG_0.jpg,364,13,435,448,278,306,True,3
1,57,kaist_dataset/Korean/Digital_Camera/outdoor6/DSC04143.JPG,char_data/1/DSC04143.JPG_0.jpg,1710,30,414,444,358,415,True,3
1,30,kaist_dataset/Korean/Digital_Camera/outdoor6/DSC04062.JPG,char_data/1/DSC04062.JPG_0.jpg,210,7,565,572,305,335,True,3
1,49,kaist_dataset/Korean/Digital_Camera/outdoor6/DSC04136.JPG,char_data/1/DSC04136.JPG_0.jpg,1029,21,331,352,327,376,True,3
1,48,kaist_dataset/Korean/Digital_Camera/outdoor6/DSC04400.JPG,char_data/1/DSC04400.JPG_0.jpg,1152,24,422,446,218,266,True,3
1,45,kaist_dataset/Korean/Digital_Camera/outdoor6/DSC04400.JPG,char_data/1/DSC04400.JPG_0.jpg,1035,23,374,397,396,441,True,3
1,25,kaist_dataset/Korean/Digital_Camera/outdoor6/DSC04343.JPG,char_data/1/DSC04343.JPG_0.jpg,425,17,368,385,208,233,True,3
1,33,kaist_dataset/Korean/Digital_Camera/outdoor6/DSC04343.JPG,char_data/1/DSC04343.JPG_0.jpg,759,23,426,449,202,235,True,3
1,36,kaist_dataset/Korean/Digital_Camera/outdoor6/DSC04339.JPG,char_data/1/DSC04339.JPG_0.jpg,756,21,354,375,211,247,True,3
1,45,kaist_dataset/Korean/Digital_Camera/outdoor6/DSC04148.JPG,char_data/1/DSC04148.JPG_0.jpg,855,19,395,414,201,246,True,3
1,42,kaist_dataset/Korean/Digital_Camera/outdoor6/DSC04148.JPG,char_data/1/DSC04148.JPG_0.jpg,840,20,414,434,202,244,True,3
1,21,kaist_dataset/Korean/Digital_Camera/outdoor6/DSC04042.JPG,char_data/1/DSC04042.JPG_0.jpg,315,15,110,125,333,354,True,3
1,80,kaist_dataset/Korean/Digital_Camera/outdoor6/DSC04096.JPG,char_data/1/DSC04096.JPG_0.jpg,2720,34,341,375,226,306,True,3
1,33,kaist_dataset/Korean/Digital_Camera/outdoor6/DSC04112.JPG,char_data/1/DSC04112.JPG_0.jpg,396,12,348,360,273,306,True,3
1,37,kaist_dataset/Korean/Digital_Camera/outdoor6/DSC04112.JPG,char_data/1/DSC04112.JPG_0.jpg,481,13,484,497,271,308,True,3
1,37,kaist_dataset/Korean/Digital_Camera/outdoor6/DSC04112.JPG,char_data/1/DSC04112.JPG_0.jpg,407,11,497,508,271,308,True,3
1,58,kaist_dataset/Korean/Digital_Camera/outdoor6/DSC04296.JPG,char_data/1/DSC04296.JPG_0.jpg,928,16,212,228,315,373,True,3
1,55,kaist_dataset/Korean/Digital_Camera/outdoor6/DSC04100.JPG,char_data/1/DSC04100.JPG_0.jpg,715,13,290,303,50,105,True,3
1,52,kaist_dataset/Korean/Digital_Camera/outdoor6/DSC04118.JPG,char_data/1/DSC04118.JPG_0.jpg,1300,25,256,281,253,305,True,3
1,52,kaist_dataset/Korean/Digital_Camera/outdoor6/DSC04118.JPG,char_data/1/DSC04118.JPG_0.jpg,1560,30,426,456,258,310,True,3
1,49,kaist_dataset/Korean/Digital_Camera/outdoor6/DSC04118.JPG,char_data/1/DSC04118.JPG_0.jpg,1323,27,485,512,257,306,True,3
1,79,kaist_dataset/Korean/Digital_Camera/A-shadow/DSC03755.JPG,char_data/1/DSC03755.JPG_0.jpg,1975,25,217,242,206,285,True,3
1,45,kaist_dataset/Korean/Digital_Camera/A-shadow/2007-12-09-day-exterior-025.jpg,char_data/1/2007-12-09-day-exterior-025.jpg_0.jpg,945,21,982,1003,735,780,True,3
1,68,kaist_dataset/Korean/Digital_Camera/A-shadow/DSC03536.JPG,char_data/1/DSC03536.JPG_0.jpg,2516,37,393,430,245,313,True,3
1,71,kaist_dataset/Korean/Digital_Camera/A-shadow/DSC03536.JPG,char_data/1/DSC03536.JPG_0.jpg,2840,40,431,471,238,309,True,3
1,74,kaist_dataset/Korean/Digital_Camera/A-shadow/DSC03793.JPG,char_data/1/DSC03793.JPG_0.jpg,3182,43,104,147,166,240,True,3
1,112,kaist_dataset/Korean/Digital_Camera/A-shadow/104.JPG,char_data/1/104.JPG_0.jpg,4928,44,458,502,347,459,True,3
1,32,kaist_dataset/Korean/Digital_Camera/A-shadow/DSC04297.JPG,char_data/1/DSC04297.JPG_0.jpg,416,13,347,360,206,238,True,3
1,73,kaist_dataset/Korean/Digital_Camera/A-shadow/DSC03535.JPG,char_data/1/DSC03535.JPG_0.jpg,1971,27,352,379,246,319,True,3
1,137,kaist_dataset/Korean/Digital_Camera/A-shadow/DSC04300.JPG,char_data/1/DSC04300.JPG_0.jpg,7946,58,451,509,237,374,True,3
1,30,kaist_dataset/Korean/Digital_Camera/outdoor3/DSC02546.JPG,char_data/1/DSC02546.JPG_0.jpg,360,12,182,194,425,455,True,3
1,35,kaist_dataset/Korean/Digital_Camera/outdoor3/DSC02943.JPG,char_data/1/DSC02943.JPG_0.jpg,595,17,418,435,434,469,True,3
1,30,kaist_dataset/Korean/Digital_Camera/outdoor3/DSC02943.JPG,char_data/1/DSC02943.JPG_0.jpg,780,26,436,462,440,470,True,3
1,31,kaist_dataset/Korean/Digital_Camera/outdoor3/DSC02944.JPG,char_data/1/DSC02944.JPG_0.jpg,527,17,323,340,231,262,True,3
1,45,kaist_dataset/Korean/Digital_Camera/outdoor3/DSC02698.JPG,char_data/1/DSC02698.JPG_0.jpg,765,17,223,240,399,444,True,3
1,76,kaist_dataset/Korean/Digital_Camera/outdoor3/DSC02562.JPG,char_data/1/DSC02562.JPG_0.jpg,2204,29,268,297,358,434,True,3
1,64,kaist_dataset/Korean/Digital_Camera/outdoor3/DSC02953.JPG,char_data/1/DSC02953.JPG_0.jpg,1728,27,465,492,384,448,True,3
1,48,kaist_dataset/Korean/Digital_Camera/outdoor3/DSC03237.JPG,char_data/1/DSC03237.JPG_0.jpg,912,19,306,325,395,443,True,3
1,51,kaist_dataset/Korean/Digital_Camera/outdoor3/DSC03064.JPG,char_data/1/DSC03064.JPG_0.jpg,1020,20,279,299,344,395,True,3
1,28,kaist_dataset/Korean/Digital_Camera/outdoor3/DSC02529.JPG,char_data/1/DSC02529.JPG_0.jpg,196,7,506,513,372,400,True,3
1,53,kaist_dataset/Korean/Digital_Camera/outdoor3/DSC02972.JPG,char_data/1/DSC02972.JPG_0.jpg,1643,31,318,349,42,95,True,3
1,45,kaist_dataset/Korean/Digital_Camera/outdoor3/DSC02994.JPG,char_data/1/DSC02994.JPG_0.jpg,855,19,322,341,288,333,True,3
1,50,kaist_dataset/Korean/Digital_Camera/outdoor3/DSC02697.JPG,char_data/1/DSC02697.JPG_0.jpg,1100,22,156,178,377,427,True,3
1,50,kaist_dataset/Korean/Digital_Camera/outdoor3/DSC02697.JPG,char_data/1/DSC02697.JPG_0.jpg,1150,23,340,363,378,428,True,3
1,56,kaist_dataset/Korean/Digital_Camera/outdoor3/DSC02697.JPG,char_data/1/DSC02697.JPG_0.jpg,1176,21,365,386,376,432,True,3
1,45,kaist_dataset/Korean/Digital_Camera/outdoor3/DSC02957.JPG,char_data/1/DSC02957.JPG_0.jpg,1080,24,381,405,408,453,True,3
1,47,kaist_dataset/Korean/Digital_Camera/outdoor3/DSC02957.JPG,char_data/1/DSC02957.JPG_0.jpg,940,20,407,427,406,453,True,3
1,50,kaist_dataset/Korean/Digital_Camera/outdoor3/DSC02957.JPG,char_data/1/DSC02957.JPG_0.jpg,1400,28,427,455,404,454,True,3
1,63,kaist_dataset/Korean/Digital_Camera/outdoor3/DSC03195.JPG,char_data/1/DSC03195.JPG_0.jpg,2016,32,228,260,249,312,True,3
1,30,kaist_dataset/Korean/Digital_Camera/outdoor3/DSC02888.JPG,char_data/1/DSC02888.JPG_0.jpg,570,19,259,278,422,452,True,3
1,37,kaist_dataset/Korean/Digital_Camera/outdoor3/DSC02939.JPG,char_data/1/DSC02939.JPG_0.jpg,518,14,479,493,369,406,True,3
1,44,kaist_dataset/Korean/Digital_Camera/outdoor3/DSC02561.JPG,char_data/1/DSC02561.JPG_0.jpg,792,18,263,281,351,395,True,3
1,35,kaist_dataset/Korean/Digital_Camera/outdoor3/DSC02561.JPG,char_data/1/DSC02561.JPG_0.jpg,840,24,418,442,354,389,True,3
1,28,kaist_dataset/Korean/Digital_Camera/outdoor1/071.JPG,char_data/1/071.JPG_0.jpg,532,19,316,335,259,287,True,3
1,25,kaist_dataset/Korean/Digital_Camera/outdoor1/017.JPG,char_data/1/017.JPG_0.jpg,250,10,475,485,269,294,True,3
1,43,kaist_dataset/Korean/Digital_Camera/outdoor1/091.JPG,char_data/1/091.JPG_0.jpg,817,19,386,405,284,327,True,3
1,28,kaist_dataset/Korean/Digital_Camera/outdoor1/028.JPG,char_data/1/028.JPG_0.jpg,392,14,311,325,263,291,True,3
1,31,kaist_dataset/Korean/Digital_Camera/outdoor1/128.JPG,char_data/1/128.JPG_0.jpg,248,8,413,421,114,145,True,3
1,28,kaist_dataset/Korean/Digital_Camera/outdoor1/029.JPG,char_data/1/029.JPG_0.jpg,392,14,286,300,295,323,True,3
1,30,kaist_dataset/Korean/Digital_Camera/outdoor1/029.JPG,char_data/1/029.JPG_0.jpg,480,16,339,355,290,320,True,3
1,41,kaist_dataset/Korean/Digital_Camera/outdoor1/127.JPG,char_data/1/127.JPG_0.jpg,820,20,320,340,270,311,True,3
1,28,kaist_dataset/Korean/Digital_Camera/outdoor1/069.JPG,char_data/1/069.JPG_0.jpg,252,9,338,347,272,300,True,3
1,33,kaist_dataset/Korean/Digital_Camera/outdoor1/069.JPG,char_data/1/069.JPG_0.jpg,462,14,371,385,269,302,True,3
1,68,kaist_dataset/Korean/Digital_Camera/outdoor1/46.JPG,char_data/1/46.JPG_0.jpg,1904,28,237,265,370,438,True,3
1,69,kaist_dataset/Korean/Digital_Camera/outdoor1/46.JPG,char_data/1/46.JPG_0.jpg,1725,25,366,391,368,437,True,3
1,27,kaist_dataset/Korean/Digital_Camera/outdoor1/126.JPG,char_data/1/126.JPG_0.jpg,486,18,378,396,262,289,True,3
1,33,kaist_dataset/Korean/Digital_Camera/outdoor1/023.JPG,char_data/1/023.JPG_0.jpg,462,14,190,204,270,303,True,3
1,25,kaist_dataset/Korean/Digital_Camera/outdoor1/002.JPG,char_data/1/002.JPG_0.jpg,225,9,324,333,374,399,True,3
1,24,kaist_dataset/Korean/Digital_Camera/outdoor1/99.jpg,char_data/1/99.jpg_0.jpg,240,10,421,431,174,198,True,3
1,19,kaist_dataset/Korean/Digital_Camera/outdoor1/99.jpg,char_data/1/99.jpg_0.jpg,171,9,458,467,176,195,True,3
1,30,kaist_dataset/Korean/Digital_Camera/outdoor1/50.JPG,char_data/1/50.JPG_0.jpg,420,14,341,355,338,368,True,3
1,42,kaist_dataset/Korean/Digital_Camera/outdoor1/109.JPG,char_data/1/109.JPG_0.jpg,924,22,530,552,4,46,True,3
1,41,kaist_dataset/Korean/Digital_Camera/outdoor1/109.JPG,char_data/1/109.JPG_0.jpg,861,21,552,573,4,45,True,3
1,25,kaist_dataset/Korean/Digital_Camera/outdoor1/011.JPG,char_data/1/011.JPG_0.jpg,350,14,451,465,258,283,True,3
1,21,kaist_dataset/Korean/Digital_Camera/outdoor1/011.JPG,char_data/1/011.JPG_0.jpg,336,16,491,507,259,280,True,3
1,62,kaist_dataset/Korean/Digital_Camera/outdoor1/54.JPG,char_data/1/54.JPG_0.jpg,1178,19,371,390,83,145,True,3
1,46,kaist_dataset/Korean/Digital_Camera/outdoor1/54.JPG,char_data/1/54.JPG_0.jpg,828,18,441,459,363,409,True,3
1,29,kaist_dataset/Korean/Digital_Camera/outdoor1/032.JPG,char_data/1/032.JPG_0.jpg,551,19,194,213,258,287,True,3
1,30,kaist_dataset/Korean/Digital_Camera/outdoor1/032.JPG,char_data/1/032.JPG_0.jpg,480,16,286,302,257,287,True,3
1,28,kaist_dataset/Korean/Digital_Camera/outdoor1/032.JPG,char_data/1/032.JPG_0.jpg,392,14,492,506,256,284,True,3
1,29,kaist_dataset/Korean/Digital_Camera/outdoor1/123.JPG,char_data/1/123.JPG_0.jpg,348,12,70,82,280,309,True,3
1,38,kaist_dataset/Korean/Digital_Camera/outdoor1/123.JPG,char_data/1/123.JPG_0.jpg,608,16,416,432,271,309,True,3
1,24,kaist_dataset/Korean/Digital_Camera/outdoor1/035.JPG,char_data/1/035.JPG_0.jpg,240,10,550,560,293,317,True,3
1,44,kaist_dataset/Korean/Digital_Camera/outdoor1/2007-12-08-day-047.jpg,char_data/1/2007-12-08-day-047.jpg_0.jpg,1144,26,953,979,713,757,True,3
1,44,kaist_dataset/Korean/Digital_Camera/outdoor1/2007-12-08-day-047.jpg,char_data/1/2007-12-08-day-047.jpg_0.jpg,1100,25,1013,1038,717,761,True,3
1,29,kaist_dataset/Korean/Digital_Camera/outdoor1/120.JPG,char_data/1/120.JPG_0.jpg,609,21,412,433,301,330,True,3
1,34,kaist_dataset/Mixed/Mobile_Phone/(C.M)A-outdoor/P090912038.jpg,char_data/1/P090912038.jpg_0.jpg,408,12,299,311,159,193,True,3
1,75,kaist_dataset/Mixed/Mobile_Phone/(C.M)A-outdoor/P090912062.jpg,char_data/1/P090912062.jpg_0.jpg,3150,42,11,53,3,78,True,3
1,74,kaist_dataset/Mixed/Mobile_Phone/(C.M)A-outdoor/P090912062.jpg,char_data/1/P090912062.jpg_0.jpg,3256,44,69,113,94,168,True,3
1,30,kaist_dataset/Mixed/Mobile_Phone/(C.M)A-outdoor/P090912036.jpg,char_data/1/P090912036.jpg_0.jpg,330,11,322,333,190,220,True,3
1,33,kaist_dataset/Mixed/Mobile_Phone/(C.M)A-outdoor/P090912036.jpg,char_data/1/P090912036.jpg_0.jpg,495,15,333,348,189,222,True,3
1,59,kaist_dataset/Mixed/Mobile_Phone/(C.M)B-indoor/P090831007.jpg,char_data/1/P090831007.jpg_0.jpg,2301,39,122,161,132,191,True,3
1,65,kaist_dataset/Mixed/Mobile_Phone/(C.M)B-indoor/P090831007.jpg,char_data/1/P090831007.jpg_0.jpg,2145,33,249,282,128,193,True,3
1,60,kaist_dataset/Mixed/Mobile_Phone/(C.M)B-indoor/P090831007.jpg,char_data/1/P090831007.jpg_0.jpg,1680,28,321,349,135,195,True,3
1,65,kaist_dataset/Mixed/Mobile_Phone/(C.M)B-indoor/P090831007.jpg,char_data/1/P090831007.jpg_0.jpg,1690,26,253,279,198,263,True,3
1,66,kaist_dataset/Mixed/Mobile_Phone/(C.M)B-indoor/P090831007.jpg,char_data/1/P090831007.jpg_0.jpg,2178,33,249,282,267,333,True,3
1,28,kaist_dataset/Mixed/Digital_Camera/(C.S)C-outdoor1/027.JPG,char_data/1/027.JPG_0.jpg,476,17,423,440,277,305,True,3
1,32,kaist_dataset/Mixed/Digital_Camera/(C.S)C-outdoor1/027.JPG,char_data/1/027.JPG_0.jpg,608,19,496,515,275,307,True,3
1,39,kaist_dataset/Mixed/Digital_Camera/(C.S)C-outdoor1/51.JPG,char_data/1/51.JPG_0.jpg,819,21,555,576,376,415,True,3
1,43,kaist_dataset/Mixed/Digital_Camera/(C.S)C-outdoor1/081.JPG,char_data/1/081.JPG_0.jpg,1333,31,240,271,254,297,True,3
1,40,kaist_dataset/Mixed/Digital_Camera/(C.S)C-outdoor1/081.JPG,char_data/1/081.JPG_0.jpg,1520,38,340,378,257,297,True,3
1,39,kaist_dataset/Mixed/Digital_Camera/(C.S)C-outdoor1/081.JPG,char_data/1/081.JPG_0.jpg,1170,30,381,411,257,296,True,3
1,47,kaist_dataset/Mixed/Digital_Camera/(C.S)C-outdoor1/2007-12-09-day-exterior-078.jpg,char_data/1/2007-12-09-day-exterior-078.jpg_0.jpg,752,16,540,556,593,640,True,3
1,44,kaist_dataset/Mixed/Digital_Camera/(C.S)C-outdoor1/2007-12-09-day-exterior-078.jpg,char_data/1/2007-12-09-day-exterior-078.jpg_0.jpg,528,12,696,708,590,634,True,3
1,57,kaist_dataset/Mixed/Digital_Camera/(C.S)C-outdoor1/2007-12-09-day-exterior-078.jpg,char_data/1/2007-12-09-day-exterior-078.jpg_0.jpg,798,14,832,846,577,634,True,3
1,47,kaist_dataset/Mixed/Digital_Camera/(C.S)C-outdoor1/P1010010.JPG,char_data/1/P1010010.JPG_0.jpg,1222,26,421,447,210,257,True,3
1,46,kaist_dataset/Mixed/Digital_Camera/(C.S)C-outdoor1/P1010010.JPG,char_data/1/P1010010.JPG_0.jpg,1334,29,457,486,211,257,True,3
1,45,kaist_dataset/Mixed/Digital_Camera/(C.S)C-outdoor1/P1010010.JPG,char_data/1/P1010010.JPG_0.jpg,720,16,413,429,359,404,True,3
1,41,kaist_dataset/Mixed/Digital_Camera/(C.S)C-outdoor1/P1010010.JPG,char_data/1/P1010010.JPG_0.jpg,861,21,429,450,360,401,True,3
1,75,kaist_dataset/Mixed/Digital_Camera/(C.S)C-outdoor1/2007-12-09-day-exterior-086.jpg,char_data/1/2007-12-09-day-exterior-086.jpg_0.jpg,3750,50,980,1030,721,796,True,3
1,53,kaist_dataset/Mixed/Digital_Camera/(C.S)C-outdoor1/080116-0084.jpg,char_data/1/080116-0084.jpg_0.jpg,1113,21,686,707,304,357,True,3
1,55,kaist_dataset/Mixed/Digital_Camera/(C.S)C-outdoor1/080116-0084.jpg,char_data/1/080116-0084.jpg_0.jpg,1650,30,706,736,305,360,True,3
1,311,kaist_dataset/Mixed/Digital_Camera/(C.S)C-outdoor1/2007-12-08-day-137.jpg,char_data/1/2007-12-08-day-137.jpg_0.jpg,48516,156,428,584,366,677,True,3
1,153,kaist_dataset/Mixed/Digital_Camera/(C.S)C-outdoor1/2007-12-08-day-118.jpg,char_data/1/2007-12-08-day-118.jpg_0.jpg,14688,96,635,731,565,718,True,3
1,31,kaist_dataset/Mixed/Digital_Camera/(C.S)C-outdoor1/008.JPG,char_data/1/008.JPG_0.jpg,403,13,475,488,265,296,True,3
1,25,kaist_dataset/Mixed/Digital_Camera/(C.S)C-outdoor1/48.JPG,char_data/1/48.JPG_0.jpg,300,12,337,349,341,366,True,3
1,23,kaist_dataset/Mixed/Digital_Camera/(C.S)C-outdoor1/48.JPG,char_data/1/48.JPG_0.jpg,322,14,349,363,343,366,True,3
1,19,kaist_dataset/Mixed/Digital_Camera/(C.S)C-outdoor1/48.JPG,char_data/1/48.JPG_0.jpg,247,13,461,474,344,363,True,3
1,42,kaist_dataset/Mixed/Digital_Camera/(C.S)C-outdoor1/56.JPG,char_data/1/56.JPG_0.jpg,1176,28,389,417,301,343,True,3
1,22,kaist_dataset/Mixed/Digital_Camera/(C.S)C-outdoor1/047.JPG,char_data/1/047.JPG_0.jpg,220,10,527,537,240,262,True,3
1,21,kaist_dataset/Mixed/Digital_Camera/(C.S)C-outdoor1/047.JPG,char_data/1/047.JPG_0.jpg,168,8,537,545,240,261,True,3
1,31,kaist_dataset/Mixed/Digital_Camera/(C.S)C-outdoor1/135.JPG,char_data/1/135.JPG_0.jpg,465,15,261,276,256,287,True,3
1,40,kaist_dataset/Mixed/Digital_Camera/(C.S)C-outdoor1/45.JPG,char_data/1/45.JPG_0.jpg,960,24,343,367,366,406,True,3
1,43,kaist_dataset/Mixed/Digital_Camera/(C.S)C-outdoor1/45.JPG,char_data/1/45.JPG_0.jpg,1032,24,484,508,364,407,True,3
1,43,kaist_dataset/Mixed/Digital_Camera/(C.S)C-outdoor1/3.JPG,char_data/1/3.JPG_0.jpg,688,16,543,559,419,462,True,3
1,29,kaist_dataset/Mixed/Digital_Camera/(C.S)C-outdoor1/57.JPG,char_data/1/57.JPG_0.jpg,377,13,499,512,295,324,True,3
1,24,kaist_dataset/Mixed/Digital_Camera/(C.S)C-outdoor1/57.JPG,char_data/1/57.JPG_0.jpg,312,13,575,588,299,323,True,3
1,26,kaist_dataset/Mixed/Digital_Camera/(C.S)C-outdoor1/57.JPG,char_data/1/57.JPG_0.jpg,260,10,335,345,455,481,True,3
1,28,kaist_dataset/Mixed/Digital_Camera/(C.S)C-outdoor1/57.JPG,char_data/1/57.JPG_0.jpg,364,13,405,418,454,482,True,3
1,30,kaist_dataset/Mixed/Digital_Camera/(C.S)C-outdoor1/054.JPG,char_data/1/054.JPG_0.jpg,450,15,491,506,301,331,True,3
1,48,kaist_dataset/Mixed/Digital_Camera/(C.S)C-outdoor1/DSC02312.JPG,char_data/1/DSC02312.JPG_0.jpg,912,19,281,300,217,265,True,3
1,61,kaist_dataset/Mixed/Digital_Camera/(C.S)C-outdoor1/080119-0003.jpg,char_data/1/080119-0003.jpg_0.jpg,915,15,539,554,1397,1458,True,3
1,61,kaist_dataset/Mixed/Digital_Camera/(C.S)C-outdoor1/080119-0003.jpg,char_data/1/080119-0003.jpg_0.jpg,915,15,640,655,1392,1453,True,3
1,21,kaist_dataset/Mixed/Digital_Camera/(C.S)C-outdoor1/47.JPG,char_data/1/47.JPG_0.jpg,273,13,374,387,480,501,True,3
1,24,kaist_dataset/Mixed/Digital_Camera/(C.S)C-outdoor1/47.JPG,char_data/1/47.JPG_0.jpg,288,12,387,399,476,500,True,3
1,24,kaist_dataset/Mixed/Digital_Camera/(C.S)C-outdoor1/DSC02323.JPG,char_data/1/DSC02323.JPG_0.jpg,360,15,71,86,291,315,True,3
1,40,kaist_dataset/Mixed/Digital_Camera/(C.S)C-outdoor1/105.jpg,char_data/1/105.jpg_0.jpg,560,14,254,268,384,424,True,3
1,85,kaist_dataset/Mixed/Digital_Camera/(C.S)C-outdoor1/DSC02244.JPG,char_data/1/DSC02244.JPG_0.jpg,3995,47,366,413,347,432,True,3
1,37,kaist_dataset/Mixed/Digital_Camera/(C.S)C-outdoor1/2007-12-08-day-130.jpg,char_data/1/2007-12-08-day-130.jpg_0.jpg,666,18,1010,1028,758,795,True,3
1,58,kaist_dataset/Mixed/Digital_Camera/(C.S)C-outdoor1/025.JPG,char_data/1/025.JPG_0.jpg,1392,24,181,205,332,390,True,3
1,49,kaist_dataset/Mixed/Digital_Camera/(C.S)C-outdoor1/55.JPG,char_data/1/55.JPG_0.jpg,931,19,360,379,145,194,True,3
1,114,kaist_dataset/Mixed/Digital_Camera/(C.S)C-outdoor1/080118-0014.jpg,char_data/1/080118-0014.jpg_0.jpg,5586,49,1121,1170,1026,1140,True,3
1,41,kaist_dataset/Mixed/Digital_Camera/(C.S)C-outdoor1/2.JPG,char_data/1/2.JPG_0.jpg,533,13,210,223,64,105,True,3
1,24,kaist_dataset/Mixed/Digital_Camera/(C.S)C-outdoor1/063.JPG,char_data/1/063.JPG_0.jpg,312,13,392,405,261,285,True,3
1,43,kaist_dataset/Mixed/Digital_Camera/(C.S)C-outdoor1/DSC02322.JPG,char_data/1/DSC02322.JPG_0.jpg,1032,24,273,297,362,405,True,3
1,49,kaist_dataset/Mixed/Digital_Camera/(C.S)C-outdoor1/1.JPG,char_data/1/1.JPG_0.jpg,1127,23,144,167,460,509,True,3
1,53,kaist_dataset/Mixed/Digital_Camera/(C.S)C-outdoor1/1.JPG,char_data/1/1.JPG_0.jpg,954,18,238,256,458,511,True,3
1,29,kaist_dataset/Mixed/Digital_Camera/(C.S)C-outdoor1/014.JPG,char_data/1/014.JPG_0.jpg,261,9,214,223,275,304,True,3
1,46,kaist_dataset/Mixed/Digital_Camera/(C.S)C-outdoor1/DSC02309.JPG,char_data/1/DSC02309.JPG_0.jpg,1380,30,530,560,241,287,True,3
1,42,kaist_dataset/Mixed/Digital_Camera/(C.S)C-outdoor1/DSC02309.JPG,char_data/1/DSC02309.JPG_0.jpg,840,20,466,486,391,433,True,3
1,43,kaist_dataset/Mixed/Digital_Camera/(C.S)C-outdoor1/DSC02325.JPG,char_data/1/DSC02325.JPG_0.jpg,903,21,325,346,306,349,True,3
1,42,kaist_dataset/Mixed/Digital_Camera/(C.S)F-others/DSC02504.JPG,char_data/1/DSC02504.JPG_0.jpg,1050,25,277,302,338,380,True,3
1,58,kaist_dataset/Mixed/Digital_Camera/(C.S)F-others/DSC02777.JPG,char_data/1/DSC02777.JPG_0.jpg,1856,32,51,83,315,373,True,3
1,45,kaist_dataset/Mixed/Digital_Camera/(C.S)F-others/2007-12-08-day-113.jpg,char_data/1/2007-12-08-day-113.jpg_0.jpg,810,18,984,1002,442,487,True,3
1,77,kaist_dataset/Mixed/Digital_Camera/(C.S)F-others/097.jpg,char_data/1/097.jpg_0.jpg,3542,46,403,449,196,273,True,3
1,33,kaist_dataset/Mixed/Digital_Camera/(C.S)F-others/2007-12-08-day-044.jpg,char_data/1/2007-12-08-day-044.jpg_0.jpg,396,12,1088,1100,835,868,True,3
1,33,kaist_dataset/Mixed/Digital_Camera/(C.S)F-others/2007-12-08-day-044.jpg,char_data/1/2007-12-08-day-044.jpg_0.jpg,429,13,1096,1109,832,865,True,3
1,42,kaist_dataset/Mixed/Digital_Camera/(C.S)D-indoor2/DSC04421.JPG,char_data/1/DSC04421.JPG_0.jpg,672,16,577,593,218,260,True,3
1,71,kaist_dataset/Mixed/Digital_Camera/(C.S)E-night/P1010152.JPG,char_data/1/P1010152.JPG_0.jpg,3124,44,292,336,220,291,True,3
1,76,kaist_dataset/Mixed/Digital_Camera/(C.S)E-night/P1010152.JPG,char_data/1/P1010152.JPG_0.jpg,2584,34,436,470,217,293,True,3
1,68,kaist_dataset/Mixed/Digital_Camera/(C.S)E-night/P1010152.JPG,char_data/1/P1010152.JPG_0.jpg,2856,42,467,509,222,290,True,3
1,36,kaist_dataset/Mixed/Digital_Camera/(C.S)E-night/DSC02585.JPG,char_data/1/DSC02585.JPG_0.jpg,468,13,468,481,419,455,True,3
1,29,kaist_dataset/Mixed/Digital_Camera/(C.S)E-night/P1010151.JPG,char_data/1/P1010151.JPG_0.jpg,290,10,532,542,202,231,True,3
1,49,kaist_dataset/Mixed/Digital_Camera/(C.S)E-night/DSC02575.JPG,char_data/1/DSC02575.JPG_0.jpg,1421,29,364,393,360,409,True,3
1,52,kaist_dataset/Mixed/Digital_Camera/(C.S)E-night/DSC02575.JPG,char_data/1/DSC02575.JPG_0.jpg,1040,20,393,413,358,410,True,3
1,52,kaist_dataset/Mixed/Digital_Camera/(C.S)E-night/DSC02595.JPG,char_data/1/DSC02595.JPG_0.jpg,1924,37,374,411,347,399,True,3
1,35,kaist_dataset/Mixed/Digital_Camera/(C.S)E-night/DSC02569.JPG,char_data/1/DSC02569.JPG_0.jpg,595,17,367,384,413,448,True,3
1,39,kaist_dataset/Mixed/Digital_Camera/(C.S)E-night/DSC02569.JPG,char_data/1/DSC02569.JPG_0.jpg,624,16,405,421,406,445,True,3
1,33,kaist_dataset/Mixed/Digital_Camera/(C.S)E-night/DSC02903.JPG,char_data/1/DSC02903.JPG_0.jpg,330,10,412,422,268,301,True,3
1,35,kaist_dataset/Mixed/Digital_Camera/(C.S)B-light/DSC03298.JPG,char_data/1/DSC03298.JPG_0.jpg,525,15,407,422,288,323,True,3
1,56,kaist_dataset/Mixed/Digital_Camera/(C.S)D-indoor1/DSC02775.JPG,char_data/1/DSC02775.JPG_0.jpg,1848,33,17,50,226,282,True,3
1,52,kaist_dataset/Mixed/Digital_Camera/(C.S)D-indoor1/DSC02776.JPG,char_data/1/DSC02776.JPG_0.jpg,1144,22,50,72,267,319,True,3
1,26,kaist_dataset/Mixed/Digital_Camera/(C.S)D-indoor1/DSC04005.JPG,char_data/1/DSC04005.JPG_0.jpg,338,13,316,329,441,467,True,3
1,24,kaist_dataset/Mixed/Digital_Camera/(C.S)D-indoor1/DSC04005.JPG,char_data/1/DSC04005.JPG_0.jpg,384,16,329,345,441,465,True,3
1,24,kaist_dataset/Mixed/Digital_Camera/(C.S)D-indoor1/DSC04005.JPG,char_data/1/DSC04005.JPG_0.jpg,384,16,490,506,440,464,True,3
1,156,kaist_dataset/Mixed/Digital_Camera/(C.S)D-indoor1/DSC02739.JPG,char_data/1/DSC02739.JPG_0.jpg,11232,72,360,432,319,475,True,3
1,54,kaist_dataset/Mixed/Digital_Camera/(C.S)D-indoor1/DSC02771.JPG,char_data/1/DSC02771.JPG_0.jpg,1404,26,44,70,251,305,True,3
1,44,kaist_dataset/Mixed/Digital_Camera/(C.S)D-indoor1/DSC02780.JPG,char_data/1/DSC02780.JPG_0.jpg,1012,23,82,105,273,317,True,3
1,47,kaist_dataset/Mixed/Digital_Camera/(C.S)D-indoor1/DSC03986.JPG,char_data/1/DSC03986.JPG_0.jpg,423,9,281,290,163,210,True,3
1,50,kaist_dataset/Mixed/Digital_Camera/(C.S)D-indoor1/DSC03986.JPG,char_data/1/DSC03986.JPG_0.jpg,800,16,343,359,159,209,True,3
1,49,kaist_dataset/Mixed/Digital_Camera/(C.S)D-indoor1/DSC03986.JPG,char_data/1/DSC03986.JPG_0.jpg,637,13,377,390,157,206,True,3
1,43,kaist_dataset/Mixed/Digital_Camera/(C.S)D-indoor1/DSC03986.JPG,char_data/1/DSC03986.JPG_0.jpg,602,14,423,437,161,204,True,3
1,47,kaist_dataset/Mixed/Digital_Camera/(C.S)D-indoor1/DSC03980.JPG,char_data/1/DSC03980.JPG_0.jpg,1598,34,318,352,306,353,True,3
1,164,kaist_dataset/Mixed/Digital_Camera/(C.S)D-indoor1/DSC02726.JPG,char_data/1/DSC02726.JPG_0.jpg,16892,103,200,303,34,198,True,3
1,47,kaist_dataset/Mixed/Digital_Camera/(C.S)D-indoor1/DSC02772.JPG,char_data/1/DSC02772.JPG_0.jpg,1034,22,112,134,328,375,True,3
1,51,kaist_dataset/Mixed/Digital_Camera/(C.S)C-outdoor5/DSC03847.JPG,char_data/1/DSC03847.JPG_0.jpg,918,18,525,543,10,61,True,3
1,43,kaist_dataset/Mixed/Digital_Camera/(C.S)C-outdoor5/DSC04395.JPG,char_data/1/DSC04395.JPG_0.jpg,989,23,130,153,289,332,True,3
1,35,kaist_dataset/Mixed/Digital_Camera/(C.S)C-outdoor5/DSC04144.JPG,char_data/1/DSC04144.JPG_0.jpg,595,17,368,385,419,454,True,3
1,49,kaist_dataset/Mixed/Digital_Camera/(C.S)C-outdoor5/DSC04094.JPG,char_data/1/DSC04094.JPG_0.jpg,1568,32,374,406,386,435,True,3
1,51,kaist_dataset/Mixed/Digital_Camera/(C.S)C-outdoor5/DSC04094.JPG,char_data/1/DSC04094.JPG_0.jpg,1530,30,495,525,387,438,True,3
1,26,kaist_dataset/Mixed/Digital_Camera/(C.S)C-outdoor5/DSC04086.JPG,char_data/1/DSC04086.JPG_0.jpg,234,9,466,475,374,400,True,3
1,34,kaist_dataset/Mixed/Digital_Camera/(C.S)C-outdoor5/DSC03839.JPG,char_data/1/DSC03839.JPG_0.jpg,510,15,258,273,363,397,True,3
1,36,kaist_dataset/Mixed/Digital_Camera/(C.S)C-outdoor5/DSC03839.JPG,char_data/1/DSC03839.JPG_0.jpg,576,16,351,367,368,404,True,3
1,39,kaist_dataset/Mixed/Digital_Camera/(C.S)C-outdoor5/DSC03839.JPG,char_data/1/DSC03839.JPG_0.jpg,624,16,366,382,364,403,True,3
1,40,kaist_dataset/Mixed/Digital_Camera/(C.S)C-outdoor5/DSC04337.JPG,char_data/1/DSC04337.JPG_0.jpg,1040,26,493,519,322,362,True,3
1,32,kaist_dataset/Mixed/Digital_Camera/(C.S)C-outdoor5/DSC04330.JPG,char_data/1/DSC04330.JPG_0.jpg,736,23,301,324,192,224,True,3
1,35,kaist_dataset/Mixed/Digital_Camera/(C.S)C-outdoor5/DSC04330.JPG,char_data/1/DSC04330.JPG_0.jpg,735,21,477,498,163,198,True,3
1,61,kaist_dataset/Mixed/Digital_Camera/(C.S)C-outdoor5/DSC04330.JPG,char_data/1/DSC04330.JPG_0.jpg,976,16,517,533,357,418,True,3
1,80,kaist_dataset/Mixed/Digital_Camera/(C.S)C-outdoor5/DSC04016.JPG,char_data/1/DSC04016.JPG_0.jpg,2880,36,396,432,105,185,True,3
1,74,kaist_dataset/Mixed/Digital_Camera/(C.S)C-outdoor5/DSC04016.JPG,char_data/1/DSC04016.JPG_0.jpg,3108,42,436,478,107,181,True,3
1,69,kaist_dataset/Mixed/Digital_Camera/(C.S)C-outdoor5/DSC04016.JPG,char_data/1/DSC04016.JPG_0.jpg,2622,38,168,206,321,390,True,3
1,73,kaist_dataset/Mixed/Digital_Camera/(C.S)C-outdoor5/DSC04016.JPG,char_data/1/DSC04016.JPG_0.jpg,2555,35,440,475,323,396,True,3
1,30,kaist_dataset/Mixed/Digital_Camera/(C.S)C-outdoor5/DSC04151.JPG,char_data/1/DSC04151.JPG_0.jpg,450,15,557,572,349,379,True,3
1,42,kaist_dataset/Mixed/Digital_Camera/(C.S)C-outdoor5/DSC04140.JPG,char_data/1/DSC04140.JPG_0.jpg,420,10,589,599,342,384,True,3
1,36,kaist_dataset/Mixed/Digital_Camera/(C.S)C-outdoor5/DSC04122.JPG,char_data/1/DSC04122.JPG_0.jpg,396,11,372,383,412,448,True,3
1,40,kaist_dataset/Mixed/Digital_Camera/(C.S)C-outdoor5/DSC04061.JPG,char_data/1/DSC04061.JPG_0.jpg,520,13,522,535,143,183,True,3
1,57,kaist_dataset/Mixed/Digital_Camera/(C.S)C-outdoor5/DSC04401.JPG,char_data/1/DSC04401.JPG_0.jpg,1482,26,535,561,248,305,True,3
1,67,kaist_dataset/Mixed/Digital_Camera/(C.S)C-outdoor5/DSC03837.JPG,char_data/1/DSC03837.JPG_0.jpg,1742,26,295,321,301,368,True,3
1,62,kaist_dataset/Mixed/Digital_Camera/(C.S)C-outdoor5/DSC04450.JPG,char_data/1/DSC04450.JPG_0.jpg,2046,33,275,308,56,118,True,3
1,52,kaist_dataset/Mixed/Digital_Camera/(C.S)C-outdoor5/DSC04017.JPG,char_data/1/DSC04017.JPG_0.jpg,2392,46,15,61,5,57,True,3
1,51,kaist_dataset/Mixed/Digital_Camera/(C.S)C-outdoor5/DSC04017.JPG,char_data/1/DSC04017.JPG_0.jpg,2346,46,63,109,3,54,True,3
1,52,kaist_dataset/Mixed/Digital_Camera/(C.S)C-outdoor5/DSC04017.JPG,char_data/1/DSC04017.JPG_0.jpg,1196,23,378,401,423,475,True,3
1,52,kaist_dataset/Mixed/Digital_Camera/(C.S)C-outdoor5/DSC04017.JPG,char_data/1/DSC04017.JPG_0.jpg,1716,33,402,435,426,478,True,3
1,41,kaist_dataset/Mixed/Digital_Camera/(C.S)C-outdoor5/DSC04139.JPG,char_data/1/DSC04139.JPG_0.jpg,820,20,340,360,398,439,True,3
1,44,kaist_dataset/Mixed/Digital_Camera/(C.S)C-outdoor5/DSC04139.JPG,char_data/1/DSC04139.JPG_0.jpg,572,13,360,373,396,440,True,3
1,49,kaist_dataset/Mixed/Digital_Camera/(C.S)C-outdoor5/DSC04139.JPG,char_data/1/DSC04139.JPG_0.jpg,637,13,374,387,395,444,True,3
1,196,kaist_dataset/Mixed/Digital_Camera/(C.S)C-outdoor5/DSC04447.JPG,char_data/1/DSC04447.JPG_0.jpg,10192,52,585,637,81,277,True,3
1,30,kaist_dataset/Mixed/Digital_Camera/(C.S)C-outdoor5/DSC04092.JPG,char_data/1/DSC04092.JPG_0.jpg,330,11,182,193,328,358,True,3
1,36,kaist_dataset/Mixed/Digital_Camera/(C.S)C-outdoor5/DSC03842.JPG,char_data/1/DSC03842.JPG_0.jpg,576,16,269,285,228,264,True,3
1,30,kaist_dataset/Mixed/Digital_Camera/(C.S)C-outdoor5/DSC04056.JPG,char_data/1/DSC04056.JPG_0.jpg,390,13,548,561,300,330,True,3
1,30,kaist_dataset/Mixed/Digital_Camera/(C.S)C-outdoor5/DSC04115.JPG,char_data/1/DSC04115.JPG_0.jpg,450,15,280,295,364,394,True,3
1,34,kaist_dataset/Mixed/Digital_Camera/(C.S)C-outdoor3/DSC03316.JPG,char_data/1/DSC03316.JPG_0.jpg,408,12,602,614,81,115,True,3
1,46,kaist_dataset/Mixed/Digital_Camera/(C.S)C-outdoor3/DSC03177.JPG,char_data/1/DSC03177.JPG_0.jpg,1472,32,110,142,194,240,True,3
1,47,kaist_dataset/Mixed/Digital_Camera/(C.S)C-outdoor3/DSC03199.JPG,char_data/1/DSC03199.JPG_0.jpg,1034,22,430,452,383,430,True,3
1,61,kaist_dataset/Mixed/Digital_Camera/(C.S)C-outdoor3/DSC03199.JPG,char_data/1/DSC03199.JPG_0.jpg,2074,34,163,197,321,382,True,3
1,67,kaist_dataset/Mixed/Digital_Camera/(C.S)C-outdoor3/DSC03199.JPG,char_data/1/DSC03199.JPG_0.jpg,2479,37,196,233,319,386,True,3
1,29,kaist_dataset/Mixed/Digital_Camera/(C.S)C-outdoor3/DSC03062.JPG,char_data/1/DSC03062.JPG_0.jpg,319,11,341,352,246,275,True,3
1,28,kaist_dataset/Mixed/Digital_Camera/(C.S)C-outdoor3/DSC03062.JPG,char_data/1/DSC03062.JPG_0.jpg,280,10,354,364,245,273,True,3
1,32,kaist_dataset/Mixed/Digital_Camera/(C.S)C-outdoor3/DSC03051.JPG,char_data/1/DSC03051.JPG_0.jpg,608,19,283,302,320,352,True,3
1,29,kaist_dataset/Mixed/Digital_Camera/(C.S)C-outdoor3/DSC03051.JPG,char_data/1/DSC03051.JPG_0.jpg,522,18,320,338,320,349,True,3
1,55,kaist_dataset/Mixed/Digital_Camera/(C.S)C-outdoor3/DSC03431.JPG,char_data/1/DSC03431.JPG_0.jpg,1375,25,65,90,47,102,True,3
1,36,kaist_dataset/Mixed/Digital_Camera/(C.S)C-outdoor3/DSC02970.JPG,char_data/1/DSC02970.JPG_0.jpg,1152,32,227,259,365,401,True,3
1,51,kaist_dataset/Mixed/Digital_Camera/(C.S)C-outdoor3/DSC03164.JPG,char_data/1/DSC03164.JPG_0.jpg,1581,31,419,450,211,262,True,3
1,36,kaist_dataset/Mixed/Digital_Camera/(C.S)C-outdoor3/DSC03328.JPG,char_data/1/DSC03328.JPG_0.jpg,468,13,204,217,402,438,True,3
1,45,kaist_dataset/Mixed/Digital_Camera/(C.S)C-outdoor3/DSC03328.JPG,char_data/1/DSC03328.JPG_0.jpg,540,12,391,403,397,442,True,3
1,41,kaist_dataset/Mixed/Digital_Camera/(C.S)C-outdoor3/DSC03328.JPG,char_data/1/DSC03328.JPG_0.jpg,574,14,439,453,396,437,True,3
1,26,kaist_dataset/Mixed/Digital_Camera/(C.S)C-outdoor3/DSC03315.JPG,char_data/1/DSC03315.JPG_0.jpg,364,14,467,481,120,146,True,3
1,36,kaist_dataset/Mixed/Digital_Camera/(C.S)C-outdoor3/DSC03301.JPG,char_data/1/DSC03301.JPG_0.jpg,468,13,390,403,142,178,True,3
1,43,kaist_dataset/Mixed/Digital_Camera/(C.S)C-outdoor3/DSC02956.JPG,char_data/1/DSC02956.JPG_0.jpg,688,16,217,233,388,431,True,3
1,39,kaist_dataset/Mixed/Digital_Camera/(C.S)C-outdoor3/DSC02956.JPG,char_data/1/DSC02956.JPG_0.jpg,546,14,233,247,399,438,True,3
1,47,kaist_dataset/Mixed/Digital_Camera/(C.S)C-outdoor3/DSC03185.JPG,char_data/1/DSC03185.JPG_0.jpg,1410,30,516,546,158,205,True,3
1,65,kaist_dataset/Mixed/Digital_Camera/(C.S)C-outdoor3/DSC03067.JPG,char_data/1/DSC03067.JPG_0.jpg,2275,35,134,169,194,259,True,3
1,35,kaist_dataset/Mixed/Digital_Camera/(C.S)C-outdoor3/DSC03311.JPG,char_data/1/DSC03311.JPG_0.jpg,385,11,372,383,367,402,True,3
1,30,kaist_dataset/Mixed/Digital_Camera/(C.S)C-outdoor3/DSC03311.JPG,char_data/1/DSC03311.JPG_0.jpg,360,12,425,437,370,400,True,3
1,29,kaist_dataset/Mixed/Digital_Camera/(C.S)C-outdoor3/DSC03311.JPG,char_data/1/DSC03311.JPG_0.jpg,464,16,437,453,369,398,True,3
1,34,kaist_dataset/Mixed/Digital_Camera/(C.S)C-outdoor3/DSC03017.JPG,char_data/1/DSC03017.JPG_0.jpg,408,12,406,418,242,276,True,3
1,34,kaist_dataset/Mixed/Digital_Camera/(C.S)C-outdoor3/DSC03017.JPG,char_data/1/DSC03017.JPG_0.jpg,612,18,449,467,242,276,True,3
1,30,kaist_dataset/Mixed/Digital_Camera/(C.S)C-outdoor3/DSC03250.JPG,char_data/1/DSC03250.JPG_0.jpg,420,14,519,533,405,435,True,3
1,39,kaist_dataset/Mixed/Digital_Camera/(C.S)C-outdoor3/DSC03308.JPG,char_data/1/DSC03308.JPG_0.jpg,741,19,451,470,246,285,True,3
1,116,kaist_dataset/Mixed/Digital_Camera/(C.S)C-outdoor6/P1010063.JPG,char_data/1/P1010063.JPG_0.jpg,4988,43,191,234,129,245,True,3
1,26,kaist_dataset/Mixed/Digital_Camera/(C.S)C-outdoor6/P1010082.JPG,char_data/1/P1010082.JPG_0.jpg,390,15,405,420,233,259,True,3
1,25,kaist_dataset/Mixed/Digital_Camera/(C.S)C-outdoor6/P1010082.JPG,char_data/1/P1010082.JPG_0.jpg,300,12,471,483,233,258,True,3
1,22,kaist_dataset/Mixed/Digital_Camera/(C.S)C-outdoor6/P1010099.JPG,char_data/1/P1010099.JPG_0.jpg,308,14,529,543,207,229,True,3
1,24,kaist_dataset/Mixed/Digital_Camera/(C.S)C-outdoor6/P1010099.JPG,char_data/1/P1010099.JPG_0.jpg,360,15,557,572,207,231,True,3
1,127,kaist_dataset/Mixed/Digital_Camera/(C.S)C-outdoor6/P1010045.JPG,char_data/1/P1010045.JPG_0.jpg,12827,101,188,289,149,276,True,3
1,28,kaist_dataset/Mixed/Digital_Camera/(C.S)C-outdoor6/P1010020.JPG,char_data/1/P1010020.JPG_0.jpg,700,25,144,169,232,260,True,3
1,23,kaist_dataset/Mixed/Digital_Camera/(C.S)C-outdoor6/P1010138.JPG,char_data/1/P1010138.JPG_0.jpg,506,22,503,525,191,214,True,3
1,24,kaist_dataset/Mixed/Digital_Camera/(C.S)C-outdoor6/P1010138.JPG,char_data/1/P1010138.JPG_0.jpg,504,21,529,550,190,214,True,3
1,59,kaist_dataset/Mixed/Digital_Camera/(C.S)C-outdoor6/080116-0057.jpg,char_data/1/080116-0057.jpg_0.jpg,1652,28,587,615,821,880,True,3
1,42,kaist_dataset/Mixed/Digital_Camera/(C.S)C-outdoor6/P1010021.JPG,char_data/1/P1010021.JPG_0.jpg,1134,27,381,408,205,247,True,3
1,37,kaist_dataset/Mixed/Digital_Camera/(C.S)C-outdoor6/P1010084.JPG,char_data/1/P1010084.JPG_0.jpg,740,20,11,31,187,224,True,3
1,46,kaist_dataset/Mixed/Digital_Camera/(C.S)C-outdoor6/P1010084.JPG,char_data/1/P1010084.JPG_0.jpg,1380,30,567,597,192,238,True,3
1,35,kaist_dataset/Mixed/Digital_Camera/(C.S)C-outdoor6/P1010056.JPG,char_data/1/P1010056.JPG_0.jpg,525,15,365,380,230,265,True,3
1,34,kaist_dataset/Mixed/Digital_Camera/(C.S)C-outdoor6/P1010018.JPG,char_data/1/P1010018.JPG_0.jpg,442,13,535,548,242,276,True,3
1,27,kaist_dataset/Mixed/Digital_Camera/(C.S)C-outdoor6/P1010096.JPG,char_data/1/P1010096.JPG_0.jpg,378,14,283,297,202,229,True,3
1,55,kaist_dataset/Mixed/Digital_Camera/(C.S)C-outdoor6/P1010067.JPG,char_data/1/P1010067.JPG_0.jpg,1210,22,160,182,317,372,True,3
1,55,kaist_dataset/Mixed/Digital_Camera/(C.S)C-outdoor6/P1010067.JPG,char_data/1/P1010067.JPG_0.jpg,1485,27,529,556,310,365,True,3
1,26,kaist_dataset/Mixed/Digital_Camera/(C.S)C-outdoor6/117.JPG,char_data/1/117.JPG_0.jpg,234,9,367,376,265,291,True,3
1,22,kaist_dataset/Mixed/Digital_Camera/(C.S)C-outdoor6/117.JPG,char_data/1/117.JPG_0.jpg,154,7,507,514,264,286,True,3
1,35,kaist_dataset/Mixed/Digital_Camera/(C.S)C-outdoor6/P1010074.JPG,char_data/1/P1010074.JPG_0.jpg,1575,45,427,472,300,335,True,3
1,37,kaist_dataset/Mixed/Digital_Camera/(C.S)C-outdoor6/P1010074.JPG,char_data/1/P1010074.JPG_0.jpg,925,25,609,634,297,334,True,3
1,49,kaist_dataset/Mixed/Digital_Camera/(C.S)C-outdoor4/DSC03651.JPG,char_data/1/DSC03651.JPG_0.jpg,1176,24,365,389,356,405,True,3
1,73,kaist_dataset/Mixed/Digital_Camera/(C.S)C-outdoor4/DSC03730.JPG,char_data/1/DSC03730.JPG_0.jpg,2920,40,484,524,320,393,True,3
1,33,kaist_dataset/Mixed/Digital_Camera/(C.S)C-outdoor4/DSC03716.JPG,char_data/1/DSC03716.JPG_0.jpg,330,10,605,615,251,284,True,3
1,33,kaist_dataset/Mixed/Digital_Camera/(C.S)C-outdoor4/DSC03716.JPG,char_data/1/DSC03716.JPG_0.jpg,330,10,628,638,249,282,True,3
1,31,kaist_dataset/Mixed/Digital_Camera/(C.S)C-outdoor4/DSC03719.JPG,char_data/1/DSC03719.JPG_0.jpg,465,15,527,542,184,215,True,3
1,48,kaist_dataset/Mixed/Digital_Camera/(C.S)C-outdoor4/DSC03531.JPG,char_data/1/DSC03531.JPG_0.jpg,1008,21,537,558,348,396,False,3
1,56,kaist_dataset/Mixed/Digital_Camera/(C.S)C-outdoor4/DSC03531.JPG,char_data/1/DSC03531.JPG_0.jpg,1008,18,602,620,340,396,False,3
1,28,kaist_dataset/Mixed/Digital_Camera/(C.S)C-outdoor4/DSC03677.JPG,char_data/1/DSC03677.JPG_0.jpg,252,9,548,557,281,309,False,3
1,31,kaist_dataset/Mixed/Digital_Camera/(C.S)C-outdoor4/DSC03642.JPG,char_data/1/DSC03642.JPG_0.jpg,434,14,498,512,396,427,False,3
1,29,kaist_dataset/Mixed/Digital_Camera/(C.S)C-outdoor4/DSC03642.JPG,char_data/1/DSC03642.JPG_0.jpg,377,13,514,527,399,428,False,3
1,38,kaist_dataset/Mixed/Digital_Camera/(C.S)C-outdoor4/DSC03435.JPG,char_data/1/DSC03435.JPG_0.jpg,646,17,83,100,233,271,False,3
1,40,kaist_dataset/Mixed/Digital_Camera/(C.S)C-outdoor4/DSC03658.JPG,char_data/1/DSC03658.JPG_0.jpg,560,14,418,432,410,450,False,3
1,51,kaist_dataset/Mixed/Digital_Camera/(C.S)C-outdoor4/DSC03544.JPG,char_data/1/DSC03544.JPG_0.jpg,1071,21,429,450,270,321,False,3
1,27,kaist_dataset/Mixed/Digital_Camera/(C.S)C-outdoor4/DSC03640.JPG,char_data/1/DSC03640.JPG_0.jpg,297,11,256,267,400,427,False,3
1,31,kaist_dataset/Mixed/Digital_Camera/(C.S)C-outdoor4/DSC03661.JPG,char_data/1/DSC03661.JPG_0.jpg,403,13,396,409,333,364,False,3
1,31,kaist_dataset/Mixed/Digital_Camera/(C.S)C-outdoor4/DSC03661.JPG,char_data/1/DSC03661.JPG_0.jpg,434,14,446,460,331,362,False,3
1,32,kaist_dataset/Mixed/Digital_Camera/(C.S)C-outdoor4/DSC03691.JPG,char_data/1/DSC03691.JPG_0.jpg,352,11,449,460,223,255,False,3
1,35,kaist_dataset/Mixed/Digital_Camera/(C.S)C-outdoor4/DSC03691.JPG,char_data/1/DSC03691.JPG_0.jpg,385,11,460,471,224,259,False,3
1,31,kaist_dataset/Mixed/Digital_Camera/(C.S)C-outdoor4/DSC03691.JPG,char_data/1/DSC03691.JPG_0.jpg,341,11,590,601,221,252,False,3
1,46,kaist_dataset/Mixed/Digital_Camera/(C.S)C-outdoor4/DSC03617.JPG,char_data/1/DSC03617.JPG_0.jpg,1150,25,351,376,380,426,False,3
1,47,kaist_dataset/Mixed/Digital_Camera/(C.S)C-outdoor4/DSC03617.JPG,char_data/1/DSC03617.JPG_0.jpg,1175,25,377,402,378,425,False,3
1,30,kaist_dataset/Mixed/Digital_Camera/(C.S)C-outdoor4/DSC03618.JPG,char_data/1/DSC03618.JPG_0.jpg,450,15,363,378,413,443,False,3
1,28,kaist_dataset/Mixed/Digital_Camera/(C.S)C-outdoor4/DSC03718.JPG,char_data/1/DSC03718.JPG_0.jpg,336,12,523,535,405,433,False,3
1,41,kaist_dataset/Mixed/Digital_Camera/(C.S)C-outdoor4/DSC03781.JPG,char_data/1/DSC03781.JPG_0.jpg,697,17,262,279,376,417,False,3
1,38,kaist_dataset/Mixed/Digital_Camera/(C.S)C-outdoor4/DSC03549.JPG,char_data/1/DSC03549.JPG_0.jpg,570,15,580,595,218,256,False,3
1,39,kaist_dataset/Mixed/Digital_Camera/(C.S)C-outdoor4/DSC03549.JPG,char_data/1/DSC03549.JPG_0.jpg,429,11,614,625,219,258,False,3
1,29,kaist_dataset/Mixed/Digital_Camera/(C.S)C-outdoor4/DSC03446.JPG,char_data/1/DSC03446.JPG_0.jpg,464,16,307,323,293,322,False,3
1,24,kaist_dataset/Mixed/Digital_Camera/(C.S)C-outdoor4/DSC03643.JPG,char_data/1/DSC03643.JPG_0.jpg,288,12,538,550,329,353,False,3
1,25,kaist_dataset/Mixed/Digital_Camera/(C.S)C-outdoor4/DSC03643.JPG,char_data/1/DSC03643.JPG_0.jpg,275,11,550,561,328,353,False,3
1,36,kaist_dataset/Mixed/Digital_Camera/(C.S)C-outdoor4/DSC03673.JPG,char_data/1/DSC03673.JPG_0.jpg,612,17,119,136,308,344,False,3
1,33,kaist_dataset/Mixed/Digital_Camera/(C.S)C-outdoor4/DSC03673.JPG,char_data/1/DSC03673.JPG_0.jpg,561,17,136,153,308,341,False,3
1,49,kaist_dataset/Mixed/Digital_Camera/(C.S)C-outdoor4/DSC03571.JPG,char_data/1/DSC03571.JPG_0.jpg,882,18,341,359,300,349,False,3
1,45,kaist_dataset/Mixed/Digital_Camera/(C.S)C-outdoor4/DSC03571.JPG,char_data/1/DSC03571.JPG_0.jpg,810,18,432,450,300,345,False,3
1,61,kaist_dataset/Mixed/Digital_Camera/(C.S)C-outdoor4/DSC03533.JPG,char_data/1/DSC03533.JPG_0.jpg,2257,37,49,86,298,359,False,3
1,38,kaist_dataset/Mixed/Digital_Camera/(C.S)C-outdoor4/DSC03665.JPG,char_data/1/DSC03665.JPG_0.jpg,798,21,387,408,155,193,False,3
1,33,kaist_dataset/Mixed/Digital_Camera/(C.S)C-outdoor4/DSC03741.JPG,char_data/1/DSC03741.JPG_0.jpg,990,30,538,568,369,402,False,3
1,37,kaist_dataset/Mixed/Digital_Camera/(C.S)C-outdoor4/DSC03741.JPG,char_data/1/DSC03741.JPG_0.jpg,1073,29,401,430,362,399,False,3
1,43,kaist_dataset/Mixed/Digital_Camera/(C.S)C-outdoor4/DSC03556.JPG,char_data/1/DSC03556.JPG_0.jpg,774,18,530,548,257,300,False,3
1,39,kaist_dataset/Mixed/Digital_Camera/(C.S)C-outdoor4/DSC03556.JPG,char_data/1/DSC03556.JPG_0.jpg,585,15,26,41,317,356,False,3
1,32,kaist_dataset/Mixed/Digital_Camera/(C.S)C-outdoor4/DSC03757.JPG,char_data/1/DSC03757.JPG_0.jpg,320,10,205,215,337,369,False,3
1,39,kaist_dataset/Mixed/Digital_Camera/(C.S)C-outdoor4/DSC03667.JPG,char_data/1/DSC03667.JPG_0.jpg,429,11,385,396,374,413,False,3
1,39,kaist_dataset/Mixed/Digital_Camera/(C.S)C-outdoor4/DSC03667.JPG,char_data/1/DSC03667.JPG_0.jpg,507,13,395,408,370,409,False,3
1,35,kaist_dataset/Mixed/Digital_Camera/(C.S)C-outdoor4/DSC03667.JPG,char_data/1/DSC03667.JPG_0.jpg,455,13,521,534,372,407,False,3
1,32,kaist_dataset/Mixed/Digital_Camera/(C.S)C-outdoor4/DSC03722.JPG,char_data/1/DSC03722.JPG_0.jpg,544,17,329,346,203,235,False,3
1,26,kaist_dataset/Mixed/Digital_Camera/(C.S)C-outdoor2/DSC02624.JPG,char_data/1/DSC02624.JPG_0.jpg,312,12,516,528,401,427,False,3
1,95,kaist_dataset/Mixed/Digital_Camera/(C.S)C-outdoor2/DSC02865.JPG,char_data/1/DSC02865.JPG_0.jpg,5510,58,47,105,303,398,False,3
1,91,kaist_dataset/Mixed/Digital_Camera/(C.S)C-outdoor2/DSC02865.JPG,char_data/1/DSC02865.JPG_0.jpg,4641,51,303,354,312,403,False,3
1,33,kaist_dataset/Mixed/Digital_Camera/(C.S)C-outdoor2/DSC02492.JPG,char_data/1/DSC02492.JPG_0.jpg,396,12,435,447,326,359,False,3
1,39,kaist_dataset/Mixed/Digital_Camera/(C.S)C-outdoor2/DSC02954.JPG,char_data/1/DSC02954.JPG_0.jpg,507,13,396,409,263,302,False,3
1,35,kaist_dataset/Mixed/Digital_Camera/(C.S)C-outdoor2/DSC02954.JPG,char_data/1/DSC02954.JPG_0.jpg,700,20,408,428,263,298,False,3
1,54,kaist_dataset/Mixed/Digital_Camera/(C.S)C-outdoor2/DSC02397.JPG,char_data/1/DSC02397.JPG_0.jpg,1566,29,609,638,422,476,False,3
1,70,kaist_dataset/Mixed/Digital_Camera/(C.S)C-outdoor2/DSC02502.JPG,char_data/1/DSC02502.JPG_0.jpg,2170,31,166,197,348,418,False,3
1,60,kaist_dataset/Mixed/Digital_Camera/(C.S)C-outdoor2/DSC02502.JPG,char_data/1/DSC02502.JPG_0.jpg,1800,30,307,337,345,405,False,3
1,65,kaist_dataset/Mixed/Digital_Camera/(C.S)C-outdoor2/DSC02502.JPG,char_data/1/DSC02502.JPG_0.jpg,2080,32,336,368,345,410,False,3
1,41,kaist_dataset/Mixed/Digital_Camera/(C.S)C-outdoor2/DSC02413.JPG,char_data/1/DSC02413.JPG_0.jpg,861,21,426,447,207,248,False,3
1,81,kaist_dataset/Mixed/Digital_Camera/(C.S)C-outdoor2/DSC02513.JPG,char_data/1/DSC02513.JPG_0.jpg,2754,34,240,274,142,223,False,3
1,35,kaist_dataset/Mixed/Digital_Camera/(C.S)C-outdoor2/DSC02887.JPG,char_data/1/DSC02887.JPG_0.jpg,630,18,338,356,119,154,False,3
1,40,kaist_dataset/Mixed/Digital_Camera/(C.S)C-outdoor2/DSC02368.JPG,char_data/1/DSC02368.JPG_0.jpg,440,11,415,426,380,420,False,3
1,40,kaist_dataset/Mixed/Digital_Camera/(C.S)C-outdoor2/DSC02545.JPG,char_data/1/DSC02545.JPG_0.jpg,560,14,286,300,399,439,False,3
1,49,kaist_dataset/Mixed/Digital_Camera/(C.S)C-outdoor2/P1010013.JPG,char_data/1/P1010013.JPG_0.jpg,1274,26,345,371,366,415,False,3
1,66,kaist_dataset/Mixed/Digital_Camera/(C.S)C-outdoor2/DSC02503.JPG,char_data/1/DSC02503.JPG_0.jpg,2046,31,545,576,344,410,False,3
1,66,kaist_dataset/Mixed/Digital_Camera/(C.S)C-outdoor2/DSC02503.JPG,char_data/1/DSC02503.JPG_0.jpg,2244,34,577,611,345,411,False,3
1,37,kaist_dataset/Mixed/Digital_Camera/(C.S)C-outdoor2/DSC02895.JPG,char_data/1/DSC02895.JPG_0.jpg,666,18,300,318,352,389,False,3
1,46,kaist_dataset/Mixed/Digital_Camera/(C.S)C-outdoor2/DSC02359.JPG,char_data/1/DSC02359.JPG_0.jpg,966,21,384,405,417,463,False,3
1,35,kaist_dataset/Mixed/Digital_Camera/(C.S)C-outdoor2/DSC02489.JPG,char_data/1/DSC02489.JPG_0.jpg,630,18,378,396,260,295,False,3
1,36,kaist_dataset/Mixed/Digital_Camera/(C.S)C-outdoor2/DSC02422.JPG,char_data/1/DSC02422.JPG_0.jpg,540,15,159,174,222,258,False,3
1,37,kaist_dataset/Mixed/Digital_Camera/(C.S)C-outdoor2/DSC02933.JPG,char_data/1/DSC02933.JPG_0.jpg,407,11,559,570,245,282,False,3
1,39,kaist_dataset/Mixed/Digital_Camera/(C.S)C-outdoor2/DSC02466.JPG,char_data/1/DSC02466.JPG_0.jpg,741,19,347,366,251,290,False,3
1,33,kaist_dataset/Mixed/Digital_Camera/(C.S)C-outdoor2/DSC02553.JPG,char_data/1/DSC02553.JPG_0.jpg,561,17,393,410,300,333,False,3
1,34,kaist_dataset/Mixed/Digital_Camera/(C.S)C-outdoor2/DSC02557.JPG,char_data/1/DSC02557.JPG_0.jpg,544,16,453,469,212,246,False,3
1,44,kaist_dataset/Mixed/Digital_Camera/(C.S)C-outdoor2/DSC02567.JPG,char_data/1/DSC02567.JPG_0.jpg,1100,25,317,342,142,186,False,3
1,44,kaist_dataset/Mixed/Digital_Camera/(C.S)C-outdoor2/DSC02567.JPG,char_data/1/DSC02567.JPG_0.jpg,1012,23,379,402,142,186,False,3
1,26,kaist_dataset/Mixed/Digital_Camera/(C.S)C-outdoor2/DSC02879.JPG,char_data/1/DSC02879.JPG_0.jpg,468,18,315,333,278,304,False,3
1,21,kaist_dataset/Mixed/Digital_Camera/(C.S)C-outdoor2/DSC02879.JPG,char_data/1/DSC02879.JPG_0.jpg,315,15,332,347,279,300,False,3
1,37,kaist_dataset/Mixed/Digital_Camera/(C.S)C-outdoor2/DSC02879.JPG,char_data/1/DSC02879.JPG_0.jpg,370,10,358,368,265,302,False,3
1,33,kaist_dataset/Mixed/Digital_Camera/(C.S)C-outdoor2/DSC02926.JPG,char_data/1/DSC02926.JPG_0.jpg,495,15,423,438,151,184,False,3
1,37,kaist_dataset/Mixed/Digital_Camera/(C.S)C-outdoor2/DSC02543.JPG,char_data/1/DSC02543.JPG_0.jpg,666,18,415,433,347,384,False,3
1,53,kaist_dataset/Mixed/Digital_Camera/(C.S)C-outdoor2/DSC02461.JPG,char_data/1/DSC02461.JPG_0.jpg,2067,39,355,394,275,328,False,3
1,56,kaist_dataset/Mixed/Digital_Camera/(C.S)C-outdoor2/DSC02461.JPG,char_data/1/DSC02461.JPG_0.jpg,2352,42,471,513,272,328,False,3
1,46,kaist_dataset/Mixed/Digital_Camera/(C.S)C-outdoor2/DSC02938.JPG,char_data/1/DSC02938.JPG_0.jpg,874,19,543,562,239,285,False,3
1,70,kaist_dataset/Mixed/Digital_Camera/(C.S)C-outdoor2/DSC02568.JPG,char_data/1/DSC02568.JPG_0.jpg,2170,31,469,500,213,283,False,3
1,39,kaist_dataset/Mixed/Digital_Camera/(C.S)C-outdoor2/DSC02389.JPG,char_data/1/DSC02389.JPG_0.jpg,624,16,370,386,34,73,False,3
1,35,kaist_dataset/Mixed/Digital_Camera/(C.S)C-outdoor2/DSC02389.JPG,char_data/1/DSC02389.JPG_0.jpg,1015,29,416,445,33,68,False,3
1,36,kaist_dataset/Mixed/Digital_Camera/(C.S)C-outdoor2/DSC02391.JPG,char_data/1/DSC02391.JPG_0.jpg,1008,28,103,131,333,369,False,3
1,34,kaist_dataset/Mixed/Digital_Camera/(C.S)C-outdoor2/DSC02391.JPG,char_data/1/DSC02391.JPG_0.jpg,646,19,173,192,334,368,False,3
1,24,kaist_dataset/Mixed/Digital_Camera/(C.S)C-outdoor2/P1010015.JPG,char_data/1/P1010015.JPG_0.jpg,168,7,255,262,184,208,False,3
1,26,kaist_dataset/Mixed/Digital_Camera/(C.S)A-shadow/DSC02624.JPG,char_data/1/DSC02624.JPG_0.jpg,312,12,516,528,401,427,False,3
1,59,kaist_dataset/Mixed/Digital_Camera/(C.S)A-shadow/DSC04304.JPG,char_data/1/DSC04304.JPG_0.jpg,1888,32,474,506,283,342,False,3
1,25,kaist_dataset/Mixed/Digital_Camera/(C.S)A-shadow/P1010017.JPG,char_data/1/P1010017.JPG_0.jpg,400,16,77,93,130,155,False,3
1,44,kaist_dataset/Mixed/Digital_Camera/(C.S)A-shadow/DSC02567.JPG,char_data/1/DSC02567.JPG_0.jpg,1100,25,317,342,142,186,False,3
1,44,kaist_dataset/Mixed/Digital_Camera/(C.S)A-shadow/DSC02567.JPG,char_data/1/DSC02567.JPG_0.jpg,1012,23,379,402,142,186,False,3
1,70,kaist_dataset/Mixed/Digital_Camera/(C.S)A-shadow/DSC02568.JPG,char_data/1/DSC02568.JPG_0.jpg,2170,31,469,500,213,283,False,3
1,24,kaist_dataset/English/Digital_Camera/(E.S)E-night/크기변환_%BA%F7%BD%BA%BD%C5%B8%DE%B4%BA_01_tjtjdska2008.jpg,char_data/1/크기변환_%BA%F7%BD%BA%BD%C5%B8%DE%B4%BA_01_tjtjdska2008.jpg_0.jpg,432,18,335,353,277,301,False,3
1,51,kaist_dataset/English/Digital_Camera/(E.S)E-night/DSC02610.JPG,char_data/1/DSC02610.JPG_0.jpg,1326,26,143,169,385,436,False,3
1,30,kaist_dataset/English/Digital_Camera/(E.S)C-outdoor2/DSC03317.JPG,char_data/1/DSC03317.JPG_0.jpg,600,20,459,479,323,353,False,3
1,47,kaist_dataset/English/Digital_Camera/(E.S)C-outdoor2/DSC03053.JPG,char_data/1/DSC03053.JPG_0.jpg,1034,22,391,413,127,174,False,3
1,42,kaist_dataset/English/Digital_Camera/(E.S)C-outdoor2/DSC03053.JPG,char_data/1/DSC03053.JPG_0.jpg,840,20,436,456,131,173,False,3
1,56,kaist_dataset/English/Digital_Camera/(E.S)C-outdoor2/DSC03650.JPG,char_data/1/DSC03650.JPG_0.jpg,1512,27,304,331,288,344,False,3
1,54,kaist_dataset/English/Digital_Camera/(E.S)C-outdoor2/DSC03650.JPG,char_data/1/DSC03650.JPG_0.jpg,1566,29,466,495,294,348,False,3
1,56,kaist_dataset/English/Digital_Camera/(E.S)C-outdoor2/DSC03161.JPG,char_data/1/DSC03161.JPG_0.jpg,896,16,1,17,225,281,False,3
1,85,kaist_dataset/English/Digital_Camera/(E.S)C-outdoor2/DSC03731.JPG,char_data/1/DSC03731.JPG_0.jpg,3825,45,522,567,28,113,False,3
1,28,kaist_dataset/English/Digital_Camera/(E.S)C-outdoor2/DSC03731.JPG,char_data/1/DSC03731.JPG_0.jpg,252,9,550,559,113,141,False,3
1,24,kaist_dataset/English/Digital_Camera/(E.S)C-outdoor2/DSC03731.JPG,char_data/1/DSC03731.JPG_0.jpg,336,14,600,614,119,143,False,3
1,33,kaist_dataset/English/Digital_Camera/(E.S)C-outdoor2/DSC03162.JPG,char_data/1/DSC03162.JPG_0.jpg,429,13,488,501,148,181,False,3
1,201,kaist_dataset/English/Digital_Camera/(E.S)C-outdoor2/DSC04080.JPG,char_data/1/DSC04080.JPG_0.jpg,22512,112,489,601,214,415,False,3
1,33,kaist_dataset/English/Digital_Camera/(E.S)C-outdoor1/077.JPG,char_data/1/077.JPG_0.jpg,297,9,268,277,250,283,False,3
1,23,kaist_dataset/English/Digital_Camera/(E.S)C-outdoor1/077.JPG,char_data/1/077.JPG_0.jpg,322,14,227,241,253,276,False,3
1,127,kaist_dataset/English/Digital_Camera/(E.S)C-outdoor1/108.JPG,char_data/1/108.JPG_0.jpg,8509,67,466,533,195,322,False,3
1,45,kaist_dataset/English/Digital_Camera/(E.S)C-outdoor1/DSC02450.JPG,char_data/1/DSC02450.JPG_0.jpg,1350,30,309,339,220,265,False,3
1,21,kaist_dataset/English/Digital_Camera/(E.S)C-outdoor1/056.JPG,char_data/1/056.JPG_0.jpg,252,12,537,549,252,273,False,3
1,29,kaist_dataset/English/Digital_Camera/(E.S)C-outdoor1/056.JPG,char_data/1/056.JPG_0.jpg,319,11,590,601,246,275,False,3
1,29,kaist_dataset/English/Digital_Camera/(E.S)C-outdoor1/113.jpg,char_data/1/113.jpg_0.jpg,493,17,513,530,304,333,False,3
1,49,kaist_dataset/English/Digital_Camera/(E.S)C-outdoor1/080116-0065.jpg,char_data/1/080116-0065.jpg_0.jpg,882,18,236,254,369,418,False,3
1,38,kaist_dataset/English/Digital_Camera/(E.S)C-outdoor1/DSC02364.JPG,char_data/1/DSC02364.JPG_0.jpg,570,15,240,255,348,386,False,3
1,39,kaist_dataset/English/Digital_Camera/(E.S)C-outdoor1/DSC02364.JPG,char_data/1/DSC02364.JPG_0.jpg,585,15,310,325,349,388,False,3
1,84,kaist_dataset/English/Digital_Camera/(E.S)C-outdoor1/DSC02491.JPG,char_data/1/DSC02491.JPG_0.jpg,3276,39,436,475,307,391,False,3
1,75,kaist_dataset/English/Digital_Camera/(E.S)C-outdoor1/DSC02491.JPG,char_data/1/DSC02491.JPG_0.jpg,2475,33,525,558,313,388,False,3
1,80,kaist_dataset/English/Digital_Camera/(E.S)C-outdoor1/DSC02491.JPG,char_data/1/DSC02491.JPG_0.jpg,2960,37,559,596,313,393,False,3
1,42,kaist_dataset/English/Digital_Camera/(E.S)F-others/2007-12-09-day-exterior-047.jpg,char_data/1/2007-12-09-day-exterior-047.jpg_0.jpg,462,11,18,29,572,614,False,3
1,204,kaist_dataset/English/Digital_Camera/(E.S)D-indoor/DSC02725.JPG,char_data/1/DSC02725.JPG_0.jpg,23664,116,167,283,170,374,False,3
1,33,kaist_dataset/English/Digital_Camera/(E.S)D-indoor/DSC03943.JPG,char_data/1/DSC03943.JPG_0.jpg,264,8,406,414,310,343,False,3
1,37,kaist_dataset/English/Digital_Camera/(E.S)D-indoor/080119-0009.jpg,char_data/1/080119-0009.jpg_0.jpg,888,24,322,346,1165,1202,False,3
1,56,kaist_dataset/English/Digital_Camera/(E.S)D-indoor/DSC03532.JPG,char_data/1/DSC03532.JPG_0.jpg,1512,27,84,111,416,472,False,3
1,58,kaist_dataset/English/Digital_Camera/(E.S)D-indoor/DSC03532.JPG,char_data/1/DSC03532.JPG_0.jpg,1566,27,166,193,419,477,False,3
T,60,kaist_dataset/Korean/Digital_Camera/outdoor2/2007-12-08-day-109.jpg,char_data/T/2007-12-08-day-109.jpg_2.jpg,2280,38,69,107,800,860,True,29
T,50,kaist_dataset/Korean/Digital_Camera/outdoor2/2007-12-09-day-exterior-006.jpg,char_data/T/2007-12-09-day-exterior-006.jpg_2.jpg,1800,36,1495,1531,576,626,True,29
T,40,kaist_dataset/Korean/Digital_Camera/outdoor2/2007-12-09-day-exterior-036.jpg,char_data/T/2007-12-09-day-exterior-036.jpg_2.jpg,960,24,1406,1430,628,668,True,29
T,43,kaist_dataset/Korean/Digital_Camera/outdoor2/2007-12-08-day-122.jpg,char_data/T/2007-12-08-day-122.jpg_1.jpg,2494,58,879,937,68,111,True,29
T,40,kaist_dataset/Korean/Digital_Camera/outdoor2/2007-12-08-day-122.jpg,char_data/T/2007-12-08-day-122.jpg_1.jpg,1960,49,1127,1176,571,611,True,29
T,58,kaist_dataset/Korean/Digital_Camera/outdoor2/2007-12-09-day-exterior-035.jpg,char_data/T/2007-12-09-day-exterior-035.jpg_0.jpg,2958,51,343,394,702,760,True,29
T,29,kaist_dataset/Korean/Digital_Camera/outdoor2/2007-12-08-day-094.jpg,char_data/T/2007-12-08-day-094.jpg_0.jpg,551,19,710,729,1420,1449,True,29
T,30,kaist_dataset/Korean/Digital_Camera/outdoor2/DSC02372.JPG,char_data/T/DSC02372.JPG_0.jpg,660,22,440,462,293,323,True,29
T,14,kaist_dataset/Korean/Digital_Camera/E-night/103.jpg,char_data/T/103.jpg_0.jpg,112,8,389,397,155,169,True,29
T,20,kaist_dataset/Korean/Digital_Camera/E-night/103.jpg,char_data/T/103.jpg_0.jpg,260,13,139,152,315,335,True,29
T,19,kaist_dataset/Korean/Digital_Camera/indoor1/145.JPG,char_data/T/145.JPG_0.jpg,304,16,214,230,307,326,True,29
T,19,kaist_dataset/Korean/Digital_Camera/indoor1/136.JPG,char_data/T/136.JPG_0.jpg,285,15,324,339,288,307,True,29
T,42,kaist_dataset/Korean/Digital_Camera/G-others/DSC03862.JPG,char_data/T/DSC03862.JPG_0.jpg,1050,25,226,251,351,393,True,29
T,24,kaist_dataset/Korean/Digital_Camera/outdoor6/DSC04341.JPG,char_data/T/DSC04341.JPG_0.jpg,504,21,453,474,225,249,True,29
T,32,kaist_dataset/Korean/Digital_Camera/outdoor3/DSC02971.JPG,char_data/T/DSC02971.JPG_0.jpg,800,25,211,236,295,327,True,29
T,36,kaist_dataset/Korean/Digital_Camera/outdoor3/DSC03237.JPG,char_data/T/DSC03237.JPG_0.jpg,1512,42,158,200,411,447,True,29
T,41,kaist_dataset/Korean/Digital_Camera/outdoor1/127.JPG,char_data/T/127.JPG_0.jpg,1107,27,172,199,271,312,True,29
T,23,kaist_dataset/Korean/Digital_Camera/outdoor1/99.jpg,char_data/T/99.jpg_0.jpg,276,12,130,142,178,201,True,29
T,47,kaist_dataset/Korean/Digital_Camera/outdoor1/2007-12-08-day-047.jpg,char_data/T/2007-12-08-day-047.jpg_0.jpg,1786,38,760,798,706,753,True,29
T,32,kaist_dataset/Mixed/Mobile_Phone/(C.M)A-outdoor/P090908006.jpg,char_data/T/P090908006.jpg_0.jpg,800,25,246,271,369,401,True,29
T,25,kaist_dataset/Mixed/Mobile_Phone/(C.M)A-outdoor/P090912040.jpg,char_data/T/P090912040.jpg_0.jpg,750,30,93,123,190,215,True,29
T,33,kaist_dataset/Mixed/Mobile_Phone/(C.M)A-outdoor/P090912036.jpg,char_data/T/P090912036.jpg_0.jpg,792,24,133,157,190,223,True,29
T,39,kaist_dataset/Mixed/Mobile_Phone/(C.M)A-outdoor/P090912047.jpg,char_data/T/P090912047.jpg_0.jpg,1053,27,199,226,281,320,True,29
T,59,kaist_dataset/Mixed/Mobile_Phone/(C.M)B-indoor/P090831015.jpg,char_data/T/P090831015.jpg_0.jpg,2714,46,109,155,200,259,True,29
T,39,kaist_dataset/Mixed/Mobile_Phone/(C.M)B-indoor/P090831021.jpg,char_data/T/P090831021.jpg_0.jpg,858,22,315,337,42,81,True,29
T,45,kaist_dataset/Mixed/Mobile_Phone/(C.M)B-indoor/P090831021.jpg,char_data/T/P090831021.jpg_0.jpg,1080,24,187,211,377,422,True,29
T,98,kaist_dataset/Mixed/Mobile_Phone/(C.M)C-bookCover/P090831136.jpg,char_data/T/P090831136.jpg_0.jpg,6958,71,401,472,225,323,True,29
T,106,kaist_dataset/Mixed/Mobile_Phone/(C.M)C-bookCover/P090831136.jpg,char_data/T/P090831136.jpg_0.jpg,9434,89,303,392,118,224,True,29
T,98,kaist_dataset/Mixed/Mobile_Phone/(C.M)C-bookCover/P090905002.jpg,char_data/T/P090905002.jpg_0.jpg,4998,51,284,335,31,129,True,29
T,79,kaist_dataset/Mixed/Mobile_Phone/(C.M)C-bookCover/P090831114.jpg,char_data/T/P090831114.jpg_0.jpg,4266,54,320,374,241,320,True,29
T,51,kaist_dataset/Mixed/Digital_Camera/(C.S)C-outdoor1/P1010012.JPG,char_data/T/P1010012.JPG_0.jpg,1887,37,223,260,235,286,True,29
T,30,kaist_dataset/Mixed/Digital_Camera/(C.S)C-outdoor1/048.JPG,char_data/T/048.JPG_0.jpg,600,20,189,209,257,287,True,29
T,38,kaist_dataset/Mixed/Digital_Camera/(C.S)C-outdoor1/51.JPG,char_data/T/51.JPG_0.jpg,1406,37,444,481,379,417,True,29
T,43,kaist_dataset/Mixed/Digital_Camera/(C.S)C-outdoor1/081.JPG,char_data/T/081.JPG_0.jpg,1247,29,101,130,252,295,True,29
T,57,kaist_dataset/Mixed/Digital_Camera/(C.S)C-outdoor1/2007-12-09-day-exterior-078.jpg,char_data/T/2007-12-09-day-exterior-078.jpg_0.jpg,2052,36,374,410,591,648,True,29
T,91,kaist_dataset/Mixed/Digital_Camera/(C.S)C-outdoor1/2007-12-08-day-092.jpg,char_data/T/2007-12-08-day-092.jpg_0.jpg,6188,68,408,476,663,754,True,29
T,39,kaist_dataset/Mixed/Digital_Camera/(C.S)C-outdoor1/P1010010.JPG,char_data/T/P1010010.JPG_0.jpg,1638,42,151,193,217,256,True,29
T,46,kaist_dataset/Mixed/Digital_Camera/(C.S)C-outdoor1/P1010010.JPG,char_data/T/P1010010.JPG_0.jpg,1196,26,279,305,363,409,True,29
T,63,kaist_dataset/Mixed/Digital_Camera/(C.S)C-outdoor1/2007-12-09-day-exterior-086.jpg,char_data/T/2007-12-09-day-exterior-086.jpg_0.jpg,5481,87,574,661,726,789,True,29
T,154,kaist_dataset/Mixed/Digital_Camera/(C.S)C-outdoor1/080119-0017.jpg,char_data/T/080119-0017.jpg_0.jpg,17248,112,976,1088,561,715,True,29
T,51,kaist_dataset/Mixed/Digital_Camera/(C.S)C-outdoor1/080119-0006.jpg,char_data/T/080119-0006.jpg_0.jpg,2040,40,826,866,738,789,True,29
T,28,kaist_dataset/Mixed/Digital_Camera/(C.S)C-outdoor1/121.JPG,char_data/T/121.JPG_0.jpg,616,22,245,267,275,303,True,29
T,32,kaist_dataset/Mixed/Digital_Camera/(C.S)C-outdoor1/009.JPG,char_data/T/009.JPG_0.jpg,864,27,217,244,321,353,True,29
T,37,kaist_dataset/Mixed/Digital_Camera/(C.S)C-outdoor1/P1010011.JPG,char_data/T/P1010011.JPG_0.jpg,851,23,414,437,311,348,True,29
T,120,kaist_dataset/Mixed/Digital_Camera/(C.S)C-outdoor1/008.JPG,char_data/T/008.JPG_0.jpg,6360,53,58,111,133,253,True,29
T,117,kaist_dataset/Mixed/Digital_Camera/(C.S)C-outdoor1/008.JPG,char_data/T/008.JPG_0.jpg,7137,61,339,400,132,249,True,29
T,26,kaist_dataset/Mixed/Digital_Camera/(C.S)C-outdoor1/008.JPG,char_data/T/008.JPG_0.jpg,520,20,410,430,267,293,True,29
T,41,kaist_dataset/Mixed/Digital_Camera/(C.S)C-outdoor1/56.JPG,char_data/T/56.JPG_0.jpg,1312,32,267,299,302,343,True,29
T,41,kaist_dataset/Mixed/Digital_Camera/(C.S)C-outdoor1/45.JPG,char_data/T/45.JPG_0.jpg,1681,41,213,254,361,402,True,29
T,61,kaist_dataset/Mixed/Digital_Camera/(C.S)C-outdoor1/2007-12-09-day-exterior-004.jpg,char_data/T/2007-12-09-day-exterior-004.jpg_0.jpg,3660,60,898,958,662,723,True,29
T,26,kaist_dataset/Mixed/Digital_Camera/(C.S)C-outdoor1/021.JPG,char_data/T/021.JPG_0.jpg,286,11,481,492,207,233,True,29
T,53,kaist_dataset/Mixed/Digital_Camera/(C.S)C-outdoor1/P1010009.JPG,char_data/T/P1010009.JPG_0.jpg,1484,28,195,223,183,236,True,29
T,55,kaist_dataset/Mixed/Digital_Camera/(C.S)C-outdoor1/P1010009.JPG,char_data/T/P1010009.JPG_0.jpg,1705,31,402,433,188,243,True,29
T,37,kaist_dataset/Mixed/Digital_Camera/(C.S)C-outdoor1/DSC02349.JPG,char_data/T/DSC02349.JPG_0.jpg,1073,29,224,253,195,232,True,29
T,26,kaist_dataset/Mixed/Digital_Camera/(C.S)C-outdoor1/57.JPG,char_data/T/57.JPG_0.jpg,546,21,294,315,292,318,True,29
T,123,kaist_dataset/Mixed/Digital_Camera/(C.S)C-outdoor1/080119-0037.jpg,char_data/T/080119-0037.jpg_0.jpg,7995,65,182,247,882,1005,True,29
T,125,kaist_dataset/Mixed/Digital_Camera/(C.S)C-outdoor1/080119-0037.jpg,char_data/T/080119-0037.jpg_0.jpg,8500,68,248,316,877,1002,True,29
T,134,kaist_dataset/Mixed/Digital_Camera/(C.S)C-outdoor1/080119-0037.jpg,char_data/T/080119-0037.jpg_0.jpg,8174,61,798,859,851,985,True,29
T,118,kaist_dataset/Mixed/Digital_Camera/(C.S)C-outdoor1/080119-0037.jpg,char_data/T/080119-0037.jpg_0.jpg,7552,64,1106,1170,843,961,True,29
T,129,kaist_dataset/Mixed/Digital_Camera/(C.S)C-outdoor1/080119-0037.jpg,char_data/T/080119-0037.jpg_0.jpg,7482,58,1250,1308,829,958,True,29
T,50,kaist_dataset/Mixed/Digital_Camera/(C.S)C-outdoor1/DSC02350.JPG,char_data/T/DSC02350.JPG_0.jpg,1900,38,193,231,398,448,True,29
T,104,kaist_dataset/Mixed/Digital_Camera/(C.S)C-outdoor1/2007-12-09-day-exterior-051.jpg,char_data/T/2007-12-09-day-exterior-051.jpg_0.jpg,11128,107,435,542,355,459,True,29
T,49,kaist_dataset/Mixed/Digital_Camera/(C.S)C-outdoor1/2007-12-09-day-exterior-051.jpg,char_data/T/2007-12-09-day-exterior-051.jpg_0.jpg,1421,29,213,242,924,973,True,29
T,60,kaist_dataset/Mixed/Digital_Camera/(C.S)C-outdoor1/2007-12-09-day-exterior-051.jpg,char_data/T/2007-12-09-day-exterior-051.jpg_0.jpg,2820,47,1329,1376,924,984,True,29
T,40,kaist_dataset/Mixed/Digital_Camera/(C.S)C-outdoor1/2007-12-09-day-exterior-037.jpg,char_data/T/2007-12-09-day-exterior-037.jpg_0.jpg,1720,43,613,656,716,756,True,29
T,60,kaist_dataset/Mixed/Digital_Camera/(C.S)C-outdoor1/2007-12-08-day-106.jpg,char_data/T/2007-12-08-day-106.jpg_0.jpg,3660,61,1149,1210,746,806,True,29
T,82,kaist_dataset/Mixed/Digital_Camera/(C.S)C-outdoor1/2007-12-09-day-exterior-044.jpg,char_data/T/2007-12-09-day-exterior-044.jpg_0.jpg,7954,97,502,599,327,409,True,29
T,76,kaist_dataset/Mixed/Digital_Camera/(C.S)C-outdoor1/2007-12-09-day-exterior-044.jpg,char_data/T/2007-12-09-day-exterior-044.jpg_0.jpg,4028,53,1343,1396,970,1046,True,29
T,84,kaist_dataset/Mixed/Digital_Camera/(C.S)C-outdoor1/DSC02244.JPG,char_data/T/DSC02244.JPG_0.jpg,4620,55,82,137,348,432,True,29
T,39,kaist_dataset/Mixed/Digital_Camera/(C.S)C-outdoor1/2007-12-08-day-130.jpg,char_data/T/2007-12-08-day-130.jpg_0.jpg,1404,36,835,871,749,788,True,29
T,53,kaist_dataset/Mixed/Digital_Camera/(C.S)C-outdoor1/025.JPG,char_data/T/025.JPG_0.jpg,1908,36,74,110,332,385,True,29
T,31,kaist_dataset/Mixed/Digital_Camera/(C.S)C-outdoor1/55.JPG,char_data/T/55.JPG_0.jpg,1147,37,226,263,371,402,True,29
T,115,kaist_dataset/Mixed/Digital_Camera/(C.S)C-outdoor1/DSC02320.JPG,char_data/T/DSC02320.JPG_0.jpg,14260,124,171,295,181,296,True,29
T,71,kaist_dataset/Mixed/Digital_Camera/(C.S)C-outdoor1/080119-0008.jpg,char_data/T/080119-0008.jpg_0.jpg,2343,33,1243,1276,654,725,True,29
T,63,kaist_dataset/Mixed/Digital_Camera/(C.S)C-outdoor1/2.JPG,char_data/T/2.JPG_0.jpg,2079,33,431,464,209,272,True,29
T,22,kaist_dataset/Mixed/Digital_Camera/(C.S)C-outdoor1/2.JPG,char_data/T/2.JPG_0.jpg,374,17,517,534,398,420,True,29
T,22,kaist_dataset/Mixed/Digital_Camera/(C.S)C-outdoor1/2.JPG,char_data/T/2.JPG_0.jpg,308,14,587,601,371,393,True,29
T,22,kaist_dataset/Mixed/Digital_Camera/(C.S)C-outdoor1/063.JPG,char_data/T/063.JPG_0.jpg,572,26,303,329,260,282,True,29
T,53,kaist_dataset/Mixed/Digital_Camera/(C.S)C-outdoor1/003.JPG,char_data/T/003.JPG_0.jpg,1696,32,344,376,94,147,True,29
T,52,kaist_dataset/Mixed/Digital_Camera/(C.S)C-outdoor1/1.JPG,char_data/T/1.JPG_0.jpg,1508,29,566,595,281,333,True,29
T,17,kaist_dataset/Mixed/Digital_Camera/(C.S)C-outdoor1/014.JPG,char_data/T/014.JPG_0.jpg,340,20,121,141,280,297,True,29
T,53,kaist_dataset/Mixed/Digital_Camera/(C.S)C-outdoor1/2007-12-08-day-091.jpg,char_data/T/2007-12-08-day-091.jpg_0.jpg,2438,46,1006,1052,635,688,True,29
T,26,kaist_dataset/Mixed/Digital_Camera/(C.S)C-outdoor1/090.JPG,char_data/T/090.JPG_0.jpg,520,20,463,483,362,388,True,29
T,33,kaist_dataset/Mixed/Digital_Camera/(C.S)C-outdoor1/090.JPG,char_data/T/090.JPG_0.jpg,825,25,304,329,388,421,True,29
T,108,kaist_dataset/Mixed/Digital_Camera/(C.S)F-others/DSC02504.JPG,char_data/T/DSC02504.JPG_0.jpg,13392,124,380,504,220,328,True,29
T,43,kaist_dataset/Mixed/Digital_Camera/(C.S)F-others/DSC02504.JPG,char_data/T/DSC02504.JPG_0.jpg,1505,35,101,136,305,348,True,29
T,39,kaist_dataset/Mixed/Digital_Camera/(C.S)F-others/DSC02504.JPG,char_data/T/DSC02504.JPG_0.jpg,897,23,350,373,315,354,True,29
T,38,kaist_dataset/Mixed/Digital_Camera/(C.S)F-others/DSC02504.JPG,char_data/T/DSC02504.JPG_0.jpg,1254,33,502,535,350,388,True,29
T,62,kaist_dataset/Mixed/Digital_Camera/(C.S)F-others/2007-12-08-day-113.jpg,char_data/T/2007-12-08-day-113.jpg_0.jpg,2232,36,335,371,252,314,True,29
T,59,kaist_dataset/Mixed/Digital_Camera/(C.S)F-others/2007-12-08-day-113.jpg,char_data/T/2007-12-08-day-113.jpg_0.jpg,1888,32,514,546,304,363,True,29
T,49,kaist_dataset/Mixed/Digital_Camera/(C.S)F-others/2007-12-08-day-113.jpg,char_data/T/2007-12-08-day-113.jpg_0.jpg,1666,34,735,769,369,418,True,29
T,27,kaist_dataset/Mixed/Digital_Camera/(C.S)F-others/097.jpg,char_data/T/097.jpg_0.jpg,351,13,252,265,167,194,True,29
T,35,kaist_dataset/Mixed/Digital_Camera/(C.S)F-others/097.jpg,char_data/T/097.jpg_0.jpg,350,10,266,276,162,197,True,29
T,31,kaist_dataset/Mixed/Digital_Camera/(C.S)F-others/DSC02609.JPG,char_data/T/DSC02609.JPG_0.jpg,713,23,228,251,312,343,True,29
T,48,kaist_dataset/Mixed/Digital_Camera/(C.S)F-others/DSC02893.JPG,char_data/T/DSC02893.JPG_0.jpg,1920,40,213,253,346,394,True,29
T,56,kaist_dataset/Mixed/Digital_Camera/(C.S)F-others/2007-12-09-day-exterior-023.jpg,char_data/T/2007-12-09-day-exterior-023.jpg_0.jpg,2632,47,784,831,571,627,True,29
T,45,kaist_dataset/Mixed/Digital_Camera/(C.S)D-indoor2/DSC04256.JPG,char_data/T/DSC04256.JPG_0.jpg,1170,26,455,481,100,145,True,29
T,31,kaist_dataset/Mixed/Digital_Camera/(C.S)E-night/P1010155.JPG,char_data/T/P1010155.JPG_0.jpg,620,20,399,419,280,311,True,29
T,35,kaist_dataset/Mixed/Digital_Camera/(C.S)E-night/DSC02647.JPG,char_data/T/DSC02647.JPG_0.jpg,945,27,109,136,296,331,True,29
T,69,kaist_dataset/Mixed/Digital_Camera/(C.S)E-night/P1010152.JPG,char_data/T/P1010152.JPG_0.jpg,3933,57,113,170,228,297,True,29
T,32,kaist_dataset/Mixed/Digital_Camera/(C.S)E-night/P1010156.JPG,char_data/T/P1010156.JPG_0.jpg,992,31,263,294,241,273,True,29
T,63,kaist_dataset/Mixed/Digital_Camera/(C.S)E-night/DSC03517.JPG,char_data/T/DSC03517.JPG_0.jpg,1827,29,501,530,188,251,True,29
T,73,kaist_dataset/Mixed/Digital_Camera/(C.S)E-night/DSC03031.JPG,char_data/T/DSC03031.JPG_0.jpg,3504,48,84,132,64,137,True,29
T,71,kaist_dataset/Mixed/Digital_Camera/(C.S)E-night/DSC03031.JPG,char_data/T/DSC03031.JPG_0.jpg,3195,45,263,308,72,143,True,29
T,27,kaist_dataset/Mixed/Digital_Camera/(C.S)E-night/DSC03840.JPG,char_data/T/DSC03840.JPG_0.jpg,513,19,408,427,204,231,True,29
T,34,kaist_dataset/Mixed/Digital_Camera/(C.S)E-night/DSC02644.JPG,char_data/T/DSC02644.JPG_0.jpg,748,22,267,289,402,436,True,29
T,52,kaist_dataset/Mixed/Digital_Camera/(C.S)E-night/DSC02575.JPG,char_data/T/DSC02575.JPG_0.jpg,2444,47,210,257,352,404,True,29
T,36,kaist_dataset/Mixed/Digital_Camera/(C.S)E-night/DSC02678.JPG,char_data/T/DSC02678.JPG_0.jpg,720,20,345,365,395,431,True,29
T,40,kaist_dataset/Mixed/Digital_Camera/(C.S)E-night/DSC02673.JPG,char_data/T/DSC02673.JPG_0.jpg,480,12,245,257,306,346,True,29
T,53,kaist_dataset/Mixed/Digital_Camera/(C.S)E-night/DSC03561.JPG,char_data/T/DSC03561.JPG_0.jpg,2279,43,156,199,251,304,True,29
T,42,kaist_dataset/Mixed/Digital_Camera/(C.S)E-night/DSC02569.JPG,char_data/T/DSC02569.JPG_0.jpg,798,19,190,209,412,454,True,29
T,39,kaist_dataset/Mixed/Digital_Camera/(C.S)E-night/DSC03871.JPG,char_data/T/DSC03871.JPG_0.jpg,1053,27,378,405,185,224,True,29
T,33,kaist_dataset/Mixed/Digital_Camera/(C.S)E-night/DSC03871.JPG,char_data/T/DSC03871.JPG_0.jpg,759,23,523,546,194,227,True,29
T,38,kaist_dataset/Mixed/Digital_Camera/(C.S)E-night/DSC02903.JPG,char_data/T/DSC02903.JPG_0.jpg,1064,28,234,262,262,300,True,29
T,53,kaist_dataset/Mixed/Digital_Camera/(C.S)E-night/DSC02573.JPG,char_data/T/DSC02573.JPG_0.jpg,1855,35,257,292,187,240,True,29
T,57,kaist_dataset/Mixed/Digital_Camera/(C.S)E-night/P1010147.JPG,char_data/T/P1010147.JPG_0.jpg,2736,48,123,171,257,314,True,29
T,35,kaist_dataset/Mixed/Digital_Camera/(C.S)B-light/DSC03298.JPG,char_data/T/DSC03298.JPG_0.jpg,945,27,300,327,289,324,True,29
T,47,kaist_dataset/Mixed/Digital_Camera/(C.S)D-indoor1/DSC03118.JPG,char_data/T/DSC03118.JPG_0.jpg,1222,26,291,317,146,193,True,29
T,39,kaist_dataset/Mixed/Digital_Camera/(C.S)D-indoor1/DSC03483.JPG,char_data/T/DSC03483.JPG_0.jpg,975,25,377,402,372,411,True,29
T,49,kaist_dataset/Mixed/Digital_Camera/(C.S)D-indoor1/DSC03372.JPG,char_data/T/DSC03372.JPG_0.jpg,1960,40,599,639,392,441,True,29
T,42,kaist_dataset/Mixed/Digital_Camera/(C.S)D-indoor1/DSC04203.JPG,char_data/T/DSC04203.JPG_0.jpg,756,18,94,112,287,329,True,29
T,56,kaist_dataset/Mixed/Digital_Camera/(C.S)D-indoor1/DSC04198.JPG,char_data/T/DSC04198.JPG_0.jpg,2240,40,302,342,82,138,True,29
T,26,kaist_dataset/Mixed/Digital_Camera/(C.S)D-indoor1/DSC04005.JPG,char_data/T/DSC04005.JPG_0.jpg,572,22,214,236,442,468,True,29
T,101,kaist_dataset/Mixed/Digital_Camera/(C.S)D-indoor1/DSC02739.JPG,char_data/T/DSC02739.JPG_0.jpg,8282,82,123,205,43,144,True,29
T,85,kaist_dataset/Mixed/Digital_Camera/(C.S)D-indoor1/DSC03472.JPG,char_data/T/DSC03472.JPG_0.jpg,3910,46,197,243,22,107,True,29
T,84,kaist_dataset/Mixed/Digital_Camera/(C.S)D-indoor1/DSC03472.JPG,char_data/T/DSC03472.JPG_0.jpg,3948,47,408,455,21,105,True,29
T,45,kaist_dataset/Mixed/Digital_Camera/(C.S)D-indoor1/DSC02787.JPG,char_data/T/DSC02787.JPG_0.jpg,1035,23,45,68,382,427,True,29
T,109,kaist_dataset/Mixed/Digital_Camera/(C.S)D-indoor1/DSC02840.JPG,char_data/T/DSC02840.JPG_0.jpg,12971,119,63,182,118,227,True,29
T,63,kaist_dataset/Mixed/Digital_Camera/(C.S)D-indoor1/DSC02733.JPG,char_data/T/DSC02733.JPG_0.jpg,3402,54,155,209,396,459,True,29
T,47,kaist_dataset/Mixed/Digital_Camera/(C.S)D-indoor1/DSC03132.JPG,char_data/T/DSC03132.JPG_0.jpg,1457,31,137,168,168,215,True,29
T,53,kaist_dataset/Mixed/Digital_Camera/(C.S)D-indoor1/DSC03479.JPG,char_data/T/DSC03479.JPG_0.jpg,2279,43,229,272,259,312,True,29
T,45,kaist_dataset/Mixed/Digital_Camera/(C.S)D-indoor1/DSC03980.JPG,char_data/T/DSC03980.JPG_0.jpg,810,18,536,554,143,188,True,29
T,48,kaist_dataset/Mixed/Digital_Camera/(C.S)D-indoor1/DSC03980.JPG,char_data/T/DSC03980.JPG_0.jpg,1968,41,191,232,301,349,True,29
T,50,kaist_dataset/Mixed/Digital_Camera/(C.S)D-indoor1/DSC04206.JPG,char_data/T/DSC04206.JPG_0.jpg,1250,25,131,156,276,326,True,29
T,106,kaist_dataset/Mixed/Digital_Camera/(C.S)D-indoor1/DSC03890.JPG,char_data/T/DSC03890.JPG_0.jpg,7208,68,368,436,237,343,True,29
T,101,kaist_dataset/Mixed/Digital_Camera/(C.S)D-indoor1/DSC03890.JPG,char_data/T/DSC03890.JPG_0.jpg,7373,73,438,511,238,339,True,29
T,47,kaist_dataset/Mixed/Digital_Camera/(C.S)D-indoor1/DSC02713.JPG,char_data/T/DSC02713.JPG_0.jpg,1692,36,140,176,149,196,True,29
T,42,kaist_dataset/Mixed/Digital_Camera/(C.S)D-indoor1/DSC02714.JPG,char_data/T/DSC02714.JPG_0.jpg,1428,34,341,375,74,116,True,29
T,71,kaist_dataset/Mixed/Digital_Camera/(C.S)D-indoor1/DSC02714.JPG,char_data/T/DSC02714.JPG_0.jpg,5751,81,401,482,118,189,True,29
T,34,kaist_dataset/Mixed/Digital_Camera/(C.S)C-outdoor5/DSC04098.JPG,char_data/T/DSC04098.JPG_0.jpg,850,25,399,424,310,344,True,29
T,110,kaist_dataset/Mixed/Digital_Camera/(C.S)C-outdoor5/DSC04449.JPG,char_data/T/DSC04449.JPG_0.jpg,6160,56,6,62,43,153,True,29
T,43,kaist_dataset/Mixed/Digital_Camera/(C.S)C-outdoor5/P1010007.JPG,char_data/T/P1010007.JPG_0.jpg,1290,30,174,204,270,313,True,29
T,33,kaist_dataset/Mixed/Digital_Camera/(C.S)C-outdoor5/DSC04146.JPG,char_data/T/DSC04146.JPG_0.jpg,792,24,231,255,404,437,True,29
T,38,kaist_dataset/Mixed/Digital_Camera/(C.S)C-outdoor5/DSC04144.JPG,char_data/T/DSC04144.JPG_0.jpg,1102,29,195,224,416,454,True,29
T,56,kaist_dataset/Mixed/Digital_Camera/(C.S)C-outdoor5/DSC04060.JPG,char_data/T/DSC04060.JPG_0.jpg,2016,36,182,218,179,235,True,29
T,56,kaist_dataset/Mixed/Digital_Camera/(C.S)C-outdoor5/DSC04060.JPG,char_data/T/DSC04060.JPG_0.jpg,1680,30,283,313,177,233,True,29
T,52,kaist_dataset/Mixed/Digital_Camera/(C.S)C-outdoor5/DSC04060.JPG,char_data/T/DSC04060.JPG_0.jpg,1612,31,386,417,179,231,True,29
T,62,kaist_dataset/Mixed/Digital_Camera/(C.S)C-outdoor5/DSC04060.JPG,char_data/T/DSC04060.JPG_0.jpg,2232,36,266,302,97,159,True,29
T,129,kaist_dataset/Mixed/Digital_Camera/(C.S)C-outdoor5/DSC04465.JPG,char_data/T/DSC04465.JPG_0.jpg,10836,84,192,276,268,397,True,29
T,114,kaist_dataset/Mixed/Digital_Camera/(C.S)C-outdoor5/DSC04465.JPG,char_data/T/DSC04465.JPG_0.jpg,8550,75,273,348,278,392,True,29
T,54,kaist_dataset/Mixed/Digital_Camera/(C.S)C-outdoor5/DSC04094.JPG,char_data/T/DSC04094.JPG_0.jpg,2538,47,138,185,381,435,True,29
T,66,kaist_dataset/Mixed/Digital_Camera/(C.S)C-outdoor5/DSC04108.JPG,char_data/T/DSC04108.JPG_0.jpg,2112,32,278,310,237,303,True,29
T,44,kaist_dataset/Mixed/Digital_Camera/(C.S)C-outdoor5/DSC04104.JPG,char_data/T/DSC04104.JPG_0.jpg,1672,38,357,395,37,81,True,29
T,27,kaist_dataset/Mixed/Digital_Camera/(C.S)C-outdoor5/DSC04086.JPG,char_data/T/DSC04086.JPG_0.jpg,513,19,340,359,369,396,True,29
T,33,kaist_dataset/Mixed/Digital_Camera/(C.S)C-outdoor5/DSC04155.JPG,char_data/T/DSC04155.JPG_0.jpg,693,21,455,476,263,296,True,29
T,45,kaist_dataset/Mixed/Digital_Camera/(C.S)C-outdoor5/DSC03839.JPG,char_data/T/DSC03839.JPG_0.jpg,945,21,202,223,358,403,True,29
T,41,kaist_dataset/Mixed/Digital_Camera/(C.S)C-outdoor5/DSC04337.JPG,char_data/T/DSC04337.JPG_0.jpg,1230,30,279,309,317,358,True,29
T,25,kaist_dataset/Mixed/Digital_Camera/(C.S)C-outdoor5/DSC04357.JPG,char_data/T/DSC04357.JPG_0.jpg,275,11,266,277,352,377,True,29
T,72,kaist_dataset/Mixed/Digital_Camera/(C.S)C-outdoor5/DSC04016.JPG,char_data/T/DSC04016.JPG_0.jpg,4104,57,98,155,110,182,True,29
T,70,kaist_dataset/Mixed/Digital_Camera/(C.S)C-outdoor5/DSC04016.JPG,char_data/T/DSC04016.JPG_0.jpg,3780,54,98,152,317,387,True,29
T,90,kaist_dataset/Mixed/Digital_Camera/(C.S)C-outdoor5/DSC04151.JPG,char_data/T/DSC04151.JPG_0.jpg,8190,91,488,579,249,339,True,29
T,66,kaist_dataset/Mixed/Digital_Camera/(C.S)C-outdoor5/DSC04059.JPG,char_data/T/DSC04059.JPG_0.jpg,1716,26,516,542,114,180,True,29
T,69,kaist_dataset/Mixed/Digital_Camera/(C.S)C-outdoor5/DSC03867.JPG,char_data/T/DSC03867.JPG_0.jpg,2553,37,342,379,299,368,True,29
T,70,kaist_dataset/Mixed/Digital_Camera/(C.S)C-outdoor5/DSC04364.JPG,char_data/T/DSC04364.JPG_0.jpg,3080,44,84,128,387,457,True,29
T,43,kaist_dataset/Mixed/Digital_Camera/(C.S)C-outdoor5/DSC04140.JPG,char_data/T/DSC04140.JPG_0.jpg,688,16,484,500,346,389,True,29
T,32,kaist_dataset/Mixed/Digital_Camera/(C.S)C-outdoor5/DSC04124.JPG,char_data/T/DSC04124.JPG_0.jpg,576,18,380,398,307,339,True,29
T,42,kaist_dataset/Mixed/Digital_Camera/(C.S)C-outdoor5/DSC04071.JPG,char_data/T/DSC04071.JPG_0.jpg,1386,33,56,89,360,402,True,29
T,61,kaist_dataset/Mixed/Digital_Camera/(C.S)C-outdoor5/DSC04033.JPG,char_data/T/DSC04033.JPG_0.jpg,3233,53,32,85,285,346,True,29
T,33,kaist_dataset/Mixed/Digital_Camera/(C.S)C-outdoor5/DSC03829.JPG,char_data/T/DSC03829.JPG_0.jpg,330,10,364,374,179,212,True,29
T,32,kaist_dataset/Mixed/Digital_Camera/(C.S)C-outdoor5/DSC03829.JPG,char_data/T/DSC03829.JPG_0.jpg,544,17,372,389,177,209,True,29
T,35,kaist_dataset/Mixed/Digital_Camera/(C.S)C-outdoor5/DSC04070.JPG,char_data/T/DSC04070.JPG_0.jpg,700,20,286,306,106,141,True,29
T,24,kaist_dataset/Mixed/Digital_Camera/(C.S)C-outdoor5/DSC04031.JPG,char_data/T/DSC04031.JPG_0.jpg,384,16,108,124,382,406,True,29
T,68,kaist_dataset/Mixed/Digital_Camera/(C.S)C-outdoor5/DSC04450.JPG,char_data/T/DSC04450.JPG_0.jpg,2108,31,221,252,50,118,True,29
T,68,kaist_dataset/Mixed/Digital_Camera/(C.S)C-outdoor5/DSC04450.JPG,char_data/T/DSC04450.JPG_0.jpg,2380,35,216,251,260,328,True,29
T,28,kaist_dataset/Mixed/Digital_Camera/(C.S)C-outdoor5/DSC04150.JPG,char_data/T/DSC04150.JPG_0.jpg,644,23,466,489,366,394,True,29
T,50,kaist_dataset/Mixed/Digital_Camera/(C.S)C-outdoor5/DSC04017.JPG,char_data/T/DSC04017.JPG_0.jpg,2100,42,151,193,428,478,True,29
T,38,kaist_dataset/Mixed/Digital_Camera/(C.S)C-outdoor5/P1010002.JPG,char_data/T/P1010002.JPG_0.jpg,1292,34,356,390,280,318,True,29
T,41,kaist_dataset/Mixed/Digital_Camera/(C.S)C-outdoor5/DSC04135.JPG,char_data/T/DSC04135.JPG_0.jpg,1271,31,357,388,385,426,True,29
T,39,kaist_dataset/Mixed/Digital_Camera/(C.S)C-outdoor5/DSC04314.JPG,char_data/T/DSC04314.JPG_0.jpg,780,20,450,470,168,207,True,29
T,38,kaist_dataset/Mixed/Digital_Camera/(C.S)C-outdoor5/DSC04434.JPG,char_data/T/DSC04434.JPG_0.jpg,836,22,291,313,386,424,True,29
T,79,kaist_dataset/Mixed/Digital_Camera/(C.S)C-outdoor3/DSC03055.JPG,char_data/T/DSC03055.JPG_0.jpg,5609,71,57,128,256,335,True,29
T,36,kaist_dataset/Mixed/Digital_Camera/(C.S)C-outdoor3/DSC03316.JPG,char_data/T/DSC03316.JPG_0.jpg,684,19,182,201,86,122,True,29
T,24,kaist_dataset/Mixed/Digital_Camera/(C.S)C-outdoor3/DSC03292.JPG,char_data/T/DSC03292.JPG_0.jpg,432,18,472,490,120,144,True,29
T,42,kaist_dataset/Mixed/Digital_Camera/(C.S)C-outdoor3/DSC02958.JPG,char_data/T/DSC02958.JPG_0.jpg,1218,29,192,221,398,440,True,29
T,36,kaist_dataset/Mixed/Digital_Camera/(C.S)C-outdoor3/DSC03330.JPG,char_data/T/DSC03330.JPG_0.jpg,720,20,182,202,395,431,True,29
T,37,kaist_dataset/Mixed/Digital_Camera/(C.S)C-outdoor3/DSC03062.JPG,char_data/T/DSC03062.JPG_0.jpg,703,19,241,260,246,283,True,29
T,31,kaist_dataset/Mixed/Digital_Camera/(C.S)C-outdoor3/DSC03051.JPG,char_data/T/DSC03051.JPG_0.jpg,620,20,215,235,323,354,True,29
T,42,kaist_dataset/Mixed/Digital_Camera/(C.S)C-outdoor3/DSC03233.JPG,char_data/T/DSC03233.JPG_0.jpg,714,17,65,82,284,326,True,29
T,104,kaist_dataset/Mixed/Digital_Camera/(C.S)C-outdoor3/DSC03260.JPG,char_data/T/DSC03260.JPG_0.jpg,6032,58,41,99,42,146,True,29
T,38,kaist_dataset/Mixed/Digital_Camera/(C.S)C-outdoor3/DSC03312.JPG,char_data/T/DSC03312.JPG_0.jpg,1140,30,75,105,286,324,True,29
T,27,kaist_dataset/Mixed/Digital_Camera/(C.S)C-outdoor3/DSC03255.JPG,char_data/T/DSC03255.JPG_0.jpg,729,27,155,182,188,215,True,29
T,37,kaist_dataset/Mixed/Digital_Camera/(C.S)C-outdoor3/DSC03331.JPG,char_data/T/DSC03331.JPG_0.jpg,740,20,174,194,380,417,True,29
T,35,kaist_dataset/Mixed/Digital_Camera/(C.S)C-outdoor3/DSC03187.JPG,char_data/T/DSC03187.JPG_0.jpg,840,24,179,203,389,424,True,29
T,40,kaist_dataset/Mixed/Digital_Camera/(C.S)C-outdoor3/DSC03212.JPG,char_data/T/DSC03212.JPG_0.jpg,1040,26,311,337,253,293,True,29
T,36,kaist_dataset/Mixed/Digital_Camera/(C.S)C-outdoor3/DSC03328.JPG,char_data/T/DSC03328.JPG_0.jpg,900,25,114,139,401,437,True,29
T,41,kaist_dataset/Mixed/Digital_Camera/(C.S)C-outdoor3/DSC03236.JPG,char_data/T/DSC03236.JPG_0.jpg,1804,44,156,200,423,464,True,29
T,34,kaist_dataset/Mixed/Digital_Camera/(C.S)C-outdoor3/DSC03301.JPG,char_data/T/DSC03301.JPG_0.jpg,748,22,320,342,144,178,True,29
T,37,kaist_dataset/Mixed/Digital_Camera/(C.S)C-outdoor3/DSC02956.JPG,char_data/T/DSC02956.JPG_0.jpg,925,25,58,83,388,425,True,29
T,51,kaist_dataset/Mixed/Digital_Camera/(C.S)C-outdoor3/DSC03185.JPG,char_data/T/DSC03185.JPG_0.jpg,2397,47,122,169,143,194,True,29
T,31,kaist_dataset/Mixed/Digital_Camera/(C.S)C-outdoor3/DSC03035.JPG,char_data/T/DSC03035.JPG_0.jpg,527,17,284,301,369,400,True,29
T,37,kaist_dataset/Mixed/Digital_Camera/(C.S)C-outdoor3/DSC03035.JPG,char_data/T/DSC03035.JPG_0.jpg,851,23,399,422,368,405,True,29
T,27,kaist_dataset/Mixed/Digital_Camera/(C.S)C-outdoor3/DSC03035.JPG,char_data/T/DSC03035.JPG_0.jpg,594,22,284,306,403,430,True,29
T,59,kaist_dataset/Mixed/Digital_Camera/(C.S)C-outdoor3/DSC03306.JPG,char_data/T/DSC03306.JPG_0.jpg,1829,31,460,491,392,451,True,29
T,78,kaist_dataset/Mixed/Digital_Camera/(C.S)C-outdoor3/DSC03067.JPG,char_data/T/DSC03067.JPG_0.jpg,4446,57,179,236,100,178,True,29
T,74,kaist_dataset/Mixed/Digital_Camera/(C.S)C-outdoor3/DSC03409.JPG,char_data/T/DSC03409.JPG_0.jpg,4070,55,255,310,120,194,True,29
T,75,kaist_dataset/Mixed/Digital_Camera/(C.S)C-outdoor3/DSC03060.JPG,char_data/T/DSC03060.JPG_0.jpg,3450,46,174,220,71,146,True,29
T,96,kaist_dataset/Mixed/Digital_Camera/(C.S)C-outdoor3/DSC03247.JPG,char_data/T/DSC03247.JPG_0.jpg,5280,55,274,329,144,240,True,29
T,42,kaist_dataset/Mixed/Digital_Camera/(C.S)C-outdoor3/DSC02969.JPG,char_data/T/DSC02969.JPG_0.jpg,1722,41,204,245,228,270,True,29
T,37,kaist_dataset/Mixed/Digital_Camera/(C.S)C-outdoor3/DSC03329.JPG,char_data/T/DSC03329.JPG_0.jpg,1110,30,499,529,440,477,True,29
T,37,kaist_dataset/Mixed/Digital_Camera/(C.S)C-outdoor3/DSC03309.JPG,char_data/T/DSC03309.JPG_0.jpg,999,27,184,211,263,300,True,29
T,29,kaist_dataset/Mixed/Digital_Camera/(C.S)C-outdoor3/DSC03254.JPG,char_data/T/DSC03254.JPG_0.jpg,1102,38,188,226,228,257,True,29
T,37,kaist_dataset/Mixed/Digital_Camera/(C.S)C-outdoor3/DSC03250.JPG,char_data/T/DSC03250.JPG_0.jpg,1036,28,407,435,400,437,True,29
T,124,kaist_dataset/Mixed/Digital_Camera/(C.S)C-outdoor3/DSC03259.JPG,char_data/T/DSC03259.JPG_0.jpg,11780,95,88,183,60,184,True,29
T,39,kaist_dataset/Mixed/Digital_Camera/(C.S)C-outdoor3/DSC02986.JPG,char_data/T/DSC02986.JPG_0.jpg,975,25,360,385,278,317,True,29
T,34,kaist_dataset/Mixed/Digital_Camera/(C.S)C-outdoor3/DSC03020.JPG,char_data/T/DSC03020.JPG_0.jpg,850,25,499,524,268,302,True,29
T,76,kaist_dataset/Mixed/Digital_Camera/(C.S)C-outdoor3/DSC03415.JPG,char_data/T/DSC03415.JPG_0.jpg,2584,34,438,472,162,238,True,29
T,37,kaist_dataset/Mixed/Digital_Camera/(C.S)C-outdoor3/DSC03061.JPG,char_data/T/DSC03061.JPG_0.jpg,851,23,261,284,253,290,True,29
T,45,kaist_dataset/Mixed/Digital_Camera/(C.S)C-outdoor3/DSC02989.JPG,char_data/T/DSC02989.JPG_0.jpg,1485,33,240,273,261,306,True,29
T,45,kaist_dataset/Mixed/Digital_Camera/(C.S)C-outdoor3/DSC02989.JPG,char_data/T/DSC02989.JPG_0.jpg,1440,32,430,462,265,310,True,29
T,51,kaist_dataset/Mixed/Digital_Camera/(C.S)C-outdoor3/DSC02989.JPG,char_data/T/DSC02989.JPG_0.jpg,1224,24,406,430,343,394,True,29
T,30,kaist_dataset/Mixed/Digital_Camera/(C.S)C-outdoor6/P1010082.JPG,char_data/T/P1010082.JPG_0.jpg,540,18,117,135,230,260,True,29
T,35,kaist_dataset/Mixed/Digital_Camera/(C.S)C-outdoor6/P1010075.JPG,char_data/T/P1010075.JPG_0.jpg,560,16,388,404,306,341,True,29
T,111,kaist_dataset/Mixed/Digital_Camera/(C.S)C-outdoor6/P1010054.JPG,char_data/T/P1010054.JPG_0.jpg,8547,77,292,369,99,210,True,29
T,43,kaist_dataset/Mixed/Digital_Camera/(C.S)C-outdoor6/P1010073.JPG,char_data/T/P1010073.JPG_0.jpg,774,18,302,320,232,275,True,29
T,24,kaist_dataset/Mixed/Digital_Camera/(C.S)C-outdoor6/P1010094.JPG,char_data/T/P1010094.JPG_0.jpg,624,26,423,449,217,241,True,29
T,33,kaist_dataset/Mixed/Digital_Camera/(C.S)C-outdoor6/P1010088.JPG,char_data/T/P1010088.JPG_0.jpg,693,21,241,262,219,252,True,29
T,46,kaist_dataset/Mixed/Digital_Camera/(C.S)C-outdoor6/P1010120.JPG,char_data/T/P1010120.JPG_0.jpg,1748,38,252,290,189,235,True,29
T,31,kaist_dataset/Mixed/Digital_Camera/(C.S)C-outdoor6/P1010020.JPG,char_data/T/P1010020.JPG_0.jpg,682,22,80,102,333,364,True,29
T,37,kaist_dataset/Mixed/Digital_Camera/(C.S)C-outdoor6/P1010080.JPG,char_data/T/P1010080.JPG_0.jpg,1258,34,313,347,245,282,True,29
T,38,kaist_dataset/Mixed/Digital_Camera/(C.S)C-outdoor6/P1010090.JPG,char_data/T/P1010090.JPG_0.jpg,646,17,378,395,197,235,True,29
T,43,kaist_dataset/Mixed/Digital_Camera/(C.S)C-outdoor6/P1010098.JPG,char_data/T/P1010098.JPG_0.jpg,1161,27,345,372,53,96,True,29
T,71,kaist_dataset/Mixed/Digital_Camera/(C.S)C-outdoor6/P1010017.JPG,char_data/T/P1010017.JPG_0.jpg,2414,34,203,237,173,244,True,29
T,37,kaist_dataset/Mixed/Digital_Camera/(C.S)C-outdoor6/P1010093.JPG,char_data/T/P1010093.JPG_0.jpg,814,22,468,490,241,278,True,29
T,43,kaist_dataset/Mixed/Digital_Camera/(C.S)C-outdoor6/P1010021.JPG,char_data/T/P1010021.JPG_0.jpg,1376,32,23,55,213,256,True,29
T,51,kaist_dataset/Mixed/Digital_Camera/(C.S)C-outdoor6/P1010084.JPG,char_data/T/P1010084.JPG_0.jpg,2244,44,237,281,188,239,True,29
T,29,kaist_dataset/Mixed/Digital_Camera/(C.S)C-outdoor6/P1010129.JPG,char_data/T/P1010129.JPG_0.jpg,754,26,333,359,233,262,True,29
T,39,kaist_dataset/Mixed/Digital_Camera/(C.S)C-outdoor6/P1010103.JPG,char_data/T/P1010103.JPG_0.jpg,1248,32,425,457,201,240,True,29
T,23,kaist_dataset/Mixed/Digital_Camera/(C.S)C-outdoor6/P1010065.JPG,char_data/T/P1010065.JPG_0.jpg,437,19,191,210,232,255,True,29
T,23,kaist_dataset/Mixed/Digital_Camera/(C.S)C-outdoor6/P1010065.JPG,char_data/T/P1010065.JPG_0.jpg,276,12,175,187,106,129,True,29
T,24,kaist_dataset/Mixed/Digital_Camera/(C.S)C-outdoor6/P1010065.JPG,char_data/T/P1010065.JPG_0.jpg,384,16,249,265,109,133,True,29
T,34,kaist_dataset/Mixed/Digital_Camera/(C.S)C-outdoor6/P1010056.JPG,char_data/T/P1010056.JPG_0.jpg,748,22,269,291,229,263,True,29
T,40,kaist_dataset/Mixed/Digital_Camera/(C.S)C-outdoor6/P1010018.JPG,char_data/T/P1010018.JPG_0.jpg,1160,29,92,121,241,281,True,29
T,61,kaist_dataset/Mixed/Digital_Camera/(C.S)C-outdoor6/P1010067.JPG,char_data/T/P1010067.JPG_0.jpg,2684,44,289,333,306,367,True,29
T,37,kaist_dataset/Mixed/Digital_Camera/(C.S)C-outdoor6/P1010132.JPG,char_data/T/P1010132.JPG_0.jpg,1147,31,500,531,155,192,True,29
T,33,kaist_dataset/Mixed/Digital_Camera/(C.S)C-outdoor6/P1010097.JPG,char_data/T/P1010097.JPG_0.jpg,957,29,371,400,187,220,True,29
T,51,kaist_dataset/Mixed/Digital_Camera/(C.S)C-outdoor6/P1010087.JPG,char_data/T/P1010087.JPG_0.jpg,2958,58,151,209,180,231,True,29
T,70,kaist_dataset/Mixed/Digital_Camera/(C.S)C-outdoor6/117.JPG,char_data/T/117.JPG_0.jpg,4970,71,343,414,177,247,True,29
T,20,kaist_dataset/Mixed/Digital_Camera/(C.S)C-outdoor6/117.JPG,char_data/T/117.JPG_0.jpg,300,15,237,252,267,287,True,29
T,46,kaist_dataset/Mixed/Digital_Camera/(C.S)C-outdoor6/P1010074.JPG,char_data/T/P1010074.JPG_0.jpg,1978,43,95,138,303,349,True,29
T,51,kaist_dataset/Mixed/Digital_Camera/(C.S)C-outdoor4/DSC03651.JPG,char_data/T/DSC03651.JPG_0.jpg,2244,44,148,192,358,409,True,29
T,49,kaist_dataset/Mixed/Digital_Camera/(C.S)C-outdoor4/DSC03633.JPG,char_data/T/DSC03633.JPG_0.jpg,1323,27,80,107,262,311,True,29
T,35,kaist_dataset/Mixed/Digital_Camera/(C.S)C-outdoor4/DSC03719.JPG,char_data/T/DSC03719.JPG_0.jpg,630,18,29,47,24,59,True,29
T,27,kaist_dataset/Mixed/Digital_Camera/(C.S)C-outdoor4/DSC03719.JPG,char_data/T/DSC03719.JPG_0.jpg,567,21,436,457,184,211,True,29
T,46,kaist_dataset/Mixed/Digital_Camera/(C.S)C-outdoor4/DSC03738.JPG,char_data/T/DSC03738.JPG_0.jpg,1794,39,249,288,233,279,True,29
T,55,kaist_dataset/Mixed/Digital_Camera/(C.S)C-outdoor4/DSC03613.JPG,char_data/T/DSC03613.JPG_0.jpg,1595,29,340,369,20,75,True,29
T,35,kaist_dataset/Mixed/Digital_Camera/(C.S)C-outdoor4/DSC03656.JPG,char_data/T/DSC03656.JPG_0.jpg,1190,34,341,375,417,452,True,29
T,28,kaist_dataset/Mixed/Digital_Camera/(C.S)C-outdoor4/DSC03570.JPG,char_data/T/DSC03570.JPG_0.jpg,700,25,215,240,421,449,True,29
T,27,kaist_dataset/Mixed/Digital_Camera/(C.S)C-outdoor4/DSC03674.JPG,char_data/T/DSC03674.JPG_0.jpg,405,15,488,503,421,448,True,29
T,35,kaist_dataset/Mixed/Digital_Camera/(C.S)C-outdoor4/DSC03616.JPG,char_data/T/DSC03616.JPG_0.jpg,945,27,518,545,149,184,True,29
T,30,kaist_dataset/Mixed/Digital_Camera/(C.S)C-outdoor4/DSC03677.JPG,char_data/T/DSC03677.JPG_0.jpg,510,17,469,486,313,343,True,29
T,28,kaist_dataset/Mixed/Digital_Camera/(C.S)C-outdoor4/DSC03642.JPG,char_data/T/DSC03642.JPG_0.jpg,504,18,375,393,399,427,True,29
T,43,kaist_dataset/Mixed/Digital_Camera/(C.S)C-outdoor4/DSC03435.JPG,char_data/T/DSC03435.JPG_0.jpg,1247,29,108,137,409,452,True,29
T,34,kaist_dataset/Mixed/Digital_Camera/(C.S)C-outdoor4/DSC03658.JPG,char_data/T/DSC03658.JPG_0.jpg,782,23,272,295,417,451,True,29
T,28,kaist_dataset/Mixed/Digital_Camera/(C.S)C-outdoor4/DSC03637.JPG,char_data/T/DSC03637.JPG_0.jpg,644,23,216,239,303,331,True,29
T,25,kaist_dataset/Mixed/Digital_Camera/(C.S)C-outdoor4/DSC03552.JPG,char_data/T/DSC03552.JPG_0.jpg,500,20,302,322,322,347,True,29
T,34,kaist_dataset/Mixed/Digital_Camera/(C.S)C-outdoor4/DSC03769.JPG,char_data/T/DSC03769.JPG_0.jpg,510,15,148,163,416,450,True,29
T,91,kaist_dataset/Mixed/Digital_Camera/(C.S)C-outdoor4/DSC03544.JPG,char_data/T/DSC03544.JPG_0.jpg,4914,54,62,116,165,256,True,29
T,32,kaist_dataset/Mixed/Digital_Camera/(C.S)C-outdoor4/DSC03660.JPG,char_data/T/DSC03660.JPG_0.jpg,1120,35,223,258,102,134,True,29
T,31,kaist_dataset/Mixed/Digital_Camera/(C.S)C-outdoor4/DSC03640.JPG,char_data/T/DSC03640.JPG_0.jpg,868,28,84,112,402,433,True,29
T,44,kaist_dataset/Mixed/Digital_Camera/(C.S)C-outdoor4/DSC03548.JPG,char_data/T/DSC03548.JPG_0.jpg,2420,55,31,86,394,438,True,29
T,26,kaist_dataset/Mixed/Digital_Camera/(C.S)C-outdoor4/DSC03661.JPG,char_data/T/DSC03661.JPG_0.jpg,416,16,339,355,340,366,True,29
T,31,kaist_dataset/Mixed/Digital_Camera/(C.S)C-outdoor4/DSC03691.JPG,char_data/T/DSC03691.JPG_0.jpg,558,18,353,371,225,256,True,29
T,41,kaist_dataset/Mixed/Digital_Camera/(C.S)C-outdoor4/DSC03617.JPG,char_data/T/DSC03617.JPG_0.jpg,984,24,115,139,387,428,True,29
T,29,kaist_dataset/Mixed/Digital_Camera/(C.S)C-outdoor4/DSC03657.JPG,char_data/T/DSC03657.JPG_0.jpg,725,25,246,271,421,450,True,29
T,26,kaist_dataset/Mixed/Digital_Camera/(C.S)C-outdoor4/DSC03618.JPG,char_data/T/DSC03618.JPG_0.jpg,858,33,196,229,410,436,True,29
T,86,kaist_dataset/Mixed/Digital_Camera/(C.S)C-outdoor4/DSC03654.JPG,char_data/T/DSC03654.JPG_0.jpg,3526,41,289,330,154,240,True,29
T,43,kaist_dataset/Mixed/Digital_Camera/(C.S)C-outdoor4/DSC03620.JPG,char_data/T/DSC03620.JPG_0.jpg,2365,55,412,467,96,139,True,29
T,37,kaist_dataset/Mixed/Digital_Camera/(C.S)C-outdoor4/DSC03718.JPG,char_data/T/DSC03718.JPG_0.jpg,518,14,29,43,252,289,True,29
T,33,kaist_dataset/Mixed/Digital_Camera/(C.S)C-outdoor4/DSC03718.JPG,char_data/T/DSC03718.JPG_0.jpg,759,23,429,452,403,436,True,29
T,80,kaist_dataset/Mixed/Digital_Camera/(C.S)C-outdoor4/DSC03609.JPG,char_data/T/DSC03609.JPG_0.jpg,3040,38,129,167,372,452,True,29
T,47,kaist_dataset/Mixed/Digital_Camera/(C.S)C-outdoor4/DSC03631.JPG,char_data/T/DSC03631.JPG_0.jpg,752,16,115,131,355,402,True,29
T,30,kaist_dataset/Mixed/Digital_Camera/(C.S)C-outdoor4/DSC03737.JPG,char_data/T/DSC03737.JPG_0.jpg,690,23,118,141,160,190,True,29
T,56,kaist_dataset/Mixed/Digital_Camera/(C.S)C-outdoor4/DSC03655.JPG,char_data/T/DSC03655.JPG_0.jpg,1456,26,155,181,386,442,True,29
T,48,kaist_dataset/Mixed/Digital_Camera/(C.S)C-outdoor4/DSC03569.JPG,char_data/T/DSC03569.JPG_0.jpg,1392,29,265,294,169,217,True,29
T,30,kaist_dataset/Mixed/Digital_Camera/(C.S)C-outdoor4/DSC03549.JPG,char_data/T/DSC03549.JPG_0.jpg,450,15,271,286,424,454,True,29
T,27,kaist_dataset/Mixed/Digital_Camera/(C.S)C-outdoor4/DSC03446.JPG,char_data/T/DSC03446.JPG_0.jpg,945,35,186,221,296,323,True,29
T,30,kaist_dataset/Mixed/Digital_Camera/(C.S)C-outdoor4/DSC03734.JPG,char_data/T/DSC03734.JPG_0.jpg,600,20,475,495,350,380,True,29
T,71,kaist_dataset/Mixed/Digital_Camera/(C.S)C-outdoor4/DSC03582.JPG,char_data/T/DSC03582.JPG_0.jpg,2911,41,349,390,154,225,True,29
T,95,kaist_dataset/Mixed/Digital_Camera/(C.S)C-outdoor4/DSC03787.JPG,char_data/T/DSC03787.JPG_0.jpg,3230,34,314,348,134,229,True,29
T,91,kaist_dataset/Mixed/Digital_Camera/(C.S)C-outdoor4/DSC03571.JPG,char_data/T/DSC03571.JPG_0.jpg,4277,47,522,569,188,279,True,29
T,34,kaist_dataset/Mixed/Digital_Camera/(C.S)C-outdoor4/DSC03676.JPG,char_data/T/DSC03676.JPG_0.jpg,510,15,26,41,269,303,True,29
T,29,kaist_dataset/Mixed/Digital_Camera/(C.S)C-outdoor4/DSC03689.JPG,char_data/T/DSC03689.JPG_0.jpg,464,16,510,526,131,160,True,29
T,52,kaist_dataset/Mixed/Digital_Camera/(C.S)C-outdoor4/DSC03678.JPG,char_data/T/DSC03678.JPG_0.jpg,1144,22,75,97,229,281,True,29
T,46,kaist_dataset/Mixed/Digital_Camera/(C.S)C-outdoor4/DSC03678.JPG,char_data/T/DSC03678.JPG_0.jpg,1150,25,219,244,235,281,True,29
T,39,kaist_dataset/Mixed/Digital_Camera/(C.S)C-outdoor4/DSC03665.JPG,char_data/T/DSC03665.JPG_0.jpg,1365,35,202,237,155,194,True,29
T,83,kaist_dataset/Mixed/Digital_Camera/(C.S)C-outdoor4/DSC03666.JPG,char_data/T/DSC03666.JPG_0.jpg,5312,64,351,415,159,242,True,29
T,34,kaist_dataset/Mixed/Digital_Camera/(C.S)C-outdoor4/DSC03741.JPG,char_data/T/DSC03741.JPG_0.jpg,1224,36,287,323,363,397,True,29
T,40,kaist_dataset/Mixed/Digital_Camera/(C.S)C-outdoor4/DSC03662.JPG,char_data/T/DSC03662.JPG_0.jpg,1320,33,392,425,419,459,True,29
T,34,kaist_dataset/Mixed/Digital_Camera/(C.S)C-outdoor4/DSC03757.JPG,char_data/T/DSC03757.JPG_0.jpg,612,18,162,180,336,370,True,29
T,51,kaist_dataset/Mixed/Digital_Camera/(C.S)C-outdoor4/DSC03621.JPG,char_data/T/DSC03621.JPG_0.jpg,1377,27,319,346,327,378,True,29
T,66,kaist_dataset/Mixed/Digital_Camera/(C.S)C-outdoor4/DSC03687.JPG,char_data/T/DSC03687.JPG_0.jpg,3696,56,334,390,325,391,True,29
T,24,kaist_dataset/Mixed/Digital_Camera/(C.S)C-outdoor4/DSC03687.JPG,char_data/T/DSC03687.JPG_0.jpg,312,13,161,174,295,319,True,29
T,29,kaist_dataset/Mixed/Digital_Camera/(C.S)C-outdoor4/DSC03687.JPG,char_data/T/DSC03687.JPG_0.jpg,522,18,254,272,292,321,True,29
T,32,kaist_dataset/Mixed/Digital_Camera/(C.S)C-outdoor4/DSC03735.JPG,char_data/T/DSC03735.JPG_0.jpg,608,19,429,448,150,182,True,29
T,41,kaist_dataset/Mixed/Digital_Camera/(C.S)C-outdoor4/DSC03724.JPG,char_data/T/DSC03724.JPG_0.jpg,1189,29,311,340,276,317,True,29
T,25,kaist_dataset/Mixed/Digital_Camera/(C.S)C-outdoor4/DSC03670.JPG,char_data/T/DSC03670.JPG_0.jpg,425,17,406,423,450,475,True,29
T,32,kaist_dataset/Mixed/Digital_Camera/(C.S)C-outdoor4/DSC03722.JPG,char_data/T/DSC03722.JPG_0.jpg,832,26,176,202,202,234,True,29
T,44,kaist_dataset/Mixed/Digital_Camera/(C.S)C-outdoor4/DSC03581.JPG,char_data/T/DSC03581.JPG_0.jpg,1056,24,123,147,193,237,True,29
T,49,kaist_dataset/Mixed/Digital_Camera/(C.S)C-outdoor4/DSC03581.JPG,char_data/T/DSC03581.JPG_0.jpg,1029,21,317,338,126,175,True,29
T,119,kaist_dataset/Mixed/Digital_Camera/(C.S)C-outdoor2/DSC02551.JPG,char_data/T/DSC02551.JPG_0.jpg,11781,99,446,545,269,388,True,29
T,36,kaist_dataset/Mixed/Digital_Camera/(C.S)C-outdoor2/DSC02492.JPG,char_data/T/DSC02492.JPG_0.jpg,1008,28,314,342,325,361,True,29
T,36,kaist_dataset/Mixed/Digital_Camera/(C.S)C-outdoor2/DSC02447.JPG,char_data/T/DSC02447.JPG_0.jpg,828,23,444,467,223,259,True,29
T,39,kaist_dataset/Mixed/Digital_Camera/(C.S)C-outdoor2/DSC02954.JPG,char_data/T/DSC02954.JPG_0.jpg,1131,29,47,76,251,290,True,29
T,24,kaist_dataset/Mixed/Digital_Camera/(C.S)C-outdoor2/DSC02555.JPG,char_data/T/DSC02555.JPG_0.jpg,336,14,128,142,152,176,True,29
T,24,kaist_dataset/Mixed/Digital_Camera/(C.S)C-outdoor2/DSC02555.JPG,char_data/T/DSC02555.JPG_0.jpg,600,25,26,51,253,277,True,29
T,23,kaist_dataset/Mixed/Digital_Camera/(C.S)C-outdoor2/DSC02477.JPG,char_data/T/DSC02477.JPG_0.jpg,276,12,115,127,158,181,True,29
T,25,kaist_dataset/Mixed/Digital_Camera/(C.S)C-outdoor2/DSC02477.JPG,char_data/T/DSC02477.JPG_0.jpg,625,25,25,50,255,280,True,29
T,42,kaist_dataset/Mixed/Digital_Camera/(C.S)C-outdoor2/DSC02361.JPG,char_data/T/DSC02361.JPG_0.jpg,1092,26,467,493,372,414,True,29
T,62,kaist_dataset/Mixed/Digital_Camera/(C.S)C-outdoor2/DSC02400.JPG,char_data/T/DSC02400.JPG_0.jpg,2604,42,127,169,391,453,True,29
T,42,kaist_dataset/Mixed/Digital_Camera/(C.S)C-outdoor2/DSC02910.JPG,char_data/T/DSC02910.JPG_0.jpg,798,19,333,352,54,96,True,29
T,39,kaist_dataset/Mixed/Digital_Camera/(C.S)C-outdoor2/DSC02910.JPG,char_data/T/DSC02910.JPG_0.jpg,585,15,445,460,52,91,True,29
T,39,kaist_dataset/Mixed/Digital_Camera/(C.S)C-outdoor2/DSC02374.JPG,char_data/T/DSC02374.JPG_0.jpg,780,20,206,226,305,344,True,29
T,72,kaist_dataset/Mixed/Digital_Camera/(C.S)C-outdoor2/DSC02385.JPG,char_data/T/DSC02385.JPG_0.jpg,3672,51,396,447,178,250,True,29
T,69,kaist_dataset/Mixed/Digital_Camera/(C.S)C-outdoor2/DSC02870.JPG,char_data/T/DSC02870.JPG_0.jpg,3105,45,224,269,277,346,True,29
T,55,kaist_dataset/Mixed/Digital_Camera/(C.S)C-outdoor2/DSC02439.JPG,char_data/T/DSC02439.JPG_0.jpg,2640,48,330,378,139,194,True,29
T,33,kaist_dataset/Mixed/Digital_Camera/(C.S)C-outdoor2/DSC02479.JPG,char_data/T/DSC02479.JPG_0.jpg,660,20,384,404,222,255,True,29
T,70,kaist_dataset/Mixed/Digital_Camera/(C.S)C-outdoor2/DSC02527.JPG,char_data/T/DSC02527.JPG_0.jpg,2520,36,194,230,288,358,True,29
T,36,kaist_dataset/Mixed/Digital_Camera/(C.S)C-outdoor2/DSC02368.JPG,char_data/T/DSC02368.JPG_0.jpg,612,17,71,88,383,419,True,29
T,39,kaist_dataset/Mixed/Digital_Camera/(C.S)C-outdoor2/DSC02864.JPG,char_data/T/DSC02864.JPG_0.jpg,819,21,557,578,256,295,True,29
T,57,kaist_dataset/Mixed/Digital_Camera/(C.S)C-outdoor2/P1010013.JPG,char_data/T/P1010013.JPG_0.jpg,2337,41,151,192,359,416,True,29
T,43,kaist_dataset/Mixed/Digital_Camera/(C.S)C-outdoor2/DSC02895.JPG,char_data/T/DSC02895.JPG_0.jpg,1032,24,161,185,361,404,True,29
T,44,kaist_dataset/Mixed/Digital_Camera/(C.S)C-outdoor2/DSC02490.JPG,char_data/T/DSC02490.JPG_0.jpg,1100,25,238,263,339,383,True,29
T,42,kaist_dataset/Mixed/Digital_Camera/(C.S)C-outdoor2/DSC02937.JPG,char_data/T/DSC02937.JPG_0.jpg,1092,26,67,93,204,246,True,29
T,35,kaist_dataset/Mixed/Digital_Camera/(C.S)C-outdoor2/DSC02930.JPG,char_data/T/DSC02930.JPG_0.jpg,875,25,236,261,194,229,True,29
T,54,kaist_dataset/Mixed/Digital_Camera/(C.S)C-outdoor2/DSC02359.JPG,char_data/T/DSC02359.JPG_0.jpg,1512,28,149,177,411,465,True,29
T,38,kaist_dataset/Mixed/Digital_Camera/(C.S)C-outdoor2/DSC02376.JPG,char_data/T/DSC02376.JPG_0.jpg,1140,30,383,413,341,379,True,29
T,36,kaist_dataset/Mixed/Digital_Camera/(C.S)C-outdoor2/DSC02489.JPG,char_data/T/DSC02489.JPG_0.jpg,936,26,221,247,262,298,True,29
T,40,kaist_dataset/Mixed/Digital_Camera/(C.S)C-outdoor2/DSC02422.JPG,char_data/T/DSC02422.JPG_0.jpg,840,21,310,331,217,257,True,29
T,43,kaist_dataset/Mixed/Digital_Camera/(C.S)C-outdoor2/DSC02933.JPG,char_data/T/DSC02933.JPG_0.jpg,1075,25,442,467,238,281,True,29
T,49,kaist_dataset/Mixed/Digital_Camera/(C.S)C-outdoor2/DSC02511.JPG,char_data/T/DSC02511.JPG_0.jpg,1225,25,79,104,196,245,True,29
T,36,kaist_dataset/Mixed/Digital_Camera/(C.S)C-outdoor2/DSC02511.JPG,char_data/T/DSC02511.JPG_0.jpg,936,26,165,191,397,433,True,29
T,31,kaist_dataset/Mixed/Digital_Camera/(C.S)C-outdoor2/DSC02556.JPG,char_data/T/DSC02556.JPG_0.jpg,1147,37,234,271,341,372,True,29
T,37,kaist_dataset/Mixed/Digital_Camera/(C.S)C-outdoor2/DSC02553.JPG,char_data/T/DSC02553.JPG_0.jpg,962,26,262,288,297,334,True,29
T,28,kaist_dataset/Mixed/Digital_Camera/(C.S)C-outdoor2/DSC02877.JPG,char_data/T/DSC02877.JPG_0.jpg,672,24,471,495,220,248,True,29
T,30,kaist_dataset/Mixed/Digital_Camera/(C.S)C-outdoor2/DSC02460.JPG,char_data/T/DSC02460.JPG_0.jpg,720,24,276,300,306,336,True,29
T,49,kaist_dataset/Mixed/Digital_Camera/(C.S)C-outdoor2/DSC02567.JPG,char_data/T/DSC02567.JPG_0.jpg,2156,44,116,160,143,192,True,29
T,55,kaist_dataset/Mixed/Digital_Camera/(C.S)C-outdoor2/DSC02365.JPG,char_data/T/DSC02365.JPG_0.jpg,1155,21,258,279,90,145,True,29
T,52,kaist_dataset/Mixed/Digital_Camera/(C.S)C-outdoor2/DSC02365.JPG,char_data/T/DSC02365.JPG_0.jpg,1872,36,305,341,82,134,True,29
T,27,kaist_dataset/Mixed/Digital_Camera/(C.S)C-outdoor2/DSC02879.JPG,char_data/T/DSC02879.JPG_0.jpg,513,19,223,242,291,318,True,29
T,38,kaist_dataset/Mixed/Digital_Camera/(C.S)C-outdoor2/DSC02543.JPG,char_data/T/DSC02543.JPG_0.jpg,1254,33,267,300,351,389,True,29
T,55,kaist_dataset/Mixed/Digital_Camera/(C.S)C-outdoor2/DSC02461.JPG,char_data/T/DSC02461.JPG_0.jpg,3905,71,5,76,288,343,True,29
T,40,kaist_dataset/Mixed/Digital_Camera/(C.S)C-outdoor2/DSC02938.JPG,char_data/T/DSC02938.JPG_0.jpg,1240,31,381,412,240,280,True,29
T,31,kaist_dataset/Mixed/Digital_Camera/(C.S)C-outdoor2/DSC02379.JPG,char_data/T/DSC02379.JPG_0.jpg,837,27,352,379,291,322,True,29
T,41,kaist_dataset/Mixed/Digital_Camera/(C.S)C-outdoor2/DSC02389.JPG,char_data/T/DSC02389.JPG_0.jpg,1681,41,172,213,50,91,True,29
T,28,kaist_dataset/Mixed/Digital_Camera/(C.S)C-outdoor2/DSC02430.JPG,char_data/T/DSC02430.JPG_0.jpg,560,20,94,114,187,215,True,29
T,33,kaist_dataset/Mixed/Digital_Camera/(C.S)C-outdoor2/DSC02377.JPG,char_data/T/DSC02377.JPG_0.jpg,594,18,362,380,356,389,True,29
T,23,kaist_dataset/Mixed/Digital_Camera/(C.S)C-outdoor2/P1010015.JPG,char_data/T/P1010015.JPG_0.jpg,368,16,322,338,186,209,True,29
T,43,kaist_dataset/Mixed/Digital_Camera/(C.S)C-outdoor2/DSC02867.JPG,char_data/T/DSC02867.JPG_0.jpg,1204,28,341,369,399,442,True,29
T,35,kaist_dataset/Mixed/Digital_Camera/(C.S)A-shadow/DSC03257.JPG,char_data/T/DSC03257.JPG_0.jpg,945,27,214,241,381,416,True,29
T,33,kaist_dataset/Mixed/Digital_Camera/(C.S)A-shadow/DSC04306.JPG,char_data/T/DSC04306.JPG_0.jpg,726,22,195,217,408,441,True,29
T,50,kaist_dataset/Mixed/Digital_Camera/(C.S)A-shadow/DSC04304.JPG,char_data/T/DSC04304.JPG_0.jpg,1800,36,285,321,283,333,True,29
T,67,kaist_dataset/Mixed/Digital_Camera/(C.S)A-shadow/DSC04326.JPG,char_data/T/DSC04326.JPG_0.jpg,2211,33,275,308,11,78,True,29
T,31,kaist_dataset/Mixed/Digital_Camera/(C.S)A-shadow/DSC02609.JPG,char_data/T/DSC02609.JPG_0.jpg,713,23,228,251,312,343,True,29
T,63,kaist_dataset/Mixed/Digital_Camera/(C.S)A-shadow/DSC03520.JPG,char_data/T/DSC03520.JPG_0.jpg,2394,38,351,389,45,108,True,29
T,49,kaist_dataset/Mixed/Digital_Camera/(C.S)A-shadow/DSC02567.JPG,char_data/T/DSC02567.JPG_0.jpg,2156,44,116,160,143,192,True,29
T,31,kaist_dataset/Mixed/Digital_Camera/(C.S)A-shadow/DSC02579.JPG,char_data/T/DSC02579.JPG_0.jpg,961,31,172,203,403,434,True,29
T,36,kaist_dataset/Mixed/Digital_Camera/(C.S)A-shadow/DSC02581.JPG,char_data/T/DSC02581.JPG_0.jpg,900,25,187,212,388,424,True,29
T,45,kaist_dataset/Mixed/Digital_Camera/(C.S)A-shadow/P1010019.JPG,char_data/T/P1010019.JPG_0.jpg,1215,27,255,282,198,243,True,29
T,121,kaist_dataset/English/Mobile_Phone/(E.M)A-outdoor/P090911064.jpg,char_data/T/P090911064.jpg_0.jpg,18392,152,436,588,114,235,True,29
T,62,kaist_dataset/English/Mobile_Phone/(E.M)B-indoor/P090902018.jpg,char_data/T/P090902018.jpg_0.jpg,2542,41,368,409,299,361,True,29
T,108,kaist_dataset/English/Mobile_Phone/(E.M)B-indoor/P090911086.jpg,char_data/T/P090911086.jpg_0.jpg,9288,86,7,93,347,455,True,29
T,51,kaist_dataset/English/Mobile_Phone/(E.M)B-indoor/P090911060.jpg,char_data/T/P090911060.jpg_0.jpg,2346,46,284,330,17,68,True,29
T,112,kaist_dataset/English/Mobile_Phone/(E.M)C-bookCover/P090903056.jpg,char_data/T/P090903056.jpg_0.jpg,8624,77,11,88,291,403,True,29
T,138,kaist_dataset/English/Mobile_Phone/(E.M)C-bookCover/P090831077.jpg,char_data/T/P090831077.jpg_0.jpg,12834,93,15,108,238,376,True,29
T,70,kaist_dataset/English/Mobile_Phone/(E.M)C-bookCover/P090903071.jpg,char_data/T/P090903071.jpg_0.jpg,4200,60,229,289,147,217,True,29
T,87,kaist_dataset/English/Mobile_Phone/(E.M)C-bookCover/P090905007.jpg,char_data/T/P090905007.jpg_0.jpg,6699,77,353,430,41,128,True,29
T,90,kaist_dataset/English/Mobile_Phone/(E.M)C-bookCover/P090905007.jpg,char_data/T/P090905007.jpg_0.jpg,5580,62,106,168,169,259,True,29
T,89,kaist_dataset/English/Mobile_Phone/(E.M)C-bookCover/P090905007.jpg,char_data/T/P090905007.jpg_0.jpg,6141,69,165,234,170,259,True,29
T,80,kaist_dataset/English/Mobile_Phone/(E.M)C-bookCover/P090905007.jpg,char_data/T/P090905007.jpg_0.jpg,4880,61,560,621,174,254,True,29
T,76,kaist_dataset/English/Mobile_Phone/(E.M)C-bookCover/P090905007.jpg,char_data/T/P090905007.jpg_0.jpg,5776,76,148,224,294,370,True,29
T,62,kaist_dataset/English/Mobile_Phone/(E.M)C-bookCover/P090903041.jpg,char_data/T/P090903041.jpg_0.jpg,2604,42,226,268,21,83,True,29
T,52,kaist_dataset/English/Mobile_Phone/(E.M)C-bookCover/P090903041.jpg,char_data/T/P090903041.jpg_0.jpg,2288,44,506,550,29,81,True,29
T,95,kaist_dataset/English/Mobile_Phone/(E.M)C-bookCover/P090831039.jpg,char_data/T/P090831039.jpg_0.jpg,5890,62,80,142,18,113,True,29
T,61,kaist_dataset/English/Mobile_Phone/(E.M)C-bookCover/P090903054.jpg,char_data/T/P090903054.jpg_0.jpg,1769,29,278,307,346,407,True,29
T,56,kaist_dataset/English/Mobile_Phone/(E.M)C-bookCover/P090903054.jpg,char_data/T/P090903054.jpg_0.jpg,1568,28,306,334,348,404,True,29
T,53,kaist_dataset/English/Mobile_Phone/(E.M)C-bookCover/P090903054.jpg,char_data/T/P090903054.jpg_0.jpg,1537,29,525,554,350,403,True,29
T,77,kaist_dataset/English/Mobile_Phone/(E.M)C-bookCover/P090903050.jpg,char_data/T/P090903050.jpg_0.jpg,6006,78,172,250,9,86,True,29
T,126,kaist_dataset/English/Mobile_Phone/(E.M)C-bookCover/P090831037.jpg,char_data/T/P090831037.jpg_0.jpg,13986,111,275,386,60,186,True,29
T,135,kaist_dataset/English/Mobile_Phone/(E.M)C-bookCover/P090831037.jpg,char_data/T/P090831037.jpg_0.jpg,13770,102,295,397,190,325,True,29
T,62,kaist_dataset/English/Mobile_Phone/(E.M)C-bookCover/P090831075.jpg,char_data/T/P090831075.jpg_0.jpg,2356,38,398,436,279,341,True,29
T,53,kaist_dataset/English/Mobile_Phone/(E.M)C-bookCover/P090831075.jpg,char_data/T/P090831075.jpg_0.jpg,2067,39,527,566,285,338,True,29
T,89,kaist_dataset/English/Mobile_Phone/(E.M)C-bookCover/P090903055.jpg,char_data/T/P090903055.jpg_0.jpg,7743,87,22,109,152,241,True,29
T,38,kaist_dataset/English/Mobile_Phone/(E.M)C-bookCover/P090903055.jpg,char_data/T/P090903055.jpg_0.jpg,1330,35,139,174,408,446,True,29
T,106,kaist_dataset/English/Digital_Camera/(E.S)E-night/DSC02613.JPG,char_data/T/DSC02613.JPG_0.jpg,12508,118,514,632,164,270,True,29
T,106,kaist_dataset/English/Digital_Camera/(E.S)E-night/DSC02606.JPG,char_data/T/DSC02606.JPG_0.jpg,9964,94,505,599,187,293,True,29
T,82,kaist_dataset/English/Digital_Camera/(E.S)E-night/DSC02675.JPG,char_data/T/DSC02675.JPG_0.jpg,4428,54,420,474,190,272,True,29
T,87,kaist_dataset/English/Digital_Camera/(E.S)E-night/DSC02675.JPG,char_data/T/DSC02675.JPG_0.jpg,5133,59,474,533,186,273,True,29
T,18,kaist_dataset/English/Digital_Camera/(E.S)E-night/111.jpg,char_data/T/111.jpg_0.jpg,198,11,241,252,286,304,True,29
T,17,kaist_dataset/English/Digital_Camera/(E.S)E-night/111.jpg,char_data/T/111.jpg_0.jpg,238,14,292,306,270,287,True,29
T,16,kaist_dataset/English/Digital_Camera/(E.S)E-night/111.jpg,char_data/T/111.jpg_0.jpg,128,8,329,337,271,287,True,29
T,52,kaist_dataset/English/Digital_Camera/(E.S)C-outdoor2/DSC03023.JPG,char_data/T/DSC03023.JPG_0.jpg,1248,24,129,153,300,352,True,29
T,78,kaist_dataset/English/Digital_Camera/(E.S)C-outdoor2/DSC02993.JPG,char_data/T/DSC02993.JPG_0.jpg,4758,61,268,329,126,204,True,29
T,43,kaist_dataset/English/Digital_Camera/(E.S)C-outdoor2/DSC03317.JPG,char_data/T/DSC03317.JPG_0.jpg,817,19,414,433,195,238,True,29
T,40,kaist_dataset/English/Digital_Camera/(E.S)C-outdoor2/DSC03317.JPG,char_data/T/DSC03317.JPG_0.jpg,880,22,536,558,193,233,True,29
T,45,kaist_dataset/English/Digital_Camera/(E.S)C-outdoor2/DSC03053.JPG,char_data/T/DSC03053.JPG_0.jpg,1215,27,236,263,126,171,True,29
T,68,kaist_dataset/English/Digital_Camera/(E.S)C-outdoor2/DSC04313.JPG,char_data/T/DSC04313.JPG_0.jpg,3060,45,381,426,114,182,True,29
T,54,kaist_dataset/English/Digital_Camera/(E.S)C-outdoor2/DSC03650.JPG,char_data/T/DSC03650.JPG_0.jpg,1836,34,359,393,212,266,True,29
T,92,kaist_dataset/English/Digital_Camera/(E.S)C-outdoor2/ktx.jpg,char_data/T/ktx.jpg_0.jpg,6808,74,120,194,52,144,True,29
T,40,kaist_dataset/English/Digital_Camera/(E.S)C-outdoor2/DSC03436.JPG,char_data/T/DSC03436.JPG_0.jpg,1080,27,155,182,121,161,True,29
T,54,kaist_dataset/English/Digital_Camera/(E.S)C-outdoor2/IMG_2481.JPG,char_data/T/IMG_2481.JPG_0.jpg,2970,55,388,443,194,248,True,29
T,67,kaist_dataset/English/Digital_Camera/(E.S)C-outdoor2/DSC03865.JPG,char_data/T/DSC03865.JPG_0.jpg,3283,49,582,631,96,163,True,29
T,31,kaist_dataset/English/Digital_Camera/(E.S)C-outdoor2/DSC03294.JPG,char_data/T/DSC03294.JPG_0.jpg,713,23,190,213,398,429,True,29
T,57,kaist_dataset/English/Digital_Camera/(E.S)C-outdoor2/DSC03412.JPG,char_data/T/DSC03412.JPG_0.jpg,2850,50,208,258,398,455,True,29
T,47,kaist_dataset/English/Digital_Camera/(E.S)C-outdoor2/DSC03575.JPG,char_data/T/DSC03575.JPG_0.jpg,1645,35,290,325,177,224,True,29
T,47,kaist_dataset/English/Digital_Camera/(E.S)C-outdoor2/DSC03705.JPG,char_data/T/DSC03705.JPG_0.jpg,1316,28,296,324,315,362,True,29
T,58,kaist_dataset/English/Digital_Camera/(E.S)C-outdoor2/DSC04464.JPG,char_data/T/DSC04464.JPG_0.jpg,2726,47,436,483,328,386,True,29
T,62,kaist_dataset/English/Digital_Camera/(E.S)C-outdoor2/DSC03413.JPG,char_data/T/DSC03413.JPG_0.jpg,2480,40,191,231,195,257,True,29
T,135,kaist_dataset/English/Digital_Camera/(E.S)C-outdoor2/DSC04163.JPG,char_data/T/DSC04163.JPG_0.jpg,15660,116,117,233,117,252,True,29
T,31,kaist_dataset/English/Digital_Camera/(E.S)C-outdoor2/DSC03731.JPG,char_data/T/DSC03731.JPG_0.jpg,403,13,507,520,114,145,True,29
T,51,kaist_dataset/English/Digital_Camera/(E.S)C-outdoor2/DSC03168.JPG,char_data/T/DSC03168.JPG_0.jpg,2499,49,218,267,291,342,True,29
T,83,kaist_dataset/English/Digital_Camera/(E.S)C-outdoor2/DSC03432.JPG,char_data/T/DSC03432.JPG_0.jpg,3735,45,415,460,357,440,True,29
T,76,kaist_dataset/English/Digital_Camera/(E.S)C-outdoor2/DSC03225.JPG,char_data/T/DSC03225.JPG_0.jpg,4484,59,51,110,39,115,True,29
T,67,kaist_dataset/English/Digital_Camera/(E.S)C-outdoor2/DSC03012.JPG,char_data/T/DSC03012.JPG_0.jpg,2144,32,491,523,215,282,True,29
T,64,kaist_dataset/English/Digital_Camera/(E.S)C-outdoor2/DSC03264.JPG,char_data/T/DSC03264.JPG_0.jpg,3264,51,294,345,162,226,True,29
T,67,kaist_dataset/English/Digital_Camera/(E.S)C-outdoor2/DSC03264.JPG,char_data/T/DSC03264.JPG_0.jpg,3685,55,236,291,92,159,True,29
T,43,kaist_dataset/English/Digital_Camera/(E.S)C-outdoor2/DSC03160.JPG,char_data/T/DSC03160.JPG_0.jpg,1075,25,267,292,396,439,True,29
T,35,kaist_dataset/English/Digital_Camera/(E.S)C-outdoor2/DSC03162.JPG,char_data/T/DSC03162.JPG_0.jpg,770,22,371,393,146,181,True,29
T,97,kaist_dataset/English/Digital_Camera/(E.S)C-outdoor2/DSC02984.JPG,char_data/T/DSC02984.JPG_0.jpg,5917,61,286,347,98,195,True,29
T,62,kaist_dataset/English/Digital_Camera/(E.S)C-outdoor2/DSC04080.JPG,char_data/T/DSC04080.JPG_0.jpg,3658,59,219,278,294,356,True,29
T,64,kaist_dataset/English/Digital_Camera/(E.S)C-outdoor2/DSC03050.JPG,char_data/T/DSC03050.JPG_0.jpg,4992,78,320,398,210,274,True,29
T,70,kaist_dataset/English/Digital_Camera/(E.S)C-outdoor2/DSC04131.JPG,char_data/T/DSC04131.JPG_0.jpg,5460,78,487,565,133,203,True,29
T,96,kaist_dataset/English/Digital_Camera/(E.S)C-outdoor1/DSC02306.JPG,char_data/T/DSC02306.JPG_0.jpg,7296,76,464,540,147,243,True,29
T,48,kaist_dataset/English/Digital_Camera/(E.S)C-outdoor1/DSC02356.JPG,char_data/T/DSC02356.JPG_0.jpg,1920,40,28,68,298,346,True,29
T,171,kaist_dataset/English/Digital_Camera/(E.S)C-outdoor1/DSC02354.JPG,char_data/T/DSC02354.JPG_0.jpg,24111,141,33,174,156,327,True,29
T,38,kaist_dataset/English/Digital_Camera/(E.S)C-outdoor1/DSC02427.JPG,char_data/T/DSC02427.JPG_0.jpg,1292,34,328,362,366,404,True,29
T,128,kaist_dataset/English/Digital_Camera/(E.S)C-outdoor1/DSC02450.JPG,char_data/T/DSC02450.JPG_0.jpg,7936,62,47,109,60,188,True,29
T,49,kaist_dataset/English/Digital_Camera/(E.S)C-outdoor1/DSC02450.JPG,char_data/T/DSC02450.JPG_0.jpg,1911,39,54,93,218,267,True,29
T,88,kaist_dataset/English/Digital_Camera/(E.S)C-outdoor1/DSC02345.JPG,char_data/T/DSC02345.JPG_0.jpg,8096,92,203,295,139,227,True,29
T,31,kaist_dataset/English/Digital_Camera/(E.S)C-outdoor1/DSC02345.JPG,char_data/T/DSC02345.JPG_0.jpg,434,14,161,175,239,270,False,29
T,28,kaist_dataset/English/Digital_Camera/(E.S)C-outdoor1/DSC02345.JPG,char_data/T/DSC02345.JPG_0.jpg,756,27,222,249,240,268,False,29
T,30,kaist_dataset/English/Digital_Camera/(E.S)C-outdoor1/DSC02345.JPG,char_data/T/DSC02345.JPG_0.jpg,510,17,442,459,237,267,False,29
T,57,kaist_dataset/English/Digital_Camera/(E.S)C-outdoor1/DSC02480.JPG,char_data/T/DSC02480.JPG_0.jpg,2223,39,92,131,403,460,False,29
T,87,kaist_dataset/English/Digital_Camera/(E.S)C-outdoor1/DSC02410.JPG,char_data/T/DSC02410.JPG_0.jpg,6438,74,239,313,120,207,False,29
T,134,kaist_dataset/English/Digital_Camera/(E.S)C-outdoor1/DSC02448.JPG,char_data/T/DSC02448.JPG_0.jpg,8576,64,196,260,192,326,False,29
T,86,kaist_dataset/English/Digital_Camera/(E.S)C-outdoor1/DSC02897.JPG,char_data/T/DSC02897.JPG_0.jpg,6622,77,547,624,265,351,False,29
T,26,kaist_dataset/English/Digital_Camera/(E.S)C-outdoor1/056.JPG,char_data/T/056.JPG_0.jpg,312,12,497,509,251,277,False,29
T,103,kaist_dataset/English/Digital_Camera/(E.S)C-outdoor1/DSC02590.JPG,char_data/T/DSC02590.JPG_0.jpg,8034,78,177,255,126,229,False,29
T,43,kaist_dataset/English/Digital_Camera/(E.S)C-outdoor1/080116-0065.jpg,char_data/T/080116-0065.jpg_0.jpg,1204,28,460,488,338,381,False,29
T,45,kaist_dataset/English/Digital_Camera/(E.S)C-outdoor1/064.JPG,char_data/T/064.JPG_0.jpg,1080,24,472,496,189,234,False,29
T,42,kaist_dataset/English/Digital_Camera/(E.S)C-outdoor1/064.JPG,char_data/T/064.JPG_0.jpg,1092,26,496,522,188,230,False,29
T,67,kaist_dataset/English/Digital_Camera/(E.S)C-outdoor1/080119-0012.jpg,char_data/T/080119-0012.jpg_0.jpg,4087,61,847,908,553,620,False,29
T,81,kaist_dataset/English/Digital_Camera/(E.S)C-outdoor1/DSC02408.JPG,char_data/T/DSC02408.JPG_0.jpg,4536,56,370,426,265,346,False,29
T,134,kaist_dataset/English/Digital_Camera/(E.S)C-outdoor1/2007-12-09-day-exterior-063.jpg,char_data/T/2007-12-09-day-exterior-063.jpg_0.jpg,12998,97,966,1063,441,575,False,29
T,81,kaist_dataset/English/Digital_Camera/(E.S)C-outdoor1/DSC02417.JPG,char_data/T/DSC02417.JPG_0.jpg,5265,65,51,116,129,210,False,29
T,161,kaist_dataset/English/Digital_Camera/(E.S)C-outdoor1/DSC02475.JPG,char_data/T/DSC02475.JPG_0.jpg,19803,123,487,610,77,238,False,29
T,75,kaist_dataset/English/Digital_Camera/(E.S)C-outdoor1/DSC02398.JPG,char_data/T/DSC02398.JPG_0.jpg,3750,50,289,339,236,311,False,29
T,60,kaist_dataset/English/Digital_Camera/(E.S)C-outdoor1/031.JPG,char_data/T/031.JPG_0.jpg,2640,44,134,178,188,248,False,29
T,24,kaist_dataset/English/Digital_Camera/(E.S)C-outdoor1/031.JPG,char_data/T/031.JPG_0.jpg,408,17,103,120,318,342,False,29
T,22,kaist_dataset/English/Digital_Camera/(E.S)C-outdoor1/031.JPG,char_data/T/031.JPG_0.jpg,352,16,495,511,320,342,False,29
T,45,kaist_dataset/English/Digital_Camera/(E.S)C-outdoor1/031.JPG,char_data/T/031.JPG_0.jpg,1665,37,303,340,351,396,False,29
T,102,kaist_dataset/English/Digital_Camera/(E.S)C-outdoor1/129.JPG,char_data/T/129.JPG_0.jpg,4692,46,300,346,193,295,False,29
T,66,kaist_dataset/English/Digital_Camera/(E.S)C-outdoor1/080118-0011.jpg,char_data/T/080118-0011.jpg_0.jpg,2574,39,709,748,936,1002,False,29
T,72,kaist_dataset/English/Digital_Camera/(E.S)C-outdoor1/080118-0011.jpg,char_data/T/080118-0011.jpg_0.jpg,4320,60,746,806,458,530,False,29
T,65,kaist_dataset/English/Digital_Camera/(E.S)C-outdoor1/080118-0011.jpg,char_data/T/080118-0011.jpg_0.jpg,3445,53,805,858,529,594,False,29
T,72,kaist_dataset/English/Digital_Camera/(E.S)C-outdoor1/055.JPG,char_data/T/055.JPG_0.jpg,3600,50,332,382,184,256,False,29
T,140,kaist_dataset/English/Digital_Camera/(E.S)C-outdoor1/DSC02406.JPG,char_data/T/DSC02406.JPG_0.jpg,12740,91,165,256,269,409,False,29
T,42,kaist_dataset/English/Digital_Camera/(E.S)C-outdoor1/041.JPG,char_data/T/041.JPG_0.jpg,1008,24,421,445,247,289,False,29
T,29,kaist_dataset/English/Digital_Camera/(E.S)C-outdoor1/DSC02500.JPG,char_data/T/DSC02500.JPG_0.jpg,435,15,22,37,103,132,False,29
T,24,kaist_dataset/English/Digital_Camera/(E.S)C-outdoor1/DSC02500.JPG,char_data/T/DSC02500.JPG_0.jpg,240,10,21,31,81,105,False,29
T,99,kaist_dataset/English/Digital_Camera/(E.S)C-outdoor1/DSC02500.JPG,char_data/T/DSC02500.JPG_0.jpg,7821,79,523,602,173,272,False,29
T,134,kaist_dataset/English/Digital_Camera/(E.S)C-outdoor1/DSC02501.JPG,char_data/T/DSC02501.JPG_0.jpg,18090,135,443,578,92,226,False,29
T,59,kaist_dataset/English/Digital_Camera/(E.S)C-outdoor1/DSC02501.JPG,char_data/T/DSC02501.JPG_0.jpg,3127,53,349,402,297,356,False,29
T,49,kaist_dataset/English/Digital_Camera/(E.S)C-outdoor1/DSC02918.JPG,char_data/T/DSC02918.JPG_0.jpg,2156,44,55,99,227,276,False,29
T,41,kaist_dataset/English/Digital_Camera/(E.S)C-outdoor1/089.jpg,char_data/T/089.jpg_0.jpg,779,19,369,388,289,330,False,29
T,57,kaist_dataset/English/Digital_Camera/(E.S)C-outdoor1/089.jpg,char_data/T/089.jpg_0.jpg,1539,27,507,534,268,325,False,29
T,46,kaist_dataset/English/Digital_Camera/(E.S)C-outdoor1/6.jpg,char_data/T/6.jpg_0.jpg,1610,35,475,510,95,141,False,29
T,46,kaist_dataset/English/Digital_Camera/(E.S)C-outdoor1/6.jpg,char_data/T/6.jpg_0.jpg,1610,35,512,547,95,141,False,29
T,88,kaist_dataset/English/Digital_Camera/(E.S)C-outdoor1/DSC02491.JPG,char_data/T/DSC02491.JPG_0.jpg,5016,57,81,138,315,403,False,29
T,77,kaist_dataset/English/Digital_Camera/(E.S)C-outdoor1/110.jpg,char_data/T/110.jpg_0.jpg,4389,57,320,377,195,272,False,29
T,51,kaist_dataset/English/Digital_Camera/(E.S)B-light/DSC02712.JPG,char_data/T/DSC02712.JPG_0.jpg,1734,34,150,184,213,264,False,29
T,25,kaist_dataset/English/Digital_Camera/(E.S)B-light/x.jpg,char_data/T/x.jpg_0.jpg,400,16,123,139,108,133,False,29
T,172,kaist_dataset/English/Digital_Camera/(E.S)B-light/080116-0059.jpg,char_data/T/080116-0059.jpg_0.jpg,13416,78,1059,1137,332,504,False,29
T,39,kaist_dataset/English/Digital_Camera/(E.S)B-light/080116-0059.jpg,char_data/T/080116-0059.jpg_0.jpg,819,21,452,473,825,864,False,29
T,37,kaist_dataset/English/Digital_Camera/(E.S)B-light/080116-0059.jpg,char_data/T/080116-0059.jpg_0.jpg,370,10,506,516,826,863,False,29
T,25,kaist_dataset/English/Digital_Camera/(E.S)B-light/080116-0059.jpg,char_data/T/080116-0059.jpg_0.jpg,300,12,991,1003,825,850,False,29
T,28,kaist_dataset/English/Digital_Camera/(E.S)B-light/080116-0059.jpg,char_data/T/080116-0059.jpg_0.jpg,504,18,1156,1174,822,850,False,29
T,34,kaist_dataset/English/Digital_Camera/(E.S)B-light/080116-0059.jpg,char_data/T/080116-0059.jpg_0.jpg,476,14,815,829,825,859,False,29
T,31,kaist_dataset/English/Digital_Camera/(E.S)B-light/080116-0059.jpg,char_data/T/080116-0059.jpg_0.jpg,589,19,623,642,826,857,False,29
T,30,kaist_dataset/English/Digital_Camera/(E.S)B-light/080116-0059.jpg,char_data/T/080116-0059.jpg_0.jpg,360,12,734,746,800,830,False,29
T,33,kaist_dataset/English/Digital_Camera/(E.S)B-light/080116-0059.jpg,char_data/T/080116-0059.jpg_0.jpg,660,20,557,577,772,805,False,29
T,33,kaist_dataset/English/Digital_Camera/(E.S)B-light/080116-0059.jpg,char_data/T/080116-0059.jpg_0.jpg,627,19,726,745,770,803,False,29
T,32,kaist_dataset/English/Digital_Camera/(E.S)B-light/080116-0059.jpg,char_data/T/080116-0059.jpg_0.jpg,416,13,821,834,771,803,False,29
T,37,kaist_dataset/English/Digital_Camera/(E.S)B-light/080116-0059.jpg,char_data/T/080116-0059.jpg_0.jpg,481,13,871,884,766,803,False,29
T,32,kaist_dataset/English/Digital_Camera/(E.S)B-light/080116-0059.jpg,char_data/T/080116-0059.jpg_0.jpg,416,13,1135,1148,769,801,False,29
T,31,kaist_dataset/English/Digital_Camera/(E.S)B-light/080116-0059.jpg,char_data/T/080116-0059.jpg_0.jpg,558,18,1174,1192,771,802,False,29
T,78,kaist_dataset/English/Digital_Camera/(E.S)B-light/080119-0038.jpg,char_data/T/080119-0038.jpg_0.jpg,5304,68,977,1045,683,761,False,29
T,32,kaist_dataset/English/Digital_Camera/(E.S)B-light/v.jpg,char_data/T/v.jpg_0.jpg,864,27,24,51,50,82,False,29
T,48,kaist_dataset/English/Digital_Camera/(E.S)F-others/크기변환_%B0%A3%C6%C716_m_starfirm.jpg,char_data/T/크기변환_%B0%A3%C6%C716_m_starfirm.jpg_0.jpg,1344,28,423,451,227,275,False,29
T,63,kaist_dataset/English/Digital_Camera/(E.S)F-others/크기변환_%B0%A3%C6%C77_m_starfirm.jpg,char_data/T/크기변환_%B0%A3%C6%C77_m_starfirm.jpg_0.jpg,3024,48,455,503,213,276,False,29
T,159,kaist_dataset/English/Digital_Camera/(E.S)F-others/080116-0060.jpg,char_data/T/080116-0060.jpg_0.jpg,21147,133,410,543,441,600,False,29
T,120,kaist_dataset/English/Digital_Camera/(E.S)F-others/080116-0060.jpg,char_data/T/080116-0060.jpg_0.jpg,11160,93,1478,1571,372,492,False,29
T,86,kaist_dataset/English/Digital_Camera/(E.S)F-others/DSC03291.JPG,char_data/T/DSC03291.JPG_0.jpg,4300,50,396,446,215,301,False,29
T,137,kaist_dataset/English/Digital_Camera/(E.S)F-others/080119-0014.jpg,char_data/T/080119-0014.jpg_0.jpg,10275,75,1294,1369,739,876,False,29
T,227,kaist_dataset/English/Digital_Camera/(E.S)F-others/080116-0058.jpg,char_data/T/080116-0058.jpg_0.jpg,26559,117,307,424,170,397,False,29
T,103,kaist_dataset/English/Digital_Camera/(E.S)F-others/080116-0058.jpg,char_data/T/080116-0058.jpg_0.jpg,2266,22,982,1004,636,739,False,29
T,35,kaist_dataset/English/Digital_Camera/(E.S)F-others/DSC02923.JPG,char_data/T/DSC02923.JPG_0.jpg,980,28,203,231,407,442,False,29
T,49,kaist_dataset/English/Digital_Camera/(E.S)F-others/086.jpg,char_data/T/086.jpg_0.jpg,980,20,283,303,306,355,False,29
T,71,kaist_dataset/English/Digital_Camera/(E.S)A-shadow/DSC02423.JPG,char_data/T/DSC02423.JPG_0.jpg,3905,55,572,627,170,241,False,29
T,44,kaist_dataset/English/Digital_Camera/(E.S)A-shadow/DSC02423.JPG,char_data/T/DSC02423.JPG_0.jpg,1936,44,470,514,244,288,False,29
T,41,kaist_dataset/English/Digital_Camera/(E.S)A-shadow/P1010044.JPG,char_data/T/P1010044.JPG_0.jpg,1066,26,219,245,357,398,False,29
T,34,kaist_dataset/English/Digital_Camera/(E.S)A-shadow/P1010044.JPG,char_data/T/P1010044.JPG_0.jpg,918,27,250,277,120,154,False,29
T,35,kaist_dataset/English/Digital_Camera/(E.S)A-shadow/P1010044.JPG,char_data/T/P1010044.JPG_0.jpg,910,26,277,303,153,188,False,29
T,72,kaist_dataset/English/Digital_Camera/(E.S)A-shadow/DSC03079.JPG,char_data/T/DSC03079.JPG_0.jpg,2736,38,194,232,317,389,False,29
T,105,kaist_dataset/English/Digital_Camera/(E.S)A-shadow/DSC02317.JPG,char_data/T/DSC02317.JPG_0.jpg,6615,63,101,164,225,330,False,29
T,80,kaist_dataset/English/Digital_Camera/(E.S)D-indoor/DSC03896.JPG,char_data/T/DSC03896.JPG_0.jpg,4480,56,308,364,274,354,False,29
T,123,kaist_dataset/English/Digital_Camera/(E.S)D-indoor/DSC02852.JPG,char_data/T/DSC02852.JPG_0.jpg,8118,66,78,144,301,424,False,29
T,31,kaist_dataset/English/Digital_Camera/(E.S)D-indoor/DSC03901.JPG,char_data/T/DSC03901.JPG_0.jpg,682,22,240,262,264,295,False,29
T,35,kaist_dataset/English/Digital_Camera/(E.S)D-indoor/DSC03901.JPG,char_data/T/DSC03901.JPG_0.jpg,700,20,373,393,261,296,False,29
T,37,kaist_dataset/English/Digital_Camera/(E.S)D-indoor/DSC03901.JPG,char_data/T/DSC03901.JPG_0.jpg,777,21,393,414,257,294,False,29
T,58,kaist_dataset/English/Digital_Camera/(E.S)D-indoor/DSC03901.JPG,char_data/T/DSC03901.JPG_0.jpg,2610,45,164,209,176,234,False,29
T,65,kaist_dataset/English/Digital_Camera/(E.S)D-indoor/DSC03901.JPG,char_data/T/DSC03901.JPG_0.jpg,3055,47,506,553,164,229,False,29
T,47,kaist_dataset/English/Digital_Camera/(E.S)D-indoor/DSC03901.JPG,char_data/T/DSC03901.JPG_0.jpg,1645,35,158,193,114,161,False,29
T,82,kaist_dataset/English/Digital_Camera/(E.S)D-indoor/DSC03367.JPG,char_data/T/DSC03367.JPG_0.jpg,5084,62,245,307,34,116,False,29
T,137,kaist_dataset/English/Digital_Camera/(E.S)D-indoor/DSC02842.JPG,char_data/T/DSC02842.JPG_0.jpg,18632,136,141,277,143,280,False,29
T,39,kaist_dataset/English/Digital_Camera/(E.S)D-indoor/DSC03942.JPG,char_data/T/DSC03942.JPG_0.jpg,975,25,492,517,371,410,False,29
T,67,kaist_dataset/English/Digital_Camera/(E.S)D-indoor/DSC04023.JPG,char_data/T/DSC04023.JPG_0.jpg,3216,48,391,439,230,297,False,29
T,37,kaist_dataset/English/Digital_Camera/(E.S)D-indoor/DSC03943.JPG,char_data/T/DSC03943.JPG_0.jpg,555,15,259,274,312,349,False,29
T,64,kaist_dataset/English/Digital_Camera/(E.S)D-indoor/DSC02769.JPG,char_data/T/DSC02769.JPG_0.jpg,2624,41,426,467,215,279,False,29
T,68,kaist_dataset/English/Digital_Camera/(E.S)D-indoor/DSC03091.JPG,char_data/T/DSC03091.JPG_0.jpg,3536,52,87,139,114,182,False,29
T,67,kaist_dataset/English/Digital_Camera/(E.S)D-indoor/DSC03883.JPG,char_data/T/DSC03883.JPG_0.jpg,2144,32,127,159,319,386,False,29
T,69,kaist_dataset/English/Digital_Camera/(E.S)D-indoor/DSC03883.JPG,char_data/T/DSC03883.JPG_0.jpg,2553,37,158,195,315,384,False,29
T,82,kaist_dataset/English/Digital_Camera/(E.S)D-indoor/DSC03087.JPG,char_data/T/DSC03087.JPG_0.jpg,4920,60,129,189,346,428,False,29
T,88,kaist_dataset/English/Digital_Camera/(E.S)D-indoor/DSC03087.JPG,char_data/T/DSC03087.JPG_0.jpg,8008,91,235,326,138,226,False,29
T,105,kaist_dataset/English/Digital_Camera/(E.S)D-indoor/080119-0009.jpg,char_data/T/080119-0009.jpg_0.jpg,7245,69,682,751,547,652,False,29
T,103,kaist_dataset/English/Digital_Camera/(E.S)D-indoor/080119-0009.jpg,char_data/T/080119-0009.jpg_0.jpg,7622,74,783,857,565,668,False,29
T,32,kaist_dataset/English/Digital_Camera/(E.S)D-indoor/080119-0009.jpg,char_data/T/080119-0009.jpg_0.jpg,576,18,112,130,1050,1082,False,29
T,36,kaist_dataset/English/Digital_Camera/(E.S)D-indoor/DSC03935.JPG,char_data/T/DSC03935.JPG_0.jpg,828,23,215,238,38,74,False,29
T,66,kaist_dataset/English/Digital_Camera/(E.S)D-indoor/DSC03467.JPG,char_data/T/DSC03467.JPG_0.jpg,2310,35,412,447,148,214,False,29
T,85,kaist_dataset/English/Digital_Camera/(E.S)C-outdoor3/P1010138.JPG,char_data/T/P1010138.JPG_0.jpg,4930,58,245,303,74,159,False,29
T,89,kaist_dataset/English/Digital_Camera/(E.S)C-outdoor3/P1010138.JPG,char_data/T/P1010138.JPG_0.jpg,5162,58,296,354,71,160,False,29
T,71,kaist_dataset/English/Digital_Camera/(E.S)C-outdoor3/크기변환_%B0%A3%C6%C718_m_starfirm.jpg,char_data/T/크기변환_%B0%A3%C6%C718_m_starfirm.jpg_0.jpg,4828,68,161,229,207,278,False,29
T,84,kaist_dataset/English/Digital_Camera/(E.S)C-outdoor3/DSC03046.JPG,char_data/T/DSC03046.JPG_0.jpg,4116,49,420,469,119,203,False,29
T,52,kaist_dataset/English/Digital_Camera/(E.S)C-outdoor3/P1010086.JPG,char_data/T/P1010086.JPG_0.jpg,2080,40,355,395,90,142,False,29
T,62,kaist_dataset/English/Digital_Camera/(E.S)C-outdoor3/DSC02788.JPG,char_data/T/DSC02788.JPG_0.jpg,2046,33,420,453,296,358,False,29
T,46,kaist_dataset/English/Digital_Camera/(E.S)C-outdoor3/크기변환_P1010076.JPG,char_data/T/크기변환_P1010076.JPG_0.jpg,2024,44,345,389,120,166,False,29
T,69,kaist_dataset/English/Digital_Camera/(E.S)C-outdoor3/크기변환_P1010028.JPG,char_data/T/크기변환_P1010028.JPG_0.jpg,2760,40,392,432,168,237,False,29
T,59,kaist_dataset/English/Digital_Camera/(E.S)C-outdoor3/크기변환_%C8%AD%C0%CC%C6%AE%C4%FE%C6%AE%B0%A3%C6%C7_%BA%B9%BB%E7_1-bona0007.jpg,char_data/T/크기변환_%C8%AD%C0%CC%C6%AE%C4%FE%C6%AE%B0%A3%C6%C7_%BA%B9%BB%E7_1-bona0007.jpg_0.jpg,2950,50,416,466,201,260,False,29
T,65,kaist_dataset/English/Digital_Camera/(E.S)C-outdoor3/크기변환_%C8%AD%C0%CC%C6%AE%C4%FE%C6%AE%B0%A3%C6%C7_%BA%B9%BB%E7_1-bona0007.jpg,char_data/T/크기변환_%C8%AD%C0%CC%C6%AE%C4%FE%C6%AE%B0%A3%C6%C7_%BA%B9%BB%E7_1-bona0007.jpg_0.jpg,3705,57,512,569,276,341,False,29
E,44,kaist_dataset/Korean/Digital_Camera/outdoor2/2007-12-08-day-109.jpg,char_data/E/2007-12-08-day-109.jpg_2.jpg,1188,27,110,137,814,858,True,16
E,25,kaist_dataset/Korean/Digital_Camera/outdoor2/2007-12-08-day-101.jpg,char_data/E/2007-12-08-day-101.jpg_2.jpg,375,15,183,198,1060,1085,True,16
E,52,kaist_dataset/Korean/Digital_Camera/outdoor2/2007-12-09-day-exterior-006.jpg,char_data/E/2007-12-09-day-exterior-006.jpg_2.jpg,1300,25,1532,1557,576,628,True,16
E,32,kaist_dataset/Korean/Digital_Camera/outdoor2/2007-12-08-day-094.jpg,char_data/E/2007-12-08-day-094.jpg_0.jpg,736,23,649,672,1420,1452,True,16
E,73,kaist_dataset/Korean/Digital_Camera/outdoor2/2007-12-09-day-exterior-068.jpg,char_data/E/2007-12-09-day-exterior-068.jpg_0.jpg,3577,49,630,679,924,997,True,16
E,18,kaist_dataset/Korean/Digital_Camera/E-night/103.jpg,char_data/E/103.jpg_0.jpg,162,9,318,327,152,170,True,16
E,15,kaist_dataset/Korean/Digital_Camera/E-night/103.jpg,char_data/E/103.jpg_0.jpg,120,8,327,335,155,170,True,16
E,17,kaist_dataset/Korean/Digital_Camera/E-night/103.jpg,char_data/E/103.jpg_0.jpg,136,8,372,380,153,170,True,16
E,31,kaist_dataset/Korean/Digital_Camera/indoor1/2007-12-08-day-139.jpg,char_data/E/2007-12-08-day-139.jpg_0.jpg,496,16,518,534,356,387,True,16
E,17,kaist_dataset/Korean/Digital_Camera/indoor1/136.JPG,char_data/E/136.JPG_0.jpg,221,13,291,304,290,307,True,16
E,53,kaist_dataset/Korean/Digital_Camera/G-others/2007-12-08-day-112.jpg,char_data/E/2007-12-08-day-112.jpg_0.jpg,1325,25,616,641,600,653,True,16
E,36,kaist_dataset/Korean/Digital_Camera/outdoor6/DSC04292.JPG,char_data/E/DSC04292.JPG_0.jpg,828,23,55,78,51,87,True,16
E,29,kaist_dataset/Korean/Digital_Camera/outdoor1/001.JPG,char_data/E/001.JPG_0.jpg,377,13,450,463,234,263,True,16
E,36,kaist_dataset/Mixed/Mobile_Phone/(C.M)A-outdoor/P090908006.jpg,char_data/E/P090908006.jpg_0.jpg,828,23,269,292,367,403,True,16
E,43,kaist_dataset/Mixed/Mobile_Phone/(C.M)A-outdoor/P090912078.jpg,char_data/E/P090912078.jpg_0.jpg,1161,27,488,515,284,327,True,16
E,63,kaist_dataset/Mixed/Mobile_Phone/(C.M)B-indoor/P090831018.jpg,char_data/E/P090831018.jpg_0.jpg,3843,61,98,159,226,289,True,16
E,49,kaist_dataset/Mixed/Mobile_Phone/(C.M)B-indoor/P090831021.jpg,char_data/E/P090831021.jpg_0.jpg,1764,36,117,153,376,425,True,16
E,38,kaist_dataset/Mixed/Mobile_Phone/(C.M)B-indoor/P090831021.jpg,char_data/E/P090831021.jpg_0.jpg,1140,30,408,438,379,417,True,16
E,49,kaist_dataset/Mixed/Mobile_Phone/(C.M)B-indoor/P090831021.jpg,char_data/E/P090831021.jpg_0.jpg,1715,35,320,355,331,380,True,16
E,103,kaist_dataset/Mixed/Mobile_Phone/(C.M)C-bookCover/P090831136.jpg,char_data/E/P090831136.jpg_0.jpg,7931,77,514,591,224,327,True,16
E,55,kaist_dataset/Mixed/Mobile_Phone/(C.M)C-bookCover/P090903092.jpg,char_data/E/P090903092.jpg_0.jpg,1815,33,591,624,200,255,True,16
E,37,kaist_dataset/Mixed/Mobile_Phone/(C.M)C-bookCover/P090903009.jpg,char_data/E/P090903009.jpg_0.jpg,851,23,177,200,354,391,True,16
E,42,kaist_dataset/Mixed/Mobile_Phone/(C.M)C-bookCover/P090903009.jpg,char_data/E/P090903009.jpg_0.jpg,924,22,408,430,355,397,True,16
E,40,kaist_dataset/Mixed/Mobile_Phone/(C.M)C-bookCover/P090831062.jpg,char_data/E/P090831062.jpg_0.jpg,1320,33,267,300,304,344,True,16
E,32,kaist_dataset/Mixed/Mobile_Phone/(C.M)C-bookCover/P090831062.jpg,char_data/E/P090831062.jpg_0.jpg,1280,40,353,393,304,336,True,16
E,39,kaist_dataset/Mixed/Mobile_Phone/(C.M)C-bookCover/P090831062.jpg,char_data/E/P090831062.jpg_0.jpg,1170,30,515,545,294,333,True,16
E,108,kaist_dataset/Mixed/Digital_Camera/(C.S)C-outdoor1/027.JPG,char_data/E/027.JPG_0.jpg,6264,58,376,434,163,271,True,16
E,33,kaist_dataset/Mixed/Digital_Camera/(C.S)C-outdoor1/048.JPG,char_data/E/048.JPG_0.jpg,825,25,207,232,254,287,True,16
E,78,kaist_dataset/Mixed/Digital_Camera/(C.S)C-outdoor1/046.JPG,char_data/E/046.JPG_0.jpg,4368,56,576,632,192,270,True,16
E,67,kaist_dataset/Mixed/Digital_Camera/(C.S)C-outdoor1/046.JPG,char_data/E/046.JPG_0.jpg,3953,59,208,267,204,271,True,16
E,39,kaist_dataset/Mixed/Digital_Camera/(C.S)C-outdoor1/114.jpg,char_data/E/114.jpg_0.jpg,1092,28,352,380,268,307,True,16
E,39,kaist_dataset/Mixed/Digital_Camera/(C.S)C-outdoor1/114.jpg,char_data/E/114.jpg_0.jpg,1248,32,392,424,272,311,True,16
E,23,kaist_dataset/Mixed/Digital_Camera/(C.S)C-outdoor1/114.jpg,char_data/E/114.jpg_0.jpg,414,18,263,281,369,392,True,16
E,58,kaist_dataset/Mixed/Digital_Camera/(C.S)C-outdoor1/080119-0006.jpg,char_data/E/080119-0006.jpg_0.jpg,2900,50,1075,1125,735,793,True,16
E,19,kaist_dataset/Mixed/Digital_Camera/(C.S)C-outdoor1/135.JPG,char_data/E/135.JPG_0.jpg,247,13,284,297,177,196,True,16
E,54,kaist_dataset/Mixed/Digital_Camera/(C.S)C-outdoor1/3.JPG,char_data/E/3.JPG_0.jpg,1944,36,317,353,229,283,True,16
E,44,kaist_dataset/Mixed/Digital_Camera/(C.S)C-outdoor1/3.JPG,char_data/E/3.JPG_0.jpg,1056,24,681,705,418,462,True,16
E,26,kaist_dataset/Mixed/Digital_Camera/(C.S)C-outdoor1/3.JPG,char_data/E/3.JPG_0.jpg,260,10,580,590,293,319,True,16
E,14,kaist_dataset/Mixed/Digital_Camera/(C.S)C-outdoor1/3.JPG,char_data/E/3.JPG_0.jpg,98,7,107,114,293,307,True,16
E,110,kaist_dataset/Mixed/Digital_Camera/(C.S)C-outdoor1/080119-0027.jpg,char_data/E/080119-0027.jpg_0.jpg,13310,121,338,459,471,581,True,16
E,77,kaist_dataset/Mixed/Digital_Camera/(C.S)C-outdoor1/080119-0027.jpg,char_data/E/080119-0027.jpg_0.jpg,3388,44,1073,1117,718,795,True,16
E,45,kaist_dataset/Mixed/Digital_Camera/(C.S)C-outdoor1/080119-0027.jpg,char_data/E/080119-0027.jpg_0.jpg,1260,28,976,1004,1055,1100,True,16
E,51,kaist_dataset/Mixed/Digital_Camera/(C.S)C-outdoor1/P1010009.JPG,char_data/E/P1010009.JPG_0.jpg,1989,39,154,193,186,237,True,16
E,46,kaist_dataset/Mixed/Digital_Camera/(C.S)C-outdoor1/P1010009.JPG,char_data/E/P1010009.JPG_0.jpg,1656,36,484,520,198,244,True,16
E,25,kaist_dataset/Mixed/Digital_Camera/(C.S)C-outdoor1/054.JPG,char_data/E/054.JPG_0.jpg,625,25,544,569,278,303,True,16
E,22,kaist_dataset/Mixed/Digital_Camera/(C.S)C-outdoor1/054.JPG,char_data/E/054.JPG_0.jpg,374,17,404,421,308,330,True,16
E,144,kaist_dataset/Mixed/Digital_Camera/(C.S)C-outdoor1/080119-0003.jpg,char_data/E/080119-0003.jpg_0.jpg,12384,86,300,386,126,270,True,16
E,139,kaist_dataset/Mixed/Digital_Camera/(C.S)C-outdoor1/080119-0037.jpg,char_data/E/080119-0037.jpg_0.jpg,10147,73,321,394,873,1012,True,16
E,132,kaist_dataset/Mixed/Digital_Camera/(C.S)C-outdoor1/080119-0037.jpg,char_data/E/080119-0037.jpg_0.jpg,8844,67,516,583,866,998,True,16
E,114,kaist_dataset/Mixed/Digital_Camera/(C.S)C-outdoor1/080119-0037.jpg,char_data/E/080119-0037.jpg_0.jpg,6726,59,968,1027,851,965,True,16
E,117,kaist_dataset/Mixed/Digital_Camera/(C.S)C-outdoor1/080119-0037.jpg,char_data/E/080119-0037.jpg_0.jpg,8073,69,1432,1501,821,938,True,16
E,78,kaist_dataset/Mixed/Digital_Camera/(C.S)C-outdoor1/2007-12-09-day-exterior-051.jpg,char_data/E/2007-12-09-day-exterior-051.jpg_0.jpg,6318,81,522,603,382,460,True,16
E,28,kaist_dataset/Mixed/Digital_Camera/(C.S)C-outdoor1/2007-12-09-day-exterior-051.jpg,char_data/E/2007-12-09-day-exterior-051.jpg_0.jpg,504,18,524,542,643,671,True,16
E,30,kaist_dataset/Mixed/Digital_Camera/(C.S)C-outdoor1/2007-12-09-day-exterior-051.jpg,char_data/E/2007-12-09-day-exterior-051.jpg_0.jpg,540,18,542,560,643,673,True,16
E,26,kaist_dataset/Mixed/Digital_Camera/(C.S)C-outdoor1/2007-12-09-day-exterior-051.jpg,char_data/E/2007-12-09-day-exterior-051.jpg_0.jpg,442,17,583,600,611,637,True,16
E,25,kaist_dataset/Mixed/Digital_Camera/(C.S)C-outdoor1/2007-12-09-day-exterior-051.jpg,char_data/E/2007-12-09-day-exterior-051.jpg_0.jpg,525,21,600,621,611,636,True,16
E,60,kaist_dataset/Mixed/Digital_Camera/(C.S)C-outdoor1/2007-12-09-day-exterior-051.jpg,char_data/E/2007-12-09-day-exterior-051.jpg_0.jpg,2040,34,282,316,918,978,True,16
E,89,kaist_dataset/Mixed/Digital_Camera/(C.S)C-outdoor1/2007-12-09-day-exterior-044.jpg,char_data/E/2007-12-09-day-exterior-044.jpg_0.jpg,9345,105,287,392,327,416,True,16
E,77,kaist_dataset/Mixed/Digital_Camera/(C.S)C-outdoor1/2007-12-09-day-exterior-044.jpg,char_data/E/2007-12-09-day-exterior-044.jpg_0.jpg,4389,57,1228,1285,971,1048,True,16
E,53,kaist_dataset/Mixed/Digital_Camera/(C.S)C-outdoor1/2007-12-08-day-130.jpg,char_data/E/2007-12-08-day-130.jpg_0.jpg,2067,39,1083,1122,708,761,True,16
E,44,kaist_dataset/Mixed/Digital_Camera/(C.S)C-outdoor1/2007-12-08-day-130.jpg,char_data/E/2007-12-08-day-130.jpg_0.jpg,1320,30,872,902,749,793,True,16
E,73,kaist_dataset/Mixed/Digital_Camera/(C.S)C-outdoor1/1.JPG,char_data/E/1.JPG_0.jpg,2847,39,258,297,195,268,True,16
E,69,kaist_dataset/Mixed/Digital_Camera/(C.S)C-outdoor1/1.JPG,char_data/E/1.JPG_0.jpg,2415,35,297,332,196,265,True,16
E,66,kaist_dataset/Mixed/Digital_Camera/(C.S)C-outdoor1/1.JPG,char_data/E/1.JPG_0.jpg,2310,35,437,472,202,268,True,16
E,63,kaist_dataset/Mixed/Digital_Camera/(C.S)C-outdoor1/1.JPG,char_data/E/1.JPG_0.jpg,2394,38,524,562,204,267,True,16
E,61,kaist_dataset/Mixed/Digital_Camera/(C.S)C-outdoor1/014.JPG,char_data/E/014.JPG_0.jpg,2196,36,241,277,196,257,True,16
E,43,kaist_dataset/Mixed/Digital_Camera/(C.S)F-others/DSC02504.JPG,char_data/E/DSC02504.JPG_0.jpg,1118,26,134,160,304,347,True,16
E,41,kaist_dataset/Mixed/Digital_Camera/(C.S)F-others/DSC02504.JPG,char_data/E/DSC02504.JPG_0.jpg,1066,26,293,319,301,342,True,16
E,68,kaist_dataset/Mixed/Digital_Camera/(C.S)F-others/2007-12-08-day-113.jpg,char_data/E/2007-12-08-day-113.jpg_0.jpg,2788,41,371,412,264,332,True,16
E,61,kaist_dataset/Mixed/Digital_Camera/(C.S)F-others/2007-12-08-day-113.jpg,char_data/E/2007-12-08-day-113.jpg_0.jpg,1891,31,482,513,295,356,True,16
E,50,kaist_dataset/Mixed/Digital_Camera/(C.S)F-others/2007-12-08-day-113.jpg,char_data/E/2007-12-08-day-113.jpg_0.jpg,1300,26,770,796,377,427,True,16
E,32,kaist_dataset/Mixed/Digital_Camera/(C.S)F-others/097.jpg,char_data/E/097.jpg_0.jpg,352,11,240,251,165,197,True,16
E,36,kaist_dataset/Mixed/Digital_Camera/(C.S)F-others/097.jpg,char_data/E/097.jpg_0.jpg,612,17,353,370,166,202,True,16
E,51,kaist_dataset/Mixed/Digital_Camera/(C.S)D-indoor2/DSC04421.JPG,char_data/E/DSC04421.JPG_0.jpg,1428,28,172,200,209,260,True,16
E,36,kaist_dataset/Mixed/Digital_Camera/(C.S)D-indoor2/DSC04254.JPG,char_data/E/DSC04254.JPG_0.jpg,828,23,322,345,339,375,True,16
E,44,kaist_dataset/Mixed/Digital_Camera/(C.S)E-night/DSC02672.JPG,char_data/E/DSC02672.JPG_0.jpg,1056,24,334,358,171,215,True,16
E,46,kaist_dataset/Mixed/Digital_Camera/(C.S)E-night/DSC02672.JPG,char_data/E/DSC02672.JPG_0.jpg,1104,24,544,568,174,220,True,16
E,31,kaist_dataset/Mixed/Digital_Camera/(C.S)E-night/DSC02660.JPG,char_data/E/DSC02660.JPG_0.jpg,496,16,265,281,384,415,True,16
E,70,kaist_dataset/Mixed/Digital_Camera/(C.S)E-night/DSC03031.JPG,char_data/E/DSC03031.JPG_0.jpg,3570,51,179,230,67,137,True,16
E,71,kaist_dataset/Mixed/Digital_Camera/(C.S)E-night/DSC03031.JPG,char_data/E/DSC03031.JPG_0.jpg,2911,41,310,351,70,141,True,16
E,43,kaist_dataset/Mixed/Digital_Camera/(C.S)E-night/DSC02673.JPG,char_data/E/DSC02673.JPG_0.jpg,430,10,257,267,304,347,True,16
E,47,kaist_dataset/Mixed/Digital_Camera/(C.S)E-night/DSC02595.JPG,char_data/E/DSC02595.JPG_0.jpg,2444,52,302,354,352,399,True,16
E,33,kaist_dataset/Mixed/Digital_Camera/(C.S)E-night/DSC02569.JPG,char_data/E/DSC02569.JPG_0.jpg,792,24,330,354,272,305,True,16
E,36,kaist_dataset/Mixed/Digital_Camera/(C.S)E-night/DSC03871.JPG,char_data/E/DSC03871.JPG_0.jpg,792,22,220,242,183,219,True,16
E,39,kaist_dataset/Mixed/Digital_Camera/(C.S)E-night/DSC03871.JPG,char_data/E/DSC03871.JPG_0.jpg,741,19,343,362,184,223,True,16
E,172,kaist_dataset/Mixed/Digital_Camera/(C.S)E-night/DSC02602.JPG,char_data/E/DSC02602.JPG_0.jpg,18576,108,470,578,146,318,True,16
E,36,kaist_dataset/Mixed/Digital_Camera/(C.S)E-night/DSC02903.JPG,char_data/E/DSC02903.JPG_0.jpg,864,24,266,290,264,300,True,16
E,36,kaist_dataset/Mixed/Digital_Camera/(C.S)B-light/DSC03298.JPG,char_data/E/DSC03298.JPG_0.jpg,432,12,327,339,286,322,True,16
E,35,kaist_dataset/Mixed/Digital_Camera/(C.S)D-indoor1/DSC03959.JPG,char_data/E/DSC03959.JPG_0.jpg,770,22,348,370,185,220,True,16
E,30,kaist_dataset/Mixed/Digital_Camera/(C.S)D-indoor1/DSC03959.JPG,char_data/E/DSC03959.JPG_0.jpg,720,24,370,394,187,217,True,16
E,49,kaist_dataset/Mixed/Digital_Camera/(C.S)D-indoor1/DSC03483.JPG,char_data/E/DSC03483.JPG_0.jpg,1323,27,241,268,368,417,True,16
E,77,kaist_dataset/Mixed/Digital_Camera/(C.S)D-indoor1/DSC03500.JPG,char_data/E/DSC03500.JPG_0.jpg,5082,66,107,173,102,179,True,16
E,74,kaist_dataset/Mixed/Digital_Camera/(C.S)D-indoor1/DSC03500.JPG,char_data/E/DSC03500.JPG_0.jpg,3700,50,334,384,103,177,True,16
E,142,kaist_dataset/Mixed/Digital_Camera/(C.S)D-indoor1/DSC04233.JPG,char_data/E/DSC04233.JPG_0.jpg,15336,108,213,321,17,159,True,16
E,61,kaist_dataset/Mixed/Digital_Camera/(C.S)D-indoor1/DSC04009.JPG,char_data/E/DSC04009.JPG_0.jpg,2013,33,202,235,397,458,True,16
E,41,kaist_dataset/Mixed/Digital_Camera/(C.S)D-indoor1/DSC02787.JPG,char_data/E/DSC02787.JPG_0.jpg,738,18,231,249,371,412,True,16
E,120,kaist_dataset/Mixed/Digital_Camera/(C.S)D-indoor1/DSC02840.JPG,char_data/E/DSC02840.JPG_0.jpg,9480,79,296,375,117,237,True,16
E,39,kaist_dataset/Mixed/Digital_Camera/(C.S)D-indoor1/DSC03904.JPG,char_data/E/DSC03904.JPG_0.jpg,624,16,329,345,212,251,True,16
E,40,kaist_dataset/Mixed/Digital_Camera/(C.S)D-indoor1/DSC03904.JPG,char_data/E/DSC03904.JPG_0.jpg,800,20,408,428,212,252,True,16
E,73,kaist_dataset/Mixed/Digital_Camera/(C.S)D-indoor1/DSC03479.JPG,char_data/E/DSC03479.JPG_0.jpg,2555,35,40,75,288,361,True,16
E,38,kaist_dataset/Mixed/Digital_Camera/(C.S)D-indoor1/DSC03980.JPG,char_data/E/DSC03980.JPG_0.jpg,608,16,219,235,135,173,True,16
E,108,kaist_dataset/Mixed/Digital_Camera/(C.S)D-indoor1/DSC03890.JPG,char_data/E/DSC03890.JPG_0.jpg,7668,71,513,584,239,347,True,16
E,179,kaist_dataset/Mixed/Digital_Camera/(C.S)D-indoor1/DSC04223.JPG,char_data/E/DSC04223.JPG_0.jpg,17184,96,310,406,6,185,True,16
E,86,kaist_dataset/Mixed/Digital_Camera/(C.S)D-indoor1/DSC02756.JPG,char_data/E/DSC02756.JPG_0.jpg,4558,53,61,114,182,268,True,16
E,32,kaist_dataset/Mixed/Digital_Camera/(C.S)D-indoor1/DSC02756.JPG,char_data/E/DSC02756.JPG_0.jpg,800,25,337,362,145,177,True,16
E,45,kaist_dataset/Mixed/Digital_Camera/(C.S)D-indoor1/DSC02714.JPG,char_data/E/DSC02714.JPG_0.jpg,1800,40,183,223,71,116,True,16
E,77,kaist_dataset/Mixed/Digital_Camera/(C.S)D-indoor1/DSC02714.JPG,char_data/E/DSC02714.JPG_0.jpg,6160,80,220,300,114,191,True,16
E,40,kaist_dataset/Mixed/Digital_Camera/(C.S)C-outdoor5/DSC04098.JPG,char_data/E/DSC04098.JPG_0.jpg,1240,31,286,317,71,111,True,16
E,36,kaist_dataset/Mixed/Digital_Camera/(C.S)C-outdoor5/DSC04290.JPG,char_data/E/DSC04290.JPG_0.jpg,756,21,52,73,376,412,True,16
E,45,kaist_dataset/Mixed/Digital_Camera/(C.S)C-outdoor5/P1010007.JPG,char_data/E/P1010007.JPG_0.jpg,990,22,206,228,271,316,True,16
E,40,kaist_dataset/Mixed/Digital_Camera/(C.S)C-outdoor5/DSC04065.JPG,char_data/E/DSC04065.JPG_0.jpg,1040,26,533,559,143,183,True,16
E,38,kaist_dataset/Mixed/Digital_Camera/(C.S)C-outdoor5/DSC04360.JPG,char_data/E/DSC04360.JPG_0.jpg,1064,28,49,77,338,376,True,16
E,53,kaist_dataset/Mixed/Digital_Camera/(C.S)C-outdoor5/DSC04060.JPG,char_data/E/DSC04060.JPG_0.jpg,1855,35,416,451,176,229,True,16
E,98,kaist_dataset/Mixed/Digital_Camera/(C.S)C-outdoor5/DSC04465.JPG,char_data/E/DSC04465.JPG_0.jpg,5096,52,417,469,289,387,True,16
E,82,kaist_dataset/Mixed/Digital_Camera/(C.S)C-outdoor5/DSC04368.JPG,char_data/E/DSC04368.JPG_0.jpg,3362,41,215,256,267,349,True,16
E,62,kaist_dataset/Mixed/Digital_Camera/(C.S)C-outdoor5/DSC04349.JPG,char_data/E/DSC04349.JPG_0.jpg,1550,25,470,495,304,366,True,16
E,105,kaist_dataset/Mixed/Digital_Camera/(C.S)C-outdoor5/DSC04151.JPG,char_data/E/DSC04151.JPG_0.jpg,8820,84,334,418,238,343,True,16
E,61,kaist_dataset/Mixed/Digital_Camera/(C.S)C-outdoor5/DSC04059.JPG,char_data/E/DSC04059.JPG_0.jpg,1769,29,460,489,117,178,True,16
E,64,kaist_dataset/Mixed/Digital_Camera/(C.S)C-outdoor5/DSC04059.JPG,char_data/E/DSC04059.JPG_0.jpg,2048,32,540,572,117,181,True,16
E,44,kaist_dataset/Mixed/Digital_Camera/(C.S)C-outdoor5/DSC04305.JPG,char_data/E/DSC04305.JPG_0.jpg,1276,29,549,578,84,128,True,16
E,31,kaist_dataset/Mixed/Digital_Camera/(C.S)C-outdoor5/DSC03829.JPG,char_data/E/DSC03829.JPG_0.jpg,558,18,343,361,179,210,True,16
E,32,kaist_dataset/Mixed/Digital_Camera/(C.S)C-outdoor5/DSC03829.JPG,char_data/E/DSC03829.JPG_0.jpg,576,18,387,405,177,209,True,16
E,37,kaist_dataset/Mixed/Digital_Camera/(C.S)C-outdoor5/DSC04070.JPG,char_data/E/DSC04070.JPG_0.jpg,592,16,306,322,107,144,True,16
E,26,kaist_dataset/Mixed/Digital_Camera/(C.S)C-outdoor5/DSC04031.JPG,char_data/E/DSC04031.JPG_0.jpg,364,14,124,138,379,405,True,16
E,67,kaist_dataset/Mixed/Digital_Camera/(C.S)C-outdoor5/DSC04450.JPG,char_data/E/DSC04450.JPG_0.jpg,2010,30,98,128,51,118,True,16
E,69,kaist_dataset/Mixed/Digital_Camera/(C.S)C-outdoor5/DSC04450.JPG,char_data/E/DSC04450.JPG_0.jpg,1863,27,164,191,51,120,True,16
E,64,kaist_dataset/Mixed/Digital_Camera/(C.S)C-outdoor5/DSC04450.JPG,char_data/E/DSC04450.JPG_0.jpg,2112,33,90,123,261,325,True,16
E,69,kaist_dataset/Mixed/Digital_Camera/(C.S)C-outdoor5/DSC04450.JPG,char_data/E/DSC04450.JPG_0.jpg,1932,28,159,187,261,330,True,16
E,51,kaist_dataset/Mixed/Digital_Camera/(C.S)C-outdoor5/DSC04129.JPG,char_data/E/DSC04129.JPG_0.jpg,1275,25,221,246,370,421,True,16
E,45,kaist_dataset/Mixed/Digital_Camera/(C.S)C-outdoor5/DSC04129.JPG,char_data/E/DSC04129.JPG_0.jpg,1485,33,403,436,375,420,True,16
E,48,kaist_dataset/Mixed/Digital_Camera/(C.S)C-outdoor5/DSC04048.JPG,char_data/E/DSC04048.JPG_0.jpg,1920,40,51,91,138,186,True,16
E,138,kaist_dataset/Mixed/Digital_Camera/(C.S)C-outdoor5/DSC03830.JPG,char_data/E/DSC03830.JPG_0.jpg,16146,117,289,406,123,261,True,16
E,143,kaist_dataset/Mixed/Digital_Camera/(C.S)C-outdoor5/DSC03830.JPG,char_data/E/DSC03830.JPG_0.jpg,15444,108,402,510,110,253,True,16
E,42,kaist_dataset/Mixed/Digital_Camera/(C.S)C-outdoor5/DSC04139.JPG,char_data/E/DSC04139.JPG_0.jpg,1260,30,364,394,92,134,True,16
E,34,kaist_dataset/Mixed/Digital_Camera/(C.S)C-outdoor5/DSC04314.JPG,char_data/E/DSC04314.JPG_0.jpg,850,25,374,399,172,206,True,16
E,40,kaist_dataset/Mixed/Digital_Camera/(C.S)C-outdoor5/DSC04314.JPG,char_data/E/DSC04314.JPG_0.jpg,1160,29,470,499,166,206,True,16
E,63,kaist_dataset/Mixed/Digital_Camera/(C.S)C-outdoor5/DSC04054.JPG,char_data/E/DSC04054.JPG_0.jpg,2898,46,204,250,66,129,True,16
E,44,kaist_dataset/Mixed/Digital_Camera/(C.S)C-outdoor5/DSC04338.JPG,char_data/E/DSC04338.JPG_0.jpg,792,18,140,158,193,237,True,16
E,54,kaist_dataset/Mixed/Digital_Camera/(C.S)C-outdoor5/DSC04055.JPG,char_data/E/DSC04055.JPG_0.jpg,2322,43,356,399,177,231,True,16
E,44,kaist_dataset/Mixed/Digital_Camera/(C.S)C-outdoor5/DSC04322.JPG,char_data/E/DSC04322.JPG_0.jpg,1232,28,213,241,216,260,True,16
E,41,kaist_dataset/Mixed/Digital_Camera/(C.S)C-outdoor3/DSC03233.JPG,char_data/E/DSC03233.JPG_0.jpg,1271,31,83,114,246,287,True,16
E,70,kaist_dataset/Mixed/Digital_Camera/(C.S)C-outdoor3/DSC03048.JPG,char_data/E/DSC03048.JPG_0.jpg,2870,41,218,259,133,203,True,16
E,57,kaist_dataset/Mixed/Digital_Camera/(C.S)C-outdoor3/DSC03428.JPG,char_data/E/DSC03428.JPG_0.jpg,1482,26,155,181,314,371,True,16
E,41,kaist_dataset/Mixed/Digital_Camera/(C.S)C-outdoor3/DSC03035.JPG,char_data/E/DSC03035.JPG_0.jpg,861,21,263,284,398,439,True,16
E,32,kaist_dataset/Mixed/Digital_Camera/(C.S)C-outdoor3/DSC03430.JPG,char_data/E/DSC03430.JPG_0.jpg,448,14,211,225,241,273,True,16
E,51,kaist_dataset/Mixed/Digital_Camera/(C.S)C-outdoor3/DSC03010.JPG,char_data/E/DSC03010.JPG_0.jpg,1173,23,358,381,89,140,True,16
E,55,kaist_dataset/Mixed/Digital_Camera/(C.S)C-outdoor3/DSC03010.JPG,char_data/E/DSC03010.JPG_0.jpg,1705,31,474,505,66,121,True,16
E,26,kaist_dataset/Mixed/Digital_Camera/(C.S)C-outdoor3/DSC03033.JPG,char_data/E/DSC03033.JPG_0.jpg,312,12,43,55,130,156,True,16
E,25,kaist_dataset/Mixed/Digital_Camera/(C.S)C-outdoor3/DSC03033.JPG,char_data/E/DSC03033.JPG_0.jpg,300,12,55,67,131,156,True,16
E,22,kaist_dataset/Mixed/Digital_Camera/(C.S)C-outdoor3/DSC03033.JPG,char_data/E/DSC03033.JPG_0.jpg,264,12,85,97,154,176,True,16
E,106,kaist_dataset/Mixed/Digital_Camera/(C.S)C-outdoor3/DSC03176.JPG,char_data/E/DSC03176.JPG_0.jpg,7950,75,310,385,261,367,True,16
E,88,kaist_dataset/Mixed/Digital_Camera/(C.S)C-outdoor3/DSC03217.JPG,char_data/E/DSC03217.JPG_0.jpg,6336,72,260,332,239,327,True,16
E,63,kaist_dataset/Mixed/Digital_Camera/(C.S)C-outdoor3/DSC03283.JPG,char_data/E/DSC03283.JPG_0.jpg,2142,34,426,460,66,129,True,16
E,37,kaist_dataset/Mixed/Digital_Camera/(C.S)C-outdoor3/DSC03020.JPG,char_data/E/DSC03020.JPG_0.jpg,851,23,346,369,263,300,True,16
E,45,kaist_dataset/Mixed/Digital_Camera/(C.S)C-outdoor3/DSC03020.JPG,char_data/E/DSC03020.JPG_0.jpg,1035,23,605,628,261,306,True,16
E,75,kaist_dataset/Mixed/Digital_Camera/(C.S)C-outdoor3/DSC03415.JPG,char_data/E/DSC03415.JPG_0.jpg,3450,46,258,304,157,232,True,16
E,25,kaist_dataset/Mixed/Digital_Camera/(C.S)C-outdoor6/P1010063.JPG,char_data/E/P1010063.JPG_0.jpg,250,10,279,289,414,439,True,16
E,27,kaist_dataset/Mixed/Digital_Camera/(C.S)C-outdoor6/P1010063.JPG,char_data/E/P1010063.JPG_0.jpg,297,11,329,340,390,417,True,16
E,19,kaist_dataset/Mixed/Digital_Camera/(C.S)C-outdoor6/P1010063.JPG,char_data/E/P1010063.JPG_0.jpg,228,12,412,424,362,381,True,16
E,19,kaist_dataset/Mixed/Digital_Camera/(C.S)C-outdoor6/P1010063.JPG,char_data/E/P1010063.JPG_0.jpg,171,9,469,478,338,357,True,16
E,24,kaist_dataset/Mixed/Digital_Camera/(C.S)C-outdoor6/P1010063.JPG,char_data/E/P1010063.JPG_0.jpg,360,15,478,493,330,354,True,16
E,55,kaist_dataset/Mixed/Digital_Camera/(C.S)C-outdoor6/P1010063.JPG,char_data/E/P1010063.JPG_0.jpg,2145,39,212,251,372,427,True,16
E,57,kaist_dataset/Mixed/Digital_Camera/(C.S)C-outdoor6/P1010063.JPG,char_data/E/P1010063.JPG_0.jpg,2052,36,410,446,288,345,True,16
E,54,kaist_dataset/Mixed/Digital_Camera/(C.S)C-outdoor6/P1010063.JPG,char_data/E/P1010063.JPG_0.jpg,1836,34,445,479,278,332,True,16
E,29,kaist_dataset/Mixed/Digital_Camera/(C.S)C-outdoor6/P1010082.JPG,char_data/E/P1010082.JPG_0.jpg,406,14,138,152,230,259,True,16
E,38,kaist_dataset/Mixed/Digital_Camera/(C.S)C-outdoor6/P1010088.JPG,char_data/E/P1010088.JPG_0.jpg,722,19,472,491,170,208,True,16
E,32,kaist_dataset/Mixed/Digital_Camera/(C.S)C-outdoor6/P1010088.JPG,char_data/E/P1010088.JPG_0.jpg,576,18,530,548,175,207,True,16
E,32,kaist_dataset/Mixed/Digital_Camera/(C.S)C-outdoor6/P1010088.JPG,char_data/E/P1010088.JPG_0.jpg,544,17,261,278,218,250,True,16
E,34,kaist_dataset/Mixed/Digital_Camera/(C.S)C-outdoor6/P1010090.JPG,char_data/E/P1010090.JPG_0.jpg,680,20,392,412,198,232,True,16
E,22,kaist_dataset/Mixed/Digital_Camera/(C.S)C-outdoor6/P1010114.JPG,char_data/E/P1010114.JPG_0.jpg,330,15,237,252,219,241,True,16
E,23,kaist_dataset/Mixed/Digital_Camera/(C.S)C-outdoor6/P1010114.JPG,char_data/E/P1010114.JPG_0.jpg,437,19,369,388,222,245,True,16
E,22,kaist_dataset/Mixed/Digital_Camera/(C.S)C-outdoor6/P1010065.JPG,char_data/E/P1010065.JPG_0.jpg,242,11,94,105,106,128,True,16
E,21,kaist_dataset/Mixed/Digital_Camera/(C.S)C-outdoor6/P1010065.JPG,char_data/E/P1010065.JPG_0.jpg,231,11,152,163,108,129,True,16
E,32,kaist_dataset/Mixed/Digital_Camera/(C.S)C-outdoor4/DSC03716.JPG,char_data/E/DSC03716.JPG_0.jpg,352,11,363,374,239,271,True,16
E,25,kaist_dataset/Mixed/Digital_Camera/(C.S)C-outdoor4/DSC03642.JPG,char_data/E/DSC03642.JPG_0.jpg,400,16,393,409,400,425,True,16
E,42,kaist_dataset/Mixed/Digital_Camera/(C.S)C-outdoor4/DSC03711.JPG,char_data/E/DSC03711.JPG_0.jpg,924,22,42,64,388,430,True,16
E,40,kaist_dataset/Mixed/Digital_Camera/(C.S)C-outdoor4/DSC03711.JPG,char_data/E/DSC03711.JPG_0.jpg,800,20,117,137,390,430,True,16
E,53,kaist_dataset/Mixed/Digital_Camera/(C.S)C-outdoor4/DSC03711.JPG,char_data/E/DSC03711.JPG_0.jpg,1590,30,194,224,380,433,True,16
E,34,kaist_dataset/Mixed/Digital_Camera/(C.S)C-outdoor4/DSC03640.JPG,char_data/E/DSC03640.JPG_0.jpg,578,17,113,130,400,434,True,16
E,61,kaist_dataset/Mixed/Digital_Camera/(C.S)C-outdoor4/DSC03661.JPG,char_data/E/DSC03661.JPG_0.jpg,2623,43,417,460,244,305,True,16
E,27,kaist_dataset/Mixed/Digital_Camera/(C.S)C-outdoor4/DSC03661.JPG,char_data/E/DSC03661.JPG_0.jpg,270,10,355,365,337,364,True,16
E,43,kaist_dataset/Mixed/Digital_Camera/(C.S)C-outdoor4/DSC03617.JPG,char_data/E/DSC03617.JPG_0.jpg,817,19,140,159,384,427,True,16
E,31,kaist_dataset/Mixed/Digital_Camera/(C.S)C-outdoor4/DSC03764.JPG,char_data/E/DSC03764.JPG_0.jpg,713,23,225,248,234,265,True,16
E,36,kaist_dataset/Mixed/Digital_Camera/(C.S)C-outdoor4/DSC03764.JPG,char_data/E/DSC03764.JPG_0.jpg,864,24,247,271,234,270,True,16
E,43,kaist_dataset/Mixed/Digital_Camera/(C.S)C-outdoor4/DSC03764.JPG,char_data/E/DSC03764.JPG_0.jpg,903,21,325,346,223,266,True,16
E,35,kaist_dataset/Mixed/Digital_Camera/(C.S)C-outdoor4/DSC03764.JPG,char_data/E/DSC03764.JPG_0.jpg,875,25,346,371,231,266,True,16
E,39,kaist_dataset/Mixed/Digital_Camera/(C.S)C-outdoor4/DSC03781.JPG,char_data/E/DSC03781.JPG_0.jpg,1989,51,180,231,267,306,True,16
E,59,kaist_dataset/Mixed/Digital_Camera/(C.S)C-outdoor4/DSC03707.JPG,char_data/E/DSC03707.JPG_0.jpg,2006,34,210,244,84,143,True,16
E,48,kaist_dataset/Mixed/Digital_Camera/(C.S)C-outdoor4/DSC03707.JPG,char_data/E/DSC03707.JPG_0.jpg,1584,33,244,277,90,138,True,16
E,59,kaist_dataset/Mixed/Digital_Camera/(C.S)C-outdoor4/DSC03707.JPG,char_data/E/DSC03707.JPG_0.jpg,2183,37,332,369,142,201,True,16
E,54,kaist_dataset/Mixed/Digital_Camera/(C.S)C-outdoor4/DSC03655.JPG,char_data/E/DSC03655.JPG_0.jpg,972,18,181,199,385,439,True,16
E,70,kaist_dataset/Mixed/Digital_Camera/(C.S)C-outdoor4/DSC03673.JPG,char_data/E/DSC03673.JPG_0.jpg,2940,42,411,453,171,241,True,16
E,76,kaist_dataset/Mixed/Digital_Camera/(C.S)C-outdoor4/DSC03652.JPG,char_data/E/DSC03652.JPG_0.jpg,4408,58,233,291,184,260,True,16
E,85,kaist_dataset/Mixed/Digital_Camera/(C.S)C-outdoor4/DSC03652.JPG,char_data/E/DSC03652.JPG_0.jpg,4420,52,345,397,176,261,True,16
E,30,kaist_dataset/Mixed/Digital_Camera/(C.S)C-outdoor4/DSC03676.JPG,char_data/E/DSC03676.JPG_0.jpg,420,14,40,54,268,298,True,16
E,42,kaist_dataset/Mixed/Digital_Camera/(C.S)C-outdoor4/DSC03678.JPG,char_data/E/DSC03678.JPG_0.jpg,882,21,198,219,238,280,True,16
E,65,kaist_dataset/Mixed/Digital_Camera/(C.S)C-outdoor4/DSC03756.JPG,char_data/E/DSC03756.JPG_0.jpg,2795,43,193,236,387,452,True,16
E,56,kaist_dataset/Mixed/Digital_Camera/(C.S)C-outdoor4/DSC03433.JPG,char_data/E/DSC03433.JPG_0.jpg,1456,26,120,146,379,435,True,16
E,27,kaist_dataset/Mixed/Digital_Camera/(C.S)C-outdoor4/DSC03687.JPG,char_data/E/DSC03687.JPG_0.jpg,351,13,131,144,296,323,True,16
E,41,kaist_dataset/Mixed/Digital_Camera/(C.S)C-outdoor2/DSC02419.JPG,char_data/E/DSC02419.JPG_0.jpg,1025,25,31,56,199,240,True,16
E,23,kaist_dataset/Mixed/Digital_Camera/(C.S)C-outdoor2/DSC02555.JPG,char_data/E/DSC02555.JPG_0.jpg,391,17,93,110,153,176,True,16
E,32,kaist_dataset/Mixed/Digital_Camera/(C.S)C-outdoor2/DSC02397.JPG,char_data/E/DSC02397.JPG_0.jpg,576,18,25,43,141,173,True,16
E,21,kaist_dataset/Mixed/Digital_Camera/(C.S)C-outdoor2/DSC02397.JPG,char_data/E/DSC02397.JPG_0.jpg,294,14,45,59,144,165,True,16
E,140,kaist_dataset/Mixed/Digital_Camera/(C.S)C-outdoor2/DSC02397.JPG,char_data/E/DSC02397.JPG_0.jpg,17220,123,165,288,295,435,True,16
E,25,kaist_dataset/Mixed/Digital_Camera/(C.S)C-outdoor2/DSC02477.JPG,char_data/E/DSC02477.JPG_0.jpg,300,12,87,99,157,182,True,16
E,27,kaist_dataset/Mixed/Digital_Camera/(C.S)C-outdoor2/DSC02483.JPG,char_data/E/DSC02483.JPG_0.jpg,621,23,273,296,152,179,True,16
E,33,kaist_dataset/Mixed/Digital_Camera/(C.S)C-outdoor2/DSC02910.JPG,char_data/E/DSC02910.JPG_0.jpg,627,19,394,413,59,92,True,16
E,73,kaist_dataset/Mixed/Digital_Camera/(C.S)C-outdoor2/DSC02385.JPG,char_data/E/DSC02385.JPG_0.jpg,4015,55,451,506,166,239,True,16
E,58,kaist_dataset/Mixed/Digital_Camera/(C.S)C-outdoor2/DSC02439.JPG,char_data/E/DSC02439.JPG_0.jpg,3480,60,392,452,137,195,True,16
E,64,kaist_dataset/Mixed/Digital_Camera/(C.S)C-outdoor2/DSC02866.JPG,char_data/E/DSC02866.JPG_0.jpg,2816,44,506,550,111,175,True,16
E,39,kaist_dataset/Mixed/Digital_Camera/(C.S)C-outdoor2/DSC02368.JPG,char_data/E/DSC02368.JPG_0.jpg,585,15,90,105,382,421,True,16
E,29,kaist_dataset/Mixed/Digital_Camera/(C.S)C-outdoor2/DSC02545.JPG,char_data/E/DSC02545.JPG_0.jpg,870,30,43,73,371,400,True,16
E,55,kaist_dataset/Mixed/Digital_Camera/(C.S)C-outdoor2/DSC02359.JPG,char_data/E/DSC02359.JPG_0.jpg,990,18,177,195,409,464,True,16
E,46,kaist_dataset/Mixed/Digital_Camera/(C.S)C-outdoor2/DSC02511.JPG,char_data/E/DSC02511.JPG_0.jpg,690,15,193,208,393,439,True,16
E,23,kaist_dataset/Mixed/Digital_Camera/(C.S)C-outdoor2/DSC02879.JPG,char_data/E/DSC02879.JPG_0.jpg,253,11,243,254,288,311,True,16
E,35,kaist_dataset/Mixed/Digital_Camera/(C.S)C-outdoor2/DSC02890.JPG,char_data/E/DSC02890.JPG_0.jpg,735,21,241,262,404,439,True,16
E,40,kaist_dataset/Mixed/Digital_Camera/(C.S)C-outdoor2/DSC02391.JPG,char_data/E/DSC02391.JPG_0.jpg,960,24,280,304,331,371,True,16
E,32,kaist_dataset/Mixed/Digital_Camera/(C.S)C-outdoor2/DSC02391.JPG,char_data/E/DSC02391.JPG_0.jpg,896,28,339,367,333,365,True,16
E,39,kaist_dataset/Mixed/Digital_Camera/(C.S)C-outdoor2/DSC02377.JPG,char_data/E/DSC02377.JPG_0.jpg,546,14,380,394,353,392,True,16
E,49,kaist_dataset/Mixed/Digital_Camera/(C.S)C-outdoor2/DSC02924.JPG,char_data/E/DSC02924.JPG_0.jpg,1225,25,189,214,315,364,True,16
E,51,kaist_dataset/Mixed/Digital_Camera/(C.S)C-outdoor2/DSC02924.JPG,char_data/E/DSC02924.JPG_0.jpg,1224,24,363,387,317,368,True,16
E,39,kaist_dataset/Mixed/Digital_Camera/(C.S)C-outdoor2/DSC02924.JPG,char_data/E/DSC02924.JPG_0.jpg,1053,27,460,487,331,370,True,16
E,32,kaist_dataset/Mixed/Digital_Camera/(C.S)A-shadow/P1010017.JPG,char_data/E/P1010017.JPG_0.jpg,832,26,47,73,130,162,True,16
E,44,kaist_dataset/Mixed/Digital_Camera/(C.S)A-shadow/DSC02902.JPG,char_data/E/DSC02902.JPG_0.jpg,1496,34,404,438,367,411,True,16
E,120,kaist_dataset/English/Mobile_Phone/(E.M)A-outdoor/P090911085.jpg,char_data/E/P090911085.jpg_0.jpg,9480,79,375,454,117,237,True,16
E,38,kaist_dataset/English/Mobile_Phone/(E.M)C-bookCover/P090903056.jpg,char_data/E/P090903056.jpg_0.jpg,1064,28,369,397,205,243,True,16
E,85,kaist_dataset/English/Mobile_Phone/(E.M)C-bookCover/P090903056.jpg,char_data/E/P090903056.jpg_0.jpg,6970,82,202,284,305,390,True,16
E,99,kaist_dataset/English/Mobile_Phone/(E.M)C-bookCover/P090903076.jpg,char_data/E/P090903076.jpg_0.jpg,7524,76,192,268,179,278,True,16
E,93,kaist_dataset/English/Mobile_Phone/(E.M)C-bookCover/P090903076.jpg,char_data/E/P090903076.jpg_0.jpg,6603,71,225,296,285,378,True,16
E,53,kaist_dataset/English/Mobile_Phone/(E.M)C-bookCover/P090903076.jpg,char_data/E/P090903076.jpg_0.jpg,1749,33,362,395,392,445,True,16
E,75,kaist_dataset/English/Mobile_Phone/(E.M)C-bookCover/P090903071.jpg,char_data/E/P090903071.jpg_0.jpg,4125,55,286,341,147,222,True,16
E,67,kaist_dataset/English/Mobile_Phone/(E.M)C-bookCover/P090903071.jpg,char_data/E/P090903071.jpg_0.jpg,4020,60,466,526,233,300,True,16
E,38,kaist_dataset/English/Mobile_Phone/(E.M)C-bookCover/P090903071.jpg,char_data/E/P090903071.jpg_0.jpg,912,24,364,388,302,340,True,16
E,140,kaist_dataset/English/Mobile_Phone/(E.M)C-bookCover/P090903082.jpg,char_data/E/P090903082.jpg_0.jpg,15820,113,416,529,45,185,True,16
E,88,kaist_dataset/English/Mobile_Phone/(E.M)C-bookCover/P090905007.jpg,char_data/E/P090905007.jpg_0.jpg,4928,56,235,291,170,258,True,16
E,85,kaist_dataset/English/Mobile_Phone/(E.M)C-bookCover/P090905007.jpg,char_data/E/P090905007.jpg_0.jpg,4845,57,223,280,294,379,True,16
E,78,kaist_dataset/English/Mobile_Phone/(E.M)C-bookCover/P090905007.jpg,char_data/E/P090905007.jpg_0.jpg,4524,58,447,505,292,370,True,16
E,60,kaist_dataset/English/Mobile_Phone/(E.M)C-bookCover/P090903041.jpg,char_data/E/P090903041.jpg_0.jpg,2400,40,287,327,23,83,True,16
E,92,kaist_dataset/English/Mobile_Phone/(E.M)C-bookCover/P090903054.jpg,char_data/E/P090903054.jpg_0.jpg,7268,79,352,431,220,312,True,16
E,51,kaist_dataset/English/Mobile_Phone/(E.M)C-bookCover/P090903054.jpg,char_data/E/P090903054.jpg_0.jpg,1887,37,331,368,354,405,True,16
E,56,kaist_dataset/English/Mobile_Phone/(E.M)C-bookCover/P090903054.jpg,char_data/E/P090903054.jpg_0.jpg,1512,27,557,584,350,406,True,16
E,78,kaist_dataset/English/Mobile_Phone/(E.M)C-bookCover/P090903050.jpg,char_data/E/P090903050.jpg_0.jpg,4602,59,317,376,5,83,True,16
E,127,kaist_dataset/English/Mobile_Phone/(E.M)C-bookCover/P090831037.jpg,char_data/E/P090831037.jpg_0.jpg,14097,111,382,493,62,189,True,16
E,148,kaist_dataset/English/Mobile_Phone/(E.M)C-bookCover/P090831037.jpg,char_data/E/P090831037.jpg_0.jpg,16132,109,512,621,186,334,True,16
E,146,kaist_dataset/English/Mobile_Phone/(E.M)C-bookCover/P090903081.jpg,char_data/E/P090903081.jpg_0.jpg,11096,76,338,414,104,250,True,16
E,68,kaist_dataset/English/Mobile_Phone/(E.M)C-bookCover/P090831075.jpg,char_data/E/P090831075.jpg_0.jpg,2652,39,268,307,159,227,True,16
E,63,kaist_dataset/English/Mobile_Phone/(E.M)C-bookCover/P090831075.jpg,char_data/E/P090831075.jpg_0.jpg,2205,35,313,348,282,345,True,16
E,40,kaist_dataset/English/Mobile_Phone/(E.M)C-bookCover/P090903055.jpg,char_data/E/P090903055.jpg_0.jpg,1640,41,369,410,71,111,True,16
E,82,kaist_dataset/English/Mobile_Phone/(E.M)C-bookCover/P090903055.jpg,char_data/E/P090903055.jpg_0.jpg,6724,82,217,299,160,242,True,16
E,31,kaist_dataset/English/Mobile_Phone/(E.M)C-bookCover/P090903055.jpg,char_data/E/P090903055.jpg_0.jpg,1054,34,223,257,412,443,True,16
E,48,kaist_dataset/English/Mobile_Phone/(E.M)C-bookCover/P090903015.jpg,char_data/E/P090903015.jpg_0.jpg,1680,35,420,455,75,123,True,16
E,51,kaist_dataset/English/Mobile_Phone/(E.M)C-bookCover/P090903015.jpg,char_data/E/P090903015.jpg_0.jpg,1938,38,336,374,142,193,True,16
E,39,kaist_dataset/English/Digital_Camera/(E.S)E-night/t.jpg,char_data/E/t.jpg_0.jpg,702,18,110,128,66,105,True,16
E,36,kaist_dataset/English/Digital_Camera/(E.S)E-night/t.jpg,char_data/E/t.jpg_0.jpg,936,26,198,224,64,100,True,16
E,42,kaist_dataset/English/Digital_Camera/(E.S)E-night/t.jpg,char_data/E/t.jpg_0.jpg,1386,33,253,286,58,100,True,16
E,92,kaist_dataset/English/Digital_Camera/(E.S)E-night/DSC02641.JPG,char_data/E/DSC02641.JPG_0.jpg,4968,54,144,198,270,362,True,16
E,97,kaist_dataset/English/Digital_Camera/(E.S)E-night/DSC02641.JPG,char_data/E/DSC02641.JPG_0.jpg,4656,48,408,456,267,364,True,16
E,97,kaist_dataset/English/Digital_Camera/(E.S)E-night/DSC02641.JPG,char_data/E/DSC02641.JPG_0.jpg,4753,49,456,505,268,365,True,16
E,88,kaist_dataset/English/Digital_Camera/(E.S)E-night/DSC02613.JPG,char_data/E/DSC02613.JPG_0.jpg,9592,109,50,159,177,265,True,16
E,103,kaist_dataset/English/Digital_Camera/(E.S)E-night/DSC02613.JPG,char_data/E/DSC02613.JPG_0.jpg,11845,115,281,396,171,274,True,16
E,29,kaist_dataset/English/Digital_Camera/(E.S)E-night/크기변환_%BA%F7%BD%BA%BD%C5%B8%DE%B4%BA_01_tjtjdska2008.jpg,char_data/E/크기변환_%BA%F7%BD%BA%BD%C5%B8%DE%B4%BA_01_tjtjdska2008.jpg_0.jpg,493,17,312,329,274,303,True,16
E,110,kaist_dataset/English/Digital_Camera/(E.S)E-night/DSC02606.JPG,char_data/E/DSC02606.JPG_0.jpg,10120,92,411,503,187,297,True,16
E,93,kaist_dataset/English/Digital_Camera/(E.S)E-night/DSC02675.JPG,char_data/E/DSC02675.JPG_0.jpg,6324,68,349,417,182,275,True,16
E,97,kaist_dataset/English/Digital_Camera/(E.S)E-night/DSC02675.JPG,char_data/E/DSC02675.JPG_0.jpg,5820,60,533,593,184,281,True,16
E,30,kaist_dataset/English/Digital_Camera/(E.S)E-night/111.jpg,char_data/E/111.jpg_0.jpg,360,12,280,292,282,312,True,16
E,22,kaist_dataset/English/Digital_Camera/(E.S)E-night/111.jpg,char_data/E/111.jpg_0.jpg,308,14,310,324,289,311,True,16
E,26,kaist_dataset/English/Digital_Camera/(E.S)E-night/111.jpg,char_data/E/111.jpg_0.jpg,312,12,339,351,270,296,True,16
E,21,kaist_dataset/English/Digital_Camera/(E.S)E-night/111.jpg,char_data/E/111.jpg_0.jpg,231,11,201,212,263,284,True,16
E,18,kaist_dataset/English/Digital_Camera/(E.S)E-night/111.jpg,char_data/E/111.jpg_0.jpg,234,13,255,268,265,283,True,16
E,140,kaist_dataset/English/Digital_Camera/(E.S)E-night/068.jpg,char_data/E/068.jpg_0.jpg,14280,102,96,198,268,408,True,16
E,52,kaist_dataset/English/Digital_Camera/(E.S)C-outdoor2/DSC03023.JPG,char_data/E/DSC03023.JPG_0.jpg,1144,22,149,171,299,351,True,16
E,56,kaist_dataset/English/Digital_Camera/(E.S)C-outdoor2/DSC03023.JPG,char_data/E/DSC03023.JPG_0.jpg,1568,28,442,470,297,353,True,16
E,59,kaist_dataset/English/Digital_Camera/(E.S)C-outdoor2/DSC03023.JPG,char_data/E/DSC03023.JPG_0.jpg,1829,31,471,502,298,357,True,16
E,81,kaist_dataset/English/Digital_Camera/(E.S)C-outdoor2/DSC02993.JPG,char_data/E/DSC02993.JPG_0.jpg,4455,55,179,234,226,307,True,16
E,80,kaist_dataset/English/Digital_Camera/(E.S)C-outdoor2/DSC02993.JPG,char_data/E/DSC02993.JPG_0.jpg,4320,54,446,500,122,202,True,16
E,41,kaist_dataset/English/Digital_Camera/(E.S)C-outdoor2/DSC03317.JPG,char_data/E/DSC03317.JPG_0.jpg,1025,25,478,503,260,301,True,16
E,110,kaist_dataset/English/Digital_Camera/(E.S)C-outdoor2/DSC03317.JPG,char_data/E/DSC03317.JPG_0.jpg,7810,71,414,485,62,172,True,16
E,49,kaist_dataset/English/Digital_Camera/(E.S)C-outdoor2/DSC03317.JPG,char_data/E/DSC03317.JPG_0.jpg,833,17,377,394,194,243,True,16
E,76,kaist_dataset/English/Digital_Camera/(E.S)C-outdoor2/DSC04079.JPG,char_data/E/DSC04079.JPG_0.jpg,3192,42,564,606,268,344,True,16
E,65,kaist_dataset/English/Digital_Camera/(E.S)C-outdoor2/DSC04079.JPG,char_data/E/DSC04079.JPG_0.jpg,2470,38,468,506,41,106,True,16
E,190,kaist_dataset/English/Digital_Camera/(E.S)C-outdoor2/DSC02949.JPG,char_data/E/DSC02949.JPG_0.jpg,7220,38,315,353,61,251,True,16
E,64,kaist_dataset/English/Digital_Camera/(E.S)C-outdoor2/DSC04313.JPG,char_data/E/DSC04313.JPG_0.jpg,2816,44,266,310,116,180,True,16
E,78,kaist_dataset/English/Digital_Camera/(E.S)C-outdoor2/DSC04313.JPG,char_data/E/DSC04313.JPG_0.jpg,3432,44,426,470,111,189,True,16
E,60,kaist_dataset/English/Digital_Camera/(E.S)C-outdoor2/DSC04120.JPG,char_data/E/DSC04120.JPG_0.jpg,2220,37,155,192,144,204,True,16
E,76,kaist_dataset/English/Digital_Camera/(E.S)C-outdoor2/DSC03411.JPG,char_data/E/DSC03411.JPG_0.jpg,5928,78,195,273,40,116,True,16
E,65,kaist_dataset/English/Digital_Camera/(E.S)C-outdoor2/DSC03411.JPG,char_data/E/DSC03411.JPG_0.jpg,4550,70,343,413,56,121,True,16
E,78,kaist_dataset/English/Digital_Camera/(E.S)C-outdoor2/DSC03191.JPG,char_data/E/DSC03191.JPG_0.jpg,3744,48,314,362,218,296,True,16
E,81,kaist_dataset/English/Digital_Camera/(E.S)C-outdoor2/DSC03191.JPG,char_data/E/DSC03191.JPG_0.jpg,4050,50,362,412,217,298,True,16
E,42,kaist_dataset/English/Digital_Camera/(E.S)C-outdoor2/DSC04361.JPG,char_data/E/DSC04361.JPG_0.jpg,1008,24,337,361,238,280,True,16
E,37,kaist_dataset/English/Digital_Camera/(E.S)C-outdoor2/DSC04361.JPG,char_data/E/DSC04361.JPG_0.jpg,925,25,408,433,241,278,True,16
E,96,kaist_dataset/English/Digital_Camera/(E.S)C-outdoor2/DSC03281.JPG,char_data/E/DSC03281.JPG_0.jpg,5760,60,209,269,211,307,True,16
E,64,kaist_dataset/English/Digital_Camera/(E.S)C-outdoor2/IMG_2481.JPG,char_data/E/IMG_2481.JPG_0.jpg,3264,51,424,475,249,313,True,16
E,52,kaist_dataset/English/Digital_Camera/(E.S)C-outdoor2/DSC03203.JPG,char_data/E/DSC03203.JPG_0.jpg,1820,35,159,194,309,361,True,16
E,57,kaist_dataset/English/Digital_Camera/(E.S)C-outdoor2/DSC03294.JPG,char_data/E/DSC03294.JPG_0.jpg,1653,29,226,255,293,350,True,16
E,59,kaist_dataset/English/Digital_Camera/(E.S)C-outdoor2/DSC03294.JPG,char_data/E/DSC03294.JPG_0.jpg,2242,38,329,367,290,349,True,16
E,40,kaist_dataset/English/Digital_Camera/(E.S)C-outdoor2/DSC03575.JPG,char_data/E/DSC03575.JPG_0.jpg,1080,27,359,386,182,222,True,16
E,52,kaist_dataset/English/Digital_Camera/(E.S)C-outdoor2/DSC03575.JPG,char_data/E/DSC03575.JPG_0.jpg,1664,32,199,231,258,310,True,16
E,54,kaist_dataset/English/Digital_Camera/(E.S)C-outdoor2/DSC03575.JPG,char_data/E/DSC03575.JPG_0.jpg,1944,36,270,306,261,315,True,16
E,55,kaist_dataset/English/Digital_Camera/(E.S)C-outdoor2/DSC03575.JPG,char_data/E/DSC03575.JPG_0.jpg,1540,28,412,440,261,316,True,16
E,134,kaist_dataset/English/Digital_Camera/(E.S)C-outdoor2/DSC03786.JPG,char_data/E/DSC03786.JPG_0.jpg,10854,81,89,170,165,299,True,16
E,30,kaist_dataset/English/Digital_Camera/(E.S)C-outdoor2/DSC04064.JPG,char_data/E/DSC04064.JPG_0.jpg,600,20,567,587,151,181,True,16
E,69,kaist_dataset/English/Digital_Camera/(E.S)C-outdoor2/DSC03262.JPG,char_data/E/DSC03262.JPG_0.jpg,2967,43,9,52,107,176,True,16
E,63,kaist_dataset/English/Digital_Camera/(E.S)C-outdoor2/DSC03297.JPG,char_data/E/DSC03297.JPG_0.jpg,2394,38,108,146,260,323,True,16
E,63,kaist_dataset/English/Digital_Camera/(E.S)C-outdoor2/DSC03297.JPG,char_data/E/DSC03297.JPG_0.jpg,2583,41,359,400,246,309,True,16
E,59,kaist_dataset/English/Digital_Camera/(E.S)C-outdoor2/DSC04464.JPG,char_data/E/DSC04464.JPG_0.jpg,1652,28,107,135,318,377,True,16
E,65,kaist_dataset/English/Digital_Camera/(E.S)C-outdoor2/DSC04464.JPG,char_data/E/DSC04464.JPG_0.jpg,2210,34,393,427,328,393,True,16
E,56,kaist_dataset/English/Digital_Camera/(E.S)C-outdoor2/DSC04464.JPG,char_data/E/DSC04464.JPG_0.jpg,1848,33,553,586,331,387,True,16
E,95,kaist_dataset/English/Digital_Camera/(E.S)C-outdoor2/DSC03831.JPG,char_data/E/DSC03831.JPG_0.jpg,6080,64,349,413,16,111,True,16
E,100,kaist_dataset/English/Digital_Camera/(E.S)C-outdoor2/DSC03831.JPG,char_data/E/DSC03831.JPG_0.jpg,6000,60,415,475,13,113,True,16
E,48,kaist_dataset/English/Digital_Camera/(E.S)C-outdoor2/DSC03279.JPG,char_data/E/DSC03279.JPG_0.jpg,1392,29,172,201,211,259,True,16
E,42,kaist_dataset/English/Digital_Camera/(E.S)C-outdoor2/DSC03279.JPG,char_data/E/DSC03279.JPG_0.jpg,1176,28,204,232,214,256,True,16
E,45,kaist_dataset/English/Digital_Camera/(E.S)C-outdoor2/DSC03225.JPG,char_data/E/DSC03225.JPG_0.jpg,1215,27,306,333,71,116,True,16
E,76,kaist_dataset/English/Digital_Camera/(E.S)C-outdoor2/DSC03012.JPG,char_data/E/DSC03012.JPG_0.jpg,2812,37,165,202,210,286,True,16
E,74,kaist_dataset/English/Digital_Camera/(E.S)C-outdoor2/DSC03012.JPG,char_data/E/DSC03012.JPG_0.jpg,2664,36,201,237,210,284,True,16
E,68,kaist_dataset/English/Digital_Camera/(E.S)C-outdoor2/DSC03264.JPG,char_data/E/DSC03264.JPG_0.jpg,3536,52,354,406,230,298,True,16
E,69,kaist_dataset/English/Digital_Camera/(E.S)C-outdoor2/DSC03264.JPG,char_data/E/DSC03264.JPG_0.jpg,3795,55,348,403,93,162,True,16
E,90,kaist_dataset/English/Digital_Camera/(E.S)C-outdoor2/DSC02984.JPG,char_data/E/DSC02984.JPG_0.jpg,5130,57,91,148,104,194,True,16
E,88,kaist_dataset/English/Digital_Camera/(E.S)C-outdoor2/DSC02984.JPG,char_data/E/DSC02984.JPG_0.jpg,5368,61,503,564,106,194,True,16
E,38,kaist_dataset/English/Digital_Camera/(E.S)C-outdoor2/DSC04080.JPG,char_data/E/DSC04080.JPG_0.jpg,1292,34,403,437,353,391,True,16
E,73,kaist_dataset/English/Digital_Camera/(E.S)C-outdoor2/DSC03050.JPG,char_data/E/DSC03050.JPG_0.jpg,5256,72,171,243,211,284,True,16
E,61,kaist_dataset/English/Digital_Camera/(E.S)C-outdoor2/DSC03684.JPG,char_data/E/DSC03684.JPG_0.jpg,2684,44,171,215,84,145,True,16
E,62,kaist_dataset/English/Digital_Camera/(E.S)C-outdoor2/DSC03684.JPG,char_data/E/DSC03684.JPG_0.jpg,2914,47,468,515,92,154,True,16
E,143,kaist_dataset/English/Digital_Camera/(E.S)C-outdoor2/DSC03410.JPG,char_data/E/DSC03410.JPG_0.jpg,21021,147,9,156,45,188,True,16
E,127,kaist_dataset/English/Digital_Camera/(E.S)C-outdoor2/DSC03410.JPG,char_data/E/DSC03410.JPG_0.jpg,17272,136,293,429,59,186,True,16
E,98,kaist_dataset/English/Digital_Camera/(E.S)C-outdoor2/P1010015.JPG,char_data/E/P1010015.JPG_0.jpg,5586,57,213,270,129,227,True,16
E,66,kaist_dataset/English/Digital_Camera/(E.S)C-outdoor2/DSC03759.JPG,char_data/E/DSC03759.JPG_0.jpg,6930,105,318,423,118,184,True,16
E,25,kaist_dataset/English/Digital_Camera/(E.S)C-outdoor1/077.JPG,char_data/E/077.JPG_0.jpg,350,14,339,353,249,274,True,16
E,23,kaist_dataset/English/Digital_Camera/(E.S)C-outdoor1/077.JPG,char_data/E/077.JPG_0.jpg,322,14,375,389,250,273,True,16
E,76,kaist_dataset/English/Digital_Camera/(E.S)C-outdoor1/DSC02356.JPG,char_data/E/DSC02356.JPG_0.jpg,3496,46,239,285,169,245,True,16
E,76,kaist_dataset/English/Digital_Camera/(E.S)C-outdoor1/DSC02356.JPG,char_data/E/DSC02356.JPG_0.jpg,3420,45,283,328,169,245,True,16
E,76,kaist_dataset/English/Digital_Camera/(E.S)C-outdoor1/DSC02356.JPG,char_data/E/DSC02356.JPG_0.jpg,3344,44,449,493,163,239,True,16
E,117,kaist_dataset/English/Digital_Camera/(E.S)C-outdoor1/DSC02427.JPG,char_data/E/DSC02427.JPG_0.jpg,6435,55,283,338,107,224,True,16
E,57,kaist_dataset/English/Digital_Camera/(E.S)C-outdoor1/DSC02427.JPG,char_data/E/DSC02427.JPG_0.jpg,1710,30,248,278,231,288,True,16
E,48,kaist_dataset/English/Digital_Camera/(E.S)C-outdoor1/DSC02427.JPG,char_data/E/DSC02427.JPG_0.jpg,1392,29,363,392,236,284,True,16
E,46,kaist_dataset/English/Digital_Camera/(E.S)C-outdoor1/DSC02427.JPG,char_data/E/DSC02427.JPG_0.jpg,966,21,597,618,241,287,True,16
E,50,kaist_dataset/English/Digital_Camera/(E.S)C-outdoor1/DSC02427.JPG,char_data/E/DSC02427.JPG_0.jpg,1000,20,618,638,241,291,True,16
E,82,kaist_dataset/English/Digital_Camera/(E.S)C-outdoor1/DSC02394.JPG,char_data/E/DSC02394.JPG_0.jpg,3936,48,375,423,252,334,True,16
E,114,kaist_dataset/English/Digital_Camera/(E.S)C-outdoor1/DSC02450.JPG,char_data/E/DSC02450.JPG_0.jpg,6954,61,571,632,73,187,True,16
E,38,kaist_dataset/English/Digital_Camera/(E.S)C-outdoor1/DSC02618.JPG,char_data/E/DSC02618.JPG_0.jpg,684,18,313,331,175,213,True,16
E,36,kaist_dataset/English/Digital_Camera/(E.S)C-outdoor1/DSC02618.JPG,char_data/E/DSC02618.JPG_0.jpg,756,21,355,376,176,212,True,16
E,212,kaist_dataset/English/Digital_Camera/(E.S)C-outdoor1/2007-12-08-day-099.jpg,char_data/E/2007-12-08-day-099.jpg_0.jpg,27136,128,580,708,446,658,True,16
E,33,kaist_dataset/English/Digital_Camera/(E.S)C-outdoor1/DSC02345.JPG,char_data/E/DSC02345.JPG_0.jpg,792,24,257,281,236,269,True,16
E,89,kaist_dataset/English/Digital_Camera/(E.S)C-outdoor1/083.JPG,char_data/E/083.JPG_0.jpg,6408,72,398,470,170,259,True,16
E,132,kaist_dataset/English/Digital_Camera/(E.S)C-outdoor1/DSC02448.JPG,char_data/E/DSC02448.JPG_0.jpg,9900,75,488,563,193,325,True,16
E,60,kaist_dataset/English/Digital_Camera/(E.S)C-outdoor1/026.JPG,char_data/E/026.JPG_0.jpg,2340,39,206,245,205,265,True,16
E,57,kaist_dataset/English/Digital_Camera/(E.S)C-outdoor1/026.JPG,char_data/E/026.JPG_0.jpg,1767,31,283,314,204,261,True,16
E,59,kaist_dataset/English/Digital_Camera/(E.S)C-outdoor1/026.JPG,char_data/E/026.JPG_0.jpg,2301,39,362,401,203,262,True,16
E,85,kaist_dataset/English/Digital_Camera/(E.S)C-outdoor1/DSC02897.JPG,char_data/E/DSC02897.JPG_0.jpg,4165,49,309,358,281,366,True,16
E,144,kaist_dataset/English/Digital_Camera/(E.S)C-outdoor1/DSC02415.JPG,char_data/E/DSC02415.JPG_0.jpg,13392,93,2,95,53,197,True,16
E,89,kaist_dataset/English/Digital_Camera/(E.S)C-outdoor1/DSC02590.JPG,char_data/E/DSC02590.JPG_0.jpg,7298,82,231,313,139,228,True,16
E,259,kaist_dataset/English/Digital_Camera/(E.S)C-outdoor1/080119-0036.jpg,char_data/E/080119-0036.jpg_0.jpg,47138,182,612,794,309,568,True,16
E,81,kaist_dataset/English/Digital_Camera/(E.S)C-outdoor1/DSC02384.JPG,char_data/E/DSC02384.JPG_0.jpg,4860,60,340,400,224,305,True,16
E,80,kaist_dataset/English/Digital_Camera/(E.S)C-outdoor1/DSC02384.JPG,char_data/E/DSC02384.JPG_0.jpg,4880,61,400,461,222,302,True,16
E,52,kaist_dataset/English/Digital_Camera/(E.S)C-outdoor1/113.jpg,char_data/E/113.jpg_0.jpg,2080,40,370,410,168,220,True,16
E,47,kaist_dataset/English/Digital_Camera/(E.S)C-outdoor1/113.jpg,char_data/E/113.jpg_0.jpg,2021,43,409,452,173,220,True,16
E,105,kaist_dataset/English/Digital_Camera/(E.S)C-outdoor1/029.jpg,char_data/E/029.jpg_0.jpg,10080,96,358,454,54,159,True,16
E,44,kaist_dataset/English/Digital_Camera/(E.S)C-outdoor1/080116-0065.jpg,char_data/E/080116-0065.jpg_0.jpg,1364,31,401,432,333,377,True,16
E,75,kaist_dataset/English/Digital_Camera/(E.S)C-outdoor1/050.JPG,char_data/E/050.JPG_0.jpg,4950,66,343,409,187,262,True,16
E,207,kaist_dataset/English/Digital_Camera/(E.S)C-outdoor1/2007-12-08-day-117.jpg,char_data/E/2007-12-08-day-117.jpg_0.jpg,32499,157,772,929,508,715,True,16
E,53,kaist_dataset/English/Digital_Camera/(E.S)C-outdoor1/064.JPG,char_data/E/064.JPG_0.jpg,1325,25,448,473,186,239,True,16
E,47,kaist_dataset/English/Digital_Camera/(E.S)C-outdoor1/064.JPG,char_data/E/064.JPG_0.jpg,1175,25,522,547,188,235,True,16
E,53,kaist_dataset/English/Digital_Camera/(E.S)C-outdoor1/DSC02559.JPG,char_data/E/DSC02559.JPG_0.jpg,3074,58,480,538,104,157,True,16
E,132,kaist_dataset/English/Digital_Camera/(E.S)C-outdoor1/2007-12-09-day-exterior-063.jpg,char_data/E/2007-12-09-day-exterior-063.jpg_0.jpg,12012,91,523,614,397,529,True,16
E,61,kaist_dataset/English/Digital_Camera/(E.S)C-outdoor1/DSC02619.JPG,char_data/E/DSC02619.JPG_0.jpg,2257,37,233,270,219,280,True,16
E,68,kaist_dataset/English/Digital_Camera/(E.S)C-outdoor1/DSC02398.JPG,char_data/E/DSC02398.JPG_0.jpg,3468,51,120,171,245,313,True,16
E,82,kaist_dataset/English/Digital_Camera/(E.S)C-outdoor1/DSC02398.JPG,char_data/E/DSC02398.JPG_0.jpg,4510,55,521,576,223,305,True,16
E,58,kaist_dataset/English/Digital_Camera/(E.S)C-outdoor1/031.JPG,char_data/E/031.JPG_0.jpg,2610,45,274,319,190,248,True,16
E,25,kaist_dataset/English/Digital_Camera/(E.S)C-outdoor1/031.JPG,char_data/E/031.JPG_0.jpg,325,13,131,144,317,342,True,16
E,21,kaist_dataset/English/Digital_Camera/(E.S)C-outdoor1/031.JPG,char_data/E/031.JPG_0.jpg,252,12,524,536,320,341,True,16
E,45,kaist_dataset/English/Digital_Camera/(E.S)C-outdoor1/004.jpg,char_data/E/004.jpg_0.jpg,1755,39,169,208,34,79,True,16
E,83,kaist_dataset/English/Digital_Camera/(E.S)C-outdoor1/DSC02364.JPG,char_data/E/DSC02364.JPG_0.jpg,4897,59,259,318,239,322,True,16
E,86,kaist_dataset/English/Digital_Camera/(E.S)C-outdoor1/DSC02364.JPG,char_data/E/DSC02364.JPG_0.jpg,5160,60,391,451,246,332,True,16
E,65,kaist_dataset/English/Digital_Camera/(E.S)C-outdoor1/080118-0011.jpg,char_data/E/080118-0011.jpg_0.jpg,2990,46,429,475,941,1006,True,16
E,64,kaist_dataset/English/Digital_Camera/(E.S)C-outdoor1/080118-0011.jpg,char_data/E/080118-0011.jpg_0.jpg,3008,47,529,576,941,1005,True,16
E,74,kaist_dataset/English/Digital_Camera/(E.S)C-outdoor1/080118-0011.jpg,char_data/E/080118-0011.jpg_0.jpg,3552,48,879,927,932,1006,True,16
E,70,kaist_dataset/English/Digital_Camera/(E.S)C-outdoor1/080118-0011.jpg,char_data/E/080118-0011.jpg_0.jpg,3570,51,860,911,457,527,True,16
E,68,kaist_dataset/English/Digital_Camera/(E.S)C-outdoor1/080118-0011.jpg,char_data/E/080118-0011.jpg_0.jpg,3536,52,863,915,595,663,True,16
E,60,kaist_dataset/English/Digital_Camera/(E.S)C-outdoor1/139.JPG,char_data/E/139.JPG_0.jpg,2400,40,271,311,253,313,True,16
E,314,kaist_dataset/English/Digital_Camera/(E.S)C-outdoor1/080119-0035.jpg,char_data/E/080119-0035.jpg_0.jpg,79756,254,156,410,753,1067,True,16
E,72,kaist_dataset/English/Digital_Camera/(E.S)C-outdoor1/DSC02395.JPG,char_data/E/DSC02395.JPG_0.jpg,5544,77,354,431,295,367,True,16
E,38,kaist_dataset/English/Digital_Camera/(E.S)C-outdoor1/041.JPG,char_data/E/041.JPG_0.jpg,1026,27,369,396,248,286,True,16
E,36,kaist_dataset/English/Digital_Camera/(E.S)C-outdoor1/041.JPG,char_data/E/041.JPG_0.jpg,972,27,443,470,249,285,True,16
E,18,kaist_dataset/English/Digital_Camera/(E.S)C-outdoor1/DSC02500.JPG,char_data/E/DSC02500.JPG_0.jpg,288,16,36,52,106,124,True,16
E,24,kaist_dataset/English/Digital_Camera/(E.S)C-outdoor1/DSC02500.JPG,char_data/E/DSC02500.JPG_0.jpg,432,18,30,48,82,106,True,16
E,24,kaist_dataset/English/Digital_Camera/(E.S)C-outdoor1/DSC02500.JPG,char_data/E/DSC02500.JPG_0.jpg,408,17,106,123,83,107,True,16
E,54,kaist_dataset/English/Digital_Camera/(E.S)C-outdoor1/DSC02500.JPG,char_data/E/DSC02500.JPG_0.jpg,1944,36,391,427,286,340,True,16
E,46,kaist_dataset/English/Digital_Camera/(E.S)C-outdoor1/001.jpg,char_data/E/001.jpg_0.jpg,1150,25,256,281,20,66,True,16
E,356,kaist_dataset/English/Digital_Camera/(E.S)C-outdoor1/080120-0001.jpg,char_data/E/080120-0001.jpg_0.jpg,139908,393,1103,1496,491,847,True,16
E,141,kaist_dataset/English/Digital_Camera/(E.S)C-outdoor1/DSC02501.JPG,char_data/E/DSC02501.JPG_0.jpg,17484,124,192,316,88,229,True,16
E,140,kaist_dataset/English/Digital_Camera/(E.S)C-outdoor1/DSC02501.JPG,char_data/E/DSC02501.JPG_0.jpg,16800,120,321,441,91,231,True,16
E,61,kaist_dataset/English/Digital_Camera/(E.S)C-outdoor1/DSC02501.JPG,char_data/E/DSC02501.JPG_0.jpg,3416,56,18,74,293,354,True,16
E,114,kaist_dataset/English/Digital_Camera/(E.S)C-outdoor1/2007-12-09-day-exterior-056.jpg,char_data/E/2007-12-09-day-exterior-056.jpg_0.jpg,7752,68,604,672,507,621,True,16
E,117,kaist_dataset/English/Digital_Camera/(E.S)C-outdoor1/2007-12-09-day-exterior-056.jpg,char_data/E/2007-12-09-day-exterior-056.jpg_0.jpg,7371,63,735,798,507,624,True,16
E,121,kaist_dataset/English/Digital_Camera/(E.S)C-outdoor1/2007-12-09-day-exterior-056.jpg,char_data/E/2007-12-09-day-exterior-056.jpg_0.jpg,8228,68,886,954,505,626,True,16
E,43,kaist_dataset/English/Digital_Camera/(E.S)C-outdoor1/089.jpg,char_data/E/089.jpg_0.jpg,1032,24,127,151,296,339,True,16
E,46,kaist_dataset/English/Digital_Camera/(E.S)C-outdoor1/089.jpg,char_data/E/089.jpg_0.jpg,828,18,331,349,283,329,True,16
E,46,kaist_dataset/English/Digital_Camera/(E.S)C-outdoor1/6.jpg,char_data/E/6.jpg_0.jpg,1886,41,433,474,94,140,True,16
E,47,kaist_dataset/English/Digital_Camera/(E.S)C-outdoor1/6.jpg,char_data/E/6.jpg_0.jpg,1880,40,548,588,93,140,True,16
E,18,kaist_dataset/English/Digital_Camera/(E.S)C-outdoor1/061.jpg,char_data/E/061.jpg_0.jpg,378,21,132,153,86,104,True,16
E,24,kaist_dataset/English/Digital_Camera/(E.S)C-outdoor1/061.jpg,char_data/E/061.jpg_0.jpg,384,16,135,151,66,90,True,16
E,126,kaist_dataset/English/Digital_Camera/(E.S)B-light/080116-0053.jpg,char_data/E/080116-0053.jpg_0.jpg,9450,75,114,189,211,337,True,16
E,112,kaist_dataset/English/Digital_Camera/(E.S)B-light/080116-0053.jpg,char_data/E/080116-0053.jpg_0.jpg,7952,71,670,741,220,332,True,16
E,76,kaist_dataset/English/Digital_Camera/(E.S)B-light/DSC04200.JPG,char_data/E/DSC04200.JPG_0.jpg,4408,58,114,172,266,342,True,16
E,66,kaist_dataset/English/Digital_Camera/(E.S)B-light/DSC04200.JPG,char_data/E/DSC04200.JPG_0.jpg,2640,40,227,267,272,338,True,16
E,23,kaist_dataset/English/Digital_Camera/(E.S)B-light/x.jpg,char_data/E/x.jpg_0.jpg,253,11,157,168,109,132,True,16
E,175,kaist_dataset/English/Digital_Camera/(E.S)B-light/080116-0059.jpg,char_data/E/080116-0059.jpg_0.jpg,16100,92,777,869,317,492,True,16
E,37,kaist_dataset/English/Digital_Camera/(E.S)B-light/080116-0059.jpg,char_data/E/080116-0059.jpg_0.jpg,518,14,474,488,825,862,True,16
E,31,kaist_dataset/English/Digital_Camera/(E.S)B-light/080116-0059.jpg,char_data/E/080116-0059.jpg_0.jpg,372,12,1144,1156,821,852,False,16
E,36,kaist_dataset/English/Digital_Camera/(E.S)B-light/080116-0059.jpg,char_data/E/080116-0059.jpg_0.jpg,504,14,787,801,824,860,False,16
E,32,kaist_dataset/English/Digital_Camera/(E.S)B-light/080116-0059.jpg,char_data/E/080116-0059.jpg_0.jpg,352,11,831,842,826,858,False,16
E,28,kaist_dataset/English/Digital_Camera/(E.S)B-light/080116-0059.jpg,char_data/E/080116-0059.jpg_0.jpg,336,12,842,854,826,854,False,16
E,29,kaist_dataset/English/Digital_Camera/(E.S)B-light/080116-0059.jpg,char_data/E/080116-0059.jpg_0.jpg,580,20,686,706,827,856,False,16
E,29,kaist_dataset/English/Digital_Camera/(E.S)B-light/080116-0059.jpg,char_data/E/080116-0059.jpg_0.jpg,406,14,801,815,798,827,False,16
E,39,kaist_dataset/English/Digital_Camera/(E.S)B-light/080116-0059.jpg,char_data/E/080116-0059.jpg_0.jpg,819,21,882,903,767,806,False,16
E,30,kaist_dataset/English/Digital_Camera/(E.S)B-light/080116-0059.jpg,char_data/E/080116-0059.jpg_0.jpg,390,13,959,972,770,800,False,16
E,29,kaist_dataset/English/Digital_Camera/(E.S)B-light/080116-0059.jpg,char_data/E/080116-0059.jpg_0.jpg,377,13,986,999,772,801,False,16
E,33,kaist_dataset/English/Digital_Camera/(E.S)B-light/080116-0059.jpg,char_data/E/080116-0059.jpg_0.jpg,429,13,1148,1161,768,801,False,16
E,228,kaist_dataset/English/Digital_Camera/(E.S)F-others/080119-0016.jpg,char_data/E/080119-0016.jpg_0.jpg,35568,156,699,855,317,545,False,16
E,143,kaist_dataset/English/Digital_Camera/(E.S)F-others/080119-0013.jpg,char_data/E/080119-0013.jpg_0.jpg,14729,103,989,1092,707,850,False,16
E,35,kaist_dataset/English/Digital_Camera/(E.S)F-others/080119-0007.jpg,char_data/E/080119-0007.jpg_0.jpg,700,20,1579,1599,433,468,False,16
E,37,kaist_dataset/English/Digital_Camera/(E.S)F-others/080119-0007.jpg,char_data/E/080119-0007.jpg_0.jpg,1924,52,1221,1273,812,849,False,16
E,27,kaist_dataset/English/Digital_Camera/(E.S)F-others/080119-0007.jpg,char_data/E/080119-0007.jpg_0.jpg,513,19,194,213,476,503,False,16
E,43,kaist_dataset/English/Digital_Camera/(E.S)F-others/080119-0007.jpg,char_data/E/080119-0007.jpg_0.jpg,989,23,221,244,602,645,False,16
E,35,kaist_dataset/English/Digital_Camera/(E.S)F-others/080119-0007.jpg,char_data/E/080119-0007.jpg_0.jpg,595,17,1391,1408,495,530,False,16
E,36,kaist_dataset/English/Digital_Camera/(E.S)F-others/080119-0007.jpg,char_data/E/080119-0007.jpg_0.jpg,468,13,1495,1508,488,524,False,16
E,49,kaist_dataset/English/Digital_Camera/(E.S)F-others/DSC02884.JPG,char_data/E/DSC02884.JPG_0.jpg,2009,41,540,581,18,67,False,16
E,77,kaist_dataset/English/Digital_Camera/(E.S)F-others/2007-12-09-day-exterior-047.jpg,char_data/E/2007-12-09-day-exterior-047.jpg_0.jpg,2541,33,84,117,492,569,False,16
E,55,kaist_dataset/English/Digital_Camera/(E.S)F-others/크기변환_%B0%A3%C6%C77_m_starfirm.jpg,char_data/E/크기변환_%B0%A3%C6%C77_m_starfirm.jpg_0.jpg,2640,48,475,523,153,208,False,16
E,66,kaist_dataset/English/Digital_Camera/(E.S)F-others/크기변환_%B0%A3%C6%C77_m_starfirm.jpg,char_data/E/크기변환_%B0%A3%C6%C77_m_starfirm.jpg_0.jpg,2640,40,421,461,202,268,False,16
E,149,kaist_dataset/English/Digital_Camera/(E.S)F-others/080116-0060.jpg,char_data/E/080116-0060.jpg_0.jpg,13708,92,676,768,425,574,False,16
E,113,kaist_dataset/English/Digital_Camera/(E.S)F-others/DSC02646.JPG,char_data/E/DSC02646.JPG_0.jpg,4859,43,360,403,197,310,False,16
E,111,kaist_dataset/English/Digital_Camera/(E.S)F-others/DSC02646.JPG,char_data/E/DSC02646.JPG_0.jpg,5106,46,404,450,186,297,False,16
E,44,kaist_dataset/English/Digital_Camera/(E.S)F-others/m.jpg,char_data/E/m.jpg_0.jpg,1496,34,134,168,96,140,False,16
E,43,kaist_dataset/English/Digital_Camera/(E.S)F-others/m.jpg,char_data/E/m.jpg_0.jpg,860,20,0,20,188,231,False,16
E,79,kaist_dataset/English/Digital_Camera/(E.S)F-others/DSC03291.JPG,char_data/E/DSC03291.JPG_0.jpg,3555,45,491,536,237,316,False,16
E,80,kaist_dataset/English/Digital_Camera/(E.S)F-others/DSC03291.JPG,char_data/E/DSC03291.JPG_0.jpg,3760,47,535,582,247,327,False,16
E,184,kaist_dataset/English/Digital_Camera/(E.S)F-others/080119-0014.jpg,char_data/E/080119-0014.jpg_0.jpg,20424,111,583,694,461,645,False,16
E,148,kaist_dataset/English/Digital_Camera/(E.S)F-others/080119-0014.jpg,char_data/E/080119-0014.jpg_0.jpg,12136,82,1158,1240,677,825,False,16
E,192,kaist_dataset/English/Digital_Camera/(E.S)F-others/080116-0058.jpg,char_data/E/080116-0058.jpg_0.jpg,18816,98,539,637,275,467,False,16
E,118,kaist_dataset/English/Digital_Camera/(E.S)F-others/080116-0058.jpg,char_data/E/080116-0058.jpg_0.jpg,3658,31,895,926,609,727,False,16
E,36,kaist_dataset/English/Digital_Camera/(E.S)F-others/DSC02923.JPG,char_data/E/DSC02923.JPG_0.jpg,504,14,232,246,408,444,False,16
E,84,kaist_dataset/English/Digital_Camera/(E.S)F-others/크기변환_%C4%BF%C7%C7%B5%B9%C3%E2%B0%A3%C6%C7_%281%29_alto99kr.jpg,char_data/E/크기변환_%C4%BF%C7%C7%B5%B9%C3%E2%B0%A3%C6%C7_%281%29_alto99kr.jpg_0.jpg,7056,84,435,519,242,326,False,16
E,88,kaist_dataset/English/Digital_Camera/(E.S)F-others/크기변환_%C4%BF%C7%C7%B5%B9%C3%E2%B0%A3%C6%C7_%281%29_alto99kr.jpg,char_data/E/크기변환_%C4%BF%C7%C7%B5%B9%C3%E2%B0%A3%C6%C7_%281%29_alto99kr.jpg_0.jpg,9064,103,518,621,218,306,False,16
E,53,kaist_dataset/English/Digital_Camera/(E.S)F-others/086.jpg,char_data/E/086.jpg_0.jpg,901,17,266,283,301,354,False,16
E,49,kaist_dataset/English/Digital_Camera/(E.S)F-others/086.jpg,char_data/E/086.jpg_0.jpg,735,15,382,397,325,374,False,16
E,50,kaist_dataset/English/Digital_Camera/(E.S)F-others/086.jpg,char_data/E/086.jpg_0.jpg,850,17,397,414,330,380,False,16
E,118,kaist_dataset/English/Digital_Camera/(E.S)A-shadow/DSC02629.JPG,char_data/E/DSC02629.JPG_0.jpg,7906,67,130,197,303,421,False,16
E,93,kaist_dataset/English/Digital_Camera/(E.S)A-shadow/DSC02629.JPG,char_data/E/DSC02629.JPG_0.jpg,5208,56,478,534,304,397,False,16
E,88,kaist_dataset/English/Digital_Camera/(E.S)A-shadow/DSC02629.JPG,char_data/E/DSC02629.JPG_0.jpg,5368,61,532,593,306,394,False,16
E,97,kaist_dataset/English/Digital_Camera/(E.S)A-shadow/DSC02633.JPG,char_data/E/DSC02633.JPG_0.jpg,6208,64,202,266,179,276,False,16
E,94,kaist_dataset/English/Digital_Camera/(E.S)A-shadow/DSC02633.JPG,char_data/E/DSC02633.JPG_0.jpg,4982,53,555,608,185,279,False,16
E,46,kaist_dataset/English/Digital_Camera/(E.S)A-shadow/P1010044.JPG,char_data/E/P1010044.JPG_0.jpg,1426,31,54,85,353,399,False,16
E,41,kaist_dataset/English/Digital_Camera/(E.S)A-shadow/P1010044.JPG,char_data/E/P1010044.JPG_0.jpg,1230,30,114,144,353,394,False,16
E,45,kaist_dataset/English/Digital_Camera/(E.S)A-shadow/P1010044.JPG,char_data/E/P1010044.JPG_0.jpg,1170,26,319,345,352,397,False,16
E,36,kaist_dataset/English/Digital_Camera/(E.S)A-shadow/P1010044.JPG,char_data/E/P1010044.JPG_0.jpg,972,27,307,334,121,157,False,16
E,35,kaist_dataset/English/Digital_Camera/(E.S)A-shadow/P1010044.JPG,char_data/E/P1010044.JPG_0.jpg,945,27,307,334,184,219,False,16
E,83,kaist_dataset/English/Digital_Camera/(E.S)A-shadow/DSC03084.JPG,char_data/E/DSC03084.JPG_0.jpg,3735,45,55,100,342,425,False,16
E,109,kaist_dataset/English/Digital_Camera/(E.S)A-shadow/DSC02317.JPG,char_data/E/DSC02317.JPG_0.jpg,6322,58,218,276,228,337,False,16
E,31,kaist_dataset/English/Digital_Camera/(E.S)D-indoor/308.jpg,char_data/E/308.jpg_0.jpg,713,23,122,145,48,79,False,16
E,79,kaist_dataset/English/Digital_Camera/(E.S)D-indoor/DSC03896.JPG,char_data/E/DSC03896.JPG_0.jpg,4503,57,369,426,274,353,False,16
E,79,kaist_dataset/English/Digital_Camera/(E.S)D-indoor/DSC03896.JPG,char_data/E/DSC03896.JPG_0.jpg,2844,36,498,534,258,337,False,16
E,39,kaist_dataset/English/Digital_Camera/(E.S)D-indoor/DSC03901.JPG,char_data/E/DSC03901.JPG_0.jpg,897,23,195,218,262,301,False,16
E,36,kaist_dataset/English/Digital_Camera/(E.S)D-indoor/DSC03901.JPG,char_data/E/DSC03901.JPG_0.jpg,828,23,411,434,259,295,False,16
E,71,kaist_dataset/English/Digital_Camera/(E.S)D-indoor/DSC03901.JPG,char_data/E/DSC03901.JPG_0.jpg,2911,41,123,164,165,236,False,16
E,58,kaist_dataset/English/Digital_Camera/(E.S)D-indoor/DSC03901.JPG,char_data/E/DSC03901.JPG_0.jpg,2552,44,208,252,174,232,False,16
E,38,kaist_dataset/English/Digital_Camera/(E.S)D-indoor/DSC03901.JPG,char_data/E/DSC03901.JPG_0.jpg,912,24,224,248,122,160,False,16
E,94,kaist_dataset/English/Digital_Camera/(E.S)D-indoor/DSC03365.JPG,char_data/E/DSC03365.JPG_0.jpg,7050,75,373,448,362,456,False,16
E,89,kaist_dataset/English/Digital_Camera/(E.S)D-indoor/DSC03367.JPG,char_data/E/DSC03367.JPG_0.jpg,6853,77,455,532,32,121,False,16
E,141,kaist_dataset/English/Digital_Camera/(E.S)D-indoor/DSC02842.JPG,char_data/E/DSC02842.JPG_0.jpg,17202,122,233,355,191,332,False,16
E,47,kaist_dataset/English/Digital_Camera/(E.S)D-indoor/DSC03401.JPG,char_data/E/DSC03401.JPG_0.jpg,1833,39,270,309,231,278,False,16
E,102,kaist_dataset/English/Digital_Camera/(E.S)D-indoor/DSC03366.JPG,char_data/E/DSC03366.JPG_0.jpg,7650,75,219,294,349,451,False,16
E,121,kaist_dataset/English/Digital_Camera/(E.S)D-indoor/DSC03911.JPG,char_data/E/DSC03911.JPG_0.jpg,8349,69,200,269,322,443,False,16
E,120,kaist_dataset/English/Digital_Camera/(E.S)D-indoor/DSC03911.JPG,char_data/E/DSC03911.JPG_0.jpg,8760,73,272,345,322,442,False,16
E,78,kaist_dataset/English/Digital_Camera/(E.S)D-indoor/DSC03074.JPG,char_data/E/DSC03074.JPG_0.jpg,3042,39,84,123,244,322,False,16
E,38,kaist_dataset/English/Digital_Camera/(E.S)D-indoor/DSC03943.JPG,char_data/E/DSC03943.JPG_0.jpg,608,16,297,313,311,349,False,16
E,68,kaist_dataset/English/Digital_Camera/(E.S)D-indoor/DSC03887.JPG,char_data/E/DSC03887.JPG_0.jpg,3468,51,106,157,166,234,False,16
E,64,kaist_dataset/English/Digital_Camera/(E.S)D-indoor/DSC02769.JPG,char_data/E/DSC02769.JPG_0.jpg,2752,43,334,377,217,281,False,16
E,62,kaist_dataset/English/Digital_Camera/(E.S)D-indoor/DSC02769.JPG,char_data/E/DSC02769.JPG_0.jpg,2480,40,466,506,216,278,False,16
E,66,kaist_dataset/English/Digital_Camera/(E.S)D-indoor/DSC02769.JPG,char_data/E/DSC02769.JPG_0.jpg,2772,42,184,226,135,201,False,16
E,67,kaist_dataset/English/Digital_Camera/(E.S)D-indoor/DSC03091.JPG,char_data/E/DSC03091.JPG_0.jpg,2546,38,480,518,205,272,False,16
E,58,kaist_dataset/English/Digital_Camera/(E.S)D-indoor/DSC03947.JPG,char_data/E/DSC03947.JPG_0.jpg,2262,39,424,463,192,250,False,16
E,68,kaist_dataset/English/Digital_Camera/(E.S)D-indoor/DSC03883.JPG,char_data/E/DSC03883.JPG_0.jpg,3332,49,195,244,316,384,False,16
E,65,kaist_dataset/English/Digital_Camera/(E.S)D-indoor/DSC03881.JPG,char_data/E/DSC03881.JPG_0.jpg,3185,49,307,356,315,380,False,16
E,67,kaist_dataset/English/Digital_Camera/(E.S)D-indoor/DSC03078.JPG,char_data/E/DSC03078.JPG_0.jpg,3015,45,193,238,293,360,False,16
E,67,kaist_dataset/English/Digital_Camera/(E.S)D-indoor/DSC03396.JPG,char_data/E/DSC03396.JPG_0.jpg,3283,49,434,483,215,282,False,16
E,46,kaist_dataset/English/Digital_Camera/(E.S)D-indoor/DSC03396.JPG,char_data/E/DSC03396.JPG_0.jpg,1518,33,363,396,336,382,False,16
E,67,kaist_dataset/English/Digital_Camera/(E.S)D-indoor/DSC03396.JPG,char_data/E/DSC03396.JPG_0.jpg,3015,45,483,528,151,218,False,16
E,39,kaist_dataset/English/Digital_Camera/(E.S)D-indoor/DSC03935.JPG,char_data/E/DSC03935.JPG_0.jpg,1014,26,85,111,38,77,False,16
E,42,kaist_dataset/English/Digital_Camera/(E.S)D-indoor/DSC03935.JPG,char_data/E/DSC03935.JPG_0.jpg,840,20,137,157,37,79,False,16
E,36,kaist_dataset/English/Digital_Camera/(E.S)D-indoor/DSC03935.JPG,char_data/E/DSC03935.JPG_0.jpg,648,18,179,197,39,75,False,16
E,39,kaist_dataset/English/Digital_Camera/(E.S)D-indoor/DSC03935.JPG,char_data/E/DSC03935.JPG_0.jpg,1014,26,533,559,53,92,False,16
E,85,kaist_dataset/English/Digital_Camera/(E.S)D-indoor/DSC02850.JPG,char_data/E/DSC02850.JPG_0.jpg,5100,60,422,482,160,245,False,16
E,67,kaist_dataset/English/Digital_Camera/(E.S)D-indoor/DSC02850.JPG,char_data/E/DSC02850.JPG_0.jpg,3283,49,342,391,240,307,False,16
E,53,kaist_dataset/English/Digital_Camera/(E.S)D-indoor/DSC03467.JPG,char_data/E/DSC03467.JPG_0.jpg,1908,36,333,369,155,208,False,16
E,57,kaist_dataset/English/Digital_Camera/(E.S)D-indoor/DSC03467.JPG,char_data/E/DSC03467.JPG_0.jpg,1881,33,449,482,154,211,False,16
E,83,kaist_dataset/English/Digital_Camera/(E.S)C-outdoor3/P1010064.JPG,char_data/E/P1010064.JPG_0.jpg,4565,55,87,142,304,387,False,16
E,78,kaist_dataset/English/Digital_Camera/(E.S)C-outdoor3/P1010064.JPG,char_data/E/P1010064.JPG_0.jpg,4212,54,263,317,311,389,False,16
E,38,kaist_dataset/English/Digital_Camera/(E.S)C-outdoor3/r.jpg,char_data/E/r.jpg_0.jpg,1292,34,208,242,55,93,False,16
E,92,kaist_dataset/English/Digital_Camera/(E.S)C-outdoor3/r.jpg,char_data/E/r.jpg_0.jpg,5152,56,229,285,97,189,False,16
E,76,kaist_dataset/English/Digital_Camera/(E.S)C-outdoor3/P1010138.JPG,char_data/E/P1010138.JPG_0.jpg,4256,56,342,398,78,154,False,16
E,56,kaist_dataset/English/Digital_Camera/(E.S)C-outdoor3/크기변환_%B0%A3%C6%C718_m_starfirm.jpg,char_data/E/크기변환_%B0%A3%C6%C718_m_starfirm.jpg_0.jpg,3136,56,272,328,216,272,False,16
E,57,kaist_dataset/English/Digital_Camera/(E.S)C-outdoor3/크기변환_%B0%A3%C6%C718_m_starfirm.jpg,char_data/E/크기변환_%B0%A3%C6%C718_m_starfirm.jpg_0.jpg,3363,59,506,565,204,261,False,16
E,67,kaist_dataset/English/Digital_Camera/(E.S)C-outdoor3/DSC02788.JPG,char_data/E/DSC02788.JPG_0.jpg,2345,35,346,381,297,364,False,16
E,61,kaist_dataset/English/Digital_Camera/(E.S)C-outdoor3/DSC02788.JPG,char_data/E/DSC02788.JPG_0.jpg,1830,30,453,483,295,356,False,16
E,58,kaist_dataset/English/Digital_Camera/(E.S)C-outdoor3/DSC02788.JPG,char_data/E/DSC02788.JPG_0.jpg,1798,31,240,271,226,284,False,16
E,94,kaist_dataset/English/Digital_Camera/(E.S)C-outdoor3/P1010133.JPG,char_data/E/P1010133.JPG_0.jpg,6110,65,329,394,63,157,False,16
E,52,kaist_dataset/English/Digital_Camera/(E.S)C-outdoor3/크기변환_P1010076.JPG,char_data/E/크기변환_P1010076.JPG_0.jpg,1664,32,432,464,120,172,False,16
E,51,kaist_dataset/English/Digital_Camera/(E.S)C-outdoor3/크기변환_P1010076.JPG,char_data/E/크기변환_P1010076.JPG_0.jpg,2091,41,465,506,119,170,False,16
E,61,kaist_dataset/English/Digital_Camera/(E.S)C-outdoor3/크기변환_%C8%AD%C0%CC%C6%AE%C4%FE%C6%AE%B0%A3%C6%C7_%BA%B9%BB%E7_1-bona0007.jpg,char_data/E/크기변환_%C8%AD%C0%CC%C6%AE%C4%FE%C6%AE%B0%A3%C6%C7_%BA%B9%BB%E7_1-bona0007.jpg_0.jpg,3416,56,469,525,197,258,False,16
o,35,kaist_dataset/Korean/Digital_Camera/outdoor2/2007-12-09-day-exterior-036.jpg,char_data/o/2007-12-09-day-exterior-036.jpg_4.jpg,980,28,1360,1388,554,589,True,41
o,34,kaist_dataset/Korean/Digital_Camera/outdoor2/2007-12-09-day-exterior-036.jpg,char_data/o/2007-12-09-day-exterior-036.jpg_4.jpg,884,26,1477,1503,558,592,True,41
o,33,kaist_dataset/Korean/Digital_Camera/outdoor2/080118-0018.jpg,char_data/o/080118-0018.jpg_0.jpg,1617,49,572,621,690,723,True,41
o,22,kaist_dataset/Korean/Digital_Camera/indoor1/080119-0029.jpg,char_data/o/080119-0029.jpg_0.jpg,286,13,693,706,656,678,True,41
o,23,kaist_dataset/Korean/Digital_Camera/indoor1/080119-0029.jpg,char_data/o/080119-0029.jpg_0.jpg,299,13,823,836,658,681,True,41
o,42,kaist_dataset/Korean/Digital_Camera/G-others/2007-12-08-day-112.jpg,char_data/o/2007-12-08-day-112.jpg_0.jpg,840,20,641,661,600,642,True,41
o,24,kaist_dataset/Korean/Digital_Camera/A-shadow/2007-12-09-day-exterior-031.jpg,char_data/o/2007-12-09-day-exterior-031.jpg_0.jpg,360,15,340,355,623,647,True,41
o,22,kaist_dataset/Korean/Digital_Camera/outdoor1/2007-12-08-day-087.jpg,char_data/o/2007-12-08-day-087.jpg_0.jpg,418,19,105,124,513,535,True,41
o,25,kaist_dataset/Korean/Digital_Camera/outdoor1/2007-12-08-day-087.jpg,char_data/o/2007-12-08-day-087.jpg_0.jpg,525,21,124,145,510,535,True,41
o,40,kaist_dataset/Korean/Digital_Camera/outdoor1/2007-12-08-day-087.jpg,char_data/o/2007-12-08-day-087.jpg_0.jpg,1520,38,1393,1431,676,716,True,41
o,17,kaist_dataset/Korean/Digital_Camera/outdoor1/001.JPG,char_data/o/001.JPG_0.jpg,204,12,119,131,245,262,True,41
o,21,kaist_dataset/Korean/Digital_Camera/outdoor1/001.JPG,char_data/o/001.JPG_0.jpg,273,13,131,144,244,265,True,41
o,21,kaist_dataset/Korean/Digital_Camera/outdoor1/001.JPG,char_data/o/001.JPG_0.jpg,294,14,171,185,242,263,True,41
o,19,kaist_dataset/Korean/Digital_Camera/outdoor1/001.JPG,char_data/o/001.JPG_0.jpg,190,10,249,259,244,263,True,41
o,26,kaist_dataset/Korean/Digital_Camera/outdoor1/001.JPG,char_data/o/001.JPG_0.jpg,260,10,315,325,241,267,True,41
o,26,kaist_dataset/Korean/Digital_Camera/outdoor1/001.JPG,char_data/o/001.JPG_0.jpg,286,11,518,529,236,262,True,41
o,35,kaist_dataset/Korean/Digital_Camera/outdoor1/023.JPG,char_data/o/023.JPG_0.jpg,770,22,457,479,45,80,True,41
o,39,kaist_dataset/Korean/Digital_Camera/outdoor1/54.JPG,char_data/o/54.JPG_0.jpg,1482,38,335,373,107,146,True,41
o,31,kaist_dataset/Mixed/Mobile_Phone/(C.M)A-outdoor/P090912078.jpg,char_data/o/P090912078.jpg_0.jpg,775,25,136,161,314,345,True,41
o,25,kaist_dataset/Mixed/Mobile_Phone/(C.M)A-outdoor/P090912078.jpg,char_data/o/P090912078.jpg_0.jpg,675,27,421,448,300,325,True,41
o,65,kaist_dataset/Mixed/Mobile_Phone/(C.M)A-outdoor/P090912037.jpg,char_data/o/P090912037.jpg_0.jpg,3120,48,313,361,170,235,True,41
o,32,kaist_dataset/Mixed/Mobile_Phone/(C.M)B-indoor/P090831005.jpg,char_data/o/P090831005.jpg_0.jpg,576,18,268,286,240,272,True,41
o,66,kaist_dataset/Mixed/Mobile_Phone/(C.M)B-indoor/P090831019.jpg,char_data/o/P090831019.jpg_0.jpg,4224,64,154,218,154,220,True,41
o,50,kaist_dataset/Mixed/Mobile_Phone/(C.M)B-indoor/P090831010.jpg,char_data/o/P090831010.jpg_0.jpg,1850,37,427,464,285,335,True,41
o,43,kaist_dataset/Mixed/Mobile_Phone/(C.M)B-indoor/P090831010.jpg,char_data/o/P090831010.jpg_0.jpg,1419,33,466,499,294,337,True,41
o,44,kaist_dataset/Mixed/Mobile_Phone/(C.M)B-indoor/P090831014.jpg,char_data/o/P090831014.jpg_0.jpg,1628,37,265,302,173,217,True,41
o,45,kaist_dataset/Mixed/Mobile_Phone/(C.M)B-indoor/P090831015.jpg,char_data/o/P090831015.jpg_0.jpg,1575,35,327,362,212,257,True,41
o,64,kaist_dataset/Mixed/Mobile_Phone/(C.M)B-indoor/P090831008.jpg,char_data/o/P090831008.jpg_0.jpg,3520,55,377,432,318,382,True,41
o,59,kaist_dataset/Mixed/Mobile_Phone/(C.M)B-indoor/P090831008.jpg,char_data/o/P090831008.jpg_0.jpg,2478,42,435,477,322,381,True,41
o,47,kaist_dataset/Mixed/Mobile_Phone/(C.M)B-indoor/P090831023.jpg,char_data/o/P090831023.jpg_0.jpg,2068,44,149,193,282,329,True,41
o,36,kaist_dataset/Mixed/Mobile_Phone/(C.M)C-bookCover/P090902016.jpg,char_data/o/P090902016.jpg_0.jpg,1008,28,258,286,140,176,True,41
o,31,kaist_dataset/Mixed/Mobile_Phone/(C.M)C-bookCover/P090902016.jpg,char_data/o/P090902016.jpg_0.jpg,713,23,306,329,278,309,True,41
o,35,kaist_dataset/Mixed/Mobile_Phone/(C.M)C-bookCover/P090904004.jpg,char_data/o/P090904004.jpg_0.jpg,1155,33,514,547,403,438,True,41
o,36,kaist_dataset/Mixed/Mobile_Phone/(C.M)C-bookCover/P090831080.jpg,char_data/o/P090831080.jpg_0.jpg,1044,29,184,213,413,449,True,41
o,32,kaist_dataset/Mixed/Mobile_Phone/(C.M)C-bookCover/P090831080.jpg,char_data/o/P090831080.jpg_0.jpg,1024,32,301,333,416,448,True,41
o,39,kaist_dataset/Mixed/Mobile_Phone/(C.M)C-bookCover/P090902019.jpg,char_data/o/P090902019.jpg_0.jpg,1599,41,470,511,303,342,True,41
o,43,kaist_dataset/Mixed/Mobile_Phone/(C.M)C-bookCover/P090902019.jpg,char_data/o/P090902019.jpg_0.jpg,1591,37,510,547,302,345,True,41
o,28,kaist_dataset/Mixed/Mobile_Phone/(C.M)C-bookCover/P090903024.jpg,char_data/o/P090903024.jpg_0.jpg,700,25,479,504,116,144,True,41
o,29,kaist_dataset/Mixed/Mobile_Phone/(C.M)C-bookCover/P090903024.jpg,char_data/o/P090903024.jpg_0.jpg,899,31,356,387,179,208,True,41
o,88,kaist_dataset/Mixed/Digital_Camera/(C.S)C-outdoor1/P1010008.JPG,char_data/o/P1010008.JPG_0.jpg,6160,70,269,339,115,203,True,41
o,68,kaist_dataset/Mixed/Digital_Camera/(C.S)C-outdoor1/P1010008.JPG,char_data/o/P1010008.JPG_0.jpg,3740,55,375,430,253,321,True,41
o,49,kaist_dataset/Mixed/Digital_Camera/(C.S)C-outdoor1/080116-0084.jpg,char_data/o/080116-0084.jpg_0.jpg,2499,51,592,643,223,272,True,41
o,59,kaist_dataset/Mixed/Digital_Camera/(C.S)C-outdoor1/DSC02344.JPG,char_data/o/DSC02344.JPG_0.jpg,3540,60,408,468,170,229,True,41
o,26,kaist_dataset/Mixed/Digital_Camera/(C.S)C-outdoor1/115.JPG,char_data/o/115.JPG_0.jpg,494,19,501,520,272,298,True,41
o,33,kaist_dataset/Mixed/Digital_Camera/(C.S)C-outdoor1/086.JPG,char_data/o/086.JPG_0.jpg,528,16,216,232,334,367,True,41
o,34,kaist_dataset/Mixed/Digital_Camera/(C.S)C-outdoor1/086.JPG,char_data/o/086.JPG_0.jpg,578,17,370,387,335,369,True,41
o,32,kaist_dataset/Mixed/Digital_Camera/(C.S)C-outdoor1/080.JPG,char_data/o/080.JPG_0.jpg,928,29,56,85,113,145,True,41
o,43,kaist_dataset/Mixed/Digital_Camera/(C.S)C-outdoor1/101.JPG,char_data/o/101.JPG_0.jpg,2107,49,420,469,249,292,True,41
o,54,kaist_dataset/Mixed/Digital_Camera/(C.S)C-outdoor1/2007-12-08-day-106.jpg,char_data/o/2007-12-08-day-106.jpg_0.jpg,2376,44,454,498,750,804,True,41
o,56,kaist_dataset/Mixed/Digital_Camera/(C.S)C-outdoor1/2007-12-08-day-106.jpg,char_data/o/2007-12-08-day-106.jpg_0.jpg,2184,39,496,535,751,807,True,41
o,50,kaist_dataset/Mixed/Digital_Camera/(C.S)C-outdoor1/2007-12-08-day-106.jpg,char_data/o/2007-12-08-day-106.jpg_0.jpg,2050,41,750,791,753,803,True,41
o,46,kaist_dataset/Mixed/Digital_Camera/(C.S)C-outdoor1/2007-12-08-day-106.jpg,char_data/o/2007-12-08-day-106.jpg_0.jpg,1840,40,927,967,756,802,True,41
o,18,kaist_dataset/Mixed/Digital_Camera/(C.S)C-outdoor1/DSC02242.JPG,char_data/o/DSC02242.JPG_0.jpg,198,11,289,300,172,190,True,41
o,62,kaist_dataset/Mixed/Digital_Camera/(C.S)C-outdoor1/2007-12-09-day-exterior-044.jpg,char_data/o/2007-12-09-day-exterior-044.jpg_0.jpg,3844,62,1081,1143,831,893,True,41
o,32,kaist_dataset/Mixed/Digital_Camera/(C.S)C-outdoor1/55.JPG,char_data/o/55.JPG_0.jpg,1216,38,324,362,164,196,True,41
o,36,kaist_dataset/Mixed/Digital_Camera/(C.S)C-outdoor1/DSC02320.JPG,char_data/o/DSC02320.JPG_0.jpg,1008,28,339,367,236,272,True,41
o,25,kaist_dataset/Mixed/Digital_Camera/(C.S)C-outdoor1/DSC02320.JPG,char_data/o/DSC02320.JPG_0.jpg,250,10,585,595,254,279,True,41
o,26,kaist_dataset/Mixed/Digital_Camera/(C.S)C-outdoor1/DSC02318.JPG,char_data/o/DSC02318.JPG_0.jpg,702,27,314,341,328,354,True,41
o,56,kaist_dataset/Mixed/Digital_Camera/(C.S)C-outdoor1/130.JPG,char_data/o/130.JPG_0.jpg,2520,45,211,256,284,340,True,41
o,127,kaist_dataset/Mixed/Digital_Camera/(C.S)C-outdoor1/080118-0014.jpg,char_data/o/080118-0014.jpg_0.jpg,12827,101,1097,1198,757,884,True,41
o,20,kaist_dataset/Mixed/Digital_Camera/(C.S)C-outdoor1/2.JPG,char_data/o/2.JPG_0.jpg,160,8,99,107,385,405,True,41
o,24,kaist_dataset/Mixed/Digital_Camera/(C.S)C-outdoor1/2.JPG,char_data/o/2.JPG_0.jpg,96,4,136,140,384,408,True,41
o,28,kaist_dataset/Mixed/Digital_Camera/(C.S)C-outdoor1/063.JPG,char_data/o/063.JPG_0.jpg,392,14,98,112,257,285,True,41
o,22,kaist_dataset/Mixed/Digital_Camera/(C.S)C-outdoor1/003.JPG,char_data/o/003.JPG_0.jpg,264,12,409,421,254,276,True,41
o,26,kaist_dataset/Mixed/Digital_Camera/(C.S)C-outdoor1/003.JPG,char_data/o/003.JPG_0.jpg,260,10,429,439,255,281,True,41
o,22,kaist_dataset/Mixed/Digital_Camera/(C.S)C-outdoor1/003.JPG,char_data/o/003.JPG_0.jpg,242,11,487,498,251,273,True,41
o,19,kaist_dataset/Mixed/Digital_Camera/(C.S)C-outdoor1/003.JPG,char_data/o/003.JPG_0.jpg,171,9,547,556,253,272,True,41
o,19,kaist_dataset/Mixed/Digital_Camera/(C.S)C-outdoor1/003.JPG,char_data/o/003.JPG_0.jpg,209,11,83,94,269,288,True,41
o,19,kaist_dataset/Mixed/Digital_Camera/(C.S)C-outdoor1/003.JPG,char_data/o/003.JPG_0.jpg,190,10,215,225,264,283,True,41
o,37,kaist_dataset/Mixed/Digital_Camera/(C.S)C-outdoor1/062.JPG,char_data/o/062.JPG_0.jpg,444,12,257,269,167,204,True,41
o,40,kaist_dataset/Mixed/Digital_Camera/(C.S)F-others/DSC02609.JPG,char_data/o/DSC02609.JPG_0.jpg,880,22,343,365,303,343,True,41
o,35,kaist_dataset/Mixed/Digital_Camera/(C.S)F-others/2007-12-08-day-044.jpg,char_data/o/2007-12-08-day-044.jpg_0.jpg,700,20,840,860,810,845,True,41
o,50,kaist_dataset/Mixed/Digital_Camera/(C.S)F-others/047.jpg,char_data/o/047.jpg_0.jpg,2050,41,235,276,51,101,True,41
o,70,kaist_dataset/Mixed/Digital_Camera/(C.S)F-others/DSC02696.JPG,char_data/o/DSC02696.JPG_0.jpg,3780,54,131,185,307,377,True,41
o,37,kaist_dataset/Mixed/Digital_Camera/(C.S)D-indoor2/DSC04249.JPG,char_data/o/DSC04249.JPG_0.jpg,925,25,357,382,220,257,True,41
o,35,kaist_dataset/Mixed/Digital_Camera/(C.S)D-indoor2/DSC04249.JPG,char_data/o/DSC04249.JPG_0.jpg,980,28,380,408,219,254,True,41
o,48,kaist_dataset/Mixed/Digital_Camera/(C.S)D-indoor2/DSC04421.JPG,char_data/o/DSC04421.JPG_0.jpg,1248,26,336,362,215,263,True,41
o,30,kaist_dataset/Mixed/Digital_Camera/(C.S)D-indoor2/DSC04254.JPG,char_data/o/DSC04254.JPG_0.jpg,570,19,439,458,343,373,True,41
o,37,kaist_dataset/Mixed/Digital_Camera/(C.S)D-indoor2/DSC04248.JPG,char_data/o/DSC04248.JPG_0.jpg,888,24,174,198,225,262,True,41
o,31,kaist_dataset/Mixed/Digital_Camera/(C.S)D-indoor2/DSC04248.JPG,char_data/o/DSC04248.JPG_0.jpg,713,23,405,428,224,255,True,41
o,34,kaist_dataset/Mixed/Digital_Camera/(C.S)D-indoor2/DSC04248.JPG,char_data/o/DSC04248.JPG_0.jpg,850,25,427,452,224,258,True,41
o,47,kaist_dataset/Mixed/Digital_Camera/(C.S)E-night/DSC02647.JPG,char_data/o/DSC02647.JPG_0.jpg,2397,51,160,211,212,259,True,41
o,59,kaist_dataset/Mixed/Digital_Camera/(C.S)E-night/DSC03840.JPG,char_data/o/DSC03840.JPG_0.jpg,2478,42,98,140,111,170,True,41
o,25,kaist_dataset/Mixed/Digital_Camera/(C.S)E-night/DSC02569.JPG,char_data/o/DSC02569.JPG_0.jpg,475,19,255,274,278,303,True,41
o,35,kaist_dataset/Mixed/Digital_Camera/(C.S)E-night/DSC02600.JPG,char_data/o/DSC02600.JPG_0.jpg,1610,46,283,329,37,72,True,41
o,37,kaist_dataset/Mixed/Digital_Camera/(C.S)B-light/134.JPG,char_data/o/134.JPG_0.jpg,851,23,410,433,291,328,True,41
o,31,kaist_dataset/Mixed/Digital_Camera/(C.S)D-indoor1/DSC03118.JPG,char_data/o/DSC03118.JPG_0.jpg,651,21,163,184,163,194,True,41
o,38,kaist_dataset/Mixed/Digital_Camera/(C.S)D-indoor1/DSC03118.JPG,char_data/o/DSC03118.JPG_0.jpg,836,22,417,439,158,196,True,41
o,39,kaist_dataset/Mixed/Digital_Camera/(C.S)D-indoor1/DSC03118.JPG,char_data/o/DSC03118.JPG_0.jpg,858,22,390,412,230,269,True,41
o,35,kaist_dataset/Mixed/Digital_Camera/(C.S)D-indoor1/DSC03124.JPG,char_data/o/DSC03124.JPG_0.jpg,980,28,237,265,208,243,True,41
o,31,kaist_dataset/Mixed/Digital_Camera/(C.S)D-indoor1/DSC03124.JPG,char_data/o/DSC03124.JPG_0.jpg,806,26,406,432,203,234,True,41
o,47,kaist_dataset/Mixed/Digital_Camera/(C.S)D-indoor1/DSC03119.JPG,char_data/o/DSC03119.JPG_0.jpg,1410,30,171,201,167,214,True,41
o,47,kaist_dataset/Mixed/Digital_Camera/(C.S)D-indoor1/DSC03119.JPG,char_data/o/DSC03119.JPG_0.jpg,1316,28,200,228,168,215,True,41
o,43,kaist_dataset/Mixed/Digital_Camera/(C.S)D-indoor1/DSC03119.JPG,char_data/o/DSC03119.JPG_0.jpg,1204,28,402,430,169,212,True,41
o,40,kaist_dataset/Mixed/Digital_Camera/(C.S)D-indoor1/DSC03119.JPG,char_data/o/DSC03119.JPG_0.jpg,1080,27,429,456,168,208,True,41
o,33,kaist_dataset/Mixed/Digital_Camera/(C.S)D-indoor1/DSC03129.JPG,char_data/o/DSC03129.JPG_0.jpg,726,22,311,333,210,243,True,41
o,32,kaist_dataset/Mixed/Digital_Camera/(C.S)D-indoor1/DSC03129.JPG,char_data/o/DSC03129.JPG_0.jpg,800,25,355,380,211,243,True,41
o,38,kaist_dataset/Mixed/Digital_Camera/(C.S)D-indoor1/DSC03134.JPG,char_data/o/DSC03134.JPG_0.jpg,912,24,237,261,169,207,True,41
o,36,kaist_dataset/Mixed/Digital_Camera/(C.S)D-indoor1/DSC03134.JPG,char_data/o/DSC03134.JPG_0.jpg,1008,28,303,331,173,209,True,41
o,35,kaist_dataset/Mixed/Digital_Camera/(C.S)D-indoor1/082.JPG,char_data/o/082.JPG_0.jpg,1015,29,454,483,178,213,True,41
o,32,kaist_dataset/Mixed/Digital_Camera/(C.S)D-indoor1/DSC03126.JPG,char_data/o/DSC03126.JPG_0.jpg,928,29,250,279,231,263,True,41
o,48,kaist_dataset/Mixed/Digital_Camera/(C.S)D-indoor1/DSC03123.JPG,char_data/o/DSC03123.JPG_0.jpg,1536,32,315,347,178,226,True,41
o,34,kaist_dataset/Mixed/Digital_Camera/(C.S)D-indoor1/DSC02787.JPG,char_data/o/DSC02787.JPG_0.jpg,544,16,137,153,386,420,True,41
o,39,kaist_dataset/Mixed/Digital_Camera/(C.S)D-indoor1/DSC02787.JPG,char_data/o/DSC02787.JPG_0.jpg,663,17,159,176,384,423,True,41
o,33,kaist_dataset/Mixed/Digital_Camera/(C.S)D-indoor1/DSC02787.JPG,char_data/o/DSC02787.JPG_0.jpg,528,16,371,387,370,403,True,41
o,37,kaist_dataset/Mixed/Digital_Camera/(C.S)D-indoor1/DSC02787.JPG,char_data/o/DSC02787.JPG_0.jpg,777,21,449,470,365,402,True,41
o,32,kaist_dataset/Mixed/Digital_Camera/(C.S)D-indoor1/DSC03466.JPG,char_data/o/DSC03466.JPG_0.jpg,768,24,423,447,233,265,True,41
o,39,kaist_dataset/Mixed/Digital_Camera/(C.S)D-indoor1/DSC03953.JPG,char_data/o/DSC03953.JPG_0.jpg,702,18,296,314,388,427,True,41
o,43,kaist_dataset/Mixed/Digital_Camera/(C.S)D-indoor1/DSC03073.JPG,char_data/o/DSC03073.JPG_0.jpg,1118,26,381,407,284,327,True,41
o,29,kaist_dataset/Mixed/Digital_Camera/(C.S)D-indoor1/DSC03073.JPG,char_data/o/DSC03073.JPG_0.jpg,725,25,408,433,296,325,True,41
o,34,kaist_dataset/Mixed/Digital_Camera/(C.S)D-indoor1/DSC03073.JPG,char_data/o/DSC03073.JPG_0.jpg,986,29,378,407,336,370,True,41
o,40,kaist_dataset/Mixed/Digital_Camera/(C.S)D-indoor1/DSC02804.JPG,char_data/o/DSC02804.JPG_0.jpg,760,19,384,403,351,391,True,41
o,35,kaist_dataset/Mixed/Digital_Camera/(C.S)D-indoor1/DSC03132.JPG,char_data/o/DSC03132.JPG_0.jpg,910,26,173,199,249,284,True,41
o,36,kaist_dataset/Mixed/Digital_Camera/(C.S)D-indoor1/DSC03132.JPG,char_data/o/DSC03132.JPG_0.jpg,936,26,371,397,251,287,True,41
o,77,kaist_dataset/Mixed/Digital_Camera/(C.S)D-indoor1/DSC03469.JPG,char_data/o/DSC03469.JPG_0.jpg,4543,59,109,168,348,425,True,41
o,84,kaist_dataset/Mixed/Digital_Camera/(C.S)D-indoor1/DSC03469.JPG,char_data/o/DSC03469.JPG_0.jpg,4956,59,411,470,344,428,True,41
o,49,kaist_dataset/Mixed/Digital_Camera/(C.S)D-indoor1/DSC04183.JPG,char_data/o/DSC04183.JPG_0.jpg,1176,24,223,247,245,294,True,41
o,37,kaist_dataset/Mixed/Digital_Camera/(C.S)D-indoor1/DSC04183.JPG,char_data/o/DSC04183.JPG_0.jpg,999,27,378,405,257,294,True,41
o,35,kaist_dataset/Mixed/Digital_Camera/(C.S)D-indoor1/DSC04183.JPG,char_data/o/DSC04183.JPG_0.jpg,735,21,439,460,257,292,True,41
o,33,kaist_dataset/Mixed/Digital_Camera/(C.S)D-indoor1/DSC04183.JPG,char_data/o/DSC04183.JPG_0.jpg,825,25,458,483,259,292,True,41
o,33,kaist_dataset/Mixed/Digital_Camera/(C.S)D-indoor1/DSC04206.JPG,char_data/o/DSC04206.JPG_0.jpg,495,15,216,231,286,319,True,41
o,35,kaist_dataset/Mixed/Digital_Camera/(C.S)D-indoor1/DSC04206.JPG,char_data/o/DSC04206.JPG_0.jpg,560,16,318,334,291,326,True,41
o,36,kaist_dataset/Mixed/Digital_Camera/(C.S)D-indoor1/DSC04206.JPG,char_data/o/DSC04206.JPG_0.jpg,576,16,408,424,294,330,True,41
o,38,kaist_dataset/Mixed/Digital_Camera/(C.S)D-indoor1/DSC04206.JPG,char_data/o/DSC04206.JPG_0.jpg,722,19,468,487,294,332,True,41
o,38,kaist_dataset/Mixed/Digital_Camera/(C.S)D-indoor1/DSC04206.JPG,char_data/o/DSC04206.JPG_0.jpg,646,17,487,504,294,332,True,41
o,47,kaist_dataset/Mixed/Digital_Camera/(C.S)D-indoor1/DSC03135.JPG,char_data/o/DSC03135.JPG_0.jpg,1504,32,277,309,187,234,True,41
o,26,kaist_dataset/Mixed/Digital_Camera/(C.S)D-indoor1/DSC03122.JPG,char_data/o/DSC03122.JPG_0.jpg,546,21,305,326,207,233,True,41
o,32,kaist_dataset/Mixed/Digital_Camera/(C.S)D-indoor1/DSC03122.JPG,char_data/o/DSC03122.JPG_0.jpg,640,20,349,369,202,234,True,41
o,32,kaist_dataset/Mixed/Digital_Camera/(C.S)D-indoor1/DSC03122.JPG,char_data/o/DSC03122.JPG_0.jpg,640,20,237,257,152,184,True,41
o,30,kaist_dataset/Mixed/Digital_Camera/(C.S)D-indoor1/DSC03122.JPG,char_data/o/DSC03122.JPG_0.jpg,660,22,257,279,153,183,True,41
o,42,kaist_dataset/Mixed/Digital_Camera/(C.S)D-indoor1/DSC03133.JPG,char_data/o/DSC03133.JPG_0.jpg,1428,34,259,293,157,199,True,41
o,37,kaist_dataset/Mixed/Digital_Camera/(C.S)D-indoor1/DSC03131.JPG,char_data/o/DSC03131.JPG_0.jpg,999,27,313,340,137,174,True,41
o,42,kaist_dataset/Mixed/Digital_Camera/(C.S)D-indoor1/DSC03125.JPG,char_data/o/DSC03125.JPG_0.jpg,1134,27,352,379,188,230,True,41
o,28,kaist_dataset/Mixed/Digital_Camera/(C.S)D-indoor1/DSC02718.JPG,char_data/o/DSC02718.JPG_0.jpg,448,16,74,90,228,256,True,41
o,31,kaist_dataset/Mixed/Digital_Camera/(C.S)D-indoor1/DSC02718.JPG,char_data/o/DSC02718.JPG_0.jpg,496,16,126,142,231,262,True,41
o,30,kaist_dataset/Mixed/Digital_Camera/(C.S)D-indoor1/DSC03096.JPG,char_data/o/DSC03096.JPG_0.jpg,570,19,140,159,424,454,True,41
o,32,kaist_dataset/Mixed/Digital_Camera/(C.S)D-indoor1/DSC03096.JPG,char_data/o/DSC03096.JPG_0.jpg,640,20,318,338,423,455,True,41
o,34,kaist_dataset/Mixed/Digital_Camera/(C.S)D-indoor1/DSC03096.JPG,char_data/o/DSC03096.JPG_0.jpg,612,18,578,596,429,463,True,41
o,33,kaist_dataset/Mixed/Digital_Camera/(C.S)D-indoor1/DSC04246.JPG,char_data/o/DSC04246.JPG_0.jpg,594,18,140,158,250,283,True,41
o,32,kaist_dataset/Mixed/Digital_Camera/(C.S)D-indoor1/DSC04246.JPG,char_data/o/DSC04246.JPG_0.jpg,544,17,336,353,250,282,True,41
o,54,kaist_dataset/Mixed/Digital_Camera/(C.S)C-outdoor5/DSC04395.JPG,char_data/o/DSC04395.JPG_0.jpg,2052,38,447,485,349,403,True,41
o,42,kaist_dataset/Mixed/Digital_Camera/(C.S)C-outdoor5/DSC04162.JPG,char_data/o/DSC04162.JPG_0.jpg,1428,34,180,214,331,373,True,41
o,49,kaist_dataset/Mixed/Digital_Camera/(C.S)C-outdoor5/DSC04456.JPG,char_data/o/DSC04456.JPG_0.jpg,1715,35,209,244,169,218,True,41
o,43,kaist_dataset/Mixed/Digital_Camera/(C.S)C-outdoor5/DSC04456.JPG,char_data/o/DSC04456.JPG_0.jpg,1462,34,326,360,176,219,True,41
o,41,kaist_dataset/Mixed/Digital_Camera/(C.S)C-outdoor5/DSC04456.JPG,char_data/o/DSC04456.JPG_0.jpg,1394,34,557,591,176,217,True,41
o,23,kaist_dataset/Mixed/Digital_Camera/(C.S)C-outdoor5/DSC04312.JPG,char_data/o/DSC04312.JPG_0.jpg,345,15,451,466,151,174,True,41
o,36,kaist_dataset/Mixed/Digital_Camera/(C.S)C-outdoor5/DSC04104.JPG,char_data/o/DSC04104.JPG_0.jpg,864,24,395,419,49,85,True,41
o,33,kaist_dataset/Mixed/Digital_Camera/(C.S)C-outdoor5/DSC04104.JPG,char_data/o/DSC04104.JPG_0.jpg,957,29,456,485,48,81,True,41
o,36,kaist_dataset/Mixed/Digital_Camera/(C.S)C-outdoor5/DSC04104.JPG,char_data/o/DSC04104.JPG_0.jpg,936,26,522,548,46,82,True,41
o,41,kaist_dataset/Mixed/Digital_Camera/(C.S)C-outdoor5/DSC04321.JPG,char_data/o/DSC04321.JPG_0.jpg,861,21,312,333,198,239,True,41
o,36,kaist_dataset/Mixed/Digital_Camera/(C.S)C-outdoor5/DSC04076.JPG,char_data/o/DSC04076.JPG_0.jpg,1044,29,248,277,107,143,True,41
o,24,kaist_dataset/Mixed/Digital_Camera/(C.S)C-outdoor5/DSC04076.JPG,char_data/o/DSC04076.JPG_0.jpg,552,23,492,515,404,428,True,41
o,27,kaist_dataset/Mixed/Digital_Camera/(C.S)C-outdoor5/DSC04357.JPG,char_data/o/DSC04357.JPG_0.jpg,297,11,309,320,383,410,True,41
o,26,kaist_dataset/Mixed/Digital_Camera/(C.S)C-outdoor5/DSC04357.JPG,char_data/o/DSC04357.JPG_0.jpg,416,16,463,479,354,380,True,41
o,33,kaist_dataset/Mixed/Digital_Camera/(C.S)C-outdoor5/DSC04069.JPG,char_data/o/DSC04069.JPG_0.jpg,759,23,186,209,424,457,True,41
o,30,kaist_dataset/Mixed/Digital_Camera/(C.S)C-outdoor5/DSC04069.JPG,char_data/o/DSC04069.JPG_0.jpg,630,21,403,424,424,454,True,41
o,31,kaist_dataset/Mixed/Digital_Camera/(C.S)C-outdoor5/DSC04069.JPG,char_data/o/DSC04069.JPG_0.jpg,589,19,162,181,390,421,True,41
o,32,kaist_dataset/Mixed/Digital_Camera/(C.S)C-outdoor5/DSC04069.JPG,char_data/o/DSC04069.JPG_0.jpg,544,17,373,390,382,414,True,41
o,25,kaist_dataset/Mixed/Digital_Camera/(C.S)C-outdoor5/DSC04069.JPG,char_data/o/DSC04069.JPG_0.jpg,575,23,527,550,385,410,True,41
o,35,kaist_dataset/Mixed/Digital_Camera/(C.S)C-outdoor5/DSC03821.JPG,char_data/o/DSC03821.JPG_0.jpg,910,26,404,430,43,78,True,41
o,45,kaist_dataset/Mixed/Digital_Camera/(C.S)C-outdoor5/DSC04399.JPG,char_data/o/DSC04399.JPG_0.jpg,1710,38,280,318,221,266,True,41
o,46,kaist_dataset/Mixed/Digital_Camera/(C.S)C-outdoor5/DSC04399.JPG,char_data/o/DSC04399.JPG_0.jpg,1472,32,520,552,214,260,True,41
o,51,kaist_dataset/Mixed/Digital_Camera/(C.S)C-outdoor5/DSC04399.JPG,char_data/o/DSC04399.JPG_0.jpg,1632,32,281,313,286,337,True,41
o,29,kaist_dataset/Mixed/Digital_Camera/(C.S)C-outdoor5/DSC04125.JPG,char_data/o/DSC04125.JPG_0.jpg,493,17,257,274,427,456,True,41
o,33,kaist_dataset/Mixed/Digital_Camera/(C.S)C-outdoor5/DSC04070.JPG,char_data/o/DSC04070.JPG_0.jpg,429,13,158,171,110,143,True,41
o,36,kaist_dataset/Mixed/Digital_Camera/(C.S)C-outdoor5/DSC04129.JPG,char_data/o/DSC04129.JPG_0.jpg,1116,31,111,142,408,444,True,41
o,28,kaist_dataset/Mixed/Digital_Camera/(C.S)C-outdoor5/DSC04091.JPG,char_data/o/DSC04091.JPG_0.jpg,532,19,383,402,427,455,True,41
o,37,kaist_dataset/Mixed/Digital_Camera/(C.S)C-outdoor5/DSC04323.JPG,char_data/o/DSC04323.JPG_0.jpg,740,20,343,363,204,241,True,41
o,39,kaist_dataset/Mixed/Digital_Camera/(C.S)C-outdoor5/DSC04323.JPG,char_data/o/DSC04323.JPG_0.jpg,702,18,553,571,209,248,True,41
o,54,kaist_dataset/Mixed/Digital_Camera/(C.S)C-outdoor5/DSC04029.JPG,char_data/o/DSC04029.JPG_0.jpg,1890,35,350,385,179,233,True,41
o,75,kaist_dataset/Mixed/Digital_Camera/(C.S)C-outdoor5/DSC04030.JPG,char_data/o/DSC04030.JPG_0.jpg,3975,53,91,144,187,262,True,41
o,29,kaist_dataset/Mixed/Digital_Camera/(C.S)C-outdoor5/DSC04338.JPG,char_data/o/DSC04338.JPG_0.jpg,725,25,484,509,207,236,True,41
o,29,kaist_dataset/Mixed/Digital_Camera/(C.S)C-outdoor5/DSC04338.JPG,char_data/o/DSC04338.JPG_0.jpg,667,23,589,612,205,234,True,41
o,34,kaist_dataset/Mixed/Digital_Camera/(C.S)C-outdoor5/DSC04322.JPG,char_data/o/DSC04322.JPG_0.jpg,680,20,508,528,229,263,True,41
o,45,kaist_dataset/Mixed/Digital_Camera/(C.S)C-outdoor5/DSC04322.JPG,char_data/o/DSC04322.JPG_0.jpg,945,21,529,550,226,271,True,41
o,41,kaist_dataset/Mixed/Digital_Camera/(C.S)C-outdoor5/DSC04057.JPG,char_data/o/DSC04057.JPG_0.jpg,738,18,78,96,118,159,True,41
o,82,kaist_dataset/Mixed/Digital_Camera/(C.S)C-outdoor3/DSC03190.JPG,char_data/o/DSC03190.JPG_0.jpg,6150,75,141,216,233,315,True,41
o,75,kaist_dataset/Mixed/Digital_Camera/(C.S)C-outdoor3/DSC03190.JPG,char_data/o/DSC03190.JPG_0.jpg,4950,66,216,282,235,310,True,41
o,87,kaist_dataset/Mixed/Digital_Camera/(C.S)C-outdoor3/DSC03190.JPG,char_data/o/DSC03190.JPG_0.jpg,6177,71,484,555,234,321,True,41
o,39,kaist_dataset/Mixed/Digital_Camera/(C.S)C-outdoor3/DSC03177.JPG,char_data/o/DSC03177.JPG_0.jpg,1209,31,270,301,145,184,True,41
o,45,kaist_dataset/Mixed/Digital_Camera/(C.S)C-outdoor3/DSC03177.JPG,char_data/o/DSC03177.JPG_0.jpg,1260,28,436,464,146,191,True,41
o,42,kaist_dataset/Mixed/Digital_Camera/(C.S)C-outdoor3/DSC03310.JPG,char_data/o/DSC03310.JPG_0.jpg,840,20,404,424,128,170,True,41
o,39,kaist_dataset/Mixed/Digital_Camera/(C.S)C-outdoor3/DSC02962.JPG,char_data/o/DSC02962.JPG_0.jpg,1482,38,76,114,299,338,True,41
o,40,kaist_dataset/Mixed/Digital_Camera/(C.S)C-outdoor3/DSC02962.JPG,char_data/o/DSC02962.JPG_0.jpg,1560,39,115,154,293,333,True,41
o,53,kaist_dataset/Mixed/Digital_Camera/(C.S)C-outdoor3/DSC03047.JPG,char_data/o/DSC03047.JPG_0.jpg,1325,25,195,220,202,255,True,41
o,61,kaist_dataset/Mixed/Digital_Camera/(C.S)C-outdoor3/DSC03047.JPG,char_data/o/DSC03047.JPG_0.jpg,1647,27,306,333,197,258,True,41
o,55,kaist_dataset/Mixed/Digital_Camera/(C.S)C-outdoor3/DSC03047.JPG,char_data/o/DSC03047.JPG_0.jpg,1540,28,423,451,199,254,True,41
o,23,kaist_dataset/Mixed/Digital_Camera/(C.S)C-outdoor3/DSC02970.JPG,char_data/o/DSC02970.JPG_0.jpg,391,17,220,237,314,337,True,41
o,35,kaist_dataset/Mixed/Digital_Camera/(C.S)C-outdoor3/DSC02978.JPG,char_data/o/DSC02978.JPG_0.jpg,770,22,209,231,168,203,True,41
o,31,kaist_dataset/Mixed/Digital_Camera/(C.S)C-outdoor3/DSC02978.JPG,char_data/o/DSC02978.JPG_0.jpg,682,22,318,340,172,203,True,41
o,34,kaist_dataset/Mixed/Digital_Camera/(C.S)C-outdoor3/DSC02978.JPG,char_data/o/DSC02978.JPG_0.jpg,578,17,375,392,174,208,True,41
o,24,kaist_dataset/Mixed/Digital_Camera/(C.S)C-outdoor3/DSC03328.JPG,char_data/o/DSC03328.JPG_0.jpg,360,15,324,339,245,269,True,41
o,25,kaist_dataset/Mixed/Digital_Camera/(C.S)C-outdoor3/DSC03328.JPG,char_data/o/DSC03328.JPG_0.jpg,325,13,452,465,237,262,True,41
o,39,kaist_dataset/Mixed/Digital_Camera/(C.S)C-outdoor3/DSC03063.JPG,char_data/o/DSC03063.JPG_0.jpg,1170,30,205,235,287,326,True,41
o,47,kaist_dataset/Mixed/Digital_Camera/(C.S)C-outdoor3/DSC03063.JPG,char_data/o/DSC03063.JPG_0.jpg,1363,29,380,409,295,342,True,41
o,41,kaist_dataset/Mixed/Digital_Camera/(C.S)C-outdoor3/DSC03332.JPG,char_data/o/DSC03332.JPG_0.jpg,1435,35,260,295,234,275,True,41
o,49,kaist_dataset/Mixed/Digital_Camera/(C.S)C-outdoor3/DSC03332.JPG,char_data/o/DSC03332.JPG_0.jpg,1960,40,365,405,227,276,True,41
o,46,kaist_dataset/Mixed/Digital_Camera/(C.S)C-outdoor3/DSC03332.JPG,char_data/o/DSC03332.JPG_0.jpg,1840,40,450,490,220,266,True,41
o,32,kaist_dataset/Mixed/Digital_Camera/(C.S)C-outdoor3/DSC03227.JPG,char_data/o/DSC03227.JPG_0.jpg,608,19,104,123,111,143,True,41
o,53,kaist_dataset/Mixed/Digital_Camera/(C.S)C-outdoor3/DSC03409.JPG,char_data/o/DSC03409.JPG_0.jpg,2597,49,478,527,150,203,True,41
o,45,kaist_dataset/Mixed/Digital_Camera/(C.S)C-outdoor3/DSC03340.JPG,char_data/o/DSC03340.JPG_0.jpg,1845,41,517,558,291,336,True,41
o,24,kaist_dataset/Mixed/Digital_Camera/(C.S)C-outdoor3/DSC03020.JPG,char_data/o/DSC03020.JPG_0.jpg,264,11,448,459,305,329,True,41
o,31,kaist_dataset/Mixed/Digital_Camera/(C.S)C-outdoor3/DSC03020.JPG,char_data/o/DSC03020.JPG_0.jpg,434,14,497,511,303,334,True,41
o,45,kaist_dataset/Mixed/Digital_Camera/(C.S)C-outdoor3/DSC02989.JPG,char_data/o/DSC02989.JPG_0.jpg,1710,38,557,595,209,254,True,41
o,21,kaist_dataset/Mixed/Digital_Camera/(C.S)C-outdoor3/DSC03271.JPG,char_data/o/DSC03271.JPG_0.jpg,420,20,320,340,118,139,True,41
o,16,kaist_dataset/Mixed/Digital_Camera/(C.S)C-outdoor3/DSC03271.JPG,char_data/o/DSC03271.JPG_0.jpg,256,16,341,357,122,138,True,41
o,32,kaist_dataset/Mixed/Digital_Camera/(C.S)C-outdoor6/002.jpg,char_data/o/002.jpg_0.jpg,800,25,125,150,63,95,True,41
o,34,kaist_dataset/Mixed/Digital_Camera/(C.S)C-outdoor6/002.jpg,char_data/o/002.jpg_0.jpg,986,29,148,177,64,98,True,41
o,31,kaist_dataset/Mixed/Digital_Camera/(C.S)C-outdoor6/002.jpg,char_data/o/002.jpg_0.jpg,620,20,209,229,78,109,True,41
o,79,kaist_dataset/Mixed/Digital_Camera/(C.S)C-outdoor6/DSC03324.JPG,char_data/o/DSC03324.JPG_0.jpg,5056,64,222,286,80,159,True,41
o,49,kaist_dataset/Mixed/Digital_Camera/(C.S)C-outdoor6/DSC03324.JPG,char_data/o/DSC03324.JPG_0.jpg,2009,41,342,383,104,153,True,41
o,75,kaist_dataset/Mixed/Digital_Camera/(C.S)C-outdoor6/DSC03324.JPG,char_data/o/DSC03324.JPG_0.jpg,4500,60,402,462,72,147,True,41
o,52,kaist_dataset/Mixed/Digital_Camera/(C.S)C-outdoor6/DSC03324.JPG,char_data/o/DSC03324.JPG_0.jpg,2444,47,525,572,90,142,True,41
o,30,kaist_dataset/Mixed/Digital_Camera/(C.S)C-outdoor6/P1010069.JPG,char_data/o/P1010069.JPG_0.jpg,600,20,206,226,298,328,True,41
o,25,kaist_dataset/Mixed/Digital_Camera/(C.S)C-outdoor6/P1010069.JPG,char_data/o/P1010069.JPG_0.jpg,500,20,251,271,301,326,True,41
o,27,kaist_dataset/Mixed/Digital_Camera/(C.S)C-outdoor6/P1010069.JPG,char_data/o/P1010069.JPG_0.jpg,540,20,294,314,303,330,True,41
o,23,kaist_dataset/Mixed/Digital_Camera/(C.S)C-outdoor6/P1010138.JPG,char_data/o/P1010138.JPG_0.jpg,414,18,246,264,188,211,True,41
o,23,kaist_dataset/Mixed/Digital_Camera/(C.S)C-outdoor6/090.jpg,char_data/o/090.jpg_0.jpg,322,14,384,398,165,188,True,41
o,31,kaist_dataset/Mixed/Digital_Camera/(C.S)C-outdoor6/P1010085.JPG,char_data/o/P1010085.JPG_0.jpg,651,21,55,76,98,129,True,41
o,137,kaist_dataset/Mixed/Digital_Camera/(C.S)C-outdoor6/080116-0057.jpg,char_data/o/080116-0057.jpg_0.jpg,17673,129,871,1000,355,492,True,41
o,133,kaist_dataset/Mixed/Digital_Camera/(C.S)C-outdoor6/080116-0057.jpg,char_data/o/080116-0057.jpg_0.jpg,16359,123,1084,1207,577,710,True,41
o,43,kaist_dataset/Mixed/Digital_Camera/(C.S)C-outdoor6/080116-0057.jpg,char_data/o/080116-0057.jpg_0.jpg,1376,32,1107,1139,829,872,True,41
o,51,kaist_dataset/Mixed/Digital_Camera/(C.S)C-outdoor6/080116-0057.jpg,char_data/o/080116-0057.jpg_0.jpg,1683,33,828,861,824,875,True,41
o,41,kaist_dataset/Mixed/Digital_Camera/(C.S)C-outdoor6/080116-0057.jpg,char_data/o/080116-0057.jpg_0.jpg,1230,30,931,961,836,877,True,41
o,48,kaist_dataset/Mixed/Digital_Camera/(C.S)C-outdoor6/025.jpg,char_data/o/025.jpg_0.jpg,3024,63,86,149,75,123,True,41
o,28,kaist_dataset/Mixed/Digital_Camera/(C.S)C-outdoor6/P1010048.JPG,char_data/o/P1010048.JPG_0.jpg,504,18,463,481,170,198,True,41
o,18,kaist_dataset/Mixed/Digital_Camera/(C.S)C-outdoor6/P1010065.JPG,char_data/o/P1010065.JPG_0.jpg,306,17,266,283,236,254,True,41
o,73,kaist_dataset/Mixed/Digital_Camera/(C.S)C-outdoor4/DSC03572.JPG,char_data/o/DSC03572.JPG_0.jpg,4453,61,399,460,132,205,True,41
o,33,kaist_dataset/Mixed/Digital_Camera/(C.S)C-outdoor4/DSC03719.JPG,char_data/o/DSC03719.JPG_0.jpg,495,15,46,61,33,66,True,41
o,30,kaist_dataset/Mixed/Digital_Camera/(C.S)C-outdoor4/DSC03719.JPG,char_data/o/DSC03719.JPG_0.jpg,390,13,224,237,35,65,True,41
o,39,kaist_dataset/Mixed/Digital_Camera/(C.S)C-outdoor4/DSC03642.JPG,char_data/o/DSC03642.JPG_0.jpg,897,23,328,351,252,291,True,41
o,38,kaist_dataset/Mixed/Digital_Camera/(C.S)C-outdoor4/DSC03773.JPG,char_data/o/DSC03773.JPG_0.jpg,1292,34,300,334,279,317,True,41
o,37,kaist_dataset/Mixed/Digital_Camera/(C.S)C-outdoor4/DSC03773.JPG,char_data/o/DSC03773.JPG_0.jpg,1628,44,464,508,292,329,True,41
o,49,kaist_dataset/Mixed/Digital_Camera/(C.S)C-outdoor4/DSC03620.JPG,char_data/o/DSC03620.JPG_0.jpg,2254,46,465,511,92,141,True,41
o,35,kaist_dataset/Mixed/Digital_Camera/(C.S)C-outdoor4/DSC03718.JPG,char_data/o/DSC03718.JPG_0.jpg,490,14,368,382,94,129,True,41
o,31,kaist_dataset/Mixed/Digital_Camera/(C.S)C-outdoor4/DSC03718.JPG,char_data/o/DSC03718.JPG_0.jpg,372,12,43,55,261,292,True,41
o,23,kaist_dataset/Mixed/Digital_Camera/(C.S)C-outdoor4/DSC03718.JPG,char_data/o/DSC03718.JPG_0.jpg,345,15,215,230,262,285,True,41
o,52,kaist_dataset/Mixed/Digital_Camera/(C.S)C-outdoor4/DSC03781.JPG,char_data/o/DSC03781.JPG_0.jpg,2860,55,241,296,313,365,True,41
o,30,kaist_dataset/Mixed/Digital_Camera/(C.S)C-outdoor4/DSC03672.JPG,char_data/o/DSC03672.JPG_0.jpg,660,22,301,323,416,446,True,41
o,30,kaist_dataset/Mixed/Digital_Camera/(C.S)C-outdoor4/DSC03672.JPG,char_data/o/DSC03672.JPG_0.jpg,630,21,377,398,415,445,True,41
o,44,kaist_dataset/Mixed/Digital_Camera/(C.S)C-outdoor4/DSC03643.JPG,char_data/o/DSC03643.JPG_0.jpg,1804,41,285,326,273,317,True,41
o,74,kaist_dataset/Mixed/Digital_Camera/(C.S)C-outdoor4/DSC03630.JPG,char_data/o/DSC03630.JPG_0.jpg,3404,46,220,266,351,425,True,41
o,75,kaist_dataset/Mixed/Digital_Camera/(C.S)C-outdoor4/DSC03630.JPG,char_data/o/DSC03630.JPG_0.jpg,3075,41,413,454,353,428,True,41
o,29,kaist_dataset/Mixed/Digital_Camera/(C.S)C-outdoor4/DSC03556.JPG,char_data/o/DSC03556.JPG_0.jpg,464,16,214,230,320,349,True,41
o,30,kaist_dataset/Mixed/Digital_Camera/(C.S)C-outdoor4/DSC03556.JPG,char_data/o/DSC03556.JPG_0.jpg,360,12,300,312,320,350,True,41
o,24,kaist_dataset/Mixed/Digital_Camera/(C.S)C-outdoor4/DSC03556.JPG,char_data/o/DSC03556.JPG_0.jpg,288,12,411,423,325,349,True,41
o,25,kaist_dataset/Mixed/Digital_Camera/(C.S)C-outdoor4/DSC03556.JPG,char_data/o/DSC03556.JPG_0.jpg,275,11,530,541,322,347,True,41
o,23,kaist_dataset/Mixed/Digital_Camera/(C.S)C-outdoor4/DSC03556.JPG,char_data/o/DSC03556.JPG_0.jpg,253,11,580,591,326,349,True,41
o,23,kaist_dataset/Mixed/Digital_Camera/(C.S)C-outdoor4/DSC03667.JPG,char_data/o/DSC03667.JPG_0.jpg,368,16,184,200,387,410,True,41
o,30,kaist_dataset/Mixed/Digital_Camera/(C.S)C-outdoor4/DSC03667.JPG,char_data/o/DSC03667.JPG_0.jpg,420,14,213,227,384,414,True,41
o,34,kaist_dataset/Mixed/Digital_Camera/(C.S)C-outdoor4/DSC03667.JPG,char_data/o/DSC03667.JPG_0.jpg,646,19,278,297,381,415,True,41
o,25,kaist_dataset/Mixed/Digital_Camera/(C.S)C-outdoor4/DSC03670.JPG,char_data/o/DSC03670.JPG_0.jpg,325,13,363,376,323,348,True,41
o,37,kaist_dataset/Mixed/Digital_Camera/(C.S)C-outdoor4/DSC03586.JPG,char_data/o/DSC03586.JPG_0.jpg,777,21,260,281,158,195,True,41
o,35,kaist_dataset/Mixed/Digital_Camera/(C.S)C-outdoor4/DSC03586.JPG,char_data/o/DSC03586.JPG_0.jpg,735,21,412,433,162,197,True,41
o,26,kaist_dataset/Mixed/Digital_Camera/(C.S)C-outdoor4/DSC03758.JPG,char_data/o/DSC03758.JPG_0.jpg,416,16,188,204,235,261,True,41
o,27,kaist_dataset/Mixed/Digital_Camera/(C.S)C-outdoor2/DSC02624.JPG,char_data/o/DSC02624.JPG_0.jpg,378,14,129,143,401,428,True,41
o,30,kaist_dataset/Mixed/Digital_Camera/(C.S)C-outdoor2/DSC02624.JPG,char_data/o/DSC02624.JPG_0.jpg,480,16,143,159,401,431,True,41
o,26,kaist_dataset/Mixed/Digital_Camera/(C.S)C-outdoor2/DSC02624.JPG,char_data/o/DSC02624.JPG_0.jpg,442,17,278,295,399,425,True,41
o,50,kaist_dataset/Mixed/Digital_Camera/(C.S)C-outdoor2/DSC02418.JPG,char_data/o/DSC02418.JPG_0.jpg,2600,52,140,192,170,220,True,41
o,56,kaist_dataset/Mixed/Digital_Camera/(C.S)C-outdoor2/DSC02940.JPG,char_data/o/DSC02940.JPG_0.jpg,3248,58,361,419,258,314,True,41
o,45,kaist_dataset/Mixed/Digital_Camera/(C.S)C-outdoor2/DSC02400.JPG,char_data/o/DSC02400.JPG_0.jpg,1485,33,60,93,324,369,True,41
o,29,kaist_dataset/Mixed/Digital_Camera/(C.S)C-outdoor2/DSC02927.JPG,char_data/o/DSC02927.JPG_0.jpg,609,21,234,255,374,403,True,41
o,22,kaist_dataset/Mixed/Digital_Camera/(C.S)C-outdoor2/DSC02483.JPG,char_data/o/DSC02483.JPG_0.jpg,352,16,438,454,151,173,True,41
o,25,kaist_dataset/Mixed/Digital_Camera/(C.S)C-outdoor2/DSC02483.JPG,char_data/o/DSC02483.JPG_0.jpg,425,17,455,472,150,175,True,41
o,35,kaist_dataset/Mixed/Digital_Camera/(C.S)C-outdoor2/DSC02411.JPG,char_data/o/DSC02411.JPG_0.jpg,840,24,96,120,352,387,True,41
o,30,kaist_dataset/Mixed/Digital_Camera/(C.S)C-outdoor2/DSC02411.JPG,char_data/o/DSC02411.JPG_0.jpg,720,24,141,165,355,385,True,41
o,36,kaist_dataset/Mixed/Digital_Camera/(C.S)C-outdoor2/DSC02411.JPG,char_data/o/DSC02411.JPG_0.jpg,900,25,189,214,353,389,True,41
o,38,kaist_dataset/Mixed/Digital_Camera/(C.S)C-outdoor2/DSC02411.JPG,char_data/o/DSC02411.JPG_0.jpg,874,23,237,260,352,390,True,41
o,36,kaist_dataset/Mixed/Digital_Camera/(C.S)C-outdoor2/DSC02411.JPG,char_data/o/DSC02411.JPG_0.jpg,900,25,294,319,352,388,True,41
o,23,kaist_dataset/Mixed/Digital_Camera/(C.S)C-outdoor2/DSC02385.JPG,char_data/o/DSC02385.JPG_0.jpg,345,15,366,381,154,177,True,41
o,22,kaist_dataset/Mixed/Digital_Camera/(C.S)C-outdoor2/DSC02385.JPG,char_data/o/DSC02385.JPG_0.jpg,264,12,426,438,148,170,True,41
o,64,kaist_dataset/Mixed/Digital_Camera/(C.S)C-outdoor2/DSC02436.JPG,char_data/o/DSC02436.JPG_0.jpg,2112,33,365,398,188,252,True,41
o,21,kaist_dataset/Mixed/Digital_Camera/(C.S)C-outdoor2/DSC02439.JPG,char_data/o/DSC02439.JPG_0.jpg,294,14,362,376,113,134,True,41
o,17,kaist_dataset/Mixed/Digital_Camera/(C.S)C-outdoor2/DSC02439.JPG,char_data/o/DSC02439.JPG_0.jpg,323,19,296,315,116,133,True,41
o,55,kaist_dataset/Mixed/Digital_Camera/(C.S)C-outdoor2/DSC02416.JPG,char_data/o/DSC02416.JPG_0.jpg,3685,67,302,369,215,270,True,41
o,117,kaist_dataset/Mixed/Digital_Camera/(C.S)C-outdoor2/DSC02919.JPG,char_data/o/DSC02919.JPG_0.jpg,13572,116,83,199,356,473,True,41
o,23,kaist_dataset/Mixed/Digital_Camera/(C.S)C-outdoor2/DSC02545.JPG,char_data/o/DSC02545.JPG_0.jpg,736,32,128,160,375,398,True,41
o,26,kaist_dataset/Mixed/Digital_Camera/(C.S)C-outdoor2/DSC02545.JPG,char_data/o/DSC02545.JPG_0.jpg,780,30,273,303,372,398,True,41
o,67,kaist_dataset/Mixed/Digital_Camera/(C.S)C-outdoor2/DSC02701.JPG,char_data/o/DSC02701.JPG_0.jpg,3953,59,137,196,101,168,True,41
o,30,kaist_dataset/Mixed/Digital_Camera/(C.S)C-outdoor2/DSC02482.JPG,char_data/o/DSC02482.JPG_0.jpg,690,23,132,155,276,306,True,41
o,28,kaist_dataset/Mixed/Digital_Camera/(C.S)C-outdoor2/DSC02482.JPG,char_data/o/DSC02482.JPG_0.jpg,616,22,197,219,276,304,True,41
o,70,kaist_dataset/Mixed/Digital_Camera/(C.S)C-outdoor2/DSC02425.JPG,char_data/o/DSC02425.JPG_0.jpg,4340,62,507,569,164,234,True,41
o,30,kaist_dataset/Mixed/Digital_Camera/(C.S)C-outdoor2/DSC02936.JPG,char_data/o/DSC02936.JPG_0.jpg,450,15,283,298,87,117,True,41
o,26,kaist_dataset/Mixed/Digital_Camera/(C.S)C-outdoor2/DSC02511.JPG,char_data/o/DSC02511.JPG_0.jpg,546,21,210,231,213,239,True,41
o,81,kaist_dataset/Mixed/Digital_Camera/(C.S)C-outdoor2/DSC02493.JPG,char_data/o/DSC02493.JPG_0.jpg,4941,61,262,323,290,371,True,41
o,42,kaist_dataset/Mixed/Digital_Camera/(C.S)C-outdoor2/DSC02926.JPG,char_data/o/DSC02926.JPG_0.jpg,1218,29,109,138,138,180,True,41
o,38,kaist_dataset/Mixed/Digital_Camera/(C.S)C-outdoor2/DSC02407.JPG,char_data/o/DSC02407.JPG_0.jpg,1178,31,359,390,185,223,True,41
o,47,kaist_dataset/Mixed/Digital_Camera/(C.S)C-outdoor2/DSC02407.JPG,char_data/o/DSC02407.JPG_0.jpg,1598,34,486,520,180,227,True,41
o,34,kaist_dataset/Mixed/Digital_Camera/(C.S)C-outdoor2/DSC02928.JPG,char_data/o/DSC02928.JPG_0.jpg,782,23,385,408,393,427,True,41
o,28,kaist_dataset/Mixed/Digital_Camera/(C.S)C-outdoor2/DSC02560.JPG,char_data/o/DSC02560.JPG_0.jpg,476,17,245,262,301,329,True,41
o,20,kaist_dataset/Mixed/Digital_Camera/(C.S)C-outdoor2/DSC02430.JPG,char_data/o/DSC02430.JPG_0.jpg,220,11,96,107,32,52,True,41
o,34,kaist_dataset/Mixed/Digital_Camera/(C.S)C-outdoor2/DSC02532.JPG,char_data/o/DSC02532.JPG_0.jpg,782,23,426,449,83,117,True,41
o,27,kaist_dataset/Mixed/Digital_Camera/(C.S)A-shadow/DSC02624.JPG,char_data/o/DSC02624.JPG_0.jpg,378,14,129,143,401,428,True,41
o,30,kaist_dataset/Mixed/Digital_Camera/(C.S)A-shadow/DSC02624.JPG,char_data/o/DSC02624.JPG_0.jpg,480,16,143,159,401,431,True,41
o,26,kaist_dataset/Mixed/Digital_Camera/(C.S)A-shadow/DSC02624.JPG,char_data/o/DSC02624.JPG_0.jpg,442,17,278,295,399,425,True,41
o,40,kaist_dataset/Mixed/Digital_Camera/(C.S)A-shadow/DSC02609.JPG,char_data/o/DSC02609.JPG_0.jpg,880,22,343,365,303,343,True,41
o,62,kaist_dataset/English/Mobile_Phone/(E.M)A-outdoor/P090911071.jpg,char_data/o/P090911071.jpg_0.jpg,2976,48,133,181,146,208,True,41
o,65,kaist_dataset/English/Mobile_Phone/(E.M)A-outdoor/P090911071.jpg,char_data/o/P090911071.jpg_0.jpg,3445,53,179,232,145,210,True,41
o,54,kaist_dataset/English/Mobile_Phone/(E.M)A-outdoor/P090911071.jpg,char_data/o/P090911071.jpg_0.jpg,2052,38,334,372,138,192,True,41
o,49,kaist_dataset/English/Mobile_Phone/(E.M)A-outdoor/P090912072.jpg,char_data/o/P090912072.jpg_0.jpg,2107,43,72,115,113,162,True,41
o,120,kaist_dataset/English/Mobile_Phone/(E.M)B-indoor/P090911075.jpg,char_data/o/P090911075.jpg_0.jpg,13800,115,33,148,120,240,True,41
o,73,kaist_dataset/English/Mobile_Phone/(E.M)B-indoor/P090831011.jpg,char_data/o/P090831011.jpg_0.jpg,3723,51,115,166,136,209,True,41
o,60,kaist_dataset/English/Mobile_Phone/(E.M)B-indoor/P090911080.jpg,char_data/o/P090911080.jpg_0.jpg,2460,41,228,269,232,292,True,41
o,52,kaist_dataset/English/Mobile_Phone/(E.M)B-indoor/P090902018.jpg,char_data/o/P090902018.jpg_0.jpg,2496,48,529,577,202,254,True,41
o,78,kaist_dataset/English/Mobile_Phone/(E.M)B-indoor/P090911086.jpg,char_data/o/P090911086.jpg_0.jpg,3822,49,89,138,368,446,True,41
o,79,kaist_dataset/English/Mobile_Phone/(E.M)B-indoor/P090911086.jpg,char_data/o/P090911086.jpg_0.jpg,4424,56,255,311,373,452,True,41
o,86,kaist_dataset/English/Mobile_Phone/(E.M)B-indoor/P090911086.jpg,char_data/o/P090911086.jpg_0.jpg,4644,54,429,483,370,456,True,41
o,56,kaist_dataset/English/Mobile_Phone/(E.M)B-indoor/P090911067.jpg,char_data/o/P090911067.jpg_0.jpg,1456,26,379,405,225,281,True,41
o,53,kaist_dataset/English/Mobile_Phone/(E.M)B-indoor/P090911060.jpg,char_data/o/P090911060.jpg_0.jpg,2014,38,76,114,22,75,True,41
o,42,kaist_dataset/English/Mobile_Phone/(E.M)B-indoor/P090911060.jpg,char_data/o/P090911060.jpg_0.jpg,1260,30,333,363,25,67,True,41
o,59,kaist_dataset/English/Mobile_Phone/(E.M)B-indoor/P090911083.jpg,char_data/o/P090911083.jpg_0.jpg,3245,55,125,180,222,281,True,41
o,64,kaist_dataset/English/Mobile_Phone/(E.M)B-indoor/P090911083.jpg,char_data/o/P090911083.jpg_0.jpg,3712,58,180,238,219,283,True,41
o,61,kaist_dataset/English/Mobile_Phone/(E.M)B-indoor/P090911083.jpg,char_data/o/P090911083.jpg_0.jpg,3294,54,393,447,226,287,True,41
o,82,kaist_dataset/English/Mobile_Phone/(E.M)B-indoor/P090903003.jpg,char_data/o/P090903003.jpg_0.jpg,6232,76,184,260,269,351,True,41
o,51,kaist_dataset/English/Mobile_Phone/(E.M)B-indoor/P090903008.jpg,char_data/o/P090903008.jpg_0.jpg,2244,44,85,129,40,91,True,41
o,69,kaist_dataset/English/Mobile_Phone/(E.M)C-bookCover/P090831039.jpg,char_data/o/P090831039.jpg_0.jpg,4071,59,358,417,128,197,True,41
o,65,kaist_dataset/English/Mobile_Phone/(E.M)C-bookCover/P090831039.jpg,char_data/o/P090831039.jpg_0.jpg,3575,55,231,286,237,302,True,41
o,62,kaist_dataset/English/Mobile_Phone/(E.M)C-bookCover/P090831039.jpg,char_data/o/P090831039.jpg_0.jpg,3720,60,353,413,239,301,True,41
o,71,kaist_dataset/English/Mobile_Phone/(E.M)C-bookCover/P090831039.jpg,char_data/o/P090831039.jpg_0.jpg,4473,63,522,585,125,196,True,41
o,117,kaist_dataset/English/Mobile_Phone/(E.M)C-bookCover/P090831022.jpg,char_data/o/P090831022.jpg_0.jpg,12753,109,148,257,158,275,True,41
o,61,kaist_dataset/English/Digital_Camera/(E.S)E-night/111.jpg,char_data/o/111.jpg_0.jpg,2745,45,328,373,198,259,True,41
o,68,kaist_dataset/English/Digital_Camera/(E.S)E-night/DSC02981.JPG,char_data/o/DSC02981.JPG_0.jpg,2720,40,253,293,380,448,True,41
o,86,kaist_dataset/English/Digital_Camera/(E.S)E-night/DSC02610.JPG,char_data/o/DSC02610.JPG_0.jpg,7998,93,216,309,176,262,True,41
o,49,kaist_dataset/English/Digital_Camera/(E.S)E-night/DSC02610.JPG,char_data/o/DSC02610.JPG_0.jpg,1323,27,228,255,268,317,True,41
o,34,kaist_dataset/English/Digital_Camera/(E.S)E-night/DSC02610.JPG,char_data/o/DSC02610.JPG_0.jpg,1054,31,324,355,274,308,True,41
o,33,kaist_dataset/English/Digital_Camera/(E.S)E-night/DSC02610.JPG,char_data/o/DSC02610.JPG_0.jpg,858,26,426,452,269,302,True,41
o,37,kaist_dataset/English/Digital_Camera/(E.S)C-outdoor2/DSC04079.JPG,char_data/o/DSC04079.JPG_0.jpg,1073,29,142,171,118,155,True,41
o,37,kaist_dataset/English/Digital_Camera/(E.S)C-outdoor2/DSC04079.JPG,char_data/o/DSC04079.JPG_0.jpg,999,27,171,198,118,155,True,41
o,31,kaist_dataset/English/Digital_Camera/(E.S)C-outdoor2/DSC04079.JPG,char_data/o/DSC04079.JPG_0.jpg,713,23,258,281,122,153,True,41
o,33,kaist_dataset/English/Digital_Camera/(E.S)C-outdoor2/DSC04079.JPG,char_data/o/DSC04079.JPG_0.jpg,759,23,342,365,123,156,True,41
o,29,kaist_dataset/English/Digital_Camera/(E.S)C-outdoor2/DSC04079.JPG,char_data/o/DSC04079.JPG_0.jpg,754,26,124,150,165,194,True,41
o,50,kaist_dataset/English/Digital_Camera/(E.S)C-outdoor2/DSC04066.JPG,char_data/o/DSC04066.JPG_0.jpg,1750,35,403,438,343,393,True,41
o,58,kaist_dataset/English/Digital_Camera/(E.S)C-outdoor2/DSC04066.JPG,char_data/o/DSC04066.JPG_0.jpg,2030,35,438,473,336,394,True,41
o,57,kaist_dataset/English/Digital_Camera/(E.S)C-outdoor2/DSC04052.JPG,char_data/o/DSC04052.JPG_0.jpg,2223,39,305,344,172,229,True,41
o,33,kaist_dataset/English/Digital_Camera/(E.S)C-outdoor2/DSC04052.JPG,char_data/o/DSC04052.JPG_0.jpg,825,25,515,540,190,223,True,41
o,74,kaist_dataset/English/Digital_Camera/(E.S)C-outdoor2/DSC02990.JPG,char_data/o/DSC02990.JPG_0.jpg,5254,71,194,265,169,243,True,41
o,41,kaist_dataset/English/Digital_Camera/(E.S)C-outdoor2/DSC03169.JPG,char_data/o/DSC03169.JPG_0.jpg,1394,34,366,400,299,340,True,41
o,54,kaist_dataset/English/Digital_Camera/(E.S)C-outdoor2/DSC03290.JPG,char_data/o/DSC03290.JPG_0.jpg,1890,35,211,246,98,152,True,41
o,43,kaist_dataset/English/Digital_Camera/(E.S)C-outdoor2/DSC03290.JPG,char_data/o/DSC03290.JPG_0.jpg,1333,31,216,247,311,354,True,41
o,41,kaist_dataset/English/Digital_Camera/(E.S)C-outdoor2/DSC03865.JPG,char_data/o/DSC03865.JPG_0.jpg,1066,26,50,76,55,96,True,41
o,43,kaist_dataset/English/Digital_Camera/(E.S)C-outdoor2/DSC03167.JPG,char_data/o/DSC03167.JPG_0.jpg,1591,37,302,339,302,345,True,41
o,45,kaist_dataset/English/Digital_Camera/(E.S)C-outdoor2/DSC03294.JPG,char_data/o/DSC03294.JPG_0.jpg,1305,29,513,542,310,355,True,41
o,47,kaist_dataset/English/Digital_Camera/(E.S)C-outdoor2/DSC03001.JPG,char_data/o/DSC03001.JPG_0.jpg,1551,33,79,112,201,248,True,41
o,48,kaist_dataset/English/Digital_Camera/(E.S)C-outdoor2/DSC03001.JPG,char_data/o/DSC03001.JPG_0.jpg,1776,37,459,496,190,238,True,41
o,53,kaist_dataset/English/Digital_Camera/(E.S)C-outdoor2/DSC03201.JPG,char_data/o/DSC03201.JPG_0.jpg,1484,28,331,359,83,136,True,41
o,46,kaist_dataset/English/Digital_Camera/(E.S)C-outdoor2/DSC03201.JPG,char_data/o/DSC03201.JPG_0.jpg,1564,34,233,267,140,186,True,41
o,100,kaist_dataset/English/Digital_Camera/(E.S)C-outdoor2/DSC03786.JPG,char_data/o/DSC03786.JPG_0.jpg,10300,103,197,300,332,432,True,41
o,100,kaist_dataset/English/Digital_Camera/(E.S)C-outdoor2/P1010060.JPG,char_data/o/P1010060.JPG_0.jpg,10400,104,237,341,137,237,True,41
o,44,kaist_dataset/English/Digital_Camera/(E.S)C-outdoor2/DSC04064.JPG,char_data/o/DSC04064.JPG_0.jpg,1364,31,98,129,130,174,True,41
o,44,kaist_dataset/English/Digital_Camera/(E.S)C-outdoor2/DSC04064.JPG,char_data/o/DSC04064.JPG_0.jpg,1232,28,130,158,133,177,True,41
o,41,kaist_dataset/English/Digital_Camera/(E.S)C-outdoor2/DSC03262.JPG,char_data/o/DSC03262.JPG_0.jpg,1189,29,282,311,149,190,True,41
o,50,kaist_dataset/English/Digital_Camera/(E.S)C-outdoor2/DSC03297.JPG,char_data/o/DSC03297.JPG_0.jpg,1650,33,588,621,254,304,True,41
o,34,kaist_dataset/English/Digital_Camera/(E.S)C-outdoor2/DSC03168.JPG,char_data/o/DSC03168.JPG_0.jpg,1258,37,267,304,307,341,True,41
o,42,kaist_dataset/English/Digital_Camera/(E.S)C-outdoor2/DSC03168.JPG,char_data/o/DSC03168.JPG_0.jpg,1596,38,377,415,307,349,True,41
o,38,kaist_dataset/English/Digital_Camera/(E.S)C-outdoor2/DSC03225.JPG,char_data/o/DSC03225.JPG_0.jpg,836,22,483,505,86,124,True,41
o,36,kaist_dataset/English/Digital_Camera/(E.S)C-outdoor2/DSC03160.JPG,char_data/o/DSC03160.JPG_0.jpg,792,22,298,320,155,191,True,41
o,41,kaist_dataset/English/Digital_Camera/(E.S)C-outdoor2/DSC03160.JPG,char_data/o/DSC03160.JPG_0.jpg,984,24,502,526,144,185,True,41
o,30,kaist_dataset/English/Digital_Camera/(E.S)C-outdoor2/DSC03162.JPG,char_data/o/DSC03162.JPG_0.jpg,630,21,295,316,151,181,True,41
o,50,kaist_dataset/English/Digital_Camera/(E.S)C-outdoor2/DSC03440.JPG,char_data/o/DSC03440.JPG_0.jpg,1850,37,163,200,29,79,True,41
o,43,kaist_dataset/English/Digital_Camera/(E.S)C-outdoor2/DSC03440.JPG,char_data/o/DSC03440.JPG_0.jpg,1161,27,387,414,33,76,True,41
o,84,kaist_dataset/English/Digital_Camera/(E.S)C-outdoor2/DSC03408.JPG,char_data/o/DSC03408.JPG_0.jpg,4788,57,479,536,343,427,True,41
o,50,kaist_dataset/English/Digital_Camera/(E.S)C-outdoor2/DSC04047.JPG,char_data/o/DSC04047.JPG_0.jpg,2400,48,398,446,238,288,True,41
o,43,kaist_dataset/English/Digital_Camera/(E.S)C-outdoor2/DSC03170.JPG,char_data/o/DSC03170.JPG_0.jpg,1892,44,448,492,317,360,True,41
o,31,kaist_dataset/English/Digital_Camera/(E.S)C-outdoor2/DSC04437.JPG,char_data/o/DSC04437.JPG_0.jpg,372,12,245,257,42,73,True,41
o,25,kaist_dataset/English/Digital_Camera/(E.S)C-outdoor2/DSC04437.JPG,char_data/o/DSC04437.JPG_0.jpg,375,15,254,269,45,70,True,41
o,24,kaist_dataset/English/Digital_Camera/(E.S)C-outdoor2/DSC04437.JPG,char_data/o/DSC04437.JPG_0.jpg,288,12,295,307,50,74,True,41
o,28,kaist_dataset/English/Digital_Camera/(E.S)C-outdoor2/DSC04437.JPG,char_data/o/DSC04437.JPG_0.jpg,308,11,334,345,46,74,True,41
o,23,kaist_dataset/English/Digital_Camera/(E.S)C-outdoor2/DSC04437.JPG,char_data/o/DSC04437.JPG_0.jpg,322,14,232,246,80,103,True,41
o,38,kaist_dataset/English/Digital_Camera/(E.S)C-outdoor2/DSC03165.JPG,char_data/o/DSC03165.JPG_0.jpg,1330,35,242,277,245,283,True,41
o,35,kaist_dataset/English/Digital_Camera/(E.S)C-outdoor2/DSC03165.JPG,char_data/o/DSC03165.JPG_0.jpg,1155,33,351,384,246,281,True,41
o,30,kaist_dataset/English/Digital_Camera/(E.S)C-outdoor1/077.JPG,char_data/o/077.JPG_0.jpg,1140,38,198,236,216,246,True,41
o,69,kaist_dataset/English/Digital_Camera/(E.S)C-outdoor1/DSC02524.JPG,char_data/o/DSC02524.JPG_0.jpg,3519,51,407,458,326,395,True,41
o,28,kaist_dataset/English/Digital_Camera/(E.S)C-outdoor1/DSC02356.JPG,char_data/o/DSC02356.JPG_0.jpg,700,25,396,421,315,343,True,41
o,25,kaist_dataset/English/Digital_Camera/(E.S)C-outdoor1/DSC02427.JPG,char_data/o/DSC02427.JPG_0.jpg,575,23,440,463,373,398,True,41
o,32,kaist_dataset/English/Digital_Camera/(E.S)C-outdoor1/DSC02427.JPG,char_data/o/DSC02427.JPG_0.jpg,768,24,537,561,372,404,True,41
o,46,kaist_dataset/English/Digital_Camera/(E.S)C-outdoor1/DSC02442.JPG,char_data/o/DSC02442.JPG_0.jpg,1840,40,352,392,175,221,True,41
o,24,kaist_dataset/English/Digital_Camera/(E.S)C-outdoor1/DSC02387.JPG,char_data/o/DSC02387.JPG_0.jpg,480,20,453,473,300,324,True,41
o,38,kaist_dataset/English/Digital_Camera/(E.S)C-outdoor1/137.JPG,char_data/o/137.JPG_0.jpg,722,19,340,359,262,300,True,41
o,37,kaist_dataset/English/Digital_Camera/(E.S)C-outdoor1/137.JPG,char_data/o/137.JPG_0.jpg,703,19,360,379,262,299,True,41
o,16,kaist_dataset/English/Digital_Camera/(E.S)C-outdoor1/056.JPG,char_data/o/056.JPG_0.jpg,128,8,276,284,245,261,True,41
o,17,kaist_dataset/English/Digital_Camera/(E.S)C-outdoor1/056.JPG,char_data/o/056.JPG_0.jpg,153,9,315,324,244,261,True,41
o,62,kaist_dataset/English/Digital_Camera/(E.S)C-outdoor1/056.JPG,char_data/o/056.JPG_0.jpg,3348,54,365,419,177,239,True,41
o,10,kaist_dataset/English/Digital_Camera/(E.S)C-outdoor1/7.jpg,char_data/o/7.jpg_0.jpg,110,11,160,171,108,118,True,41
o,12,kaist_dataset/English/Digital_Camera/(E.S)C-outdoor1/7.jpg,char_data/o/7.jpg_0.jpg,144,12,171,183,109,121,True,41
o,68,kaist_dataset/English/Digital_Camera/(E.S)C-outdoor1/7.jpg,char_data/o/7.jpg_0.jpg,4148,61,449,510,267,335,True,41
o,114,kaist_dataset/English/Digital_Camera/(E.S)C-outdoor1/DSC02415.JPG,char_data/o/DSC02415.JPG_0.jpg,10260,90,419,509,76,190,True,41
o,44,kaist_dataset/English/Digital_Camera/(E.S)C-outdoor1/DSC02355.JPG,char_data/o/DSC02355.JPG_0.jpg,924,21,140,161,300,344,True,41
o,30,kaist_dataset/English/Digital_Camera/(E.S)C-outdoor1/033.jpg,char_data/o/033.jpg_0.jpg,780,26,145,171,120,150,True,41
o,51,kaist_dataset/English/Digital_Camera/(E.S)C-outdoor1/109.jpg,char_data/o/109.jpg_0.jpg,2193,43,315,358,239,290,True,41
o,30,kaist_dataset/English/Digital_Camera/(E.S)C-outdoor1/DSC02559.JPG,char_data/o/DSC02559.JPG_0.jpg,780,26,169,195,129,159,True,41
o,123,kaist_dataset/English/Digital_Camera/(E.S)C-outdoor1/2007-12-08-day-015.jpg,char_data/o/2007-12-08-day-015.jpg_0.jpg,21156,172,659,831,511,634,True,41
o,37,kaist_dataset/English/Digital_Camera/(E.S)C-outdoor1/2007-12-08-day-015.jpg,char_data/o/2007-12-08-day-015.jpg_0.jpg,925,25,741,766,819,856,True,41
o,33,kaist_dataset/English/Digital_Camera/(E.S)C-outdoor1/2007-12-08-day-015.jpg,char_data/o/2007-12-08-day-015.jpg_0.jpg,1023,31,943,974,827,860,True,41
o,58,kaist_dataset/English/Digital_Camera/(E.S)C-outdoor1/107.jpg,char_data/o/107.jpg_0.jpg,3016,52,210,262,268,326,True,41
o,52,kaist_dataset/English/Digital_Camera/(E.S)C-outdoor1/107.jpg,char_data/o/107.jpg_0.jpg,2808,54,262,316,270,322,True,41
o,31,kaist_dataset/English/Digital_Camera/(E.S)C-outdoor1/2007-12-09-day-exterior-063.jpg,char_data/o/2007-12-09-day-exterior-063.jpg_0.jpg,713,23,52,75,536,567,True,41
o,28,kaist_dataset/English/Digital_Camera/(E.S)C-outdoor1/2007-12-09-day-exterior-063.jpg,char_data/o/2007-12-09-day-exterior-063.jpg_0.jpg,588,21,169,190,550,578,True,41
o,49,kaist_dataset/English/Digital_Camera/(E.S)C-outdoor1/138.JPG,char_data/o/138.JPG_0.jpg,1519,31,221,252,256,305,True,41
o,39,kaist_dataset/English/Digital_Camera/(E.S)C-outdoor1/138.JPG,char_data/o/138.JPG_0.jpg,1365,35,377,412,268,307,True,41
o,65,kaist_dataset/English/Digital_Camera/(E.S)C-outdoor1/080116-0064.jpg,char_data/o/080116-0064.jpg_0.jpg,2405,37,463,500,248,313,True,41
o,42,kaist_dataset/English/Digital_Camera/(E.S)C-outdoor1/080116-0066.jpg,char_data/o/080116-0066.jpg_0.jpg,1344,32,319,351,353,395,True,41
o,38,kaist_dataset/English/Digital_Camera/(E.S)C-outdoor1/080116-0066.jpg,char_data/o/080116-0066.jpg_0.jpg,1482,39,549,588,358,396,True,41
o,80,kaist_dataset/English/Digital_Camera/(E.S)C-outdoor1/129.JPG,char_data/o/129.JPG_0.jpg,3680,46,506,552,215,295,True,41
o,42,kaist_dataset/English/Digital_Camera/(E.S)C-outdoor1/055.JPG,char_data/o/055.JPG_0.jpg,1386,33,30,63,205,247,True,41
o,133,kaist_dataset/English/Digital_Camera/(E.S)C-outdoor1/2007-12-08-day-098.jpg,char_data/o/2007-12-08-day-098.jpg_0.jpg,13832,104,1053,1157,521,654,True,41
o,29,kaist_dataset/English/Digital_Camera/(E.S)C-outdoor1/DSC02918.JPG,char_data/o/DSC02918.JPG_0.jpg,783,27,284,311,238,267,True,41
o,31,kaist_dataset/English/Digital_Camera/(E.S)C-outdoor1/DSC02918.JPG,char_data/o/DSC02918.JPG_0.jpg,775,25,324,349,236,267,False,41
o,73,kaist_dataset/English/Digital_Camera/(E.S)C-outdoor1/104.jpg,char_data/o/104.jpg_0.jpg,4891,67,486,553,121,194,False,41
o,33,kaist_dataset/English/Digital_Camera/(E.S)B-light/크기변환_%B0%A3%C6%C74_fabdent.jpg,char_data/o/크기변환_%B0%A3%C6%C74_fabdent.jpg_0.jpg,396,12,208,220,257,290,False,41
o,86,kaist_dataset/English/Digital_Camera/(E.S)B-light/DSC02587.JPG,char_data/o/DSC02587.JPG_0.jpg,5246,61,242,303,335,421,False,41
o,47,kaist_dataset/English/Digital_Camera/(E.S)F-others/080119-0007.jpg,char_data/o/080119-0007.jpg_0.jpg,1927,41,793,834,837,884,False,41
o,51,kaist_dataset/English/Digital_Camera/(E.S)F-others/080119-0007.jpg,char_data/o/080119-0007.jpg_0.jpg,1989,39,974,1013,796,847,False,41
o,33,kaist_dataset/English/Digital_Camera/(E.S)F-others/080119-0007.jpg,char_data/o/080119-0007.jpg_0.jpg,660,20,798,818,910,943,False,41
o,87,kaist_dataset/English/Digital_Camera/(E.S)F-others/크기변환_%B0%A3%C6%C72_ktimt007.jpg,char_data/o/크기변환_%B0%A3%C6%C72_ktimt007.jpg_0.jpg,4176,48,135,183,242,329,False,41
o,74,kaist_dataset/English/Digital_Camera/(E.S)F-others/DSC02925.JPG,char_data/o/DSC02925.JPG_0.jpg,5402,73,238,311,264,338,False,41
o,28,kaist_dataset/English/Digital_Camera/(E.S)F-others/DSC03218.JPG,char_data/o/DSC03218.JPG_0.jpg,840,30,343,373,328,356,False,41
o,42,kaist_dataset/English/Digital_Camera/(E.S)A-shadow/DSC03075.JPG,char_data/o/DSC03075.JPG_0.jpg,1008,24,175,199,357,399,False,41
o,40,kaist_dataset/English/Digital_Camera/(E.S)A-shadow/DSC03075.JPG,char_data/o/DSC03075.JPG_0.jpg,1080,27,211,238,360,400,False,41
o,36,kaist_dataset/English/Digital_Camera/(E.S)A-shadow/DSC03082.JPG,char_data/o/DSC03082.JPG_0.jpg,792,22,188,210,385,421,False,41
o,74,kaist_dataset/English/Digital_Camera/(E.S)A-shadow/DSC02858.JPG,char_data/o/DSC02858.JPG_0.jpg,4144,56,229,285,318,392,False,41
o,66,kaist_dataset/English/Digital_Camera/(E.S)A-shadow/DSC02857.JPG,char_data/o/DSC02857.JPG_0.jpg,2970,45,283,328,212,278,False,41
o,40,kaist_dataset/English/Digital_Camera/(E.S)A-shadow/DSC03081.JPG,char_data/o/DSC03081.JPG_0.jpg,1000,25,329,354,415,455,False,41
o,50,kaist_dataset/English/Digital_Camera/(E.S)A-shadow/P090912074.jpg,char_data/o/P090912074.jpg_0.jpg,1100,22,549,571,82,132,False,41
o,53,kaist_dataset/English/Digital_Camera/(E.S)A-shadow/DSC03084.JPG,char_data/o/DSC03084.JPG_0.jpg,1166,22,216,238,371,424,False,41
o,51,kaist_dataset/English/Digital_Camera/(E.S)A-shadow/DSC03079.JPG,char_data/o/DSC03079.JPG_0.jpg,1275,25,327,352,334,385,False,41
o,54,kaist_dataset/English/Digital_Camera/(E.S)A-shadow/DSC03079.JPG,char_data/o/DSC03079.JPG_0.jpg,1404,26,365,391,332,386,False,41
o,58,kaist_dataset/English/Digital_Camera/(E.S)A-shadow/IMG_2647.JPG,char_data/o/IMG_2647.JPG_0.jpg,2958,51,361,412,262,320,False,41
o,56,kaist_dataset/English/Digital_Camera/(E.S)D-indoor/DSC03093.JPG,char_data/o/DSC03093.JPG_0.jpg,2632,47,369,416,133,189,False,41
o,34,kaist_dataset/English/Digital_Camera/(E.S)D-indoor/DSC03144.JPG,char_data/o/DSC03144.JPG_0.jpg,714,21,305,326,240,274,False,41
o,29,kaist_dataset/English/Digital_Camera/(E.S)D-indoor/DSC03144.JPG,char_data/o/DSC03144.JPG_0.jpg,667,23,483,506,244,273,False,41
o,33,kaist_dataset/English/Digital_Camera/(E.S)D-indoor/DSC03144.JPG,char_data/o/DSC03144.JPG_0.jpg,693,21,301,322,292,325,False,41
o,25,kaist_dataset/English/Digital_Camera/(E.S)D-indoor/DSC03144.JPG,char_data/o/DSC03144.JPG_0.jpg,500,20,490,510,295,320,False,41
o,59,kaist_dataset/English/Digital_Camera/(E.S)D-indoor/DSC03136.JPG,char_data/o/DSC03136.JPG_0.jpg,1829,31,152,183,258,317,False,41
o,56,kaist_dataset/English/Digital_Camera/(E.S)D-indoor/DSC03136.JPG,char_data/o/DSC03136.JPG_0.jpg,1792,32,182,214,260,316,False,41
o,57,kaist_dataset/English/Digital_Camera/(E.S)D-indoor/DSC03136.JPG,char_data/o/DSC03136.JPG_0.jpg,1881,33,294,327,261,318,False,41
o,53,kaist_dataset/English/Digital_Camera/(E.S)D-indoor/DSC03136.JPG,char_data/o/DSC03136.JPG_0.jpg,1537,29,418,447,265,318,False,41
o,45,kaist_dataset/English/Digital_Camera/(E.S)D-indoor/DSC03150.JPG,char_data/o/DSC03150.JPG_0.jpg,1755,39,81,120,39,84,False,41
o,56,kaist_dataset/English/Digital_Camera/(E.S)D-indoor/DSC03150.JPG,char_data/o/DSC03150.JPG_0.jpg,2240,40,327,367,26,82,False,41
o,40,kaist_dataset/English/Digital_Camera/(E.S)D-indoor/DSC03083.JPG,char_data/o/DSC03083.JPG_0.jpg,1160,29,210,239,406,446,False,41
o,39,kaist_dataset/English/Digital_Camera/(E.S)D-indoor/DSC03146.JPG,char_data/o/DSC03146.JPG_0.jpg,936,24,375,399,233,272,False,41
o,37,kaist_dataset/English/Digital_Camera/(E.S)D-indoor/DSC03146.JPG,char_data/o/DSC03146.JPG_0.jpg,888,24,528,552,238,275,False,41
o,30,kaist_dataset/English/Digital_Camera/(E.S)D-indoor/DSC03146.JPG,char_data/o/DSC03146.JPG_0.jpg,690,23,438,461,183,213,False,41
o,32,kaist_dataset/English/Digital_Camera/(E.S)D-indoor/DSC03146.JPG,char_data/o/DSC03146.JPG_0.jpg,800,25,531,556,186,218,False,41
o,38,kaist_dataset/English/Digital_Camera/(E.S)D-indoor/DSC03090.JPG,char_data/o/DSC03090.JPG_0.jpg,912,24,130,154,244,282,False,41
o,38,kaist_dataset/English/Digital_Camera/(E.S)D-indoor/DSC03090.JPG,char_data/o/DSC03090.JPG_0.jpg,836,22,181,203,246,284,False,41
o,36,kaist_dataset/English/Digital_Camera/(E.S)D-indoor/DSC03090.JPG,char_data/o/DSC03090.JPG_0.jpg,792,22,351,373,244,280,False,41
o,34,kaist_dataset/English/Digital_Camera/(E.S)D-indoor/DSC03090.JPG,char_data/o/DSC03090.JPG_0.jpg,748,22,460,482,246,280,False,41
o,32,kaist_dataset/English/Digital_Camera/(E.S)D-indoor/DSC03090.JPG,char_data/o/DSC03090.JPG_0.jpg,832,26,480,506,247,279,False,41
o,34,kaist_dataset/English/Digital_Camera/(E.S)D-indoor/DSC03090.JPG,char_data/o/DSC03090.JPG_0.jpg,578,17,253,270,297,331,False,41
o,36,kaist_dataset/English/Digital_Camera/(E.S)D-indoor/DSC03090.JPG,char_data/o/DSC03090.JPG_0.jpg,576,16,270,286,297,333,False,41
o,45,kaist_dataset/English/Digital_Camera/(E.S)D-indoor/DSC03090.JPG,char_data/o/DSC03090.JPG_0.jpg,765,17,394,411,291,336,False,41
o,36,kaist_dataset/English/Digital_Camera/(E.S)D-indoor/DSC03090.JPG,char_data/o/DSC03090.JPG_0.jpg,648,18,461,479,296,332,False,41
o,40,kaist_dataset/English/Digital_Camera/(E.S)D-indoor/DSC03090.JPG,char_data/o/DSC03090.JPG_0.jpg,760,19,476,495,295,335,False,41
o,67,kaist_dataset/English/Digital_Camera/(E.S)D-indoor/DSC03080.JPG,char_data/o/DSC03080.JPG_0.jpg,3417,51,242,293,371,438,False,41
o,69,kaist_dataset/English/Digital_Camera/(E.S)D-indoor/DSC03080.JPG,char_data/o/DSC03080.JPG_0.jpg,3588,52,336,388,367,436,False,41
o,37,kaist_dataset/English/Digital_Camera/(E.S)D-indoor/크기변환_%B0%A3%C6%C76_fabdent.jpg,char_data/o/크기변환_%B0%A3%C6%C76_fabdent.jpg_0.jpg,777,21,280,301,193,230,False,41
o,40,kaist_dataset/English/Digital_Camera/(E.S)D-indoor/DSC03149.JPG,char_data/o/DSC03149.JPG_0.jpg,1480,37,261,298,392,432,False,41
o,38,kaist_dataset/English/Digital_Camera/(E.S)D-indoor/DSC03149.JPG,char_data/o/DSC03149.JPG_0.jpg,1140,30,297,327,394,432,False,41
o,34,kaist_dataset/English/Digital_Camera/(E.S)D-indoor/DSC03149.JPG,char_data/o/DSC03149.JPG_0.jpg,1020,30,376,406,400,434,False,41
o,40,kaist_dataset/English/Digital_Camera/(E.S)D-indoor/DSC03149.JPG,char_data/o/DSC03149.JPG_0.jpg,1280,32,477,509,399,439,False,41
o,72,kaist_dataset/English/Digital_Camera/(E.S)D-indoor/DSC02842.JPG,char_data/o/DSC02842.JPG_0.jpg,4824,67,233,300,78,150,False,41
o,79,kaist_dataset/English/Digital_Camera/(E.S)D-indoor/DSC02842.JPG,char_data/o/DSC02842.JPG_0.jpg,5451,69,446,515,90,169,False,41
o,32,kaist_dataset/English/Digital_Camera/(E.S)D-indoor/DSC03147.JPG,char_data/o/DSC03147.JPG_0.jpg,736,23,209,232,301,333,False,41
o,27,kaist_dataset/English/Digital_Camera/(E.S)D-indoor/DSC03147.JPG,char_data/o/DSC03147.JPG_0.jpg,567,21,508,529,302,329,False,41
o,27,kaist_dataset/English/Digital_Camera/(E.S)D-indoor/DSC03147.JPG,char_data/o/DSC03147.JPG_0.jpg,621,23,214,237,245,272,False,41
o,36,kaist_dataset/English/Digital_Camera/(E.S)D-indoor/DSC03147.JPG,char_data/o/DSC03147.JPG_0.jpg,792,22,505,527,241,277,False,41
o,47,kaist_dataset/English/Digital_Camera/(E.S)D-indoor/DSC02859.JPG,char_data/o/DSC02859.JPG_0.jpg,1692,36,401,437,348,395,False,41
o,29,kaist_dataset/English/Digital_Camera/(E.S)D-indoor/DSC03142.JPG,char_data/o/DSC03142.JPG_0.jpg,696,24,350,374,434,463,False,41
o,30,kaist_dataset/English/Digital_Camera/(E.S)D-indoor/DSC03142.JPG,char_data/o/DSC03142.JPG_0.jpg,780,26,233,259,369,399,False,41
o,52,kaist_dataset/English/Digital_Camera/(E.S)D-indoor/DSC04023.JPG,char_data/o/DSC04023.JPG_0.jpg,1976,38,431,469,252,304,False,41
o,31,kaist_dataset/English/Digital_Camera/(E.S)D-indoor/DSC04023.JPG,char_data/o/DSC04023.JPG_0.jpg,651,21,415,436,324,355,False,41
o,54,kaist_dataset/English/Digital_Camera/(E.S)D-indoor/DSC03074.JPG,char_data/o/DSC03074.JPG_0.jpg,1188,22,142,164,268,322,False,41
o,54,kaist_dataset/English/Digital_Camera/(E.S)D-indoor/DSC03074.JPG,char_data/o/DSC03074.JPG_0.jpg,1242,23,184,207,266,320,False,41
o,43,kaist_dataset/English/Digital_Camera/(E.S)D-indoor/DSC02719.JPG,char_data/o/DSC02719.JPG_0.jpg,1634,38,165,203,299,342,False,41
o,51,kaist_dataset/English/Digital_Camera/(E.S)D-indoor/DSC02719.JPG,char_data/o/DSC02719.JPG_0.jpg,1989,39,302,341,294,345,False,41
o,61,kaist_dataset/English/Digital_Camera/(E.S)D-indoor/DSC03085.JPG,char_data/o/DSC03085.JPG_0.jpg,2074,34,431,465,378,439,False,41
o,53,kaist_dataset/English/Digital_Camera/(E.S)D-indoor/DSC03091.JPG,char_data/o/DSC03091.JPG_0.jpg,2809,53,489,542,132,185,False,41
o,63,kaist_dataset/English/Digital_Camera/(E.S)D-indoor/DSC03395.JPG,char_data/o/DSC03395.JPG_0.jpg,2646,42,195,237,408,471,False,41
o,37,kaist_dataset/English/Digital_Camera/(E.S)D-indoor/DSC03947.JPG,char_data/o/DSC03947.JPG_0.jpg,1221,33,369,402,282,319,False,41
o,33,kaist_dataset/English/Digital_Camera/(E.S)D-indoor/DSC03947.JPG,char_data/o/DSC03947.JPG_0.jpg,1089,33,321,354,426,459,False,41
o,40,kaist_dataset/English/Digital_Camera/(E.S)D-indoor/DSC03947.JPG,char_data/o/DSC03947.JPG_0.jpg,1160,29,435,464,425,465,False,41
o,49,kaist_dataset/English/Digital_Camera/(E.S)D-indoor/DSC03936.JPG,char_data/o/DSC03936.JPG_0.jpg,1715,35,272,307,89,138,False,41
o,50,kaist_dataset/English/Digital_Camera/(E.S)D-indoor/DSC03936.JPG,char_data/o/DSC03936.JPG_0.jpg,1150,23,540,563,90,140,False,41
o,37,kaist_dataset/English/Digital_Camera/(E.S)D-indoor/DSC03145.JPG,char_data/o/DSC03145.JPG_0.jpg,777,21,196,217,179,216,False,41
o,25,kaist_dataset/English/Digital_Camera/(E.S)D-indoor/DSC03145.JPG,char_data/o/DSC03145.JPG_0.jpg,550,22,383,405,185,210,False,41
o,34,kaist_dataset/English/Digital_Camera/(E.S)D-indoor/DSC03145.JPG,char_data/o/DSC03145.JPG_0.jpg,680,20,203,223,125,159,False,41
o,28,kaist_dataset/English/Digital_Camera/(E.S)D-indoor/DSC03145.JPG,char_data/o/DSC03145.JPG_0.jpg,616,22,378,400,130,158,False,41
o,52,kaist_dataset/English/Digital_Camera/(E.S)D-indoor/DSC03087.JPG,char_data/o/DSC03087.JPG_0.jpg,2184,42,343,385,375,427,False,41
o,54,kaist_dataset/English/Digital_Camera/(E.S)D-indoor/DSC03087.JPG,char_data/o/DSC03087.JPG_0.jpg,2106,39,410,449,375,429,False,41
o,42,kaist_dataset/English/Digital_Camera/(E.S)D-indoor/DSC03151.JPG,char_data/o/DSC03151.JPG_0.jpg,1344,32,119,151,114,156,False,41
o,44,kaist_dataset/English/Digital_Camera/(E.S)D-indoor/DSC03078.JPG,char_data/o/DSC03078.JPG_0.jpg,1364,31,167,198,238,282,False,41
o,42,kaist_dataset/English/Digital_Camera/(E.S)D-indoor/DSC03078.JPG,char_data/o/DSC03078.JPG_0.jpg,1302,31,233,264,240,282,False,41
o,50,kaist_dataset/English/Digital_Camera/(E.S)D-indoor/DSC03078.JPG,char_data/o/DSC03078.JPG_0.jpg,1550,31,501,532,237,287,False,41
o,44,kaist_dataset/English/Digital_Camera/(E.S)D-indoor/DSC03078.JPG,char_data/o/DSC03078.JPG_0.jpg,1452,33,413,446,314,358,False,41
o,33,kaist_dataset/English/Digital_Camera/(E.S)D-indoor/080119-0009.jpg,char_data/o/080119-0009.jpg_0.jpg,495,15,616,631,1028,1061,False,41
o,34,kaist_dataset/English/Digital_Camera/(E.S)D-indoor/080119-0009.jpg,char_data/o/080119-0009.jpg_0.jpg,646,19,711,730,1057,1091,False,41
o,33,kaist_dataset/English/Digital_Camera/(E.S)D-indoor/080119-0009.jpg,char_data/o/080119-0009.jpg_0.jpg,561,17,753,770,1069,1102,False,41
o,41,kaist_dataset/English/Digital_Camera/(E.S)D-indoor/080119-0009.jpg,char_data/o/080119-0009.jpg_0.jpg,574,14,617,631,1067,1108,False,41
o,36,kaist_dataset/English/Digital_Camera/(E.S)D-indoor/080119-0009.jpg,char_data/o/080119-0009.jpg_0.jpg,756,21,762,783,1000,1036,False,41
o,28,kaist_dataset/English/Digital_Camera/(E.S)D-indoor/DSC03532.JPG,char_data/o/DSC03532.JPG_0.jpg,560,20,59,79,377,405,False,41
o,23,kaist_dataset/English/Digital_Camera/(E.S)D-indoor/DSC03532.JPG,char_data/o/DSC03532.JPG_0.jpg,414,18,154,172,386,409,False,41
o,46,kaist_dataset/English/Digital_Camera/(E.S)D-indoor/DSC03112.JPG,char_data/o/DSC03112.JPG_0.jpg,1886,41,284,325,265,311,False,41
o,47,kaist_dataset/English/Digital_Camera/(E.S)D-indoor/DSC03112.JPG,char_data/o/DSC03112.JPG_0.jpg,1786,38,325,363,265,312,False,41
o,62,kaist_dataset/English/Digital_Camera/(E.S)C-outdoor3/P1010064.JPG,char_data/o/P1010064.JPG_0.jpg,3038,49,549,598,335,397,False,41
o,18,kaist_dataset/English/Digital_Camera/(E.S)C-outdoor3/크기변환_P1010076.JPG,char_data/o/크기변환_P1010076.JPG_0.jpg,198,11,304,315,103,121,False,41
o,30,kaist_dataset/English/Digital_Camera/(E.S)C-outdoor3/크기변환_%B0%A3%C6%C71_m_starfirm.jpg,char_data/o/크기변환_%B0%A3%C6%C71_m_starfirm.jpg_0.jpg,1020,34,159,193,285,315,False,41
o,27,kaist_dataset/English/Digital_Camera/(E.S)C-outdoor3/크기변환_%B0%A3%C6%C71_m_starfirm.jpg,char_data/o/크기변환_%B0%A3%C6%C71_m_starfirm.jpg_0.jpg,864,32,193,225,287,314,False,41
o,32,kaist_dataset/English/Digital_Camera/(E.S)C-outdoor3/크기변환_%B0%A3%C6%C71_m_starfirm.jpg,char_data/o/크기변환_%B0%A3%C6%C71_m_starfirm.jpg_0.jpg,832,26,468,494,285,317,False,41
5,27,"kaist_dataset/Korean/Mobile_Phone/(M,K)C-outdoor/P090912042.jpg",char_data/5/P090912042.jpg_2.jpg,351,13,381,394,256,283,True,7
5,57,"kaist_dataset/Korean/Mobile_Phone/(M,K)C-outdoor/P090912033.jpg",char_data/5/P090912033.jpg_2.jpg,1767,31,285,316,349,406,True,7
5,43,"kaist_dataset/Korean/Mobile_Phone/(M,K)C-outdoor/P090912034.jpg",char_data/5/P090912034.jpg_2.jpg,1333,31,150,181,262,305,True,7
5,136,kaist_dataset/Korean/Digital_Camera/F-bookCover/DSC02823.JPG,char_data/5/DSC02823.JPG_2.jpg,11152,82,35,117,169,305,True,7
5,106,kaist_dataset/Korean/Digital_Camera/F-bookCover/DSC02834.JPG,char_data/5/DSC02834.JPG_2.jpg,6784,64,158,222,30,136,True,7
5,35,kaist_dataset/Korean/Digital_Camera/outdoor5/DSC03996.JPG,char_data/5/DSC03996.JPG_2.jpg,980,28,376,404,279,314,True,7
5,49,kaist_dataset/Korean/Digital_Camera/outdoor5/DSC03979.JPG,char_data/5/DSC03979.JPG_4.jpg,2940,60,367,427,381,430,True,7
5,51,kaist_dataset/Korean/Digital_Camera/outdoor5/DSC03979.JPG,char_data/5/DSC03979.JPG_4.jpg,3111,61,503,564,382,433,True,7
5,29,kaist_dataset/Korean/Digital_Camera/outdoor5/DSC03744.JPG,char_data/5/DSC03744.JPG_2.jpg,696,24,313,337,303,332,True,7
5,28,kaist_dataset/Korean/Digital_Camera/outdoor5/DSC03780.JPG,char_data/5/DSC03780.JPG_2.jpg,476,17,247,264,436,464,True,7
5,40,kaist_dataset/Korean/Digital_Camera/outdoor5/DSC03779.JPG,char_data/5/DSC03779.JPG_2.jpg,720,18,505,523,238,278,True,7
5,39,kaist_dataset/Korean/Digital_Camera/outdoor5/DSC03692.JPG,char_data/5/DSC03692.JPG_6.jpg,702,18,457,475,182,221,True,7
5,40,kaist_dataset/Korean/Digital_Camera/outdoor5/DSC03692.JPG,char_data/5/DSC03692.JPG_6.jpg,680,17,536,553,188,228,True,7
5,40,kaist_dataset/Korean/Digital_Camera/outdoor5/DSC03692.JPG,char_data/5/DSC03692.JPG_6.jpg,760,19,551,570,187,227,True,7
5,33,kaist_dataset/Korean/Digital_Camera/outdoor5/DSC04027.JPG,char_data/5/DSC04027.JPG_4.jpg,594,18,230,248,387,420,True,7
5,36,kaist_dataset/Korean/Digital_Camera/outdoor5/DSC04027.JPG,char_data/5/DSC04027.JPG_4.jpg,576,16,442,458,382,418,True,7
5,86,kaist_dataset/Korean/Digital_Camera/outdoor5/DSC03715.JPG,char_data/5/DSC03715.JPG_2.jpg,4386,51,408,459,84,170,True,7
5,63,kaist_dataset/Korean/Digital_Camera/outdoor5/DSC03694.JPG,char_data/5/DSC03694.JPG_4.jpg,1953,31,517,548,118,181,True,7
5,65,kaist_dataset/Korean/Digital_Camera/outdoor5/DSC03694.JPG,char_data/5/DSC03694.JPG_4.jpg,2080,32,344,376,245,310,True,7
5,27,kaist_dataset/Korean/Digital_Camera/outdoor5/DSC03752.JPG,char_data/5/DSC03752.JPG_2.jpg,324,12,165,177,411,438,True,7
5,37,kaist_dataset/Korean/Digital_Camera/outdoor5/DSC04040.JPG,char_data/5/DSC04040.JPG_2.jpg,1295,35,439,474,342,379,True,7
5,33,kaist_dataset/Korean/Digital_Camera/outdoor5/DSC03794.JPG,char_data/5/DSC03794.JPG_2.jpg,627,19,284,303,366,399,True,7
5,32,kaist_dataset/Korean/Digital_Camera/outdoor5/DSC03751.JPG,char_data/5/DSC03751.JPG_2.jpg,896,28,307,335,410,442,True,7
5,50,kaist_dataset/Korean/Digital_Camera/outdoor5/DSC03970.JPG,char_data/5/DSC03970.JPG_2.jpg,2050,41,297,338,92,142,True,7
5,32,kaist_dataset/Korean/Digital_Camera/outdoor5/DSC03777.JPG,char_data/5/DSC03777.JPG_2.jpg,576,18,154,172,341,373,True,7
5,25,kaist_dataset/Korean/Digital_Camera/outdoor5/DSC03636.JPG,char_data/5/DSC03636.JPG_4.jpg,300,12,330,342,162,187,True,7
5,32,kaist_dataset/Korean/Digital_Camera/outdoor5/DSC03636.JPG,char_data/5/DSC03636.JPG_4.jpg,736,23,304,327,398,430,True,7
5,39,kaist_dataset/Korean/Digital_Camera/outdoor5/DSC03740.JPG,char_data/5/DSC03740.JPG_6.jpg,975,25,397,422,285,324,True,7
5,39,kaist_dataset/Korean/Digital_Camera/outdoor5/DSC03740.JPG,char_data/5/DSC03740.JPG_6.jpg,897,23,449,472,285,324,True,7
5,39,kaist_dataset/Korean/Digital_Camera/outdoor5/DSC03740.JPG,char_data/5/DSC03740.JPG_6.jpg,975,25,514,539,284,323,True,7
5,95,kaist_dataset/Korean/Digital_Camera/outdoor5/DSC03864.JPG,char_data/5/DSC03864.JPG_2.jpg,5035,53,164,217,155,250,True,7
5,56,kaist_dataset/Korean/Digital_Camera/outdoor4/DSC03598.JPG,char_data/5/DSC03598.JPG_2.jpg,1456,26,272,298,199,255,True,7
5,36,kaist_dataset/Korean/Digital_Camera/outdoor4/DSC03592.JPG,char_data/5/DSC03592.JPG_4.jpg,900,25,197,222,118,154,True,7
5,38,kaist_dataset/Korean/Digital_Camera/outdoor4/DSC03592.JPG,char_data/5/DSC03592.JPG_4.jpg,608,16,626,642,124,162,True,7
5,46,kaist_dataset/Korean/Digital_Camera/outdoor4/DSC03319.JPG,char_data/5/DSC03319.JPG_2.jpg,1104,24,219,243,84,130,True,7
5,39,kaist_dataset/Korean/Digital_Camera/outdoor4/DSC03545.JPG,char_data/5/DSC03545.JPG_2.jpg,663,17,186,203,40,79,True,7
5,47,kaist_dataset/Korean/Digital_Camera/outdoor4/DSC03601.JPG,char_data/5/DSC03601.JPG_2.jpg,1175,25,270,295,293,340,True,7
5,48,kaist_dataset/Korean/Digital_Camera/outdoor4/DSC03272.JPG,char_data/5/DSC03272.JPG_2.jpg,2352,49,284,333,423,471,True,7
5,84,kaist_dataset/Korean/Digital_Camera/outdoor4/DSC03452.JPG,char_data/5/DSC03452.JPG_4.jpg,3528,42,284,326,278,362,True,7
5,80,kaist_dataset/Korean/Digital_Camera/outdoor4/DSC03452.JPG,char_data/5/DSC03452.JPG_4.jpg,2720,34,362,396,277,357,True,7
5,35,kaist_dataset/Korean/Digital_Camera/outdoor4/DSC03555.JPG,char_data/5/DSC03555.JPG_2.jpg,805,23,416,439,422,457,True,7
5,44,kaist_dataset/Korean/Digital_Camera/outdoor4/DSC03603.JPG,char_data/5/DSC03603.JPG_2.jpg,1188,27,342,369,287,331,True,7
5,43,kaist_dataset/Korean/Digital_Camera/outdoor2/2007-12-09-day-exterior-016.jpg,char_data/5/2007-12-09-day-exterior-016.jpg_2.jpg,1333,31,7,38,906,949,True,7
5,62,kaist_dataset/Korean/Digital_Camera/outdoor2/2007-12-08-day-101.jpg,char_data/5/2007-12-08-day-101.jpg_4.jpg,2232,36,815,851,639,701,True,7
5,41,kaist_dataset/Korean/Digital_Camera/outdoor2/2007-12-08-day-101.jpg,char_data/5/2007-12-08-day-101.jpg_4.jpg,697,17,827,844,743,784,True,7
5,52,kaist_dataset/Korean/Digital_Camera/outdoor2/2007-12-09-day-exterior-084.jpg,char_data/5/2007-12-09-day-exterior-084.jpg_0.jpg,1768,34,906,940,790,842,True,7
5,48,kaist_dataset/Korean/Digital_Camera/outdoor2/2007-12-09-day-exterior-084.jpg,char_data/5/2007-12-09-day-exterior-084.jpg_0.jpg,1824,38,941,979,789,837,True,7
5,57,kaist_dataset/Korean/Digital_Camera/outdoor2/2007-12-09-day-exterior-033.jpg,char_data/5/2007-12-09-day-exterior-033.jpg_0.jpg,4104,72,856,928,726,783,True,7
5,54,kaist_dataset/Korean/Digital_Camera/outdoor2/DSC02305.JPG,char_data/5/DSC02305.JPG_0.jpg,2376,44,409,453,245,299,True,7
5,39,kaist_dataset/Korean/Digital_Camera/outdoor2/DSC02426.JPG,char_data/5/DSC02426.JPG_0.jpg,1053,27,437,464,217,256,True,7
5,31,kaist_dataset/Korean/Digital_Camera/outdoor2/DSC02426.JPG,char_data/5/DSC02426.JPG_0.jpg,837,27,562,589,215,246,True,7
5,26,kaist_dataset/Korean/Digital_Camera/outdoor2/DSC02441.JPG,char_data/5/DSC02441.JPG_0.jpg,494,19,531,550,202,228,True,7
5,104,kaist_dataset/Korean/Digital_Camera/outdoor2/DSC02486.JPG,char_data/5/DSC02486.JPG_0.jpg,3952,38,248,286,236,340,True,7
5,46,kaist_dataset/Korean/Digital_Camera/outdoor2/DSC02414.JPG,char_data/5/DSC02414.JPG_0.jpg,1656,36,286,322,238,284,True,7
5,44,kaist_dataset/Korean/Digital_Camera/outdoor2/DSC02414.JPG,char_data/5/DSC02414.JPG_0.jpg,1408,32,486,518,243,287,True,7
5,36,kaist_dataset/Korean/Digital_Camera/outdoor2/DSC02380.JPG,char_data/5/DSC02380.JPG_0.jpg,576,16,375,391,231,267,True,7
5,34,kaist_dataset/Korean/Digital_Camera/outdoor2/DSC02380.JPG,char_data/5/DSC02380.JPG_0.jpg,408,12,420,432,233,267,True,7
5,39,kaist_dataset/Korean/Digital_Camera/outdoor2/DSC02311.JPG,char_data/5/DSC02311.JPG_0.jpg,741,19,581,600,250,289,True,7
5,27,kaist_dataset/Korean/Digital_Camera/outdoor2/DSC02435.JPG,char_data/5/DSC02435.JPG_0.jpg,405,15,501,516,247,274,True,7
5,25,kaist_dataset/Korean/Digital_Camera/outdoor2/DSC02435.JPG,char_data/5/DSC02435.JPG_0.jpg,350,14,562,576,248,273,True,7
5,25,kaist_dataset/Korean/Digital_Camera/outdoor2/DSC02435.JPG,char_data/5/DSC02435.JPG_0.jpg,500,20,590,610,250,275,True,7
5,30,kaist_dataset/Korean/Digital_Camera/outdoor2/DSC02373.JPG,char_data/5/DSC02373.JPG_0.jpg,330,11,437,448,336,366,True,7
5,31,kaist_dataset/Korean/Digital_Camera/outdoor2/DSC02386.JPG,char_data/5/DSC02386.JPG_0.jpg,868,28,562,590,252,283,True,7
5,31,kaist_dataset/Korean/Digital_Camera/outdoor2/DSC02299.JPG,char_data/5/DSC02299.JPG_0.jpg,372,12,629,641,210,241,True,7
5,58,kaist_dataset/Korean/Digital_Camera/outdoor2/2007-12-09-day-exterior-035.jpg,char_data/5/2007-12-09-day-exterior-035.jpg_0.jpg,2030,35,742,777,712,770,True,7
5,77,kaist_dataset/Korean/Digital_Camera/outdoor2/2007-12-09-day-exterior-009.jpg,char_data/5/2007-12-09-day-exterior-009.jpg_0.jpg,3234,42,962,1004,652,729,True,7
5,39,kaist_dataset/Korean/Digital_Camera/outdoor2/DSC02327.JPG,char_data/5/DSC02327.JPG_0.jpg,1092,28,218,246,357,396,True,7
5,40,kaist_dataset/Korean/Digital_Camera/outdoor2/DSC02327.JPG,char_data/5/DSC02327.JPG_0.jpg,1120,28,422,450,362,402,True,7
5,31,kaist_dataset/Korean/Digital_Camera/outdoor2/DSC02304.JPG,char_data/5/DSC02304.JPG_0.jpg,713,23,378,401,263,294,True,7
5,32,kaist_dataset/Korean/Digital_Camera/outdoor2/DSC02304.JPG,char_data/5/DSC02304.JPG_0.jpg,1088,34,402,436,264,296,True,7
5,31,kaist_dataset/Korean/Digital_Camera/outdoor2/DSC02372.JPG,char_data/5/DSC02372.JPG_0.jpg,434,14,510,524,286,317,True,7
5,35,kaist_dataset/Korean/Digital_Camera/outdoor2/DSC02372.JPG,char_data/5/DSC02372.JPG_0.jpg,490,14,524,538,284,319,True,7
5,37,kaist_dataset/Korean/Digital_Camera/outdoor2/DSC02523.JPG,char_data/5/DSC02523.JPG_0.jpg,888,24,535,559,338,375,True,7
5,26,kaist_dataset/Korean/Digital_Camera/E-night/P1010149.JPG,char_data/5/P1010149.JPG_0.jpg,390,15,588,603,241,267,True,7
5,30,kaist_dataset/Korean/Digital_Camera/E-night/P1010146.JPG,char_data/5/P1010146.JPG_0.jpg,480,16,273,289,249,279,True,7
5,34,kaist_dataset/Korean/Digital_Camera/E-night/P1010146.JPG,char_data/5/P1010146.JPG_0.jpg,578,17,312,329,245,279,True,7
5,45,kaist_dataset/Korean/Digital_Camera/E-night/DSC02649.JPG,char_data/5/DSC02649.JPG_0.jpg,945,21,546,567,392,437,True,7
5,23,kaist_dataset/Korean/Digital_Camera/E-night/103.jpg,char_data/5/103.jpg_0.jpg,253,11,155,166,312,335,True,7
5,21,kaist_dataset/Korean/Digital_Camera/E-night/103.jpg,char_data/5/103.jpg_0.jpg,252,12,219,231,313,334,True,7
5,48,kaist_dataset/Korean/Digital_Camera/indoor1/080119-0029.jpg,char_data/5/080119-0029.jpg_0.jpg,1200,25,7,32,572,620,True,7
5,87,kaist_dataset/Korean/Digital_Camera/indoor1/080119-0029.jpg,char_data/5/080119-0029.jpg_0.jpg,3654,42,1361,1403,983,1070,True,7
5,102,kaist_dataset/Korean/Digital_Camera/indoor1/080119-0030.jpg,char_data/5/080119-0030.jpg_0.jpg,5406,53,906,959,426,528,True,7
5,159,kaist_dataset/Korean/Digital_Camera/indoor1/080119-0030.jpg,char_data/5/080119-0030.jpg_0.jpg,16854,106,999,1105,561,720,True,7
5,47,kaist_dataset/Korean/Digital_Camera/indoor1/080119-0018.jpg,char_data/5/080119-0018.jpg_0.jpg,1598,34,1005,1039,699,746,True,7
5,49,kaist_dataset/Korean/Digital_Camera/indoor1/080119-0018.jpg,char_data/5/080119-0018.jpg_0.jpg,1568,32,1143,1175,699,748,True,7
5,30,kaist_dataset/Korean/Digital_Camera/outdoor7/P1010022.JPG,char_data/5/P1010022.JPG_0.jpg,750,25,190,215,258,288,True,7
5,42,kaist_dataset/Korean/Digital_Camera/outdoor7/P1010012.JPG,char_data/5/P1010012.JPG_0.jpg,1008,24,281,305,220,262,True,7
5,40,kaist_dataset/Korean/Digital_Camera/outdoor7/P1010012.JPG,char_data/5/P1010012.JPG_0.jpg,1160,29,327,356,220,260,True,7
5,41,kaist_dataset/Korean/Digital_Camera/outdoor7/P1010082.JPG,char_data/5/P1010082.JPG_0.jpg,1394,34,245,279,53,94,True,7
5,30,kaist_dataset/Korean/Digital_Camera/outdoor7/P1010091.JPG,char_data/5/P1010091.JPG_0.jpg,810,27,282,309,233,263,True,7
5,41,kaist_dataset/Korean/Digital_Camera/outdoor7/P1010091.JPG,char_data/5/P1010091.JPG_0.jpg,779,19,332,351,231,272,True,7
5,33,kaist_dataset/Korean/Digital_Camera/outdoor7/P1010091.JPG,char_data/5/P1010091.JPG_0.jpg,660,20,376,396,234,267,True,7
5,28,kaist_dataset/Korean/Digital_Camera/outdoor7/P1010091.JPG,char_data/5/P1010091.JPG_0.jpg,644,23,415,438,239,267,True,7
5,31,kaist_dataset/Korean/Digital_Camera/outdoor7/P1010054.JPG,char_data/5/P1010054.JPG_0.jpg,620,20,590,610,227,258,True,7
5,57,kaist_dataset/Korean/Digital_Camera/outdoor7/k.jpg,char_data/5/k.jpg_0.jpg,3078,54,37,91,144,201,True,7
5,28,kaist_dataset/Korean/Digital_Camera/outdoor7/P1010107.JPG,char_data/5/P1010107.JPG_0.jpg,476,17,347,364,228,256,True,7
5,34,kaist_dataset/Korean/Digital_Camera/outdoor7/P1010101.JPG,char_data/5/P1010101.JPG_0.jpg,714,21,402,423,232,266,True,7
5,35,kaist_dataset/Korean/Digital_Camera/outdoor7/P1010003.JPG,char_data/5/P1010003.JPG_0.jpg,840,24,351,375,277,312,True,7
5,32,kaist_dataset/Korean/Digital_Camera/outdoor7/P1010005.JPG,char_data/5/P1010005.JPG_0.jpg,992,31,574,605,188,220,True,7
5,35,kaist_dataset/Korean/Digital_Camera/outdoor7/P1010055.JPG,char_data/5/P1010055.JPG_0.jpg,665,19,48,67,204,239,True,7
5,29,kaist_dataset/Korean/Digital_Camera/outdoor7/P1010121.JPG,char_data/5/P1010121.JPG_0.jpg,609,21,580,601,215,244,True,7
5,58,kaist_dataset/Korean/Digital_Camera/outdoor7/P1010011.JPG,char_data/5/P1010011.JPG_0.jpg,2320,40,517,557,223,281,True,7
5,21,kaist_dataset/Korean/Digital_Camera/outdoor7/P1010100.JPG,char_data/5/P1010100.JPG_0.jpg,399,19,246,265,225,246,True,7
5,23,kaist_dataset/Korean/Digital_Camera/outdoor7/P1010100.JPG,char_data/5/P1010100.JPG_0.jpg,253,11,303,314,224,247,True,7
5,27,kaist_dataset/Korean/Digital_Camera/outdoor7/P1010100.JPG,char_data/5/P1010100.JPG_0.jpg,540,20,443,463,217,244,True,7
5,23,kaist_dataset/Korean/Digital_Camera/outdoor7/P1010100.JPG,char_data/5/P1010100.JPG_0.jpg,598,26,498,524,219,242,True,7
5,44,kaist_dataset/Korean/Digital_Camera/outdoor7/P1010100.JPG,char_data/5/P1010100.JPG_0.jpg,1452,33,227,260,347,391,True,7
5,44,kaist_dataset/Korean/Digital_Camera/outdoor7/P1010100.JPG,char_data/5/P1010100.JPG_0.jpg,1188,27,326,353,350,394,True,7
5,56,kaist_dataset/Korean/Digital_Camera/outdoor7/P1010023.JPG,char_data/5/P1010023.JPG_0.jpg,2016,36,225,261,287,343,True,7
5,56,kaist_dataset/Korean/Digital_Camera/outdoor7/P1010023.JPG,char_data/5/P1010023.JPG_0.jpg,1400,25,446,471,282,338,True,7
5,53,kaist_dataset/Korean/Digital_Camera/outdoor7/P1010023.JPG,char_data/5/P1010023.JPG_0.jpg,1272,24,597,621,282,335,True,7
5,145,kaist_dataset/Korean/Digital_Camera/outdoor7/P1010002.JPG,char_data/5/P1010002.JPG_0.jpg,19865,137,404,541,158,303,True,7
5,32,kaist_dataset/Korean/Digital_Camera/outdoor7/P1010035.JPG,char_data/5/P1010035.JPG_0.jpg,768,24,151,175,205,237,True,7
5,32,kaist_dataset/Korean/Digital_Camera/outdoor7/P1010057.JPG,char_data/5/P1010057.JPG_0.jpg,672,21,586,607,228,260,True,7
5,98,kaist_dataset/Korean/Digital_Camera/outdoor7/P1010079.JPG,char_data/5/P1010079.JPG_0.jpg,5978,61,328,389,343,441,True,7
5,38,kaist_dataset/Korean/Digital_Camera/outdoor8/P1010189.JPG,char_data/5/P1010189.JPG_0.jpg,1254,33,521,554,229,267,True,7
5,60,kaist_dataset/Korean/Digital_Camera/outdoor8/DSC02950.JPG,char_data/5/DSC02950.JPG_0.jpg,2760,46,402,448,293,353,True,7
5,54,kaist_dataset/Korean/Digital_Camera/outdoor8/P1010171.JPG,char_data/5/P1010171.JPG_0.jpg,1350,25,543,568,228,282,True,7
5,32,kaist_dataset/Korean/Digital_Camera/outdoor8/P1010178.JPG,char_data/5/P1010178.JPG_0.jpg,640,20,316,336,389,421,True,7
5,36,kaist_dataset/Korean/Digital_Camera/outdoor8/P1011112.JPG,char_data/5/P1011112.JPG_0.jpg,576,16,394,410,216,252,True,7
5,30,kaist_dataset/Korean/Digital_Camera/outdoor8/P1011112.JPG,char_data/5/P1011112.JPG_0.jpg,510,17,530,547,225,255,True,7
5,37,kaist_dataset/Korean/Digital_Camera/outdoor8/P1011112.JPG,char_data/5/P1011112.JPG_0.jpg,592,16,594,610,224,261,True,7
5,40,kaist_dataset/Korean/Digital_Camera/outdoor8/P1011112.JPG,char_data/5/P1011112.JPG_0.jpg,560,14,623,637,227,267,True,7
5,56,kaist_dataset/Korean/Digital_Camera/indoor2/DSC03474.JPG,char_data/5/DSC03474.JPG_0.jpg,2016,36,436,472,150,206,True,7
5,53,kaist_dataset/Korean/Digital_Camera/indoor2/DSC03474.JPG,char_data/5/DSC03474.JPG_0.jpg,2173,41,470,511,149,202,True,7
5,55,kaist_dataset/Korean/Digital_Camera/indoor2/DSC03475.JPG,char_data/5/DSC03475.JPG_0.jpg,2200,40,459,499,93,148,True,7
5,59,kaist_dataset/Korean/Digital_Camera/indoor2/DSC03475.JPG,char_data/5/DSC03475.JPG_0.jpg,2714,46,530,576,85,144,True,7
5,51,kaist_dataset/Korean/Digital_Camera/indoor2/DSC03560.JPG,char_data/5/DSC03560.JPG_0.jpg,1530,30,394,424,54,105,True,7
5,74,kaist_dataset/Korean/Digital_Camera/indoor2/P071209063.jpg,char_data/5/P071209063.jpg_0.jpg,3996,54,1230,1284,1060,1134,True,7
5,76,kaist_dataset/Korean/Digital_Camera/indoor2/P071209063.jpg,char_data/5/P071209063.jpg_0.jpg,4028,53,1283,1336,1057,1133,True,7
5,50,kaist_dataset/Korean/Digital_Camera/indoor2/DSC04204.JPG,char_data/5/DSC04204.JPG_0.jpg,1850,37,249,286,204,254,True,7
5,42,kaist_dataset/Korean/Digital_Camera/indoor2/DSC04204.JPG,char_data/5/DSC04204.JPG_0.jpg,882,21,433,454,279,321,True,7
5,43,kaist_dataset/Korean/Digital_Camera/indoor2/DSC03995.JPG,char_data/5/DSC03995.JPG_0.jpg,1075,25,521,546,264,307,True,7
5,43,kaist_dataset/Korean/Digital_Camera/indoor2/DSC03995.JPG,char_data/5/DSC03995.JPG_0.jpg,1161,27,570,597,262,305,True,7
5,54,kaist_dataset/Korean/Digital_Camera/indoor2/DSC03994.JPG,char_data/5/DSC03994.JPG_0.jpg,1620,30,458,488,286,340,True,7
5,56,kaist_dataset/Korean/Digital_Camera/indoor2/DSC03994.JPG,char_data/5/DSC03994.JPG_0.jpg,2240,40,512,552,286,342,True,7
5,95,kaist_dataset/Korean/Digital_Camera/indoor2/DSC03565.JPG,char_data/5/DSC03565.JPG_0.jpg,5795,61,291,352,269,364,True,7
5,92,kaist_dataset/Korean/Digital_Camera/indoor2/DSC03565.JPG,char_data/5/DSC03565.JPG_0.jpg,5152,56,457,513,267,359,True,7
5,46,kaist_dataset/Korean/Digital_Camera/G-others/2007-12-09-day-exterior-083.jpg,char_data/5/2007-12-09-day-exterior-083.jpg_0.jpg,1380,30,664,694,979,1025,True,7
5,46,kaist_dataset/Korean/Digital_Camera/G-others/2007-12-09-day-exterior-083.jpg,char_data/5/2007-12-09-day-exterior-083.jpg_0.jpg,1334,29,695,724,983,1029,True,7
5,59,kaist_dataset/Korean/Digital_Camera/G-others/2007-12-09-day-exterior-083.jpg,char_data/5/2007-12-09-day-exterior-083.jpg_0.jpg,2242,38,482,520,118,177,True,7
5,58,kaist_dataset/Korean/Digital_Camera/G-others/2007-12-09-day-exterior-083.jpg,char_data/5/2007-12-09-day-exterior-083.jpg_0.jpg,2494,43,521,564,120,178,True,7
5,25,kaist_dataset/Korean/Digital_Camera/G-others/DSC03863.JPG,char_data/5/DSC03863.JPG_0.jpg,350,14,191,205,408,433,True,7
5,50,kaist_dataset/Korean/Digital_Camera/G-others/DSC03434.JPG,char_data/5/DSC03434.JPG_0.jpg,1450,29,371,400,29,79,True,7
5,54,kaist_dataset/Korean/Digital_Camera/G-others/DSC03434.JPG,char_data/5/DSC03434.JPG_0.jpg,1890,35,426,461,30,84,True,7
5,114,kaist_dataset/Korean/Digital_Camera/G-others/2007-12-09-day-exterior-062.jpg,char_data/5/2007-12-09-day-exterior-062.jpg_0.jpg,3876,34,631,665,1396,1510,True,7
5,50,kaist_dataset/Korean/Digital_Camera/G-others/005.JPG,char_data/5/005.JPG_0.jpg,1700,34,293,327,427,477,True,7
5,20,kaist_dataset/Korean/Digital_Camera/G-others/2007-12-08-day-112.jpg,char_data/5/2007-12-08-day-112.jpg_0.jpg,260,13,403,416,1175,1195,True,7
5,43,kaist_dataset/Korean/Digital_Camera/G-others/DSC03065.JPG,char_data/5/DSC03065.JPG_0.jpg,2494,58,257,315,53,96,True,7
5,29,kaist_dataset/Korean/Digital_Camera/B-light/DSC02987.JPG,char_data/5/DSC02987.JPG_0.jpg,377,13,418,431,276,305,True,7
5,32,kaist_dataset/Korean/Digital_Camera/B-light/DSC02987.JPG,char_data/5/DSC02987.JPG_0.jpg,416,13,445,458,275,307,True,7
5,40,kaist_dataset/Korean/Digital_Camera/outdoor6/DSC04081.JPG,char_data/5/DSC04081.JPG_0.jpg,1880,47,426,473,317,357,True,7
5,40,kaist_dataset/Korean/Digital_Camera/outdoor6/DSC04081.JPG,char_data/5/DSC04081.JPG_0.jpg,1840,46,473,519,317,357,True,7
5,106,kaist_dataset/Korean/Digital_Camera/outdoor6/DSC04090.JPG,char_data/5/DSC04090.JPG_0.jpg,5194,49,437,486,182,288,True,7
5,108,kaist_dataset/Korean/Digital_Camera/outdoor6/DSC04090.JPG,char_data/5/DSC04090.JPG_0.jpg,6480,60,486,546,179,287,True,7
5,56,kaist_dataset/Korean/Digital_Camera/outdoor6/DSC04143.JPG,char_data/5/DSC04143.JPG_0.jpg,1904,34,256,290,355,411,True,7
5,28,kaist_dataset/Korean/Digital_Camera/outdoor6/DSC04132.JPG,char_data/5/DSC04132.JPG_0.jpg,532,19,278,297,158,186,True,7
5,46,kaist_dataset/Korean/Digital_Camera/outdoor6/DSC04400.JPG,char_data/5/DSC04400.JPG_0.jpg,1748,38,416,454,394,440,True,7
5,39,kaist_dataset/Korean/Digital_Camera/outdoor6/DSC04400.JPG,char_data/5/DSC04400.JPG_0.jpg,780,20,524,544,406,445,True,7
5,21,kaist_dataset/Korean/Digital_Camera/outdoor6/DSC04041.JPG,char_data/5/DSC04041.JPG_0.jpg,399,19,496,515,147,168,True,7
5,29,kaist_dataset/Korean/Digital_Camera/outdoor6/DSC04343.JPG,char_data/5/DSC04343.JPG_0.jpg,667,23,323,346,204,233,True,7
5,52,kaist_dataset/Korean/Digital_Camera/outdoor6/DSC04352.JPG,char_data/5/DSC04352.JPG_0.jpg,1508,29,351,380,283,335,True,7
5,59,kaist_dataset/Korean/Digital_Camera/outdoor6/DSC04352.JPG,char_data/5/DSC04352.JPG_0.jpg,1534,26,399,425,281,340,True,7
5,49,kaist_dataset/Korean/Digital_Camera/outdoor6/DSC04089.JPG,char_data/5/DSC04089.JPG_0.jpg,1421,29,465,494,277,326,True,7
5,72,kaist_dataset/Korean/Digital_Camera/outdoor6/DSC04301.JPG,char_data/5/DSC04301.JPG_0.jpg,4464,62,190,252,359,431,True,7
5,69,kaist_dataset/Korean/Digital_Camera/outdoor6/DSC04301.JPG,char_data/5/DSC04301.JPG_0.jpg,5796,84,309,393,361,430,True,7
5,74,kaist_dataset/Korean/Digital_Camera/outdoor6/DSC04301.JPG,char_data/5/DSC04301.JPG_0.jpg,5254,71,508,579,361,435,True,7
5,23,kaist_dataset/Korean/Digital_Camera/outdoor6/DSC04042.JPG,char_data/5/DSC04042.JPG_0.jpg,322,14,123,137,334,357,True,7
5,39,kaist_dataset/Korean/Digital_Camera/outdoor6/DSC04116.JPG,char_data/5/DSC04116.JPG_0.jpg,624,16,206,222,317,356,True,7
5,90,kaist_dataset/Korean/Digital_Camera/outdoor6/DSC04096.JPG,char_data/5/DSC04096.JPG_0.jpg,4140,46,213,259,217,307,True,7
5,82,kaist_dataset/Korean/Digital_Camera/outdoor6/DSC04096.JPG,char_data/5/DSC04096.JPG_0.jpg,4674,57,421,478,225,307,True,7
5,57,kaist_dataset/Korean/Digital_Camera/outdoor6/DSC04100.JPG,char_data/5/DSC04100.JPG_0.jpg,1140,20,385,405,51,108,True,7
5,59,kaist_dataset/Korean/Digital_Camera/outdoor6/DSC04100.JPG,char_data/5/DSC04100.JPG_0.jpg,1180,20,502,522,53,112,True,7
5,65,kaist_dataset/Korean/Digital_Camera/outdoor6/DSC04073.JPG,char_data/5/DSC04073.JPG_0.jpg,2275,35,361,396,32,97,True,7
5,61,kaist_dataset/Korean/Digital_Camera/outdoor6/DSC04073.JPG,char_data/5/DSC04073.JPG_0.jpg,1647,27,515,542,34,95,True,7
5,74,kaist_dataset/Korean/Digital_Camera/outdoor6/DSC04147.JPG,char_data/5/DSC04147.JPG_0.jpg,2960,40,230,270,177,251,True,7
5,85,kaist_dataset/Korean/Digital_Camera/outdoor6/DSC04147.JPG,char_data/5/DSC04147.JPG_0.jpg,3315,39,348,387,174,259,True,7
5,80,kaist_dataset/Korean/Digital_Camera/outdoor6/DSC04147.JPG,char_data/5/DSC04147.JPG_0.jpg,3200,40,426,466,174,254,True,7
5,28,kaist_dataset/Korean/Digital_Camera/outdoor6/DSC04046.JPG,char_data/5/DSC04046.JPG_0.jpg,504,18,328,346,259,287,True,7
5,56,kaist_dataset/Korean/Digital_Camera/outdoor6/DSC04370.JPG,char_data/5/DSC04370.JPG_0.jpg,2800,50,227,277,320,376,True,7
5,62,kaist_dataset/Korean/Digital_Camera/outdoor6/DSC04370.JPG,char_data/5/DSC04370.JPG_0.jpg,3348,54,328,382,323,385,True,7
5,60,kaist_dataset/Korean/Digital_Camera/outdoor6/DSC04370.JPG,char_data/5/DSC04370.JPG_0.jpg,3420,57,490,547,323,383,True,7
5,56,kaist_dataset/Korean/Digital_Camera/outdoor6/DSC04332.JPG,char_data/5/DSC04332.JPG_0.jpg,2800,50,185,235,351,407,True,7
5,52,kaist_dataset/Korean/Digital_Camera/outdoor6/DSC04118.JPG,char_data/5/DSC04118.JPG_0.jpg,1820,35,277,312,252,304,True,7
5,47,kaist_dataset/Korean/Digital_Camera/A-shadow/DSC04315.JPG,char_data/5/DSC04315.JPG_0.jpg,1363,29,241,270,415,462,True,7
5,47,kaist_dataset/Korean/Digital_Camera/A-shadow/DSC04315.JPG,char_data/5/DSC04315.JPG_0.jpg,1363,29,292,321,417,464,True,7
5,81,kaist_dataset/Korean/Digital_Camera/A-shadow/DSC04311.JPG,char_data/5/DSC04311.JPG_0.jpg,5103,63,533,596,264,345,True,7
5,76,kaist_dataset/Korean/Digital_Camera/A-shadow/DSC03536.JPG,char_data/5/DSC03536.JPG_0.jpg,3192,42,185,227,243,319,True,7
5,70,kaist_dataset/Korean/Digital_Camera/A-shadow/DSC03535.JPG,char_data/5/DSC03535.JPG_0.jpg,2800,40,273,313,252,322,True,7
5,68,kaist_dataset/Korean/Digital_Camera/A-shadow/DSC03535.JPG,char_data/5/DSC03535.JPG_0.jpg,2788,41,524,565,245,313,True,7
5,48,kaist_dataset/Korean/Digital_Camera/outdoor3/DSC02546.JPG,char_data/5/DSC02546.JPG_0.jpg,1440,30,388,418,229,277,True,7
5,33,kaist_dataset/Korean/Digital_Camera/outdoor3/DSC02546.JPG,char_data/5/DSC02546.JPG_0.jpg,330,10,210,220,426,459,True,7
5,33,kaist_dataset/Korean/Digital_Camera/outdoor3/DSC02531.JPG,char_data/5/DSC02531.JPG_0.jpg,627,19,311,330,347,380,True,7
5,34,kaist_dataset/Korean/Digital_Camera/outdoor3/DSC02531.JPG,char_data/5/DSC02531.JPG_0.jpg,646,19,332,351,347,381,True,7
5,67,kaist_dataset/Korean/Digital_Camera/outdoor3/DSC03198.JPG,char_data/5/DSC03198.JPG_0.jpg,3149,47,121,168,195,262,True,7
5,36,kaist_dataset/Korean/Digital_Camera/outdoor3/DSC02944.JPG,char_data/5/DSC02944.JPG_0.jpg,792,22,303,325,235,271,True,7
5,51,kaist_dataset/Korean/Digital_Camera/outdoor3/DSC03221.JPG,char_data/5/DSC03221.JPG_0.jpg,1122,22,128,150,90,141,True,7
5,39,kaist_dataset/Korean/Digital_Camera/outdoor3/DSC02899.JPG,char_data/5/DSC02899.JPG_0.jpg,1677,43,583,626,224,263,True,7
5,81,kaist_dataset/Korean/Digital_Camera/outdoor3/DSC02900.JPG,char_data/5/DSC02900.JPG_0.jpg,3645,45,516,561,238,319,True,7
5,56,kaist_dataset/Korean/Digital_Camera/outdoor3/DSC02953.JPG,char_data/5/DSC02953.JPG_0.jpg,1848,33,522,555,388,444,True,7
5,27,kaist_dataset/Korean/Digital_Camera/outdoor3/DSC02891.JPG,char_data/5/DSC02891.JPG_0.jpg,378,14,548,562,302,329,True,7
5,112,kaist_dataset/Korean/Digital_Camera/outdoor3/DSC02525.JPG,char_data/5/DSC02525.JPG_0.jpg,8960,80,270,350,27,139,True,7
5,26,kaist_dataset/Korean/Digital_Camera/outdoor3/DSC02529.JPG,char_data/5/DSC02529.JPG_0.jpg,234,9,542,551,372,398,True,7
5,50,kaist_dataset/Korean/Digital_Camera/outdoor3/DSC02994.JPG,char_data/5/DSC02994.JPG_0.jpg,1450,29,254,283,284,334,True,7
5,47,kaist_dataset/Korean/Digital_Camera/outdoor3/DSC02697.JPG,char_data/5/DSC02697.JPG_0.jpg,1692,36,177,213,376,423,True,7
5,98,kaist_dataset/Korean/Digital_Camera/outdoor3/DSC02983.JPG,char_data/5/DSC02983.JPG_0.jpg,4802,49,364,413,312,410,True,7
5,104,kaist_dataset/Korean/Digital_Camera/outdoor3/DSC02983.JPG,char_data/5/DSC02983.JPG_0.jpg,5616,54,462,516,314,418,True,7
5,117,kaist_dataset/Korean/Digital_Camera/outdoor3/DSC03159.JPG,char_data/5/DSC03159.JPG_0.jpg,5967,51,290,341,222,339,True,7
5,69,kaist_dataset/Korean/Digital_Camera/outdoor3/DSC03222.JPG,char_data/5/DSC03222.JPG_0.jpg,3933,57,280,337,378,447,True,7
5,68,kaist_dataset/Korean/Digital_Camera/outdoor3/DSC02951.JPG,char_data/5/DSC02951.JPG_0.jpg,3672,54,334,388,391,459,True,7
5,73,kaist_dataset/Korean/Digital_Camera/outdoor3/DSC02951.JPG,char_data/5/DSC02951.JPG_0.jpg,4307,59,439,498,386,459,True,7
5,30,kaist_dataset/Korean/Digital_Camera/outdoor3/DSC03232.JPG,char_data/5/DSC03232.JPG_0.jpg,660,22,299,321,284,314,True,7
5,33,kaist_dataset/Korean/Digital_Camera/outdoor3/DSC03232.JPG,char_data/5/DSC03232.JPG_0.jpg,792,24,564,588,272,305,True,7
5,40,kaist_dataset/Korean/Digital_Camera/outdoor1/53.JPG,char_data/5/53.JPG_0.jpg,560,14,707,721,225,265,True,7
5,21,kaist_dataset/Korean/Digital_Camera/outdoor1/070.JPG,char_data/5/070.JPG_0.jpg,336,16,412,428,249,270,True,7
5,23,kaist_dataset/Korean/Digital_Camera/outdoor1/070.JPG,char_data/5/070.JPG_0.jpg,414,18,428,446,247,270,True,7
5,21,kaist_dataset/Korean/Digital_Camera/outdoor1/070.JPG,char_data/5/070.JPG_0.jpg,420,20,459,479,251,272,True,7
5,39,kaist_dataset/Korean/Digital_Camera/outdoor1/091.JPG,char_data/5/091.JPG_0.jpg,975,25,404,429,282,321,True,7
5,51,kaist_dataset/Korean/Digital_Camera/outdoor1/091.JPG,char_data/5/091.JPG_0.jpg,1479,29,429,458,276,327,True,7
5,37,kaist_dataset/Korean/Digital_Camera/outdoor1/091.JPG,char_data/5/091.JPG_0.jpg,1110,30,283,313,284,321,True,7
5,25,kaist_dataset/Korean/Digital_Camera/outdoor1/028.JPG,char_data/5/028.JPG_0.jpg,325,13,359,372,265,290,True,7
5,24,kaist_dataset/Korean/Digital_Camera/outdoor1/028.JPG,char_data/5/028.JPG_0.jpg,288,12,373,385,263,287,True,7
5,40,kaist_dataset/Korean/Digital_Camera/outdoor1/052.JPG,char_data/5/052.JPG_0.jpg,1040,26,408,434,320,360,True,7
5,31,kaist_dataset/Korean/Digital_Camera/outdoor1/102.JPG,char_data/5/102.JPG_0.jpg,651,21,368,389,308,339,True,7
5,30,kaist_dataset/Korean/Digital_Camera/outdoor1/102.JPG,char_data/5/102.JPG_0.jpg,630,21,388,409,308,338,True,7
5,41,kaist_dataset/Korean/Digital_Camera/outdoor1/127.JPG,char_data/5/127.JPG_0.jpg,1230,30,393,423,267,308,True,7
5,30,kaist_dataset/Korean/Digital_Camera/outdoor1/069.JPG,char_data/5/069.JPG_0.jpg,540,18,388,406,270,300,True,7
5,26,kaist_dataset/Korean/Digital_Camera/outdoor1/126.JPG,char_data/5/126.JPG_0.jpg,702,27,350,377,260,286,True,7
5,28,kaist_dataset/Korean/Digital_Camera/outdoor1/126.JPG,char_data/5/126.JPG_0.jpg,308,11,518,529,254,282,True,7
5,68,kaist_dataset/Korean/Digital_Camera/outdoor1/2007-12-08-day-057.jpg,char_data/5/2007-12-08-day-057.jpg_0.jpg,2788,41,949,990,595,663,True,7
5,72,kaist_dataset/Korean/Digital_Camera/outdoor1/2007-12-08-day-057.jpg,char_data/5/2007-12-08-day-057.jpg_0.jpg,3024,42,990,1032,593,665,True,7
5,21,kaist_dataset/Korean/Digital_Camera/outdoor1/006.JPG,char_data/5/006.JPG_0.jpg,357,17,382,399,251,272,True,7
5,33,kaist_dataset/Korean/Digital_Camera/outdoor1/50.JPG,char_data/5/50.JPG_0.jpg,561,17,370,387,338,371,True,7
5,26,kaist_dataset/Korean/Digital_Camera/outdoor1/50.JPG,char_data/5/50.JPG_0.jpg,494,19,387,406,343,369,True,7
5,40,kaist_dataset/Korean/Digital_Camera/outdoor1/54.JPG,char_data/5/54.JPG_0.jpg,1160,29,494,523,367,407,True,7
5,32,kaist_dataset/Korean/Digital_Camera/outdoor1/032.JPG,char_data/5/032.JPG_0.jpg,544,17,178,195,257,289,True,7
5,35,kaist_dataset/Korean/Digital_Camera/outdoor1/123.JPG,char_data/5/123.JPG_0.jpg,700,20,383,403,272,307,True,7
5,33,kaist_dataset/Korean/Digital_Camera/outdoor1/059.JPG,char_data/5/059.JPG_0.jpg,561,17,515,532,329,362,True,7
5,40,kaist_dataset/Korean/Digital_Camera/outdoor1/059.JPG,char_data/5/059.JPG_0.jpg,720,18,486,504,322,362,True,7
5,29,kaist_dataset/Korean/Digital_Camera/outdoor1/035.JPG,char_data/5/035.JPG_0.jpg,493,17,358,375,290,319,True,7
5,34,kaist_dataset/Korean/Digital_Camera/outdoor1/120.JPG,char_data/5/120.JPG_0.jpg,1224,36,279,315,299,333,True,7
5,48,kaist_dataset/Korean/Digital_Camera/outdoor1/120.JPG,char_data/5/120.JPG_0.jpg,1776,37,334,371,287,335,True,7
5,43,kaist_dataset/Korean/Digital_Camera/outdoor1/120.JPG,char_data/5/120.JPG_0.jpg,1591,37,372,409,292,335,True,7
5,33,kaist_dataset/Mixed/Mobile_Phone/(C.M)A-outdoor/P090908006.jpg,char_data/5/P090908006.jpg_0.jpg,891,27,471,498,363,396,True,7
5,25,kaist_dataset/Mixed/Mobile_Phone/(C.M)A-outdoor/P090912040.jpg,char_data/5/P090912040.jpg_0.jpg,550,22,241,263,192,217,True,7
5,36,kaist_dataset/Mixed/Mobile_Phone/(C.M)A-outdoor/P090912038.jpg,char_data/5/P090912038.jpg_0.jpg,612,17,472,489,155,191,True,7
5,29,kaist_dataset/Mixed/Mobile_Phone/(C.M)A-outdoor/P090912036.jpg,char_data/5/P090912036.jpg_0.jpg,348,12,227,239,189,218,True,7
5,29,kaist_dataset/Mixed/Mobile_Phone/(C.M)A-outdoor/P090912036.jpg,char_data/5/P090912036.jpg_0.jpg,406,14,428,442,191,220,True,7
5,71,kaist_dataset/Mixed/Mobile_Phone/(C.M)B-indoor/P090831007.jpg,char_data/5/P090831007.jpg_0.jpg,2982,42,399,441,202,273,True,7
5,37,kaist_dataset/Mixed/Mobile_Phone/(C.M)C-bookCover/P090903009.jpg,char_data/5/P090903009.jpg_0.jpg,666,18,200,218,355,392,True,7
5,96,kaist_dataset/Mixed/Mobile_Phone/(C.M)C-bookCover/P090905002.jpg,char_data/5/P090905002.jpg_0.jpg,6624,69,353,422,42,138,True,7
5,109,kaist_dataset/Mixed/Mobile_Phone/(C.M)C-bookCover/P090902019.jpg,char_data/5/P090902019.jpg_0.jpg,4905,45,124,169,66,175,True,7
5,64,kaist_dataset/Mixed/Mobile_Phone/(C.M)C-bookCover/P090902019.jpg,char_data/5/P090902019.jpg_0.jpg,2240,35,77,112,281,345,True,7
5,57,kaist_dataset/Mixed/Digital_Camera/(C.S)C-outdoor1/P1010012.JPG,char_data/5/P1010012.JPG_0.jpg,1938,34,521,555,231,288,True,7
5,27,kaist_dataset/Mixed/Digital_Camera/(C.S)C-outdoor1/048.JPG,char_data/5/048.JPG_0.jpg,459,17,359,376,257,284,True,7
5,29,kaist_dataset/Mixed/Digital_Camera/(C.S)C-outdoor1/048.JPG,char_data/5/048.JPG_0.jpg,638,22,376,398,256,285,True,7
5,40,kaist_dataset/Mixed/Digital_Camera/(C.S)C-outdoor1/51.JPG,char_data/5/51.JPG_0.jpg,1120,28,663,691,377,417,True,7
5,97,kaist_dataset/Mixed/Digital_Camera/(C.S)C-outdoor1/2007-12-08-day-092.jpg,char_data/5/2007-12-08-day-092.jpg_0.jpg,6790,70,968,1038,659,756,True,7
5,63,kaist_dataset/Mixed/Digital_Camera/(C.S)C-outdoor1/2007-12-09-day-exterior-086.jpg,char_data/5/2007-12-09-day-exterior-086.jpg_0.jpg,4536,72,1096,1168,723,786,True,7
5,53,kaist_dataset/Mixed/Digital_Camera/(C.S)C-outdoor1/080116-0084.jpg,char_data/5/080116-0084.jpg_0.jpg,1431,27,598,625,304,357,True,7
5,34,kaist_dataset/Mixed/Digital_Camera/(C.S)C-outdoor1/DSC02344.JPG,char_data/5/DSC02344.JPG_0.jpg,680,20,565,585,257,291,True,7
5,343,kaist_dataset/Mixed/Digital_Camera/(C.S)C-outdoor1/2007-12-08-day-137.jpg,char_data/5/2007-12-08-day-137.jpg_0.jpg,79576,232,946,1178,389,732,True,7
5,31,kaist_dataset/Mixed/Digital_Camera/(C.S)C-outdoor1/118.JPG,char_data/5/118.JPG_0.jpg,713,23,376,399,360,391,True,7
5,226,kaist_dataset/Mixed/Digital_Camera/(C.S)C-outdoor1/2007-12-08-day-118.jpg,char_data/5/2007-12-08-day-118.jpg_0.jpg,24860,110,1080,1190,548,774,True,7
5,38,kaist_dataset/Mixed/Digital_Camera/(C.S)C-outdoor1/P1010011.JPG,char_data/5/P1010011.JPG_0.jpg,646,17,540,557,310,348,True,7
5,20,kaist_dataset/Mixed/Digital_Camera/(C.S)C-outdoor1/48.JPG,char_data/5/48.JPG_0.jpg,260,13,437,450,344,364,True,7
5,24,kaist_dataset/Mixed/Digital_Camera/(C.S)C-outdoor1/047.JPG,char_data/5/047.JPG_0.jpg,216,9,564,573,238,262,True,7
5,43,kaist_dataset/Mixed/Digital_Camera/(C.S)C-outdoor1/3.JPG,char_data/5/3.JPG_0.jpg,1032,24,451,475,419,462,True,7
5,97,kaist_dataset/Mixed/Digital_Camera/(C.S)C-outdoor1/080119-0027.jpg,char_data/5/080119-0027.jpg_0.jpg,4365,45,582,627,710,807,True,7
5,38,kaist_dataset/Mixed/Digital_Camera/(C.S)C-outdoor1/P1010009.JPG,char_data/5/P1010009.JPG_0.jpg,836,22,293,315,244,282,True,7
5,37,kaist_dataset/Mixed/Digital_Camera/(C.S)C-outdoor1/P1010009.JPG,char_data/5/P1010009.JPG_0.jpg,999,27,315,342,243,280,True,7
5,27,kaist_dataset/Mixed/Digital_Camera/(C.S)C-outdoor1/57.JPG,char_data/5/57.JPG_0.jpg,432,16,638,654,299,326,True,7
5,27,kaist_dataset/Mixed/Digital_Camera/(C.S)C-outdoor1/57.JPG,char_data/5/57.JPG_0.jpg,297,11,465,476,454,481,True,7
5,28,kaist_dataset/Mixed/Digital_Camera/(C.S)C-outdoor1/47.JPG,char_data/5/47.JPG_0.jpg,448,16,403,419,476,504,True,7
5,38,kaist_dataset/Mixed/Digital_Camera/(C.S)C-outdoor1/105.jpg,char_data/5/105.jpg_0.jpg,1292,34,222,256,384,422,True,7
5,36,kaist_dataset/Mixed/Digital_Camera/(C.S)C-outdoor1/105.jpg,char_data/5/105.jpg_0.jpg,900,25,317,342,387,423,True,7
5,113,kaist_dataset/Mixed/Digital_Camera/(C.S)C-outdoor1/DSC02244.JPG,char_data/5/DSC02244.JPG_0.jpg,8023,71,342,413,112,225,True,7
5,54,kaist_dataset/Mixed/Digital_Camera/(C.S)C-outdoor1/025.JPG,char_data/5/025.JPG_0.jpg,1296,24,259,283,337,391,True,7
5,56,kaist_dataset/Mixed/Digital_Camera/(C.S)C-outdoor1/025.JPG,char_data/5/025.JPG_0.jpg,1680,30,311,341,337,393,True,7
5,48,kaist_dataset/Mixed/Digital_Camera/(C.S)C-outdoor1/025.JPG,char_data/5/025.JPG_0.jpg,1296,27,510,537,342,390,True,7
5,63,kaist_dataset/Mixed/Digital_Camera/(C.S)C-outdoor1/025.JPG,char_data/5/025.JPG_0.jpg,2205,35,562,597,336,399,True,7
5,38,kaist_dataset/Mixed/Digital_Camera/(C.S)C-outdoor1/DSC02320.JPG,char_data/5/DSC02320.JPG_0.jpg,874,23,504,527,351,389,True,7
5,41,kaist_dataset/Mixed/Digital_Camera/(C.S)C-outdoor1/2.JPG,char_data/5/2.JPG_0.jpg,820,20,421,441,65,106,True,7
5,42,kaist_dataset/Mixed/Digital_Camera/(C.S)C-outdoor1/DSC02325.JPG,char_data/5/DSC02325.JPG_0.jpg,840,20,369,389,304,346,True,7
5,63,kaist_dataset/Mixed/Digital_Camera/(C.S)C-outdoor1/2007-12-08-day-091.jpg,char_data/5/2007-12-08-day-091.jpg_0.jpg,2898,46,1356,1402,622,685,True,7
5,30,kaist_dataset/Mixed/Digital_Camera/(C.S)C-outdoor1/090.JPG,char_data/5/090.JPG_0.jpg,570,19,417,436,395,425,True,7
5,36,kaist_dataset/Mixed/Digital_Camera/(C.S)F-others/DSC02504.JPG,char_data/5/DSC02504.JPG_0.jpg,1044,29,486,515,386,422,True,7
5,46,kaist_dataset/Mixed/Digital_Camera/(C.S)F-others/DSC02799.JPG,char_data/5/DSC02799.JPG_0.jpg,966,21,63,84,393,439,True,7
5,50,kaist_dataset/Mixed/Digital_Camera/(C.S)F-others/2007-12-08-day-113.jpg,char_data/5/2007-12-08-day-113.jpg_0.jpg,950,19,944,963,426,476,True,7
5,85,kaist_dataset/Mixed/Digital_Camera/(C.S)F-others/DSC03224.JPG,char_data/5/DSC03224.JPG_0.jpg,4420,52,376,428,204,289,True,7
5,45,kaist_dataset/Mixed/Digital_Camera/(C.S)F-others/DSC02893.JPG,char_data/5/DSC02893.JPG_0.jpg,1710,38,330,368,334,379,True,7
5,49,kaist_dataset/Mixed/Digital_Camera/(C.S)F-others/2007-12-09-day-exterior-023.jpg,char_data/5/2007-12-09-day-exterior-023.jpg_0.jpg,1568,32,1051,1083,597,646,True,7
5,62,kaist_dataset/Mixed/Digital_Camera/(C.S)F-others/DSC02800.JPG,char_data/5/DSC02800.JPG_0.jpg,1922,31,41,72,267,329,True,7
5,86,kaist_dataset/Mixed/Digital_Camera/(C.S)D-indoor2/DSC04249.JPG,char_data/5/DSC04249.JPG_0.jpg,6536,76,190,266,88,174,True,7
5,51,kaist_dataset/Mixed/Digital_Camera/(C.S)D-indoor2/DSC04249.JPG,char_data/5/DSC04249.JPG_0.jpg,2091,41,450,491,213,264,True,7
5,26,kaist_dataset/Mixed/Digital_Camera/(C.S)E-night/P1010155.JPG,char_data/5/P1010155.JPG_0.jpg,286,11,505,516,284,310,True,7
5,31,kaist_dataset/Mixed/Digital_Camera/(C.S)E-night/DSC02660.JPG,char_data/5/DSC02660.JPG_0.jpg,775,25,286,311,418,449,True,7
5,32,kaist_dataset/Mixed/Digital_Camera/(C.S)E-night/DSC02585.JPG,char_data/5/DSC02585.JPG_0.jpg,416,13,408,421,419,451,True,7
5,36,kaist_dataset/Mixed/Digital_Camera/(C.S)E-night/DSC03031.JPG,char_data/5/DSC03031.JPG_0.jpg,864,24,80,104,20,56,True,7
5,26,kaist_dataset/Mixed/Digital_Camera/(C.S)E-night/DSC03840.JPG,char_data/5/DSC03840.JPG_0.jpg,338,13,489,502,211,237,True,7
5,30,kaist_dataset/Mixed/Digital_Camera/(C.S)E-night/DSC02644.JPG,char_data/5/DSC02644.JPG_0.jpg,570,19,376,395,404,434,True,7
5,29,kaist_dataset/Mixed/Digital_Camera/(C.S)E-night/DSC02673.JPG,char_data/5/DSC02673.JPG_0.jpg,609,21,377,398,304,333,True,7
5,31,kaist_dataset/Mixed/Digital_Camera/(C.S)E-night/DSC02623.JPG,char_data/5/DSC02623.JPG_0.jpg,527,17,164,181,401,432,True,7
5,32,kaist_dataset/Mixed/Digital_Camera/(C.S)E-night/DSC02623.JPG,char_data/5/DSC02623.JPG_0.jpg,704,22,198,220,400,432,True,7
5,28,kaist_dataset/Mixed/Digital_Camera/(C.S)E-night/DSC02903.JPG,char_data/5/DSC02903.JPG_0.jpg,420,15,396,411,270,298,True,7
5,70,kaist_dataset/Mixed/Digital_Camera/(C.S)E-night/DSC02573.JPG,char_data/5/DSC02573.JPG_0.jpg,2660,38,481,519,146,216,True,7
5,37,kaist_dataset/Mixed/Digital_Camera/(C.S)B-light/DSC03298.JPG,char_data/5/DSC03298.JPG_0.jpg,740,20,453,473,288,325,True,7
5,25,kaist_dataset/Mixed/Digital_Camera/(C.S)D-indoor1/DSC04005.JPG,char_data/5/DSC04005.JPG_0.jpg,450,18,472,490,438,463,True,7
5,68,kaist_dataset/Mixed/Digital_Camera/(C.S)D-indoor1/DSC03998.JPG,char_data/5/DSC03998.JPG_0.jpg,2380,35,412,447,411,479,True,7
5,63,kaist_dataset/Mixed/Digital_Camera/(C.S)D-indoor1/DSC03998.JPG,char_data/5/DSC03998.JPG_0.jpg,2079,33,515,548,416,479,True,7
5,123,kaist_dataset/Mixed/Digital_Camera/(C.S)D-indoor1/DSC03455.JPG,char_data/5/DSC03455.JPG_0.jpg,16236,132,361,493,93,216,True,7
5,53,kaist_dataset/Mixed/Digital_Camera/(C.S)D-indoor1/DSC02801.JPG,char_data/5/DSC02801.JPG_0.jpg,2120,40,21,61,271,324,True,7
5,108,kaist_dataset/Mixed/Digital_Camera/(C.S)D-indoor1/DSC04002.JPG,char_data/5/DSC04002.JPG_0.jpg,7128,66,194,260,344,452,True,7
5,99,kaist_dataset/Mixed/Digital_Camera/(C.S)D-indoor1/DSC04002.JPG,char_data/5/DSC04002.JPG_0.jpg,5841,59,387,446,346,445,True,7
5,54,kaist_dataset/Mixed/Digital_Camera/(C.S)D-indoor1/DSC02802.JPG,char_data/5/DSC02802.JPG_0.jpg,1944,36,23,59,267,321,True,7
5,53,kaist_dataset/Mixed/Digital_Camera/(C.S)D-indoor1/DSC03986.JPG,char_data/5/DSC03986.JPG_0.jpg,954,18,437,455,158,211,True,7
5,51,kaist_dataset/Mixed/Digital_Camera/(C.S)D-indoor1/DSC02733.JPG,char_data/5/DSC02733.JPG_0.jpg,1632,32,345,377,390,441,True,7
5,51,kaist_dataset/Mixed/Digital_Camera/(C.S)D-indoor1/DSC02797.JPG,char_data/5/DSC02797.JPG_0.jpg,1836,36,73,109,278,329,True,7
5,88,kaist_dataset/Mixed/Digital_Camera/(C.S)C-outdoor5/DSC04111.JPG,char_data/5/DSC04111.JPG_0.jpg,5280,60,525,585,97,185,True,7
5,167,kaist_dataset/Mixed/Digital_Camera/(C.S)C-outdoor5/DSC04451.JPG,char_data/5/DSC04451.JPG_0.jpg,16032,96,29,125,284,451,True,7
5,37,kaist_dataset/Mixed/Digital_Camera/(C.S)C-outdoor5/DSC03839.JPG,char_data/5/DSC03839.JPG_0.jpg,555,15,272,287,363,400,True,7
5,36,kaist_dataset/Mixed/Digital_Camera/(C.S)C-outdoor5/DSC04330.JPG,char_data/5/DSC04330.JPG_0.jpg,936,26,325,351,184,220,True,7
5,53,kaist_dataset/Mixed/Digital_Camera/(C.S)C-outdoor5/DSC04330.JPG,char_data/5/DSC04330.JPG_0.jpg,1219,23,418,441,365,418,True,7
5,26,kaist_dataset/Mixed/Digital_Camera/(C.S)C-outdoor5/DSC04357.JPG,char_data/5/DSC04357.JPG_0.jpg,416,16,185,201,382,408,True,7
5,74,kaist_dataset/Mixed/Digital_Camera/(C.S)C-outdoor5/DSC04016.JPG,char_data/5/DSC04016.JPG_0.jpg,2886,39,207,246,318,392,True,7
5,65,kaist_dataset/Mixed/Digital_Camera/(C.S)C-outdoor5/DSC04364.JPG,char_data/5/DSC04364.JPG_0.jpg,2470,38,326,364,392,457,True,7
5,41,kaist_dataset/Mixed/Digital_Camera/(C.S)C-outdoor5/DSC04140.JPG,char_data/5/DSC04140.JPG_0.jpg,492,12,530,542,343,384,True,7
5,38,kaist_dataset/Mixed/Digital_Camera/(C.S)C-outdoor5/DSC04122.JPG,char_data/5/DSC04122.JPG_0.jpg,570,15,440,455,411,449,True,7
5,29,kaist_dataset/Mixed/Digital_Camera/(C.S)C-outdoor5/DSC04124.JPG,char_data/5/DSC04124.JPG_0.jpg,464,16,477,493,308,337,True,7
5,68,kaist_dataset/Mixed/Digital_Camera/(C.S)C-outdoor5/DSC04401.JPG,char_data/5/DSC04401.JPG_0.jpg,2176,32,599,631,243,311,True,7
5,40,kaist_dataset/Mixed/Digital_Camera/(C.S)C-outdoor5/DSC04014.JPG,char_data/5/DSC04014.JPG_0.jpg,840,21,282,303,300,340,True,7
5,35,kaist_dataset/Mixed/Digital_Camera/(C.S)C-outdoor5/DSC04014.JPG,char_data/5/DSC04014.JPG_0.jpg,700,20,321,341,303,338,True,7
5,40,kaist_dataset/Mixed/Digital_Camera/(C.S)C-outdoor5/DSC04125.JPG,char_data/5/DSC04125.JPG_0.jpg,840,21,167,188,180,220,True,7
5,41,kaist_dataset/Mixed/Digital_Camera/(C.S)C-outdoor5/DSC04125.JPG,char_data/5/DSC04125.JPG_0.jpg,738,18,535,553,414,455,True,7
5,40,kaist_dataset/Mixed/Digital_Camera/(C.S)C-outdoor5/DSC04070.JPG,char_data/5/DSC04070.JPG_0.jpg,720,18,489,507,103,143,True,7
5,40,kaist_dataset/Mixed/Digital_Camera/(C.S)C-outdoor5/DSC04070.JPG,char_data/5/DSC04070.JPG_0.jpg,720,18,525,543,102,142,True,7
5,68,kaist_dataset/Mixed/Digital_Camera/(C.S)C-outdoor5/DSC04450.JPG,char_data/5/DSC04450.JPG_0.jpg,2924,43,306,349,131,199,True,7
5,30,kaist_dataset/Mixed/Digital_Camera/(C.S)C-outdoor5/DSC04150.JPG,char_data/5/DSC04150.JPG_0.jpg,450,15,583,598,364,394,True,7
5,43,kaist_dataset/Mixed/Digital_Camera/(C.S)C-outdoor5/DSC04139.JPG,char_data/5/DSC04139.JPG_0.jpg,731,17,310,327,394,437,True,7
5,48,kaist_dataset/Mixed/Digital_Camera/(C.S)C-outdoor5/DSC04115.JPG,char_data/5/DSC04115.JPG_0.jpg,1488,31,485,516,353,401,True,7
5,26,kaist_dataset/Mixed/Digital_Camera/(C.S)C-outdoor3/DSC03292.JPG,char_data/5/DSC03292.JPG_0.jpg,364,14,526,540,119,145,True,7
5,59,kaist_dataset/Mixed/Digital_Camera/(C.S)C-outdoor3/DSC03177.JPG,char_data/5/DSC03177.JPG_0.jpg,1888,32,140,172,193,252,True,7
5,24,kaist_dataset/Mixed/Digital_Camera/(C.S)C-outdoor3/DSC03303.JPG,char_data/5/DSC03303.JPG_0.jpg,600,25,348,373,279,303,True,7
5,26,kaist_dataset/Mixed/Digital_Camera/(C.S)C-outdoor3/DSC03303.JPG,char_data/5/DSC03303.JPG_0.jpg,624,24,400,424,278,304,True,7
5,37,kaist_dataset/Mixed/Digital_Camera/(C.S)C-outdoor3/DSC03312.JPG,char_data/5/DSC03312.JPG_0.jpg,1147,31,274,305,282,319,True,7
5,42,kaist_dataset/Mixed/Digital_Camera/(C.S)C-outdoor3/DSC03312.JPG,char_data/5/DSC03312.JPG_0.jpg,1344,32,311,343,279,321,True,7
5,24,kaist_dataset/Mixed/Digital_Camera/(C.S)C-outdoor3/DSC03255.JPG,char_data/5/DSC03255.JPG_0.jpg,600,25,269,294,184,208,True,7
5,32,kaist_dataset/Mixed/Digital_Camera/(C.S)C-outdoor3/DSC03255.JPG,char_data/5/DSC03255.JPG_0.jpg,608,19,295,314,180,212,True,7
5,41,kaist_dataset/Mixed/Digital_Camera/(C.S)C-outdoor3/DSC02970.JPG,char_data/5/DSC02970.JPG_0.jpg,1189,29,469,498,360,401,True,7
5,46,kaist_dataset/Mixed/Digital_Camera/(C.S)C-outdoor3/DSC03212.JPG,char_data/5/DSC03212.JPG_0.jpg,920,20,354,374,250,296,True,7
5,34,kaist_dataset/Mixed/Digital_Camera/(C.S)C-outdoor3/DSC03328.JPG,char_data/5/DSC03328.JPG_0.jpg,544,16,174,190,401,435,True,7
5,39,kaist_dataset/Mixed/Digital_Camera/(C.S)C-outdoor3/DSC03328.JPG,char_data/5/DSC03328.JPG_0.jpg,663,17,355,372,398,437,True,7
5,48,kaist_dataset/Mixed/Digital_Camera/(C.S)C-outdoor3/DSC03236.JPG,char_data/5/DSC03236.JPG_0.jpg,1344,28,359,387,418,466,True,7
5,35,kaist_dataset/Mixed/Digital_Camera/(C.S)C-outdoor3/DSC03301.JPG,char_data/5/DSC03301.JPG_0.jpg,700,20,421,441,140,175,True,7
5,36,kaist_dataset/Mixed/Digital_Camera/(C.S)C-outdoor3/DSC02956.JPG,char_data/5/DSC02956.JPG_0.jpg,792,22,178,200,392,428,True,7
5,36,kaist_dataset/Mixed/Digital_Camera/(C.S)C-outdoor3/DSC02956.JPG,char_data/5/DSC02956.JPG_0.jpg,576,16,201,217,392,428,True,7
5,76,kaist_dataset/Mixed/Digital_Camera/(C.S)C-outdoor3/DSC03063.JPG,char_data/5/DSC03063.JPG_0.jpg,5396,71,333,404,207,283,True,7
5,49,kaist_dataset/Mixed/Digital_Camera/(C.S)C-outdoor3/DSC03063.JPG,char_data/5/DSC03063.JPG_0.jpg,1519,31,334,365,288,337,True,7
5,39,kaist_dataset/Mixed/Digital_Camera/(C.S)C-outdoor3/DSC03185.JPG,char_data/5/DSC03185.JPG_0.jpg,1638,42,472,514,161,200,True,7
5,65,kaist_dataset/Mixed/Digital_Camera/(C.S)C-outdoor3/DSC03067.JPG,char_data/5/DSC03067.JPG_0.jpg,2210,34,170,204,195,260,True,7
5,32,kaist_dataset/Mixed/Digital_Camera/(C.S)C-outdoor3/DSC03017.JPG,char_data/5/DSC03017.JPG_0.jpg,448,14,468,482,243,275,True,7
5,33,kaist_dataset/Mixed/Digital_Camera/(C.S)C-outdoor3/DSC03017.JPG,char_data/5/DSC03017.JPG_0.jpg,660,20,482,502,245,278,True,7
5,59,kaist_dataset/Mixed/Digital_Camera/(C.S)C-outdoor3/DSC03274.JPG,char_data/5/DSC03274.JPG_0.jpg,2478,42,429,471,364,423,True,7
5,28,kaist_dataset/Mixed/Digital_Camera/(C.S)C-outdoor6/P1010082.JPG,char_data/5/P1010082.JPG_0.jpg,616,22,217,239,231,259,True,7
5,30,kaist_dataset/Mixed/Digital_Camera/(C.S)C-outdoor6/P1010082.JPG,char_data/5/P1010082.JPG_0.jpg,450,15,287,302,230,260,True,7
5,28,kaist_dataset/Mixed/Digital_Camera/(C.S)C-outdoor6/P1010075.JPG,char_data/5/P1010075.JPG_0.jpg,504,18,467,485,316,344,True,7
5,31,kaist_dataset/Mixed/Digital_Camera/(C.S)C-outdoor6/P1010075.JPG,char_data/5/P1010075.JPG_0.jpg,496,16,501,517,311,342,True,7
5,26,kaist_dataset/Mixed/Digital_Camera/(C.S)C-outdoor6/DSC03324.JPG,char_data/5/DSC03324.JPG_0.jpg,364,14,422,436,154,180,True,7
5,25,kaist_dataset/Mixed/Digital_Camera/(C.S)C-outdoor6/DSC03324.JPG,char_data/5/DSC03324.JPG_0.jpg,350,14,478,492,154,179,True,7
5,25,kaist_dataset/Mixed/Digital_Camera/(C.S)C-outdoor6/P1010099.JPG,char_data/5/P1010099.JPG_0.jpg,350,14,515,529,209,234,True,7
5,28,kaist_dataset/Mixed/Digital_Camera/(C.S)C-outdoor6/P1010069.JPG,char_data/5/P1010069.JPG_0.jpg,728,26,529,555,314,342,True,7
5,31,kaist_dataset/Mixed/Digital_Camera/(C.S)C-outdoor6/P1010069.JPG,char_data/5/P1010069.JPG_0.jpg,837,27,556,583,313,344,True,7
5,25,kaist_dataset/Mixed/Digital_Camera/(C.S)C-outdoor6/P1010094.JPG,char_data/5/P1010094.JPG_0.jpg,700,28,599,627,219,244,True,7
5,28,kaist_dataset/Mixed/Digital_Camera/(C.S)C-outdoor6/P1010088.JPG,char_data/5/P1010088.JPG_0.jpg,476,17,358,375,218,246,True,7
5,37,kaist_dataset/Mixed/Digital_Camera/(C.S)C-outdoor6/P1010120.JPG,char_data/5/P1010120.JPG_0.jpg,999,27,475,502,190,227,True,7
5,30,kaist_dataset/Mixed/Digital_Camera/(C.S)C-outdoor6/P1010020.JPG,char_data/5/P1010020.JPG_0.jpg,750,25,264,289,233,263,True,7
5,29,kaist_dataset/Mixed/Digital_Camera/(C.S)C-outdoor6/P1010111.JPG,char_data/5/P1010111.JPG_0.jpg,551,19,324,343,343,372,True,7
5,39,kaist_dataset/Mixed/Digital_Camera/(C.S)C-outdoor6/P1010111.JPG,char_data/5/P1010111.JPG_0.jpg,1326,34,457,491,205,244,True,7
5,32,kaist_dataset/Mixed/Digital_Camera/(C.S)C-outdoor6/P1010080.JPG,char_data/5/P1010080.JPG_0.jpg,768,24,517,541,248,280,True,7
5,32,kaist_dataset/Mixed/Digital_Camera/(C.S)C-outdoor6/P1010138.JPG,char_data/5/P1010138.JPG_0.jpg,736,23,438,461,183,215,True,7
5,51,kaist_dataset/Mixed/Digital_Camera/(C.S)C-outdoor6/P1010021.JPG,char_data/5/P1010021.JPG_0.jpg,1428,28,166,194,209,260,True,7
5,35,kaist_dataset/Mixed/Digital_Camera/(C.S)C-outdoor6/P1010021.JPG,char_data/5/P1010021.JPG_0.jpg,875,25,613,638,206,241,True,7
5,48,kaist_dataset/Mixed/Digital_Camera/(C.S)C-outdoor6/P1010084.JPG,char_data/5/P1010084.JPG_0.jpg,1824,38,454,492,188,236,True,7
5,23,kaist_dataset/Mixed/Digital_Camera/(C.S)C-outdoor6/P1010129.JPG,char_data/5/P1010129.JPG_0.jpg,345,15,415,430,237,260,True,7
5,27,kaist_dataset/Mixed/Digital_Camera/(C.S)C-outdoor6/P1010114.JPG,char_data/5/P1010114.JPG_0.jpg,756,28,581,609,216,243,True,7
5,35,kaist_dataset/Mixed/Digital_Camera/(C.S)C-outdoor6/P1010056.JPG,char_data/5/P1010056.JPG_0.jpg,735,21,381,402,231,266,True,7
5,65,kaist_dataset/Mixed/Digital_Camera/(C.S)C-outdoor6/P1010030.JPG,char_data/5/P1010030.JPG_0.jpg,3185,49,40,89,395,460,True,7
5,28,kaist_dataset/Mixed/Digital_Camera/(C.S)C-outdoor6/P1010097.JPG,char_data/5/P1010097.JPG_0.jpg,560,20,84,104,182,210,True,7
5,29,kaist_dataset/Mixed/Digital_Camera/(C.S)C-outdoor6/P1010097.JPG,char_data/5/P1010097.JPG_0.jpg,551,19,453,472,184,213,True,7
5,33,kaist_dataset/Mixed/Digital_Camera/(C.S)C-outdoor4/DSC03730.JPG,char_data/5/DSC03730.JPG_0.jpg,759,23,408,431,254,287,True,7
5,33,kaist_dataset/Mixed/Digital_Camera/(C.S)C-outdoor4/DSC03730.JPG,char_data/5/DSC03730.JPG_0.jpg,759,23,430,453,251,284,True,7
5,47,kaist_dataset/Mixed/Digital_Camera/(C.S)C-outdoor4/DSC03633.JPG,char_data/5/DSC03633.JPG_0.jpg,1316,28,286,314,266,313,True,7
5,43,kaist_dataset/Mixed/Digital_Camera/(C.S)C-outdoor4/DSC03633.JPG,char_data/5/DSC03633.JPG_0.jpg,1118,26,315,341,267,310,True,7
5,29,kaist_dataset/Mixed/Digital_Camera/(C.S)C-outdoor4/DSC03719.JPG,char_data/5/DSC03719.JPG_0.jpg,464,16,543,559,182,211,True,7
5,42,kaist_dataset/Mixed/Digital_Camera/(C.S)C-outdoor4/DSC03738.JPG,char_data/5/DSC03738.JPG_0.jpg,1428,34,462,496,238,280,True,7
5,30,kaist_dataset/Mixed/Digital_Camera/(C.S)C-outdoor4/DSC03604.JPG,char_data/5/DSC03604.JPG_0.jpg,600,20,293,313,144,174,True,7
5,29,kaist_dataset/Mixed/Digital_Camera/(C.S)C-outdoor4/DSC03570.JPG,char_data/5/DSC03570.JPG_0.jpg,522,18,342,360,423,452,True,7
5,32,kaist_dataset/Mixed/Digital_Camera/(C.S)C-outdoor4/DSC03570.JPG,char_data/5/DSC03570.JPG_0.jpg,544,17,375,392,424,456,True,7
5,76,kaist_dataset/Mixed/Digital_Camera/(C.S)C-outdoor4/DSC03702.JPG,char_data/5/DSC03702.JPG_0.jpg,3496,46,174,220,327,403,True,7
5,30,kaist_dataset/Mixed/Digital_Camera/(C.S)C-outdoor4/DSC03616.JPG,char_data/5/DSC03616.JPG_0.jpg,630,21,586,607,156,186,True,7
5,38,kaist_dataset/Mixed/Digital_Camera/(C.S)C-outdoor4/DSC03677.JPG,char_data/5/DSC03677.JPG_0.jpg,418,11,609,620,310,348,True,7
5,38,kaist_dataset/Mixed/Digital_Camera/(C.S)C-outdoor4/DSC03677.JPG,char_data/5/DSC03677.JPG_0.jpg,456,12,630,642,306,344,True,7
5,34,kaist_dataset/Mixed/Digital_Camera/(C.S)C-outdoor4/DSC03642.JPG,char_data/5/DSC03642.JPG_0.jpg,714,21,550,571,397,431,True,7
5,51,kaist_dataset/Mixed/Digital_Camera/(C.S)C-outdoor4/DSC03693.JPG,char_data/5/DSC03693.JPG_0.jpg,1122,22,509,531,350,401,True,7
5,34,kaist_dataset/Mixed/Digital_Camera/(C.S)C-outdoor4/DSC03658.JPG,char_data/5/DSC03658.JPG_0.jpg,646,19,337,356,415,449,False,7
5,28,kaist_dataset/Mixed/Digital_Camera/(C.S)C-outdoor4/DSC03552.JPG,char_data/5/DSC03552.JPG_0.jpg,392,14,388,402,320,348,False,7
5,90,kaist_dataset/Mixed/Digital_Camera/(C.S)C-outdoor4/DSC03544.JPG,char_data/5/DSC03544.JPG_0.jpg,3240,36,431,467,168,258,False,7
5,30,kaist_dataset/Mixed/Digital_Camera/(C.S)C-outdoor4/DSC03640.JPG,char_data/5/DSC03640.JPG_0.jpg,600,20,269,289,398,428,False,7
5,27,kaist_dataset/Mixed/Digital_Camera/(C.S)C-outdoor4/DSC03640.JPG,char_data/5/DSC03640.JPG_0.jpg,540,20,289,309,398,425,False,7
5,33,kaist_dataset/Mixed/Digital_Camera/(C.S)C-outdoor4/DSC03675.JPG,char_data/5/DSC03675.JPG_0.jpg,924,28,575,603,345,378,False,7
5,33,kaist_dataset/Mixed/Digital_Camera/(C.S)C-outdoor4/DSC03661.JPG,char_data/5/DSC03661.JPG_0.jpg,693,21,501,522,329,362,False,7
5,36,kaist_dataset/Mixed/Digital_Camera/(C.S)C-outdoor4/DSC03661.JPG,char_data/5/DSC03661.JPG_0.jpg,720,20,559,579,328,364,False,7
5,31,kaist_dataset/Mixed/Digital_Camera/(C.S)C-outdoor4/DSC03691.JPG,char_data/5/DSC03691.JPG_0.jpg,589,19,561,580,221,252,False,7
5,39,kaist_dataset/Mixed/Digital_Camera/(C.S)C-outdoor4/DSC03618.JPG,char_data/5/DSC03618.JPG_0.jpg,1092,28,407,435,409,448,False,7
5,44,kaist_dataset/Mixed/Digital_Camera/(C.S)C-outdoor4/DSC03534.JPG,char_data/5/DSC03534.JPG_0.jpg,1276,29,290,319,287,331,False,7
5,31,kaist_dataset/Mixed/Digital_Camera/(C.S)C-outdoor4/DSC03718.JPG,char_data/5/DSC03718.JPG_0.jpg,527,17,535,552,405,436,False,7
5,35,kaist_dataset/Mixed/Digital_Camera/(C.S)C-outdoor4/DSC03745.JPG,char_data/5/DSC03745.JPG_0.jpg,875,25,227,252,272,307,False,7
5,33,kaist_dataset/Mixed/Digital_Camera/(C.S)C-outdoor4/DSC03745.JPG,char_data/5/DSC03745.JPG_0.jpg,561,17,577,594,274,307,False,7
5,44,kaist_dataset/Mixed/Digital_Camera/(C.S)C-outdoor4/DSC03631.JPG,char_data/5/DSC03631.JPG_0.jpg,1276,29,144,173,354,398,False,7
5,43,kaist_dataset/Mixed/Digital_Camera/(C.S)C-outdoor4/DSC03631.JPG,char_data/5/DSC03631.JPG_0.jpg,1376,32,261,293,355,398,False,7
5,43,kaist_dataset/Mixed/Digital_Camera/(C.S)C-outdoor4/DSC03631.JPG,char_data/5/DSC03631.JPG_0.jpg,1290,30,348,378,355,398,False,7
5,41,kaist_dataset/Mixed/Digital_Camera/(C.S)C-outdoor4/DSC03781.JPG,char_data/5/DSC03781.JPG_0.jpg,1312,32,354,386,378,419,False,7
5,27,kaist_dataset/Mixed/Digital_Camera/(C.S)C-outdoor4/DSC03737.JPG,char_data/5/DSC03737.JPG_0.jpg,513,19,231,250,166,193,False,7
5,30,kaist_dataset/Mixed/Digital_Camera/(C.S)C-outdoor4/DSC03737.JPG,char_data/5/DSC03737.JPG_0.jpg,570,19,400,419,169,199,False,7
5,32,kaist_dataset/Mixed/Digital_Camera/(C.S)C-outdoor4/DSC03737.JPG,char_data/5/DSC03737.JPG_0.jpg,736,23,456,479,173,205,False,7
5,47,kaist_dataset/Mixed/Digital_Camera/(C.S)C-outdoor4/DSC03655.JPG,char_data/5/DSC03655.JPG_0.jpg,1316,28,523,551,390,437,False,7
5,30,kaist_dataset/Mixed/Digital_Camera/(C.S)C-outdoor4/DSC03734.JPG,char_data/5/DSC03734.JPG_0.jpg,390,13,550,563,349,379,False,7
5,35,kaist_dataset/Mixed/Digital_Camera/(C.S)C-outdoor4/DSC03734.JPG,char_data/5/DSC03734.JPG_0.jpg,350,10,564,574,346,381,False,7
5,28,kaist_dataset/Mixed/Digital_Camera/(C.S)C-outdoor4/DSC03734.JPG,char_data/5/DSC03734.JPG_0.jpg,364,13,573,586,350,378,False,7
5,40,kaist_dataset/Mixed/Digital_Camera/(C.S)C-outdoor4/DSC03732.JPG,char_data/5/DSC03732.JPG_0.jpg,1080,27,416,443,391,431,False,7
5,41,kaist_dataset/Mixed/Digital_Camera/(C.S)C-outdoor4/DSC03732.JPG,char_data/5/DSC03732.JPG_0.jpg,1066,26,443,469,389,430,False,7
5,25,kaist_dataset/Mixed/Digital_Camera/(C.S)C-outdoor4/DSC03643.JPG,char_data/5/DSC03643.JPG_0.jpg,450,18,577,595,329,354,False,7
5,28,kaist_dataset/Mixed/Digital_Camera/(C.S)C-outdoor4/DSC03673.JPG,char_data/5/DSC03673.JPG_0.jpg,588,21,198,219,310,338,False,7
5,28,kaist_dataset/Mixed/Digital_Camera/(C.S)C-outdoor4/DSC03723.JPG,char_data/5/DSC03723.JPG_0.jpg,504,18,439,457,196,224,False,7
5,28,kaist_dataset/Mixed/Digital_Camera/(C.S)C-outdoor4/DSC03723.JPG,char_data/5/DSC03723.JPG_0.jpg,588,21,519,540,198,226,False,7
5,37,kaist_dataset/Mixed/Digital_Camera/(C.S)C-outdoor4/DSC03556.JPG,char_data/5/DSC03556.JPG_0.jpg,666,18,570,588,260,297,False,7
5,37,kaist_dataset/Mixed/Digital_Camera/(C.S)C-outdoor4/DSC03556.JPG,char_data/5/DSC03556.JPG_0.jpg,518,14,54,68,316,353,False,7
5,28,kaist_dataset/Mixed/Digital_Camera/(C.S)C-outdoor4/DSC03634.JPG,char_data/5/DSC03634.JPG_0.jpg,644,23,427,450,429,457,False,7
5,34,kaist_dataset/Mixed/Digital_Camera/(C.S)C-outdoor4/DSC03634.JPG,char_data/5/DSC03634.JPG_0.jpg,816,24,506,530,424,458,False,7
5,37,kaist_dataset/Mixed/Digital_Camera/(C.S)C-outdoor4/DSC03634.JPG,char_data/5/DSC03634.JPG_0.jpg,740,20,551,571,425,462,False,7
5,35,kaist_dataset/Mixed/Digital_Camera/(C.S)C-outdoor4/DSC03634.JPG,char_data/5/DSC03634.JPG_0.jpg,945,27,324,351,243,278,False,7
5,84,kaist_dataset/Mixed/Digital_Camera/(C.S)C-outdoor4/DSC03634.JPG,char_data/5/DSC03634.JPG_0.jpg,6048,72,255,327,272,356,False,7
5,59,kaist_dataset/Mixed/Digital_Camera/(C.S)C-outdoor4/DSC03662.JPG,char_data/5/DSC03662.JPG_0.jpg,1534,26,579,605,411,470,False,7
5,31,kaist_dataset/Mixed/Digital_Camera/(C.S)C-outdoor4/DSC03757.JPG,char_data/5/DSC03757.JPG_0.jpg,434,14,266,280,337,368,False,7
5,29,kaist_dataset/Mixed/Digital_Camera/(C.S)C-outdoor4/DSC03757.JPG,char_data/5/DSC03757.JPG_0.jpg,377,13,304,317,341,370,False,7
5,33,kaist_dataset/Mixed/Digital_Camera/(C.S)C-outdoor4/DSC03757.JPG,char_data/5/DSC03757.JPG_0.jpg,396,12,452,464,339,372,False,7
5,29,kaist_dataset/Mixed/Digital_Camera/(C.S)C-outdoor4/DSC03757.JPG,char_data/5/DSC03757.JPG_0.jpg,348,12,478,490,339,368,False,7
5,39,kaist_dataset/Mixed/Digital_Camera/(C.S)C-outdoor4/DSC03667.JPG,char_data/5/DSC03667.JPG_0.jpg,663,17,440,457,373,412,False,7
5,56,kaist_dataset/Mixed/Digital_Camera/(C.S)C-outdoor4/DSC03621.JPG,char_data/5/DSC03621.JPG_0.jpg,1344,24,464,488,330,386,False,7
5,26,kaist_dataset/Mixed/Digital_Camera/(C.S)C-outdoor4/DSC03687.JPG,char_data/5/DSC03687.JPG_0.jpg,312,12,515,527,403,429,False,7
5,40,kaist_dataset/Mixed/Digital_Camera/(C.S)C-outdoor4/DSC03735.JPG,char_data/5/DSC03735.JPG_0.jpg,760,19,535,554,149,189,False,7
5,40,kaist_dataset/Mixed/Digital_Camera/(C.S)C-outdoor4/DSC03735.JPG,char_data/5/DSC03735.JPG_0.jpg,560,14,555,569,144,184,False,7
5,27,kaist_dataset/Mixed/Digital_Camera/(C.S)C-outdoor4/DSC03670.JPG,char_data/5/DSC03670.JPG_0.jpg,243,9,481,490,450,477,False,7
5,24,kaist_dataset/Mixed/Digital_Camera/(C.S)C-outdoor4/DSC03670.JPG,char_data/5/DSC03670.JPG_0.jpg,192,8,490,498,450,474,False,7
5,100,kaist_dataset/Mixed/Digital_Camera/(C.S)C-outdoor2/DSC02865.JPG,char_data/5/DSC02865.JPG_0.jpg,6200,62,103,165,299,399,False,7
5,33,kaist_dataset/Mixed/Digital_Camera/(C.S)C-outdoor2/DSC02492.JPG,char_data/5/DSC02492.JPG_0.jpg,627,19,465,484,323,356,False,7
5,32,kaist_dataset/Mixed/Digital_Camera/(C.S)C-outdoor2/DSC02447.JPG,char_data/5/DSC02447.JPG_0.jpg,416,13,543,556,226,258,False,7
5,33,kaist_dataset/Mixed/Digital_Camera/(C.S)C-outdoor2/DSC02447.JPG,char_data/5/DSC02447.JPG_0.jpg,429,13,557,570,225,258,False,7
5,29,kaist_dataset/Mixed/Digital_Camera/(C.S)C-outdoor2/DSC02555.JPG,char_data/5/DSC02555.JPG_0.jpg,609,21,155,176,249,278,False,7
5,23,kaist_dataset/Mixed/Digital_Camera/(C.S)C-outdoor2/DSC02477.JPG,char_data/5/DSC02477.JPG_0.jpg,460,20,134,154,255,278,False,7
5,41,kaist_dataset/Mixed/Digital_Camera/(C.S)C-outdoor2/DSC02361.JPG,char_data/5/DSC02361.JPG_0.jpg,656,16,575,591,373,414,False,7
5,42,kaist_dataset/Mixed/Digital_Camera/(C.S)C-outdoor2/DSC02361.JPG,char_data/5/DSC02361.JPG_0.jpg,924,22,607,629,374,416,False,7
5,56,kaist_dataset/Mixed/Digital_Camera/(C.S)C-outdoor2/DSC02400.JPG,char_data/5/DSC02400.JPG_0.jpg,2016,36,243,279,397,453,False,7
5,42,kaist_dataset/Mixed/Digital_Camera/(C.S)C-outdoor2/DSC02411.JPG,char_data/5/DSC02411.JPG_0.jpg,882,21,508,529,345,387,False,7
5,41,kaist_dataset/Mixed/Digital_Camera/(C.S)C-outdoor2/DSC02411.JPG,char_data/5/DSC02411.JPG_0.jpg,1107,27,529,556,345,386,False,7
5,50,kaist_dataset/Mixed/Digital_Camera/(C.S)C-outdoor2/DSC02374.JPG,char_data/5/DSC02374.JPG_0.jpg,1750,35,411,446,287,337,False,7
5,32,kaist_dataset/Mixed/Digital_Camera/(C.S)C-outdoor2/DSC02887.JPG,char_data/5/DSC02887.JPG_0.jpg,704,22,315,337,121,153,False,7
5,34,kaist_dataset/Mixed/Digital_Camera/(C.S)C-outdoor2/DSC02368.JPG,char_data/5/DSC02368.JPG_0.jpg,442,13,199,212,384,418,False,7
5,35,kaist_dataset/Mixed/Digital_Camera/(C.S)C-outdoor2/DSC02368.JPG,char_data/5/DSC02368.JPG_0.jpg,735,21,233,254,382,417,False,7
5,34,kaist_dataset/Mixed/Digital_Camera/(C.S)C-outdoor2/DSC02368.JPG,char_data/5/DSC02368.JPG_0.jpg,884,26,561,587,381,415,False,7
5,44,kaist_dataset/Mixed/Digital_Camera/(C.S)C-outdoor2/DSC02490.JPG,char_data/5/DSC02490.JPG_0.jpg,1320,30,425,455,341,385,False,7
5,45,kaist_dataset/Mixed/Digital_Camera/(C.S)C-outdoor2/DSC02937.JPG,char_data/5/DSC02937.JPG_0.jpg,1080,24,194,218,198,243,False,7
5,45,kaist_dataset/Mixed/Digital_Camera/(C.S)C-outdoor2/DSC02937.JPG,char_data/5/DSC02937.JPG_0.jpg,900,20,219,239,198,243,False,7
5,42,kaist_dataset/Mixed/Digital_Camera/(C.S)C-outdoor2/DSC02937.JPG,char_data/5/DSC02937.JPG_0.jpg,1134,27,265,292,195,237,False,7
5,62,kaist_dataset/Mixed/Digital_Camera/(C.S)C-outdoor2/DSC02359.JPG,char_data/5/DSC02359.JPG_0.jpg,1922,31,284,315,406,468,False,7
5,39,kaist_dataset/Mixed/Digital_Camera/(C.S)C-outdoor2/DSC02376.JPG,char_data/5/DSC02376.JPG_0.jpg,975,25,469,494,338,377,False,7
5,46,kaist_dataset/Mixed/Digital_Camera/(C.S)C-outdoor2/DSC02376.JPG,char_data/5/DSC02376.JPG_0.jpg,1196,26,506,532,334,380,False,7
5,32,kaist_dataset/Mixed/Digital_Camera/(C.S)C-outdoor2/DSC02422.JPG,char_data/5/DSC02422.JPG_0.jpg,640,20,461,481,220,252,False,7
5,40,kaist_dataset/Mixed/Digital_Camera/(C.S)C-outdoor2/DSC02933.JPG,char_data/5/DSC02933.JPG_0.jpg,720,18,513,531,242,282,False,7
5,33,kaist_dataset/Mixed/Digital_Camera/(C.S)C-outdoor2/DSC02936.JPG,char_data/5/DSC02936.JPG_0.jpg,594,18,548,566,223,256,False,7
5,31,kaist_dataset/Mixed/Digital_Camera/(C.S)C-outdoor2/DSC02936.JPG,char_data/5/DSC02936.JPG_0.jpg,372,12,567,579,225,256,False,7
5,40,kaist_dataset/Mixed/Digital_Camera/(C.S)C-outdoor2/DSC02511.JPG,char_data/5/DSC02511.JPG_0.jpg,960,24,410,434,214,254,False,7
5,42,kaist_dataset/Mixed/Digital_Camera/(C.S)C-outdoor2/DSC02511.JPG,char_data/5/DSC02511.JPG_0.jpg,1092,26,363,389,397,439,False,7
5,45,kaist_dataset/Mixed/Digital_Camera/(C.S)C-outdoor2/DSC02511.JPG,char_data/5/DSC02511.JPG_0.jpg,1125,25,388,413,395,440,False,7
5,35,kaist_dataset/Mixed/Digital_Camera/(C.S)C-outdoor2/DSC02553.JPG,char_data/5/DSC02553.JPG_0.jpg,875,25,430,455,296,331,False,7
5,28,kaist_dataset/Mixed/Digital_Camera/(C.S)C-outdoor2/DSC02877.JPG,char_data/5/DSC02877.JPG_0.jpg,476,17,550,567,220,248,False,7
5,30,kaist_dataset/Mixed/Digital_Camera/(C.S)C-outdoor2/DSC02877.JPG,char_data/5/DSC02877.JPG_0.jpg,420,14,566,580,218,248,False,7
5,29,kaist_dataset/Mixed/Digital_Camera/(C.S)C-outdoor2/DSC02879.JPG,char_data/5/DSC02879.JPG_0.jpg,319,11,347,358,272,301,False,7
5,33,kaist_dataset/Mixed/Digital_Camera/(C.S)C-outdoor2/DSC02543.JPG,char_data/5/DSC02543.JPG_0.jpg,660,20,434,454,349,382,False,7
5,35,kaist_dataset/Mixed/Digital_Camera/(C.S)C-outdoor2/DSC02560.JPG,char_data/5/DSC02560.JPG_0.jpg,630,18,617,635,304,339,False,7
5,19,kaist_dataset/Mixed/Digital_Camera/(C.S)C-outdoor2/P1010015.JPG,char_data/5/P1010015.JPG_0.jpg,228,12,415,427,190,209,False,7
5,70,kaist_dataset/Mixed/Digital_Camera/(C.S)A-shadow/DSC04326.JPG,char_data/5/DSC04326.JPG_0.jpg,2240,32,385,417,12,82,False,7
5,55,kaist_dataset/Mixed/Digital_Camera/(C.S)A-shadow/DSC03258.JPG,char_data/5/DSC03258.JPG_0.jpg,1870,34,405,439,370,425,False,7
5,31,kaist_dataset/Mixed/Digital_Camera/(C.S)A-shadow/P1010017.JPG,char_data/5/P1010017.JPG_0.jpg,589,19,130,149,131,162,False,7
5,41,kaist_dataset/Mixed/Digital_Camera/(C.S)A-shadow/P1010019.JPG,char_data/5/P1010019.JPG_0.jpg,1189,29,451,480,200,241,False,7
5,78,kaist_dataset/English/Mobile_Phone/(E.M)B-indoor/P090902018.jpg,char_data/5/P090902018.jpg_0.jpg,3354,43,153,196,167,245,False,7
5,40,kaist_dataset/English/Digital_Camera/(E.S)C-outdoor2/DSC03436.JPG,char_data/5/DSC03436.JPG_0.jpg,840,21,314,335,120,160,False,7
5,34,kaist_dataset/English/Digital_Camera/(E.S)C-outdoor2/DSC03436.JPG,char_data/5/DSC03436.JPG_0.jpg,714,21,360,381,127,161,False,7
5,51,kaist_dataset/English/Digital_Camera/(E.S)C-outdoor2/DSC03161.JPG,char_data/5/DSC03161.JPG_0.jpg,1734,34,17,51,229,280,False,7
5,74,kaist_dataset/English/Digital_Camera/(E.S)C-outdoor2/DSC04163.JPG,char_data/5/DSC04163.JPG_0.jpg,3552,48,419,467,315,389,False,7
5,46,kaist_dataset/English/Digital_Camera/(E.S)C-outdoor1/DSC02415.JPG,char_data/5/DSC02415.JPG_0.jpg,1518,33,518,551,247,293,False,7
5,44,kaist_dataset/English/Digital_Camera/(E.S)C-outdoor1/080116-0065.jpg,char_data/5/080116-0065.jpg_0.jpg,1056,24,277,301,370,414,False,7
5,38,kaist_dataset/English/Digital_Camera/(E.S)F-others/DSC02923.JPG,char_data/5/DSC02923.JPG_0.jpg,798,21,386,407,387,425,False,7
5,101,kaist_dataset/English/Digital_Camera/(E.S)A-shadow/DSC03077.JPG,char_data/5/DSC03077.JPG_0.jpg,13029,129,338,467,88,189,False,7
5,124,kaist_dataset/English/Digital_Camera/(E.S)C-outdoor3/P1010123.JPG,char_data/5/P1010123.JPG_0.jpg,11656,94,357,451,51,175,False,7
7,76,"kaist_dataset/Korean/Mobile_Phone/(M,K)E-bookCover/P090831154.jpg",char_data/7/P090831154.jpg_2.jpg,4332,57,360,417,139,215,True,9
7,31,"kaist_dataset/Korean/Mobile_Phone/(M,K)C-outdoor/P090912042.jpg",char_data/7/P090912042.jpg_2.jpg,527,17,431,448,247,278,True,9
7,36,kaist_dataset/Korean/Digital_Camera/outdoor5/DSC03996.JPG,char_data/7/DSC03996.JPG_2.jpg,1080,30,316,346,281,317,True,9
7,55,kaist_dataset/Korean/Digital_Camera/outdoor5/DSC03979.JPG,char_data/7/DSC03979.JPG_2.jpg,3135,57,302,359,378,433,True,9
7,31,kaist_dataset/Korean/Digital_Camera/outdoor5/DSC03627.JPG,char_data/7/DSC03627.JPG_4.jpg,930,30,237,267,224,255,True,9
7,36,kaist_dataset/Korean/Digital_Camera/outdoor5/DSC03627.JPG,char_data/7/DSC03627.JPG_4.jpg,1080,30,357,387,223,259,True,9
7,26,kaist_dataset/Korean/Digital_Camera/outdoor5/DSC03688.JPG,char_data/7/DSC03688.JPG_4.jpg,312,12,565,577,229,255,True,9
7,24,kaist_dataset/Korean/Digital_Camera/outdoor5/DSC03688.JPG,char_data/7/DSC03688.JPG_4.jpg,312,13,584,597,229,253,True,9
7,44,kaist_dataset/Korean/Digital_Camera/outdoor5/DSC03717.JPG,char_data/7/DSC03717.JPG_2.jpg,1452,33,200,233,346,390,True,9
7,30,kaist_dataset/Korean/Digital_Camera/outdoor5/DSC04027.JPG,char_data/7/DSC04027.JPG_2.jpg,630,21,369,390,384,414,True,9
7,35,kaist_dataset/Korean/Digital_Camera/outdoor5/DSC03671.JPG,char_data/7/DSC03671.JPG_4.jpg,805,23,351,374,407,442,True,9
7,29,kaist_dataset/Korean/Digital_Camera/outdoor5/DSC03671.JPG,char_data/7/DSC03671.JPG_4.jpg,725,25,579,604,416,445,True,9
7,47,kaist_dataset/Korean/Digital_Camera/outdoor5/DSC03838.JPG,char_data/7/DSC03838.JPG_2.jpg,1175,25,272,297,200,247,True,9
7,44,kaist_dataset/Korean/Digital_Camera/outdoor5/DSC03778.JPG,char_data/7/DSC03778.JPG_2.jpg,616,14,338,352,335,379,True,9
7,38,kaist_dataset/Korean/Digital_Camera/outdoor5/DSC04040.JPG,char_data/7/DSC04040.JPG_2.jpg,1330,35,342,377,341,379,True,9
7,40,kaist_dataset/Korean/Digital_Camera/outdoor5/DSC03794.JPG,char_data/7/DSC03794.JPG_2.jpg,720,18,402,420,357,397,True,9
7,68,kaist_dataset/Korean/Digital_Camera/outdoor5/DSC03749.JPG,char_data/7/DSC03749.JPG_2.jpg,2108,31,402,433,408,476,True,9
7,39,kaist_dataset/Korean/Digital_Camera/outdoor5/DSC03710.JPG,char_data/7/DSC03710.JPG_2.jpg,1326,34,283,317,405,444,True,9
7,47,kaist_dataset/Korean/Digital_Camera/outdoor5/DSC03626.JPG,char_data/7/DSC03626.JPG_4.jpg,1128,24,478,502,292,339,True,9
7,51,kaist_dataset/Korean/Digital_Camera/outdoor5/DSC03626.JPG,char_data/7/DSC03626.JPG_4.jpg,1275,25,504,529,292,343,True,9
7,33,kaist_dataset/Korean/Digital_Camera/outdoor5/DSC03751.JPG,char_data/7/DSC03751.JPG_4.jpg,660,20,336,356,409,442,True,9
7,32,kaist_dataset/Korean/Digital_Camera/outdoor5/DSC03751.JPG,char_data/7/DSC03751.JPG_4.jpg,704,22,357,379,407,439,True,9
7,47,kaist_dataset/Korean/Digital_Camera/outdoor5/DSC03970.JPG,char_data/7/DSC03970.JPG_2.jpg,1551,33,267,300,94,141,True,9
7,37,kaist_dataset/Korean/Digital_Camera/outdoor5/DSC03669.JPG,char_data/7/DSC03669.JPG_4.jpg,888,24,303,327,311,348,True,9
7,38,kaist_dataset/Korean/Digital_Camera/outdoor5/DSC03669.JPG,char_data/7/DSC03669.JPG_4.jpg,950,25,328,353,312,350,True,9
7,38,kaist_dataset/Korean/Digital_Camera/outdoor5/DSC03740.JPG,char_data/7/DSC03740.JPG_2.jpg,912,24,471,495,286,324,True,9
7,30,kaist_dataset/Korean/Digital_Camera/outdoor5/DSC03641.JPG,char_data/7/DSC03641.JPG_4.jpg,420,14,462,476,423,453,True,9
7,31,kaist_dataset/Korean/Digital_Camera/outdoor5/DSC03641.JPG,char_data/7/DSC03641.JPG_4.jpg,620,20,475,495,420,451,True,9
7,19,kaist_dataset/Korean/Digital_Camera/outdoor5/DSC03776.JPG,char_data/7/DSC03776.JPG_2.jpg,266,14,529,543,424,443,True,9
7,43,kaist_dataset/Korean/Digital_Camera/outdoor5/DSC03645.JPG,char_data/7/DSC03645.JPG_4.jpg,1204,28,377,405,351,394,True,9
7,42,kaist_dataset/Korean/Digital_Camera/outdoor5/DSC03645.JPG,char_data/7/DSC03645.JPG_4.jpg,1176,28,422,450,350,392,True,9
7,38,kaist_dataset/Korean/Digital_Camera/outdoor4/DSC03293.JPG,char_data/7/DSC03293.JPG_4.jpg,570,15,242,257,283,321,True,9
7,35,kaist_dataset/Korean/Digital_Camera/outdoor4/DSC03293.JPG,char_data/7/DSC03293.JPG_4.jpg,735,21,318,339,285,320,True,9
7,46,kaist_dataset/Korean/Digital_Camera/outdoor4/DSC03599.JPG,char_data/7/DSC03599.JPG_2.jpg,1012,22,317,339,306,352,True,9
7,54,kaist_dataset/Korean/Digital_Camera/outdoor4/DSC03608.JPG,char_data/7/DSC03608.JPG_2.jpg,1674,31,521,552,386,440,True,9
7,38,kaist_dataset/Korean/Digital_Camera/outdoor4/DSC03592.JPG,char_data/7/DSC03592.JPG_2.jpg,760,20,84,104,115,153,True,9
7,73,kaist_dataset/Korean/Digital_Camera/outdoor4/DSC03606.JPG,char_data/7/DSC03606.JPG_2.jpg,4161,57,344,401,234,307,True,9
7,38,kaist_dataset/Korean/Digital_Camera/outdoor4/DSC03614.JPG,char_data/7/DSC03614.JPG_4.jpg,912,24,432,456,390,428,True,9
7,45,kaist_dataset/Korean/Digital_Camera/outdoor4/DSC03614.JPG,char_data/7/DSC03614.JPG_4.jpg,855,19,457,476,384,429,True,9
7,49,kaist_dataset/Korean/Digital_Camera/outdoor4/DSC03319.JPG,char_data/7/DSC03319.JPG_4.jpg,1421,29,214,243,387,436,True,9
7,45,kaist_dataset/Korean/Digital_Camera/outdoor4/DSC03319.JPG,char_data/7/DSC03319.JPG_4.jpg,1125,25,122,147,81,126,True,9
7,64,kaist_dataset/Korean/Digital_Camera/outdoor4/DSC03550.JPG,char_data/7/DSC03550.JPG_2.jpg,3456,54,259,313,308,372,True,9
7,42,kaist_dataset/Korean/Digital_Camera/outdoor4/DSC03545.JPG,char_data/7/DSC03545.JPG_2.jpg,546,13,116,129,39,81,True,9
7,60,kaist_dataset/Korean/Digital_Camera/outdoor4/DSC03313.JPG,char_data/7/DSC03313.JPG_8.jpg,2100,35,302,337,312,372,True,9
7,54,kaist_dataset/Korean/Digital_Camera/outdoor4/DSC03313.JPG,char_data/7/DSC03313.JPG_8.jpg,1782,33,417,450,312,366,True,9
7,54,kaist_dataset/Korean/Digital_Camera/outdoor4/DSC03313.JPG,char_data/7/DSC03313.JPG_8.jpg,1836,34,487,521,313,367,True,9
7,54,kaist_dataset/Korean/Digital_Camera/outdoor4/DSC03313.JPG,char_data/7/DSC03313.JPG_8.jpg,1944,36,523,559,312,366,True,9
7,74,kaist_dataset/Korean/Digital_Camera/outdoor4/DSC03553.JPG,char_data/7/DSC03553.JPG_6.jpg,4736,64,164,228,179,253,True,9
7,80,kaist_dataset/Korean/Digital_Camera/outdoor4/DSC03553.JPG,char_data/7/DSC03553.JPG_6.jpg,5920,74,391,465,172,252,True,9
7,75,kaist_dataset/Korean/Digital_Camera/outdoor4/DSC03553.JPG,char_data/7/DSC03553.JPG_6.jpg,5700,76,516,592,175,250,True,9
7,54,kaist_dataset/Korean/Digital_Camera/outdoor4/DSC03580.JPG,char_data/7/DSC03580.JPG_2.jpg,1674,31,391,422,201,255,True,9
7,27,kaist_dataset/Korean/Digital_Camera/outdoor4/DSC03555.JPG,char_data/7/DSC03555.JPG_2.jpg,621,23,439,462,429,456,True,9
7,59,kaist_dataset/Korean/Digital_Camera/outdoor2/2007-12-09-day-exterior-016.jpg,char_data/7/2007-12-09-day-exterior-016.jpg_4.jpg,2183,37,56,93,353,412,True,9
7,65,kaist_dataset/Korean/Digital_Camera/outdoor2/2007-12-09-day-exterior-016.jpg,char_data/7/2007-12-09-day-exterior-016.jpg_4.jpg,2665,41,731,772,742,807,True,9
7,38,kaist_dataset/Korean/Digital_Camera/outdoor2/DSC02476.JPG,char_data/7/DSC02476.JPG_4.jpg,760,20,308,328,272,310,True,9
7,36,kaist_dataset/Korean/Digital_Camera/outdoor2/DSC02476.JPG,char_data/7/DSC02476.JPG_4.jpg,828,23,334,357,272,308,True,9
7,30,kaist_dataset/Korean/Digital_Camera/outdoor2/DSC02308.JPG,char_data/7/DSC02308.JPG_6.jpg,840,28,345,373,237,267,True,9
7,33,kaist_dataset/Korean/Digital_Camera/outdoor2/DSC02308.JPG,char_data/7/DSC02308.JPG_6.jpg,891,27,371,398,236,269,True,9
7,25,kaist_dataset/Korean/Digital_Camera/outdoor2/DSC02308.JPG,char_data/7/DSC02308.JPG_6.jpg,700,28,400,428,242,267,True,9
7,37,kaist_dataset/Korean/Digital_Camera/outdoor2/2007-12-09-day-exterior-036.jpg,char_data/7/2007-12-09-day-exterior-036.jpg_2.jpg,703,19,1468,1487,630,667,True,9
7,50,kaist_dataset/Korean/Digital_Camera/outdoor2/2007-12-09-day-exterior-084.jpg,char_data/7/2007-12-09-day-exterior-084.jpg_0.jpg,1950,39,865,904,794,844,True,9
7,29,kaist_dataset/Korean/Digital_Camera/outdoor2/DSC02326.JPG,char_data/7/DSC02326.JPG_0.jpg,319,11,446,457,338,367,True,9
7,36,kaist_dataset/Korean/Digital_Camera/outdoor2/DSC02393.JPG,char_data/7/DSC02393.JPG_0.jpg,864,24,522,546,306,342,True,9
7,41,kaist_dataset/Korean/Digital_Camera/outdoor2/DSC02366.JPG,char_data/7/DSC02366.JPG_0.jpg,1107,27,416,443,403,444,True,9
7,42,kaist_dataset/Korean/Digital_Camera/outdoor2/DSC02366.JPG,char_data/7/DSC02366.JPG_0.jpg,1176,28,442,470,404,446,True,9
7,38,kaist_dataset/Korean/Digital_Camera/outdoor2/DSC02381.JPG,char_data/7/DSC02381.JPG_0.jpg,646,17,342,359,320,358,True,9
7,24,kaist_dataset/Korean/Digital_Camera/outdoor2/DSC02435.JPG,char_data/7/DSC02435.JPG_0.jpg,312,13,427,440,247,271,True,9
7,80,kaist_dataset/Korean/Digital_Camera/outdoor2/DSC02451.JPG,char_data/7/DSC02451.JPG_0.jpg,4560,57,317,374,321,401,True,9
7,29,kaist_dataset/Korean/Digital_Camera/outdoor2/DSC02383.JPG,char_data/7/DSC02383.JPG_0.jpg,435,15,117,132,293,322,True,9
7,34,kaist_dataset/Korean/Digital_Camera/outdoor2/DSC02383.JPG,char_data/7/DSC02383.JPG_0.jpg,578,17,277,294,287,321,True,9
7,57,kaist_dataset/Korean/Digital_Camera/outdoor2/2007-12-09-day-exterior-035.jpg,char_data/7/2007-12-09-day-exterior-035.jpg_0.jpg,1881,33,533,566,706,763,True,9
7,32,kaist_dataset/Korean/Digital_Camera/outdoor2/DSC02488.JPG,char_data/7/DSC02488.JPG_0.jpg,384,12,624,636,371,403,True,9
7,28,kaist_dataset/Korean/Digital_Camera/outdoor2/DSC02304.JPG,char_data/7/DSC02304.JPG_0.jpg,700,25,326,351,263,291,True,9
7,38,kaist_dataset/Korean/Digital_Camera/outdoor2/DSC02521.JPG,char_data/7/DSC02521.JPG_0.jpg,912,24,372,396,326,364,True,9
7,46,kaist_dataset/Korean/Digital_Camera/E-night/DSC02645.JPG,char_data/7/DSC02645.JPG_0.jpg,1104,24,454,478,330,376,True,9
7,47,kaist_dataset/Korean/Digital_Camera/E-night/DSC02645.JPG,char_data/7/DSC02645.JPG_0.jpg,1222,26,482,508,331,378,True,9
7,35,kaist_dataset/Korean/Digital_Camera/E-night/DSC03850.JPG,char_data/7/DSC03850.JPG_0.jpg,560,16,339,355,429,464,True,9
7,28,kaist_dataset/Korean/Digital_Camera/E-night/P1010149.JPG,char_data/7/P1010149.JPG_0.jpg,364,13,577,590,237,265,True,9
7,21,kaist_dataset/Korean/Digital_Camera/E-night/P1010149.JPG,char_data/7/P1010149.JPG_0.jpg,189,9,603,612,242,263,True,9
7,24,kaist_dataset/Korean/Digital_Camera/E-night/DSC03870.JPG,char_data/7/DSC03870.JPG_0.jpg,288,12,346,358,224,248,True,9
7,32,kaist_dataset/Korean/Digital_Camera/E-night/DSC02626.JPG,char_data/7/DSC02626.JPG_0.jpg,480,15,180,195,372,404,True,9
7,32,kaist_dataset/Korean/Digital_Camera/E-night/DSC02626.JPG,char_data/7/DSC02626.JPG_0.jpg,512,16,244,260,367,399,True,9
7,30,kaist_dataset/Korean/Digital_Camera/E-night/DSC02626.JPG,char_data/7/DSC02626.JPG_0.jpg,510,17,329,346,367,397,True,9
7,40,kaist_dataset/Korean/Digital_Camera/E-night/DSC03515.JPG,char_data/7/DSC03515.JPG_0.jpg,720,18,525,543,272,312,True,9
7,49,kaist_dataset/Korean/Digital_Camera/indoor1/080119-0029.jpg,char_data/7/080119-0029.jpg_0.jpg,980,20,1271,1291,618,667,True,9
7,48,kaist_dataset/Korean/Digital_Camera/outdoor7/P1010069.JPG,char_data/7/P1010069.JPG_0.jpg,1584,33,259,292,311,359,True,9
7,25,kaist_dataset/Korean/Digital_Camera/outdoor7/P1010005.JPG,char_data/7/P1010005.JPG_0.jpg,675,27,488,515,191,216,True,9
7,41,kaist_dataset/Korean/Digital_Camera/outdoor7/P1010138.JPG,char_data/7/P1010138.JPG_0.jpg,738,18,292,310,281,322,True,9
7,60,kaist_dataset/Korean/Digital_Camera/outdoor7/P1010068.JPG,char_data/7/P1010068.JPG_0.jpg,1560,26,409,435,272,332,True,9
7,59,kaist_dataset/Korean/Digital_Camera/outdoor7/P1010068.JPG,char_data/7/P1010068.JPG_0.jpg,1770,30,491,521,274,333,True,9
7,56,kaist_dataset/Korean/Digital_Camera/outdoor7/P1010068.JPG,char_data/7/P1010068.JPG_0.jpg,1568,28,554,582,275,331,True,9
7,48,kaist_dataset/Korean/Digital_Camera/outdoor7/P1010085.JPG,char_data/7/P1010085.JPG_0.jpg,1776,37,247,284,269,317,True,9
7,51,kaist_dataset/Korean/Digital_Camera/outdoor7/P1010085.JPG,char_data/7/P1010085.JPG_0.jpg,1836,36,414,450,267,318,True,9
7,55,kaist_dataset/Korean/Digital_Camera/outdoor7/P1010077.JPG,char_data/7/P1010077.JPG_0.jpg,1595,29,233,262,246,301,True,9
7,32,kaist_dataset/Korean/Digital_Camera/outdoor7/P1010078.JPG,char_data/7/P1010078.JPG_0.jpg,736,23,267,290,251,283,True,9
7,37,kaist_dataset/Korean/Digital_Camera/outdoor7/P1010078.JPG,char_data/7/P1010078.JPG_0.jpg,888,24,292,316,251,288,True,9
7,61,kaist_dataset/Korean/Digital_Camera/outdoor7/P1010011.JPG,char_data/7/P1010011.JPG_0.jpg,2623,43,556,599,218,279,True,9
7,76,kaist_dataset/Korean/Digital_Camera/outdoor7/P1010086.JPG,char_data/7/P1010086.JPG_0.jpg,4332,57,116,173,255,331,True,9
7,67,kaist_dataset/Korean/Digital_Camera/outdoor7/P1010086.JPG,char_data/7/P1010086.JPG_0.jpg,3685,55,414,469,259,326,True,9
7,37,kaist_dataset/Korean/Digital_Camera/outdoor7/P1010009.JPG,char_data/7/P1010009.JPG_0.jpg,1036,28,546,574,266,303,True,9
7,59,kaist_dataset/Korean/Digital_Camera/outdoor7/P1010023.JPG,char_data/7/P1010023.JPG_0.jpg,1652,28,50,78,291,350,True,9
7,40,kaist_dataset/Korean/Digital_Camera/outdoor7/P1010067.JPG,char_data/7/P1010067.JPG_0.jpg,1120,28,174,202,311,351,True,9
7,30,kaist_dataset/Korean/Digital_Camera/outdoor7/P1010035.JPG,char_data/7/P1010035.JPG_0.jpg,390,13,74,87,208,238,True,9
7,104,kaist_dataset/Korean/Digital_Camera/outdoor7/P1010079.JPG,char_data/7/P1010079.JPG_0.jpg,7488,72,148,220,335,439,True,9
7,32,kaist_dataset/Korean/Digital_Camera/outdoor8/P1010143.JPG,char_data/7/P1010143.JPG_0.jpg,576,18,479,497,278,310,True,9
7,37,kaist_dataset/Korean/Digital_Camera/outdoor8/P1010142.JPG,char_data/7/P1010142.JPG_0.jpg,999,27,306,333,282,319,True,9
7,39,kaist_dataset/Korean/Digital_Camera/outdoor8/P1010170.JPG,char_data/7/P1010170.JPG_0.jpg,702,18,470,488,273,312,True,9
7,76,kaist_dataset/Korean/Digital_Camera/outdoor8/P1010172.JPG,char_data/7/P1010172.JPG_0.jpg,3420,45,191,236,225,301,True,9
7,65,kaist_dataset/Korean/Digital_Camera/outdoor8/P1010172.JPG,char_data/7/P1010172.JPG_0.jpg,2795,43,451,494,232,297,True,9
7,51,kaist_dataset/Korean/Digital_Camera/outdoor8/P1010171.JPG,char_data/7/P1010171.JPG_0.jpg,1326,26,399,425,230,281,True,9
7,70,kaist_dataset/Korean/Digital_Camera/indoor2/DSC04006.JPG,char_data/7/DSC04006.JPG_0.jpg,2310,33,181,214,152,222,True,9
7,33,kaist_dataset/Korean/Digital_Camera/indoor2/DSC03564.JPG,char_data/7/DSC03564.JPG_0.jpg,561,17,286,303,405,438,True,9
7,34,kaist_dataset/Korean/Digital_Camera/indoor2/DSC03564.JPG,char_data/7/DSC03564.JPG_0.jpg,612,18,351,369,403,437,True,9
7,32,kaist_dataset/Korean/Digital_Camera/indoor2/DSC03564.JPG,char_data/7/DSC03564.JPG_0.jpg,576,18,384,402,402,434,True,9
7,52,kaist_dataset/Korean/Digital_Camera/indoor2/DSC03474.JPG,char_data/7/DSC03474.JPG_0.jpg,2080,40,369,409,152,204,True,9
7,38,kaist_dataset/Korean/Digital_Camera/indoor2/DSC03983.JPG,char_data/7/DSC03983.JPG_0.jpg,760,20,395,415,321,359,True,9
7,61,kaist_dataset/Korean/Digital_Camera/indoor2/DSC03475.JPG,char_data/7/DSC03475.JPG_0.jpg,2440,40,290,330,89,150,True,9
7,58,kaist_dataset/Korean/Digital_Camera/indoor2/DSC03475.JPG,char_data/7/DSC03475.JPG_0.jpg,2204,38,421,459,90,148,True,9
7,42,kaist_dataset/Korean/Digital_Camera/indoor2/DSC03995.JPG,char_data/7/DSC03995.JPG_0.jpg,1218,29,427,456,267,309,True,9
7,55,kaist_dataset/Korean/Digital_Camera/indoor2/DSC03994.JPG,char_data/7/DSC03994.JPG_0.jpg,1595,29,343,372,283,338,True,9
7,46,kaist_dataset/Korean/Digital_Camera/G-others/2007-12-09-day-exterior-083.jpg,char_data/7/2007-12-09-day-exterior-083.jpg_0.jpg,1518,33,631,664,975,1021,True,9
7,56,kaist_dataset/Korean/Digital_Camera/G-others/2007-12-09-day-exterior-083.jpg,char_data/7/2007-12-09-day-exterior-083.jpg_0.jpg,2352,42,439,481,122,178,True,9
7,42,kaist_dataset/Korean/Digital_Camera/G-others/DSC03862.JPG,char_data/7/DSC03862.JPG_0.jpg,714,17,275,292,352,394,True,9
7,74,kaist_dataset/Korean/Digital_Camera/G-others/2007-12-08-day-108.jpg,char_data/7/2007-12-08-day-108.jpg_0.jpg,2664,36,887,923,685,759,True,9
7,71,kaist_dataset/Korean/Digital_Camera/G-others/2007-12-08-day-108.jpg,char_data/7/2007-12-08-day-108.jpg_0.jpg,2911,41,947,988,708,779,True,9
7,79,kaist_dataset/Korean/Digital_Camera/G-others/2007-12-08-day-108.jpg,char_data/7/2007-12-08-day-108.jpg_0.jpg,2686,34,903,937,772,851,True,9
7,80,kaist_dataset/Korean/Digital_Camera/G-others/2007-12-08-day-108.jpg,char_data/7/2007-12-08-day-108.jpg_0.jpg,3760,47,965,1012,789,869,True,9
7,46,kaist_dataset/Korean/Digital_Camera/outdoor6/DSC04143.JPG,char_data/7/DSC04143.JPG_0.jpg,1380,30,352,382,361,407,True,9
7,30,kaist_dataset/Korean/Digital_Camera/outdoor6/DSC04062.JPG,char_data/7/DSC04062.JPG_0.jpg,360,12,552,564,304,334,True,9
7,24,kaist_dataset/Korean/Digital_Camera/outdoor6/DSC04062.JPG,char_data/7/DSC04062.JPG_0.jpg,192,8,589,597,308,332,True,9
7,26,kaist_dataset/Korean/Digital_Camera/outdoor6/DSC04041.JPG,char_data/7/DSC04041.JPG_0.jpg,416,16,446,462,142,168,True,9
7,37,kaist_dataset/Korean/Digital_Camera/outdoor6/DSC04099.JPG,char_data/7/DSC04099.JPG_0.jpg,703,19,438,457,410,447,True,9
7,50,kaist_dataset/Korean/Digital_Camera/outdoor6/DSC04089.JPG,char_data/7/DSC04089.JPG_0.jpg,1300,26,395,421,275,325,True,9
7,47,kaist_dataset/Korean/Digital_Camera/outdoor6/DSC04089.JPG,char_data/7/DSC04089.JPG_0.jpg,1175,25,420,445,274,321,True,9
7,42,kaist_dataset/Korean/Digital_Camera/outdoor6/DSC04148.JPG,char_data/7/DSC04148.JPG_0.jpg,924,22,398,420,251,293,True,9
7,41,kaist_dataset/Korean/Digital_Camera/outdoor6/DSC04121.JPG,char_data/7/DSC04121.JPG_0.jpg,1189,29,450,479,181,222,True,9
7,36,kaist_dataset/Korean/Digital_Camera/outdoor6/DSC04116.JPG,char_data/7/DSC04116.JPG_0.jpg,612,17,390,407,317,353,True,9
7,30,kaist_dataset/Korean/Digital_Camera/outdoor6/DSC04113.JPG,char_data/7/DSC04113.JPG_0.jpg,900,30,175,205,442,472,True,9
7,33,kaist_dataset/Korean/Digital_Camera/outdoor6/DSC04113.JPG,char_data/7/DSC04113.JPG_0.jpg,924,28,275,303,440,473,True,9
7,32,kaist_dataset/Korean/Digital_Camera/outdoor6/DSC04113.JPG,char_data/7/DSC04113.JPG_0.jpg,1056,33,307,340,443,475,True,9
7,29,kaist_dataset/Korean/Digital_Camera/outdoor6/DSC04113.JPG,char_data/7/DSC04113.JPG_0.jpg,1044,36,370,406,444,473,True,9
7,58,kaist_dataset/Korean/Digital_Camera/outdoor6/DSC04296.JPG,char_data/7/DSC04296.JPG_0.jpg,1392,24,423,447,303,361,True,9
7,31,kaist_dataset/Korean/Digital_Camera/outdoor6/DSC04046.JPG,char_data/7/DSC04046.JPG_0.jpg,496,16,283,299,260,291,True,9
7,29,kaist_dataset/Korean/Digital_Camera/outdoor6/DSC04046.JPG,char_data/7/DSC04046.JPG_0.jpg,319,11,349,360,260,289,True,9
7,29,kaist_dataset/Korean/Digital_Camera/outdoor6/DSC04046.JPG,char_data/7/DSC04046.JPG_0.jpg,522,18,375,393,257,286,True,9
7,29,kaist_dataset/Korean/Digital_Camera/outdoor6/DSC04046.JPG,char_data/7/DSC04046.JPG_0.jpg,406,14,499,513,260,289,True,9
7,26,kaist_dataset/Korean/Digital_Camera/outdoor6/DSC04046.JPG,char_data/7/DSC04046.JPG_0.jpg,364,14,543,557,263,289,True,9
7,34,kaist_dataset/Korean/Digital_Camera/outdoor6/DSC04046.JPG,char_data/7/DSC04046.JPG_0.jpg,476,14,575,589,259,293,True,9
7,40,kaist_dataset/Korean/Digital_Camera/A-shadow/2007-12-09-day-exterior-040.jpg,char_data/7/2007-12-09-day-exterior-040.jpg_0.jpg,840,21,1035,1056,811,851,True,9
7,42,kaist_dataset/Korean/Digital_Camera/A-shadow/DSC04315.JPG,char_data/7/DSC04315.JPG_0.jpg,1218,29,212,241,416,458,True,9
7,47,kaist_dataset/Korean/Digital_Camera/A-shadow/DSC04315.JPG,char_data/7/DSC04315.JPG_0.jpg,1081,23,271,294,415,462,True,9
7,82,kaist_dataset/Korean/Digital_Camera/A-shadow/DSC03755.JPG,char_data/7/DSC03755.JPG_0.jpg,2214,27,414,441,208,290,True,9
7,85,kaist_dataset/Korean/Digital_Camera/A-shadow/DSC03755.JPG,char_data/7/DSC03755.JPG_0.jpg,2890,34,578,612,207,292,True,9
7,73,kaist_dataset/Korean/Digital_Camera/A-shadow/2007-12-09-day-exterior-026.jpg,char_data/7/2007-12-09-day-exterior-026.jpg_0.jpg,2482,34,958,992,754,827,True,9
7,35,kaist_dataset/Korean/Digital_Camera/A-shadow/DSC04297.JPG,char_data/7/DSC04297.JPG_0.jpg,455,13,407,420,205,240,True,9
7,67,kaist_dataset/Korean/Digital_Camera/A-shadow/DSC03535.JPG,char_data/7/DSC03535.JPG_0.jpg,2345,35,457,492,248,315,True,9
7,81,kaist_dataset/Korean/Digital_Camera/A-shadow/2007-12-09-day-exterior-031.jpg,char_data/7/2007-12-09-day-exterior-031.jpg_0.jpg,3888,48,792,840,665,746,True,9
7,81,kaist_dataset/Korean/Digital_Camera/A-shadow/2007-12-09-day-exterior-031.jpg,char_data/7/2007-12-09-day-exterior-031.jpg_0.jpg,4617,57,888,945,667,748,True,9
7,32,kaist_dataset/Korean/Digital_Camera/outdoor3/DSC02999.JPG,char_data/7/DSC02999.JPG_0.jpg,480,15,337,352,433,465,True,9
7,32,kaist_dataset/Korean/Digital_Camera/outdoor3/DSC02999.JPG,char_data/7/DSC02999.JPG_0.jpg,576,18,352,370,431,463,True,9
7,34,kaist_dataset/Korean/Digital_Camera/outdoor3/DSC02971.JPG,char_data/7/DSC02971.JPG_0.jpg,782,23,298,321,294,328,True,9
7,31,kaist_dataset/Korean/Digital_Camera/outdoor3/DSC02971.JPG,char_data/7/DSC02971.JPG_0.jpg,589,19,395,414,299,330,True,9
7,38,kaist_dataset/Korean/Digital_Camera/outdoor3/DSC02971.JPG,char_data/7/DSC02971.JPG_0.jpg,1064,28,414,442,296,334,True,9
7,42,kaist_dataset/Korean/Digital_Camera/outdoor3/DSC02686.JPG,char_data/7/DSC02686.JPG_0.jpg,1260,30,270,300,223,265,True,9
7,42,kaist_dataset/Korean/Digital_Camera/outdoor3/DSC02686.JPG,char_data/7/DSC02686.JPG_0.jpg,882,21,572,593,225,267,True,9
7,47,kaist_dataset/Korean/Digital_Camera/outdoor3/DSC02686.JPG,char_data/7/DSC02686.JPG_0.jpg,1128,24,594,618,221,268,True,9
7,50,kaist_dataset/Korean/Digital_Camera/outdoor3/DSC02528.JPG,char_data/7/DSC02528.JPG_0.jpg,1550,31,302,333,411,461,True,9
7,72,kaist_dataset/Korean/Digital_Camera/outdoor3/DSC02562.JPG,char_data/7/DSC02562.JPG_0.jpg,2736,38,400,438,358,430,True,9
7,82,kaist_dataset/Korean/Digital_Camera/outdoor3/DSC02562.JPG,char_data/7/DSC02562.JPG_0.jpg,3772,46,436,482,356,438,True,9
7,28,kaist_dataset/Korean/Digital_Camera/outdoor3/DSC02891.JPG,char_data/7/DSC02891.JPG_0.jpg,420,15,572,587,299,327,True,9
7,26,kaist_dataset/Korean/Digital_Camera/outdoor3/DSC02891.JPG,char_data/7/DSC02891.JPG_0.jpg,364,14,588,602,301,327,True,9
7,36,kaist_dataset/Korean/Digital_Camera/outdoor3/DSC02975.JPG,char_data/7/DSC02975.JPG_0.jpg,828,23,461,484,246,282,True,9
7,47,kaist_dataset/Korean/Digital_Camera/outdoor3/DSC03064.JPG,char_data/7/DSC03064.JPG_0.jpg,987,21,302,323,348,395,True,9
7,38,kaist_dataset/Korean/Digital_Camera/outdoor3/DSC02941.JPG,char_data/7/DSC02941.JPG_0.jpg,874,23,472,495,257,295,True,9
7,30,kaist_dataset/Korean/Digital_Camera/outdoor3/DSC03219.JPG,char_data/7/DSC03219.JPG_0.jpg,570,19,407,426,412,442,True,9
7,34,kaist_dataset/Korean/Digital_Camera/outdoor3/DSC02939.JPG,char_data/7/DSC02939.JPG_0.jpg,680,20,358,378,369,403,True,9
7,34,kaist_dataset/Korean/Digital_Camera/outdoor3/DSC02939.JPG,char_data/7/DSC02939.JPG_0.jpg,782,23,493,516,370,404,True,9
7,36,kaist_dataset/Korean/Digital_Camera/outdoor3/DSC03232.JPG,char_data/7/DSC03232.JPG_0.jpg,864,24,322,346,277,313,True,9
7,29,kaist_dataset/Korean/Digital_Camera/outdoor1/071.JPG,char_data/7/071.JPG_0.jpg,493,17,356,373,258,287,True,9
7,25,kaist_dataset/Korean/Digital_Camera/outdoor1/2007-12-08-day-087.jpg,char_data/7/2007-12-08-day-087.jpg_0.jpg,375,15,18,33,806,831,True,9
7,25,kaist_dataset/Korean/Digital_Camera/outdoor1/2007-12-08-day-087.jpg,char_data/7/2007-12-08-day-087.jpg_0.jpg,400,16,34,50,808,833,True,9
7,29,kaist_dataset/Korean/Digital_Camera/outdoor1/2007-12-08-day-087.jpg,char_data/7/2007-12-08-day-087.jpg_0.jpg,464,16,1,17,806,835,True,9
7,35,kaist_dataset/Korean/Digital_Camera/outdoor1/53.JPG,char_data/7/53.JPG_0.jpg,735,21,683,704,227,262,True,9
7,42,kaist_dataset/Korean/Digital_Camera/outdoor1/052.JPG,char_data/7/052.JPG_0.jpg,1092,26,379,405,319,361,True,9
7,30,kaist_dataset/Korean/Digital_Camera/outdoor1/102.JPG,char_data/7/102.JPG_0.jpg,630,21,407,428,309,339,True,9
7,69,kaist_dataset/Korean/Digital_Camera/outdoor1/46.JPG,char_data/7/46.JPG_0.jpg,2415,35,327,362,366,435,True,9
7,22,kaist_dataset/Korean/Digital_Camera/outdoor1/126.JPG,char_data/7/126.JPG_0.jpg,286,13,554,567,255,277,True,9
7,66,kaist_dataset/Korean/Digital_Camera/outdoor1/2007-12-08-day-057.jpg,char_data/7/2007-12-08-day-057.jpg_0.jpg,2310,35,876,911,599,665,True,9
7,70,kaist_dataset/Korean/Digital_Camera/outdoor1/2007-12-08-day-057.jpg,char_data/7/2007-12-08-day-057.jpg_0.jpg,2730,39,1031,1070,593,663,True,9
7,31,kaist_dataset/Korean/Digital_Camera/outdoor1/023.JPG,char_data/7/023.JPG_0.jpg,775,25,277,302,267,298,True,9
7,48,kaist_dataset/Korean/Digital_Camera/outdoor1/098.JPG,char_data/7/098.JPG_0.jpg,1344,28,306,334,352,400,True,9
7,46,kaist_dataset/Korean/Digital_Camera/outdoor1/098.JPG,char_data/7/098.JPG_0.jpg,1702,37,334,371,353,399,True,9
7,30,kaist_dataset/Korean/Digital_Camera/outdoor1/50.JPG,char_data/7/50.JPG_0.jpg,480,16,408,424,340,370,True,9
7,33,kaist_dataset/Korean/Digital_Camera/outdoor1/50.JPG,char_data/7/50.JPG_0.jpg,660,20,425,445,338,371,True,9
7,29,kaist_dataset/Korean/Digital_Camera/outdoor1/032.JPG,char_data/7/032.JPG_0.jpg,435,15,141,156,258,287,True,9
7,23,kaist_dataset/Korean/Digital_Camera/outdoor1/032.JPG,char_data/7/032.JPG_0.jpg,437,19,331,350,260,283,True,9
7,29,kaist_dataset/Korean/Digital_Camera/outdoor1/032.JPG,char_data/7/032.JPG_0.jpg,754,26,540,566,254,283,True,9
7,31,kaist_dataset/Korean/Digital_Camera/outdoor1/125.JPG,char_data/7/125.JPG_0.jpg,620,20,394,414,256,287,True,9
7,30,kaist_dataset/Korean/Digital_Camera/outdoor1/125.JPG,char_data/7/125.JPG_0.jpg,750,25,414,439,257,287,True,9
7,32,kaist_dataset/Korean/Digital_Camera/outdoor1/123.JPG,char_data/7/123.JPG_0.jpg,384,12,83,95,280,312,True,9
7,37,kaist_dataset/Korean/Digital_Camera/outdoor1/035.JPG,char_data/7/035.JPG_0.jpg,444,12,537,549,287,324,True,9
7,43,kaist_dataset/Korean/Digital_Camera/outdoor1/2007-12-08-day-047.jpg,char_data/7/2007-12-08-day-047.jpg_0.jpg,1161,27,892,919,711,754,True,9
7,31,kaist_dataset/Mixed/Mobile_Phone/(C.M)A-outdoor/P090908006.jpg,char_data/7/P090908006.jpg_0.jpg,744,24,406,430,367,398,True,9
7,71,kaist_dataset/Mixed/Mobile_Phone/(C.M)A-outdoor/P090912078.jpg,char_data/7/P090912078.jpg_0.jpg,4331,61,558,619,209,280,True,9
7,41,kaist_dataset/Mixed/Mobile_Phone/(C.M)A-outdoor/P090912078.jpg,char_data/7/P090912078.jpg_0.jpg,1558,38,576,614,281,322,True,9
7,32,kaist_dataset/Mixed/Mobile_Phone/(C.M)A-outdoor/P090912036.jpg,char_data/7/P090912036.jpg_0.jpg,480,15,174,189,189,221,True,9
7,29,kaist_dataset/Mixed/Mobile_Phone/(C.M)A-outdoor/P090912036.jpg,char_data/7/P090912036.jpg_0.jpg,522,18,255,273,190,219,True,9
7,34,kaist_dataset/Mixed/Mobile_Phone/(C.M)A-outdoor/P090912036.jpg,char_data/7/P090912036.jpg_0.jpg,782,23,453,476,190,224,True,9
7,41,kaist_dataset/Mixed/Mobile_Phone/(C.M)A-outdoor/P090912047.jpg,char_data/7/P090912047.jpg_0.jpg,779,19,312,331,276,317,True,9
7,41,kaist_dataset/Mixed/Mobile_Phone/(C.M)C-bookCover/P090902016.jpg,char_data/7/P090902016.jpg_0.jpg,1189,29,374,403,270,311,True,9
7,50,kaist_dataset/Mixed/Digital_Camera/(C.S)C-outdoor1/P1010012.JPG,char_data/7/P1010012.JPG_0.jpg,1500,30,359,389,234,284,True,9
7,30,kaist_dataset/Mixed/Digital_Camera/(C.S)C-outdoor1/048.JPG,char_data/7/048.JPG_0.jpg,600,20,337,357,258,288,True,9
7,39,kaist_dataset/Mixed/Digital_Camera/(C.S)C-outdoor1/51.JPG,char_data/7/51.JPG_0.jpg,1131,29,609,638,377,416,True,9
7,44,kaist_dataset/Mixed/Digital_Camera/(C.S)C-outdoor1/081.JPG,char_data/7/081.JPG_0.jpg,2200,50,190,240,250,294,True,9
7,44,kaist_dataset/Mixed/Digital_Camera/(C.S)C-outdoor1/2007-12-09-day-exterior-078.jpg,char_data/7/2007-12-09-day-exterior-078.jpg_0.jpg,836,19,710,729,588,632,True,9
7,46,kaist_dataset/Mixed/Digital_Camera/(C.S)C-outdoor1/P1010010.JPG,char_data/7/P1010010.JPG_0.jpg,1564,34,258,292,214,260,True,9
7,37,kaist_dataset/Mixed/Digital_Camera/(C.S)C-outdoor1/P1010010.JPG,char_data/7/P1010010.JPG_0.jpg,1480,40,296,336,219,256,True,9
7,46,kaist_dataset/Mixed/Digital_Camera/(C.S)C-outdoor1/P1010010.JPG,char_data/7/P1010010.JPG_0.jpg,828,18,337,355,362,408,True,9
7,44,kaist_dataset/Mixed/Digital_Camera/(C.S)C-outdoor1/P1010010.JPG,char_data/7/P1010010.JPG_0.jpg,704,16,356,372,363,407,True,9
7,38,kaist_dataset/Mixed/Digital_Camera/(C.S)C-outdoor1/DSC02344.JPG,char_data/7/DSC02344.JPG_0.jpg,532,14,586,600,256,294,True,9
7,22,kaist_dataset/Mixed/Digital_Camera/(C.S)C-outdoor1/114.jpg,char_data/7/114.jpg_0.jpg,352,16,427,443,375,397,True,9
7,33,kaist_dataset/Mixed/Digital_Camera/(C.S)C-outdoor1/118.JPG,char_data/7/118.JPG_0.jpg,561,17,445,462,361,394,True,9
7,32,kaist_dataset/Mixed/Digital_Camera/(C.S)C-outdoor1/121.JPG,char_data/7/121.JPG_0.jpg,576,18,334,352,272,304,True,9
7,41,kaist_dataset/Mixed/Digital_Camera/(C.S)C-outdoor1/P1010011.JPG,char_data/7/P1010011.JPG_0.jpg,1025,25,515,540,309,350,True,9
7,25,kaist_dataset/Mixed/Digital_Camera/(C.S)C-outdoor1/48.JPG,char_data/7/48.JPG_0.jpg,325,13,253,266,341,366,True,9
7,25,kaist_dataset/Mixed/Digital_Camera/(C.S)C-outdoor1/48.JPG,char_data/7/48.JPG_0.jpg,375,15,400,415,340,365,True,9
7,21,kaist_dataset/Mixed/Digital_Camera/(C.S)C-outdoor1/047.JPG,char_data/7/047.JPG_0.jpg,126,6,601,607,173,194,True,9
7,71,kaist_dataset/Mixed/Digital_Camera/(C.S)C-outdoor1/2007-12-09-day-exterior-004.jpg,char_data/7/2007-12-09-day-exterior-004.jpg_0.jpg,3266,46,1172,1218,660,731,True,9
7,76,kaist_dataset/Mixed/Digital_Camera/(C.S)C-outdoor1/2007-12-09-day-exterior-004.jpg,char_data/7/2007-12-09-day-exterior-004.jpg_0.jpg,3496,46,1219,1265,657,733,True,9
7,67,kaist_dataset/Mixed/Digital_Camera/(C.S)C-outdoor1/2007-12-09-day-exterior-004.jpg,char_data/7/2007-12-09-day-exterior-004.jpg_0.jpg,3216,48,1322,1370,662,729,True,9
7,38,kaist_dataset/Mixed/Digital_Camera/(C.S)C-outdoor1/P1010009.JPG,char_data/7/P1010009.JPG_0.jpg,1026,27,241,268,240,278,True,9
7,51,kaist_dataset/Mixed/Digital_Camera/(C.S)C-outdoor1/DSC02312.JPG,char_data/7/DSC02312.JPG_0.jpg,1734,34,246,280,216,267,True,9
7,28,kaist_dataset/Mixed/Digital_Camera/(C.S)C-outdoor1/47.JPG,char_data/7/47.JPG_0.jpg,308,11,340,351,476,504,True,9
7,31,kaist_dataset/Mixed/Digital_Camera/(C.S)C-outdoor1/105.jpg,char_data/7/105.jpg_0.jpg,651,21,267,288,386,417,True,9
7,35,kaist_dataset/Mixed/Digital_Camera/(C.S)C-outdoor1/55.JPG,char_data/7/55.JPG_0.jpg,1015,29,378,407,368,403,True,9
7,36,kaist_dataset/Mixed/Digital_Camera/(C.S)C-outdoor1/55.JPG,char_data/7/55.JPG_0.jpg,864,24,408,432,367,403,True,9
7,34,kaist_dataset/Mixed/Digital_Camera/(C.S)C-outdoor1/55.JPG,char_data/7/55.JPG_0.jpg,952,28,433,461,368,402,True,9
7,34,kaist_dataset/Mixed/Digital_Camera/(C.S)C-outdoor1/55.JPG,char_data/7/55.JPG_0.jpg,1122,33,460,493,366,400,True,9
7,39,kaist_dataset/Mixed/Digital_Camera/(C.S)C-outdoor1/2.JPG,char_data/7/2.JPG_0.jpg,741,19,359,378,67,106,True,9
7,41,kaist_dataset/Mixed/Digital_Camera/(C.S)C-outdoor1/2.JPG,char_data/7/2.JPG_0.jpg,779,19,379,398,65,106,True,9
7,24,kaist_dataset/Mixed/Digital_Camera/(C.S)C-outdoor1/2.JPG,char_data/7/2.JPG_0.jpg,216,9,614,623,393,417,True,9
7,25,kaist_dataset/Mixed/Digital_Camera/(C.S)C-outdoor1/063.JPG,char_data/7/063.JPG_0.jpg,400,16,460,476,258,283,True,9
7,33,kaist_dataset/Mixed/Digital_Camera/(C.S)C-outdoor1/DSC02325.JPG,char_data/7/DSC02325.JPG_0.jpg,759,23,389,412,310,343,True,9
7,82,kaist_dataset/Mixed/Digital_Camera/(C.S)F-others/DSC03224.JPG,char_data/7/DSC03224.JPG_0.jpg,4756,58,426,484,195,277,True,9
7,31,kaist_dataset/Mixed/Digital_Camera/(C.S)F-others/2007-12-08-day-044.jpg,char_data/7/2007-12-08-day-044.jpg_0.jpg,527,17,1103,1120,836,867,True,9
7,49,kaist_dataset/Mixed/Digital_Camera/(C.S)F-others/2007-12-08-day-044.jpg,char_data/7/2007-12-08-day-044.jpg_0.jpg,1078,22,47,69,727,776,True,9
7,38,kaist_dataset/Mixed/Digital_Camera/(C.S)F-others/DSC02803.JPG,char_data/7/DSC02803.JPG_0.jpg,836,22,147,169,355,393,True,9
7,77,kaist_dataset/Mixed/Digital_Camera/(C.S)F-others/2007-12-08-day-067.jpg,char_data/7/2007-12-08-day-067.jpg_0.jpg,5005,65,1016,1081,1,78,True,9
7,38,kaist_dataset/Mixed/Digital_Camera/(C.S)D-indoor2/DSC04256.JPG,char_data/7/DSC04256.JPG_0.jpg,874,23,452,475,146,184,True,9
7,37,kaist_dataset/Mixed/Digital_Camera/(C.S)D-indoor2/DSC04256.JPG,char_data/7/DSC04256.JPG_0.jpg,740,20,528,548,152,189,True,9
7,21,kaist_dataset/Mixed/Digital_Camera/(C.S)E-night/P1010155.JPG,char_data/7/P1010155.JPG_0.jpg,252,12,452,464,286,307,True,9
7,30,kaist_dataset/Mixed/Digital_Camera/(C.S)E-night/DSC02660.JPG,char_data/7/DSC02660.JPG_0.jpg,600,20,260,280,420,450,True,9
7,38,kaist_dataset/Mixed/Digital_Camera/(C.S)E-night/DSC02647.JPG,char_data/7/DSC02647.JPG_0.jpg,988,26,302,328,276,314,True,9
7,38,kaist_dataset/Mixed/Digital_Camera/(C.S)E-night/DSC02647.JPG,char_data/7/DSC02647.JPG_0.jpg,798,21,356,377,269,307,True,9
7,74,kaist_dataset/Mixed/Digital_Camera/(C.S)E-night/P1010152.JPG,char_data/7/P1010152.JPG_0.jpg,3700,50,244,294,222,296,True,9
7,32,kaist_dataset/Mixed/Digital_Camera/(C.S)E-night/DSC03840.JPG,char_data/7/DSC03840.JPG_0.jpg,416,13,520,533,208,240,True,9
7,33,kaist_dataset/Mixed/Digital_Camera/(C.S)E-night/DSC03840.JPG,char_data/7/DSC03840.JPG_0.jpg,561,17,534,551,212,245,True,9
7,33,kaist_dataset/Mixed/Digital_Camera/(C.S)E-night/DSC02586.JPG,char_data/7/DSC02586.JPG_0.jpg,462,14,339,353,395,428,True,9
7,33,kaist_dataset/Mixed/Digital_Camera/(C.S)E-night/DSC02586.JPG,char_data/7/DSC02586.JPG_0.jpg,495,15,365,380,392,425,True,9
7,34,kaist_dataset/Mixed/Digital_Camera/(C.S)E-night/DSC02586.JPG,char_data/7/DSC02586.JPG_0.jpg,408,12,396,408,391,425,True,9
7,29,kaist_dataset/Mixed/Digital_Camera/(C.S)E-night/DSC02586.JPG,char_data/7/DSC02586.JPG_0.jpg,580,20,408,428,391,420,True,9
7,78,kaist_dataset/Mixed/Digital_Camera/(C.S)E-night/P1010151.JPG,char_data/7/P1010151.JPG_0.jpg,4212,54,222,276,350,428,True,9
7,37,kaist_dataset/Mixed/Digital_Camera/(C.S)E-night/DSC02673.JPG,char_data/7/DSC02673.JPG_0.jpg,481,13,338,351,304,341,True,9
7,39,kaist_dataset/Mixed/Digital_Camera/(C.S)E-night/DSC02673.JPG,char_data/7/DSC02673.JPG_0.jpg,585,15,366,381,300,339,True,9
7,56,kaist_dataset/Mixed/Digital_Camera/(C.S)E-night/DSC02595.JPG,char_data/7/DSC02595.JPG_0.jpg,2296,41,484,525,341,397,True,9
7,47,kaist_dataset/Mixed/Digital_Camera/(C.S)E-night/DSC03561.JPG,char_data/7/DSC03561.JPG_0.jpg,1739,37,361,398,251,298,True,9
7,51,kaist_dataset/Mixed/Digital_Camera/(C.S)E-night/DSC03561.JPG,char_data/7/DSC03561.JPG_0.jpg,1938,38,434,472,248,299,True,9
7,41,kaist_dataset/Mixed/Digital_Camera/(C.S)E-night/DSC02569.JPG,char_data/7/DSC02569.JPG_0.jpg,656,16,439,455,407,448,True,9
7,32,kaist_dataset/Mixed/Digital_Camera/(C.S)E-night/DSC02623.JPG,char_data/7/DSC02623.JPG_0.jpg,480,15,147,162,399,431,True,9
7,54,kaist_dataset/Mixed/Digital_Camera/(C.S)E-night/DSC02573.JPG,char_data/7/DSC02573.JPG_0.jpg,2214,41,443,484,161,215,True,9
7,44,kaist_dataset/Mixed/Digital_Camera/(C.S)D-indoor1/DSC02747.JPG,char_data/7/DSC02747.JPG_0.jpg,1672,38,8,46,332,376,True,9
7,26,kaist_dataset/Mixed/Digital_Camera/(C.S)D-indoor1/DSC04005.JPG,char_data/7/DSC04005.JPG_0.jpg,494,19,278,297,442,468,True,9
7,40,kaist_dataset/Mixed/Digital_Camera/(C.S)D-indoor1/DSC02752.JPG,char_data/7/DSC02752.JPG_0.jpg,1720,43,15,58,251,291,True,9
7,84,kaist_dataset/Mixed/Digital_Camera/(C.S)D-indoor1/DSC03998.JPG,char_data/7/DSC03998.JPG_0.jpg,3276,39,578,617,414,498,True,9
7,43,kaist_dataset/Mixed/Digital_Camera/(C.S)D-indoor1/DSC02755.JPG,char_data/7/DSC02755.JPG_0.jpg,1634,38,29,67,254,297,True,9
7,82,kaist_dataset/Mixed/Digital_Camera/(C.S)D-indoor1/DSC03909.JPG,char_data/7/DSC03909.JPG_0.jpg,2952,36,1,37,99,181,True,9
7,82,kaist_dataset/Mixed/Digital_Camera/(C.S)D-indoor1/DSC03909.JPG,char_data/7/DSC03909.JPG_0.jpg,3444,42,78,120,96,178,True,9
7,49,kaist_dataset/Mixed/Digital_Camera/(C.S)D-indoor1/DSC03909.JPG,char_data/7/DSC03909.JPG_0.jpg,1176,24,412,436,298,347,True,9
7,47,kaist_dataset/Mixed/Digital_Camera/(C.S)D-indoor1/DSC03909.JPG,char_data/7/DSC03909.JPG_0.jpg,940,20,454,474,295,342,True,9
7,89,kaist_dataset/Mixed/Digital_Camera/(C.S)D-indoor1/DSC04002.JPG,char_data/7/DSC04002.JPG_0.jpg,3916,44,502,546,349,438,True,9
7,38,kaist_dataset/Mixed/Digital_Camera/(C.S)D-indoor1/DSC02749.JPG,char_data/7/DSC02749.JPG_0.jpg,1102,29,63,92,368,406,True,9
7,48,kaist_dataset/Mixed/Digital_Camera/(C.S)D-indoor1/DSC03986.JPG,char_data/7/DSC03986.JPG_0.jpg,768,16,97,113,159,207,True,9
7,40,kaist_dataset/Mixed/Digital_Camera/(C.S)D-indoor1/DSC02746.JPG,char_data/7/DSC02746.JPG_0.jpg,1440,36,62,98,297,337,True,9
7,45,kaist_dataset/Mixed/Digital_Camera/(C.S)D-indoor1/DSC02751.JPG,char_data/7/DSC02751.JPG_0.jpg,1530,34,52,86,254,299,True,9
7,33,kaist_dataset/Mixed/Digital_Camera/(C.S)D-indoor1/DSC02750.JPG,char_data/7/DSC02750.JPG_0.jpg,1089,33,49,82,273,306,True,9
7,46,kaist_dataset/Mixed/Digital_Camera/(C.S)D-indoor1/DSC02748.JPG,char_data/7/DSC02748.JPG_0.jpg,1610,35,35,70,340,386,True,9
7,123,kaist_dataset/Mixed/Digital_Camera/(C.S)C-outdoor5/DSC04449.JPG,char_data/7/DSC04449.JPG_0.jpg,9348,76,345,421,34,157,True,9
7,29,kaist_dataset/Mixed/Digital_Camera/(C.S)C-outdoor5/DSC04146.JPG,char_data/7/DSC04146.JPG_0.jpg,580,20,286,306,406,435,True,9
7,44,kaist_dataset/Mixed/Digital_Camera/(C.S)C-outdoor5/DSC04395.JPG,char_data/7/DSC04395.JPG_0.jpg,1100,25,153,178,289,333,True,9
7,38,kaist_dataset/Mixed/Digital_Camera/(C.S)C-outdoor5/DSC04144.JPG,char_data/7/DSC04144.JPG_0.jpg,836,22,325,347,417,455,True,9
7,68,kaist_dataset/Mixed/Digital_Camera/(C.S)C-outdoor5/DSC04108.JPG,char_data/7/DSC04108.JPG_0.jpg,2312,34,388,422,238,306,True,9
7,66,kaist_dataset/Mixed/Digital_Camera/(C.S)C-outdoor5/DSC04108.JPG,char_data/7/DSC04108.JPG_0.jpg,2574,39,447,486,236,302,True,9
7,67,kaist_dataset/Mixed/Digital_Camera/(C.S)C-outdoor5/DSC04108.JPG,char_data/7/DSC04108.JPG_0.jpg,2412,36,486,522,234,301,True,9
7,35,kaist_dataset/Mixed/Digital_Camera/(C.S)C-outdoor5/DSC04155.JPG,char_data/7/DSC04155.JPG_0.jpg,595,17,510,527,260,295,True,9
7,29,kaist_dataset/Mixed/Digital_Camera/(C.S)C-outdoor5/DSC04072.JPG,char_data/7/DSC04072.JPG_0.jpg,377,13,459,472,350,379,True,9
7,30,kaist_dataset/Mixed/Digital_Camera/(C.S)C-outdoor5/DSC04072.JPG,char_data/7/DSC04072.JPG_0.jpg,390,13,503,516,350,380,True,9
7,37,kaist_dataset/Mixed/Digital_Camera/(C.S)C-outdoor5/DSC04072.JPG,char_data/7/DSC04072.JPG_0.jpg,407,11,516,527,344,381,True,9
7,29,kaist_dataset/Mixed/Digital_Camera/(C.S)C-outdoor5/DSC04072.JPG,char_data/7/DSC04072.JPG_0.jpg,406,14,570,584,351,380,True,9
7,32,kaist_dataset/Mixed/Digital_Camera/(C.S)C-outdoor5/DSC04072.JPG,char_data/7/DSC04072.JPG_0.jpg,384,12,594,606,349,381,True,9
7,82,kaist_dataset/Mixed/Digital_Camera/(C.S)C-outdoor5/DSC04016.JPG,char_data/7/DSC04016.JPG_0.jpg,4100,50,347,397,106,188,True,9
7,26,kaist_dataset/Mixed/Digital_Camera/(C.S)C-outdoor5/DSC04151.JPG,char_data/7/DSC04151.JPG_0.jpg,390,15,470,485,346,372,True,9
7,60,kaist_dataset/Mixed/Digital_Camera/(C.S)C-outdoor5/DSC04364.JPG,char_data/7/DSC04364.JPG_0.jpg,2100,35,292,327,397,457,True,9
7,39,kaist_dataset/Mixed/Digital_Camera/(C.S)C-outdoor5/DSC04140.JPG,char_data/7/DSC04140.JPG_0.jpg,468,12,564,576,341,380,True,9
7,41,kaist_dataset/Mixed/Digital_Camera/(C.S)C-outdoor5/DSC04122.JPG,char_data/7/DSC04122.JPG_0.jpg,656,16,397,413,410,451,True,9
7,33,kaist_dataset/Mixed/Digital_Camera/(C.S)C-outdoor5/DSC04061.JPG,char_data/7/DSC04061.JPG_0.jpg,495,15,509,524,146,179,True,9
7,37,kaist_dataset/Mixed/Digital_Camera/(C.S)C-outdoor5/DSC04061.JPG,char_data/7/DSC04061.JPG_0.jpg,592,16,564,580,141,178,True,9
7,41,kaist_dataset/Mixed/Digital_Camera/(C.S)C-outdoor5/DSC04071.JPG,char_data/7/DSC04071.JPG_0.jpg,820,20,125,145,361,402,True,9
7,55,kaist_dataset/Mixed/Digital_Camera/(C.S)C-outdoor5/DSC04033.JPG,char_data/7/DSC04033.JPG_0.jpg,2310,42,181,223,281,336,True,9
7,58,kaist_dataset/Mixed/Digital_Camera/(C.S)C-outdoor5/DSC04033.JPG,char_data/7/DSC04033.JPG_0.jpg,2146,37,302,339,272,330,True,9
7,45,kaist_dataset/Mixed/Digital_Camera/(C.S)C-outdoor5/DSC03821.JPG,char_data/7/DSC03821.JPG_0.jpg,1260,28,354,382,77,122,True,9
7,64,kaist_dataset/Mixed/Digital_Camera/(C.S)C-outdoor5/DSC03837.JPG,char_data/7/DSC03837.JPG_0.jpg,2368,37,258,295,304,368,True,9
7,23,kaist_dataset/Mixed/Digital_Camera/(C.S)C-outdoor5/P1010004.JPG,char_data/7/P1010004.JPG_0.jpg,322,14,294,308,311,334,True,9
7,35,kaist_dataset/Mixed/Digital_Camera/(C.S)C-outdoor5/P1010004.JPG,char_data/7/P1010004.JPG_0.jpg,490,14,346,360,305,340,True,9
7,27,kaist_dataset/Mixed/Digital_Camera/(C.S)C-outdoor5/P1010004.JPG,char_data/7/P1010004.JPG_0.jpg,486,18,368,386,311,338,True,9
7,23,kaist_dataset/Mixed/Digital_Camera/(C.S)C-outdoor5/DSC04031.JPG,char_data/7/DSC04031.JPG_0.jpg,253,11,499,510,382,405,True,9
7,23,kaist_dataset/Mixed/Digital_Camera/(C.S)C-outdoor5/DSC04031.JPG,char_data/7/DSC04031.JPG_0.jpg,207,9,521,530,380,403,True,9
7,25,kaist_dataset/Mixed/Digital_Camera/(C.S)C-outdoor5/DSC04031.JPG,char_data/7/DSC04031.JPG_0.jpg,300,12,532,544,380,405,True,9
7,24,kaist_dataset/Mixed/Digital_Camera/(C.S)C-outdoor5/DSC04031.JPG,char_data/7/DSC04031.JPG_0.jpg,264,11,197,208,380,404,True,9
7,24,kaist_dataset/Mixed/Digital_Camera/(C.S)C-outdoor5/DSC04031.JPG,char_data/7/DSC04031.JPG_0.jpg,240,10,221,231,381,405,True,9
7,25,kaist_dataset/Mixed/Digital_Camera/(C.S)C-outdoor5/DSC04150.JPG,char_data/7/DSC04150.JPG_0.jpg,325,13,503,516,364,389,True,9
7,54,kaist_dataset/Mixed/Digital_Camera/(C.S)C-outdoor5/DSC04017.JPG,char_data/7/DSC04017.JPG_0.jpg,1998,37,273,310,424,478,True,9
7,51,kaist_dataset/Mixed/Digital_Camera/(C.S)C-outdoor5/DSC04017.JPG,char_data/7/DSC04017.JPG_0.jpg,2295,45,333,378,425,476,True,9
7,35,kaist_dataset/Mixed/Digital_Camera/(C.S)C-outdoor5/DSC04048.JPG,char_data/7/DSC04048.JPG_0.jpg,700,20,312,332,166,201,True,9
7,40,kaist_dataset/Mixed/Digital_Camera/(C.S)C-outdoor5/P1010002.JPG,char_data/7/P1010002.JPG_0.jpg,880,22,599,621,278,318,True,9
7,42,kaist_dataset/Mixed/Digital_Camera/(C.S)C-outdoor5/DSC04139.JPG,char_data/7/DSC04139.JPG_0.jpg,882,21,387,408,399,441,True,9
7,46,kaist_dataset/Mixed/Digital_Camera/(C.S)C-outdoor5/DSC04135.JPG,char_data/7/DSC04135.JPG_0.jpg,1150,25,424,449,384,430,True,9
7,88,kaist_dataset/Mixed/Digital_Camera/(C.S)C-outdoor5/DSC04054.JPG,char_data/7/DSC04054.JPG_0.jpg,7392,84,260,344,64,152,True,9
7,39,kaist_dataset/Mixed/Digital_Camera/(C.S)C-outdoor5/DSC04055.JPG,char_data/7/DSC04055.JPG_0.jpg,1443,37,70,107,369,408,True,9
7,40,kaist_dataset/Mixed/Digital_Camera/(C.S)C-outdoor5/DSC03842.JPG,char_data/7/DSC03842.JPG_0.jpg,800,20,246,266,228,268,True,9
7,37,kaist_dataset/Mixed/Digital_Camera/(C.S)C-outdoor5/DSC04056.JPG,char_data/7/DSC04056.JPG_0.jpg,851,23,546,569,258,295,True,9
7,36,kaist_dataset/Mixed/Digital_Camera/(C.S)C-outdoor5/DSC04115.JPG,char_data/7/DSC04115.JPG_0.jpg,936,26,460,486,356,392,True,9
7,147,kaist_dataset/Mixed/Digital_Camera/(C.S)C-outdoor5/P1010006.JPG,char_data/7/P1010006.JPG_0.jpg,15288,104,105,209,168,315,True,9
7,49,kaist_dataset/Mixed/Digital_Camera/(C.S)C-outdoor3/DSC03189.JPG,char_data/7/DSC03189.JPG_0.jpg,1176,24,389,413,304,353,True,9
7,34,kaist_dataset/Mixed/Digital_Camera/(C.S)C-outdoor3/DSC03316.JPG,char_data/7/DSC03316.JPG_0.jpg,510,15,293,308,85,119,True,9
7,33,kaist_dataset/Mixed/Digital_Camera/(C.S)C-outdoor3/DSC03316.JPG,char_data/7/DSC03316.JPG_0.jpg,462,14,454,468,83,116,True,9
7,39,kaist_dataset/Mixed/Digital_Camera/(C.S)C-outdoor3/DSC02958.JPG,char_data/7/DSC02958.JPG_0.jpg,897,23,261,284,404,443,True,9
7,27,kaist_dataset/Mixed/Digital_Camera/(C.S)C-outdoor3/DSC03303.JPG,char_data/7/DSC03303.JPG_0.jpg,567,21,276,297,280,307,True,9
7,36,kaist_dataset/Mixed/Digital_Camera/(C.S)C-outdoor3/DSC03312.JPG,char_data/7/DSC03312.JPG_0.jpg,1260,35,153,188,284,320,True,9
7,32,kaist_dataset/Mixed/Digital_Camera/(C.S)C-outdoor3/DSC03255.JPG,char_data/7/DSC03255.JPG_0.jpg,640,20,210,230,181,213,True,9
7,44,kaist_dataset/Mixed/Digital_Camera/(C.S)C-outdoor3/DSC03323.JPG,char_data/7/DSC03323.JPG_0.jpg,1012,23,219,242,303,347,True,9
7,43,kaist_dataset/Mixed/Digital_Camera/(C.S)C-outdoor3/DSC02970.JPG,char_data/7/DSC02970.JPG_0.jpg,1247,29,171,200,361,404,True,9
7,44,kaist_dataset/Mixed/Digital_Camera/(C.S)C-outdoor3/DSC03212.JPG,char_data/7/DSC03212.JPG_0.jpg,880,20,395,415,250,294,True,9
7,27,kaist_dataset/Mixed/Digital_Camera/(C.S)C-outdoor3/DSC03315.JPG,char_data/7/DSC03315.JPG_0.jpg,486,18,361,379,124,151,True,9
7,25,kaist_dataset/Mixed/Digital_Camera/(C.S)C-outdoor3/DSC03315.JPG,char_data/7/DSC03315.JPG_0.jpg,475,19,412,431,124,149,True,9
7,29,kaist_dataset/Mixed/Digital_Camera/(C.S)C-outdoor3/DSC03315.JPG,char_data/7/DSC03315.JPG_0.jpg,522,18,431,449,121,150,True,9
7,32,kaist_dataset/Mixed/Digital_Camera/(C.S)C-outdoor3/DSC03301.JPG,char_data/7/DSC03301.JPG_0.jpg,512,16,374,390,142,174,True,9
7,34,kaist_dataset/Mixed/Digital_Camera/(C.S)C-outdoor3/DSC02956.JPG,char_data/7/DSC02956.JPG_0.jpg,646,19,114,133,391,425,True,9
7,44,kaist_dataset/Mixed/Digital_Camera/(C.S)C-outdoor3/DSC02956.JPG,char_data/7/DSC02956.JPG_0.jpg,924,21,134,155,388,432,True,9
7,63,kaist_dataset/Mixed/Digital_Camera/(C.S)C-outdoor3/DSC03332.JPG,char_data/7/DSC03332.JPG_0.jpg,2142,34,114,148,339,402,True,9
7,68,kaist_dataset/Mixed/Digital_Camera/(C.S)C-outdoor3/DSC03284.JPG,char_data/7/DSC03284.JPG_0.jpg,4760,70,166,236,335,403,True,9
7,33,kaist_dataset/Mixed/Digital_Camera/(C.S)C-outdoor3/DSC03311.JPG,char_data/7/DSC03311.JPG_0.jpg,495,15,357,372,368,401,True,9
7,34,kaist_dataset/Mixed/Digital_Camera/(C.S)C-outdoor3/DSC03311.JPG,char_data/7/DSC03311.JPG_0.jpg,578,17,391,408,367,401,True,9
7,38,kaist_dataset/Mixed/Digital_Camera/(C.S)C-outdoor3/DSC02969.JPG,char_data/7/DSC02969.JPG_0.jpg,912,24,282,306,231,269,True,9
7,41,kaist_dataset/Mixed/Digital_Camera/(C.S)C-outdoor3/DSC03309.JPG,char_data/7/DSC03309.JPG_0.jpg,984,24,348,372,257,298,True,9
7,30,kaist_dataset/Mixed/Digital_Camera/(C.S)C-outdoor3/DSC03017.JPG,char_data/7/DSC03017.JPG_0.jpg,450,15,390,405,242,272,True,9
7,35,kaist_dataset/Mixed/Digital_Camera/(C.S)C-outdoor3/DSC03017.JPG,char_data/7/DSC03017.JPG_0.jpg,560,16,434,450,243,278,True,9
7,45,kaist_dataset/Mixed/Digital_Camera/(C.S)C-outdoor3/DSC03061.JPG,char_data/7/DSC03061.JPG_0.jpg,585,13,322,335,248,293,True,9
7,41,kaist_dataset/Mixed/Digital_Camera/(C.S)C-outdoor3/DSC03061.JPG,char_data/7/DSC03061.JPG_0.jpg,820,20,348,368,252,293,True,9
7,39,kaist_dataset/Mixed/Digital_Camera/(C.S)C-outdoor3/DSC03061.JPG,char_data/7/DSC03061.JPG_0.jpg,663,17,367,384,251,290,True,9
7,47,kaist_dataset/Mixed/Digital_Camera/(C.S)C-outdoor3/DSC03061.JPG,char_data/7/DSC03061.JPG_0.jpg,611,13,384,397,248,295,True,9
7,94,kaist_dataset/Mixed/Digital_Camera/(C.S)C-outdoor3/DSC03271.JPG,char_data/7/DSC03271.JPG_0.jpg,6956,74,253,327,340,434,True,9
7,33,kaist_dataset/Mixed/Digital_Camera/(C.S)C-outdoor3/DSC03308.JPG,char_data/7/DSC03308.JPG_0.jpg,726,22,228,250,249,282,True,9
7,31,kaist_dataset/Mixed/Digital_Camera/(C.S)C-outdoor6/P1010073.JPG,char_data/7/P1010073.JPG_0.jpg,341,11,399,410,241,272,True,9
7,30,kaist_dataset/Mixed/Digital_Camera/(C.S)C-outdoor6/P1010073.JPG,char_data/7/P1010073.JPG_0.jpg,420,14,410,424,243,273,True,9
7,37,kaist_dataset/Mixed/Digital_Camera/(C.S)C-outdoor6/P1010120.JPG,char_data/7/P1010120.JPG_0.jpg,1073,29,350,379,192,229,True,9
7,31,kaist_dataset/Mixed/Digital_Camera/(C.S)C-outdoor6/P1010020.JPG,char_data/7/P1010020.JPG_0.jpg,527,17,155,172,336,367,True,9
7,31,kaist_dataset/Mixed/Digital_Camera/(C.S)C-outdoor6/P1010020.JPG,char_data/7/P1010020.JPG_0.jpg,713,23,121,144,231,262,True,9
7,31,kaist_dataset/Mixed/Digital_Camera/(C.S)C-outdoor6/P1010020.JPG,char_data/7/P1010020.JPG_0.jpg,775,25,239,264,233,264,True,9
7,41,kaist_dataset/Mixed/Digital_Camera/(C.S)C-outdoor6/P1010111.JPG,char_data/7/P1010111.JPG_0.jpg,1435,35,288,323,204,245,True,9
7,37,kaist_dataset/Mixed/Digital_Camera/(C.S)C-outdoor6/P1010111.JPG,char_data/7/P1010111.JPG_0.jpg,1295,35,387,422,207,244,True,9
7,28,kaist_dataset/Mixed/Digital_Camera/(C.S)C-outdoor6/P1010138.JPG,char_data/7/P1010138.JPG_0.jpg,728,26,401,427,183,211,True,9
7,62,kaist_dataset/Mixed/Digital_Camera/(C.S)C-outdoor6/P1010017.JPG,char_data/7/P1010017.JPG_0.jpg,1488,24,419,443,181,243,True,9
7,23,kaist_dataset/Mixed/Digital_Camera/(C.S)C-outdoor6/P1010085.JPG,char_data/7/P1010085.JPG_0.jpg,276,12,382,394,155,178,True,9
7,27,kaist_dataset/Mixed/Digital_Camera/(C.S)C-outdoor6/P1010093.JPG,char_data/7/P1010093.JPG_0.jpg,405,15,584,599,248,275,True,9
7,53,kaist_dataset/Mixed/Digital_Camera/(C.S)C-outdoor6/P1010084.JPG,char_data/7/P1010084.JPG_0.jpg,1908,36,339,375,186,239,True,9
7,29,kaist_dataset/Mixed/Digital_Camera/(C.S)C-outdoor6/P1010103.JPG,char_data/7/P1010103.JPG_0.jpg,493,17,477,494,203,232,True,9
7,24,kaist_dataset/Mixed/Digital_Camera/(C.S)C-outdoor6/P1010065.JPG,char_data/7/P1010065.JPG_0.jpg,480,20,347,367,236,260,True,9
7,37,kaist_dataset/Mixed/Digital_Camera/(C.S)C-outdoor6/P1010056.JPG,char_data/7/P1010056.JPG_0.jpg,481,13,321,334,227,264,True,9
7,38,kaist_dataset/Mixed/Digital_Camera/(C.S)C-outdoor6/P1010018.JPG,char_data/7/P1010018.JPG_0.jpg,722,19,277,296,239,277,True,9
7,34,kaist_dataset/Mixed/Digital_Camera/(C.S)C-outdoor6/P1010018.JPG,char_data/7/P1010018.JPG_0.jpg,578,17,517,534,244,278,True,9
7,69,kaist_dataset/Mixed/Digital_Camera/(C.S)C-outdoor6/P1010067.JPG,char_data/7/P1010067.JPG_0.jpg,2277,33,553,586,298,367,True,9
7,34,kaist_dataset/Mixed/Digital_Camera/(C.S)C-outdoor6/P1010137.JPG,char_data/7/P1010137.JPG_0.jpg,850,25,46,71,72,106,True,9
7,43,kaist_dataset/Mixed/Digital_Camera/(C.S)C-outdoor6/P1010074.JPG,char_data/7/P1010074.JPG_0.jpg,2064,48,302,350,301,344,True,9
7,46,kaist_dataset/Mixed/Digital_Camera/(C.S)C-outdoor4/DSC03651.JPG,char_data/7/DSC03651.JPG_0.jpg,1472,32,332,364,358,404,True,9
7,48,kaist_dataset/Mixed/Digital_Camera/(C.S)C-outdoor4/DSC03651.JPG,char_data/7/DSC03651.JPG_0.jpg,1584,33,388,421,357,405,True,9
7,51,kaist_dataset/Mixed/Digital_Camera/(C.S)C-outdoor4/DSC03651.JPG,char_data/7/DSC03651.JPG_0.jpg,1836,36,421,457,354,405,True,9
7,36,kaist_dataset/Mixed/Digital_Camera/(C.S)C-outdoor4/DSC03719.JPG,char_data/7/DSC03719.JPG_0.jpg,612,17,575,592,178,214,True,9
7,53,kaist_dataset/Mixed/Digital_Camera/(C.S)C-outdoor4/DSC03738.JPG,char_data/7/DSC03738.JPG_0.jpg,1749,33,338,371,233,286,True,9
7,45,kaist_dataset/Mixed/Digital_Camera/(C.S)C-outdoor4/DSC03738.JPG,char_data/7/DSC03738.JPG_0.jpg,1530,34,430,464,238,283,True,9
7,48,kaist_dataset/Mixed/Digital_Camera/(C.S)C-outdoor4/DSC03613.JPG,char_data/7/DSC03613.JPG_0.jpg,1152,24,572,596,28,76,True,9
7,35,kaist_dataset/Mixed/Digital_Camera/(C.S)C-outdoor4/DSC03656.JPG,char_data/7/DSC03656.JPG_0.jpg,1015,29,416,445,414,449,True,9
7,39,kaist_dataset/Mixed/Digital_Camera/(C.S)C-outdoor4/DSC03656.JPG,char_data/7/DSC03656.JPG_0.jpg,975,25,445,470,412,451,True,9
7,29,kaist_dataset/Mixed/Digital_Camera/(C.S)C-outdoor4/DSC03733.JPG,char_data/7/DSC03733.JPG_0.jpg,435,15,516,531,176,205,True,9
7,30,kaist_dataset/Mixed/Digital_Camera/(C.S)C-outdoor4/DSC03677.JPG,char_data/7/DSC03677.JPG_0.jpg,360,12,518,530,316,346,True,9
7,27,kaist_dataset/Mixed/Digital_Camera/(C.S)C-outdoor4/DSC03642.JPG,char_data/7/DSC03642.JPG_0.jpg,432,16,464,480,401,428,True,9
7,37,kaist_dataset/Mixed/Digital_Camera/(C.S)C-outdoor4/DSC03435.JPG,char_data/7/DSC03435.JPG_0.jpg,740,20,189,209,409,446,True,9
7,40,kaist_dataset/Mixed/Digital_Camera/(C.S)C-outdoor4/DSC03658.JPG,char_data/7/DSC03658.JPG_0.jpg,880,22,433,455,409,449,True,9
7,30,kaist_dataset/Mixed/Digital_Camera/(C.S)C-outdoor4/DSC03769.JPG,char_data/7/DSC03769.JPG_0.jpg,330,11,193,204,416,446,True,9
7,95,kaist_dataset/Mixed/Digital_Camera/(C.S)C-outdoor4/DSC03544.JPG,char_data/7/DSC03544.JPG_0.jpg,3990,42,466,508,165,260,False,9
7,42,kaist_dataset/Mixed/Digital_Camera/(C.S)C-outdoor4/DSC03660.JPG,char_data/7/DSC03660.JPG_0.jpg,1218,29,331,360,93,135,False,9
7,37,kaist_dataset/Mixed/Digital_Camera/(C.S)C-outdoor4/DSC03660.JPG,char_data/7/DSC03660.JPG_0.jpg,888,24,431,455,91,128,False,9
7,34,kaist_dataset/Mixed/Digital_Camera/(C.S)C-outdoor4/DSC03661.JPG,char_data/7/DSC03661.JPG_0.jpg,578,17,430,447,331,365,False,9
7,38,kaist_dataset/Mixed/Digital_Camera/(C.S)C-outdoor4/DSC03661.JPG,char_data/7/DSC03661.JPG_0.jpg,570,15,462,477,329,367,False,9
7,33,kaist_dataset/Mixed/Digital_Camera/(C.S)C-outdoor4/DSC03691.JPG,char_data/7/DSC03691.JPG_0.jpg,396,12,616,628,218,251,False,9
7,31,kaist_dataset/Mixed/Digital_Camera/(C.S)C-outdoor4/DSC03618.JPG,char_data/7/DSC03618.JPG_0.jpg,651,21,291,312,412,443,False,9
7,85,kaist_dataset/Mixed/Digital_Camera/(C.S)C-outdoor4/DSC03654.JPG,char_data/7/DSC03654.JPG_0.jpg,2720,32,377,409,152,237,False,9
7,95,kaist_dataset/Mixed/Digital_Camera/(C.S)C-outdoor4/DSC03654.JPG,char_data/7/DSC03654.JPG_0.jpg,3705,39,408,447,145,240,False,9
7,31,kaist_dataset/Mixed/Digital_Camera/(C.S)C-outdoor4/DSC03764.JPG,char_data/7/DSC03764.JPG_0.jpg,651,21,290,311,269,300,False,9
7,35,kaist_dataset/Mixed/Digital_Camera/(C.S)C-outdoor4/DSC03718.JPG,char_data/7/DSC03718.JPG_0.jpg,840,24,568,592,400,435,False,9
7,43,kaist_dataset/Mixed/Digital_Camera/(C.S)C-outdoor4/DSC03781.JPG,char_data/7/DSC03781.JPG_0.jpg,1290,30,231,261,375,418,False,9
7,55,kaist_dataset/Mixed/Digital_Camera/(C.S)C-outdoor4/DSC03655.JPG,char_data/7/DSC03655.JPG_0.jpg,1045,19,270,289,384,439,False,9
7,47,kaist_dataset/Mixed/Digital_Camera/(C.S)C-outdoor4/DSC03655.JPG,char_data/7/DSC03655.JPG_0.jpg,940,20,344,364,387,434,False,9
7,45,kaist_dataset/Mixed/Digital_Camera/(C.S)C-outdoor4/DSC03655.JPG,char_data/7/DSC03655.JPG_0.jpg,855,19,551,570,393,438,False,9
7,49,kaist_dataset/Mixed/Digital_Camera/(C.S)C-outdoor4/DSC03655.JPG,char_data/7/DSC03655.JPG_0.jpg,1029,21,571,592,389,438,False,9
7,29,kaist_dataset/Mixed/Digital_Camera/(C.S)C-outdoor4/DSC03549.JPG,char_data/7/DSC03549.JPG_0.jpg,348,12,319,331,424,453,False,9
7,29,kaist_dataset/Mixed/Digital_Camera/(C.S)C-outdoor4/DSC03734.JPG,char_data/7/DSC03734.JPG_0.jpg,406,14,586,600,350,379,False,9
7,27,kaist_dataset/Mixed/Digital_Camera/(C.S)C-outdoor4/DSC03643.JPG,char_data/7/DSC03643.JPG_0.jpg,513,19,503,522,327,354,False,9
7,32,kaist_dataset/Mixed/Digital_Camera/(C.S)C-outdoor4/DSC03673.JPG,char_data/7/DSC03673.JPG_0.jpg,768,24,261,285,309,341,False,9
7,92,kaist_dataset/Mixed/Digital_Camera/(C.S)C-outdoor4/DSC03787.JPG,char_data/7/DSC03787.JPG_0.jpg,2576,28,396,424,138,230,False,9
7,88,kaist_dataset/Mixed/Digital_Camera/(C.S)C-outdoor4/DSC03787.JPG,char_data/7/DSC03787.JPG_0.jpg,2992,34,422,456,136,224,False,9
7,50,kaist_dataset/Mixed/Digital_Camera/(C.S)C-outdoor4/DSC03571.JPG,char_data/7/DSC03571.JPG_0.jpg,1100,22,319,341,302,352,False,9
7,27,kaist_dataset/Mixed/Digital_Camera/(C.S)C-outdoor4/DSC03689.JPG,char_data/7/DSC03689.JPG_0.jpg,297,11,551,562,130,157,False,9
7,42,kaist_dataset/Mixed/Digital_Camera/(C.S)C-outdoor4/DSC03665.JPG,char_data/7/DSC03665.JPG_0.jpg,1428,34,316,350,152,194,False,9
7,38,kaist_dataset/Mixed/Digital_Camera/(C.S)C-outdoor4/DSC03665.JPG,char_data/7/DSC03665.JPG_0.jpg,1368,36,408,444,155,193,False,9
7,40,kaist_dataset/Mixed/Digital_Camera/(C.S)C-outdoor4/DSC03679.JPG,char_data/7/DSC03679.JPG_0.jpg,1080,27,260,287,277,317,False,9
7,36,kaist_dataset/Mixed/Digital_Camera/(C.S)C-outdoor4/DSC03741.JPG,char_data/7/DSC03741.JPG_0.jpg,1188,33,369,402,364,400,False,9
7,37,kaist_dataset/Mixed/Digital_Camera/(C.S)C-outdoor4/DSC03634.JPG,char_data/7/DSC03634.JPG_0.jpg,740,20,472,492,425,462,False,9
7,50,kaist_dataset/Mixed/Digital_Camera/(C.S)C-outdoor4/DSC03662.JPG,char_data/7/DSC03662.JPG_0.jpg,1050,21,559,580,413,463,False,9
7,31,kaist_dataset/Mixed/Digital_Camera/(C.S)C-outdoor4/DSC03757.JPG,char_data/7/DSC03757.JPG_0.jpg,434,14,241,255,337,368,False,9
7,30,kaist_dataset/Mixed/Digital_Camera/(C.S)C-outdoor4/DSC03757.JPG,char_data/7/DSC03757.JPG_0.jpg,390,13,378,391,339,369,False,9
7,27,kaist_dataset/Mixed/Digital_Camera/(C.S)C-outdoor4/DSC03757.JPG,char_data/7/DSC03757.JPG_0.jpg,297,11,402,413,340,367,False,9
7,29,kaist_dataset/Mixed/Digital_Camera/(C.S)C-outdoor4/DSC03687.JPG,char_data/7/DSC03687.JPG_0.jpg,348,12,446,458,396,425,False,9
7,40,kaist_dataset/Mixed/Digital_Camera/(C.S)C-outdoor4/DSC03724.JPG,char_data/7/DSC03724.JPG_0.jpg,840,21,379,400,281,321,False,9
7,43,kaist_dataset/Mixed/Digital_Camera/(C.S)C-outdoor4/DSC03724.JPG,char_data/7/DSC03724.JPG_0.jpg,1075,25,452,477,278,321,False,9
7,43,kaist_dataset/Mixed/Digital_Camera/(C.S)C-outdoor4/DSC03724.JPG,char_data/7/DSC03724.JPG_0.jpg,1118,26,478,504,275,318,False,9
7,24,kaist_dataset/Mixed/Digital_Camera/(C.S)C-outdoor4/DSC03670.JPG,char_data/7/DSC03670.JPG_0.jpg,312,13,498,511,449,473,False,9
7,35,kaist_dataset/Mixed/Digital_Camera/(C.S)C-outdoor4/DSC03722.JPG,char_data/7/DSC03722.JPG_0.jpg,945,27,271,298,203,238,False,9
7,24,kaist_dataset/Mixed/Digital_Camera/(C.S)C-outdoor4/DSC03758.JPG,char_data/7/DSC03758.JPG_0.jpg,408,17,321,338,307,331,False,9
7,38,kaist_dataset/Mixed/Digital_Camera/(C.S)C-outdoor2/DSC02912.JPG,char_data/7/DSC02912.JPG_0.jpg,1254,33,237,270,438,476,False,9
7,36,kaist_dataset/Mixed/Digital_Camera/(C.S)C-outdoor2/DSC02912.JPG,char_data/7/DSC02912.JPG_0.jpg,1512,42,408,450,441,477,False,9
7,35,kaist_dataset/Mixed/Digital_Camera/(C.S)C-outdoor2/DSC02954.JPG,char_data/7/DSC02954.JPG_0.jpg,945,27,191,218,256,291,False,9
7,37,kaist_dataset/Mixed/Digital_Camera/(C.S)C-outdoor2/DSC02954.JPG,char_data/7/DSC02954.JPG_0.jpg,851,23,240,263,258,295,False,9
7,34,kaist_dataset/Mixed/Digital_Camera/(C.S)C-outdoor2/DSC02954.JPG,char_data/7/DSC02954.JPG_0.jpg,578,17,542,559,268,302,False,9
7,34,kaist_dataset/Mixed/Digital_Camera/(C.S)C-outdoor2/DSC02954.JPG,char_data/7/DSC02954.JPG_0.jpg,408,12,579,591,271,305,False,9
7,26,kaist_dataset/Mixed/Digital_Camera/(C.S)C-outdoor2/DSC02555.JPG,char_data/7/DSC02555.JPG_0.jpg,676,26,416,442,249,275,False,9
7,23,kaist_dataset/Mixed/Digital_Camera/(C.S)C-outdoor2/DSC02555.JPG,char_data/7/DSC02555.JPG_0.jpg,667,29,487,516,253,276,False,9
7,35,kaist_dataset/Mixed/Digital_Camera/(C.S)C-outdoor2/DSC02397.JPG,char_data/7/DSC02397.JPG_0.jpg,665,19,494,513,205,240,False,9
7,24,kaist_dataset/Mixed/Digital_Camera/(C.S)C-outdoor2/DSC02477.JPG,char_data/7/DSC02477.JPG_0.jpg,600,25,374,399,246,270,False,9
7,29,kaist_dataset/Mixed/Digital_Camera/(C.S)C-outdoor2/DSC02477.JPG,char_data/7/DSC02477.JPG_0.jpg,783,27,444,471,243,272,False,9
7,31,kaist_dataset/Mixed/Digital_Camera/(C.S)C-outdoor2/DSC02479.JPG,char_data/7/DSC02479.JPG_0.jpg,496,16,542,558,221,252,False,9
7,35,kaist_dataset/Mixed/Digital_Camera/(C.S)C-outdoor2/DSC02887.JPG,char_data/7/DSC02887.JPG_0.jpg,700,20,283,303,119,154,False,9
7,36,kaist_dataset/Mixed/Digital_Camera/(C.S)C-outdoor2/DSC02368.JPG,char_data/7/DSC02368.JPG_0.jpg,612,17,489,506,376,412,False,9
7,33,kaist_dataset/Mixed/Digital_Camera/(C.S)C-outdoor2/DSC02368.JPG,char_data/7/DSC02368.JPG_0.jpg,660,20,510,530,382,415,False,9
7,34,kaist_dataset/Mixed/Digital_Camera/(C.S)C-outdoor2/DSC02947.JPG,char_data/7/DSC02947.JPG_0.jpg,510,15,419,434,228,262,False,9
7,28,kaist_dataset/Mixed/Digital_Camera/(C.S)C-outdoor2/DSC02947.JPG,char_data/7/DSC02947.JPG_0.jpg,476,17,435,452,234,262,False,9
7,38,kaist_dataset/Mixed/Digital_Camera/(C.S)C-outdoor2/DSC02894.JPG,char_data/7/DSC02894.JPG_0.jpg,1064,28,439,467,236,274,False,9
7,37,kaist_dataset/Mixed/Digital_Camera/(C.S)C-outdoor2/DSC02895.JPG,char_data/7/DSC02895.JPG_0.jpg,703,19,316,335,350,387,False,9
7,39,kaist_dataset/Mixed/Digital_Camera/(C.S)C-outdoor2/DSC02482.JPG,char_data/7/DSC02482.JPG_0.jpg,1131,29,408,437,320,359,False,9
7,38,kaist_dataset/Mixed/Digital_Camera/(C.S)C-outdoor2/DSC02482.JPG,char_data/7/DSC02482.JPG_0.jpg,1292,34,451,485,324,362,False,9
7,35,kaist_dataset/Mixed/Digital_Camera/(C.S)C-outdoor2/DSC02930.JPG,char_data/7/DSC02930.JPG_0.jpg,770,22,300,322,193,228,False,9
7,38,kaist_dataset/Mixed/Digital_Camera/(C.S)C-outdoor2/DSC02422.JPG,char_data/7/DSC02422.JPG_0.jpg,646,17,195,212,221,259,False,9
7,39,kaist_dataset/Mixed/Digital_Camera/(C.S)C-outdoor2/DSC02933.JPG,char_data/7/DSC02933.JPG_0.jpg,507,13,571,584,243,282,False,9
7,28,kaist_dataset/Mixed/Digital_Camera/(C.S)C-outdoor2/DSC02936.JPG,char_data/7/DSC02936.JPG_0.jpg,448,16,505,521,228,256,False,9
7,33,kaist_dataset/Mixed/Digital_Camera/(C.S)C-outdoor2/DSC02936.JPG,char_data/7/DSC02936.JPG_0.jpg,528,16,595,611,225,258,False,9
7,36,kaist_dataset/Mixed/Digital_Camera/(C.S)C-outdoor2/DSC02511.JPG,char_data/7/DSC02511.JPG_0.jpg,684,19,336,355,212,248,False,9
7,30,kaist_dataset/Mixed/Digital_Camera/(C.S)C-outdoor2/DSC02556.JPG,char_data/7/DSC02556.JPG_0.jpg,690,23,379,402,343,373,False,9
7,30,kaist_dataset/Mixed/Digital_Camera/(C.S)C-outdoor2/DSC02556.JPG,char_data/7/DSC02556.JPG_0.jpg,840,28,402,430,347,377,False,9
7,35,kaist_dataset/Mixed/Digital_Camera/(C.S)C-outdoor2/DSC02460.JPG,char_data/7/DSC02460.JPG_0.jpg,665,19,341,360,302,337,False,9
7,31,kaist_dataset/Mixed/Digital_Camera/(C.S)C-outdoor2/DSC02926.JPG,char_data/7/DSC02926.JPG_0.jpg,682,22,399,421,151,182,False,9
7,45,kaist_dataset/Mixed/Digital_Camera/(C.S)C-outdoor2/DSC02938.JPG,char_data/7/DSC02938.JPG_0.jpg,990,22,435,457,241,286,False,9
7,43,kaist_dataset/Mixed/Digital_Camera/(C.S)C-outdoor2/DSC02938.JPG,char_data/7/DSC02938.JPG_0.jpg,817,19,458,477,239,282,False,9
7,33,kaist_dataset/Mixed/Digital_Camera/(C.S)C-outdoor2/DSC02379.JPG,char_data/7/DSC02379.JPG_0.jpg,594,18,454,472,289,322,False,9
7,39,kaist_dataset/Mixed/Digital_Camera/(C.S)C-outdoor2/DSC02389.JPG,char_data/7/DSC02389.JPG_0.jpg,1209,31,387,418,36,75,False,9
7,39,kaist_dataset/Mixed/Digital_Camera/(C.S)C-outdoor2/DSC02377.JPG,char_data/7/DSC02377.JPG_0.jpg,858,22,557,579,349,388,False,9
7,24,kaist_dataset/Mixed/Digital_Camera/(C.S)C-outdoor2/P1010015.JPG,char_data/7/P1010015.JPG_0.jpg,288,12,392,404,186,210,False,9
7,40,kaist_dataset/Mixed/Digital_Camera/(C.S)A-shadow/DSC04306.JPG,char_data/7/DSC04306.JPG_0.jpg,1000,25,382,407,410,450,False,9
7,38,kaist_dataset/Mixed/Digital_Camera/(C.S)A-shadow/DSC02579.JPG,char_data/7/DSC02579.JPG_0.jpg,988,26,317,343,400,438,False,9
7,41,kaist_dataset/Mixed/Digital_Camera/(C.S)A-shadow/DSC02579.JPG,char_data/7/DSC02579.JPG_0.jpg,1107,27,343,370,398,439,False,9
7,44,kaist_dataset/Mixed/Digital_Camera/(C.S)A-shadow/DSC02581.JPG,char_data/7/DSC02581.JPG_0.jpg,924,21,276,297,381,425,False,9
7,43,kaist_dataset/Mixed/Digital_Camera/(C.S)A-shadow/P1010019.JPG,char_data/7/P1010019.JPG_0.jpg,946,22,318,340,198,241,False,9
7,36,kaist_dataset/Mixed/Digital_Camera/(C.S)A-shadow/P1010019.JPG,char_data/7/P1010019.JPG_0.jpg,792,22,429,451,201,237,False,9
7,25,kaist_dataset/English/Digital_Camera/(E.S)E-night/크기변환_%BA%F7%BD%BA%BD%C5%B8%DE%B4%BA_01_tjtjdska2008.jpg,char_data/7/크기변환_%BA%F7%BD%BA%BD%C5%B8%DE%B4%BA_01_tjtjdska2008.jpg_0.jpg,500,20,381,401,277,302,False,9
7,52,kaist_dataset/English/Digital_Camera/(E.S)E-night/DSC02610.JPG,char_data/7/DSC02610.JPG_0.jpg,1612,31,226,257,381,433,False,9
7,56,kaist_dataset/English/Digital_Camera/(E.S)E-night/DSC02610.JPG,char_data/7/DSC02610.JPG_0.jpg,2296,41,311,352,374,430,False,9
7,58,kaist_dataset/English/Digital_Camera/(E.S)C-outdoor2/DSC03650.JPG,char_data/7/DSC03650.JPG_0.jpg,1856,32,177,209,283,341,False,9
7,40,kaist_dataset/English/Digital_Camera/(E.S)C-outdoor2/DSC03436.JPG,char_data/7/DSC03436.JPG_0.jpg,920,23,291,314,122,162,False,9
7,53,kaist_dataset/English/Digital_Camera/(E.S)C-outdoor2/DSC03161.JPG,char_data/7/DSC03161.JPG_0.jpg,1749,33,50,83,226,279,False,9
7,56,kaist_dataset/English/Digital_Camera/(E.S)C-outdoor2/DSC03161.JPG,char_data/7/DSC03161.JPG_0.jpg,1792,32,82,114,223,279,False,9
7,36,kaist_dataset/English/Digital_Camera/(E.S)C-outdoor2/DSC03294.JPG,char_data/7/DSC03294.JPG_0.jpg,828,23,245,268,396,432,False,9
7,33,kaist_dataset/English/Digital_Camera/(E.S)C-outdoor2/DSC03294.JPG,char_data/7/DSC03294.JPG_0.jpg,660,20,334,354,399,432,False,9
7,30,kaist_dataset/English/Digital_Camera/(E.S)C-outdoor2/DSC03731.JPG,char_data/7/DSC03731.JPG_0.jpg,360,12,538,550,115,145,False,9
7,27,kaist_dataset/English/Digital_Camera/(E.S)C-outdoor1/056.JPG,char_data/7/056.JPG_0.jpg,378,14,556,570,250,277,False,9
7,43,kaist_dataset/English/Digital_Camera/(E.S)C-outdoor1/DSC02415.JPG,char_data/7/DSC02415.JPG_0.jpg,989,23,548,571,248,291,False,9
7,43,kaist_dataset/English/Digital_Camera/(E.S)C-outdoor1/080116-0065.jpg,char_data/7/080116-0065.jpg_0.jpg,1161,27,420,447,203,246,False,9
7,107,kaist_dataset/English/Digital_Camera/(E.S)C-outdoor1/2007-12-09-day-exterior-056.jpg,char_data/7/2007-12-09-day-exterior-056.jpg_0.jpg,7918,74,737,811,174,281,False,9
7,110,kaist_dataset/English/Digital_Camera/(E.S)C-outdoor1/2007-12-09-day-exterior-056.jpg,char_data/7/2007-12-09-day-exterior-056.jpg_0.jpg,10120,92,473,565,513,623,False,9
7,43,kaist_dataset/English/Digital_Camera/(E.S)F-others/m.jpg,char_data/7/m.jpg_0.jpg,645,15,95,110,173,216,False,9
7,30,kaist_dataset/English/Digital_Camera/(E.S)D-indoor/DSC03943.JPG,char_data/7/DSC03943.JPG_0.jpg,570,19,357,376,312,342,False,9
6,86,kaist_dataset/Korean/Digital_Camera/F-bookCover/DSC02833.JPG,char_data/6/DSC02833.JPG_2.jpg,4644,54,231,285,361,447,True,8
6,92,kaist_dataset/Korean/Digital_Camera/F-bookCover/DSC02832.JPG,char_data/6/DSC02832.JPG_2.jpg,5704,62,224,286,336,428,True,8
6,97,kaist_dataset/Korean/Digital_Camera/F-bookCover/DSC02829.JPG,char_data/6/DSC02829.JPG_2.jpg,6693,69,211,280,44,141,True,8
6,151,kaist_dataset/Korean/Digital_Camera/F-bookCover/DSC02822.JPG,char_data/6/DSC02822.JPG_2.jpg,16006,106,11,117,67,218,True,8
6,110,kaist_dataset/Korean/Digital_Camera/F-bookCover/DSC02834.JPG,char_data/6/DSC02834.JPG_2.jpg,8690,79,206,285,319,429,True,8
6,53,kaist_dataset/Korean/Digital_Camera/outdoor5/DSC03979.JPG,char_data/6/DSC03979.JPG_2.jpg,3551,67,121,188,378,431,True,8
6,28,kaist_dataset/Korean/Digital_Camera/outdoor5/DSC03688.JPG,char_data/6/DSC03688.JPG_2.jpg,364,13,598,611,227,255,True,8
6,29,kaist_dataset/Korean/Digital_Camera/outdoor5/DSC03779.JPG,char_data/6/DSC03779.JPG_2.jpg,696,24,544,568,245,274,True,8
6,31,kaist_dataset/Korean/Digital_Camera/outdoor5/DSC04027.JPG,char_data/6/DSC04027.JPG_4.jpg,465,15,249,264,388,419,True,8
6,44,kaist_dataset/Korean/Digital_Camera/outdoor5/DSC04027.JPG,char_data/6/DSC04027.JPG_4.jpg,836,19,459,478,374,418,True,8
6,39,kaist_dataset/Korean/Digital_Camera/outdoor5/DSC03685.JPG,char_data/6/DSC03685.JPG_4.jpg,936,24,169,193,185,224,True,8
6,38,kaist_dataset/Korean/Digital_Camera/outdoor5/DSC03685.JPG,char_data/6/DSC03685.JPG_4.jpg,874,23,418,441,187,225,True,8
6,50,kaist_dataset/Korean/Digital_Camera/outdoor5/DSC03838.JPG,char_data/6/DSC03838.JPG_6.jpg,1400,28,343,371,202,252,True,8
6,54,kaist_dataset/Korean/Digital_Camera/outdoor5/DSC03838.JPG,char_data/6/DSC03838.JPG_6.jpg,1512,28,396,424,202,256,True,8
6,51,kaist_dataset/Korean/Digital_Camera/outdoor5/DSC03838.JPG,char_data/6/DSC03838.JPG_6.jpg,1683,33,423,456,206,257,True,8
6,42,kaist_dataset/Korean/Digital_Camera/outdoor5/DSC03708.JPG,char_data/6/DSC03708.JPG_2.jpg,1218,29,482,511,264,306,True,8
6,38,kaist_dataset/Korean/Digital_Camera/outdoor5/DSC03794.JPG,char_data/6/DSC03794.JPG_6.jpg,874,23,302,325,364,402,True,8
6,42,kaist_dataset/Korean/Digital_Camera/outdoor5/DSC03794.JPG,char_data/6/DSC03794.JPG_6.jpg,756,18,324,342,360,402,True,8
6,37,kaist_dataset/Korean/Digital_Camera/outdoor5/DSC03794.JPG,char_data/6/DSC03794.JPG_6.jpg,703,19,363,382,362,399,True,8
6,34,kaist_dataset/Korean/Digital_Camera/outdoor5/DSC03751.JPG,char_data/6/DSC03751.JPG_2.jpg,952,28,379,407,407,441,True,8
6,45,kaist_dataset/Korean/Digital_Camera/outdoor5/DSC03970.JPG,char_data/6/DSC03970.JPG_2.jpg,1485,33,99,132,95,140,True,8
6,29,kaist_dataset/Korean/Digital_Camera/outdoor5/DSC03636.JPG,char_data/6/DSC03636.JPG_6.jpg,464,16,313,329,160,189,True,8
6,32,kaist_dataset/Korean/Digital_Camera/outdoor5/DSC03636.JPG,char_data/6/DSC03636.JPG_6.jpg,416,13,344,357,155,187,True,8
6,34,kaist_dataset/Korean/Digital_Camera/outdoor5/DSC03636.JPG,char_data/6/DSC03636.JPG_6.jpg,680,20,322,342,397,431,True,8
6,36,kaist_dataset/Korean/Digital_Camera/outdoor5/DSC03740.JPG,char_data/6/DSC03740.JPG_2.jpg,684,19,495,514,286,322,True,8
6,38,kaist_dataset/Korean/Digital_Camera/outdoor5/DSC03645.JPG,char_data/6/DSC03645.JPG_6.jpg,1064,28,449,477,353,391,True,8
6,38,kaist_dataset/Korean/Digital_Camera/outdoor5/DSC03645.JPG,char_data/6/DSC03645.JPG_6.jpg,1102,29,477,506,353,391,True,8
6,35,kaist_dataset/Korean/Digital_Camera/outdoor5/DSC03645.JPG,char_data/6/DSC03645.JPG_6.jpg,1120,32,507,539,354,389,True,8
6,85,kaist_dataset/Korean/Digital_Camera/outdoor5/DSC03864.JPG,char_data/6/DSC03864.JPG_4.jpg,4335,51,266,317,159,244,True,8
6,86,kaist_dataset/Korean/Digital_Camera/outdoor5/DSC03864.JPG,char_data/6/DSC03864.JPG_4.jpg,4730,55,378,433,168,254,True,8
6,57,kaist_dataset/Korean/Digital_Camera/outdoor5/DSC03858.JPG,char_data/6/DSC03858.JPG_2.jpg,3135,55,106,161,400,457,True,8
6,64,kaist_dataset/Korean/Digital_Camera/outdoor4/DSC03599.JPG,char_data/6/DSC03599.JPG_2.jpg,2432,38,331,369,230,294,True,8
6,98,kaist_dataset/Korean/Digital_Camera/outdoor4/DSC03542.JPG,char_data/6/DSC03542.JPG_6.jpg,5488,56,190,246,236,334,True,8
6,102,kaist_dataset/Korean/Digital_Camera/outdoor4/DSC03542.JPG,char_data/6/DSC03542.JPG_6.jpg,4692,46,443,489,234,336,True,8
6,106,kaist_dataset/Korean/Digital_Camera/outdoor4/DSC03542.JPG,char_data/6/DSC03542.JPG_6.jpg,5406,51,534,585,230,336,True,8
6,66,kaist_dataset/Korean/Digital_Camera/outdoor4/DSC03550.JPG,char_data/6/DSC03550.JPG_4.jpg,3498,53,342,395,306,372,True,8
6,66,kaist_dataset/Korean/Digital_Camera/outdoor4/DSC03550.JPG,char_data/6/DSC03550.JPG_4.jpg,4422,67,503,570,307,373,True,8
6,41,kaist_dataset/Korean/Digital_Camera/outdoor4/DSC03602.JPG,char_data/6/DSC03602.JPG_2.jpg,2009,49,246,295,311,352,True,8
6,95,kaist_dataset/Korean/Digital_Camera/outdoor4/DSC03566.JPG,char_data/6/DSC03566.JPG_12.jpg,5795,61,209,270,148,243,True,8
6,95,kaist_dataset/Korean/Digital_Camera/outdoor4/DSC03566.JPG,char_data/6/DSC03566.JPG_12.jpg,5605,59,333,392,147,242,True,8
6,97,kaist_dataset/Korean/Digital_Camera/outdoor4/DSC03566.JPG,char_data/6/DSC03566.JPG_12.jpg,5432,56,393,449,145,242,True,8
6,34,kaist_dataset/Korean/Digital_Camera/outdoor4/DSC03566.JPG,char_data/6/DSC03566.JPG_12.jpg,2210,65,168,233,93,127,True,8
6,38,kaist_dataset/Korean/Digital_Camera/outdoor4/DSC03566.JPG,char_data/6/DSC03566.JPG_12.jpg,2546,67,291,358,90,128,True,8
6,35,kaist_dataset/Korean/Digital_Camera/outdoor4/DSC03566.JPG,char_data/6/DSC03566.JPG_12.jpg,2275,65,356,421,87,122,True,8
6,49,kaist_dataset/Korean/Digital_Camera/outdoor4/DSC03603.JPG,char_data/6/DSC03603.JPG_2.jpg,1764,36,265,301,386,435,True,8
6,57,kaist_dataset/Korean/Digital_Camera/outdoor4/DSC03261.JPG,char_data/6/DSC03261.JPG_2.jpg,2109,37,276,313,389,446,True,8
6,40,kaist_dataset/Korean/Digital_Camera/outdoor2/DSC02467.JPG,char_data/6/DSC02467.JPG_2.jpg,880,22,246,268,255,295,True,8
6,60,kaist_dataset/Korean/Digital_Camera/outdoor2/2007-12-09-day-exterior-016.jpg,char_data/6/2007-12-09-day-exterior-016.jpg_2.jpg,2400,40,549,589,747,807,True,8
6,29,kaist_dataset/Korean/Digital_Camera/outdoor2/DSC02476.JPG,char_data/6/DSC02476.JPG_2.jpg,725,25,248,273,278,307,True,8
6,22,kaist_dataset/Korean/Digital_Camera/outdoor2/DSC02314.JPG,char_data/6/DSC02314.JPG_2.jpg,528,24,424,448,207,229,True,8
6,75,kaist_dataset/Korean/Digital_Camera/outdoor2/2007-12-08-day-101.jpg,char_data/6/2007-12-08-day-101.jpg_2.jpg,2775,37,993,1030,637,712,True,8
6,32,kaist_dataset/Korean/Digital_Camera/outdoor2/DSC02308.JPG,char_data/6/DSC02308.JPG_2.jpg,1312,41,426,467,238,270,True,8
6,35,kaist_dataset/Korean/Digital_Camera/outdoor2/2007-12-09-day-exterior-036.jpg,char_data/6/2007-12-09-day-exterior-036.jpg_4.jpg,770,22,1452,1474,631,666,True,8
6,45,kaist_dataset/Korean/Digital_Camera/outdoor2/2007-12-09-day-exterior-036.jpg,char_data/6/2007-12-09-day-exterior-036.jpg_4.jpg,1125,25,1553,1578,627,672,True,8
6,28,kaist_dataset/Korean/Digital_Camera/outdoor2/2007-12-08-day-122.jpg,char_data/6/2007-12-08-day-122.jpg_1.jpg,1540,55,885,940,145,173,True,8
6,40,kaist_dataset/Korean/Digital_Camera/outdoor2/2007-12-08-day-122.jpg,char_data/6/2007-12-08-day-122.jpg_1.jpg,960,24,1218,1242,562,602,True,8
6,43,kaist_dataset/Korean/Digital_Camera/outdoor2/2007-12-09-day-exterior-084.jpg,char_data/6/2007-12-09-day-exterior-084.jpg_0.jpg,1376,32,769,801,802,845,True,8
6,65,kaist_dataset/Korean/Digital_Camera/outdoor2/2007-12-09-day-exterior-033.jpg,char_data/6/2007-12-09-day-exterior-033.jpg_0.jpg,4745,73,503,576,723,788,True,8
6,65,kaist_dataset/Korean/Digital_Camera/outdoor2/2007-12-09-day-exterior-033.jpg,char_data/6/2007-12-09-day-exterior-033.jpg_0.jpg,4940,76,956,1032,728,793,True,8
6,32,kaist_dataset/Korean/Digital_Camera/outdoor2/DSC02326.JPG,char_data/6/DSC02326.JPG_0.jpg,480,15,461,476,333,365,True,8
6,36,kaist_dataset/Korean/Digital_Camera/outdoor2/DSC02393.JPG,char_data/6/DSC02393.JPG_0.jpg,828,23,494,517,305,341,True,8
6,42,kaist_dataset/Korean/Digital_Camera/outdoor2/DSC02366.JPG,char_data/6/DSC02366.JPG_0.jpg,1008,24,344,368,404,446,True,8
6,34,kaist_dataset/Korean/Digital_Camera/outdoor2/DSC02380.JPG,char_data/6/DSC02380.JPG_0.jpg,476,14,432,446,233,267,True,8
6,30,kaist_dataset/Korean/Digital_Camera/outdoor2/DSC02373.JPG,char_data/6/DSC02373.JPG_0.jpg,450,15,405,420,334,364,True,8
6,53,kaist_dataset/Korean/Digital_Camera/outdoor2/DSC02512.JPG,char_data/6/DSC02512.JPG_0.jpg,1749,33,422,455,288,341,True,8
6,50,kaist_dataset/Korean/Digital_Camera/outdoor2/DSC02512.JPG,char_data/6/DSC02512.JPG_0.jpg,1650,33,509,542,288,338,True,8
6,51,kaist_dataset/Korean/Digital_Camera/outdoor2/2007-12-09-day-exterior-035.jpg,char_data/6/2007-12-09-day-exterior-035.jpg_0.jpg,1632,32,444,476,706,757,True,8
6,50,kaist_dataset/Korean/Digital_Camera/outdoor2/2007-12-09-day-exterior-035.jpg,char_data/6/2007-12-09-day-exterior-035.jpg_0.jpg,1600,32,776,808,717,767,True,8
6,48,kaist_dataset/Korean/Digital_Camera/outdoor2/2007-12-09-day-exterior-035.jpg,char_data/6/2007-12-09-day-exterior-035.jpg_0.jpg,2064,43,1018,1061,722,770,True,8
6,51,kaist_dataset/Korean/Digital_Camera/outdoor2/2007-12-09-day-exterior-035.jpg,char_data/6/2007-12-09-day-exterior-035.jpg_0.jpg,2091,41,1215,1256,724,775,True,8
6,70,kaist_dataset/Korean/Digital_Camera/outdoor2/2007-12-09-day-exterior-009.jpg,char_data/6/2007-12-09-day-exterior-009.jpg_0.jpg,2660,38,741,779,677,747,True,8
6,57,kaist_dataset/Korean/Digital_Camera/outdoor2/DSC02515.JPG,char_data/6/DSC02515.JPG_0.jpg,2451,43,251,294,323,380,True,8
6,59,kaist_dataset/Korean/Digital_Camera/outdoor2/DSC02515.JPG,char_data/6/DSC02515.JPG_0.jpg,2242,38,417,455,334,393,True,8
6,26,kaist_dataset/Korean/Digital_Camera/outdoor2/DSC02506.JPG,char_data/6/DSC02506.JPG_0.jpg,858,33,268,301,439,465,True,8
6,122,kaist_dataset/Korean/Digital_Camera/outdoor2/DSC02520.JPG,char_data/6/DSC02520.JPG_0.jpg,3660,30,431,461,297,419,True,8
6,28,kaist_dataset/Korean/Digital_Camera/outdoor2/DSC02470.JPG,char_data/6/DSC02470.JPG_0.jpg,560,20,200,220,182,210,True,8
6,57,kaist_dataset/Korean/Digital_Camera/outdoor2/DSC02470.JPG,char_data/6/DSC02470.JPG_0.jpg,1881,33,292,325,377,434,True,8
6,76,kaist_dataset/Korean/Digital_Camera/outdoor2/2007-12-09-day-exterior-012.jpg,char_data/6/2007-12-09-day-exterior-012.jpg_0.jpg,3344,44,1064,1108,621,697,True,8
6,32,kaist_dataset/Korean/Digital_Camera/outdoor2/DSC02310.JPG,char_data/6/DSC02310.JPG_0.jpg,1056,33,259,292,208,240,True,8
6,38,kaist_dataset/Korean/Digital_Camera/outdoor2/DSC02372.JPG,char_data/6/DSC02372.JPG_0.jpg,532,14,550,564,281,319,True,8
6,35,kaist_dataset/Korean/Digital_Camera/outdoor2/DSC02521.JPG,char_data/6/DSC02521.JPG_0.jpg,805,23,310,333,327,362,True,8
6,43,kaist_dataset/Korean/Digital_Camera/outdoor2/DSC02523.JPG,char_data/6/DSC02523.JPG_0.jpg,860,20,476,496,334,377,True,8
6,47,kaist_dataset/Korean/Digital_Camera/E-night/DSC02645.JPG,char_data/6/DSC02645.JPG_0.jpg,1363,29,331,360,334,381,True,8
6,41,kaist_dataset/Korean/Digital_Camera/E-night/DSC03850.JPG,char_data/6/DSC03850.JPG_0.jpg,820,20,384,404,425,466,True,8
6,36,kaist_dataset/Korean/Digital_Camera/E-night/DSC03850.JPG,char_data/6/DSC03850.JPG_0.jpg,540,15,421,436,429,465,True,8
6,37,kaist_dataset/Korean/Digital_Camera/E-night/DSC03850.JPG,char_data/6/DSC03850.JPG_0.jpg,814,22,435,457,428,465,True,8
6,22,kaist_dataset/Korean/Digital_Camera/E-night/P1010149.JPG,char_data/6/P1010149.JPG_0.jpg,352,16,560,576,242,264,True,8
6,37,kaist_dataset/Korean/Digital_Camera/E-night/P1010146.JPG,char_data/6/P1010146.JPG_0.jpg,444,12,332,344,242,279,True,8
6,26,kaist_dataset/Korean/Digital_Camera/E-night/DSC03870.JPG,char_data/6/DSC03870.JPG_0.jpg,390,15,407,422,222,248,True,8
6,31,kaist_dataset/Korean/Digital_Camera/E-night/DSC03870.JPG,char_data/6/DSC03870.JPG_0.jpg,713,23,422,445,220,251,True,8
6,47,kaist_dataset/Korean/Digital_Camera/E-night/DSC02649.JPG,char_data/6/DSC02649.JPG_0.jpg,1034,22,470,492,391,438,True,8
6,45,kaist_dataset/Korean/Digital_Camera/E-night/DSC02649.JPG,char_data/6/DSC02649.JPG_0.jpg,720,16,566,582,392,437,True,8
6,38,kaist_dataset/Korean/Digital_Camera/E-night/DSC02658.JPG,char_data/6/DSC02658.JPG_0.jpg,1026,27,259,286,352,390,True,8
6,54,kaist_dataset/Korean/Digital_Camera/E-night/DSC02594.JPG,char_data/6/DSC02594.JPG_0.jpg,1998,37,149,186,380,434,True,8
6,31,kaist_dataset/Korean/Digital_Camera/E-night/DSC02626.JPG,char_data/6/DSC02626.JPG_0.jpg,372,12,102,114,378,409,True,8
6,33,kaist_dataset/Korean/Digital_Camera/E-night/DSC02626.JPG,char_data/6/DSC02626.JPG_0.jpg,561,17,345,362,364,397,True,8
6,60,kaist_dataset/Korean/Digital_Camera/E-night/DSC02597.JPG,char_data/6/DSC02597.JPG_0.jpg,1740,29,406,435,286,346,True,8
6,42,kaist_dataset/Korean/Digital_Camera/E-night/DSC03515.JPG,char_data/6/DSC03515.JPG_0.jpg,798,19,473,492,276,318,True,8
6,96,kaist_dataset/Korean/Digital_Camera/indoor1/080119-0029.jpg,char_data/6/080119-0029.jpg_0.jpg,4032,42,563,605,572,668,True,8
6,79,kaist_dataset/Korean/Digital_Camera/indoor1/080119-0029.jpg,char_data/6/080119-0029.jpg_0.jpg,2449,31,1402,1433,983,1062,True,8
6,143,kaist_dataset/Korean/Digital_Camera/indoor1/080119-0030.jpg,char_data/6/080119-0030.jpg_0.jpg,12870,90,1096,1186,571,714,True,8
6,29,kaist_dataset/Korean/Digital_Camera/indoor1/080119-0030.jpg,char_data/6/080119-0030.jpg_0.jpg,319,11,772,783,862,891,True,8
6,44,kaist_dataset/Korean/Digital_Camera/indoor1/080119-0018.jpg,char_data/6/080119-0018.jpg_0.jpg,1100,25,1060,1085,940,984,True,8
6,40,kaist_dataset/Korean/Digital_Camera/indoor1/080119-0018.jpg,char_data/6/080119-0018.jpg_0.jpg,1480,37,1205,1242,944,984,True,8
6,32,kaist_dataset/Korean/Digital_Camera/outdoor7/P1010022.JPG,char_data/6/P1010022.JPG_0.jpg,928,29,162,191,258,290,True,8
6,43,kaist_dataset/Korean/Digital_Camera/outdoor7/P1010012.JPG,char_data/6/P1010012.JPG_0.jpg,1161,27,359,386,219,262,True,8
6,32,kaist_dataset/Korean/Digital_Camera/outdoor7/P1010082.JPG,char_data/6/P1010082.JPG_0.jpg,1056,33,276,309,54,86,True,8
6,33,kaist_dataset/Korean/Digital_Camera/outdoor7/P1010082.JPG,char_data/6/P1010082.JPG_0.jpg,891,27,307,334,49,82,True,8
6,39,kaist_dataset/Korean/Digital_Camera/outdoor7/P1010138.JPG,char_data/6/P1010138.JPG_0.jpg,624,16,347,363,283,322,True,8
6,31,kaist_dataset/Korean/Digital_Camera/outdoor7/P1010121.JPG,char_data/6/P1010121.JPG_0.jpg,651,21,490,511,209,240,True,8
6,31,kaist_dataset/Korean/Digital_Camera/outdoor7/P1010121.JPG,char_data/6/P1010121.JPG_0.jpg,899,29,602,631,212,243,True,8
6,37,kaist_dataset/Korean/Digital_Camera/outdoor7/P1010078.JPG,char_data/6/P1010078.JPG_0.jpg,851,23,316,339,251,288,True,8
6,23,kaist_dataset/Korean/Digital_Camera/outdoor7/P1010112.JPG,char_data/6/P1010112.JPG_0.jpg,322,14,549,563,360,383,True,8
6,38,kaist_dataset/Korean/Digital_Camera/outdoor7/P1010061.JPG,char_data/6/P1010061.JPG_0.jpg,1026,27,397,424,319,357,True,8
6,37,kaist_dataset/Korean/Digital_Camera/outdoor7/P1010061.JPG,char_data/6/P1010061.JPG_0.jpg,1073,29,519,548,320,357,True,8
6,40,kaist_dataset/Korean/Digital_Camera/outdoor7/P1010035.JPG,char_data/6/P1010035.JPG_0.jpg,600,15,137,152,202,242,True,8
6,36,kaist_dataset/Korean/Digital_Camera/outdoor8/P1010143.JPG,char_data/6/P1010143.JPG_0.jpg,720,20,459,479,273,309,True,8
6,43,kaist_dataset/Korean/Digital_Camera/outdoor8/P1010142.JPG,char_data/6/P1010142.JPG_0.jpg,1075,25,377,402,277,320,True,8
6,37,kaist_dataset/Korean/Digital_Camera/outdoor8/P1010170.JPG,char_data/6/P1010170.JPG_0.jpg,999,27,419,446,273,310,True,8
6,37,kaist_dataset/Korean/Digital_Camera/outdoor8/P1010170.JPG,char_data/6/P1010170.JPG_0.jpg,777,21,447,468,274,311,True,8
6,38,kaist_dataset/Korean/Digital_Camera/outdoor8/P1011112.JPG,char_data/6/P1011112.JPG_0.jpg,912,24,351,375,210,248,True,8
6,32,kaist_dataset/Korean/Digital_Camera/outdoor8/P1011112.JPG,char_data/6/P1011112.JPG_0.jpg,736,23,409,432,217,249,True,8
6,40,kaist_dataset/Korean/Digital_Camera/indoor2/DSC03983.JPG,char_data/6/DSC03983.JPG_0.jpg,920,23,304,327,324,364,True,8
6,37,kaist_dataset/Korean/Digital_Camera/indoor2/DSC03983.JPG,char_data/6/DSC03983.JPG_0.jpg,962,26,415,441,322,359,True,8
6,61,kaist_dataset/Korean/Digital_Camera/indoor2/DSC03475.JPG,char_data/6/DSC03475.JPG_0.jpg,2379,39,330,369,88,149,True,8
6,70,kaist_dataset/Korean/Digital_Camera/indoor2/P071209063.jpg,char_data/6/P071209063.jpg_0.jpg,3710,53,1020,1073,1069,1139,True,8
6,52,kaist_dataset/Korean/Digital_Camera/indoor2/DSC04204.JPG,char_data/6/DSC04204.JPG_0.jpg,1768,34,381,415,205,257,True,8
6,46,kaist_dataset/Korean/Digital_Camera/indoor2/DSC04204.JPG,char_data/6/DSC04204.JPG_0.jpg,1104,24,475,499,276,322,True,8
6,37,kaist_dataset/Korean/Digital_Camera/indoor2/DSC03975.JPG,char_data/6/DSC03975.JPG_0.jpg,592,16,166,182,290,327,True,8
6,29,kaist_dataset/Korean/Digital_Camera/indoor2/DSC03975.JPG,char_data/6/DSC03975.JPG_0.jpg,406,14,228,242,290,319,True,8
6,46,kaist_dataset/Korean/Digital_Camera/G-others/2007-12-09-day-exterior-083.jpg,char_data/6/2007-12-09-day-exterior-083.jpg_0.jpg,1426,31,543,574,968,1014,True,8
6,58,kaist_dataset/Korean/Digital_Camera/G-others/2007-12-09-day-exterior-083.jpg,char_data/6/2007-12-09-day-exterior-083.jpg_0.jpg,2262,39,329,368,124,182,True,8
6,57,kaist_dataset/Korean/Digital_Camera/G-others/DSC03434.JPG,char_data/6/DSC03434.JPG_0.jpg,1596,28,293,321,25,82,True,8
6,111,kaist_dataset/Korean/Digital_Camera/G-others/2007-12-09-day-exterior-062.jpg,char_data/6/2007-12-09-day-exterior-062.jpg_0.jpg,3441,31,505,536,1396,1507,True,8
6,46,kaist_dataset/Korean/Digital_Camera/G-others/2007-12-08-day-045.jpg,char_data/6/2007-12-08-day-045.jpg_0.jpg,552,12,121,133,795,841,True,8
6,41,kaist_dataset/Korean/Digital_Camera/G-others/2007-12-08-day-045.jpg,char_data/6/2007-12-08-day-045.jpg_0.jpg,410,10,1,11,807,848,True,8
6,45,kaist_dataset/Korean/Digital_Camera/G-others/2007-12-08-day-045.jpg,char_data/6/2007-12-08-day-045.jpg_0.jpg,675,15,69,84,800,845,True,8
6,21,kaist_dataset/Korean/Digital_Camera/G-others/2007-12-08-day-112.jpg,char_data/6/2007-12-08-day-112.jpg_0.jpg,252,12,389,401,1172,1193,True,8
6,87,kaist_dataset/Korean/Digital_Camera/G-others/2007-12-08-day-112.jpg,char_data/6/2007-12-08-day-112.jpg_0.jpg,4611,53,754,807,434,521,True,8
6,57,kaist_dataset/Korean/Digital_Camera/G-others/2007-12-08-day-112.jpg,char_data/6/2007-12-08-day-112.jpg_0.jpg,1311,23,715,738,555,612,True,8
6,42,kaist_dataset/Korean/Digital_Camera/G-others/DSC03862.JPG,char_data/6/DSC03862.JPG_0.jpg,714,17,337,354,354,396,True,8
6,31,kaist_dataset/Korean/Digital_Camera/B-light/DSC02987.JPG,char_data/6/DSC02987.JPG_0.jpg,434,14,458,472,276,307,True,8
6,31,kaist_dataset/Korean/Digital_Camera/B-light/DSC02987.JPG,char_data/6/DSC02987.JPG_0.jpg,496,16,472,488,277,308,True,8
6,30,kaist_dataset/Korean/Digital_Camera/B-light/DSC02987.JPG,char_data/6/DSC02987.JPG_0.jpg,420,14,542,556,279,309,True,8
6,30,kaist_dataset/Korean/Digital_Camera/B-light/DSC02987.JPG,char_data/6/DSC02987.JPG_0.jpg,360,12,584,596,281,311,True,8
6,104,kaist_dataset/Korean/Digital_Camera/outdoor6/DSC04090.JPG,char_data/6/DSC04090.JPG_0.jpg,4680,45,255,300,186,290,True,8
6,31,kaist_dataset/Korean/Digital_Camera/outdoor6/DSC04132.JPG,char_data/6/DSC04132.JPG_0.jpg,620,20,331,351,153,184,True,8
6,37,kaist_dataset/Korean/Digital_Camera/outdoor6/DSC04099.JPG,char_data/6/DSC04099.JPG_0.jpg,851,23,530,553,413,450,True,8
6,38,kaist_dataset/Korean/Digital_Camera/outdoor6/DSC04099.JPG,char_data/6/DSC04099.JPG_0.jpg,912,24,554,578,412,450,True,8
6,78,kaist_dataset/Korean/Digital_Camera/outdoor6/DSC04301.JPG,char_data/6/DSC04301.JPG_0.jpg,5304,68,382,450,363,441,True,8
6,24,kaist_dataset/Korean/Digital_Camera/outdoor6/DSC04042.JPG,char_data/6/DSC04042.JPG_0.jpg,360,15,137,152,332,356,True,8
6,26,kaist_dataset/Korean/Digital_Camera/outdoor6/DSC04042.JPG,char_data/6/DSC04042.JPG_0.jpg,416,16,153,169,330,356,True,8
6,39,kaist_dataset/Korean/Digital_Camera/outdoor6/DSC04116.JPG,char_data/6/DSC04116.JPG_0.jpg,507,13,409,422,315,354,True,8
6,36,kaist_dataset/Korean/Digital_Camera/outdoor6/DSC04112.JPG,char_data/6/DSC04112.JPG_0.jpg,612,17,507,524,273,309,True,8
6,57,kaist_dataset/Korean/Digital_Camera/outdoor6/DSC04100.JPG,char_data/6/DSC04100.JPG_0.jpg,1938,34,300,334,49,106,True,8
6,56,kaist_dataset/Korean/Digital_Camera/outdoor6/DSC04100.JPG,char_data/6/DSC04100.JPG_0.jpg,1400,25,406,431,50,106,True,8
6,62,kaist_dataset/Korean/Digital_Camera/outdoor6/DSC04370.JPG,char_data/6/DSC04370.JPG_0.jpg,3286,53,382,435,318,380,True,8
6,31,kaist_dataset/Korean/Digital_Camera/outdoor6/DSC04138.JPG,char_data/6/DSC04138.JPG_0.jpg,868,28,302,330,153,184,True,8
6,29,kaist_dataset/Korean/Digital_Camera/outdoor6/DSC04138.JPG,char_data/6/DSC04138.JPG_0.jpg,783,27,354,381,156,185,True,8
6,36,kaist_dataset/Korean/Digital_Camera/A-shadow/2007-12-09-day-exterior-040.jpg,char_data/6/2007-12-09-day-exterior-040.jpg_0.jpg,720,20,1000,1020,812,848,True,8
6,74,kaist_dataset/Korean/Digital_Camera/A-shadow/DSC03755.JPG,char_data/6/DSC03755.JPG_0.jpg,2442,33,318,351,209,283,True,8
6,71,kaist_dataset/Korean/Digital_Camera/A-shadow/DSC03755.JPG,char_data/6/DSC03755.JPG_0.jpg,2698,38,478,516,208,279,True,8
6,89,kaist_dataset/Korean/Digital_Camera/A-shadow/DSC04311.JPG,char_data/6/DSC04311.JPG_0.jpg,4806,54,263,317,258,347,True,8
6,68,kaist_dataset/Korean/Digital_Camera/A-shadow/2007-12-09-day-exterior-026.jpg,char_data/6/2007-12-09-day-exterior-026.jpg_0.jpg,2584,38,919,957,756,824,True,8
6,43,kaist_dataset/Korean/Digital_Camera/A-shadow/2007-12-09-day-exterior-025.jpg,char_data/6/2007-12-09-day-exterior-025.jpg_0.jpg,1075,25,957,982,738,781,True,8
6,72,kaist_dataset/Korean/Digital_Camera/A-shadow/DSC03536.JPG,char_data/6/DSC03536.JPG_0.jpg,3240,45,348,393,245,317,True,8
6,77,kaist_dataset/Korean/Digital_Camera/A-shadow/DSC03536.JPG,char_data/6/DSC03536.JPG_0.jpg,3696,48,472,520,233,310,True,8
6,159,kaist_dataset/Korean/Digital_Camera/A-shadow/DSC02670.JPG,char_data/6/DSC02670.JPG_0.jpg,14151,89,99,188,23,182,True,8
6,132,kaist_dataset/Korean/Digital_Camera/A-shadow/089.JPG,char_data/6/089.JPG_0.jpg,11088,84,257,341,163,295,True,8
6,35,kaist_dataset/Korean/Digital_Camera/A-shadow/DSC02598.JPG,char_data/6/DSC02598.JPG_0.jpg,735,21,522,543,415,450,True,8
6,35,kaist_dataset/Korean/Digital_Camera/A-shadow/DSC04297.JPG,char_data/6/DSC04297.JPG_0.jpg,595,17,448,465,208,243,True,8
6,83,kaist_dataset/Korean/Digital_Camera/A-shadow/2007-12-09-day-exterior-031.jpg,char_data/6/2007-12-09-day-exterior-031.jpg_0.jpg,3486,42,603,645,665,748,True,8
6,39,kaist_dataset/Korean/Digital_Camera/outdoor3/DSC02999.JPG,char_data/6/DSC02999.JPG_0.jpg,702,18,369,387,428,467,True,8
6,31,kaist_dataset/Korean/Digital_Camera/outdoor3/DSC02531.JPG,char_data/6/DSC02531.JPG_0.jpg,651,21,225,246,352,383,True,8
6,35,kaist_dataset/Korean/Digital_Camera/outdoor3/DSC02531.JPG,char_data/6/DSC02531.JPG_0.jpg,735,21,352,373,345,380,True,8
6,36,kaist_dataset/Korean/Digital_Camera/outdoor3/DSC02943.JPG,char_data/6/DSC02943.JPG_0.jpg,828,23,372,395,431,467,True,8
6,33,kaist_dataset/Korean/Digital_Camera/outdoor3/DSC02943.JPG,char_data/6/DSC02943.JPG_0.jpg,858,26,393,419,435,468,True,8
6,62,kaist_dataset/Korean/Digital_Camera/outdoor3/DSC03221.JPG,char_data/6/DSC03221.JPG_0.jpg,1488,24,104,128,78,140,True,8
6,36,kaist_dataset/Korean/Digital_Camera/outdoor3/DSC02899.JPG,char_data/6/DSC02899.JPG_0.jpg,1332,37,413,450,232,268,True,8
6,44,kaist_dataset/Korean/Digital_Camera/outdoor3/DSC02528.JPG,char_data/6/DSC02528.JPG_0.jpg,1672,38,202,240,410,454,True,8
6,44,kaist_dataset/Korean/Digital_Camera/outdoor3/DSC02528.JPG,char_data/6/DSC02528.JPG_0.jpg,1540,35,365,400,410,454,True,8
6,67,kaist_dataset/Korean/Digital_Camera/outdoor3/DSC02562.JPG,char_data/6/DSC02562.JPG_0.jpg,2479,37,230,267,361,428,True,8
6,103,kaist_dataset/Korean/Digital_Camera/outdoor3/DSC02525.JPG,char_data/6/DSC02525.JPG_0.jpg,8652,84,180,264,27,130,True,8
6,35,kaist_dataset/Korean/Digital_Camera/outdoor3/DSC02598.JPG,char_data/6/DSC02598.JPG_0.jpg,735,21,522,543,415,450,True,8
6,25,kaist_dataset/Korean/Digital_Camera/outdoor3/DSC02529.JPG,char_data/6/DSC02529.JPG_0.jpg,325,13,550,563,373,398,True,8
6,44,kaist_dataset/Korean/Digital_Camera/outdoor3/DSC02994.JPG,char_data/6/DSC02994.JPG_0.jpg,1364,31,366,397,285,329,True,8
6,29,kaist_dataset/Korean/Digital_Camera/outdoor3/DSC02558.JPG,char_data/6/DSC02558.JPG_0.jpg,435,15,500,515,220,249,True,8
6,115,kaist_dataset/Korean/Digital_Camera/outdoor3/DSC02983.JPG,char_data/6/DSC02983.JPG_0.jpg,6325,55,200,255,296,411,True,8
6,105,kaist_dataset/Korean/Digital_Camera/outdoor3/DSC03222.JPG,char_data/6/DSC03222.JPG_0.jpg,4935,47,244,291,355,460,True,8
6,67,kaist_dataset/Korean/Digital_Camera/outdoor3/DSC02951.JPG,char_data/6/DSC02951.JPG_0.jpg,3685,55,173,228,390,457,True,8
6,38,kaist_dataset/Korean/Digital_Camera/outdoor3/DSC02561.JPG,char_data/6/DSC02561.JPG_0.jpg,988,26,237,263,352,390,True,8
6,41,kaist_dataset/Korean/Digital_Camera/outdoor3/DSC02561.JPG,char_data/6/DSC02561.JPG_0.jpg,902,22,300,322,353,394,True,8
6,25,kaist_dataset/Korean/Digital_Camera/outdoor1/071.JPG,char_data/6/071.JPG_0.jpg,550,22,260,282,259,284,True,8
6,20,kaist_dataset/Korean/Digital_Camera/outdoor1/017.JPG,char_data/6/017.JPG_0.jpg,360,18,426,444,272,292,True,8
6,24,kaist_dataset/Korean/Digital_Camera/outdoor1/017.JPG,char_data/6/017.JPG_0.jpg,384,16,506,522,270,294,True,8
6,16,kaist_dataset/Korean/Digital_Camera/outdoor1/070.JPG,char_data/6/070.JPG_0.jpg,208,13,372,385,254,270,True,8
6,18,kaist_dataset/Korean/Digital_Camera/outdoor1/070.JPG,char_data/6/070.JPG_0.jpg,234,13,446,459,250,268,True,8
6,24,kaist_dataset/Korean/Digital_Camera/outdoor1/028.JPG,char_data/6/028.JPG_0.jpg,288,12,300,312,263,287,True,8
6,44,kaist_dataset/Korean/Digital_Camera/outdoor1/052.JPG,char_data/6/052.JPG_0.jpg,1100,25,270,295,319,363,True,8
6,34,kaist_dataset/Korean/Digital_Camera/outdoor1/128.JPG,char_data/6/128.JPG_0.jpg,510,15,379,394,115,149,True,8
6,31,kaist_dataset/Korean/Digital_Camera/outdoor1/029.JPG,char_data/6/029.JPG_0.jpg,775,25,260,285,290,321,True,8
6,30,kaist_dataset/Korean/Digital_Camera/outdoor1/029.JPG,char_data/6/029.JPG_0.jpg,780,26,380,406,291,321,True,8
6,26,kaist_dataset/Korean/Digital_Camera/outdoor1/069.JPG,char_data/6/069.JPG_0.jpg,494,19,278,297,271,297,True,8
6,67,kaist_dataset/Korean/Digital_Camera/outdoor1/46.JPG,char_data/6/46.JPG_0.jpg,2144,32,203,235,371,438,True,8
6,68,kaist_dataset/Korean/Digital_Camera/outdoor1/46.JPG,char_data/6/46.JPG_0.jpg,2312,34,292,326,369,437,True,8
6,58,kaist_dataset/Korean/Digital_Camera/outdoor1/2007-12-08-day-057.jpg,char_data/6/2007-12-08-day-057.jpg_0.jpg,2320,40,836,876,602,660,True,8
6,32,kaist_dataset/Korean/Digital_Camera/outdoor1/040.JPG,char_data/6/040.JPG_0.jpg,736,23,248,271,297,329,True,8
6,33,kaist_dataset/Korean/Digital_Camera/outdoor1/023.JPG,char_data/6/023.JPG_0.jpg,693,21,167,188,270,303,True,8
6,18,kaist_dataset/Korean/Digital_Camera/outdoor1/006.JPG,char_data/6/006.JPG_0.jpg,324,18,298,316,255,273,True,8
6,15,kaist_dataset/Korean/Digital_Camera/outdoor1/013.JPG,char_data/6/013.JPG_0.jpg,120,8,378,386,253,268,True,8
6,17,kaist_dataset/Korean/Digital_Camera/outdoor1/013.JPG,char_data/6/013.JPG_0.jpg,170,10,429,439,249,266,True,8
6,18,kaist_dataset/Korean/Digital_Camera/outdoor1/013.JPG,char_data/6/013.JPG_0.jpg,288,16,441,457,248,266,True,8
6,26,kaist_dataset/Korean/Digital_Camera/outdoor1/99.jpg,char_data/6/99.jpg_0.jpg,338,13,408,421,173,199,True,8
6,28,kaist_dataset/Korean/Digital_Camera/outdoor1/99.jpg,char_data/6/99.jpg_0.jpg,196,7,431,438,173,201,True,8
6,31,kaist_dataset/Korean/Digital_Camera/outdoor1/50.JPG,char_data/6/50.JPG_0.jpg,558,18,322,340,336,367,True,8
6,23,kaist_dataset/Korean/Digital_Camera/outdoor1/011.JPG,char_data/6/011.JPG_0.jpg,552,24,362,386,257,280,True,8
6,42,kaist_dataset/Korean/Digital_Camera/outdoor1/54.JPG,char_data/6/54.JPG_0.jpg,1176,28,410,438,367,409,True,8
6,33,kaist_dataset/Korean/Digital_Camera/outdoor1/032.JPG,char_data/6/032.JPG_0.jpg,561,17,88,105,256,289,True,8
6,28,kaist_dataset/Korean/Digital_Camera/outdoor1/032.JPG,char_data/6/032.JPG_0.jpg,588,21,264,285,260,288,True,8
6,24,kaist_dataset/Korean/Digital_Camera/outdoor1/032.JPG,char_data/6/032.JPG_0.jpg,408,17,350,367,262,286,True,8
6,28,kaist_dataset/Korean/Digital_Camera/outdoor1/032.JPG,char_data/6/032.JPG_0.jpg,532,19,438,457,254,282,True,8
6,34,kaist_dataset/Korean/Digital_Camera/outdoor1/123.JPG,char_data/6/123.JPG_0.jpg,748,22,452,474,273,307,True,8
6,36,kaist_dataset/Korean/Digital_Camera/outdoor1/059.JPG,char_data/6/059.JPG_0.jpg,648,18,406,424,321,357,True,8
6,35,kaist_dataset/Korean/Digital_Camera/outdoor1/059.JPG,char_data/6/059.JPG_0.jpg,630,18,541,559,327,362,True,8
6,34,kaist_dataset/Korean/Digital_Camera/outdoor1/035.JPG,char_data/6/035.JPG_0.jpg,646,19,322,341,286,320,True,8
6,28,kaist_dataset/Korean/Digital_Camera/outdoor1/035.JPG,char_data/6/035.JPG_0.jpg,532,19,473,492,288,316,True,8
6,44,kaist_dataset/Korean/Digital_Camera/outdoor1/2007-12-08-day-047.jpg,char_data/6/2007-12-08-day-047.jpg_0.jpg,1364,31,860,891,711,755,True,8
6,32,kaist_dataset/Mixed/Mobile_Phone/(C.M)A-outdoor/P090912036.jpg,char_data/6/P090912036.jpg_0.jpg,544,17,158,175,190,222,True,8
6,42,kaist_dataset/Mixed/Mobile_Phone/(C.M)C-bookCover/P090903009.jpg,char_data/6/P090903009.jpg_0.jpg,756,18,432,450,355,397,True,8
6,91,kaist_dataset/Mixed/Mobile_Phone/(C.M)C-bookCover/P090905002.jpg,char_data/6/P090905002.jpg_0.jpg,6643,73,462,535,43,134,True,8
6,29,kaist_dataset/Mixed/Digital_Camera/(C.S)C-outdoor1/027.JPG,char_data/6/027.JPG_0.jpg,348,12,412,424,277,306,True,8
6,32,kaist_dataset/Mixed/Digital_Camera/(C.S)C-outdoor1/048.JPG,char_data/6/048.JPG_0.jpg,640,20,398,418,255,287,True,8
6,39,kaist_dataset/Mixed/Digital_Camera/(C.S)C-outdoor1/51.JPG,char_data/6/51.JPG_0.jpg,1170,30,524,554,376,415,True,8
6,48,kaist_dataset/Mixed/Digital_Camera/(C.S)C-outdoor1/081.JPG,char_data/6/081.JPG_0.jpg,1536,32,158,190,250,298,True,8
6,56,kaist_dataset/Mixed/Digital_Camera/(C.S)C-outdoor1/2007-12-09-day-exterior-078.jpg,char_data/6/2007-12-09-day-exterior-078.jpg_0.jpg,1456,26,445,471,595,651,True,8
6,97,kaist_dataset/Mixed/Digital_Camera/(C.S)C-outdoor1/2007-12-08-day-092.jpg,char_data/6/2007-12-08-day-092.jpg_0.jpg,8051,83,1039,1122,658,755,True,8
6,77,kaist_dataset/Mixed/Digital_Camera/(C.S)C-outdoor1/2007-12-09-day-exterior-086.jpg,char_data/6/2007-12-09-day-exterior-086.jpg_0.jpg,5005,65,764,829,713,790,True,8
6,36,kaist_dataset/Mixed/Digital_Camera/(C.S)C-outdoor1/DSC02344.JPG,char_data/6/DSC02344.JPG_0.jpg,684,19,511,530,254,290,True,8
6,20,kaist_dataset/Mixed/Digital_Camera/(C.S)C-outdoor1/114.jpg,char_data/6/114.jpg_0.jpg,340,17,290,307,371,391,True,8
6,37,kaist_dataset/Mixed/Digital_Camera/(C.S)C-outdoor1/118.JPG,char_data/6/118.JPG_0.jpg,925,25,418,443,357,394,True,8
6,39,kaist_dataset/Mixed/Digital_Camera/(C.S)C-outdoor1/009.JPG,char_data/6/009.JPG_0.jpg,663,17,284,301,318,357,True,8
6,229,kaist_dataset/Mixed/Digital_Camera/(C.S)C-outdoor1/2007-12-08-day-118.jpg,char_data/6/2007-12-08-day-118.jpg_0.jpg,33434,146,915,1061,482,711,True,8
6,37,kaist_dataset/Mixed/Digital_Camera/(C.S)C-outdoor1/P1010011.JPG,char_data/6/P1010011.JPG_0.jpg,592,16,558,574,310,347,True,8
6,27,kaist_dataset/Mixed/Digital_Camera/(C.S)C-outdoor1/008.JPG,char_data/6/008.JPG_0.jpg,405,15,458,473,265,292,True,8
6,28,kaist_dataset/Mixed/Digital_Camera/(C.S)C-outdoor1/008.JPG,char_data/6/008.JPG_0.jpg,476,17,535,552,266,294,True,8
6,26,kaist_dataset/Mixed/Digital_Camera/(C.S)C-outdoor1/008.JPG,char_data/6/008.JPG_0.jpg,390,15,552,567,264,290,True,8
6,25,kaist_dataset/Mixed/Digital_Camera/(C.S)C-outdoor1/48.JPG,char_data/6/48.JPG_0.jpg,350,14,215,229,339,364,True,8
6,39,kaist_dataset/Mixed/Digital_Camera/(C.S)C-outdoor1/56.JPG,char_data/6/56.JPG_0.jpg,1287,33,355,388,302,341,True,8
6,24,kaist_dataset/Mixed/Digital_Camera/(C.S)C-outdoor1/047.JPG,char_data/6/047.JPG_0.jpg,192,8,591,599,171,195,True,8
6,20,kaist_dataset/Mixed/Digital_Camera/(C.S)C-outdoor1/047.JPG,char_data/6/047.JPG_0.jpg,200,10,608,618,174,194,True,8
6,36,kaist_dataset/Mixed/Digital_Camera/(C.S)C-outdoor1/45.JPG,char_data/6/45.JPG_0.jpg,1224,34,307,341,367,403,True,8
6,67,kaist_dataset/Mixed/Digital_Camera/(C.S)C-outdoor1/2007-12-09-day-exterior-004.jpg,char_data/6/2007-12-09-day-exterior-004.jpg_0.jpg,3350,50,1028,1078,660,727,True,8
6,95,kaist_dataset/Mixed/Digital_Camera/(C.S)C-outdoor1/080119-0027.jpg,char_data/6/080119-0027.jpg_0.jpg,4370,46,535,581,712,807,True,8
6,46,kaist_dataset/Mixed/Digital_Camera/(C.S)C-outdoor1/P1010009.JPG,char_data/6/P1010009.JPG_0.jpg,1150,25,268,293,238,284,True,8
6,28,kaist_dataset/Mixed/Digital_Camera/(C.S)C-outdoor1/57.JPG,char_data/6/57.JPG_0.jpg,448,16,339,355,293,321,True,8
6,28,kaist_dataset/Mixed/Digital_Camera/(C.S)C-outdoor1/054.JPG,char_data/6/054.JPG_0.jpg,504,18,473,491,302,330,True,8
6,30,kaist_dataset/Mixed/Digital_Camera/(C.S)C-outdoor1/47.JPG,char_data/6/47.JPG_0.jpg,450,15,324,339,473,503,True,8
6,46,kaist_dataset/Mixed/Digital_Camera/(C.S)C-outdoor1/2007-12-09-day-exterior-037.jpg,char_data/6/2007-12-09-day-exterior-037.jpg_0.jpg,1794,39,703,742,710,756,True,8
6,29,kaist_dataset/Mixed/Digital_Camera/(C.S)C-outdoor1/DSC02242.JPG,char_data/6/DSC02242.JPG_0.jpg,435,15,558,573,261,290,True,8
6,83,kaist_dataset/Mixed/Digital_Camera/(C.S)C-outdoor1/DSC02244.JPG,char_data/6/DSC02244.JPG_0.jpg,3652,44,228,272,351,434,True,8
6,39,kaist_dataset/Mixed/Digital_Camera/(C.S)C-outdoor1/2007-12-08-day-130.jpg,char_data/6/2007-12-08-day-130.jpg_0.jpg,1014,26,981,1007,755,794,True,8
6,57,kaist_dataset/Mixed/Digital_Camera/(C.S)C-outdoor1/025.JPG,char_data/6/025.JPG_0.jpg,1653,29,151,180,331,388,True,8
6,54,kaist_dataset/Mixed/Digital_Camera/(C.S)C-outdoor1/025.JPG,char_data/6/025.JPG_0.jpg,1404,26,411,437,341,395,True,8
6,32,kaist_dataset/Mixed/Digital_Camera/(C.S)C-outdoor1/55.JPG,char_data/6/55.JPG_0.jpg,864,27,306,333,370,402,True,8
6,24,kaist_dataset/Mixed/Digital_Camera/(C.S)C-outdoor1/2.JPG,char_data/6/2.JPG_0.jpg,240,10,581,591,393,417,True,8
6,24,kaist_dataset/Mixed/Digital_Camera/(C.S)C-outdoor1/063.JPG,char_data/6/063.JPG_0.jpg,432,18,376,394,261,285,True,8
6,47,kaist_dataset/Mixed/Digital_Camera/(C.S)C-outdoor1/DSC02322.JPG,char_data/6/DSC02322.JPG_0.jpg,1222,26,217,243,363,410,True,8
6,44,kaist_dataset/Mixed/Digital_Camera/(C.S)C-outdoor1/DSC02322.JPG,char_data/6/DSC02322.JPG_0.jpg,1100,25,326,351,364,408,True,8
6,21,kaist_dataset/Mixed/Digital_Camera/(C.S)C-outdoor1/014.JPG,char_data/6/014.JPG_0.jpg,252,12,168,180,278,299,True,8
6,64,kaist_dataset/Mixed/Digital_Camera/(C.S)C-outdoor1/2007-12-08-day-091.jpg,char_data/6/2007-12-08-day-091.jpg_0.jpg,3648,57,1405,1462,627,691,True,8
6,31,kaist_dataset/Mixed/Digital_Camera/(C.S)C-outdoor1/090.JPG,char_data/6/090.JPG_0.jpg,651,21,491,512,396,427,True,8
6,31,kaist_dataset/Mixed/Digital_Camera/(C.S)C-outdoor1/090.JPG,char_data/6/090.JPG_0.jpg,837,27,509,536,395,426,True,8
6,37,kaist_dataset/Mixed/Digital_Camera/(C.S)F-others/DSC02504.JPG,char_data/6/DSC02504.JPG_0.jpg,1110,30,246,276,333,370,True,8
6,46,kaist_dataset/Mixed/Digital_Camera/(C.S)F-others/2007-12-08-day-113.jpg,char_data/6/2007-12-08-day-113.jpg_0.jpg,966,21,852,873,402,448,True,8
6,39,kaist_dataset/Mixed/Digital_Camera/(C.S)F-others/2007-12-08-day-044.jpg,char_data/6/2007-12-08-day-044.jpg_0.jpg,585,15,1043,1058,823,862,True,8
6,53,kaist_dataset/Mixed/Digital_Camera/(C.S)F-others/2007-12-09-day-exterior-023.jpg,char_data/6/2007-12-09-day-exterior-023.jpg_0.jpg,2226,42,896,938,582,635,True,8
6,44,kaist_dataset/Mixed/Digital_Camera/(C.S)D-indoor2/DSC04256.JPG,char_data/6/DSC04256.JPG_0.jpg,924,21,588,609,146,190,True,8
6,26,kaist_dataset/Mixed/Digital_Camera/(C.S)E-night/P1010155.JPG,char_data/6/P1010155.JPG_0.jpg,338,13,481,494,285,311,True,8
6,29,kaist_dataset/Mixed/Digital_Camera/(C.S)E-night/DSC02660.JPG,char_data/6/DSC02660.JPG_0.jpg,696,24,228,252,422,451,True,8
6,30,kaist_dataset/Mixed/Digital_Camera/(C.S)E-night/DSC02660.JPG,char_data/6/DSC02660.JPG_0.jpg,750,25,342,367,419,449,True,8
6,36,kaist_dataset/Mixed/Digital_Camera/(C.S)E-night/DSC02647.JPG,char_data/6/DSC02647.JPG_0.jpg,1080,30,219,249,284,320,True,8
6,59,kaist_dataset/Mixed/Digital_Camera/(C.S)E-night/DSC02574.JPG,char_data/6/DSC02574.JPG_0.jpg,2006,34,315,349,412,471,True,8
6,35,kaist_dataset/Mixed/Digital_Camera/(C.S)E-night/DSC02644.JPG,char_data/6/DSC02644.JPG_0.jpg,560,16,320,336,399,434,True,8
6,40,kaist_dataset/Mixed/Digital_Camera/(C.S)E-night/DSC02586.JPG,char_data/6/DSC02586.JPG_0.jpg,560,14,325,339,390,430,True,8
6,82,kaist_dataset/Mixed/Digital_Camera/(C.S)E-night/P1010151.JPG,char_data/6/P1010151.JPG_0.jpg,4756,58,376,434,347,429,True,8
6,48,kaist_dataset/Mixed/Digital_Camera/(C.S)E-night/DSC02575.JPG,char_data/6/DSC02575.JPG_0.jpg,1584,33,290,323,357,405,True,8
6,37,kaist_dataset/Mixed/Digital_Camera/(C.S)E-night/DSC02678.JPG,char_data/6/DSC02678.JPG_0.jpg,555,15,385,400,394,431,True,8
6,41,kaist_dataset/Mixed/Digital_Camera/(C.S)E-night/DSC02673.JPG,char_data/6/DSC02673.JPG_0.jpg,615,15,298,313,303,344,True,8
6,39,kaist_dataset/Mixed/Digital_Camera/(C.S)E-night/DSC02673.JPG,char_data/6/DSC02673.JPG_0.jpg,702,18,464,482,297,336,True,8
6,34,kaist_dataset/Mixed/Digital_Camera/(C.S)E-night/DSC02569.JPG,char_data/6/DSC02569.JPG_0.jpg,646,19,350,369,413,447,True,8
6,36,kaist_dataset/Mixed/Digital_Camera/(C.S)E-night/DSC02623.JPG,char_data/6/DSC02623.JPG_0.jpg,612,17,109,126,398,434,True,8
6,32,kaist_dataset/Mixed/Digital_Camera/(C.S)E-night/DSC02903.JPG,char_data/6/DSC02903.JPG_0.jpg,576,18,378,396,269,301,True,8
6,35,kaist_dataset/Mixed/Digital_Camera/(C.S)E-night/DSC02903.JPG,char_data/6/DSC02903.JPG_0.jpg,840,24,421,445,268,303,True,8
6,57,kaist_dataset/Mixed/Digital_Camera/(C.S)E-night/DSC02573.JPG,char_data/6/DSC02573.JPG_0.jpg,1710,30,349,379,171,228,True,8
6,58,kaist_dataset/Mixed/Digital_Camera/(C.S)E-night/P1010147.JPG,char_data/6/P1010147.JPG_0.jpg,2204,38,270,308,258,316,True,8
6,117,kaist_dataset/Mixed/Digital_Camera/(C.S)D-indoor1/DSC03455.JPG,char_data/6/DSC03455.JPG_0.jpg,14859,127,262,389,52,169,True,8
6,48,kaist_dataset/Mixed/Digital_Camera/(C.S)D-indoor1/DSC03986.JPG,char_data/6/DSC03986.JPG_0.jpg,720,15,82,97,160,208,True,8
6,57,kaist_dataset/Mixed/Digital_Camera/(C.S)D-indoor1/DSC02733.JPG,char_data/6/DSC02733.JPG_0.jpg,2337,41,435,476,389,446,True,8
6,45,kaist_dataset/Mixed/Digital_Camera/(C.S)D-indoor1/DSC03980.JPG,char_data/6/DSC03980.JPG_0.jpg,1710,38,284,322,304,349,True,8
6,121,kaist_dataset/Mixed/Digital_Camera/(C.S)C-outdoor5/DSC04449.JPG,char_data/6/DSC04449.JPG_0.jpg,9922,82,208,290,34,155,True,8
6,131,kaist_dataset/Mixed/Digital_Camera/(C.S)C-outdoor5/DSC04449.JPG,char_data/6/DSC04449.JPG_0.jpg,10087,77,478,555,34,165,True,8
6,30,kaist_dataset/Mixed/Digital_Camera/(C.S)C-outdoor5/DSC04146.JPG,char_data/6/DSC04146.JPG_0.jpg,570,19,351,370,407,437,True,8
6,30,kaist_dataset/Mixed/Digital_Camera/(C.S)C-outdoor5/DSC04146.JPG,char_data/6/DSC04146.JPG_0.jpg,660,22,387,409,405,435,True,8
6,28,kaist_dataset/Mixed/Digital_Camera/(C.S)C-outdoor5/DSC04086.JPG,char_data/6/DSC04086.JPG_0.jpg,420,15,451,466,371,399,True,8
6,31,kaist_dataset/Mixed/Digital_Camera/(C.S)C-outdoor5/DSC04155.JPG,char_data/6/DSC04155.JPG_0.jpg,527,17,572,589,262,293,True,8
6,32,kaist_dataset/Mixed/Digital_Camera/(C.S)C-outdoor5/DSC04155.JPG,char_data/6/DSC04155.JPG_0.jpg,768,24,589,613,263,295,True,8
6,67,kaist_dataset/Mixed/Digital_Camera/(C.S)C-outdoor5/DSC04016.JPG,char_data/6/DSC04016.JPG_0.jpg,2479,37,247,284,324,391,True,8
6,70,kaist_dataset/Mixed/Digital_Camera/(C.S)C-outdoor5/DSC04016.JPG,char_data/6/DSC04016.JPG_0.jpg,2590,37,286,323,322,392,True,8
6,27,kaist_dataset/Mixed/Digital_Camera/(C.S)C-outdoor5/DSC04151.JPG,char_data/6/DSC04151.JPG_0.jpg,486,18,489,507,349,376,True,8
6,39,kaist_dataset/Mixed/Digital_Camera/(C.S)C-outdoor5/DSC04071.JPG,char_data/6/DSC04071.JPG_0.jpg,1092,28,187,215,362,401,True,8
6,43,kaist_dataset/Mixed/Digital_Camera/(C.S)C-outdoor5/DSC04071.JPG,char_data/6/DSC04071.JPG_0.jpg,1290,30,233,263,357,400,True,8
6,32,kaist_dataset/Mixed/Digital_Camera/(C.S)C-outdoor5/DSC04071.JPG,char_data/6/DSC04071.JPG_0.jpg,768,24,486,510,369,401,True,8
6,53,kaist_dataset/Mixed/Digital_Camera/(C.S)C-outdoor5/DSC04033.JPG,char_data/6/DSC04033.JPG_0.jpg,2226,42,259,301,278,331,True,8
6,52,kaist_dataset/Mixed/Digital_Camera/(C.S)C-outdoor5/DSC04033.JPG,char_data/6/DSC04033.JPG_0.jpg,1872,36,338,374,271,323,True,8
6,54,kaist_dataset/Mixed/Digital_Camera/(C.S)C-outdoor5/DSC04033.JPG,char_data/6/DSC04033.JPG_0.jpg,2052,38,456,494,264,318,True,8
6,21,kaist_dataset/Mixed/Digital_Camera/(C.S)C-outdoor5/DSC04031.JPG,char_data/6/DSC04031.JPG_0.jpg,231,11,510,521,382,403,True,8
6,29,kaist_dataset/Mixed/Digital_Camera/(C.S)C-outdoor5/DSC04031.JPG,char_data/6/DSC04031.JPG_0.jpg,348,12,209,221,378,407,True,8
6,25,kaist_dataset/Mixed/Digital_Camera/(C.S)C-outdoor5/DSC04031.JPG,char_data/6/DSC04031.JPG_0.jpg,325,13,233,246,380,405,True,8
6,37,kaist_dataset/Mixed/Digital_Camera/(C.S)C-outdoor5/P1010002.JPG,char_data/6/P1010002.JPG_0.jpg,925,25,548,573,281,318,True,8
6,36,kaist_dataset/Mixed/Digital_Camera/(C.S)C-outdoor5/DSC04056.JPG,char_data/6/DSC04056.JPG_0.jpg,900,25,520,545,259,295,True,8
6,49,kaist_dataset/Mixed/Digital_Camera/(C.S)C-outdoor3/DSC03189.JPG,char_data/6/DSC03189.JPG_0.jpg,1470,30,534,564,301,350,True,8
6,48,kaist_dataset/Mixed/Digital_Camera/(C.S)C-outdoor3/DSC03189.JPG,char_data/6/DSC03189.JPG_0.jpg,1488,31,564,595,298,346,True,8
6,36,kaist_dataset/Mixed/Digital_Camera/(C.S)C-outdoor3/DSC03316.JPG,char_data/6/DSC03316.JPG_0.jpg,504,14,309,323,82,118,True,8
6,66,kaist_dataset/Mixed/Digital_Camera/(C.S)C-outdoor3/DSC03302.JPG,char_data/6/DSC03302.JPG_0.jpg,3036,46,546,592,248,314,True,8
6,34,kaist_dataset/Mixed/Digital_Camera/(C.S)C-outdoor3/DSC03062.JPG,char_data/6/DSC03062.JPG_0.jpg,578,17,279,296,244,278,True,8
6,30,kaist_dataset/Mixed/Digital_Camera/(C.S)C-outdoor3/DSC03051.JPG,char_data/6/DSC03051.JPG_0.jpg,540,18,267,285,323,353,True,8
6,60,kaist_dataset/Mixed/Digital_Camera/(C.S)C-outdoor3/DSC03323.JPG,char_data/6/DSC03323.JPG_0.jpg,2460,41,551,592,260,320,True,8
6,46,kaist_dataset/Mixed/Digital_Camera/(C.S)C-outdoor3/DSC03212.JPG,char_data/6/DSC03212.JPG_0.jpg,1012,22,459,481,252,298,True,8
6,65,kaist_dataset/Mixed/Digital_Camera/(C.S)C-outdoor3/DSC03273.JPG,char_data/6/DSC03273.JPG_0.jpg,2600,40,510,550,283,348,True,8
6,58,kaist_dataset/Mixed/Digital_Camera/(C.S)C-outdoor3/DSC03067.JPG,char_data/6/DSC03067.JPG_0.jpg,2378,41,304,345,195,253,True,8
6,43,kaist_dataset/Mixed/Digital_Camera/(C.S)C-outdoor3/DSC03061.JPG,char_data/6/DSC03061.JPG_0.jpg,731,17,305,322,250,293,True,8
6,46,kaist_dataset/Mixed/Digital_Camera/(C.S)C-outdoor3/DSC03061.JPG,char_data/6/DSC03061.JPG_0.jpg,1058,23,395,418,248,294,True,8
6,50,kaist_dataset/Mixed/Digital_Camera/(C.S)C-outdoor3/DSC02989.JPG,char_data/6/DSC02989.JPG_0.jpg,1050,21,533,554,346,396,True,8
6,39,kaist_dataset/Mixed/Digital_Camera/(C.S)C-outdoor3/DSC02989.JPG,char_data/6/DSC02989.JPG_0.jpg,897,23,576,599,354,393,True,8
6,32,kaist_dataset/Mixed/Digital_Camera/(C.S)C-outdoor3/DSC03308.JPG,char_data/6/DSC03308.JPG_0.jpg,896,28,314,342,248,280,True,8
6,29,kaist_dataset/Mixed/Digital_Camera/(C.S)C-outdoor6/P1010082.JPG,char_data/6/P1010082.JPG_0.jpg,696,24,259,283,230,259,True,8
6,31,kaist_dataset/Mixed/Digital_Camera/(C.S)C-outdoor6/P1010082.JPG,char_data/6/P1010082.JPG_0.jpg,527,17,306,323,229,260,True,8
6,71,kaist_dataset/Mixed/Digital_Camera/(C.S)C-outdoor6/P1010054.JPG,char_data/6/P1010054.JPG_0.jpg,4544,64,366,430,367,438,True,8
6,22,kaist_dataset/Mixed/Digital_Camera/(C.S)C-outdoor6/P1010099.JPG,char_data/6/P1010099.JPG_0.jpg,264,12,546,558,212,234,True,8
6,20,kaist_dataset/Mixed/Digital_Camera/(C.S)C-outdoor6/P1010085.JPG,char_data/6/P1010085.JPG_0.jpg,340,17,350,367,159,179,True,8
6,41,kaist_dataset/Mixed/Digital_Camera/(C.S)C-outdoor6/P1010021.JPG,char_data/6/P1010021.JPG_0.jpg,1271,31,224,255,208,249,True,8
6,43,kaist_dataset/Mixed/Digital_Camera/(C.S)C-outdoor6/P1010021.JPG,char_data/6/P1010021.JPG_0.jpg,1247,29,255,284,207,250,True,8
6,36,kaist_dataset/Mixed/Digital_Camera/(C.S)C-outdoor6/P1010056.JPG,char_data/6/P1010056.JPG_0.jpg,684,19,333,352,228,264,True,8
6,34,kaist_dataset/Mixed/Digital_Camera/(C.S)C-outdoor6/P1010056.JPG,char_data/6/P1010056.JPG_0.jpg,714,21,419,440,227,261,True,8
6,41,kaist_dataset/Mixed/Digital_Camera/(C.S)C-outdoor6/P1010018.JPG,char_data/6/P1010018.JPG_0.jpg,902,22,230,252,238,279,True,8
6,32,kaist_dataset/Mixed/Digital_Camera/(C.S)C-outdoor6/P1010018.JPG,char_data/6/P1010018.JPG_0.jpg,704,22,495,517,243,275,True,8
6,26,kaist_dataset/Mixed/Digital_Camera/(C.S)C-outdoor6/P1010137.JPG,char_data/6/P1010137.JPG_0.jpg,494,19,506,525,181,207,True,8
6,36,kaist_dataset/Mixed/Digital_Camera/(C.S)C-outdoor6/P1010097.JPG,char_data/6/P1010097.JPG_0.jpg,900,25,113,138,175,211,True,8
6,37,kaist_dataset/Mixed/Digital_Camera/(C.S)C-outdoor6/P1010097.JPG,char_data/6/P1010097.JPG_0.jpg,814,22,137,159,175,212,True,8
6,22,kaist_dataset/Mixed/Digital_Camera/(C.S)C-outdoor6/P1010097.JPG,char_data/6/P1010097.JPG_0.jpg,462,21,513,534,190,212,True,8
6,27,kaist_dataset/Mixed/Digital_Camera/(C.S)C-outdoor6/P1010097.JPG,char_data/6/P1010097.JPG_0.jpg,486,18,534,552,186,213,True,8
6,41,kaist_dataset/Mixed/Digital_Camera/(C.S)C-outdoor4/DSC03730.JPG,char_data/6/DSC03730.JPG_0.jpg,1148,28,452,480,245,286,True,8
6,35,kaist_dataset/Mixed/Digital_Camera/(C.S)C-outdoor4/DSC03730.JPG,char_data/6/DSC03730.JPG_0.jpg,735,21,480,501,247,282,True,8
6,33,kaist_dataset/Mixed/Digital_Camera/(C.S)C-outdoor4/DSC03716.JPG,char_data/6/DSC03716.JPG_0.jpg,462,14,615,629,250,283,True,8
6,51,kaist_dataset/Mixed/Digital_Camera/(C.S)C-outdoor4/DSC03613.JPG,char_data/6/DSC03613.JPG_0.jpg,1122,22,494,516,24,75,True,8
6,30,kaist_dataset/Mixed/Digital_Camera/(C.S)C-outdoor4/DSC03733.JPG,char_data/6/DSC03733.JPG_0.jpg,450,15,553,568,176,206,True,8
6,36,kaist_dataset/Mixed/Digital_Camera/(C.S)C-outdoor4/DSC03733.JPG,char_data/6/DSC03733.JPG_0.jpg,612,17,581,598,172,208,True,8
6,28,kaist_dataset/Mixed/Digital_Camera/(C.S)C-outdoor4/DSC03674.JPG,char_data/6/DSC03674.JPG_0.jpg,392,14,531,545,422,450,True,8
6,39,kaist_dataset/Mixed/Digital_Camera/(C.S)C-outdoor4/DSC03435.JPG,char_data/6/DSC03435.JPG_0.jpg,624,16,539,555,414,453,True,8
6,26,kaist_dataset/Mixed/Digital_Camera/(C.S)C-outdoor4/DSC03552.JPG,char_data/6/DSC03552.JPG_0.jpg,468,18,411,429,323,349,True,8
6,27,kaist_dataset/Mixed/Digital_Camera/(C.S)C-outdoor4/DSC03552.JPG,char_data/6/DSC03552.JPG_0.jpg,378,14,447,461,322,349,True,8
6,30,kaist_dataset/Mixed/Digital_Camera/(C.S)C-outdoor4/DSC03640.JPG,char_data/6/DSC03640.JPG_0.jpg,660,22,359,381,399,429,True,8
6,46,kaist_dataset/Mixed/Digital_Camera/(C.S)C-outdoor4/DSC03548.JPG,char_data/6/DSC03548.JPG_0.jpg,2070,45,191,236,391,437,True,8
6,33,kaist_dataset/Mixed/Digital_Camera/(C.S)C-outdoor4/DSC03745.JPG,char_data/6/DSC03745.JPG_0.jpg,759,23,253,276,273,306,True,8
6,29,kaist_dataset/Mixed/Digital_Camera/(C.S)C-outdoor4/DSC03655.JPG,char_data/6/DSC03655.JPG_0.jpg,551,19,493,512,404,433,True,8
6,48,kaist_dataset/Mixed/Digital_Camera/(C.S)C-outdoor4/DSC03569.JPG,char_data/6/DSC03569.JPG_0.jpg,1584,33,547,580,165,213,True,8
6,41,kaist_dataset/Mixed/Digital_Camera/(C.S)C-outdoor4/DSC03549.JPG,char_data/6/DSC03549.JPG_0.jpg,779,19,576,595,177,218,True,8
6,31,kaist_dataset/Mixed/Digital_Camera/(C.S)C-outdoor4/DSC03549.JPG,char_data/6/DSC03549.JPG_0.jpg,775,25,553,578,220,251,True,8
6,31,kaist_dataset/Mixed/Digital_Camera/(C.S)C-outdoor4/DSC03549.JPG,char_data/6/DSC03549.JPG_0.jpg,372,12,359,371,423,454,False,8
6,40,kaist_dataset/Mixed/Digital_Camera/(C.S)C-outdoor4/DSC03732.JPG,char_data/6/DSC03732.JPG_0.jpg,1200,30,470,500,391,431,False,8
6,38,kaist_dataset/Mixed/Digital_Camera/(C.S)C-outdoor4/DSC03732.JPG,char_data/6/DSC03732.JPG_0.jpg,1178,31,501,532,390,428,False,8
6,29,kaist_dataset/Mixed/Digital_Camera/(C.S)C-outdoor4/DSC03723.JPG,char_data/6/DSC03723.JPG_0.jpg,638,22,498,520,197,226,False,8
6,47,kaist_dataset/Mixed/Digital_Camera/(C.S)C-outdoor4/DSC03571.JPG,char_data/6/DSC03571.JPG_0.jpg,1081,23,410,433,300,347,False,8
6,33,kaist_dataset/Mixed/Digital_Camera/(C.S)C-outdoor4/DSC03676.JPG,char_data/6/DSC03676.JPG_0.jpg,462,14,154,168,272,305,False,8
6,35,kaist_dataset/Mixed/Digital_Camera/(C.S)C-outdoor4/DSC03741.JPG,char_data/6/DSC03741.JPG_0.jpg,1085,31,448,479,366,401,False,8
6,43,kaist_dataset/Mixed/Digital_Camera/(C.S)C-outdoor4/DSC03741.JPG,char_data/6/DSC03741.JPG_0.jpg,1247,29,480,509,361,404,False,8
6,42,kaist_dataset/Mixed/Digital_Camera/(C.S)C-outdoor4/DSC03556.JPG,char_data/6/DSC03556.JPG_0.jpg,1134,27,485,512,254,296,False,8
6,31,kaist_dataset/Mixed/Digital_Camera/(C.S)C-outdoor4/DSC03556.JPG,char_data/6/DSC03556.JPG_0.jpg,465,15,354,369,318,349,False,8
6,51,kaist_dataset/Mixed/Digital_Camera/(C.S)C-outdoor4/DSC03662.JPG,char_data/6/DSC03662.JPG_0.jpg,1428,28,513,541,411,462,False,8
6,49,kaist_dataset/Mixed/Digital_Camera/(C.S)C-outdoor4/DSC03662.JPG,char_data/6/DSC03662.JPG_0.jpg,980,20,542,562,413,462,False,8
6,32,kaist_dataset/Mixed/Digital_Camera/(C.S)C-outdoor4/DSC03757.JPG,char_data/6/DSC03757.JPG_0.jpg,384,12,429,441,339,371,False,8
6,34,kaist_dataset/Mixed/Digital_Camera/(C.S)C-outdoor4/DSC03667.JPG,char_data/6/DSC03667.JPG_0.jpg,544,16,505,521,374,408,False,8
6,55,kaist_dataset/Mixed/Digital_Camera/(C.S)C-outdoor4/DSC03621.JPG,char_data/6/DSC03621.JPG_0.jpg,1210,22,413,435,329,384,False,8
6,25,kaist_dataset/Mixed/Digital_Camera/(C.S)C-outdoor4/DSC03687.JPG,char_data/6/DSC03687.JPG_0.jpg,250,10,474,484,402,427,False,8
6,25,kaist_dataset/Mixed/Digital_Camera/(C.S)C-outdoor4/DSC03670.JPG,char_data/6/DSC03670.JPG_0.jpg,250,10,454,464,447,472,False,8
6,213,kaist_dataset/Mixed/Digital_Camera/(C.S)C-outdoor4/DSC03586.JPG,char_data/6/DSC03586.JPG_0.jpg,50694,238,205,443,237,450,False,8
6,30,kaist_dataset/Mixed/Digital_Camera/(C.S)C-outdoor2/DSC02624.JPG,char_data/6/DSC02624.JPG_0.jpg,330,11,442,453,398,428,False,8
6,32,kaist_dataset/Mixed/Digital_Camera/(C.S)C-outdoor2/DSC02624.JPG,char_data/6/DSC02624.JPG_0.jpg,320,10,492,502,398,430,False,8
6,34,kaist_dataset/Mixed/Digital_Camera/(C.S)C-outdoor2/DSC02492.JPG,char_data/6/DSC02492.JPG_0.jpg,646,19,373,392,324,358,False,8
6,23,kaist_dataset/Mixed/Digital_Camera/(C.S)C-outdoor2/DSC02555.JPG,char_data/6/DSC02555.JPG_0.jpg,483,21,89,110,253,276,False,8
6,28,kaist_dataset/Mixed/Digital_Camera/(C.S)C-outdoor2/DSC02397.JPG,char_data/6/DSC02397.JPG_0.jpg,616,22,461,483,207,235,False,8
6,21,kaist_dataset/Mixed/Digital_Camera/(C.S)C-outdoor2/DSC02477.JPG,char_data/6/DSC02477.JPG_0.jpg,420,20,76,96,256,277,False,8
6,72,kaist_dataset/Mixed/Digital_Camera/(C.S)C-outdoor2/DSC02502.JPG,char_data/6/DSC02502.JPG_0.jpg,2664,37,128,165,346,418,False,8
6,46,kaist_dataset/Mixed/Digital_Camera/(C.S)C-outdoor2/DSC02413.JPG,char_data/6/DSC02413.JPG_0.jpg,1242,27,375,402,206,252,False,8
6,43,kaist_dataset/Mixed/Digital_Camera/(C.S)C-outdoor2/DSC02374.JPG,char_data/6/DSC02374.JPG_0.jpg,1161,27,360,387,292,335,False,8
6,80,kaist_dataset/Mixed/Digital_Camera/(C.S)C-outdoor2/DSC02513.JPG,char_data/6/DSC02513.JPG_0.jpg,3520,44,193,237,139,219,False,8
6,35,kaist_dataset/Mixed/Digital_Camera/(C.S)C-outdoor2/DSC02479.JPG,char_data/6/DSC02479.JPG_0.jpg,665,19,463,482,221,256,False,8
6,29,kaist_dataset/Mixed/Digital_Camera/(C.S)C-outdoor2/DSC02479.JPG,char_data/6/DSC02479.JPG_0.jpg,464,16,508,524,223,252,False,8
6,32,kaist_dataset/Mixed/Digital_Camera/(C.S)C-outdoor2/DSC02368.JPG,char_data/6/DSC02368.JPG_0.jpg,608,19,178,197,384,416,False,8
6,31,kaist_dataset/Mixed/Digital_Camera/(C.S)C-outdoor2/DSC02368.JPG,char_data/6/DSC02368.JPG_0.jpg,558,18,427,445,382,413,False,8
6,37,kaist_dataset/Mixed/Digital_Camera/(C.S)C-outdoor2/DSC02368.JPG,char_data/6/DSC02368.JPG_0.jpg,518,14,545,559,380,417,False,8
6,37,kaist_dataset/Mixed/Digital_Camera/(C.S)C-outdoor2/DSC02545.JPG,char_data/6/DSC02545.JPG_0.jpg,1147,31,251,282,400,437,False,8
6,37,kaist_dataset/Mixed/Digital_Camera/(C.S)C-outdoor2/DSC02895.JPG,char_data/6/DSC02895.JPG_0.jpg,740,20,239,259,361,398,False,8
6,37,kaist_dataset/Mixed/Digital_Camera/(C.S)C-outdoor2/DSC02895.JPG,char_data/6/DSC02895.JPG_0.jpg,888,24,335,359,348,385,False,8
6,42,kaist_dataset/Mixed/Digital_Camera/(C.S)C-outdoor2/DSC02490.JPG,char_data/6/DSC02490.JPG_0.jpg,924,22,297,319,342,384,False,8
6,44,kaist_dataset/Mixed/Digital_Camera/(C.S)C-outdoor2/DSC02482.JPG,char_data/6/DSC02482.JPG_0.jpg,1628,37,369,406,322,366,False,8
6,43,kaist_dataset/Mixed/Digital_Camera/(C.S)C-outdoor2/DSC02937.JPG,char_data/6/DSC02937.JPG_0.jpg,1075,25,148,173,203,246,False,8
6,36,kaist_dataset/Mixed/Digital_Camera/(C.S)C-outdoor2/DSC02489.JPG,char_data/6/DSC02489.JPG_0.jpg,828,23,278,301,261,297,False,8
6,42,kaist_dataset/Mixed/Digital_Camera/(C.S)C-outdoor2/DSC02511.JPG,char_data/6/DSC02511.JPG_0.jpg,966,23,313,336,204,246,False,8
6,44,kaist_dataset/Mixed/Digital_Camera/(C.S)C-outdoor2/DSC02511.JPG,char_data/6/DSC02511.JPG_0.jpg,1144,26,264,290,390,434,False,8
6,39,kaist_dataset/Mixed/Digital_Camera/(C.S)C-outdoor2/DSC02533.JPG,char_data/6/DSC02533.JPG_0.jpg,1326,34,241,275,362,401,False,8
6,34,kaist_dataset/Mixed/Digital_Camera/(C.S)C-outdoor2/DSC02466.JPG,char_data/6/DSC02466.JPG_0.jpg,918,27,193,220,256,290,False,8
6,31,kaist_dataset/Mixed/Digital_Camera/(C.S)C-outdoor2/DSC02556.JPG,char_data/6/DSC02556.JPG_0.jpg,775,25,308,333,342,373,False,8
6,41,kaist_dataset/Mixed/Digital_Camera/(C.S)C-outdoor2/DSC02553.JPG,char_data/6/DSC02553.JPG_0.jpg,984,24,325,349,296,337,False,8
6,29,kaist_dataset/Mixed/Digital_Camera/(C.S)C-outdoor2/DSC02877.JPG,char_data/6/DSC02877.JPG_0.jpg,464,16,529,545,218,247,False,8
6,38,kaist_dataset/Mixed/Digital_Camera/(C.S)C-outdoor2/DSC02460.JPG,char_data/6/DSC02460.JPG_0.jpg,684,18,323,341,303,341,False,8
6,36,kaist_dataset/Mixed/Digital_Camera/(C.S)C-outdoor2/DSC02460.JPG,char_data/6/DSC02460.JPG_0.jpg,720,20,377,397,303,339,False,8
6,30,kaist_dataset/Mixed/Digital_Camera/(C.S)C-outdoor2/DSC02460.JPG,char_data/6/DSC02460.JPG_0.jpg,660,22,396,418,304,334,False,8
6,35,kaist_dataset/Mixed/Digital_Camera/(C.S)C-outdoor2/DSC02460.JPG,char_data/6/DSC02460.JPG_0.jpg,665,19,417,436,304,339,False,8
6,41,kaist_dataset/Mixed/Digital_Camera/(C.S)C-outdoor2/DSC02460.JPG,char_data/6/DSC02460.JPG_0.jpg,820,20,437,457,303,344,False,8
6,41,kaist_dataset/Mixed/Digital_Camera/(C.S)C-outdoor2/DSC02557.JPG,char_data/6/DSC02557.JPG_0.jpg,697,17,392,409,210,251,False,8
6,47,kaist_dataset/Mixed/Digital_Camera/(C.S)C-outdoor2/DSC02567.JPG,char_data/6/DSC02567.JPG_0.jpg,1504,32,221,253,143,190,False,8
6,38,kaist_dataset/Mixed/Digital_Camera/(C.S)C-outdoor2/DSC02543.JPG,char_data/6/DSC02543.JPG_0.jpg,836,22,335,357,349,387,False,8
6,34,kaist_dataset/Mixed/Digital_Camera/(C.S)C-outdoor2/DSC02543.JPG,char_data/6/DSC02543.JPG_0.jpg,714,21,396,417,348,382,False,8
6,50,kaist_dataset/Mixed/Digital_Camera/(C.S)C-outdoor2/DSC02461.JPG,char_data/6/DSC02461.JPG_0.jpg,2850,57,168,225,287,337,False,8
6,34,kaist_dataset/Mixed/Digital_Camera/(C.S)C-outdoor2/DSC02379.JPG,char_data/6/DSC02379.JPG_0.jpg,510,15,472,487,291,325,False,8
6,31,kaist_dataset/Mixed/Digital_Camera/(C.S)C-outdoor2/DSC02560.JPG,char_data/6/DSC02560.JPG_0.jpg,527,17,527,544,304,335,False,8
6,30,kaist_dataset/Mixed/Digital_Camera/(C.S)C-outdoor2/DSC02560.JPG,char_data/6/DSC02560.JPG_0.jpg,480,16,580,596,307,337,False,8
6,30,kaist_dataset/Mixed/Digital_Camera/(C.S)A-shadow/DSC02624.JPG,char_data/6/DSC02624.JPG_0.jpg,330,11,442,453,398,428,False,8
6,32,kaist_dataset/Mixed/Digital_Camera/(C.S)A-shadow/DSC02624.JPG,char_data/6/DSC02624.JPG_0.jpg,320,10,492,502,398,430,False,8
6,37,kaist_dataset/Mixed/Digital_Camera/(C.S)A-shadow/DSC03257.JPG,char_data/6/DSC03257.JPG_0.jpg,888,24,404,428,377,414,False,8
6,37,kaist_dataset/Mixed/Digital_Camera/(C.S)A-shadow/DSC04306.JPG,char_data/6/DSC04306.JPG_0.jpg,740,20,323,343,408,445,False,8
6,27,kaist_dataset/Mixed/Digital_Camera/(C.S)A-shadow/P1010017.JPG,char_data/6/P1010017.JPG_0.jpg,405,15,115,130,132,159,False,8
6,47,kaist_dataset/Mixed/Digital_Camera/(C.S)A-shadow/DSC02567.JPG,char_data/6/DSC02567.JPG_0.jpg,1504,32,221,253,143,190,False,8
6,40,kaist_dataset/Mixed/Digital_Camera/(C.S)A-shadow/DSC02579.JPG,char_data/6/DSC02579.JPG_0.jpg,1000,25,239,264,396,436,False,8
6,41,kaist_dataset/Mixed/Digital_Camera/(C.S)A-shadow/DSC02579.JPG,char_data/6/DSC02579.JPG_0.jpg,1107,27,372,399,400,441,False,8
6,37,kaist_dataset/Mixed/Digital_Camera/(C.S)A-shadow/DSC02579.JPG,char_data/6/DSC02579.JPG_0.jpg,1258,34,400,434,397,434,False,8
6,43,kaist_dataset/Mixed/Digital_Camera/(C.S)A-shadow/DSC02581.JPG,char_data/6/DSC02581.JPG_0.jpg,1118,26,249,275,384,427,False,8
6,38,kaist_dataset/Mixed/Digital_Camera/(C.S)A-shadow/DSC02581.JPG,char_data/6/DSC02581.JPG_0.jpg,912,24,326,350,386,424,False,8
6,36,kaist_dataset/Mixed/Digital_Camera/(C.S)A-shadow/DSC02581.JPG,char_data/6/DSC02581.JPG_0.jpg,756,21,353,374,387,423,False,8
6,57,kaist_dataset/English/Digital_Camera/(E.S)E-night/DSC02610.JPG,char_data/6/DSC02610.JPG_0.jpg,1482,26,103,129,383,440,False,8
6,54,kaist_dataset/English/Digital_Camera/(E.S)E-night/DSC02610.JPG,char_data/6/DSC02610.JPG_0.jpg,1620,30,185,215,381,435,False,8
6,43,kaist_dataset/English/Digital_Camera/(E.S)C-outdoor2/DSC03053.JPG,char_data/6/DSC03053.JPG_0.jpg,1247,29,361,390,128,171,False,8
6,64,kaist_dataset/English/Digital_Camera/(E.S)C-outdoor2/DSC03650.JPG,char_data/6/DSC03650.JPG_0.jpg,2176,34,208,242,284,348,False,8
6,56,kaist_dataset/English/Digital_Camera/(E.S)C-outdoor2/DSC03650.JPG,char_data/6/DSC03650.JPG_0.jpg,1624,29,330,359,292,348,False,8
6,35,kaist_dataset/English/Digital_Camera/(E.S)C-outdoor2/DSC03436.JPG,char_data/6/DSC03436.JPG_0.jpg,945,27,414,441,124,159,False,8
6,35,kaist_dataset/English/Digital_Camera/(E.S)C-outdoor2/DSC03162.JPG,char_data/6/DSC03162.JPG_0.jpg,595,17,440,457,147,182,False,8
6,32,kaist_dataset/English/Digital_Camera/(E.S)C-outdoor2/DSC03162.JPG,char_data/6/DSC03162.JPG_0.jpg,576,18,469,487,150,182,False,8
6,28,kaist_dataset/English/Digital_Camera/(E.S)C-outdoor1/056.JPG,char_data/6/056.JPG_0.jpg,224,8,530,538,250,278,False,8
6,22,kaist_dataset/English/Digital_Camera/(E.S)C-outdoor1/042.JPG,char_data/6/042.JPG_0.jpg,374,17,502,519,321,343,False,8
6,94,kaist_dataset/English/Digital_Camera/(E.S)C-outdoor1/DSC02491.JPG,char_data/6/DSC02491.JPG_0.jpg,4888,52,286,338,307,401,False,8
6,49,kaist_dataset/English/Digital_Camera/(E.S)F-others/080119-0007.jpg,char_data/6/080119-0007.jpg_0.jpg,1372,28,1049,1077,225,274,False,8
6,47,kaist_dataset/English/Digital_Camera/(E.S)F-others/2007-12-09-day-exterior-047.jpg,char_data/6/2007-12-09-day-exterior-047.jpg_0.jpg,564,12,3,15,565,612,False,8
6,46,kaist_dataset/English/Digital_Camera/(E.S)F-others/2007-12-09-day-exterior-047.jpg,char_data/6/2007-12-09-day-exterior-047.jpg_0.jpg,552,12,74,86,594,640,False,8
6,45,kaist_dataset/English/Digital_Camera/(E.S)F-others/m.jpg,char_data/6/m.jpg_0.jpg,900,20,53,73,177,222,False,8
6,39,kaist_dataset/English/Digital_Camera/(E.S)F-others/m.jpg,char_data/6/m.jpg_0.jpg,858,22,72,94,177,216,False,8
6,38,kaist_dataset/English/Digital_Camera/(E.S)F-others/DSC02923.JPG,char_data/6/DSC02923.JPG_0.jpg,570,15,356,371,392,430,False,8
6,92,kaist_dataset/English/Digital_Camera/(E.S)D-indoor/DSC03087.JPG,char_data/6/DSC03087.JPG_0.jpg,7912,86,324,410,137,229,False,8
6,50,kaist_dataset/English/Digital_Camera/(E.S)C-outdoor3/P1010086.JPG,char_data/6/P1010086.JPG_0.jpg,1550,31,574,605,95,145,False,8
6,48,kaist_dataset/English/Digital_Camera/(E.S)C-outdoor3/P1010086.JPG,char_data/6/P1010086.JPG_0.jpg,1104,23,525,548,94,142,False,8
a,61,kaist_dataset/Korean/Digital_Camera/outdoor2/2007-12-08-day-101.jpg,char_data/a/2007-12-08-day-101.jpg_2.jpg,3050,50,989,1039,401,462,True,31
a,37,kaist_dataset/Korean/Digital_Camera/outdoor2/2007-12-09-day-exterior-036.jpg,char_data/a/2007-12-09-day-exterior-036.jpg_2.jpg,1073,29,1411,1440,556,593,True,31
a,54,kaist_dataset/Korean/Digital_Camera/outdoor2/080119-0031.jpg,char_data/a/080119-0031.jpg_0.jpg,2052,38,581,619,121,175,True,31
a,36,kaist_dataset/Korean/Digital_Camera/outdoor2/080118-0018.jpg,char_data/a/080118-0018.jpg_0.jpg,1656,46,847,893,693,729,True,31
a,44,kaist_dataset/Korean/Digital_Camera/outdoor2/080118-0018.jpg,char_data/a/080118-0018.jpg_0.jpg,1980,45,1206,1251,695,739,True,31
a,24,kaist_dataset/Korean/Digital_Camera/indoor1/080119-0029.jpg,char_data/a/080119-0029.jpg_0.jpg,264,11,309,320,584,608,True,31
a,21,kaist_dataset/Korean/Digital_Camera/indoor1/145.JPG,char_data/a/145.JPG_0.jpg,252,12,243,255,306,327,True,31
a,42,kaist_dataset/Korean/Digital_Camera/G-others/080119-0005.jpg,char_data/a/080119-0005.jpg_0.jpg,1302,31,611,642,1156,1198,True,31
a,37,kaist_dataset/Korean/Digital_Camera/G-others/080119-0005.jpg,char_data/a/080119-0005.jpg_0.jpg,1073,29,712,741,1170,1207,True,31
a,32,kaist_dataset/Korean/Digital_Camera/G-others/080119-0005.jpg,char_data/a/080119-0005.jpg_0.jpg,672,21,674,695,603,635,True,31
a,25,kaist_dataset/Korean/Digital_Camera/outdoor6/DSC04292.JPG,char_data/a/DSC04292.JPG_0.jpg,350,14,139,153,59,84,True,31
a,21,kaist_dataset/Korean/Digital_Camera/A-shadow/2007-12-09-day-exterior-031.jpg,char_data/a/2007-12-09-day-exterior-031.jpg_0.jpg,252,12,385,397,624,645,True,31
a,24,kaist_dataset/Korean/Digital_Camera/A-shadow/2007-12-09-day-exterior-031.jpg,char_data/a/2007-12-09-day-exterior-031.jpg_0.jpg,360,15,496,511,618,642,True,31
a,29,kaist_dataset/Korean/Digital_Camera/A-shadow/2007-12-09-day-exterior-031.jpg,char_data/a/2007-12-09-day-exterior-031.jpg_0.jpg,493,17,545,562,614,643,True,31
a,26,kaist_dataset/Korean/Digital_Camera/outdoor1/2007-12-08-day-087.jpg,char_data/a/2007-12-08-day-087.jpg_0.jpg,520,20,46,66,517,543,True,31
a,13,kaist_dataset/Korean/Digital_Camera/outdoor1/001.JPG,char_data/a/001.JPG_0.jpg,156,12,285,297,247,260,True,31
a,19,kaist_dataset/Korean/Digital_Camera/outdoor1/001.JPG,char_data/a/001.JPG_0.jpg,285,15,372,387,242,261,True,31
a,30,kaist_dataset/Korean/Digital_Camera/outdoor1/40.jpg,char_data/a/40.jpg_0.jpg,600,20,53,73,52,82,True,31
a,34,kaist_dataset/Mixed/Mobile_Phone/(C.M)A-outdoor/P090912078.jpg,char_data/a/P090912078.jpg_0.jpg,1020,30,282,312,308,342,True,31
a,37,kaist_dataset/Mixed/Mobile_Phone/(C.M)A-outdoor/P090912078.jpg,char_data/a/P090912078.jpg_0.jpg,1036,28,364,392,296,333,True,31
a,34,kaist_dataset/Mixed/Mobile_Phone/(C.M)A-outdoor/P090912062.jpg,char_data/a/P090912062.jpg_0.jpg,646,19,498,517,126,160,True,31
a,30,kaist_dataset/Mixed/Mobile_Phone/(C.M)A-outdoor/P090912062.jpg,char_data/a/P090912062.jpg_0.jpg,510,17,616,633,125,155,True,31
a,68,kaist_dataset/Mixed/Mobile_Phone/(C.M)A-outdoor/P090912037.jpg,char_data/a/P090912037.jpg_0.jpg,3264,48,156,204,173,241,True,31
a,43,kaist_dataset/Mixed/Mobile_Phone/(C.M)B-indoor/P090831012.jpg,char_data/a/P090831012.jpg_0.jpg,1419,33,242,275,181,224,True,31
a,41,kaist_dataset/Mixed/Mobile_Phone/(C.M)B-indoor/P090831012.jpg,char_data/a/P090831012.jpg_0.jpg,1312,32,352,384,184,225,True,31
a,53,kaist_dataset/Mixed/Mobile_Phone/(C.M)B-indoor/P090831015.jpg,char_data/a/P090831015.jpg_0.jpg,1961,37,155,192,209,262,True,31
a,41,kaist_dataset/Mixed/Mobile_Phone/(C.M)B-indoor/P090831013.jpg,char_data/a/P090831013.jpg_0.jpg,1312,32,347,379,200,241,True,31
a,44,kaist_dataset/Mixed/Mobile_Phone/(C.M)B-indoor/P090831013.jpg,char_data/a/P090831013.jpg_0.jpg,1540,35,455,490,201,245,True,31
a,47,kaist_dataset/Mixed/Mobile_Phone/(C.M)B-indoor/P090831017.jpg,char_data/a/P090831017.jpg_0.jpg,1786,38,358,396,248,295,True,31
a,47,kaist_dataset/Mixed/Mobile_Phone/(C.M)B-indoor/P090831023.jpg,char_data/a/P090831023.jpg_0.jpg,2115,45,298,343,278,325,True,31
a,46,kaist_dataset/Mixed/Mobile_Phone/(C.M)C-bookCover/P090831113.jpg,char_data/a/P090831113.jpg_0.jpg,1564,34,424,458,247,293,True,31
a,55,kaist_dataset/Mixed/Mobile_Phone/(C.M)C-bookCover/P090831126.jpg,char_data/a/P090831126.jpg_0.jpg,1980,36,269,305,287,342,True,31
a,51,kaist_dataset/Mixed/Mobile_Phone/(C.M)C-bookCover/P090831126.jpg,char_data/a/P090831126.jpg_0.jpg,1785,35,340,375,292,343,True,31
a,38,kaist_dataset/Mixed/Mobile_Phone/(C.M)C-bookCover/P090902016.jpg,char_data/a/P090902016.jpg_0.jpg,988,26,331,357,140,178,True,31
a,25,kaist_dataset/Mixed/Mobile_Phone/(C.M)C-bookCover/P090902016.jpg,char_data/a/P090902016.jpg_0.jpg,500,20,207,227,279,304,True,31
a,35,kaist_dataset/Mixed/Mobile_Phone/(C.M)C-bookCover/P090904005.jpg,char_data/a/P090904005.jpg_0.jpg,945,27,295,322,119,154,True,31
a,49,kaist_dataset/Mixed/Mobile_Phone/(C.M)C-bookCover/P090831125.jpg,char_data/a/P090831125.jpg_0.jpg,1470,30,296,326,277,326,True,31
a,46,kaist_dataset/Mixed/Mobile_Phone/(C.M)C-bookCover/P090831125.jpg,char_data/a/P090831125.jpg_0.jpg,1610,35,356,391,277,323,True,31
a,38,kaist_dataset/Mixed/Mobile_Phone/(C.M)C-bookCover/P090831080.jpg,char_data/a/P090831080.jpg_0.jpg,912,24,282,306,337,375,True,31
a,30,kaist_dataset/Mixed/Mobile_Phone/(C.M)C-bookCover/P090831080.jpg,char_data/a/P090831080.jpg_0.jpg,960,32,321,353,378,408,True,31
a,45,kaist_dataset/Mixed/Mobile_Phone/(C.M)C-bookCover/P090831121.jpg,char_data/a/P090831121.jpg_0.jpg,1620,36,303,339,323,368,True,31
a,24,kaist_dataset/Mixed/Mobile_Phone/(C.M)C-bookCover/P090831115.jpg,char_data/a/P090831115.jpg_0.jpg,504,21,300,321,181,205,True,31
a,44,kaist_dataset/Mixed/Mobile_Phone/(C.M)C-bookCover/P090831124.jpg,char_data/a/P090831124.jpg_0.jpg,1144,26,255,281,402,446,True,31
a,42,kaist_dataset/Mixed/Mobile_Phone/(C.M)C-bookCover/P090902019.jpg,char_data/a/P090902019.jpg_0.jpg,1554,37,353,390,303,345,True,31
a,47,kaist_dataset/Mixed/Mobile_Phone/(C.M)C-bookCover/P090831122.jpg,char_data/a/P090831122.jpg_0.jpg,1645,35,365,400,269,316,True,31
a,46,kaist_dataset/Mixed/Mobile_Phone/(C.M)C-bookCover/P090903083.jpg,char_data/a/P090903083.jpg_0.jpg,1978,43,112,155,178,224,True,31
a,32,kaist_dataset/Mixed/Mobile_Phone/(C.M)C-bookCover/P090831118.jpg,char_data/a/P090831118.jpg_0.jpg,640,20,133,153,222,254,True,31
a,39,kaist_dataset/Mixed/Mobile_Phone/(C.M)C-bookCover/P090831118.jpg,char_data/a/P090831118.jpg_0.jpg,897,23,244,267,218,257,True,31
a,30,kaist_dataset/Mixed/Mobile_Phone/(C.M)C-bookCover/P090903024.jpg,char_data/a/P090903024.jpg_0.jpg,750,25,460,485,228,258,True,31
a,36,kaist_dataset/Mixed/Digital_Camera/(C.S)C-outdoor1/51.JPG,char_data/a/51.JPG_0.jpg,1188,33,154,187,230,266,True,31
a,67,kaist_dataset/Mixed/Digital_Camera/(C.S)C-outdoor1/P1010008.JPG,char_data/a/P1010008.JPG_0.jpg,4288,64,512,576,250,317,True,31
a,37,kaist_dataset/Mixed/Digital_Camera/(C.S)C-outdoor1/133.JPG,char_data/a/133.JPG_0.jpg,888,24,540,564,338,375,True,31
a,20,kaist_dataset/Mixed/Digital_Camera/(C.S)C-outdoor1/DSC02319.JPG,char_data/a/DSC02319.JPG_0.jpg,280,14,121,135,281,301,True,31
a,64,kaist_dataset/Mixed/Digital_Camera/(C.S)C-outdoor1/DSC02344.JPG,char_data/a/DSC02344.JPG_0.jpg,2752,43,264,307,160,224,True,31
a,26,kaist_dataset/Mixed/Digital_Camera/(C.S)C-outdoor1/115.JPG,char_data/a/115.JPG_0.jpg,442,17,313,330,281,307,True,31
a,75,kaist_dataset/Mixed/Digital_Camera/(C.S)C-outdoor1/8.jpg,char_data/a/8.jpg_0.jpg,4275,57,29,86,166,241,True,31
a,71,kaist_dataset/Mixed/Digital_Camera/(C.S)C-outdoor1/8.jpg,char_data/a/8.jpg_0.jpg,3763,53,142,195,165,236,True,31
a,82,kaist_dataset/Mixed/Digital_Camera/(C.S)C-outdoor1/8.jpg,char_data/a/8.jpg_0.jpg,4428,54,249,303,157,239,True,31
a,32,kaist_dataset/Mixed/Digital_Camera/(C.S)C-outdoor1/080.JPG,char_data/a/080.JPG_0.jpg,864,27,76,103,76,108,True,31
a,52,kaist_dataset/Mixed/Digital_Camera/(C.S)C-outdoor1/2007-12-09-day-exterior-004.jpg,char_data/a/2007-12-09-day-exterior-004.jpg_0.jpg,2444,47,434,481,675,727,True,31
a,52,kaist_dataset/Mixed/Digital_Camera/(C.S)C-outdoor1/2007-12-09-day-exterior-004.jpg,char_data/a/2007-12-09-day-exterior-004.jpg_0.jpg,2444,47,578,625,672,724,True,31
a,24,kaist_dataset/Mixed/Digital_Camera/(C.S)C-outdoor1/021.JPG,char_data/a/021.JPG_0.jpg,288,12,466,478,140,164,True,31
a,34,kaist_dataset/Mixed/Digital_Camera/(C.S)C-outdoor1/47.JPG,char_data/a/47.JPG_0.jpg,816,24,343,367,183,217,True,31
a,56,kaist_dataset/Mixed/Digital_Camera/(C.S)C-outdoor1/2007-12-08-day-106.jpg,char_data/a/2007-12-08-day-106.jpg_0.jpg,3192,57,1251,1308,759,815,True,31
a,31,kaist_dataset/Mixed/Digital_Camera/(C.S)C-outdoor1/DSC02242.JPG,char_data/a/DSC02242.JPG_0.jpg,341,11,225,236,166,197,True,31
a,30,kaist_dataset/Mixed/Digital_Camera/(C.S)C-outdoor1/DSC02318.JPG,char_data/a/DSC02318.JPG_0.jpg,660,22,487,509,324,354,True,31
a,33,kaist_dataset/Mixed/Digital_Camera/(C.S)C-outdoor1/130.JPG,char_data/a/130.JPG_0.jpg,1056,32,118,150,299,332,True,31
a,111,kaist_dataset/Mixed/Digital_Camera/(C.S)C-outdoor1/080118-0014.jpg,char_data/a/080118-0014.jpg_0.jpg,10989,99,471,570,763,874,True,31
a,29,kaist_dataset/Mixed/Digital_Camera/(C.S)C-outdoor1/2.JPG,char_data/a/2.JPG_0.jpg,203,7,70,77,379,408,True,31
a,22,kaist_dataset/Mixed/Digital_Camera/(C.S)C-outdoor1/2.JPG,char_data/a/2.JPG_0.jpg,154,7,85,92,385,407,True,31
a,19,kaist_dataset/Mixed/Digital_Camera/(C.S)C-outdoor1/003.JPG,char_data/a/003.JPG_0.jpg,209,11,316,327,261,280,True,31
a,20,kaist_dataset/Mixed/Digital_Camera/(C.S)C-outdoor1/003.JPG,char_data/a/003.JPG_0.jpg,240,12,522,534,253,273,True,31
a,18,kaist_dataset/Mixed/Digital_Camera/(C.S)C-outdoor1/003.JPG,char_data/a/003.JPG_0.jpg,162,9,116,125,271,289,True,31
a,41,kaist_dataset/Mixed/Digital_Camera/(C.S)C-outdoor1/1.JPG,char_data/a/1.JPG_0.jpg,1148,28,449,477,7,48,True,31
a,37,kaist_dataset/Mixed/Digital_Camera/(C.S)C-outdoor1/1.JPG,char_data/a/1.JPG_0.jpg,814,22,744,766,11,48,True,31
a,83,kaist_dataset/Mixed/Digital_Camera/(C.S)F-others/2007-12-08-day-044.jpg,char_data/a/2007-12-08-day-044.jpg_0.jpg,4814,58,327,385,429,512,True,31
a,49,kaist_dataset/Mixed/Digital_Camera/(C.S)F-others/047.jpg,char_data/a/047.jpg_0.jpg,1813,37,125,162,72,121,True,31
a,39,kaist_dataset/Mixed/Digital_Camera/(C.S)D-indoor2/DSC04249.JPG,char_data/a/DSC04249.JPG_0.jpg,975,25,205,230,218,257,True,31
a,34,kaist_dataset/Mixed/Digital_Camera/(C.S)D-indoor2/DSC04254.JPG,char_data/a/DSC04254.JPG_0.jpg,578,17,184,201,344,378,True,31
a,28,kaist_dataset/Mixed/Digital_Camera/(C.S)D-indoor2/DSC04254.JPG,char_data/a/DSC04254.JPG_0.jpg,476,17,264,281,347,375,True,31
a,35,kaist_dataset/Mixed/Digital_Camera/(C.S)D-indoor2/DSC04254.JPG,char_data/a/DSC04254.JPG_0.jpg,630,18,400,418,341,376,True,31
a,42,kaist_dataset/Mixed/Digital_Camera/(C.S)E-night/DSC02647.JPG,char_data/a/DSC02647.JPG_0.jpg,1932,46,288,334,200,242,True,31
a,40,kaist_dataset/Mixed/Digital_Camera/(C.S)E-night/DSC02574.JPG,char_data/a/DSC02574.JPG_0.jpg,1040,26,449,475,155,195,True,31
a,36,kaist_dataset/Mixed/Digital_Camera/(C.S)E-night/DSC02574.JPG,char_data/a/DSC02574.JPG_0.jpg,972,27,520,547,152,188,True,31
a,97,kaist_dataset/Mixed/Digital_Camera/(C.S)E-night/DSC02586.JPG,char_data/a/DSC02586.JPG_0.jpg,8730,90,191,281,265,362,True,31
a,23,kaist_dataset/Mixed/Digital_Camera/(C.S)E-night/DSC03516.JPG,char_data/a/DSC03516.JPG_0.jpg,437,19,137,156,114,137,True,31
a,85,kaist_dataset/Mixed/Digital_Camera/(C.S)B-light/DSC04404.JPG,char_data/a/DSC04404.JPG_0.jpg,5270,62,249,311,229,314,True,31
a,30,kaist_dataset/Mixed/Digital_Camera/(C.S)B-light/134.JPG,char_data/a/134.JPG_0.jpg,540,18,286,304,293,323,True,31
a,37,kaist_dataset/Mixed/Digital_Camera/(C.S)B-light/134.JPG,char_data/a/134.JPG_0.jpg,740,20,368,388,291,328,True,31
a,39,kaist_dataset/Mixed/Digital_Camera/(C.S)D-indoor1/DSC03118.JPG,char_data/a/DSC03118.JPG_0.jpg,975,25,225,250,156,195,True,31
a,40,kaist_dataset/Mixed/Digital_Camera/(C.S)D-indoor1/DSC03118.JPG,char_data/a/DSC03118.JPG_0.jpg,1000,25,334,359,153,193,True,31
a,40,kaist_dataset/Mixed/Digital_Camera/(C.S)D-indoor1/DSC03118.JPG,char_data/a/DSC03118.JPG_0.jpg,1000,25,464,489,155,195,True,31
a,39,kaist_dataset/Mixed/Digital_Camera/(C.S)D-indoor1/DSC03118.JPG,char_data/a/DSC03118.JPG_0.jpg,1053,27,185,212,230,269,True,31
a,41,kaist_dataset/Mixed/Digital_Camera/(C.S)D-indoor1/DSC03119.JPG,char_data/a/DSC03119.JPG_0.jpg,1189,29,305,334,168,209,True,31
a,37,kaist_dataset/Mixed/Digital_Camera/(C.S)D-indoor1/DSC03134.JPG,char_data/a/DSC03134.JPG_0.jpg,1036,28,379,407,171,208,True,31
a,33,kaist_dataset/Mixed/Digital_Camera/(C.S)D-indoor1/082.JPG,char_data/a/082.JPG_0.jpg,891,27,222,249,187,220,True,31
a,44,kaist_dataset/Mixed/Digital_Camera/(C.S)D-indoor1/DSC03126.JPG,char_data/a/DSC03126.JPG_0.jpg,1452,33,337,370,221,265,True,31
a,50,kaist_dataset/Mixed/Digital_Camera/(C.S)D-indoor1/DSC03455.JPG,char_data/a/DSC03455.JPG_0.jpg,1350,27,288,315,398,448,True,31
a,48,kaist_dataset/Mixed/Digital_Camera/(C.S)D-indoor1/DSC03123.JPG,char_data/a/DSC03123.JPG_0.jpg,1536,32,250,282,181,229,True,31
a,42,kaist_dataset/Mixed/Digital_Camera/(C.S)D-indoor1/DSC03123.JPG,char_data/a/DSC03123.JPG_0.jpg,1218,29,399,428,181,223,True,31
a,48,kaist_dataset/Mixed/Digital_Camera/(C.S)D-indoor1/DSC03121.JPG,char_data/a/DSC03121.JPG_0.jpg,1536,32,328,360,205,253,True,31
a,31,kaist_dataset/Mixed/Digital_Camera/(C.S)D-indoor1/DSC02787.JPG,char_data/a/DSC02787.JPG_0.jpg,496,16,263,279,380,411,True,31
a,36,kaist_dataset/Mixed/Digital_Camera/(C.S)D-indoor1/DSC02787.JPG,char_data/a/DSC02787.JPG_0.jpg,684,19,333,352,372,408,True,31
a,34,kaist_dataset/Mixed/Digital_Camera/(C.S)D-indoor1/DSC03466.JPG,char_data/a/DSC03466.JPG_0.jpg,748,22,339,361,235,269,True,31
a,35,kaist_dataset/Mixed/Digital_Camera/(C.S)D-indoor1/DSC03073.JPG,char_data/a/DSC03073.JPG_0.jpg,805,23,283,306,292,327,True,31
a,57,kaist_dataset/Mixed/Digital_Camera/(C.S)D-indoor1/DSC03925.JPG,char_data/a/DSC03925.JPG_0.jpg,1938,34,356,390,380,437,True,31
a,53,kaist_dataset/Mixed/Digital_Camera/(C.S)D-indoor1/DSC03925.JPG,char_data/a/DSC03925.JPG_0.jpg,2120,40,417,457,383,436,True,31
a,80,kaist_dataset/Mixed/Digital_Camera/(C.S)D-indoor1/DSC03469.JPG,char_data/a/DSC03469.JPG_0.jpg,5360,67,293,360,348,428,True,31
a,35,kaist_dataset/Mixed/Digital_Camera/(C.S)D-indoor1/DSC04206.JPG,char_data/a/DSC04206.JPG_0.jpg,490,14,245,259,287,322,True,31
a,46,kaist_dataset/Mixed/Digital_Camera/(C.S)D-indoor1/DSC03135.JPG,char_data/a/DSC03135.JPG_0.jpg,1702,37,390,427,197,243,True,31
a,48,kaist_dataset/Mixed/Digital_Camera/(C.S)D-indoor1/DSC03133.JPG,char_data/a/DSC03133.JPG_0.jpg,1584,33,184,217,148,196,True,31
a,43,kaist_dataset/Mixed/Digital_Camera/(C.S)D-indoor1/DSC03912.JPG,char_data/a/DSC03912.JPG_0.jpg,1247,29,316,345,46,89,True,31
a,36,kaist_dataset/Mixed/Digital_Camera/(C.S)D-indoor1/DSC03131.JPG,char_data/a/DSC03131.JPG_0.jpg,1188,33,416,449,142,178,True,31
a,42,kaist_dataset/Mixed/Digital_Camera/(C.S)D-indoor1/DSC03125.JPG,char_data/a/DSC03125.JPG_0.jpg,1386,33,256,289,189,231,True,31
a,32,kaist_dataset/Mixed/Digital_Camera/(C.S)D-indoor1/DSC02718.JPG,char_data/a/DSC02718.JPG_0.jpg,384,12,182,194,241,273,True,31
a,54,kaist_dataset/Mixed/Digital_Camera/(C.S)D-indoor1/DSC02770.JPG,char_data/a/DSC02770.JPG_0.jpg,2160,40,372,412,357,411,True,31
a,30,kaist_dataset/Mixed/Digital_Camera/(C.S)D-indoor1/DSC03096.JPG,char_data/a/DSC03096.JPG_0.jpg,540,18,82,100,423,453,True,31
a,32,kaist_dataset/Mixed/Digital_Camera/(C.S)D-indoor1/DSC03096.JPG,char_data/a/DSC03096.JPG_0.jpg,544,17,112,129,423,455,True,31
a,35,kaist_dataset/Mixed/Digital_Camera/(C.S)D-indoor1/DSC03096.JPG,char_data/a/DSC03096.JPG_0.jpg,560,16,384,400,425,460,True,31
a,58,kaist_dataset/Mixed/Digital_Camera/(C.S)D-indoor1/DSC03130.JPG,char_data/a/DSC03130.JPG_0.jpg,2378,41,273,314,172,230,True,31
a,48,kaist_dataset/Mixed/Digital_Camera/(C.S)D-indoor1/DSC03130.JPG,char_data/a/DSC03130.JPG_0.jpg,1920,40,399,439,178,226,True,31
a,40,kaist_dataset/Mixed/Digital_Camera/(C.S)D-indoor1/DSC04246.JPG,char_data/a/DSC04246.JPG_0.jpg,760,19,203,222,250,290,True,31
a,32,kaist_dataset/Mixed/Digital_Camera/(C.S)D-indoor1/DSC04246.JPG,char_data/a/DSC04246.JPG_0.jpg,480,15,369,384,250,282,True,31
a,32,kaist_dataset/Mixed/Digital_Camera/(C.S)D-indoor1/DSC04246.JPG,char_data/a/DSC04246.JPG_0.jpg,448,14,489,503,249,281,True,31
a,32,kaist_dataset/Mixed/Digital_Camera/(C.S)C-outdoor5/DSC04290.JPG,char_data/a/DSC04290.JPG_0.jpg,544,17,134,151,381,413,True,31
a,48,kaist_dataset/Mixed/Digital_Camera/(C.S)C-outdoor5/DSC04456.JPG,char_data/a/DSC04456.JPG_0.jpg,1680,35,449,484,168,216,True,31
a,42,kaist_dataset/Mixed/Digital_Camera/(C.S)C-outdoor5/DSC04154.JPG,char_data/a/DSC04154.JPG_0.jpg,1092,26,491,517,236,278,True,31
a,35,kaist_dataset/Mixed/Digital_Camera/(C.S)C-outdoor5/DSC04321.JPG,char_data/a/DSC04321.JPG_0.jpg,875,25,168,193,194,229,True,31
a,31,kaist_dataset/Mixed/Digital_Camera/(C.S)C-outdoor5/DSC04321.JPG,char_data/a/DSC04321.JPG_0.jpg,713,23,263,286,204,235,True,31
a,32,kaist_dataset/Mixed/Digital_Camera/(C.S)C-outdoor5/DSC04321.JPG,char_data/a/DSC04321.JPG_0.jpg,640,20,356,376,203,235,True,31
a,24,kaist_dataset/Mixed/Digital_Camera/(C.S)C-outdoor5/DSC04076.JPG,char_data/a/DSC04076.JPG_0.jpg,456,19,404,423,403,427,True,31
a,26,kaist_dataset/Mixed/Digital_Camera/(C.S)C-outdoor5/DSC04076.JPG,char_data/a/DSC04076.JPG_0.jpg,312,12,463,475,401,427,True,31
a,33,kaist_dataset/Mixed/Digital_Camera/(C.S)C-outdoor5/DSC03839.JPG,char_data/a/DSC03839.JPG_0.jpg,495,15,367,382,37,70,True,31
a,24,kaist_dataset/Mixed/Digital_Camera/(C.S)C-outdoor5/DSC04357.JPG,char_data/a/DSC04357.JPG_0.jpg,384,16,339,355,356,380,True,31
a,25,kaist_dataset/Mixed/Digital_Camera/(C.S)C-outdoor5/DSC04357.JPG,char_data/a/DSC04357.JPG_0.jpg,375,15,367,382,353,378,True,31
a,22,kaist_dataset/Mixed/Digital_Camera/(C.S)C-outdoor5/DSC04357.JPG,char_data/a/DSC04357.JPG_0.jpg,330,15,395,410,358,380,True,31
a,30,kaist_dataset/Mixed/Digital_Camera/(C.S)C-outdoor5/DSC04151.JPG,char_data/a/DSC04151.JPG_0.jpg,600,20,92,112,339,369,True,31
a,35,kaist_dataset/Mixed/Digital_Camera/(C.S)C-outdoor5/DSC03821.JPG,char_data/a/DSC03821.JPG_0.jpg,770,22,50,72,35,70,True,31
a,39,kaist_dataset/Mixed/Digital_Camera/(C.S)C-outdoor5/DSC03821.JPG,char_data/a/DSC03821.JPG_0.jpg,858,22,138,160,32,71,True,31
a,55,kaist_dataset/Mixed/Digital_Camera/(C.S)C-outdoor5/DSC04399.JPG,char_data/a/DSC04399.JPG_0.jpg,1870,34,377,411,211,266,True,31
a,50,kaist_dataset/Mixed/Digital_Camera/(C.S)C-outdoor5/DSC04399.JPG,char_data/a/DSC04399.JPG_0.jpg,1900,38,385,423,283,333,True,31
a,36,kaist_dataset/Mixed/Digital_Camera/(C.S)C-outdoor5/DSC04429.JPG,char_data/a/DSC04429.JPG_0.jpg,576,16,203,219,257,293,True,31
a,37,kaist_dataset/Mixed/Digital_Camera/(C.S)C-outdoor5/DSC04323.JPG,char_data/a/DSC04323.JPG_0.jpg,703,19,132,151,200,237,True,31
a,28,kaist_dataset/Mixed/Digital_Camera/(C.S)C-outdoor5/DSC04323.JPG,char_data/a/DSC04323.JPG_0.jpg,588,21,209,230,207,235,True,31
a,74,kaist_dataset/Mixed/Digital_Camera/(C.S)C-outdoor5/DSC04030.JPG,char_data/a/DSC04030.JPG_0.jpg,4218,57,209,266,184,258,True,31
a,38,kaist_dataset/Mixed/Digital_Camera/(C.S)C-outdoor5/DSC04338.JPG,char_data/a/DSC04338.JPG_0.jpg,950,25,303,328,198,236,True,31
a,40,kaist_dataset/Mixed/Digital_Camera/(C.S)C-outdoor5/DSC04338.JPG,char_data/a/DSC04338.JPG_0.jpg,800,20,551,571,199,239,True,31
a,46,kaist_dataset/Mixed/Digital_Camera/(C.S)C-outdoor5/DSC04322.JPG,char_data/a/DSC04322.JPG_0.jpg,966,21,64,85,212,258,True,31
a,42,kaist_dataset/Mixed/Digital_Camera/(C.S)C-outdoor5/DSC04322.JPG,char_data/a/DSC04322.JPG_0.jpg,840,20,159,179,219,261,True,31
a,39,kaist_dataset/Mixed/Digital_Camera/(C.S)C-outdoor5/DSC04322.JPG,char_data/a/DSC04322.JPG_0.jpg,819,21,363,384,223,262,True,31
a,27,kaist_dataset/Mixed/Digital_Camera/(C.S)C-outdoor5/DSC04057.JPG,char_data/a/DSC04057.JPG_0.jpg,459,17,266,283,120,147,True,31
a,34,kaist_dataset/Mixed/Digital_Camera/(C.S)C-outdoor5/DSC04057.JPG,char_data/a/DSC04057.JPG_0.jpg,680,20,317,337,117,151,True,31
a,69,kaist_dataset/Mixed/Digital_Camera/(C.S)C-outdoor5/DSC04115.JPG,char_data/a/DSC04115.JPG_0.jpg,3174,46,130,176,210,279,True,31
a,51,kaist_dataset/Mixed/Digital_Camera/(C.S)C-outdoor3/DSC03199.JPG,char_data/a/DSC03199.JPG_0.jpg,2040,40,50,90,335,386,True,31
a,47,kaist_dataset/Mixed/Digital_Camera/(C.S)C-outdoor3/DSC03310.JPG,char_data/a/DSC03310.JPG_0.jpg,2538,54,138,192,122,169,True,31
a,60,kaist_dataset/Mixed/Digital_Camera/(C.S)C-outdoor3/DSC03260.JPG,char_data/a/DSC03260.JPG_0.jpg,2940,49,91,140,82,142,True,31
a,50,kaist_dataset/Mixed/Digital_Camera/(C.S)C-outdoor3/DSC02962.JPG,char_data/a/DSC02962.JPG_0.jpg,1850,37,440,477,233,283,True,31
a,53,kaist_dataset/Mixed/Digital_Camera/(C.S)C-outdoor3/DSC02962.JPG,char_data/a/DSC02962.JPG_0.jpg,1802,34,279,313,189,242,True,31
a,79,kaist_dataset/Mixed/Digital_Camera/(C.S)C-outdoor3/DSC03421.JPG,char_data/a/DSC03421.JPG_0.jpg,3081,39,133,172,228,307,True,31
a,78,kaist_dataset/Mixed/Digital_Camera/(C.S)C-outdoor3/DSC03421.JPG,char_data/a/DSC03421.JPG_0.jpg,3042,39,428,467,247,325,True,31
a,94,kaist_dataset/Mixed/Digital_Camera/(C.S)C-outdoor3/DSC03421.JPG,char_data/a/DSC03421.JPG_0.jpg,6486,69,247,316,86,180,True,31
a,75,kaist_dataset/Mixed/Digital_Camera/(C.S)C-outdoor3/P1010016.JPG,char_data/a/P1010016.JPG_0.jpg,3150,42,298,340,179,254,True,31
a,25,kaist_dataset/Mixed/Digital_Camera/(C.S)C-outdoor3/DSC02970.JPG,char_data/a/DSC02970.JPG_0.jpg,500,20,325,345,310,335,True,31
a,42,kaist_dataset/Mixed/Digital_Camera/(C.S)C-outdoor3/DSC02978.JPG,char_data/a/DSC02978.JPG_0.jpg,1008,24,83,107,160,202,True,31
a,40,kaist_dataset/Mixed/Digital_Camera/(C.S)C-outdoor3/DSC02978.JPG,char_data/a/DSC02978.JPG_0.jpg,1120,28,154,182,166,206,True,31
a,36,kaist_dataset/Mixed/Digital_Camera/(C.S)C-outdoor3/DSC02978.JPG,char_data/a/DSC02978.JPG_0.jpg,720,20,278,298,168,204,True,31
a,29,kaist_dataset/Mixed/Digital_Camera/(C.S)C-outdoor3/DSC03328.JPG,char_data/a/DSC03328.JPG_0.jpg,493,17,493,510,234,263,True,31
a,100,kaist_dataset/Mixed/Digital_Camera/(C.S)C-outdoor3/DSC03196.JPG,char_data/a/DSC03196.JPG_0.jpg,8700,87,359,446,290,390,True,31
a,104,kaist_dataset/Mixed/Digital_Camera/(C.S)C-outdoor3/DSC03196.JPG,char_data/a/DSC03196.JPG_0.jpg,9464,91,445,536,289,393,True,31
a,30,kaist_dataset/Mixed/Digital_Camera/(C.S)C-outdoor3/DSC03209.JPG,char_data/a/DSC03209.JPG_0.jpg,870,29,362,391,420,450,True,31
a,32,kaist_dataset/Mixed/Digital_Camera/(C.S)C-outdoor3/DSC03209.JPG,char_data/a/DSC03209.JPG_0.jpg,1024,32,433,465,418,450,True,31
a,101,kaist_dataset/Mixed/Digital_Camera/(C.S)C-outdoor3/DSC03210.JPG,char_data/a/DSC03210.JPG_0.jpg,5959,59,273,332,244,345,True,31
a,70,kaist_dataset/Mixed/Digital_Camera/(C.S)C-outdoor3/DSC03422.JPG,char_data/a/DSC03422.JPG_0.jpg,1890,27,152,179,237,307,True,31
a,62,kaist_dataset/Mixed/Digital_Camera/(C.S)C-outdoor3/DSC03422.JPG,char_data/a/DSC03422.JPG_0.jpg,1364,22,345,367,258,320,True,31
a,32,kaist_dataset/Mixed/Digital_Camera/(C.S)C-outdoor3/DSC03227.JPG,char_data/a/DSC03227.JPG_0.jpg,512,16,147,163,108,140,True,31
a,33,kaist_dataset/Mixed/Digital_Camera/(C.S)C-outdoor3/DSC03227.JPG,char_data/a/DSC03227.JPG_0.jpg,561,17,212,229,104,137,True,31
a,92,kaist_dataset/Mixed/Digital_Camera/(C.S)C-outdoor3/DSC03017.JPG,char_data/a/DSC03017.JPG_0.jpg,8280,90,194,284,150,242,True,31
a,45,kaist_dataset/Mixed/Digital_Camera/(C.S)C-outdoor3/DSC02989.JPG,char_data/a/DSC02989.JPG_0.jpg,1575,35,477,512,207,252,True,31
a,30,kaist_dataset/Mixed/Digital_Camera/(C.S)C-outdoor3/DSC03271.JPG,char_data/a/DSC03271.JPG_0.jpg,600,20,290,310,81,111,True,31
a,51,kaist_dataset/Mixed/Digital_Camera/(C.S)C-outdoor3/DSC03242.JPG,char_data/a/DSC03242.JPG_0.jpg,2499,49,221,270,174,225,True,31
a,20,kaist_dataset/Mixed/Digital_Camera/(C.S)C-outdoor6/P1010138.JPG,char_data/a/P1010138.JPG_0.jpg,380,19,131,150,184,204,True,31
a,33,kaist_dataset/Mixed/Digital_Camera/(C.S)C-outdoor6/090.jpg,char_data/a/090.jpg_0.jpg,792,24,233,257,158,191,True,31
a,89,kaist_dataset/Mixed/Digital_Camera/(C.S)C-outdoor6/P1010093.JPG,char_data/a/P1010093.JPG_0.jpg,9167,103,269,372,135,224,True,31
a,140,kaist_dataset/Mixed/Digital_Camera/(C.S)C-outdoor6/080116-0057.jpg,char_data/a/080116-0057.jpg_0.jpg,17500,125,412,537,577,717,True,31
a,42,kaist_dataset/Mixed/Digital_Camera/(C.S)C-outdoor6/080116-0057.jpg,char_data/a/080116-0057.jpg_0.jpg,1218,29,244,273,924,966,True,31
a,29,kaist_dataset/Mixed/Digital_Camera/(C.S)C-outdoor6/P1010021.JPG,char_data/a/P1010021.JPG_0.jpg,638,22,502,524,214,243,True,31
a,61,kaist_dataset/Mixed/Digital_Camera/(C.S)C-outdoor6/P1010116.JPG,char_data/a/P1010116.JPG_0.jpg,1098,18,337,355,204,265,True,31
a,33,kaist_dataset/Mixed/Digital_Camera/(C.S)C-outdoor6/P1010048.JPG,char_data/a/P1010048.JPG_0.jpg,462,14,506,520,170,203,True,31
a,34,kaist_dataset/Mixed/Digital_Camera/(C.S)C-outdoor6/P1010048.JPG,char_data/a/P1010048.JPG_0.jpg,680,20,574,594,173,207,True,31
a,24,kaist_dataset/Mixed/Digital_Camera/(C.S)C-outdoor6/P1010132.JPG,char_data/a/P1010132.JPG_0.jpg,336,14,142,156,109,133,True,31
a,46,kaist_dataset/Mixed/Digital_Camera/(C.S)C-outdoor4/DSC03730.JPG,char_data/a/DSC03730.JPG_0.jpg,1932,42,263,305,346,392,True,31
a,30,kaist_dataset/Mixed/Digital_Camera/(C.S)C-outdoor4/DSC03719.JPG,char_data/a/DSC03719.JPG_0.jpg,480,16,70,86,33,63,True,31
a,31,kaist_dataset/Mixed/Digital_Camera/(C.S)C-outdoor4/DSC03719.JPG,char_data/a/DSC03719.JPG_0.jpg,434,14,120,134,33,64,True,31
a,32,kaist_dataset/Mixed/Digital_Camera/(C.S)C-outdoor4/DSC03719.JPG,char_data/a/DSC03719.JPG_0.jpg,480,15,173,188,35,67,True,31
a,62,kaist_dataset/Mixed/Digital_Camera/(C.S)C-outdoor4/DSC03733.JPG,char_data/a/DSC03733.JPG_0.jpg,2914,47,271,318,218,280,True,31
a,42,kaist_dataset/Mixed/Digital_Camera/(C.S)C-outdoor4/DSC03642.JPG,char_data/a/DSC03642.JPG_0.jpg,966,23,274,297,253,295,True,31
a,38,kaist_dataset/Mixed/Digital_Camera/(C.S)C-outdoor4/DSC03642.JPG,char_data/a/DSC03642.JPG_0.jpg,760,20,379,399,249,287,True,31
a,24,kaist_dataset/Mixed/Digital_Camera/(C.S)C-outdoor4/DSC03661.JPG,char_data/a/DSC03661.JPG_0.jpg,408,17,103,120,276,300,True,31
a,55,kaist_dataset/Mixed/Digital_Camera/(C.S)C-outdoor4/DSC03784.JPG,char_data/a/DSC03784.JPG_0.jpg,1650,30,429,459,323,378,True,31
a,60,kaist_dataset/Mixed/Digital_Camera/(C.S)C-outdoor4/DSC03784.JPG,char_data/a/DSC03784.JPG_0.jpg,2280,38,516,554,317,377,True,31
a,30,kaist_dataset/Mixed/Digital_Camera/(C.S)C-outdoor4/DSC03718.JPG,char_data/a/DSC03718.JPG_0.jpg,390,13,299,312,98,128,True,31
a,34,kaist_dataset/Mixed/Digital_Camera/(C.S)C-outdoor4/DSC03718.JPG,char_data/a/DSC03718.JPG_0.jpg,442,13,68,81,258,292,True,31
a,27,kaist_dataset/Mixed/Digital_Camera/(C.S)C-outdoor4/DSC03718.JPG,char_data/a/DSC03718.JPG_0.jpg,459,17,112,129,264,291,True,31
a,34,kaist_dataset/Mixed/Digital_Camera/(C.S)C-outdoor4/DSC03718.JPG,char_data/a/DSC03718.JPG_0.jpg,578,17,166,183,259,293,True,31
a,81,kaist_dataset/Mixed/Digital_Camera/(C.S)C-outdoor4/DSC03519.JPG,char_data/a/DSC03519.JPG_0.jpg,6804,84,440,524,116,197,True,31
a,35,kaist_dataset/Mixed/Digital_Camera/(C.S)C-outdoor4/DSC03672.JPG,char_data/a/DSC03672.JPG_0.jpg,840,24,203,227,410,445,True,31
a,62,kaist_dataset/Mixed/Digital_Camera/(C.S)C-outdoor4/DSC03638.JPG,char_data/a/DSC03638.JPG_0.jpg,2666,43,419,462,120,182,True,31
a,53,kaist_dataset/Mixed/Digital_Camera/(C.S)C-outdoor4/DSC03643.JPG,char_data/a/DSC03643.JPG_0.jpg,2279,43,203,246,260,313,True,31
a,27,kaist_dataset/Mixed/Digital_Camera/(C.S)C-outdoor4/DSC03682.JPG,char_data/a/DSC03682.JPG_0.jpg,459,17,492,509,329,356,True,31
a,60,kaist_dataset/Mixed/Digital_Camera/(C.S)C-outdoor4/DSC03635.JPG,char_data/a/DSC03635.JPG_0.jpg,3000,50,422,472,171,231,True,31
a,44,kaist_dataset/Mixed/Digital_Camera/(C.S)C-outdoor4/DSC03571.JPG,char_data/a/DSC03571.JPG_0.jpg,968,22,537,559,300,344,True,31
a,34,kaist_dataset/Mixed/Digital_Camera/(C.S)C-outdoor4/DSC03556.JPG,char_data/a/DSC03556.JPG_0.jpg,374,11,158,169,319,353,True,31
a,29,kaist_dataset/Mixed/Digital_Camera/(C.S)C-outdoor4/DSC03556.JPG,char_data/a/DSC03556.JPG_0.jpg,319,11,255,266,319,348,True,31
a,25,kaist_dataset/Mixed/Digital_Camera/(C.S)C-outdoor4/DSC03556.JPG,char_data/a/DSC03556.JPG_0.jpg,275,11,489,500,326,351,True,31
a,28,kaist_dataset/Mixed/Digital_Camera/(C.S)C-outdoor4/DSC03556.JPG,char_data/a/DSC03556.JPG_0.jpg,336,12,614,626,325,353,True,31
a,27,kaist_dataset/Mixed/Digital_Camera/(C.S)C-outdoor4/DSC03670.JPG,char_data/a/DSC03670.JPG_0.jpg,378,14,255,269,323,350,True,31
a,25,kaist_dataset/Mixed/Digital_Camera/(C.S)C-outdoor4/DSC03670.JPG,char_data/a/DSC03670.JPG_0.jpg,375,15,463,478,319,344,True,31
a,23,kaist_dataset/Mixed/Digital_Camera/(C.S)C-outdoor4/DSC03670.JPG,char_data/a/DSC03670.JPG_0.jpg,368,16,503,519,321,344,True,31
a,34,kaist_dataset/Mixed/Digital_Camera/(C.S)C-outdoor4/DSC03586.JPG,char_data/a/DSC03586.JPG_0.jpg,680,20,149,169,157,191,True,31
a,36,kaist_dataset/Mixed/Digital_Camera/(C.S)C-outdoor4/DSC03586.JPG,char_data/a/DSC03586.JPG_0.jpg,828,23,325,348,160,196,True,31
a,24,kaist_dataset/Mixed/Digital_Camera/(C.S)C-outdoor2/DSC02421.JPG,char_data/a/DSC02421.JPG_0.jpg,528,22,106,128,215,239,True,31
a,22,kaist_dataset/Mixed/Digital_Camera/(C.S)C-outdoor2/DSC02421.JPG,char_data/a/DSC02421.JPG_0.jpg,374,17,301,318,215,237,True,31
a,16,kaist_dataset/Mixed/Digital_Camera/(C.S)C-outdoor2/DSC02421.JPG,char_data/a/DSC02421.JPG_0.jpg,336,21,456,477,213,229,True,31
a,66,kaist_dataset/Mixed/Digital_Camera/(C.S)C-outdoor2/DSC02418.JPG,char_data/a/DSC02418.JPG_0.jpg,3036,46,459,505,160,226,True,31
a,35,kaist_dataset/Mixed/Digital_Camera/(C.S)C-outdoor2/DSC02886.JPG,char_data/a/DSC02886.JPG_0.jpg,630,18,301,319,146,181,True,31
a,26,kaist_dataset/Mixed/Digital_Camera/(C.S)C-outdoor2/DSC02886.JPG,char_data/a/DSC02886.JPG_0.jpg,520,20,462,482,139,165,True,31
a,29,kaist_dataset/Mixed/Digital_Camera/(C.S)C-outdoor2/DSC02886.JPG,char_data/a/DSC02886.JPG_0.jpg,493,17,537,554,130,159,True,31
a,49,kaist_dataset/Mixed/Digital_Camera/(C.S)C-outdoor2/DSC02400.JPG,char_data/a/DSC02400.JPG_0.jpg,1715,35,500,535,324,373,True,31
a,34,kaist_dataset/Mixed/Digital_Camera/(C.S)C-outdoor2/DSC02927.JPG,char_data/a/DSC02927.JPG_0.jpg,544,16,290,306,368,402,True,31
a,23,kaist_dataset/Mixed/Digital_Camera/(C.S)C-outdoor2/DSC02385.JPG,char_data/a/DSC02385.JPG_0.jpg,483,21,546,567,137,160,True,31
a,51,kaist_dataset/Mixed/Digital_Camera/(C.S)C-outdoor2/DSC02382.JPG,char_data/a/DSC02382.JPG_0.jpg,1887,37,52,89,265,316,True,31
a,65,kaist_dataset/Mixed/Digital_Camera/(C.S)C-outdoor2/DSC02436.JPG,char_data/a/DSC02436.JPG_0.jpg,2535,39,193,232,185,250,True,31
a,68,kaist_dataset/Mixed/Digital_Camera/(C.S)C-outdoor2/DSC02436.JPG,char_data/a/DSC02436.JPG_0.jpg,2992,44,540,584,187,255,True,31
a,19,kaist_dataset/Mixed/Digital_Camera/(C.S)C-outdoor2/DSC02439.JPG,char_data/a/DSC02439.JPG_0.jpg,361,19,486,505,113,132,True,31
a,41,kaist_dataset/Mixed/Digital_Camera/(C.S)C-outdoor2/DSC02519.JPG,char_data/a/DSC02519.JPG_0.jpg,1476,36,364,400,217,258,True,31
a,31,kaist_dataset/Mixed/Digital_Camera/(C.S)C-outdoor2/DSC02545.JPG,char_data/a/DSC02545.JPG_0.jpg,713,23,327,350,369,400,True,31
a,52,kaist_dataset/Mixed/Digital_Camera/(C.S)C-outdoor2/DSC02433.JPG,char_data/a/DSC02433.JPG_0.jpg,2236,43,233,276,196,248,True,31
a,37,kaist_dataset/Mixed/Digital_Camera/(C.S)C-outdoor2/DSC02482.JPG,char_data/a/DSC02482.JPG_0.jpg,1147,31,66,97,272,309,True,31
a,73,kaist_dataset/Mixed/Digital_Camera/(C.S)C-outdoor2/DSC02425.JPG,char_data/a/DSC02425.JPG_0.jpg,4234,58,327,385,168,241,True,31
a,47,kaist_dataset/Mixed/Digital_Camera/(C.S)C-outdoor2/DSC02907.JPG,char_data/a/DSC02907.JPG_0.jpg,1880,40,362,402,97,144,True,31
a,51,kaist_dataset/Mixed/Digital_Camera/(C.S)C-outdoor2/DSC02936.JPG,char_data/a/DSC02936.JPG_0.jpg,2601,51,129,180,135,186,True,31
a,54,kaist_dataset/Mixed/Digital_Camera/(C.S)C-outdoor2/DSC02936.JPG,char_data/a/DSC02936.JPG_0.jpg,2646,49,254,303,137,191,True,31
a,42,kaist_dataset/Mixed/Digital_Camera/(C.S)C-outdoor2/DSC02926.JPG,char_data/a/DSC02926.JPG_0.jpg,1260,30,202,232,136,178,True,31
a,36,kaist_dataset/Mixed/Digital_Camera/(C.S)C-outdoor2/DSC02928.JPG,char_data/a/DSC02928.JPG_0.jpg,720,20,457,477,393,429,True,31
a,24,kaist_dataset/Mixed/Digital_Camera/(C.S)C-outdoor2/DSC02430.JPG,char_data/a/DSC02430.JPG_0.jpg,360,15,115,130,189,213,True,31
a,51,kaist_dataset/Mixed/Digital_Camera/(C.S)A-shadow/DSC03207.JPG,char_data/a/DSC03207.JPG_0.jpg,2142,42,324,366,208,259,True,31
a,86,kaist_dataset/English/Mobile_Phone/(E.M)A-outdoor/P090912059.jpg,char_data/a/P090912059.jpg_0.jpg,7310,85,363,448,159,245,True,31
a,61,kaist_dataset/English/Mobile_Phone/(E.M)A-outdoor/P090912072.jpg,char_data/a/P090912072.jpg_0.jpg,2135,35,69,104,28,89,True,31
a,59,kaist_dataset/English/Mobile_Phone/(E.M)A-outdoor/P090912072.jpg,char_data/a/P090912072.jpg_0.jpg,1947,33,127,160,34,93,True,31
a,60,kaist_dataset/English/Mobile_Phone/(E.M)A-outdoor/P090912072.jpg,char_data/a/P090912072.jpg_0.jpg,2460,41,256,297,37,97,True,31
a,108,kaist_dataset/English/Mobile_Phone/(E.M)A-outdoor/P090911070.jpg,char_data/a/P090911070.jpg_0.jpg,13176,122,130,252,158,266,True,31
a,66,kaist_dataset/English/Mobile_Phone/(E.M)B-indoor/P090831011.jpg,char_data/a/P090831011.jpg_0.jpg,2442,37,435,472,143,209,True,31
a,61,kaist_dataset/English/Mobile_Phone/(E.M)B-indoor/P090902018.jpg,char_data/a/P090902018.jpg_0.jpg,2135,35,430,465,193,254,True,31
a,118,kaist_dataset/English/Mobile_Phone/(E.M)B-indoor/P090903001.jpg,char_data/a/P090903001.jpg_0.jpg,14278,121,164,285,141,259,True,31
a,105,kaist_dataset/English/Mobile_Phone/(E.M)B-indoor/P090903005.jpg,char_data/a/P090903005.jpg_0.jpg,9765,93,245,338,194,299,True,31
a,59,kaist_dataset/English/Mobile_Phone/(E.M)B-indoor/P090911067.jpg,char_data/a/P090911067.jpg_0.jpg,1888,32,245,277,219,278,True,31
a,65,kaist_dataset/English/Mobile_Phone/(E.M)B-indoor/P090911081.jpg,char_data/a/P090911081.jpg_0.jpg,2730,42,269,311,227,292,True,31
a,81,kaist_dataset/English/Mobile_Phone/(E.M)B-indoor/P090903004.jpg,char_data/a/P090903004.jpg_0.jpg,6075,75,385,460,250,331,True,31
a,44,kaist_dataset/English/Mobile_Phone/(E.M)B-indoor/P090911060.jpg,char_data/a/P090911060.jpg_0.jpg,1408,32,403,435,25,69,True,31
a,53,kaist_dataset/English/Mobile_Phone/(E.M)B-indoor/P090903008.jpg,char_data/a/P090903008.jpg_0.jpg,2491,47,488,535,46,99,True,31
a,78,kaist_dataset/English/Mobile_Phone/(E.M)B-indoor/P090903007.jpg,char_data/a/P090903007.jpg_0.jpg,4758,61,67,128,259,337,True,31
a,104,kaist_dataset/English/Mobile_Phone/(E.M)C-bookCover/P090831077.jpg,char_data/a/P090831077.jpg_0.jpg,9776,94,235,329,92,196,True,31
a,92,kaist_dataset/English/Mobile_Phone/(E.M)C-bookCover/P090903054.jpg,char_data/a/P090903054.jpg_0.jpg,6716,73,95,168,225,317,True,31
a,119,kaist_dataset/English/Mobile_Phone/(E.M)C-bookCover/P090831022.jpg,char_data/a/P090831022.jpg_0.jpg,11662,98,363,461,156,275,True,31
a,41,kaist_dataset/English/Mobile_Phone/(E.M)C-bookCover/P090903030.jpg,char_data/a/P090903030.jpg_0.jpg,1107,27,65,92,81,122,True,31
a,39,kaist_dataset/English/Mobile_Phone/(E.M)C-bookCover/P090903030.jpg,char_data/a/P090903030.jpg_0.jpg,1053,27,289,316,75,114,True,31
a,40,kaist_dataset/English/Mobile_Phone/(E.M)C-bookCover/P090903030.jpg,char_data/a/P090903030.jpg_0.jpg,840,21,473,494,73,113,True,31
a,30,kaist_dataset/English/Mobile_Phone/(E.M)C-bookCover/P090903030.jpg,char_data/a/P090903030.jpg_0.jpg,870,29,538,567,77,107,True,31
a,82,kaist_dataset/English/Digital_Camera/(E.S)E-night/DSC02570.JPG,char_data/a/DSC02570.JPG_0.jpg,5248,64,382,446,252,334,True,31
a,119,kaist_dataset/English/Digital_Camera/(E.S)E-night/DSC02639.JPG,char_data/a/DSC02639.JPG_0.jpg,6307,53,192,245,218,337,True,31
a,118,kaist_dataset/English/Digital_Camera/(E.S)E-night/DSC02639.JPG,char_data/a/DSC02639.JPG_0.jpg,6844,58,305,363,223,341,True,31
a,117,kaist_dataset/English/Digital_Camera/(E.S)E-night/DSC02639.JPG,char_data/a/DSC02639.JPG_0.jpg,9009,77,418,495,224,341,True,31
a,74,kaist_dataset/English/Digital_Camera/(E.S)E-night/DSC02676.JPG,char_data/a/DSC02676.JPG_0.jpg,2886,39,66,105,216,290,True,31
a,97,kaist_dataset/English/Digital_Camera/(E.S)E-night/DSC02981.JPG,char_data/a/DSC02981.JPG_0.jpg,4559,47,376,423,27,124,True,31
a,48,kaist_dataset/English/Digital_Camera/(E.S)C-outdoor2/DSC02998.JPG,char_data/a/DSC02998.JPG_0.jpg,1536,32,256,288,421,469,True,31
a,35,kaist_dataset/English/Digital_Camera/(E.S)C-outdoor2/DSC04079.JPG,char_data/a/DSC04079.JPG_0.jpg,840,24,68,92,161,196,True,31
a,24,kaist_dataset/English/Digital_Camera/(E.S)C-outdoor2/DSC03208.JPG,char_data/a/DSC03208.JPG_0.jpg,432,18,333,351,170,194,True,31
a,38,kaist_dataset/English/Digital_Camera/(E.S)C-outdoor2/DSC03053.JPG,char_data/a/DSC03053.JPG_0.jpg,836,22,57,79,137,175,True,31
a,94,kaist_dataset/English/Digital_Camera/(E.S)C-outdoor2/DSC04430.JPG,char_data/a/DSC04430.JPG_0.jpg,8742,93,196,289,167,261,True,31
a,50,kaist_dataset/English/Digital_Camera/(E.S)C-outdoor2/DSC03277.JPG,char_data/a/DSC03277.JPG_0.jpg,2100,42,488,530,203,253,True,31
a,53,kaist_dataset/English/Digital_Camera/(E.S)C-outdoor2/DSC04160.JPG,char_data/a/DSC04160.JPG_0.jpg,2915,55,430,485,337,390,True,31
a,43,kaist_dataset/English/Digital_Camera/(E.S)C-outdoor2/DSC03166.JPG,char_data/a/DSC03166.JPG_0.jpg,1634,38,273,311,273,316,True,31
a,98,kaist_dataset/English/Digital_Camera/(E.S)C-outdoor2/DSC04397.JPG,char_data/a/DSC04397.JPG_0.jpg,8330,85,117,202,219,317,True,31
a,97,kaist_dataset/English/Digital_Camera/(E.S)C-outdoor2/DSC04397.JPG,char_data/a/DSC04397.JPG_0.jpg,7857,81,307,388,230,327,True,31
a,57,kaist_dataset/English/Digital_Camera/(E.S)C-outdoor2/DSC04397.JPG,char_data/a/DSC04397.JPG_0.jpg,2166,38,367,405,141,198,True,31
a,51,kaist_dataset/English/Digital_Camera/(E.S)C-outdoor2/DSC04052.JPG,char_data/a/DSC04052.JPG_0.jpg,1785,35,446,481,173,224,True,31
a,70,kaist_dataset/English/Digital_Camera/(E.S)C-outdoor2/DSC02990.JPG,char_data/a/DSC02990.JPG_0.jpg,4480,64,466,530,189,259,True,31
a,71,kaist_dataset/English/Digital_Camera/(E.S)C-outdoor2/DSC03436.JPG,char_data/a/DSC03436.JPG_0.jpg,4047,57,439,496,41,112,True,31
a,77,kaist_dataset/English/Digital_Camera/(E.S)C-outdoor2/DSC03281.JPG,char_data/a/DSC03281.JPG_0.jpg,4466,58,458,516,212,289,True,31
a,60,kaist_dataset/English/Digital_Camera/(E.S)C-outdoor2/DSC04251.JPG,char_data/a/DSC04251.JPG_0.jpg,2580,43,236,279,78,138,True,31
a,63,kaist_dataset/English/Digital_Camera/(E.S)C-outdoor2/DSC03229.JPG,char_data/a/DSC03229.JPG_0.jpg,3591,57,342,399,165,228,True,31
a,68,kaist_dataset/English/Digital_Camera/(E.S)C-outdoor2/DSC03229.JPG,char_data/a/DSC03229.JPG_0.jpg,4148,61,444,505,157,225,True,31
a,75,kaist_dataset/English/Digital_Camera/(E.S)C-outdoor2/DSC03229.JPG,char_data/a/DSC03229.JPG_0.jpg,2850,38,568,606,144,219,True,31
a,39,kaist_dataset/English/Digital_Camera/(E.S)C-outdoor2/DSC03290.JPG,char_data/a/DSC03290.JPG_0.jpg,1326,34,325,359,103,142,True,31
a,43,kaist_dataset/English/Digital_Camera/(E.S)C-outdoor2/DSC03290.JPG,char_data/a/DSC03290.JPG_0.jpg,1419,33,315,348,314,357,True,31
a,42,kaist_dataset/English/Digital_Camera/(E.S)C-outdoor2/DSC03865.JPG,char_data/a/DSC03865.JPG_0.jpg,1050,25,120,145,98,140,True,31
a,35,kaist_dataset/English/Digital_Camera/(E.S)C-outdoor2/DSC03865.JPG,char_data/a/DSC03865.JPG_0.jpg,945,27,191,218,106,141,True,31
a,33,kaist_dataset/English/Digital_Camera/(E.S)C-outdoor2/DSC03865.JPG,char_data/a/DSC03865.JPG_0.jpg,924,28,122,150,62,95,True,31
a,72,kaist_dataset/English/Digital_Camera/(E.S)C-outdoor2/DSC03276.JPG,char_data/a/DSC03276.JPG_0.jpg,4032,56,177,233,348,420,True,31
a,71,kaist_dataset/English/Digital_Camera/(E.S)C-outdoor2/DSC03276.JPG,char_data/a/DSC03276.JPG_0.jpg,4473,63,391,454,342,413,True,31
a,54,kaist_dataset/English/Digital_Camera/(E.S)C-outdoor2/DSC03001.JPG,char_data/a/DSC03001.JPG_0.jpg,2052,38,335,373,189,243,True,31
a,124,kaist_dataset/English/Digital_Camera/(E.S)C-outdoor2/DSC04458.JPG,char_data/a/DSC04458.JPG_0.jpg,10788,87,135,222,297,421,True,31
a,55,kaist_dataset/English/Digital_Camera/(E.S)C-outdoor2/DSC03412.JPG,char_data/a/DSC03412.JPG_0.jpg,2090,38,327,365,146,201,True,31
a,51,kaist_dataset/English/Digital_Camera/(E.S)C-outdoor2/DSC03201.JPG,char_data/a/DSC03201.JPG_0.jpg,1428,28,251,279,83,134,True,31
a,53,kaist_dataset/English/Digital_Camera/(E.S)C-outdoor2/DSC03201.JPG,char_data/a/DSC03201.JPG_0.jpg,1537,29,375,404,83,136,True,31
a,40,kaist_dataset/English/Digital_Camera/(E.S)C-outdoor2/DSC04064.JPG,char_data/a/DSC04064.JPG_0.jpg,1040,26,243,269,137,177,True,31
a,43,kaist_dataset/English/Digital_Camera/(E.S)C-outdoor2/DSC04064.JPG,char_data/a/DSC04064.JPG_0.jpg,1075,25,438,463,139,182,True,31
a,46,kaist_dataset/English/Digital_Camera/(E.S)C-outdoor2/DSC03192.JPG,char_data/a/DSC03192.JPG_0.jpg,1932,42,276,318,171,217,True,31
a,50,kaist_dataset/English/Digital_Camera/(E.S)C-outdoor2/DSC03765.JPG,char_data/a/DSC03765.JPG_0.jpg,1700,34,223,257,93,143,True,31
a,51,kaist_dataset/English/Digital_Camera/(E.S)C-outdoor2/DSC03765.JPG,char_data/a/DSC03765.JPG_0.jpg,1734,34,319,353,88,139,True,31
a,64,kaist_dataset/English/Digital_Camera/(E.S)C-outdoor2/DSC03413.JPG,char_data/a/DSC03413.JPG_0.jpg,3328,52,321,373,130,194,True,31
a,55,kaist_dataset/English/Digital_Camera/(E.S)C-outdoor2/DSC04163.JPG,char_data/a/DSC04163.JPG_0.jpg,2035,37,306,343,261,316,True,31
a,44,kaist_dataset/English/Digital_Camera/(E.S)C-outdoor2/DSC04035.JPG,char_data/a/DSC04035.JPG_0.jpg,1276,29,258,287,200,244,True,31
a,66,kaist_dataset/English/Digital_Camera/(E.S)C-outdoor2/DSC03731.JPG,char_data/a/DSC03731.JPG_0.jpg,3828,58,252,310,51,117,True,31
a,36,kaist_dataset/English/Digital_Camera/(E.S)C-outdoor2/DSC03160.JPG,char_data/a/DSC03160.JPG_0.jpg,828,23,433,456,150,186,True,31
a,37,kaist_dataset/English/Digital_Camera/(E.S)C-outdoor2/DSC03160.JPG,char_data/a/DSC03160.JPG_0.jpg,925,25,477,502,146,183,True,31
a,50,kaist_dataset/English/Digital_Camera/(E.S)C-outdoor2/DSC03440.JPG,char_data/a/DSC03440.JPG_0.jpg,1750,35,257,292,141,191,True,31
a,41,kaist_dataset/English/Digital_Camera/(E.S)C-outdoor2/DSC03440.JPG,char_data/a/DSC03440.JPG_0.jpg,1148,28,376,404,151,192,True,31
a,39,kaist_dataset/English/Digital_Camera/(E.S)C-outdoor2/DSC03170.JPG,char_data/a/DSC03170.JPG_0.jpg,1677,43,368,411,324,363,True,31
a,26,kaist_dataset/English/Digital_Camera/(E.S)C-outdoor2/DSC04437.JPG,char_data/a/DSC04437.JPG_0.jpg,338,13,208,221,77,103,True,31
a,48,kaist_dataset/English/Digital_Camera/(E.S)C-outdoor2/P1010057.JPG,char_data/a/P1010057.JPG_0.jpg,1152,24,184,208,201,249,True,31
a,36,kaist_dataset/English/Digital_Camera/(E.S)C-outdoor2/P1010057.JPG,char_data/a/P1010057.JPG_0.jpg,828,23,357,380,207,243,True,31
a,73,kaist_dataset/English/Digital_Camera/(E.S)C-outdoor1/DSC02524.JPG,char_data/a/DSC02524.JPG_0.jpg,3796,52,103,155,327,400,True,31
a,43,kaist_dataset/English/Digital_Camera/(E.S)C-outdoor1/DSC02356.JPG,char_data/a/DSC02356.JPG_0.jpg,731,17,69,86,307,350,True,31
a,37,kaist_dataset/English/Digital_Camera/(E.S)C-outdoor1/DSC02356.JPG,char_data/a/DSC02356.JPG_0.jpg,814,22,142,164,308,345,True,31
a,31,kaist_dataset/English/Digital_Camera/(E.S)C-outdoor1/DSC02356.JPG,char_data/a/DSC02356.JPG_0.jpg,558,18,236,254,311,342,True,31
a,36,kaist_dataset/English/Digital_Camera/(E.S)C-outdoor1/DSC02356.JPG,char_data/a/DSC02356.JPG_0.jpg,756,21,555,576,314,350,True,31
a,29,kaist_dataset/English/Digital_Camera/(E.S)C-outdoor1/DSC02427.JPG,char_data/a/DSC02427.JPG_0.jpg,609,21,362,383,371,400,True,31
a,56,kaist_dataset/English/Digital_Camera/(E.S)C-outdoor1/DSC02514.JPG,char_data/a/DSC02514.JPG_0.jpg,1960,35,353,388,188,244,True,31
a,41,kaist_dataset/English/Digital_Camera/(E.S)C-outdoor1/1.jpg,char_data/a/1.jpg_0.jpg,1517,37,405,442,142,183,True,31
a,107,kaist_dataset/English/Digital_Camera/(E.S)C-outdoor1/DSC02914.JPG,char_data/a/DSC02914.JPG_0.jpg,5671,53,127,180,183,290,True,31
a,49,kaist_dataset/English/Digital_Camera/(E.S)C-outdoor1/DSC02480.JPG,char_data/a/DSC02480.JPG_0.jpg,1421,29,235,264,119,168,True,31
a,39,kaist_dataset/English/Digital_Camera/(E.S)C-outdoor1/DSC02480.JPG,char_data/a/DSC02480.JPG_0.jpg,1014,26,154,180,412,451,True,31
a,18,kaist_dataset/English/Digital_Camera/(E.S)C-outdoor1/056.JPG,char_data/a/056.JPG_0.jpg,198,11,128,139,246,264,True,31
a,62,kaist_dataset/English/Digital_Camera/(E.S)C-outdoor1/056.JPG,char_data/a/056.JPG_0.jpg,3410,55,151,206,178,240,True,31
a,62,kaist_dataset/English/Digital_Camera/(E.S)C-outdoor1/056.JPG,char_data/a/056.JPG_0.jpg,3286,53,263,316,177,239,True,31
a,13,kaist_dataset/English/Digital_Camera/(E.S)C-outdoor1/7.jpg,char_data/a/7.jpg_0.jpg,130,10,214,224,108,121,True,31
a,181,kaist_dataset/English/Digital_Camera/(E.S)C-outdoor1/080119-0036.jpg,char_data/a/080119-0036.jpg_0.jpg,21177,117,1164,1281,367,548,True,31
a,33,kaist_dataset/English/Digital_Camera/(E.S)C-outdoor1/065.jpg,char_data/a/065.jpg_0.jpg,594,18,85,103,165,198,True,31
a,29,kaist_dataset/English/Digital_Camera/(E.S)C-outdoor1/065.jpg,char_data/a/065.jpg_0.jpg,319,11,159,170,170,199,True,31
a,26,kaist_dataset/English/Digital_Camera/(E.S)C-outdoor1/065.jpg,char_data/a/065.jpg_0.jpg,364,14,185,199,174,200,True,31
a,35,kaist_dataset/English/Digital_Camera/(E.S)C-outdoor1/065.jpg,char_data/a/065.jpg_0.jpg,770,22,341,363,150,185,True,31
a,33,kaist_dataset/English/Digital_Camera/(E.S)C-outdoor1/065.jpg,char_data/a/065.jpg_0.jpg,627,19,423,442,155,188,True,31
a,36,kaist_dataset/English/Digital_Camera/(E.S)C-outdoor1/065.jpg,char_data/a/065.jpg_0.jpg,936,26,456,482,150,186,True,31
a,43,kaist_dataset/English/Digital_Camera/(E.S)C-outdoor1/DSC02355.JPG,char_data/a/DSC02355.JPG_0.jpg,946,22,69,91,304,347,True,31
a,35,kaist_dataset/English/Digital_Camera/(E.S)C-outdoor1/DSC02355.JPG,char_data/a/DSC02355.JPG_0.jpg,665,19,235,254,310,345,True,31
a,116,kaist_dataset/English/Digital_Camera/(E.S)C-outdoor1/100.JPG,char_data/a/100.JPG_0.jpg,11252,97,468,565,71,187,True,31
a,44,kaist_dataset/English/Digital_Camera/(E.S)C-outdoor1/080119-0012.jpg,char_data/a/080119-0012.jpg_0.jpg,2684,61,967,1028,564,608,True,31
a,67,kaist_dataset/English/Digital_Camera/(E.S)C-outdoor1/027.jpg,char_data/a/027.jpg_0.jpg,2881,43,300,343,105,172,True,31
a,69,kaist_dataset/English/Digital_Camera/(E.S)C-outdoor1/2007-12-08-day-111.jpg,char_data/a/2007-12-08-day-111.jpg_0.jpg,4761,69,958,1027,513,582,True,31
a,133,kaist_dataset/English/Digital_Camera/(E.S)C-outdoor1/2007-12-08-day-015.jpg,char_data/a/2007-12-08-day-015.jpg_0.jpg,24206,182,369,551,500,633,True,31
a,139,kaist_dataset/English/Digital_Camera/(E.S)C-outdoor1/2007-12-08-day-015.jpg,char_data/a/2007-12-08-day-015.jpg_0.jpg,27244,196,1089,1285,651,790,True,31
a,37,kaist_dataset/English/Digital_Camera/(E.S)C-outdoor1/2007-12-08-day-015.jpg,char_data/a/2007-12-08-day-015.jpg_0.jpg,1110,30,838,868,819,856,True,31
a,34,kaist_dataset/English/Digital_Camera/(E.S)C-outdoor1/2007-12-09-day-exterior-063.jpg,char_data/a/2007-12-09-day-exterior-063.jpg_0.jpg,714,21,14,35,533,567,True,31
a,34,kaist_dataset/English/Digital_Camera/(E.S)C-outdoor1/DSC02417.JPG,char_data/a/DSC02417.JPG_0.jpg,646,19,481,500,136,170,True,31
a,25,kaist_dataset/English/Digital_Camera/(E.S)C-outdoor1/DSC02417.JPG,char_data/a/DSC02417.JPG_0.jpg,425,17,534,551,142,167,True,31
a,23,kaist_dataset/English/Digital_Camera/(E.S)C-outdoor1/DSC02417.JPG,char_data/a/DSC02417.JPG_0.jpg,345,15,522,537,183,206,True,31
a,48,kaist_dataset/English/Digital_Camera/(E.S)C-outdoor1/031.JPG,char_data/a/031.JPG_0.jpg,1920,40,421,461,201,249,True,31
a,215,kaist_dataset/English/Digital_Camera/(E.S)C-outdoor1/080119-0035.jpg,char_data/a/080119-0035.jpg_0.jpg,30745,143,906,1049,787,1002,True,31
a,146,kaist_dataset/English/Digital_Camera/(E.S)C-outdoor1/2007-12-08-day-098.jpg,char_data/a/2007-12-08-day-098.jpg_0.jpg,14892,102,225,327,519,665,True,31
a,53,kaist_dataset/English/Digital_Camera/(E.S)C-outdoor1/076.JPG,char_data/a/076.JPG_0.jpg,2014,38,537,575,214,267,True,31
a,16,kaist_dataset/English/Digital_Camera/(E.S)C-outdoor1/076.JPG,char_data/a/076.JPG_0.jpg,80,5,624,629,321,337,True,31
a,41,kaist_dataset/English/Digital_Camera/(E.S)C-outdoor1/DSC02868.JPG,char_data/a/DSC02868.JPG_0.jpg,779,19,271,290,402,443,True,31
a,37,kaist_dataset/English/Digital_Camera/(E.S)C-outdoor1/DSC02918.JPG,char_data/a/DSC02918.JPG_0.jpg,1073,29,357,386,185,222,True,31
a,73,kaist_dataset/English/Digital_Camera/(E.S)C-outdoor1/DSC02491.JPG,char_data/a/DSC02491.JPG_0.jpg,4161,57,348,405,139,212,True,31
a,67,kaist_dataset/English/Digital_Camera/(E.S)C-outdoor1/DSC02491.JPG,char_data/a/DSC02491.JPG_0.jpg,3752,56,328,384,59,126,False,31
a,73,kaist_dataset/English/Digital_Camera/(E.S)C-outdoor1/104.jpg,char_data/a/104.jpg_0.jpg,4745,65,70,135,122,195,False,31
a,75,kaist_dataset/English/Digital_Camera/(E.S)C-outdoor1/104.jpg,char_data/a/104.jpg_0.jpg,3975,53,320,373,121,196,False,31
a,32,kaist_dataset/English/Digital_Camera/(E.S)C-outdoor1/DSC02352.JPG,char_data/a/DSC02352.JPG_0.jpg,736,23,441,464,325,357,False,31
a,28,kaist_dataset/English/Digital_Camera/(E.S)C-outdoor1/DSC02352.JPG,char_data/a/DSC02352.JPG_0.jpg,532,19,504,523,326,354,False,31
a,27,kaist_dataset/English/Digital_Camera/(E.S)B-light/크기변환_%B0%A3%C6%C74_fabdent.jpg,char_data/a/크기변환_%B0%A3%C6%C74_fabdent.jpg_0.jpg,567,21,334,355,257,284,False,31
a,71,kaist_dataset/English/Digital_Camera/(E.S)B-light/DSC02980.JPG,char_data/a/DSC02980.JPG_0.jpg,5538,78,292,370,77,148,False,31
a,79,kaist_dataset/English/Digital_Camera/(E.S)B-light/DSC02980.JPG,char_data/a/DSC02980.JPG_0.jpg,5530,70,472,542,92,171,False,31
a,53,kaist_dataset/English/Digital_Camera/(E.S)F-others/080119-0007.jpg,char_data/a/080119-0007.jpg_0.jpg,2173,41,886,927,749,802,False,31
a,52,kaist_dataset/English/Digital_Camera/(E.S)F-others/080119-0007.jpg,char_data/a/080119-0007.jpg_0.jpg,2028,39,1068,1107,711,763,False,31
a,40,kaist_dataset/English/Digital_Camera/(E.S)F-others/080116-0058.jpg,char_data/a/080116-0058.jpg_0.jpg,1040,26,52,78,635,675,False,31
a,26,kaist_dataset/English/Digital_Camera/(E.S)F-others/크기변환_%C4%BF%C7%C7%B5%B9%C3%E2%B0%A3%C6%C7_%281%29_alto99kr.jpg,char_data/a/크기변환_%C4%BF%C7%C7%B5%B9%C3%E2%B0%A3%C6%C7_%281%29_alto99kr.jpg_0.jpg,624,24,330,354,204,230,False,31
a,25,kaist_dataset/English/Digital_Camera/(E.S)F-others/크기변환_%C4%BF%C7%C7%B5%B9%C3%E2%B0%A3%C6%C7_%281%29_alto99kr.jpg,char_data/a/크기변환_%C4%BF%C7%C7%B5%B9%C3%E2%B0%A3%C6%C7_%281%29_alto99kr.jpg_0.jpg,625,25,432,457,203,228,False,31
a,84,kaist_dataset/English/Digital_Camera/(E.S)F-others/DSC02925.JPG,char_data/a/DSC02925.JPG_0.jpg,5292,63,455,518,221,305,False,31
a,43,kaist_dataset/English/Digital_Camera/(E.S)A-shadow/DSC03075.JPG,char_data/a/DSC03075.JPG_0.jpg,989,23,412,435,357,400,False,31
a,41,kaist_dataset/English/Digital_Camera/(E.S)A-shadow/DSC03082.JPG,char_data/a/DSC03082.JPG_0.jpg,779,19,253,272,384,425,False,31
a,39,kaist_dataset/English/Digital_Camera/(E.S)A-shadow/DSC03082.JPG,char_data/a/DSC03082.JPG_0.jpg,858,22,404,426,384,423,False,31
a,77,kaist_dataset/English/Digital_Camera/(E.S)A-shadow/DSC02858.JPG,char_data/a/DSC02858.JPG_0.jpg,3773,49,62,111,311,388,False,31
a,77,kaist_dataset/English/Digital_Camera/(E.S)A-shadow/DSC02858.JPG,char_data/a/DSC02858.JPG_0.jpg,3773,49,417,466,319,396,False,31
a,53,kaist_dataset/English/Digital_Camera/(E.S)A-shadow/DSC03026.JPG,char_data/a/DSC03026.JPG_0.jpg,2279,43,130,173,163,216,False,31
a,47,kaist_dataset/English/Digital_Camera/(E.S)A-shadow/DSC03026.JPG,char_data/a/DSC03026.JPG_0.jpg,1927,41,274,315,164,211,False,31
a,67,kaist_dataset/English/Digital_Camera/(E.S)A-shadow/DSC02857.JPG,char_data/a/DSC02857.JPG_0.jpg,2747,41,138,179,210,277,False,31
a,69,kaist_dataset/English/Digital_Camera/(E.S)A-shadow/DSC02857.JPG,char_data/a/DSC02857.JPG_0.jpg,3105,45,448,493,211,280,False,31
a,55,kaist_dataset/English/Digital_Camera/(E.S)A-shadow/P090912074.jpg,char_data/a/P090912074.jpg_0.jpg,1595,29,432,461,83,138,False,31
a,56,kaist_dataset/English/Digital_Camera/(E.S)A-shadow/DSC03084.JPG,char_data/a/DSC03084.JPG_0.jpg,1176,21,165,186,372,428,False,31
a,54,kaist_dataset/English/Digital_Camera/(E.S)A-shadow/IMG_2647.JPG,char_data/a/IMG_2647.JPG_0.jpg,2376,44,208,252,259,313,False,31
a,51,kaist_dataset/English/Digital_Camera/(E.S)A-shadow/IMG_2647.JPG,char_data/a/IMG_2647.JPG_0.jpg,2040,40,227,267,187,238,False,31
a,59,kaist_dataset/English/Digital_Camera/(E.S)A-shadow/IMG_2647.JPG,char_data/a/IMG_2647.JPG_0.jpg,2478,42,286,328,103,162,False,31
a,46,kaist_dataset/English/Digital_Camera/(E.S)D-indoor/DSC02862.JPG,char_data/a/DSC02862.JPG_0.jpg,2438,53,291,344,259,305,False,31
a,53,kaist_dataset/English/Digital_Camera/(E.S)D-indoor/DSC03093.JPG,char_data/a/DSC03093.JPG_0.jpg,2226,42,522,564,138,191,False,31
a,47,kaist_dataset/English/Digital_Camera/(E.S)D-indoor/DSC03093.JPG,char_data/a/DSC03093.JPG_0.jpg,1316,28,325,353,210,257,False,31
a,34,kaist_dataset/English/Digital_Camera/(E.S)D-indoor/DSC03144.JPG,char_data/a/DSC03144.JPG_0.jpg,816,24,392,416,292,326,False,31
a,56,kaist_dataset/English/Digital_Camera/(E.S)D-indoor/DSC03136.JPG,char_data/a/DSC03136.JPG_0.jpg,2184,39,504,543,265,321,False,31
a,46,kaist_dataset/English/Digital_Camera/(E.S)D-indoor/DSC03150.JPG,char_data/a/DSC03150.JPG_0.jpg,1702,37,188,225,38,84,False,31
a,52,kaist_dataset/English/Digital_Camera/(E.S)D-indoor/DSC03150.JPG,char_data/a/DSC03150.JPG_0.jpg,1612,31,464,495,22,74,False,31
a,40,kaist_dataset/English/Digital_Camera/(E.S)D-indoor/DSC03083.JPG,char_data/a/DSC03083.JPG_0.jpg,1040,26,410,436,405,445,False,31
a,40,kaist_dataset/English/Digital_Camera/(E.S)D-indoor/DSC03146.JPG,char_data/a/DSC03146.JPG_0.jpg,1000,25,331,356,173,213,False,31
a,77,kaist_dataset/English/Digital_Camera/(E.S)D-indoor/DSC02853.JPG,char_data/a/DSC02853.JPG_0.jpg,3311,43,324,367,139,216,False,31
a,46,kaist_dataset/English/Digital_Camera/(E.S)D-indoor/DSC03345.JPG,char_data/a/DSC03345.JPG_0.jpg,1610,35,135,170,104,150,False,31
a,42,kaist_dataset/English/Digital_Camera/(E.S)D-indoor/DSC03345.JPG,char_data/a/DSC03345.JPG_0.jpg,1470,35,492,527,105,147,False,31
a,38,kaist_dataset/English/Digital_Camera/(E.S)D-indoor/DSC03149.JPG,char_data/a/DSC03149.JPG_0.jpg,988,26,145,171,387,425,False,31
a,41,kaist_dataset/English/Digital_Camera/(E.S)D-indoor/DSC03149.JPG,char_data/a/DSC03149.JPG_0.jpg,1271,31,566,597,396,437,False,31
a,103,kaist_dataset/English/Digital_Camera/(E.S)D-indoor/DSC03398.JPG,char_data/a/DSC03398.JPG_0.jpg,9888,96,121,217,315,418,False,31
a,99,kaist_dataset/English/Digital_Camera/(E.S)D-indoor/DSC03398.JPG,char_data/a/DSC03398.JPG_0.jpg,8712,88,422,510,329,428,False,31
a,31,kaist_dataset/English/Digital_Camera/(E.S)D-indoor/DSC03147.JPG,char_data/a/DSC03147.JPG_0.jpg,775,25,306,331,299,330,False,31
a,29,kaist_dataset/English/Digital_Camera/(E.S)D-indoor/DSC03147.JPG,char_data/a/DSC03147.JPG_0.jpg,725,25,406,431,297,326,False,31
a,41,kaist_dataset/English/Digital_Camera/(E.S)D-indoor/DSC03147.JPG,char_data/a/DSC03147.JPG_0.jpg,1025,25,312,337,233,274,False,31
a,39,kaist_dataset/English/Digital_Camera/(E.S)D-indoor/DSC03142.JPG,char_data/a/DSC03142.JPG_0.jpg,1170,30,260,290,428,467,False,31
a,31,kaist_dataset/English/Digital_Camera/(E.S)D-indoor/DSC03142.JPG,char_data/a/DSC03142.JPG_0.jpg,837,27,390,417,371,402,False,31
a,81,kaist_dataset/English/Digital_Camera/(E.S)D-indoor/DSC03918.JPG,char_data/a/DSC03918.JPG_0.jpg,6318,78,133,211,288,369,False,31
a,92,kaist_dataset/English/Digital_Camera/(E.S)D-indoor/DSC03918.JPG,char_data/a/DSC03918.JPG_0.jpg,6072,66,354,420,274,366,False,31
a,83,kaist_dataset/English/Digital_Camera/(E.S)D-indoor/DSC04023.JPG,char_data/a/DSC04023.JPG_0.jpg,3735,45,223,268,208,291,False,31
a,83,kaist_dataset/English/Digital_Camera/(E.S)D-indoor/DSC04023.JPG,char_data/a/DSC04023.JPG_0.jpg,3320,40,268,308,215,298,False,31
a,50,kaist_dataset/English/Digital_Camera/(E.S)D-indoor/DSC04023.JPG,char_data/a/DSC04023.JPG_0.jpg,3100,62,471,533,255,305,False,31
a,37,kaist_dataset/English/Digital_Camera/(E.S)D-indoor/DSC04023.JPG,char_data/a/DSC04023.JPG_0.jpg,925,25,169,194,307,344,False,31
a,55,kaist_dataset/English/Digital_Camera/(E.S)D-indoor/DSC03074.JPG,char_data/a/DSC03074.JPG_0.jpg,1100,20,311,331,267,322,False,31
a,64,kaist_dataset/English/Digital_Camera/(E.S)D-indoor/DSC03074.JPG,char_data/a/DSC03074.JPG_0.jpg,1344,21,353,374,259,323,False,31
a,49,kaist_dataset/English/Digital_Camera/(E.S)D-indoor/DSC03376.JPG,char_data/a/DSC03376.JPG_0.jpg,1617,33,232,265,403,452,False,31
a,63,kaist_dataset/English/Digital_Camera/(E.S)D-indoor/DSC02719.JPG,char_data/a/DSC02719.JPG_0.jpg,2016,32,459,491,286,349,False,31
a,56,kaist_dataset/English/Digital_Camera/(E.S)D-indoor/DSC03091.JPG,char_data/a/DSC03091.JPG_0.jpg,2072,37,322,359,130,186,False,31
a,37,kaist_dataset/English/Digital_Camera/(E.S)D-indoor/DSC03947.JPG,char_data/a/DSC03947.JPG_0.jpg,1110,30,374,404,429,466,False,31
a,49,kaist_dataset/English/Digital_Camera/(E.S)D-indoor/DSC03936.JPG,char_data/a/DSC03936.JPG_0.jpg,1470,30,367,397,90,139,False,31
a,40,kaist_dataset/English/Digital_Camera/(E.S)D-indoor/DSC03936.JPG,char_data/a/DSC03936.JPG_0.jpg,1040,26,484,510,171,211,False,31
a,28,kaist_dataset/English/Digital_Camera/(E.S)D-indoor/DSC03145.JPG,char_data/a/DSC03145.JPG_0.jpg,644,23,237,260,184,212,False,31
a,35,kaist_dataset/English/Digital_Camera/(E.S)D-indoor/DSC03145.JPG,char_data/a/DSC03145.JPG_0.jpg,945,27,282,309,178,213,False,31
a,27,kaist_dataset/English/Digital_Camera/(E.S)D-indoor/DSC03145.JPG,char_data/a/DSC03145.JPG_0.jpg,648,24,240,264,128,155,False,31
a,44,kaist_dataset/English/Digital_Camera/(E.S)D-indoor/DSC03151.JPG,char_data/a/DSC03151.JPG_0.jpg,1408,32,209,241,116,160,False,31
a,41,kaist_dataset/English/Digital_Camera/(E.S)D-indoor/DSC03151.JPG,char_data/a/DSC03151.JPG_0.jpg,1353,33,339,372,110,151,False,31
a,40,kaist_dataset/English/Digital_Camera/(E.S)D-indoor/DSC03151.JPG,char_data/a/DSC03151.JPG_0.jpg,1200,30,495,525,114,154,False,31
a,56,kaist_dataset/English/Digital_Camera/(E.S)D-indoor/DSC03078.JPG,char_data/a/DSC03078.JPG_0.jpg,2016,36,339,375,305,361,False,31
a,45,kaist_dataset/English/Digital_Camera/(E.S)D-indoor/080119-0009.jpg,char_data/a/080119-0009.jpg_0.jpg,1215,27,1522,1549,169,214,False,31
a,55,kaist_dataset/English/Digital_Camera/(E.S)D-indoor/080119-0009.jpg,char_data/a/080119-0009.jpg_0.jpg,1430,26,1573,1599,171,226,False,31
a,40,kaist_dataset/English/Digital_Camera/(E.S)D-indoor/080119-0009.jpg,char_data/a/080119-0009.jpg_0.jpg,1440,36,722,758,671,711,False,31
a,36,kaist_dataset/English/Digital_Camera/(E.S)D-indoor/080119-0009.jpg,char_data/a/080119-0009.jpg_0.jpg,1080,30,1075,1105,697,733,False,31
a,34,kaist_dataset/English/Digital_Camera/(E.S)D-indoor/080119-0009.jpg,char_data/a/080119-0009.jpg_0.jpg,544,16,583,599,1012,1046,False,31
a,32,kaist_dataset/English/Digital_Camera/(E.S)D-indoor/080119-0009.jpg,char_data/a/080119-0009.jpg_0.jpg,704,22,816,838,1077,1109,False,31
a,37,kaist_dataset/English/Digital_Camera/(E.S)D-indoor/080119-0009.jpg,char_data/a/080119-0009.jpg_0.jpg,1147,31,879,910,1084,1121,False,31
a,49,kaist_dataset/English/Digital_Camera/(E.S)D-indoor/080119-0009.jpg,char_data/a/080119-0009.jpg_0.jpg,1323,27,1522,1549,92,141,False,31
a,43,kaist_dataset/English/Digital_Camera/(E.S)D-indoor/DSC03532.JPG,char_data/a/DSC03532.JPG_0.jpg,1720,40,472,512,432,475,False,31
a,34,kaist_dataset/English/Digital_Camera/(E.S)D-indoor/DSC03532.JPG,char_data/a/DSC03532.JPG_0.jpg,612,18,118,136,379,413,False,31
a,28,kaist_dataset/English/Digital_Camera/(E.S)D-indoor/DSC03532.JPG,char_data/a/DSC03532.JPG_0.jpg,476,17,267,284,385,413,False,31
a,23,kaist_dataset/English/Digital_Camera/(E.S)D-indoor/DSC03532.JPG,char_data/a/DSC03532.JPG_0.jpg,460,20,417,437,386,409,False,31
a,25,kaist_dataset/English/Digital_Camera/(E.S)D-indoor/DSC03532.JPG,char_data/a/DSC03532.JPG_0.jpg,400,16,566,582,380,405,False,31
a,39,kaist_dataset/English/Digital_Camera/(E.S)D-indoor/DSC03396.JPG,char_data/a/DSC03396.JPG_0.jpg,1053,27,415,442,348,387,False,31
a,36,kaist_dataset/English/Digital_Camera/(E.S)D-indoor/DSC03112.JPG,char_data/a/DSC03112.JPG_0.jpg,900,25,306,331,211,247,False,31
a,58,kaist_dataset/English/Digital_Camera/(E.S)C-outdoor3/크기변환_%B0%A3%C6%C71_fabdent.jpg,char_data/a/크기변환_%B0%A3%C6%C71_fabdent.jpg_0.jpg,2262,39,90,129,256,314,False,31
a,59,kaist_dataset/English/Digital_Camera/(E.S)C-outdoor3/크기변환_%B0%A3%C6%C71_fabdent.jpg,char_data/a/크기변환_%B0%A3%C6%C71_fabdent.jpg_0.jpg,2301,39,347,386,249,308,False,31
a,57,kaist_dataset/English/Digital_Camera/(E.S)C-outdoor3/크기변환_%B0%A3%C6%C71_fabdent.jpg,char_data/a/크기변환_%B0%A3%C6%C71_fabdent.jpg_0.jpg,2565,45,536,581,242,299,False,31
a,42,kaist_dataset/English/Digital_Camera/(E.S)C-outdoor3/DSC03038.JPG,char_data/a/DSC03038.JPG_0.jpg,924,22,147,169,330,372,False,31
a,64,kaist_dataset/English/Digital_Camera/(E.S)C-outdoor3/P1010086.JPG,char_data/a/P1010086.JPG_0.jpg,3520,55,177,232,87,151,False,31
a,14,kaist_dataset/English/Digital_Camera/(E.S)C-outdoor3/크기변환_P1010076.JPG,char_data/a/크기변환_P1010076.JPG_0.jpg,210,15,243,258,109,123,False,31
a,11,kaist_dataset/English/Digital_Camera/(E.S)C-outdoor3/크기변환_P1010076.JPG,char_data/a/크기변환_P1010076.JPG_0.jpg,121,11,221,232,111,122,False,31
3,45,"kaist_dataset/Korean/Mobile_Phone/(M,K)E-bookCover/P090831033.jpg",char_data/3/P090831033.jpg_2.jpg,1260,28,238,266,409,454,True,5
3,103,"kaist_dataset/Korean/Mobile_Phone/(M,K)E-bookCover/P090831035.jpg",char_data/3/P090831035.jpg_2.jpg,4223,41,12,53,32,135,True,5
3,128,"kaist_dataset/Korean/Mobile_Phone/(M,K)E-bookCover/P090911010.jpg",char_data/3/P090911010.jpg_2.jpg,13440,105,361,466,130,258,True,5
3,36,"kaist_dataset/Korean/Mobile_Phone/(M,K)C-outdoor/P090912042.jpg",char_data/3/P090912042.jpg_6.jpg,540,15,404,419,248,284,True,5
3,36,"kaist_dataset/Korean/Mobile_Phone/(M,K)C-outdoor/P090912042.jpg",char_data/3/P090912042.jpg_6.jpg,468,13,418,431,249,285,True,5
3,31,"kaist_dataset/Korean/Mobile_Phone/(M,K)C-outdoor/P090912042.jpg",char_data/3/P090912042.jpg_6.jpg,496,16,448,464,250,281,True,5
3,56,"kaist_dataset/Korean/Mobile_Phone/(M,K)C-outdoor/P090912033.jpg",char_data/3/P090912033.jpg_2.jpg,2128,38,338,376,353,409,True,5
3,48,"kaist_dataset/Korean/Mobile_Phone/(M,K)C-outdoor/P090912034.jpg",char_data/3/P090912034.jpg_2.jpg,1104,23,262,285,257,305,True,5
3,122,kaist_dataset/Korean/Digital_Camera/F-bookCover/DSC02827.JPG,char_data/3/DSC02827.JPG_2.jpg,11956,98,90,188,293,415,True,5
3,90,kaist_dataset/Korean/Digital_Camera/F-bookCover/DSC02833.JPG,char_data/3/DSC02833.JPG_2.jpg,4140,46,203,249,46,136,True,5
3,101,kaist_dataset/Korean/Digital_Camera/F-bookCover/DSC02835.JPG,char_data/3/DSC02835.JPG_2.jpg,6666,66,172,238,15,116,True,5
3,109,kaist_dataset/Korean/Digital_Camera/F-bookCover/DSC02832.JPG,char_data/3/DSC02832.JPG_2.jpg,6649,61,205,266,22,131,True,5
3,185,kaist_dataset/Korean/Digital_Camera/F-bookCover/P090911043.jpg,char_data/3/P090911043.jpg_2.jpg,17760,96,85,181,143,328,True,5
3,72,kaist_dataset/Korean/Digital_Camera/outdoor5/DSC03790.JPG,char_data/3/DSC03790.JPG_2.jpg,4248,59,498,557,149,221,True,5
3,56,kaist_dataset/Korean/Digital_Camera/outdoor5/DSC03979.JPG,char_data/3/DSC03979.JPG_4.jpg,3920,70,191,261,377,433,True,5
3,47,kaist_dataset/Korean/Digital_Camera/outdoor5/DSC03979.JPG,char_data/3/DSC03979.JPG_4.jpg,3008,64,438,502,387,434,True,5
3,25,kaist_dataset/Korean/Digital_Camera/outdoor5/DSC03688.JPG,char_data/3/DSC03688.JPG_2.jpg,350,14,618,632,227,252,True,5
3,29,kaist_dataset/Korean/Digital_Camera/outdoor5/DSC03736.JPG,char_data/3/DSC03736.JPG_4.jpg,464,16,384,400,406,435,True,5
3,29,kaist_dataset/Korean/Digital_Camera/outdoor5/DSC03736.JPG,char_data/3/DSC03736.JPG_4.jpg,464,16,400,416,406,435,True,5
3,36,kaist_dataset/Korean/Digital_Camera/outdoor5/DSC03692.JPG,char_data/3/DSC03692.JPG_2.jpg,540,15,504,519,188,224,True,5
3,38,kaist_dataset/Korean/Digital_Camera/outdoor5/DSC04027.JPG,char_data/3/DSC04027.JPG_2.jpg,950,25,168,193,389,427,True,5
3,37,kaist_dataset/Korean/Digital_Camera/outdoor5/DSC03671.JPG,char_data/3/DSC03671.JPG_2.jpg,814,22,491,513,410,447,True,5
3,93,kaist_dataset/Korean/Digital_Camera/outdoor5/DSC03715.JPG,char_data/3/DSC03715.JPG_2.jpg,4371,47,503,550,79,172,True,5
3,68,kaist_dataset/Korean/Digital_Camera/outdoor5/DSC03694.JPG,char_data/3/DSC03694.JPG_2.jpg,1836,27,572,599,118,186,True,5
3,22,kaist_dataset/Korean/Digital_Camera/outdoor5/DSC03752.JPG,char_data/3/DSC03752.JPG_2.jpg,220,10,122,132,412,434,True,5
3,36,kaist_dataset/Korean/Digital_Camera/outdoor5/DSC03794.JPG,char_data/3/DSC03794.JPG_2.jpg,648,18,384,402,359,395,True,5
3,64,kaist_dataset/Korean/Digital_Camera/outdoor5/DSC03749.JPG,char_data/3/DSC03749.JPG_2.jpg,2176,34,545,579,411,475,True,5
3,30,kaist_dataset/Korean/Digital_Camera/outdoor5/DSC03777.JPG,char_data/3/DSC03777.JPG_4.jpg,390,13,141,154,345,375,True,5
3,29,kaist_dataset/Korean/Digital_Camera/outdoor5/DSC03777.JPG,char_data/3/DSC03777.JPG_4.jpg,435,15,213,228,342,371,True,5
3,32,kaist_dataset/Korean/Digital_Camera/outdoor5/DSC03853.JPG,char_data/3/DSC03853.JPG_2.jpg,512,16,428,444,117,149,True,5
3,31,kaist_dataset/Korean/Digital_Camera/outdoor5/DSC03636.JPG,char_data/3/DSC03636.JPG_2.jpg,527,17,276,293,397,428,True,5
3,32,kaist_dataset/Korean/Digital_Camera/outdoor5/DSC03641.JPG,char_data/3/DSC03641.JPG_2.jpg,576,18,442,460,422,454,True,5
3,89,kaist_dataset/Korean/Digital_Camera/outdoor5/DSC03864.JPG,char_data/3/DSC03864.JPG_2.jpg,5251,59,529,588,169,258,True,5
3,38,kaist_dataset/Korean/Digital_Camera/outdoor5/DSC03858.JPG,char_data/3/DSC03858.JPG_2.jpg,722,19,468,487,415,453,True,5
3,41,kaist_dataset/Korean/Digital_Camera/outdoor4/DSC03598.JPG,char_data/3/DSC03598.JPG_2.jpg,1353,33,282,315,267,308,True,5
3,100,kaist_dataset/Korean/Digital_Camera/outdoor4/DSC03542.JPG,char_data/3/DSC03542.JPG_2.jpg,4800,48,245,293,234,334,True,5
3,61,kaist_dataset/Korean/Digital_Camera/outdoor4/DSC03592.JPG,char_data/3/DSC03592.JPG_8.jpg,1769,29,430,459,57,118,True,5
3,39,kaist_dataset/Korean/Digital_Camera/outdoor4/DSC03592.JPG,char_data/3/DSC03592.JPG_8.jpg,819,21,298,319,117,156,True,5
3,36,kaist_dataset/Korean/Digital_Camera/outdoor4/DSC03592.JPG,char_data/3/DSC03592.JPG_8.jpg,792,22,498,520,125,161,True,5
3,39,kaist_dataset/Korean/Digital_Camera/outdoor4/DSC03592.JPG,char_data/3/DSC03592.JPG_8.jpg,819,21,605,626,124,163,True,5
3,57,kaist_dataset/Korean/Digital_Camera/outdoor4/DSC03607.JPG,char_data/3/DSC03607.JPG_2.jpg,2736,48,77,125,96,153,True,5
3,45,kaist_dataset/Korean/Digital_Camera/outdoor4/DSC03614.JPG,char_data/3/DSC03614.JPG_2.jpg,1080,24,409,433,389,434,True,5
3,84,kaist_dataset/Korean/Digital_Camera/outdoor4/DSC03320.JPG,char_data/3/DSC03320.JPG_2.jpg,4284,51,294,345,380,464,True,5
3,64,kaist_dataset/Korean/Digital_Camera/outdoor4/DSC03537.JPG,char_data/3/DSC03537.JPG_4.jpg,2816,44,267,311,130,194,True,5
3,61,kaist_dataset/Korean/Digital_Camera/outdoor4/DSC03537.JPG,char_data/3/DSC03537.JPG_4.jpg,2257,37,353,390,128,189,True,5
3,72,kaist_dataset/Korean/Digital_Camera/outdoor4/DSC03555.JPG,char_data/3/DSC03555.JPG_2.jpg,3096,43,262,305,353,425,True,5
3,49,kaist_dataset/Korean/Digital_Camera/outdoor4/DSC03603.JPG,char_data/3/DSC03603.JPG_4.jpg,1421,29,262,291,52,101,True,5
3,41,kaist_dataset/Korean/Digital_Camera/outdoor4/DSC03603.JPG,char_data/3/DSC03603.JPG_4.jpg,902,22,321,343,287,328,True,5
3,58,kaist_dataset/Korean/Digital_Camera/outdoor4/DSC03261.JPG,char_data/3/DSC03261.JPG_4.jpg,2320,40,349,389,398,456,True,5
3,54,kaist_dataset/Korean/Digital_Camera/outdoor4/DSC03261.JPG,char_data/3/DSC03261.JPG_4.jpg,2214,41,428,469,403,457,True,5
3,36,kaist_dataset/Korean/Digital_Camera/outdoor2/DSC02467.JPG,char_data/3/DSC02467.JPG_2.jpg,684,19,269,288,253,289,True,5
3,37,kaist_dataset/Korean/Digital_Camera/outdoor2/2007-12-08-day-101.jpg,char_data/3/2007-12-08-day-101.jpg_2.jpg,629,17,844,861,744,781,True,5
3,31,kaist_dataset/Korean/Digital_Camera/outdoor2/DSC02308.JPG,char_data/3/DSC02308.JPG_2.jpg,930,30,287,317,238,269,True,5
3,40,kaist_dataset/Korean/Digital_Camera/outdoor2/2007-12-09-day-exterior-036.jpg,char_data/3/2007-12-09-day-exterior-036.jpg_2.jpg,840,21,1502,1523,629,669,True,5
3,32,kaist_dataset/Korean/Digital_Camera/outdoor2/2007-12-08-day-122.jpg,char_data/3/2007-12-08-day-122.jpg_1.jpg,1824,57,884,941,262,294,True,5
3,41,kaist_dataset/Korean/Digital_Camera/outdoor2/2007-12-08-day-122.jpg,char_data/3/2007-12-08-day-122.jpg_1.jpg,1066,26,1324,1350,555,596,True,5
3,37,kaist_dataset/Korean/Digital_Camera/outdoor2/2007-12-09-day-exterior-084.jpg,char_data/3/2007-12-09-day-exterior-084.jpg_0.jpg,1258,34,803,837,801,838,True,5
3,38,kaist_dataset/Korean/Digital_Camera/outdoor2/DSC02426.JPG,char_data/3/DSC02426.JPG_0.jpg,1140,30,590,620,210,248,True,5
3,34,kaist_dataset/Korean/Digital_Camera/outdoor2/DSC02396.JPG,char_data/3/DSC02396.JPG_0.jpg,782,23,434,457,371,405,True,5
3,35,kaist_dataset/Korean/Digital_Camera/outdoor2/DSC02396.JPG,char_data/3/DSC02396.JPG_0.jpg,1050,30,502,532,367,402,True,5
3,24,kaist_dataset/Korean/Digital_Camera/outdoor2/DSC02441.JPG,char_data/3/DSC02441.JPG_0.jpg,360,15,460,475,203,227,True,5
3,30,kaist_dataset/Korean/Digital_Camera/outdoor2/DSC02441.JPG,char_data/3/DSC02441.JPG_0.jpg,540,18,499,517,202,232,True,5
3,28,kaist_dataset/Korean/Digital_Camera/outdoor2/DSC02441.JPG,char_data/3/DSC02441.JPG_0.jpg,392,14,517,531,202,230,True,5
3,22,kaist_dataset/Korean/Digital_Camera/outdoor2/DSC02424.JPG,char_data/3/DSC02424.JPG_0.jpg,286,13,485,498,246,268,True,5
3,42,kaist_dataset/Korean/Digital_Camera/outdoor2/DSC02366.JPG,char_data/3/DSC02366.JPG_0.jpg,966,23,369,392,407,449,True,5
3,40,kaist_dataset/Korean/Digital_Camera/outdoor2/DSC02381.JPG,char_data/3/DSC02381.JPG_0.jpg,800,20,255,275,312,352,True,5
3,37,kaist_dataset/Korean/Digital_Camera/outdoor2/DSC02311.JPG,char_data/3/DSC02311.JPG_0.jpg,777,21,492,513,252,289,True,5
3,34,kaist_dataset/Korean/Digital_Camera/outdoor2/DSC02311.JPG,char_data/3/DSC02311.JPG_0.jpg,884,26,530,556,251,285,True,5
3,31,kaist_dataset/Korean/Digital_Camera/outdoor2/DSC02383.JPG,char_data/3/DSC02383.JPG_0.jpg,496,16,62,78,298,329,True,5
3,35,kaist_dataset/Korean/Digital_Camera/outdoor2/DSC02383.JPG,char_data/3/DSC02383.JPG_0.jpg,420,12,103,115,292,327,True,5
3,33,kaist_dataset/Korean/Digital_Camera/outdoor2/DSC02383.JPG,char_data/3/DSC02383.JPG_0.jpg,528,16,295,311,287,320,True,5
3,41,kaist_dataset/Korean/Digital_Camera/outdoor2/DSC02386.JPG,char_data/3/DSC02386.JPG_0.jpg,861,21,466,487,252,293,True,5
3,36,kaist_dataset/Korean/Digital_Camera/outdoor2/DSC02386.JPG,char_data/3/DSC02386.JPG_0.jpg,756,21,518,539,252,288,True,5
3,35,kaist_dataset/Korean/Digital_Camera/outdoor2/DSC02386.JPG,char_data/3/DSC02386.JPG_0.jpg,840,24,538,562,252,287,True,5
3,50,kaist_dataset/Korean/Digital_Camera/outdoor2/DSC02485.JPG,char_data/3/DSC02485.JPG_0.jpg,1900,38,144,182,275,325,True,5
3,55,kaist_dataset/Korean/Digital_Camera/outdoor2/DSC02512.JPG,char_data/3/DSC02512.JPG_0.jpg,1650,30,455,485,287,342,True,5
3,39,kaist_dataset/Korean/Digital_Camera/outdoor2/DSC02371.JPG,char_data/3/DSC02371.JPG_0.jpg,741,19,196,215,241,280,True,5
3,53,kaist_dataset/Korean/Digital_Camera/outdoor2/DSC02515.JPG,char_data/3/DSC02515.JPG_0.jpg,2067,39,295,334,328,381,True,5
3,39,kaist_dataset/Korean/Digital_Camera/outdoor2/DSC02488.JPG,char_data/3/DSC02488.JPG_0.jpg,858,22,508,530,370,409,True,5
3,40,kaist_dataset/Korean/Digital_Camera/outdoor2/DSC02488.JPG,char_data/3/DSC02488.JPG_0.jpg,760,19,575,594,370,410,True,5
3,126,kaist_dataset/Korean/Digital_Camera/outdoor2/DSC02520.JPG,char_data/3/DSC02520.JPG_0.jpg,4410,35,367,402,297,423,True,5
3,121,kaist_dataset/Korean/Digital_Camera/outdoor2/DSC02520.JPG,char_data/3/DSC02520.JPG_0.jpg,4598,38,504,542,294,415,True,5
3,120,kaist_dataset/Korean/Digital_Camera/outdoor2/DSC02520.JPG,char_data/3/DSC02520.JPG_0.jpg,4560,38,569,607,298,418,True,5
3,29,kaist_dataset/Korean/Digital_Camera/outdoor2/DSC02304.JPG,char_data/3/DSC02304.JPG_0.jpg,812,28,351,379,264,293,True,5
3,31,kaist_dataset/Korean/Digital_Camera/outdoor2/DSC02470.JPG,char_data/3/DSC02470.JPG_0.jpg,651,21,265,286,177,208,True,5
3,29,kaist_dataset/Korean/Digital_Camera/outdoor2/DSC02470.JPG,char_data/3/DSC02470.JPG_0.jpg,609,21,313,334,174,203,True,5
3,73,kaist_dataset/Korean/Digital_Camera/outdoor2/2007-12-09-day-exterior-012.jpg,char_data/3/2007-12-09-day-exterior-012.jpg_0.jpg,3212,44,1108,1152,622,695,True,5
3,33,kaist_dataset/Korean/Digital_Camera/outdoor2/DSC02310.JPG,char_data/3/DSC02310.JPG_0.jpg,1089,33,377,410,211,244,True,5
3,33,kaist_dataset/Korean/Digital_Camera/outdoor2/DSC02372.JPG,char_data/3/DSC02372.JPG_0.jpg,396,12,536,548,283,316,True,5
3,29,kaist_dataset/Korean/Digital_Camera/outdoor2/DSC02521.JPG,char_data/3/DSC02521.JPG_0.jpg,609,21,334,355,326,355,True,5
3,49,kaist_dataset/Korean/Digital_Camera/E-night/DSC02645.JPG,char_data/3/DSC02645.JPG_0.jpg,1274,26,363,389,331,380,True,5
3,22,kaist_dataset/Korean/Digital_Camera/E-night/103.jpg,char_data/3/103.jpg_0.jpg,154,7,194,201,314,336,True,5
3,18,kaist_dataset/Korean/Digital_Camera/E-night/103.jpg,char_data/3/103.jpg_0.jpg,144,8,202,210,315,333,True,5
3,52,kaist_dataset/Korean/Digital_Camera/E-night/DSC02594.JPG,char_data/3/DSC02594.JPG_0.jpg,2080,40,195,235,378,430,True,5
3,56,kaist_dataset/Korean/Digital_Camera/E-night/DSC02597.JPG,char_data/3/DSC02597.JPG_0.jpg,1736,31,434,465,285,341,True,5
3,88,kaist_dataset/Korean/Digital_Camera/indoor1/DSC03364.JPG,char_data/3/DSC03364.JPG_0.jpg,6424,73,189,262,236,324,True,5
3,89,kaist_dataset/Korean/Digital_Camera/indoor1/080119-0029.jpg,char_data/3/080119-0029.jpg_0.jpg,3382,38,523,561,573,662,True,5
3,44,kaist_dataset/Korean/Digital_Camera/indoor1/080119-0029.jpg,char_data/3/080119-0029.jpg_0.jpg,660,15,1254,1269,620,664,True,5
3,87,kaist_dataset/Korean/Digital_Camera/indoor1/DSC02728.JPG,char_data/3/DSC02728.JPG_0.jpg,6003,69,288,357,169,256,True,5
3,88,kaist_dataset/Korean/Digital_Camera/indoor1/080119-0030.jpg,char_data/3/080119-0030.jpg_0.jpg,4400,50,961,1011,433,521,True,5
3,28,kaist_dataset/Korean/Digital_Camera/indoor1/080119-0030.jpg,char_data/3/080119-0030.jpg_0.jpg,308,11,761,772,865,893,True,5
3,62,kaist_dataset/Korean/Digital_Camera/indoor1/DSC02715.JPG,char_data/3/DSC02715.JPG_0.jpg,2790,45,283,328,174,236,True,5
3,155,kaist_dataset/Korean/Digital_Camera/indoor1/DSC02700.JPG,char_data/3/DSC02700.JPG_0.jpg,16895,109,96,205,208,363,True,5
3,32,kaist_dataset/Korean/Digital_Camera/indoor1/DSC02700.JPG,char_data/3/DSC02700.JPG_0.jpg,512,16,270,286,425,457,True,5
3,52,kaist_dataset/Korean/Digital_Camera/indoor1/080119-0018.jpg,char_data/3/080119-0018.jpg_0.jpg,1352,26,1041,1067,695,747,True,5
3,53,kaist_dataset/Korean/Digital_Camera/indoor1/080119-0018.jpg,char_data/3/080119-0018.jpg_0.jpg,1484,28,969,997,773,826,True,5
3,46,kaist_dataset/Korean/Digital_Camera/indoor1/080119-0018.jpg,char_data/3/080119-0018.jpg_0.jpg,1150,25,1084,1109,940,986,True,5
3,46,kaist_dataset/Korean/Digital_Camera/indoor1/080119-0018.jpg,char_data/3/080119-0018.jpg_0.jpg,1150,25,1132,1157,936,982,True,5
3,185,kaist_dataset/Korean/Digital_Camera/indoor1/DSC02699.JPG,char_data/3/DSC02699.JPG_0.jpg,20165,109,8,117,234,419,True,5
3,116,kaist_dataset/Korean/Digital_Camera/indoor1/DSC03374.JPG,char_data/3/DSC03374.JPG_0.jpg,9744,84,128,212,290,406,True,5
3,28,kaist_dataset/Korean/Digital_Camera/outdoor7/P1010022.JPG,char_data/3/P1010022.JPG_0.jpg,812,29,133,162,258,286,True,5
3,42,kaist_dataset/Korean/Digital_Camera/outdoor7/P1010012.JPG,char_data/3/P1010012.JPG_0.jpg,1344,32,415,447,221,263,True,5
3,40,kaist_dataset/Korean/Digital_Camera/outdoor7/P1010082.JPG,char_data/3/P1010082.JPG_0.jpg,1560,39,334,373,47,87,True,5
3,34,kaist_dataset/Korean/Digital_Camera/outdoor7/P1010091.JPG,char_data/3/P1010091.JPG_0.jpg,544,16,312,328,231,265,True,5
3,50,kaist_dataset/Korean/Digital_Camera/outdoor7/k.jpg,char_data/3/k.jpg_0.jpg,1700,34,90,124,144,194,True,5
3,41,kaist_dataset/Korean/Digital_Camera/outdoor7/P1010069.JPG,char_data/3/P1010069.JPG_0.jpg,697,17,576,593,318,359,True,5
3,48,kaist_dataset/Korean/Digital_Camera/outdoor7/P1010111.JPG,char_data/3/P1010111.JPG_0.jpg,1728,36,527,563,219,267,True,5
3,62,kaist_dataset/Korean/Digital_Camera/outdoor7/P1010080.JPG,char_data/3/P1010080.JPG_0.jpg,1984,32,457,489,193,255,True,5
3,81,kaist_dataset/Korean/Digital_Camera/outdoor7/P1010017.JPG,char_data/3/P1010017.JPG_0.jpg,1782,22,360,382,348,429,True,5
3,30,kaist_dataset/Korean/Digital_Camera/outdoor7/P1010055.JPG,char_data/3/P1010055.JPG_0.jpg,1050,35,120,155,207,237,True,5
3,55,kaist_dataset/Korean/Digital_Camera/outdoor7/P1010011.JPG,char_data/3/P1010011.JPG_0.jpg,2090,38,349,387,224,279,True,5
3,52,kaist_dataset/Korean/Digital_Camera/outdoor7/P1010011.JPG,char_data/3/P1010011.JPG_0.jpg,1924,37,480,517,226,278,True,5
3,27,kaist_dataset/Korean/Digital_Camera/outdoor7/P1010112.JPG,char_data/3/P1010112.JPG_0.jpg,486,18,419,437,360,387,True,5
3,26,kaist_dataset/Korean/Digital_Camera/outdoor7/P1010124.JPG,char_data/3/P1010124.JPG_0.jpg,416,16,317,333,149,175,True,5
3,18,kaist_dataset/Korean/Digital_Camera/outdoor7/P1010124.JPG,char_data/3/P1010124.JPG_0.jpg,324,18,346,364,156,174,True,5
3,20,kaist_dataset/Korean/Digital_Camera/outdoor7/P1010124.JPG,char_data/3/P1010124.JPG_0.jpg,300,15,378,393,154,174,True,5
3,42,kaist_dataset/Korean/Digital_Camera/outdoor7/P1010009.JPG,char_data/3/P1010009.JPG_0.jpg,1050,25,444,469,263,305,True,5
3,32,kaist_dataset/Korean/Digital_Camera/outdoor7/P1010004.JPG,char_data/3/P1010004.JPG_0.jpg,416,13,503,516,295,327,True,5
3,33,kaist_dataset/Korean/Digital_Camera/outdoor7/P1010004.JPG,char_data/3/P1010004.JPG_0.jpg,429,13,524,537,294,327,True,5
3,54,kaist_dataset/Korean/Digital_Camera/outdoor7/P1010023.JPG,char_data/3/P1010023.JPG_0.jpg,1350,25,545,570,283,337,True,5
3,36,kaist_dataset/Korean/Digital_Camera/outdoor7/P1010061.JPG,char_data/3/P1010061.JPG_0.jpg,936,26,466,492,319,355,True,5
3,74,kaist_dataset/Korean/Digital_Camera/outdoor7/P1010066.JPG,char_data/3/P1010066.JPG_0.jpg,3700,50,280,330,335,409,True,5
3,103,kaist_dataset/Korean/Digital_Camera/outdoor7/P1010079.JPG,char_data/3/P1010079.JPG_0.jpg,8137,79,519,598,335,438,True,5
3,36,kaist_dataset/Korean/Digital_Camera/outdoor8/P1010143.JPG,char_data/3/P1010143.JPG_0.jpg,864,24,359,383,268,304,True,5
3,31,kaist_dataset/Korean/Digital_Camera/outdoor8/P1010189.JPG,char_data/3/P1010189.JPG_0.jpg,1054,34,369,403,232,263,True,5
3,38,kaist_dataset/Korean/Digital_Camera/outdoor8/P1010189.JPG,char_data/3/P1010189.JPG_0.jpg,950,25,462,487,229,267,True,5
3,55,kaist_dataset/Korean/Digital_Camera/outdoor8/DSC02950.JPG,char_data/3/DSC02950.JPG_0.jpg,2310,42,359,401,296,351,True,5
3,70,kaist_dataset/Korean/Digital_Camera/outdoor8/P1010160.JPG,char_data/3/P1010160.JPG_0.jpg,3780,54,437,491,222,292,True,5
3,53,kaist_dataset/Korean/Digital_Camera/outdoor8/P1010171.JPG,char_data/3/P1010171.JPG_0.jpg,1749,33,484,517,229,282,True,5
3,49,kaist_dataset/Korean/Digital_Camera/indoor2/DSC03474.JPG,char_data/3/DSC03474.JPG_0.jpg,1568,32,339,371,210,259,True,5
3,44,kaist_dataset/Korean/Digital_Camera/G-others/2007-12-09-day-exterior-083.jpg,char_data/3/2007-12-09-day-exterior-083.jpg_0.jpg,1364,31,574,605,972,1016,True,5
3,52,kaist_dataset/Korean/Digital_Camera/G-others/2007-12-09-day-exterior-083.jpg,char_data/3/2007-12-09-day-exterior-083.jpg_0.jpg,1872,36,370,406,126,178,True,5
3,29,kaist_dataset/Korean/Digital_Camera/G-others/DSC03863.JPG,char_data/3/DSC03863.JPG_0.jpg,348,12,228,240,406,435,True,5
3,26,kaist_dataset/Korean/Digital_Camera/G-others/DSC03863.JPG,char_data/3/DSC03863.JPG_0.jpg,364,14,240,254,407,433,True,5
3,48,kaist_dataset/Korean/Digital_Camera/G-others/2007-12-08-day-045.jpg,char_data/3/2007-12-08-day-045.jpg_0.jpg,864,18,132,150,794,842,True,5
3,80,kaist_dataset/Korean/Digital_Camera/outdoor6/DSC04359.JPG,char_data/3/DSC04359.JPG_0.jpg,3120,39,185,224,111,191,True,5
3,49,kaist_dataset/Korean/Digital_Camera/outdoor6/DSC04136.JPG,char_data/3/DSC04136.JPG_0.jpg,1274,26,350,376,328,377,True,5
3,40,kaist_dataset/Korean/Digital_Camera/outdoor6/DSC04400.JPG,char_data/3/DSC04400.JPG_0.jpg,760,19,307,326,225,265,True,5
3,151,kaist_dataset/Korean/Digital_Camera/outdoor6/DSC04446.JPG,char_data/3/DSC04446.JPG_0.jpg,13439,89,229,318,274,425,True,5
3,23,kaist_dataset/Korean/Digital_Camera/outdoor6/DSC04341.JPG,char_data/3/DSC04341.JPG_0.jpg,414,18,547,565,226,249,True,5
3,26,kaist_dataset/Korean/Digital_Camera/outdoor6/DSC04341.JPG,char_data/3/DSC04341.JPG_0.jpg,572,22,562,584,222,248,True,5
3,40,kaist_dataset/Korean/Digital_Camera/outdoor6/DSC04148.JPG,char_data/3/DSC04148.JPG_0.jpg,680,17,445,462,255,295,True,5
3,27,kaist_dataset/Korean/Digital_Camera/outdoor6/DSC04042.JPG,char_data/3/DSC04042.JPG_0.jpg,351,13,86,99,331,358,True,5
3,77,kaist_dataset/Korean/Digital_Camera/outdoor6/DSC04292.JPG,char_data/3/DSC04292.JPG_0.jpg,3696,48,454,502,14,91,True,5
3,38,kaist_dataset/Korean/Digital_Camera/outdoor6/DSC04116.JPG,char_data/3/DSC04116.JPG_0.jpg,646,17,272,289,319,357,True,5
3,41,kaist_dataset/Korean/Digital_Camera/outdoor6/DSC04116.JPG,char_data/3/DSC04116.JPG_0.jpg,615,15,360,375,316,357,True,5
3,34,kaist_dataset/Korean/Digital_Camera/outdoor6/DSC04116.JPG,char_data/3/DSC04116.JPG_0.jpg,510,15,423,438,319,353,True,5
3,55,kaist_dataset/Korean/Digital_Camera/outdoor6/DSC04296.JPG,char_data/3/DSC04296.JPG_0.jpg,1320,24,261,285,315,370,True,5
3,59,kaist_dataset/Korean/Digital_Camera/outdoor6/DSC04296.JPG,char_data/3/DSC04296.JPG_0.jpg,1121,19,304,323,308,367,True,5
3,82,kaist_dataset/Korean/Digital_Camera/outdoor6/DSC04083.JPG,char_data/3/DSC04083.JPG_0.jpg,3362,41,436,477,157,239,True,5
3,163,kaist_dataset/Korean/Digital_Camera/A-shadow/DSC02670.JPG,char_data/3/DSC02670.JPG_0.jpg,10595,65,338,403,14,177,True,5
3,155,kaist_dataset/Korean/Digital_Camera/A-shadow/DSC02670.JPG,char_data/3/DSC02670.JPG_0.jpg,10695,69,409,478,18,173,True,5
3,41,kaist_dataset/Korean/Digital_Camera/A-shadow/DSC02598.JPG,char_data/3/DSC02598.JPG_0.jpg,779,19,574,593,413,454,True,5
3,40,kaist_dataset/Korean/Digital_Camera/A-shadow/DSC02598.JPG,char_data/3/DSC02598.JPG_0.jpg,760,19,593,612,415,455,True,5
3,78,kaist_dataset/Korean/Digital_Camera/A-shadow/DSC03535.JPG,char_data/3/DSC03535.JPG_0.jpg,3198,41,313,354,247,325,True,5
3,130,kaist_dataset/Korean/Digital_Camera/A-shadow/DSC04300.JPG,char_data/3/DSC04300.JPG_0.jpg,6500,50,209,259,219,349,True,5
3,77,kaist_dataset/Korean/Digital_Camera/A-shadow/2007-12-09-day-exterior-031.jpg,char_data/3/2007-12-09-day-exterior-031.jpg_0.jpg,3696,48,745,793,670,747,True,5
3,35,kaist_dataset/Korean/Digital_Camera/outdoor3/DSC02971.JPG,char_data/3/DSC02971.JPG_0.jpg,1050,30,342,372,298,333,True,5
3,35,kaist_dataset/Korean/Digital_Camera/outdoor3/DSC02971.JPG,char_data/3/DSC02971.JPG_0.jpg,770,22,373,395,298,333,True,5
3,33,kaist_dataset/Korean/Digital_Camera/outdoor3/DSC02531.JPG,char_data/3/DSC02531.JPG_0.jpg,660,20,248,268,351,384,True,5
3,61,kaist_dataset/Korean/Digital_Camera/outdoor3/DSC03198.JPG,char_data/3/DSC03198.JPG_0.jpg,2684,44,220,264,200,261,True,5
3,65,kaist_dataset/Korean/Digital_Camera/outdoor3/DSC03221.JPG,char_data/3/DSC03221.JPG_0.jpg,4160,64,42,106,80,145,True,5
3,34,kaist_dataset/Korean/Digital_Camera/outdoor3/DSC02698.JPG,char_data/3/DSC02698.JPG_0.jpg,612,18,347,365,403,437,True,5
3,64,kaist_dataset/Korean/Digital_Camera/outdoor3/DSC02953.JPG,char_data/3/DSC02953.JPG_0.jpg,1984,31,492,523,383,447,True,5
3,119,kaist_dataset/Korean/Digital_Camera/outdoor3/DSC02525.JPG,char_data/3/DSC02525.JPG_0.jpg,8568,72,100,172,17,136,True,5
3,38,kaist_dataset/Korean/Digital_Camera/outdoor3/DSC02975.JPG,char_data/3/DSC02975.JPG_0.jpg,836,22,440,462,244,282,True,5
3,41,kaist_dataset/Korean/Digital_Camera/outdoor3/DSC02598.JPG,char_data/3/DSC02598.JPG_0.jpg,779,19,574,593,413,454,True,5
3,40,kaist_dataset/Korean/Digital_Camera/outdoor3/DSC02598.JPG,char_data/3/DSC02598.JPG_0.jpg,760,19,593,612,415,455,True,5
3,27,kaist_dataset/Korean/Digital_Camera/outdoor3/DSC02529.JPG,char_data/3/DSC02529.JPG_0.jpg,243,9,589,598,372,399,True,5
3,41,kaist_dataset/Korean/Digital_Camera/outdoor3/DSC02941.JPG,char_data/3/DSC02941.JPG_0.jpg,1230,30,494,524,255,296,True,5
3,45,kaist_dataset/Korean/Digital_Camera/outdoor3/DSC02994.JPG,char_data/3/DSC02994.JPG_0.jpg,1395,31,397,428,289,334,True,5
3,48,kaist_dataset/Korean/Digital_Camera/outdoor3/DSC02697.JPG,char_data/3/DSC02697.JPG_0.jpg,1968,41,299,340,378,426,True,5
3,34,kaist_dataset/Korean/Digital_Camera/outdoor3/DSC02558.JPG,char_data/3/DSC02558.JPG_0.jpg,544,16,514,530,218,252,True,5
3,33,kaist_dataset/Korean/Digital_Camera/outdoor3/DSC02558.JPG,char_data/3/DSC02558.JPG_0.jpg,462,14,587,601,218,251,True,5
3,164,kaist_dataset/Korean/Digital_Camera/outdoor3/DSC03066.JPG,char_data/3/DSC03066.JPG_0.jpg,26404,161,179,340,240,404,True,5
3,115,kaist_dataset/Korean/Digital_Camera/outdoor3/DSC03159.JPG,char_data/3/DSC03159.JPG_0.jpg,6900,60,227,287,225,340,True,5
3,33,kaist_dataset/Korean/Digital_Camera/outdoor3/DSC02888.JPG,char_data/3/DSC02888.JPG_0.jpg,858,26,233,259,423,456,True,5
3,30,kaist_dataset/Korean/Digital_Camera/outdoor3/DSC02888.JPG,char_data/3/DSC02888.JPG_0.jpg,810,27,301,328,420,450,True,5
3,33,kaist_dataset/Korean/Digital_Camera/outdoor3/DSC02888.JPG,char_data/3/DSC02888.JPG_0.jpg,957,29,448,477,418,451,True,5
3,90,kaist_dataset/Korean/Digital_Camera/outdoor3/DSC03222.JPG,char_data/3/DSC03222.JPG_0.jpg,7290,81,166,247,358,448,True,5
3,49,kaist_dataset/Korean/Digital_Camera/outdoor1/052.JPG,char_data/3/052.JPG_0.jpg,931,19,301,320,317,366,True,5
3,40,kaist_dataset/Korean/Digital_Camera/outdoor1/052.JPG,char_data/3/052.JPG_0.jpg,1240,31,439,470,322,362,True,5
3,27,kaist_dataset/Korean/Digital_Camera/outdoor1/102.JPG,char_data/3/102.JPG_0.jpg,540,20,309,329,308,335,True,5
3,40,kaist_dataset/Korean/Digital_Camera/outdoor1/127.JPG,char_data/3/127.JPG_0.jpg,1080,27,366,393,269,309,True,5
3,23,kaist_dataset/Korean/Digital_Camera/outdoor1/126.JPG,char_data/3/126.JPG_0.jpg,667,29,274,303,266,289,True,5
3,21,kaist_dataset/Korean/Digital_Camera/outdoor1/126.JPG,char_data/3/126.JPG_0.jpg,252,12,567,579,259,280,True,5
3,27,kaist_dataset/Korean/Digital_Camera/outdoor1/040.JPG,char_data/3/040.JPG_0.jpg,702,26,313,339,301,328,True,5
3,29,kaist_dataset/Korean/Digital_Camera/outdoor1/040.JPG,char_data/3/040.JPG_0.jpg,783,27,338,365,299,328,True,5
3,28,kaist_dataset/Korean/Digital_Camera/outdoor1/040.JPG,char_data/3/040.JPG_0.jpg,644,23,365,388,302,330,True,5
3,25,kaist_dataset/Korean/Digital_Camera/outdoor1/002.JPG,char_data/3/002.JPG_0.jpg,275,11,349,360,374,399,True,5
3,19,kaist_dataset/Korean/Digital_Camera/outdoor1/006.JPG,char_data/3/006.JPG_0.jpg,285,15,365,380,253,272,True,5
3,47,kaist_dataset/Korean/Digital_Camera/outdoor1/098.JPG,char_data/3/098.JPG_0.jpg,1551,33,137,170,353,400,True,5
3,13,kaist_dataset/Korean/Digital_Camera/outdoor1/013.JPG,char_data/3/013.JPG_0.jpg,143,11,389,400,252,265,True,5
3,28,kaist_dataset/Korean/Digital_Camera/outdoor1/99.jpg,char_data/3/99.jpg_0.jpg,252,9,447,456,172,200,True,5
3,26,kaist_dataset/Korean/Digital_Camera/outdoor1/99.jpg,char_data/3/99.jpg_0.jpg,364,14,475,489,175,201,True,5
3,28,kaist_dataset/Korean/Digital_Camera/outdoor1/011.JPG,char_data/3/011.JPG_0.jpg,616,22,385,407,254,282,True,5
3,43,kaist_dataset/Korean/Digital_Camera/outdoor1/54.JPG,char_data/3/54.JPG_0.jpg,1204,28,636,664,362,405,True,5
3,27,kaist_dataset/Korean/Digital_Camera/outdoor1/032.JPG,char_data/3/032.JPG_0.jpg,567,21,367,388,259,286,True,5
3,31,kaist_dataset/Korean/Digital_Camera/outdoor1/032.JPG,char_data/3/032.JPG_0.jpg,651,21,455,476,253,284,True,5
3,32,kaist_dataset/Korean/Digital_Camera/outdoor1/032.JPG,char_data/3/032.JPG_0.jpg,480,15,507,522,255,287,True,5
3,28,kaist_dataset/Korean/Digital_Camera/outdoor1/125.JPG,char_data/3/125.JPG_0.jpg,560,20,310,330,257,285,True,5
3,33,kaist_dataset/Korean/Digital_Camera/outdoor1/123.JPG,char_data/3/123.JPG_0.jpg,594,18,212,230,277,310,True,5
3,31,kaist_dataset/Korean/Digital_Camera/outdoor1/035.JPG,char_data/3/035.JPG_0.jpg,496,16,289,305,287,318,True,5
3,33,kaist_dataset/Korean/Digital_Camera/outdoor1/035.JPG,char_data/3/035.JPG_0.jpg,561,17,521,538,285,318,True,5
3,35,kaist_dataset/Mixed/Mobile_Phone/(C.M)A-outdoor/P090912068.jpg,char_data/3/P090912068.jpg_0.jpg,1015,29,387,416,128,163,True,5
3,37,kaist_dataset/Mixed/Mobile_Phone/(C.M)A-outdoor/P090912038.jpg,char_data/3/P090912038.jpg_0.jpg,814,22,351,373,158,195,True,5
3,38,kaist_dataset/Mixed/Mobile_Phone/(C.M)A-outdoor/P090912038.jpg,char_data/3/P090912038.jpg_0.jpg,798,21,430,451,156,194,True,5
3,30,kaist_dataset/Mixed/Mobile_Phone/(C.M)A-outdoor/P090912036.jpg,char_data/3/P090912036.jpg_0.jpg,420,14,190,204,189,219,True,5
3,29,kaist_dataset/Mixed/Mobile_Phone/(C.M)A-outdoor/P090912036.jpg,char_data/3/P090912036.jpg_0.jpg,406,14,388,402,192,221,True,5
3,65,kaist_dataset/Mixed/Mobile_Phone/(C.M)B-indoor/P090831007.jpg,char_data/3/P090831007.jpg_0.jpg,3250,50,437,487,131,196,True,5
3,58,kaist_dataset/Mixed/Mobile_Phone/(C.M)B-indoor/P090831007.jpg,char_data/3/P090831007.jpg_0.jpg,2900,50,115,165,272,330,True,5
3,65,kaist_dataset/Mixed/Mobile_Phone/(C.M)B-indoor/P090831007.jpg,char_data/3/P090831007.jpg_0.jpg,2470,38,313,351,273,338,True,5
3,25,kaist_dataset/Mixed/Digital_Camera/(C.S)C-outdoor1/027.JPG,char_data/3/027.JPG_0.jpg,375,15,466,481,278,303,True,5
3,31,kaist_dataset/Mixed/Digital_Camera/(C.S)C-outdoor1/048.JPG,char_data/3/048.JPG_0.jpg,682,22,299,321,257,288,True,5
3,38,kaist_dataset/Mixed/Digital_Camera/(C.S)C-outdoor1/51.JPG,char_data/3/51.JPG_0.jpg,950,25,692,717,378,416,True,5
3,106,kaist_dataset/Mixed/Digital_Camera/(C.S)C-outdoor1/112.JPG,char_data/3/112.JPG_0.jpg,19398,183,12,195,14,120,True,5
3,60,kaist_dataset/Mixed/Digital_Camera/(C.S)C-outdoor1/112.JPG,char_data/3/112.JPG_0.jpg,3300,55,81,136,282,342,True,5
3,58,kaist_dataset/Mixed/Digital_Camera/(C.S)C-outdoor1/2007-12-09-day-exterior-078.jpg,char_data/3/2007-12-09-day-exterior-078.jpg_0.jpg,1160,20,813,833,578,636,True,5
3,92,kaist_dataset/Mixed/Digital_Camera/(C.S)C-outdoor1/2007-12-08-day-092.jpg,char_data/3/2007-12-08-day-092.jpg_0.jpg,6256,68,898,966,662,754,True,5
3,39,kaist_dataset/Mixed/Digital_Camera/(C.S)C-outdoor1/P1010010.JPG,char_data/3/P1010010.JPG_0.jpg,1599,41,493,534,210,249,True,5
3,48,kaist_dataset/Mixed/Digital_Camera/(C.S)C-outdoor1/P1010010.JPG,char_data/3/P1010010.JPG_0.jpg,1248,26,448,474,359,407,True,5
3,46,kaist_dataset/Mixed/Digital_Camera/(C.S)C-outdoor1/080116-0084.jpg,char_data/3/080116-0084.jpg_0.jpg,1518,33,502,535,304,350,True,5
3,21,kaist_dataset/Mixed/Digital_Camera/(C.S)C-outdoor1/114.jpg,char_data/3/114.jpg_0.jpg,336,16,314,330,374,395,True,5
3,25,kaist_dataset/Mixed/Digital_Camera/(C.S)C-outdoor1/114.jpg,char_data/3/114.jpg_0.jpg,375,15,359,374,374,399,True,5
3,24,kaist_dataset/Mixed/Digital_Camera/(C.S)C-outdoor1/114.jpg,char_data/3/114.jpg_0.jpg,360,15,383,398,374,398,True,5
3,25,kaist_dataset/Mixed/Digital_Camera/(C.S)C-outdoor1/114.jpg,char_data/3/114.jpg_0.jpg,425,17,404,421,373,398,True,5
3,28,kaist_dataset/Mixed/Digital_Camera/(C.S)C-outdoor1/121.JPG,char_data/3/121.JPG_0.jpg,448,16,444,460,276,304,True,5
3,24,kaist_dataset/Mixed/Digital_Camera/(C.S)C-outdoor1/121.JPG,char_data/3/121.JPG_0.jpg,456,19,486,505,278,302,True,5
3,35,kaist_dataset/Mixed/Digital_Camera/(C.S)C-outdoor1/009.JPG,char_data/3/009.JPG_0.jpg,805,23,388,411,319,354,True,5
3,36,kaist_dataset/Mixed/Digital_Camera/(C.S)C-outdoor1/009.JPG,char_data/3/009.JPG_0.jpg,1008,28,411,439,317,353,True,5
3,40,kaist_dataset/Mixed/Digital_Camera/(C.S)C-outdoor1/P1010011.JPG,char_data/3/P1010011.JPG_0.jpg,960,24,442,466,311,351,True,5
3,23,kaist_dataset/Mixed/Digital_Camera/(C.S)C-outdoor1/48.JPG,char_data/3/48.JPG_0.jpg,276,12,283,295,342,365,True,5
3,39,kaist_dataset/Mixed/Digital_Camera/(C.S)C-outdoor1/56.JPG,char_data/3/56.JPG_0.jpg,1326,34,509,543,298,337,True,5
3,21,kaist_dataset/Mixed/Digital_Camera/(C.S)C-outdoor1/047.JPG,char_data/3/047.JPG_0.jpg,189,9,574,583,174,195,True,5
3,24,kaist_dataset/Mixed/Digital_Camera/(C.S)C-outdoor1/047.JPG,char_data/3/047.JPG_0.jpg,312,13,623,636,241,265,True,5
3,63,kaist_dataset/Mixed/Digital_Camera/(C.S)C-outdoor1/2007-12-09-day-exterior-004.jpg,char_data/3/2007-12-09-day-exterior-004.jpg_0.jpg,3024,48,1080,1128,659,722,True,5
3,70,kaist_dataset/Mixed/Digital_Camera/(C.S)C-outdoor1/2007-12-09-day-exterior-004.jpg,char_data/3/2007-12-09-day-exterior-004.jpg_0.jpg,3640,52,1266,1318,665,735,True,5
3,89,kaist_dataset/Mixed/Digital_Camera/(C.S)C-outdoor1/080119-0027.jpg,char_data/3/080119-0027.jpg_0.jpg,4450,50,484,534,713,802,True,5
3,35,kaist_dataset/Mixed/Digital_Camera/(C.S)C-outdoor1/DSC02349.JPG,char_data/3/DSC02349.JPG_0.jpg,770,22,315,337,200,235,True,5
3,43,kaist_dataset/Mixed/Digital_Camera/(C.S)C-outdoor1/DSC02349.JPG,char_data/3/DSC02349.JPG_0.jpg,817,19,389,408,194,237,True,5
3,35,kaist_dataset/Mixed/Digital_Camera/(C.S)C-outdoor1/DSC02349.JPG,char_data/3/DSC02349.JPG_0.jpg,630,18,389,407,430,465,True,5
3,35,kaist_dataset/Mixed/Digital_Camera/(C.S)C-outdoor1/DSC02349.JPG,char_data/3/DSC02349.JPG_0.jpg,560,16,442,458,426,461,True,5
3,27,kaist_dataset/Mixed/Digital_Camera/(C.S)C-outdoor1/57.JPG,char_data/3/57.JPG_0.jpg,378,14,386,400,294,321,True,5
3,47,kaist_dataset/Mixed/Digital_Camera/(C.S)C-outdoor1/DSC02312.JPG,char_data/3/DSC02312.JPG_0.jpg,1551,33,197,230,215,262,True,5
3,30,kaist_dataset/Mixed/Digital_Camera/(C.S)C-outdoor1/47.JPG,char_data/3/47.JPG_0.jpg,420,14,360,374,474,504,True,5
3,33,kaist_dataset/Mixed/Digital_Camera/(C.S)C-outdoor1/DSC02242.JPG,char_data/3/DSC02242.JPG_0.jpg,561,17,598,615,258,291,True,5
3,38,kaist_dataset/Mixed/Digital_Camera/(C.S)C-outdoor1/105.jpg,char_data/3/105.jpg_0.jpg,760,20,342,362,386,424,True,5
3,33,kaist_dataset/Mixed/Digital_Camera/(C.S)C-outdoor1/55.JPG,char_data/3/55.JPG_0.jpg,858,26,334,360,370,403,True,5
3,65,kaist_dataset/Mixed/Digital_Camera/(C.S)C-outdoor1/080119-0008.jpg,char_data/3/080119-0008.jpg_0.jpg,1755,27,1289,1316,655,720,True,5
3,77,kaist_dataset/Mixed/Digital_Camera/(C.S)C-outdoor1/080119-0008.jpg,char_data/3/080119-0008.jpg_0.jpg,4851,63,973,1036,831,908,True,5
3,63,kaist_dataset/Mixed/Digital_Camera/(C.S)C-outdoor1/2007-12-08-day-091.jpg,char_data/3/2007-12-08-day-091.jpg_0.jpg,2394,38,1318,1356,624,687,True,5
3,31,kaist_dataset/Mixed/Digital_Camera/(C.S)C-outdoor1/090.JPG,char_data/3/090.JPG_0.jpg,620,20,185,205,353,384,True,5
3,30,kaist_dataset/Mixed/Digital_Camera/(C.S)C-outdoor1/090.JPG,char_data/3/090.JPG_0.jpg,660,22,569,591,365,395,True,5
3,31,kaist_dataset/Mixed/Digital_Camera/(C.S)C-outdoor1/090.JPG,char_data/3/090.JPG_0.jpg,620,20,395,415,390,421,True,5
3,38,kaist_dataset/Mixed/Digital_Camera/(C.S)F-others/DSC02504.JPG,char_data/3/DSC02504.JPG_0.jpg,1178,31,387,418,364,402,True,5
3,87,kaist_dataset/Mixed/Digital_Camera/(C.S)F-others/DSC03224.JPG,char_data/3/DSC03224.JPG_0.jpg,4611,53,277,330,224,311,True,5
3,32,kaist_dataset/Mixed/Digital_Camera/(C.S)F-others/2007-12-08-day-044.jpg,char_data/3/2007-12-08-day-044.jpg_0.jpg,448,14,1054,1068,829,861,True,5
3,44,kaist_dataset/Mixed/Digital_Camera/(C.S)F-others/DSC02893.JPG,char_data/3/DSC02893.JPG_0.jpg,1452,33,416,449,332,376,True,5
3,40,kaist_dataset/Mixed/Digital_Camera/(C.S)F-others/DSC02893.JPG,char_data/3/DSC02893.JPG_0.jpg,1560,39,486,525,324,364,True,5
3,51,kaist_dataset/Mixed/Digital_Camera/(C.S)F-others/2007-12-09-day-exterior-023.jpg,char_data/3/2007-12-09-day-exterior-023.jpg_0.jpg,1887,37,1012,1049,592,643,True,5
3,43,kaist_dataset/Mixed/Digital_Camera/(C.S)D-indoor2/DSC04256.JPG,char_data/3/DSC04256.JPG_0.jpg,817,19,499,518,146,189,True,5
3,42,kaist_dataset/Mixed/Digital_Camera/(C.S)D-indoor2/DSC04256.JPG,char_data/3/DSC04256.JPG_0.jpg,882,21,547,568,151,193,True,5
3,80,kaist_dataset/Mixed/Digital_Camera/(C.S)D-indoor2/DSC04463.JPG,char_data/3/DSC04463.JPG_0.jpg,6880,86,467,553,38,118,True,5
3,37,kaist_dataset/Mixed/Digital_Camera/(C.S)E-night/DSC02647.JPG,char_data/3/DSC02647.JPG_0.jpg,999,27,248,275,279,316,True,5
3,62,kaist_dataset/Mixed/Digital_Camera/(C.S)E-night/DSC02574.JPG,char_data/3/DSC02574.JPG_0.jpg,1860,30,349,379,411,473,True,5
3,58,kaist_dataset/Mixed/Digital_Camera/(C.S)E-night/DSC02574.JPG,char_data/3/DSC02574.JPG_0.jpg,1798,31,507,538,407,465,True,5
3,31,kaist_dataset/Mixed/Digital_Camera/(C.S)E-night/DSC02585.JPG,char_data/3/DSC02585.JPG_0.jpg,682,22,370,392,418,449,True,5
3,37,kaist_dataset/Mixed/Digital_Camera/(C.S)E-night/DSC02644.JPG,char_data/3/DSC02644.JPG_0.jpg,814,22,334,356,399,436,True,5
3,37,kaist_dataset/Mixed/Digital_Camera/(C.S)E-night/DSC02644.JPG,char_data/3/DSC02644.JPG_0.jpg,629,17,412,429,399,436,True,5
3,27,kaist_dataset/Mixed/Digital_Camera/(C.S)E-night/DSC02644.JPG,char_data/3/DSC02644.JPG_0.jpg,594,22,430,452,409,436,True,5
3,50,kaist_dataset/Mixed/Digital_Camera/(C.S)E-night/DSC02575.JPG,char_data/3/DSC02575.JPG_0.jpg,1450,29,538,567,366,416,True,5
3,33,kaist_dataset/Mixed/Digital_Camera/(C.S)E-night/DSC02673.JPG,char_data/3/DSC02673.JPG_0.jpg,561,17,538,555,303,336,True,5
3,37,kaist_dataset/Mixed/Digital_Camera/(C.S)E-night/DSC02673.JPG,char_data/3/DSC02673.JPG_0.jpg,592,16,554,570,302,339,True,5
3,31,kaist_dataset/Mixed/Digital_Camera/(C.S)E-night/DSC02623.JPG,char_data/3/DSC02623.JPG_0.jpg,496,16,181,197,399,430,True,5
3,74,kaist_dataset/Mixed/Digital_Camera/(C.S)E-night/DSC02600.JPG,char_data/3/DSC02600.JPG_0.jpg,5106,69,97,166,388,462,True,5
3,37,kaist_dataset/Mixed/Digital_Camera/(C.S)E-night/DSC02903.JPG,char_data/3/DSC02903.JPG_0.jpg,592,16,354,370,263,300,True,5
3,56,kaist_dataset/Mixed/Digital_Camera/(C.S)E-night/DSC02573.JPG,char_data/3/DSC02573.JPG_0.jpg,2128,38,377,415,170,226,True,5
3,55,kaist_dataset/Mixed/Digital_Camera/(C.S)E-night/P1010147.JPG,char_data/3/P1010147.JPG_0.jpg,2090,38,388,426,256,311,True,5
3,33,kaist_dataset/Mixed/Digital_Camera/(C.S)B-light/DSC03298.JPG,char_data/3/DSC03298.JPG_0.jpg,462,14,387,401,287,320,True,5
3,119,kaist_dataset/Mixed/Digital_Camera/(C.S)D-indoor1/DSC03455.JPG,char_data/3/DSC03455.JPG_0.jpg,11662,98,168,266,53,172,True,5
3,99,kaist_dataset/Mixed/Digital_Camera/(C.S)D-indoor1/DSC03478.JPG,char_data/3/DSC03478.JPG_0.jpg,7425,75,91,166,99,198,True,5
3,50,kaist_dataset/Mixed/Digital_Camera/(C.S)D-indoor1/DSC03986.JPG,char_data/3/DSC03986.JPG_0.jpg,850,17,327,344,160,210,True,5
3,43,kaist_dataset/Mixed/Digital_Camera/(C.S)D-indoor1/DSC03980.JPG,char_data/3/DSC03980.JPG_0.jpg,1677,39,463,502,314,357,True,5
3,227,kaist_dataset/Mixed/Digital_Camera/(C.S)D-indoor1/DSC02724.JPG,char_data/3/DSC02724.JPG_0.jpg,39725,175,130,305,170,397,True,5
3,44,kaist_dataset/Mixed/Digital_Camera/(C.S)C-outdoor5/DSC04098.JPG,char_data/3/DSC04098.JPG_0.jpg,616,14,465,479,311,355,True,5
3,73,kaist_dataset/Mixed/Digital_Camera/(C.S)C-outdoor5/DSC04290.JPG,char_data/3/DSC04290.JPG_0.jpg,3942,54,449,503,339,412,True,5
3,76,kaist_dataset/Mixed/Digital_Camera/(C.S)C-outdoor5/DSC04153.JPG,char_data/3/DSC04153.JPG_0.jpg,5168,68,138,206,197,273,True,5
3,119,kaist_dataset/Mixed/Digital_Camera/(C.S)C-outdoor5/DSC04449.JPG,char_data/3/DSC04449.JPG_0.jpg,7259,61,421,482,35,154,True,5
3,32,kaist_dataset/Mixed/Digital_Camera/(C.S)C-outdoor5/DSC04146.JPG,char_data/3/DSC04146.JPG_0.jpg,576,18,370,388,405,437,True,5
3,46,kaist_dataset/Mixed/Digital_Camera/(C.S)C-outdoor5/DSC04094.JPG,char_data/3/DSC04094.JPG_0.jpg,2116,46,280,326,385,431,True,5
3,31,kaist_dataset/Mixed/Digital_Camera/(C.S)C-outdoor5/DSC04072.JPG,char_data/3/DSC04072.JPG_0.jpg,372,12,527,539,350,381,True,5
3,42,kaist_dataset/Mixed/Digital_Camera/(C.S)C-outdoor5/DSC04337.JPG,char_data/3/DSC04337.JPG_0.jpg,966,23,470,493,320,362,True,5
3,37,kaist_dataset/Mixed/Digital_Camera/(C.S)C-outdoor5/DSC04330.JPG,char_data/3/DSC04330.JPG_0.jpg,1554,42,497,539,161,198,True,5
3,63,kaist_dataset/Mixed/Digital_Camera/(C.S)C-outdoor5/DSC04330.JPG,char_data/3/DSC04330.JPG_0.jpg,2079,33,532,565,356,419,True,5
3,64,kaist_dataset/Mixed/Digital_Camera/(C.S)C-outdoor5/DSC04364.JPG,char_data/3/DSC04364.JPG_0.jpg,2432,38,216,254,389,453,True,5
3,65,kaist_dataset/Mixed/Digital_Camera/(C.S)C-outdoor5/DSC04364.JPG,char_data/3/DSC04364.JPG_0.jpg,2535,39,360,399,391,456,True,5
3,67,kaist_dataset/Mixed/Digital_Camera/(C.S)C-outdoor5/DSC04364.JPG,char_data/3/DSC04364.JPG_0.jpg,2345,35,397,432,390,457,True,5
3,35,kaist_dataset/Mixed/Digital_Camera/(C.S)C-outdoor5/DSC04122.JPG,char_data/3/DSC04122.JPG_0.jpg,455,13,346,359,412,447,True,5
3,32,kaist_dataset/Mixed/Digital_Camera/(C.S)C-outdoor5/DSC04124.JPG,char_data/3/DSC04124.JPG_0.jpg,512,16,510,526,307,339,True,5
3,42,kaist_dataset/Mixed/Digital_Camera/(C.S)C-outdoor5/DSC04071.JPG,char_data/3/DSC04071.JPG_0.jpg,1134,27,263,290,360,402,True,5
3,43,kaist_dataset/Mixed/Digital_Camera/(C.S)C-outdoor5/DSC04071.JPG,char_data/3/DSC04071.JPG_0.jpg,860,20,549,569,361,404,True,5
3,42,kaist_dataset/Mixed/Digital_Camera/(C.S)C-outdoor5/DSC04014.JPG,char_data/3/DSC04014.JPG_0.jpg,756,18,302,320,300,342,True,5
3,51,kaist_dataset/Mixed/Digital_Camera/(C.S)C-outdoor5/DSC04033.JPG,char_data/3/DSC04033.JPG_0.jpg,1785,35,529,564,264,315,True,5
3,23,kaist_dataset/Mixed/Digital_Camera/(C.S)C-outdoor5/DSC04031.JPG,char_data/3/DSC04031.JPG_0.jpg,230,10,486,496,381,404,True,5
3,27,kaist_dataset/Mixed/Digital_Camera/(C.S)C-outdoor5/DSC04031.JPG,char_data/3/DSC04031.JPG_0.jpg,324,12,180,192,381,408,True,5
3,29,kaist_dataset/Mixed/Digital_Camera/(C.S)C-outdoor5/DSC04048.JPG,char_data/3/DSC04048.JPG_0.jpg,464,16,391,407,172,201,True,5
3,29,kaist_dataset/Mixed/Digital_Camera/(C.S)C-outdoor5/DSC04048.JPG,char_data/3/DSC04048.JPG_0.jpg,464,16,416,432,172,201,True,5
3,39,kaist_dataset/Mixed/Digital_Camera/(C.S)C-outdoor5/DSC04135.JPG,char_data/3/DSC04135.JPG_0.jpg,1053,27,535,562,393,432,True,5
3,62,kaist_dataset/Mixed/Digital_Camera/(C.S)C-outdoor5/DSC04461.JPG,char_data/3/DSC04461.JPG_0.jpg,5022,81,308,389,343,405,True,5
3,30,kaist_dataset/Mixed/Digital_Camera/(C.S)C-outdoor3/DSC03316.JPG,char_data/3/DSC03316.JPG_0.jpg,390,13,245,258,90,120,True,5
3,41,kaist_dataset/Mixed/Digital_Camera/(C.S)C-outdoor3/DSC03316.JPG,char_data/3/DSC03316.JPG_0.jpg,533,13,401,414,78,119,True,5
3,32,kaist_dataset/Mixed/Digital_Camera/(C.S)C-outdoor3/DSC03316.JPG,char_data/3/DSC03316.JPG_0.jpg,448,14,580,594,80,112,True,5
3,25,kaist_dataset/Mixed/Digital_Camera/(C.S)C-outdoor3/DSC03292.JPG,char_data/3/DSC03292.JPG_0.jpg,400,16,591,607,120,145,True,5
3,55,kaist_dataset/Mixed/Digital_Camera/(C.S)C-outdoor3/DSC03199.JPG,char_data/3/DSC03199.JPG_0.jpg,1760,32,247,279,324,379,True,5
3,59,kaist_dataset/Mixed/Digital_Camera/(C.S)C-outdoor3/DSC03199.JPG,char_data/3/DSC03199.JPG_0.jpg,2478,42,464,506,321,380,True,5
3,56,kaist_dataset/Mixed/Digital_Camera/(C.S)C-outdoor3/DSC03199.JPG,char_data/3/DSC03199.JPG_0.jpg,2072,37,515,552,321,377,True,5
3,37,kaist_dataset/Mixed/Digital_Camera/(C.S)C-outdoor3/DSC03062.JPG,char_data/3/DSC03062.JPG_0.jpg,666,18,364,382,243,280,True,5
3,46,kaist_dataset/Mixed/Digital_Camera/(C.S)C-outdoor3/DSC03187.JPG,char_data/3/DSC03187.JPG_0.jpg,1380,30,393,423,389,435,True,5
3,50,kaist_dataset/Mixed/Digital_Camera/(C.S)C-outdoor3/DSC03212.JPG,char_data/3/DSC03212.JPG_0.jpg,750,15,482,497,250,300,True,5
3,35,kaist_dataset/Mixed/Digital_Camera/(C.S)C-outdoor3/DSC03301.JPG,char_data/3/DSC03301.JPG_0.jpg,1015,29,538,567,136,171,True,5
3,57,kaist_dataset/Mixed/Digital_Camera/(C.S)C-outdoor3/DSC03314.JPG,char_data/3/DSC03314.JPG_0.jpg,1710,30,458,488,363,420,True,5
3,42,kaist_dataset/Mixed/Digital_Camera/(C.S)C-outdoor3/DSC03185.JPG,char_data/3/DSC03185.JPG_0.jpg,1764,42,290,332,151,193,True,5
3,57,kaist_dataset/Mixed/Digital_Camera/(C.S)C-outdoor3/DSC03267.JPG,char_data/3/DSC03267.JPG_0.jpg,2679,47,242,289,58,115,True,5
3,95,kaist_dataset/Mixed/Digital_Camera/(C.S)C-outdoor3/DSC03340.JPG,char_data/3/DSC03340.JPG_0.jpg,7790,82,291,373,252,347,True,5
3,37,kaist_dataset/Mixed/Digital_Camera/(C.S)C-outdoor3/DSC03250.JPG,char_data/3/DSC03250.JPG_0.jpg,703,19,577,596,404,441,True,5
3,36,kaist_dataset/Mixed/Digital_Camera/(C.S)C-outdoor3/DSC03259.JPG,char_data/3/DSC03259.JPG_0.jpg,612,17,380,397,358,394,True,5
3,26,kaist_dataset/Mixed/Digital_Camera/(C.S)C-outdoor6/P1010082.JPG,char_data/3/P1010082.JPG_0.jpg,494,19,502,521,231,257,True,5
3,27,kaist_dataset/Mixed/Digital_Camera/(C.S)C-outdoor6/DSC03324.JPG,char_data/3/DSC03324.JPG_0.jpg,486,18,492,510,152,179,True,5
3,27,kaist_dataset/Mixed/Digital_Camera/(C.S)C-outdoor6/P1010094.JPG,char_data/3/P1010094.JPG_0.jpg,567,21,504,525,217,244,True,5
3,39,kaist_dataset/Mixed/Digital_Camera/(C.S)C-outdoor6/P1010120.JPG,char_data/3/P1010120.JPG_0.jpg,975,25,423,448,192,231,True,5
3,34,kaist_dataset/Mixed/Digital_Camera/(C.S)C-outdoor6/P1010080.JPG,char_data/3/P1010080.JPG_0.jpg,952,28,549,577,251,285,True,5
3,31,kaist_dataset/Mixed/Digital_Camera/(C.S)C-outdoor6/P1010138.JPG,char_data/3/P1010138.JPG_0.jpg,682,22,474,496,185,216,True,5
3,28,kaist_dataset/Mixed/Digital_Camera/(C.S)C-outdoor6/P1010085.JPG,char_data/3/P1010085.JPG_0.jpg,616,22,432,454,154,182,True,5
3,80,kaist_dataset/Mixed/Digital_Camera/(C.S)C-outdoor6/P1010055.JPG,char_data/3/P1010055.JPG_0.jpg,4960,62,416,478,263,343,True,5
3,26,kaist_dataset/Mixed/Digital_Camera/(C.S)C-outdoor6/P1010114.JPG,char_data/3/P1010114.JPG_0.jpg,598,23,537,560,215,241,True,5
3,34,kaist_dataset/Mixed/Digital_Camera/(C.S)C-outdoor6/P1010065.JPG,char_data/3/P1010065.JPG_0.jpg,748,22,407,429,227,261,True,5
3,33,kaist_dataset/Mixed/Digital_Camera/(C.S)C-outdoor6/P1010065.JPG,char_data/3/P1010065.JPG_0.jpg,759,23,429,452,229,262,True,5
3,40,kaist_dataset/Mixed/Digital_Camera/(C.S)C-outdoor6/P1010018.JPG,char_data/3/P1010018.JPG_0.jpg,960,24,253,277,240,280,True,5
3,30,kaist_dataset/Mixed/Digital_Camera/(C.S)C-outdoor6/P1010132.JPG,char_data/3/P1010132.JPG_0.jpg,780,26,482,508,94,124,True,5
3,21,kaist_dataset/Mixed/Digital_Camera/(C.S)C-outdoor6/P1010097.JPG,char_data/3/P1010097.JPG_0.jpg,441,21,491,512,190,211,True,5
3,54,kaist_dataset/Mixed/Digital_Camera/(C.S)C-outdoor6/P1010087.JPG,char_data/3/P1010087.JPG_0.jpg,1890,35,479,514,179,233,True,5
3,25,kaist_dataset/Mixed/Digital_Camera/(C.S)C-outdoor6/117.JPG,char_data/3/117.JPG_0.jpg,325,13,514,527,262,287,True,5
3,35,kaist_dataset/Mixed/Digital_Camera/(C.S)C-outdoor6/P1010074.JPG,char_data/3/P1010074.JPG_0.jpg,1365,39,236,275,307,342,False,5
3,33,kaist_dataset/Mixed/Digital_Camera/(C.S)C-outdoor4/DSC03730.JPG,char_data/3/DSC03730.JPG_0.jpg,693,21,374,395,255,288,False,5
3,57,kaist_dataset/Mixed/Digital_Camera/(C.S)C-outdoor4/DSC03738.JPG,char_data/3/DSC03738.JPG_0.jpg,2736,48,83,131,221,278,False,5
3,50,kaist_dataset/Mixed/Digital_Camera/(C.S)C-outdoor4/DSC03604.JPG,char_data/3/DSC03604.JPG_0.jpg,1350,27,277,304,80,130,False,5
3,31,kaist_dataset/Mixed/Digital_Camera/(C.S)C-outdoor4/DSC03570.JPG,char_data/3/DSC03570.JPG_0.jpg,403,13,361,374,421,452,False,5
3,36,kaist_dataset/Mixed/Digital_Camera/(C.S)C-outdoor4/DSC03435.JPG,char_data/3/DSC03435.JPG_0.jpg,576,16,498,514,417,453,False,5
3,39,kaist_dataset/Mixed/Digital_Camera/(C.S)C-outdoor4/DSC03675.JPG,char_data/3/DSC03675.JPG_0.jpg,741,19,530,549,342,381,False,5
3,37,kaist_dataset/Mixed/Digital_Camera/(C.S)C-outdoor4/DSC03691.JPG,char_data/3/DSC03691.JPG_0.jpg,629,17,424,441,219,256,False,5
3,34,kaist_dataset/Mixed/Digital_Camera/(C.S)C-outdoor4/DSC03691.JPG,char_data/3/DSC03691.JPG_0.jpg,646,19,470,489,222,256,False,5
3,36,kaist_dataset/Mixed/Digital_Camera/(C.S)C-outdoor4/DSC03691.JPG,char_data/3/DSC03691.JPG_0.jpg,612,17,599,616,218,254,False,5
3,50,kaist_dataset/Mixed/Digital_Camera/(C.S)C-outdoor4/DSC03617.JPG,char_data/3/DSC03617.JPG_0.jpg,1850,37,272,309,377,427,False,5
3,34,kaist_dataset/Mixed/Digital_Camera/(C.S)C-outdoor4/DSC03745.JPG,char_data/3/DSC03745.JPG_0.jpg,782,23,206,229,270,304,False,5
3,47,kaist_dataset/Mixed/Digital_Camera/(C.S)C-outdoor4/DSC03631.JPG,char_data/3/DSC03631.JPG_0.jpg,1175,25,294,319,355,402,False,5
3,38,kaist_dataset/Mixed/Digital_Camera/(C.S)C-outdoor4/DSC03781.JPG,char_data/3/DSC03781.JPG_0.jpg,1140,30,321,351,380,418,False,5
3,32,kaist_dataset/Mixed/Digital_Camera/(C.S)C-outdoor4/DSC03737.JPG,char_data/3/DSC03737.JPG_0.jpg,608,19,545,564,171,203,False,5
3,29,kaist_dataset/Mixed/Digital_Camera/(C.S)C-outdoor4/DSC03549.JPG,char_data/3/DSC03549.JPG_0.jpg,377,13,345,358,424,453,False,5
3,30,kaist_dataset/Mixed/Digital_Camera/(C.S)C-outdoor4/DSC03446.JPG,char_data/3/DSC03446.JPG_0.jpg,780,26,267,293,292,322,False,5
3,27,kaist_dataset/Mixed/Digital_Camera/(C.S)C-outdoor4/DSC03446.JPG,char_data/3/DSC03446.JPG_0.jpg,972,36,409,445,294,321,False,5
3,40,kaist_dataset/Mixed/Digital_Camera/(C.S)C-outdoor4/DSC03732.JPG,char_data/3/DSC03732.JPG_0.jpg,1000,25,373,398,392,432,False,5
3,35,kaist_dataset/Mixed/Digital_Camera/(C.S)C-outdoor4/DSC03673.JPG,char_data/3/DSC03673.JPG_0.jpg,735,21,220,241,307,342,False,5
3,37,kaist_dataset/Mixed/Digital_Camera/(C.S)C-outdoor4/DSC03673.JPG,char_data/3/DSC03673.JPG_0.jpg,740,20,328,348,305,342,False,5
3,39,kaist_dataset/Mixed/Digital_Camera/(C.S)C-outdoor4/DSC03665.JPG,char_data/3/DSC03665.JPG_0.jpg,1209,31,445,476,153,192,False,5
3,40,kaist_dataset/Mixed/Digital_Camera/(C.S)C-outdoor4/DSC03665.JPG,char_data/3/DSC03665.JPG_0.jpg,1560,39,475,514,153,193,False,5
3,42,kaist_dataset/Mixed/Digital_Camera/(C.S)C-outdoor4/DSC03679.JPG,char_data/3/DSC03679.JPG_0.jpg,966,23,359,382,277,319,False,5
3,26,kaist_dataset/Mixed/Digital_Camera/(C.S)C-outdoor4/DSC03735.JPG,char_data/3/DSC03735.JPG_0.jpg,546,21,516,537,152,178,False,5
3,43,kaist_dataset/Mixed/Digital_Camera/(C.S)C-outdoor4/DSC03724.JPG,char_data/3/DSC03724.JPG_0.jpg,1161,27,503,530,274,317,False,5
3,27,kaist_dataset/Mixed/Digital_Camera/(C.S)C-outdoor4/DSC03581.JPG,char_data/3/DSC03581.JPG_0.jpg,378,14,548,562,123,150,False,5
3,39,kaist_dataset/Mixed/Digital_Camera/(C.S)C-outdoor2/DSC02419.JPG,char_data/3/DSC02419.JPG_0.jpg,663,17,497,514,212,251,False,5
3,34,kaist_dataset/Mixed/Digital_Camera/(C.S)C-outdoor2/DSC02419.JPG,char_data/3/DSC02419.JPG_0.jpg,748,22,579,601,218,252,False,5
3,96,kaist_dataset/Mixed/Digital_Camera/(C.S)C-outdoor2/DSC02865.JPG,char_data/3/DSC02865.JPG_0.jpg,5184,54,355,409,309,405,False,5
3,32,kaist_dataset/Mixed/Digital_Camera/(C.S)C-outdoor2/DSC02447.JPG,char_data/3/DSC02447.JPG_0.jpg,384,12,505,517,225,257,False,5
3,28,kaist_dataset/Mixed/Digital_Camera/(C.S)C-outdoor2/DSC02555.JPG,char_data/3/DSC02555.JPG_0.jpg,700,25,110,135,251,279,False,5
3,29,kaist_dataset/Mixed/Digital_Camera/(C.S)C-outdoor2/DSC02477.JPG,char_data/3/DSC02477.JPG_0.jpg,725,25,93,118,253,282,False,5
3,56,kaist_dataset/Mixed/Digital_Camera/(C.S)C-outdoor2/DSC02400.JPG,char_data/3/DSC02400.JPG_0.jpg,1960,35,302,337,398,454,False,5
3,55,kaist_dataset/Mixed/Digital_Camera/(C.S)C-outdoor2/DSC02483.JPG,char_data/3/DSC02483.JPG_0.jpg,3355,61,25,86,295,350,False,5
3,75,kaist_dataset/Mixed/Digital_Camera/(C.S)C-outdoor2/DSC02502.JPG,char_data/3/DSC02502.JPG_0.jpg,5700,76,415,491,335,410,False,5
3,31,kaist_dataset/Mixed/Digital_Camera/(C.S)C-outdoor2/DSC02479.JPG,char_data/3/DSC02479.JPG_0.jpg,496,16,482,498,221,252,False,5
3,60,kaist_dataset/Mixed/Digital_Camera/(C.S)C-outdoor2/DSC02519.JPG,char_data/3/DSC02519.JPG_0.jpg,3000,50,107,157,154,214,False,5
3,34,kaist_dataset/Mixed/Digital_Camera/(C.S)C-outdoor2/DSC02368.JPG,char_data/3/DSC02368.JPG_0.jpg,510,15,158,173,384,418,False,5
3,39,kaist_dataset/Mixed/Digital_Camera/(C.S)C-outdoor2/DSC02368.JPG,char_data/3/DSC02368.JPG_0.jpg,741,19,528,547,380,419,False,5
3,45,kaist_dataset/Mixed/Digital_Camera/(C.S)C-outdoor2/DSC02545.JPG,char_data/3/DSC02545.JPG_0.jpg,1440,32,542,574,392,437,False,5
3,33,kaist_dataset/Mixed/Digital_Camera/(C.S)C-outdoor2/DSC02894.JPG,char_data/3/DSC02894.JPG_0.jpg,957,29,358,387,250,283,False,5
3,66,kaist_dataset/Mixed/Digital_Camera/(C.S)C-outdoor2/DSC02503.JPG,char_data/3/DSC02503.JPG_0.jpg,3366,51,263,314,349,415,False,5
3,68,kaist_dataset/Mixed/Digital_Camera/(C.S)C-outdoor2/DSC02503.JPG,char_data/3/DSC02503.JPG_0.jpg,3060,45,366,411,348,416,False,5
3,35,kaist_dataset/Mixed/Digital_Camera/(C.S)C-outdoor2/DSC02895.JPG,char_data/3/DSC02895.JPG_0.jpg,665,19,282,301,354,389,False,5
3,48,kaist_dataset/Mixed/Digital_Camera/(C.S)C-outdoor2/DSC02490.JPG,char_data/3/DSC02490.JPG_0.jpg,1104,23,378,401,340,388,False,5
3,40,kaist_dataset/Mixed/Digital_Camera/(C.S)C-outdoor2/DSC02937.JPG,char_data/3/DSC02937.JPG_0.jpg,920,23,241,264,199,239,False,5
3,40,kaist_dataset/Mixed/Digital_Camera/(C.S)C-outdoor2/DSC02376.JPG,char_data/3/DSC02376.JPG_0.jpg,840,21,556,577,334,374,False,5
3,35,kaist_dataset/Mixed/Digital_Camera/(C.S)C-outdoor2/DSC02489.JPG,char_data/3/DSC02489.JPG_0.jpg,700,20,301,321,263,298,False,5
3,43,kaist_dataset/Mixed/Digital_Camera/(C.S)C-outdoor2/DSC02511.JPG,char_data/3/DSC02511.JPG_0.jpg,1161,27,289,316,393,436,False,5
3,44,kaist_dataset/Mixed/Digital_Camera/(C.S)C-outdoor2/DSC02511.JPG,char_data/3/DSC02511.JPG_0.jpg,1188,27,336,363,400,444,False,5
3,50,kaist_dataset/Mixed/Digital_Camera/(C.S)C-outdoor2/DSC02511.JPG,char_data/3/DSC02511.JPG_0.jpg,1350,27,411,438,396,446,False,5
3,32,kaist_dataset/Mixed/Digital_Camera/(C.S)C-outdoor2/DSC02466.JPG,char_data/3/DSC02466.JPG_0.jpg,864,27,319,346,257,289,False,5
3,29,kaist_dataset/Mixed/Digital_Camera/(C.S)C-outdoor2/DSC02877.JPG,char_data/3/DSC02877.JPG_0.jpg,406,14,578,592,219,248,False,5
3,28,kaist_dataset/Mixed/Digital_Camera/(C.S)C-outdoor2/DSC02877.JPG,char_data/3/DSC02877.JPG_0.jpg,532,19,592,611,219,247,False,5
3,33,kaist_dataset/Mixed/Digital_Camera/(C.S)C-outdoor2/DSC02557.JPG,char_data/3/DSC02557.JPG_0.jpg,825,25,409,434,214,247,False,5
3,36,kaist_dataset/Mixed/Digital_Camera/(C.S)C-outdoor2/DSC02557.JPG,char_data/3/DSC02557.JPG_0.jpg,756,21,471,492,209,245,False,5
3,36,kaist_dataset/Mixed/Digital_Camera/(C.S)C-outdoor2/DSC02926.JPG,char_data/3/DSC02926.JPG_0.jpg,792,22,487,509,150,186,False,5
3,37,kaist_dataset/Mixed/Digital_Camera/(C.S)C-outdoor2/DSC02543.JPG,char_data/3/DSC02543.JPG_0.jpg,666,18,357,375,349,386,False,5
3,32,kaist_dataset/Mixed/Digital_Camera/(C.S)C-outdoor2/DSC02543.JPG,char_data/3/DSC02543.JPG_0.jpg,640,20,455,475,348,380,False,5
3,41,kaist_dataset/Mixed/Digital_Camera/(C.S)C-outdoor2/DSC02885.JPG,char_data/3/DSC02885.JPG_0.jpg,820,20,558,578,63,104,False,5
3,32,kaist_dataset/Mixed/Digital_Camera/(C.S)C-outdoor2/DSC02379.JPG,char_data/3/DSC02379.JPG_0.jpg,448,14,430,444,289,321,False,5
3,33,kaist_dataset/Mixed/Digital_Camera/(C.S)C-outdoor2/DSC02379.JPG,char_data/3/DSC02379.JPG_0.jpg,594,18,487,505,290,323,False,5
3,37,kaist_dataset/Mixed/Digital_Camera/(C.S)C-outdoor2/DSC02379.JPG,char_data/3/DSC02379.JPG_0.jpg,703,19,505,524,287,324,False,5
3,40,kaist_dataset/Mixed/Digital_Camera/(C.S)C-outdoor2/DSC02389.JPG,char_data/3/DSC02389.JPG_0.jpg,1440,36,202,238,256,296,False,5
3,40,kaist_dataset/Mixed/Digital_Camera/(C.S)C-outdoor2/DSC02389.JPG,char_data/3/DSC02389.JPG_0.jpg,1400,35,274,309,252,292,False,5
3,37,kaist_dataset/Mixed/Digital_Camera/(C.S)C-outdoor2/DSC02389.JPG,char_data/3/DSC02389.JPG_0.jpg,2035,55,375,430,248,285,False,5
3,44,kaist_dataset/Mixed/Digital_Camera/(C.S)C-outdoor2/DSC02377.JPG,char_data/3/DSC02377.JPG_0.jpg,968,22,580,602,352,396,False,5
3,22,kaist_dataset/Mixed/Digital_Camera/(C.S)C-outdoor2/P1010015.JPG,char_data/3/P1010015.JPG_0.jpg,220,10,262,272,186,208,False,5
3,20,kaist_dataset/Mixed/Digital_Camera/(C.S)C-outdoor2/P1010015.JPG,char_data/3/P1010015.JPG_0.jpg,240,12,369,381,188,208,False,5
3,25,kaist_dataset/Mixed/Digital_Camera/(C.S)C-outdoor2/P1010015.JPG,char_data/3/P1010015.JPG_0.jpg,325,13,402,415,188,213,False,5
3,35,kaist_dataset/Mixed/Digital_Camera/(C.S)A-shadow/DSC03257.JPG,char_data/3/DSC03257.JPG_0.jpg,700,20,298,318,384,419,False,5
3,67,kaist_dataset/Mixed/Digital_Camera/(C.S)A-shadow/DSC04326.JPG,char_data/3/DSC04326.JPG_0.jpg,1809,27,479,506,16,83,False,5
3,39,kaist_dataset/Mixed/Digital_Camera/(C.S)A-shadow/DSC02581.JPG,char_data/3/DSC02581.JPG_0.jpg,1482,38,390,428,389,428,False,5
3,74,kaist_dataset/English/Mobile_Phone/(E.M)B-indoor/P090902018.jpg,char_data/3/P090902018.jpg_0.jpg,3034,41,194,235,164,238,False,5
3,75,kaist_dataset/English/Mobile_Phone/(E.M)B-indoor/P090902018.jpg,char_data/3/P090902018.jpg_0.jpg,2625,35,257,292,289,364,False,5
3,184,kaist_dataset/English/Digital_Camera/(E.S)C-outdoor2/DSC02949.JPG,char_data/3/DSC02949.JPG_0.jpg,7176,39,352,391,59,243,False,5
3,67,kaist_dataset/English/Digital_Camera/(E.S)C-outdoor2/DSC04163.JPG,char_data/3/DSC04163.JPG_0.jpg,2613,39,233,272,315,382,False,5
3,64,kaist_dataset/English/Digital_Camera/(E.S)C-outdoor2/DSC04163.JPG,char_data/3/DSC04163.JPG_0.jpg,2816,44,338,382,315,379,False,5
3,35,kaist_dataset/English/Digital_Camera/(E.S)C-outdoor2/DSC03162.JPG,char_data/3/DSC03162.JPG_0.jpg,665,19,566,585,146,181,False,5
3,24,kaist_dataset/English/Digital_Camera/(E.S)C-outdoor1/042.JPG,char_data/3/042.JPG_0.jpg,288,12,518,530,320,344,False,5
3,51,kaist_dataset/English/Digital_Camera/(E.S)C-outdoor1/080116-0065.jpg,char_data/3/080116-0065.jpg_0.jpg,969,19,215,234,363,414,False,5
3,37,kaist_dataset/English/Digital_Camera/(E.S)C-outdoor1/DSC02364.JPG,char_data/3/DSC02364.JPG_0.jpg,518,14,582,596,352,389,False,5
3,27,kaist_dataset/English/Digital_Camera/(E.S)B-light/080116-0059.jpg,char_data/3/080116-0059.jpg_0.jpg,405,15,630,645,953,980,False,5
3,52,kaist_dataset/English/Digital_Camera/(E.S)F-others/2007-12-09-day-exterior-047.jpg,char_data/3/2007-12-09-day-exterior-047.jpg_0.jpg,728,14,44,58,578,630,False,5
3,47,kaist_dataset/English/Digital_Camera/(E.S)F-others/2007-12-09-day-exterior-047.jpg,char_data/3/2007-12-09-day-exterior-047.jpg_0.jpg,658,14,58,72,587,634,False,5
3,41,kaist_dataset/English/Digital_Camera/(E.S)F-others/2007-12-09-day-exterior-047.jpg,char_data/3/2007-12-09-day-exterior-047.jpg_0.jpg,533,13,87,100,601,642,False,5
3,34,kaist_dataset/English/Digital_Camera/(E.S)D-indoor/DSC03943.JPG,char_data/3/DSC03943.JPG_0.jpg,510,15,376,391,311,345,False,5
O,55,kaist_dataset/Korean/Digital_Camera/outdoor2/2007-12-08-day-101.jpg,char_data/O/2007-12-08-day-101.jpg_2.jpg,2805,51,186,237,1093,1148,True,25
O,72,kaist_dataset/Korean/Digital_Camera/outdoor2/2007-12-09-day-exterior-068.jpg,char_data/O/2007-12-09-day-exterior-068.jpg_0.jpg,4104,57,540,597,955,1027,True,25
O,26,kaist_dataset/Korean/Digital_Camera/indoor1/080119-0029.jpg,char_data/O/080119-0029.jpg_0.jpg,546,21,885,906,657,683,True,25
O,19,kaist_dataset/Korean/Digital_Camera/indoor1/146.JPG,char_data/O/146.JPG_0.jpg,304,16,291,307,267,286,True,25
O,15,kaist_dataset/Korean/Digital_Camera/indoor1/146.JPG,char_data/O/146.JPG_0.jpg,150,10,337,347,271,286,True,25
O,56,kaist_dataset/Mixed/Mobile_Phone/(C.M)C-bookCover/P090903092.jpg,char_data/O/P090903092.jpg_0.jpg,2296,41,487,528,202,258,True,25
O,39,kaist_dataset/Mixed/Mobile_Phone/(C.M)C-bookCover/P090831062.jpg,char_data/O/P090831062.jpg_0.jpg,1443,37,54,91,307,346,True,25
O,108,kaist_dataset/Mixed/Digital_Camera/(C.S)C-outdoor1/027.JPG,char_data/O/027.JPG_0.jpg,7776,72,231,303,158,266,True,25
O,23,kaist_dataset/Mixed/Digital_Camera/(C.S)C-outdoor1/DSC02319.JPG,char_data/O/DSC02319.JPG_0.jpg,575,25,85,110,249,272,True,25
O,82,kaist_dataset/Mixed/Digital_Camera/(C.S)C-outdoor1/046.JPG,char_data/O/046.JPG_0.jpg,3936,48,438,486,186,268,True,25
O,49,kaist_dataset/Mixed/Digital_Camera/(C.S)C-outdoor1/080116-0084.jpg,char_data/O/080116-0084.jpg_0.jpg,2205,45,402,447,300,349,True,25
O,179,kaist_dataset/Mixed/Digital_Camera/(C.S)C-outdoor1/080119-0017.jpg,char_data/O/080119-0017.jpg_0.jpg,26671,149,441,590,557,736,True,25
O,163,kaist_dataset/Mixed/Digital_Camera/(C.S)C-outdoor1/080119-0017.jpg,char_data/O/080119-0017.jpg_0.jpg,21353,131,1131,1262,551,714,True,25
O,148,kaist_dataset/Mixed/Digital_Camera/(C.S)C-outdoor1/038.JPG,char_data/O/038.JPG_0.jpg,23384,158,22,180,154,302,True,25
O,30,kaist_dataset/Mixed/Digital_Camera/(C.S)C-outdoor1/114.jpg,char_data/O/114.jpg_0.jpg,1080,36,214,250,269,299,True,25
O,22,kaist_dataset/Mixed/Digital_Camera/(C.S)C-outdoor1/114.jpg,char_data/O/114.jpg_0.jpg,506,23,202,225,366,388,True,25
O,53,kaist_dataset/Mixed/Digital_Camera/(C.S)C-outdoor1/080119-0006.jpg,char_data/O/080119-0006.jpg_0.jpg,3180,60,611,671,736,789,True,25
O,63,kaist_dataset/Mixed/Digital_Camera/(C.S)C-outdoor1/080119-0006.jpg,char_data/O/080119-0006.jpg_0.jpg,3654,58,882,940,734,797,True,25
O,26,kaist_dataset/Mixed/Digital_Camera/(C.S)C-outdoor1/DSC02240.JPG,char_data/O/DSC02240.JPG_0.jpg,754,29,116,145,289,315,True,25
O,28,kaist_dataset/Mixed/Digital_Camera/(C.S)C-outdoor1/DSC02240.JPG,char_data/O/DSC02240.JPG_0.jpg,700,25,397,422,288,316,True,25
O,26,kaist_dataset/Mixed/Digital_Camera/(C.S)C-outdoor1/DSC02240.JPG,char_data/O/DSC02240.JPG_0.jpg,754,29,147,176,284,310,True,25
O,112,kaist_dataset/Mixed/Digital_Camera/(C.S)C-outdoor1/008.JPG,char_data/O/008.JPG_0.jpg,7280,65,254,319,137,249,True,25
O,115,kaist_dataset/Mixed/Digital_Camera/(C.S)C-outdoor1/008.JPG,char_data/O/008.JPG_0.jpg,7360,64,529,593,134,249,True,25
O,22,kaist_dataset/Mixed/Digital_Camera/(C.S)C-outdoor1/3.JPG,char_data/O/3.JPG_0.jpg,396,18,259,277,63,85,True,25
O,25,kaist_dataset/Mixed/Digital_Camera/(C.S)C-outdoor1/3.JPG,char_data/O/3.JPG_0.jpg,450,18,293,311,60,85,True,25
O,27,kaist_dataset/Mixed/Digital_Camera/(C.S)C-outdoor1/3.JPG,char_data/O/3.JPG_0.jpg,486,18,462,480,52,79,True,25
O,32,kaist_dataset/Mixed/Digital_Camera/(C.S)C-outdoor1/3.JPG,char_data/O/3.JPG_0.jpg,736,23,497,520,51,83,True,25
O,24,kaist_dataset/Mixed/Digital_Camera/(C.S)C-outdoor1/3.JPG,char_data/O/3.JPG_0.jpg,240,10,637,647,291,315,True,25
O,72,kaist_dataset/Mixed/Digital_Camera/(C.S)C-outdoor1/080119-0027.jpg,char_data/O/080119-0027.jpg_0.jpg,3672,51,923,974,720,792,True,25
O,50,kaist_dataset/Mixed/Digital_Camera/(C.S)C-outdoor1/080119-0027.jpg,char_data/O/080119-0027.jpg_0.jpg,1900,38,1038,1076,1050,1100,True,25
O,52,kaist_dataset/Mixed/Digital_Camera/(C.S)C-outdoor1/P1010009.JPG,char_data/O/P1010009.JPG_0.jpg,2860,55,272,327,185,237,True,25
O,26,kaist_dataset/Mixed/Digital_Camera/(C.S)C-outdoor1/054.JPG,char_data/O/054.JPG_0.jpg,780,30,242,272,278,304,True,25
O,28,kaist_dataset/Mixed/Digital_Camera/(C.S)C-outdoor1/054.JPG,char_data/O/054.JPG_0.jpg,728,26,272,298,277,305,True,25
O,149,kaist_dataset/Mixed/Digital_Camera/(C.S)C-outdoor1/080119-0003.jpg,char_data/O/080119-0003.jpg_0.jpg,15347,103,566,669,125,274,True,25
O,141,kaist_dataset/Mixed/Digital_Camera/(C.S)C-outdoor1/080119-0003.jpg,char_data/O/080119-0003.jpg_0.jpg,13677,97,821,918,128,269,True,25
O,117,kaist_dataset/Mixed/Digital_Camera/(C.S)C-outdoor1/080119-0037.jpg,char_data/O/080119-0037.jpg_0.jpg,9945,85,96,181,885,1002,True,25
O,117,kaist_dataset/Mixed/Digital_Camera/(C.S)C-outdoor1/080119-0037.jpg,char_data/O/080119-0037.jpg_0.jpg,7605,65,1307,1372,826,943,True,25
O,29,kaist_dataset/Mixed/Digital_Camera/(C.S)C-outdoor1/2007-12-09-day-exterior-051.jpg,char_data/O/2007-12-09-day-exterior-051.jpg_0.jpg,638,22,526,548,609,638,True,25
O,53,kaist_dataset/Mixed/Digital_Camera/(C.S)C-outdoor1/2007-12-08-day-130.jpg,char_data/O/2007-12-08-day-130.jpg_0.jpg,2650,50,584,634,689,742,True,25
O,45,kaist_dataset/Mixed/Digital_Camera/(C.S)C-outdoor1/2007-12-08-day-130.jpg,char_data/O/2007-12-08-day-130.jpg_0.jpg,2070,46,636,682,693,738,True,25
O,31,kaist_dataset/Mixed/Digital_Camera/(C.S)C-outdoor1/DSC02318.JPG,char_data/O/DSC02318.JPG_0.jpg,1147,37,378,415,324,355,True,25
O,64,kaist_dataset/Mixed/Digital_Camera/(C.S)C-outdoor1/2.JPG,char_data/O/2.JPG_0.jpg,3008,47,464,511,206,270,True,25
O,25,kaist_dataset/Mixed/Digital_Camera/(C.S)C-outdoor1/2.JPG,char_data/O/2.JPG_0.jpg,375,15,601,616,370,395,True,25
O,51,kaist_dataset/Mixed/Digital_Camera/(C.S)C-outdoor1/DSC02325.JPG,char_data/O/DSC02325.JPG_0.jpg,2040,40,345,385,244,295,True,25
O,40,kaist_dataset/Mixed/Digital_Camera/(C.S)C-outdoor1/DSC02325.JPG,char_data/O/DSC02325.JPG_0.jpg,1840,46,383,429,244,284,True,25
O,112,kaist_dataset/Mixed/Digital_Camera/(C.S)F-others/DSC02504.JPG,char_data/O/DSC02504.JPG_0.jpg,11536,103,231,334,187,299,True,25
O,67,kaist_dataset/Mixed/Digital_Camera/(C.S)F-others/58.JPG,char_data/O/58.JPG_0.jpg,3015,45,61,106,166,233,True,25
O,58,kaist_dataset/Mixed/Digital_Camera/(C.S)F-others/58.JPG,char_data/O/58.JPG_0.jpg,2610,45,166,211,179,237,True,25
O,35,kaist_dataset/Mixed/Digital_Camera/(C.S)F-others/097.jpg,char_data/O/097.jpg_0.jpg,385,11,312,323,165,200,True,25
O,84,kaist_dataset/Mixed/Digital_Camera/(C.S)E-night/DSC02660.JPG,char_data/O/DSC02660.JPG_0.jpg,6132,73,313,386,216,300,True,25
O,30,kaist_dataset/Mixed/Digital_Camera/(C.S)E-night/DSC02660.JPG,char_data/O/DSC02660.JPG_0.jpg,630,21,225,246,387,417,True,25
O,58,kaist_dataset/Mixed/Digital_Camera/(C.S)E-night/DSC03517.JPG,char_data/O/DSC03517.JPG_0.jpg,2204,38,428,466,192,250,True,25
O,36,kaist_dataset/Mixed/Digital_Camera/(C.S)E-night/DSC03871.JPG,char_data/O/DSC03871.JPG_0.jpg,1260,35,155,190,181,217,True,25
O,57,kaist_dataset/Mixed/Digital_Camera/(C.S)D-indoor1/DSC03959.JPG,char_data/O/DSC03959.JPG_0.jpg,3135,55,248,303,109,166,True,25
O,22,kaist_dataset/Mixed/Digital_Camera/(C.S)D-indoor1/DSC03959.JPG,char_data/O/DSC03959.JPG_0.jpg,418,19,279,298,190,212,True,25
O,41,kaist_dataset/Mixed/Digital_Camera/(C.S)D-indoor1/DSC03372.JPG,char_data/O/DSC03372.JPG_0.jpg,1558,38,73,111,404,445,True,25
O,36,kaist_dataset/Mixed/Digital_Camera/(C.S)D-indoor1/DSC03372.JPG,char_data/O/DSC03372.JPG_0.jpg,1512,42,110,152,415,451,True,25
O,39,kaist_dataset/Mixed/Digital_Camera/(C.S)D-indoor1/DSC03372.JPG,char_data/O/DSC03372.JPG_0.jpg,1755,45,455,500,403,442,True,25
O,141,kaist_dataset/Mixed/Digital_Camera/(C.S)D-indoor1/DSC04233.JPG,char_data/O/DSC04233.JPG_0.jpg,19881,141,321,462,16,157,True,25
O,122,kaist_dataset/Mixed/Digital_Camera/(C.S)D-indoor1/DSC02739.JPG,char_data/O/DSC02739.JPG_0.jpg,12566,103,215,318,350,472,True,25
O,50,kaist_dataset/Mixed/Digital_Camera/(C.S)D-indoor1/DSC04009.JPG,char_data/O/DSC04009.JPG_0.jpg,1800,36,235,271,399,449,True,25
O,49,kaist_dataset/Mixed/Digital_Camera/(C.S)D-indoor1/DSC04009.JPG,char_data/O/DSC04009.JPG_0.jpg,1764,36,379,415,399,448,True,25
O,46,kaist_dataset/Mixed/Digital_Camera/(C.S)D-indoor1/DSC04009.JPG,char_data/O/DSC04009.JPG_0.jpg,1380,30,420,450,403,449,True,25
O,110,kaist_dataset/Mixed/Digital_Camera/(C.S)D-indoor1/DSC02840.JPG,char_data/O/DSC02840.JPG_0.jpg,13310,121,173,294,118,228,True,25
O,120,kaist_dataset/Mixed/Digital_Camera/(C.S)D-indoor1/DSC02840.JPG,char_data/O/DSC02840.JPG_0.jpg,14640,122,177,299,239,359,True,25
O,158,kaist_dataset/Mixed/Digital_Camera/(C.S)D-indoor1/DSC04173.JPG,char_data/O/DSC04173.JPG_0.jpg,12324,78,100,178,314,472,True,25
O,39,kaist_dataset/Mixed/Digital_Camera/(C.S)D-indoor1/DSC03980.JPG,char_data/O/DSC03980.JPG_0.jpg,975,25,176,201,135,174,True,25
O,31,kaist_dataset/Mixed/Digital_Camera/(C.S)D-indoor1/DSC03980.JPG,char_data/O/DSC03980.JPG_0.jpg,775,25,361,386,144,175,True,25
O,38,kaist_dataset/Mixed/Digital_Camera/(C.S)D-indoor1/DSC03980.JPG,char_data/O/DSC03980.JPG_0.jpg,874,23,460,483,146,184,True,25
O,36,kaist_dataset/Mixed/Digital_Camera/(C.S)D-indoor1/DSC03980.JPG,char_data/O/DSC03980.JPG_0.jpg,720,20,563,583,150,186,True,25
O,103,kaist_dataset/Mixed/Digital_Camera/(C.S)D-indoor1/DSC03890.JPG,char_data/O/DSC03890.JPG_0.jpg,8652,84,284,368,238,341,True,25
O,46,kaist_dataset/Mixed/Digital_Camera/(C.S)D-indoor1/DSC02713.JPG,char_data/O/DSC02713.JPG_0.jpg,1932,42,174,216,151,197,True,25
O,43,kaist_dataset/Mixed/Digital_Camera/(C.S)D-indoor1/DSC02713.JPG,char_data/O/DSC02713.JPG_0.jpg,1935,45,342,387,156,199,True,25
O,48,kaist_dataset/Mixed/Digital_Camera/(C.S)C-outdoor5/DSC04098.JPG,char_data/O/DSC04098.JPG_0.jpg,1632,34,335,369,65,113,True,25
O,46,kaist_dataset/Mixed/Digital_Camera/(C.S)C-outdoor5/DSC04098.JPG,char_data/O/DSC04098.JPG_0.jpg,1840,40,423,463,75,121,True,25
O,25,kaist_dataset/Mixed/Digital_Camera/(C.S)C-outdoor5/DSC04360.JPG,char_data/O/DSC04360.JPG_0.jpg,300,12,79,91,316,341,True,25
O,24,kaist_dataset/Mixed/Digital_Camera/(C.S)C-outdoor5/DSC04360.JPG,char_data/O/DSC04360.JPG_0.jpg,312,13,91,104,318,342,True,25
O,34,kaist_dataset/Mixed/Digital_Camera/(C.S)C-outdoor5/DSC04360.JPG,char_data/O/DSC04360.JPG_0.jpg,510,15,102,117,380,414,True,25
O,34,kaist_dataset/Mixed/Digital_Camera/(C.S)C-outdoor5/DSC04360.JPG,char_data/O/DSC04360.JPG_0.jpg,510,15,117,132,380,414,True,25
O,62,kaist_dataset/Mixed/Digital_Camera/(C.S)C-outdoor5/DSC04060.JPG,char_data/O/DSC04060.JPG_0.jpg,2480,40,110,150,181,243,True,25
O,54,kaist_dataset/Mixed/Digital_Camera/(C.S)C-outdoor5/DSC04060.JPG,char_data/O/DSC04060.JPG_0.jpg,1998,37,306,343,100,154,True,25
O,54,kaist_dataset/Mixed/Digital_Camera/(C.S)C-outdoor5/DSC04060.JPG,char_data/O/DSC04060.JPG_0.jpg,1674,31,535,566,95,149,True,25
O,115,kaist_dataset/Mixed/Digital_Camera/(C.S)C-outdoor5/DSC04465.JPG,char_data/O/DSC04465.JPG_0.jpg,8050,70,347,417,278,393,True,25
O,153,kaist_dataset/Mixed/Digital_Camera/(C.S)C-outdoor5/DSC04451.JPG,char_data/O/DSC04451.JPG_0.jpg,13617,89,351,440,286,439,True,25
O,43,kaist_dataset/Mixed/Digital_Camera/(C.S)C-outdoor5/DSC04312.JPG,char_data/O/DSC04312.JPG_0.jpg,1161,27,425,452,105,148,True,25
O,44,kaist_dataset/Mixed/Digital_Camera/(C.S)C-outdoor5/DSC04312.JPG,char_data/O/DSC04312.JPG_0.jpg,1496,34,449,483,108,152,True,25
O,73,kaist_dataset/Mixed/Digital_Camera/(C.S)C-outdoor5/DSC04368.JPG,char_data/O/DSC04368.JPG_0.jpg,3577,49,321,370,274,347,True,25
O,63,kaist_dataset/Mixed/Digital_Camera/(C.S)C-outdoor5/DSC04349.JPG,char_data/O/DSC04349.JPG_0.jpg,3780,60,323,383,302,365,True,25
O,90,kaist_dataset/Mixed/Digital_Camera/(C.S)C-outdoor5/DSC03839.JPG,char_data/O/DSC03839.JPG_0.jpg,6930,77,302,379,199,289,True,25
O,51,kaist_dataset/Mixed/Digital_Camera/(C.S)C-outdoor5/DSC04119.JPG,char_data/O/DSC04119.JPG_0.jpg,1989,39,543,582,137,188,True,25
O,115,kaist_dataset/Mixed/Digital_Camera/(C.S)C-outdoor5/DSC03819.JPG,char_data/O/DSC03819.JPG_0.jpg,12880,112,109,221,66,181,True,25
O,43,kaist_dataset/Mixed/Digital_Camera/(C.S)C-outdoor5/DSC03819.JPG,char_data/O/DSC03819.JPG_0.jpg,946,22,432,454,367,410,True,25
O,78,kaist_dataset/Mixed/Digital_Camera/(C.S)C-outdoor5/DSC04401.JPG,char_data/O/DSC04401.JPG_0.jpg,5460,70,88,158,0,78,True,25
O,59,kaist_dataset/Mixed/Digital_Camera/(C.S)C-outdoor5/DSC04014.JPG,char_data/O/DSC04014.JPG_0.jpg,2950,50,351,401,99,158,True,25
O,51,kaist_dataset/Mixed/Digital_Camera/(C.S)C-outdoor5/DSC04129.JPG,char_data/O/DSC04129.JPG_0.jpg,2040,40,243,283,368,419,True,25
O,57,kaist_dataset/Mixed/Digital_Camera/(C.S)C-outdoor5/DSC04447.JPG,char_data/O/DSC04447.JPG_0.jpg,2850,50,444,494,344,401,True,25
O,48,kaist_dataset/Mixed/Digital_Camera/(C.S)C-outdoor5/DSC04338.JPG,char_data/O/DSC04338.JPG_0.jpg,1536,32,185,217,192,240,True,25
O,43,kaist_dataset/Mixed/Digital_Camera/(C.S)C-outdoor5/DSC04338.JPG,char_data/O/DSC04338.JPG_0.jpg,1462,34,213,247,196,239,True,25
O,37,kaist_dataset/Mixed/Digital_Camera/(C.S)C-outdoor5/DSC04434.JPG,char_data/O/DSC04434.JPG_0.jpg,999,27,313,340,390,427,True,25
O,78,kaist_dataset/Mixed/Digital_Camera/(C.S)C-outdoor3/DSC03055.JPG,char_data/O/DSC03055.JPG_0.jpg,6084,78,201,279,256,334,True,25
O,40,kaist_dataset/Mixed/Digital_Camera/(C.S)C-outdoor3/DSC03330.JPG,char_data/O/DSC03330.JPG_0.jpg,1280,32,149,181,390,430,True,25
O,33,kaist_dataset/Mixed/Digital_Camera/(C.S)C-outdoor3/DSC03330.JPG,char_data/O/DSC03330.JPG_0.jpg,1056,32,203,235,398,431,True,25
O,95,kaist_dataset/Mixed/Digital_Camera/(C.S)C-outdoor3/DSC03260.JPG,char_data/O/DSC03260.JPG_0.jpg,6555,69,280,349,65,160,True,25
O,46,kaist_dataset/Mixed/Digital_Camera/(C.S)C-outdoor3/DSC03331.JPG,char_data/O/DSC03331.JPG_0.jpg,1104,24,149,173,376,422,True,25
O,41,kaist_dataset/Mixed/Digital_Camera/(C.S)C-outdoor3/DSC03331.JPG,char_data/O/DSC03331.JPG_0.jpg,1271,31,194,225,380,421,True,25
O,70,kaist_dataset/Mixed/Digital_Camera/(C.S)C-outdoor3/DSC03048.JPG,char_data/O/DSC03048.JPG_0.jpg,3430,49,326,375,131,201,True,25
O,52,kaist_dataset/Mixed/Digital_Camera/(C.S)C-outdoor3/DSC03186.JPG,char_data/O/DSC03186.JPG_0.jpg,2340,45,58,103,103,155,True,25
O,28,kaist_dataset/Mixed/Digital_Camera/(C.S)C-outdoor3/DSC03035.JPG,char_data/O/DSC03035.JPG_0.jpg,728,26,352,378,372,400,True,25
O,33,kaist_dataset/Mixed/Digital_Camera/(C.S)C-outdoor3/DSC03035.JPG,char_data/O/DSC03035.JPG_0.jpg,660,20,349,369,402,435,True,25
O,37,kaist_dataset/Mixed/Digital_Camera/(C.S)C-outdoor3/DSC03035.JPG,char_data/O/DSC03035.JPG_0.jpg,888,24,369,393,400,437,True,25
O,57,kaist_dataset/Mixed/Digital_Camera/(C.S)C-outdoor3/DSC03306.JPG,char_data/O/DSC03306.JPG_0.jpg,1995,35,314,349,396,453,True,25
O,63,kaist_dataset/Mixed/Digital_Camera/(C.S)C-outdoor3/DSC03306.JPG,char_data/O/DSC03306.JPG_0.jpg,2394,38,506,544,390,453,True,25
O,162,kaist_dataset/Mixed/Digital_Camera/(C.S)C-outdoor3/DSC03006.JPG,char_data/O/DSC03006.JPG_0.jpg,13284,82,411,493,106,268,True,25
O,52,kaist_dataset/Mixed/Digital_Camera/(C.S)C-outdoor3/DSC03010.JPG,char_data/O/DSC03010.JPG_0.jpg,2288,44,283,327,96,148,True,25
O,47,kaist_dataset/Mixed/Digital_Camera/(C.S)C-outdoor3/DSC03010.JPG,char_data/O/DSC03010.JPG_0.jpg,1692,36,408,444,79,126,True,25
O,20,kaist_dataset/Mixed/Digital_Camera/(C.S)C-outdoor3/DSC03033.JPG,char_data/O/DSC03033.JPG_0.jpg,260,13,54,67,156,176,True,25
O,18,kaist_dataset/Mixed/Digital_Camera/(C.S)C-outdoor3/DSC03033.JPG,char_data/O/DSC03033.JPG_0.jpg,252,14,141,155,151,169,True,25
O,96,kaist_dataset/Mixed/Digital_Camera/(C.S)C-outdoor3/DSC03176.JPG,char_data/O/DSC03176.JPG_0.jpg,9120,95,122,217,269,365,True,25
O,39,kaist_dataset/Mixed/Digital_Camera/(C.S)C-outdoor3/DSC03329.JPG,char_data/O/DSC03329.JPG_0.jpg,1248,32,468,500,439,478,True,25
O,33,kaist_dataset/Mixed/Digital_Camera/(C.S)C-outdoor3/DSC03329.JPG,char_data/O/DSC03329.JPG_0.jpg,1056,32,530,562,445,478,True,25
O,36,kaist_dataset/Mixed/Digital_Camera/(C.S)C-outdoor3/DSC03254.JPG,char_data/O/DSC03254.JPG_0.jpg,1332,37,112,149,226,262,True,25
O,36,kaist_dataset/Mixed/Digital_Camera/(C.S)C-outdoor3/DSC03250.JPG,char_data/O/DSC03250.JPG_0.jpg,828,23,444,467,364,400,True,25
O,28,kaist_dataset/Mixed/Digital_Camera/(C.S)C-outdoor3/DSC03250.JPG,char_data/O/DSC03250.JPG_0.jpg,588,21,467,488,371,399,True,25
O,118,kaist_dataset/Mixed/Digital_Camera/(C.S)C-outdoor3/DSC03259.JPG,char_data/O/DSC03259.JPG_0.jpg,10502,89,181,270,72,190,True,25
O,35,kaist_dataset/Mixed/Digital_Camera/(C.S)C-outdoor3/DSC02986.JPG,char_data/O/DSC02986.JPG_0.jpg,1400,40,462,502,282,317,True,25
O,35,kaist_dataset/Mixed/Digital_Camera/(C.S)C-outdoor3/DSC03020.JPG,char_data/O/DSC03020.JPG_0.jpg,945,27,555,582,265,300,True,25
O,45,kaist_dataset/Mixed/Digital_Camera/(C.S)C-outdoor3/DSC02989.JPG,char_data/O/DSC02989.JPG_0.jpg,1575,35,395,430,264,309,True,25
O,44,kaist_dataset/Mixed/Digital_Camera/(C.S)C-outdoor3/DSC02989.JPG,char_data/O/DSC02989.JPG_0.jpg,1672,38,457,495,269,313,True,25
O,47,kaist_dataset/Mixed/Digital_Camera/(C.S)C-outdoor3/DSC02989.JPG,char_data/O/DSC02989.JPG_0.jpg,1645,35,564,599,268,315,True,25
O,33,kaist_dataset/Mixed/Digital_Camera/(C.S)C-outdoor3/DSC03271.JPG,char_data/O/DSC03271.JPG_0.jpg,1287,39,236,275,80,113,True,25
O,37,kaist_dataset/Mixed/Digital_Camera/(C.S)C-outdoor3/DSC03242.JPG,char_data/O/DSC03242.JPG_0.jpg,1184,32,191,223,319,356,True,25
O,40,kaist_dataset/Mixed/Digital_Camera/(C.S)C-outdoor3/DSC03242.JPG,char_data/O/DSC03242.JPG_0.jpg,1320,33,220,253,316,356,True,25
O,19,kaist_dataset/Mixed/Digital_Camera/(C.S)C-outdoor6/P1010063.JPG,char_data/O/P1010063.JPG_0.jpg,190,10,440,450,351,370,True,25
O,50,kaist_dataset/Mixed/Digital_Camera/(C.S)C-outdoor6/P1010063.JPG,char_data/O/P1010063.JPG_0.jpg,2050,41,308,349,334,384,True,25
O,32,kaist_dataset/Mixed/Digital_Camera/(C.S)C-outdoor6/P1010090.JPG,char_data/O/P1010090.JPG_0.jpg,736,23,441,464,198,230,True,25
O,19,kaist_dataset/Mixed/Digital_Camera/(C.S)C-outdoor6/P1010114.JPG,char_data/O/P1010114.JPG_0.jpg,323,17,328,345,222,241,True,25
O,17,kaist_dataset/Mixed/Digital_Camera/(C.S)C-outdoor6/P1010065.JPG,char_data/O/P1010065.JPG_0.jpg,153,9,71,80,108,125,True,25
O,44,kaist_dataset/Mixed/Digital_Camera/(C.S)C-outdoor6/P1010132.JPG,char_data/O/P1010132.JPG_0.jpg,1980,45,375,420,157,201,True,25
O,34,kaist_dataset/Mixed/Digital_Camera/(C.S)C-outdoor4/DSC03716.JPG,char_data/O/DSC03716.JPG_0.jpg,578,17,271,288,239,273,True,25
O,34,kaist_dataset/Mixed/Digital_Camera/(C.S)C-outdoor4/DSC03711.JPG,char_data/O/DSC03711.JPG_0.jpg,952,28,519,547,385,419,True,25
O,41,kaist_dataset/Mixed/Digital_Camera/(C.S)C-outdoor4/DSC03711.JPG,char_data/O/DSC03711.JPG_0.jpg,1435,35,546,581,382,423,True,25
O,67,kaist_dataset/Mixed/Digital_Camera/(C.S)C-outdoor4/DSC03640.JPG,char_data/O/DSC03640.JPG_0.jpg,4288,64,387,451,304,371,True,25
O,40,kaist_dataset/Mixed/Digital_Camera/(C.S)C-outdoor4/DSC03764.JPG,char_data/O/DSC03764.JPG_0.jpg,920,23,159,182,230,270,True,25
O,51,kaist_dataset/Mixed/Digital_Camera/(C.S)C-outdoor4/DSC03707.JPG,char_data/O/DSC03707.JPG_0.jpg,1683,33,357,390,90,141,True,25
O,54,kaist_dataset/Mixed/Digital_Camera/(C.S)C-outdoor4/DSC03707.JPG,char_data/O/DSC03707.JPG_0.jpg,1998,37,388,425,89,143,True,25
O,53,kaist_dataset/Mixed/Digital_Camera/(C.S)C-outdoor4/DSC03707.JPG,char_data/O/DSC03707.JPG_0.jpg,1749,33,265,298,150,203,True,25
O,62,kaist_dataset/Mixed/Digital_Camera/(C.S)C-outdoor4/DSC03673.JPG,char_data/O/DSC03673.JPG_0.jpg,2232,36,217,253,179,241,True,25
O,59,kaist_dataset/Mixed/Digital_Camera/(C.S)C-outdoor4/DSC03673.JPG,char_data/O/DSC03673.JPG_0.jpg,2242,38,335,373,184,243,True,25
O,93,kaist_dataset/Mixed/Digital_Camera/(C.S)C-outdoor4/DSC03652.JPG,char_data/O/DSC03652.JPG_0.jpg,7905,85,21,106,178,271,True,25
O,38,kaist_dataset/Mixed/Digital_Camera/(C.S)C-outdoor4/DSC03679.JPG,char_data/O/DSC03679.JPG_0.jpg,1064,28,171,199,101,139,True,25
O,66,kaist_dataset/Mixed/Digital_Camera/(C.S)C-outdoor4/DSC03756.JPG,char_data/O/DSC03756.JPG_0.jpg,3564,54,234,288,387,453,True,25
O,65,kaist_dataset/Mixed/Digital_Camera/(C.S)C-outdoor4/DSC03756.JPG,char_data/O/DSC03756.JPG_0.jpg,3380,52,386,438,383,448,True,25
O,65,kaist_dataset/Mixed/Digital_Camera/(C.S)C-outdoor4/DSC03756.JPG,char_data/O/DSC03756.JPG_0.jpg,3770,58,436,494,384,449,True,25
O,85,kaist_dataset/Mixed/Digital_Camera/(C.S)C-outdoor4/DSC03666.JPG,char_data/O/DSC03666.JPG_0.jpg,5780,68,161,229,162,247,True,25
O,73,kaist_dataset/Mixed/Digital_Camera/(C.S)C-outdoor4/DSC03687.JPG,char_data/O/DSC03687.JPG_0.jpg,3796,52,177,229,321,394,True,25
O,43,kaist_dataset/Mixed/Digital_Camera/(C.S)C-outdoor4/DSC03581.JPG,char_data/O/DSC03581.JPG_0.jpg,1548,36,50,86,191,234,True,25
O,33,kaist_dataset/Mixed/Digital_Camera/(C.S)C-outdoor2/DSC02418.JPG,char_data/O/DSC02418.JPG_0.jpg,792,24,54,78,87,120,True,25
O,107,kaist_dataset/Mixed/Digital_Camera/(C.S)C-outdoor2/DSC02917.JPG,char_data/O/DSC02917.JPG_0.jpg,8239,77,350,427,73,180,True,25
O,110,kaist_dataset/Mixed/Digital_Camera/(C.S)C-outdoor2/DSC02917.JPG,char_data/O/DSC02917.JPG_0.jpg,9240,84,495,579,70,180,True,25
O,34,kaist_dataset/Mixed/Digital_Camera/(C.S)C-outdoor2/DSC02917.JPG,char_data/O/DSC02917.JPG_0.jpg,816,24,79,103,222,256,True,25
O,32,kaist_dataset/Mixed/Digital_Camera/(C.S)C-outdoor2/DSC02917.JPG,char_data/O/DSC02917.JPG_0.jpg,640,20,122,142,223,255,True,25
O,29,kaist_dataset/Mixed/Digital_Camera/(C.S)C-outdoor2/DSC02917.JPG,char_data/O/DSC02917.JPG_0.jpg,551,19,178,197,226,255,True,25
O,23,kaist_dataset/Mixed/Digital_Camera/(C.S)C-outdoor2/DSC02555.JPG,char_data/O/DSC02555.JPG_0.jpg,368,16,152,168,154,177,True,25
O,30,kaist_dataset/Mixed/Digital_Camera/(C.S)C-outdoor2/DSC02397.JPG,char_data/O/DSC02397.JPG_0.jpg,510,17,98,115,140,170,True,25
O,21,kaist_dataset/Mixed/Digital_Camera/(C.S)C-outdoor2/DSC02477.JPG,char_data/O/DSC02477.JPG_0.jpg,273,13,136,149,156,177,True,25
O,52,kaist_dataset/Mixed/Digital_Camera/(C.S)C-outdoor2/DSC02869.JPG,char_data/O/DSC02869.JPG_0.jpg,1664,32,254,286,134,186,True,25
O,35,kaist_dataset/Mixed/Digital_Camera/(C.S)C-outdoor2/DSC02910.JPG,char_data/O/DSC02910.JPG_0.jpg,805,23,292,315,56,91,True,25
O,21,kaist_dataset/Mixed/Digital_Camera/(C.S)C-outdoor2/DSC02411.JPG,char_data/O/DSC02411.JPG_0.jpg,147,7,550,557,272,293,True,25
O,13,kaist_dataset/Mixed/Digital_Camera/(C.S)C-outdoor2/DSC02411.JPG,char_data/O/DSC02411.JPG_0.jpg,130,10,571,581,277,290,True,25
O,15,kaist_dataset/Mixed/Digital_Camera/(C.S)C-outdoor2/DSC02411.JPG,char_data/O/DSC02411.JPG_0.jpg,120,8,596,604,276,291,True,25
O,21,kaist_dataset/Mixed/Digital_Camera/(C.S)C-outdoor2/DSC02411.JPG,char_data/O/DSC02411.JPG_0.jpg,294,14,616,630,273,294,True,25
O,83,kaist_dataset/Mixed/Digital_Camera/(C.S)C-outdoor2/DSC02513.JPG,char_data/O/DSC02513.JPG_0.jpg,3154,38,316,354,234,317,True,25
O,73,kaist_dataset/Mixed/Digital_Camera/(C.S)C-outdoor2/DSC02870.JPG,char_data/O/DSC02870.JPG_0.jpg,3869,53,267,320,276,349,True,25
O,39,kaist_dataset/Mixed/Digital_Camera/(C.S)C-outdoor2/DSC02864.JPG,char_data/O/DSC02864.JPG_0.jpg,1287,33,494,527,259,298,True,25
O,36,kaist_dataset/Mixed/Digital_Camera/(C.S)C-outdoor2/DSC02545.JPG,char_data/O/DSC02545.JPG_0.jpg,1116,31,181,212,366,402,True,25
O,44,kaist_dataset/Mixed/Digital_Camera/(C.S)C-outdoor2/DSC02429.JPG,char_data/O/DSC02429.JPG_0.jpg,1848,42,387,429,115,159,True,25
O,36,kaist_dataset/Mixed/Digital_Camera/(C.S)C-outdoor2/DSC02429.JPG,char_data/O/DSC02429.JPG_0.jpg,1512,42,505,547,117,153,True,25
O,54,kaist_dataset/Mixed/Digital_Camera/(C.S)C-outdoor2/DSC02365.JPG,char_data/O/DSC02365.JPG_0.jpg,2160,40,385,425,82,136,True,25
O,38,kaist_dataset/Mixed/Digital_Camera/(C.S)C-outdoor2/DSC02568.JPG,char_data/O/DSC02568.JPG_0.jpg,874,23,260,283,145,183,True,25
O,30,kaist_dataset/Mixed/Digital_Camera/(C.S)C-outdoor2/DSC02890.JPG,char_data/O/DSC02890.JPG_0.jpg,840,28,111,139,408,438,True,25
O,32,kaist_dataset/Mixed/Digital_Camera/(C.S)C-outdoor2/DSC02890.JPG,char_data/O/DSC02890.JPG_0.jpg,768,24,139,163,407,439,True,25
O,30,kaist_dataset/Mixed/Digital_Camera/(C.S)C-outdoor2/DSC02430.JPG,char_data/O/DSC02430.JPG_0.jpg,690,23,172,195,184,214,True,25
O,43,kaist_dataset/Mixed/Digital_Camera/(C.S)C-outdoor2/DSC02867.JPG,char_data/O/DSC02867.JPG_0.jpg,1462,34,278,312,401,444,True,25
O,66,kaist_dataset/Mixed/Digital_Camera/(C.S)A-shadow/DSC03520.JPG,char_data/O/DSC03520.JPG_0.jpg,3696,56,261,317,48,114,True,25
O,44,kaist_dataset/Mixed/Digital_Camera/(C.S)A-shadow/DSC02902.JPG,char_data/O/DSC02902.JPG_0.jpg,1276,29,244,273,384,428,True,25
O,44,kaist_dataset/Mixed/Digital_Camera/(C.S)A-shadow/DSC02902.JPG,char_data/O/DSC02902.JPG_0.jpg,1012,23,273,296,379,423,True,25
O,45,kaist_dataset/Mixed/Digital_Camera/(C.S)A-shadow/DSC02902.JPG,char_data/O/DSC02902.JPG_0.jpg,1215,27,355,382,370,415,True,25
O,38,kaist_dataset/Mixed/Digital_Camera/(C.S)A-shadow/DSC02568.JPG,char_data/O/DSC02568.JPG_0.jpg,874,23,260,283,145,183,True,25
O,81,kaist_dataset/English/Mobile_Phone/(E.M)B-indoor/P090902018.jpg,char_data/O/P090902018.jpg_0.jpg,3888,48,215,263,51,132,True,25
O,61,kaist_dataset/English/Mobile_Phone/(E.M)B-indoor/P090911084.jpg,char_data/O/P090911084.jpg_0.jpg,2562,42,80,122,150,211,True,25
O,43,kaist_dataset/English/Mobile_Phone/(E.M)C-bookCover/P090903056.jpg,char_data/O/P090903056.jpg_0.jpg,1505,35,283,318,200,243,True,25
O,105,kaist_dataset/English/Mobile_Phone/(E.M)C-bookCover/P090903076.jpg,char_data/O/P090903076.jpg_0.jpg,9030,86,367,453,176,281,True,25
O,77,kaist_dataset/English/Mobile_Phone/(E.M)C-bookCover/P090903071.jpg,char_data/O/P090903071.jpg_0.jpg,5467,71,400,471,147,224,True,25
O,149,kaist_dataset/English/Mobile_Phone/(E.M)C-bookCover/P090903082.jpg,char_data/O/P090903082.jpg_0.jpg,20711,139,186,325,32,181,True,25
O,59,kaist_dataset/English/Mobile_Phone/(E.M)C-bookCover/P090903054.jpg,char_data/O/P090903054.jpg_0.jpg,2242,38,239,277,352,411,True,25
O,55,kaist_dataset/English/Mobile_Phone/(E.M)C-bookCover/P090903054.jpg,char_data/O/P090903054.jpg_0.jpg,1925,35,457,492,351,406,True,25
O,64,kaist_dataset/English/Mobile_Phone/(E.M)C-bookCover/P090831075.jpg,char_data/O/P090831075.jpg_0.jpg,3840,60,176,236,157,221,True,25
O,65,kaist_dataset/English/Mobile_Phone/(E.M)C-bookCover/P090831075.jpg,char_data/O/P090831075.jpg_0.jpg,4160,64,390,454,161,226,True,25
O,41,kaist_dataset/English/Mobile_Phone/(E.M)C-bookCover/P090903055.jpg,char_data/O/P090903055.jpg_0.jpg,1353,33,290,323,69,110,True,25
O,38,kaist_dataset/English/Mobile_Phone/(E.M)C-bookCover/P090903055.jpg,char_data/O/P090903055.jpg_0.jpg,1102,29,327,356,406,444,True,25
O,35,kaist_dataset/English/Mobile_Phone/(E.M)C-bookCover/P090903055.jpg,char_data/O/P090903055.jpg_0.jpg,1330,38,398,436,408,443,True,25
O,70,kaist_dataset/English/Mobile_Phone/(E.M)C-bookCover/P090831042.jpg,char_data/O/P090831042.jpg_0.jpg,4060,58,48,106,199,269,True,25
O,49,kaist_dataset/English/Mobile_Phone/(E.M)C-bookCover/P090903015.jpg,char_data/O/P090903015.jpg_0.jpg,1911,39,338,377,76,125,True,25
O,42,kaist_dataset/English/Mobile_Phone/(E.M)C-bookCover/P090903015.jpg,char_data/O/P090903015.jpg_0.jpg,1512,36,160,196,150,192,True,25
O,48,kaist_dataset/English/Mobile_Phone/(E.M)C-bookCover/P090903015.jpg,char_data/O/P090903015.jpg_0.jpg,1872,39,441,480,140,188,True,25
O,110,kaist_dataset/English/Digital_Camera/(E.S)E-night/DSC02606.JPG,char_data/O/DSC02606.JPG_0.jpg,11770,107,219,326,197,307,True,25
O,53,kaist_dataset/English/Digital_Camera/(E.S)C-outdoor2/DSC03023.JPG,char_data/O/DSC03023.JPG_0.jpg,1431,27,239,266,299,352,True,25
O,49,kaist_dataset/English/Digital_Camera/(E.S)C-outdoor2/DSC03023.JPG,char_data/O/DSC03023.JPG_0.jpg,1470,30,358,388,300,349,True,25
O,72,kaist_dataset/English/Digital_Camera/(E.S)C-outdoor2/DSC04079.JPG,char_data/O/DSC04079.JPG_0.jpg,4248,59,251,310,267,339,True,25
O,54,kaist_dataset/English/Digital_Camera/(E.S)C-outdoor2/DSC04079.JPG,char_data/O/DSC04079.JPG_0.jpg,2376,44,346,390,46,100,True,25
O,91,kaist_dataset/English/Digital_Camera/(E.S)C-outdoor2/DSC03200.JPG,char_data/O/DSC03200.JPG_0.jpg,9828,108,52,160,229,320,True,25
O,63,kaist_dataset/English/Digital_Camera/(E.S)C-outdoor2/DSC04120.JPG,char_data/O/DSC04120.JPG_0.jpg,2520,40,492,532,139,202,True,25
O,57,kaist_dataset/English/Digital_Camera/(E.S)C-outdoor2/f.jpg,char_data/O/f.jpg_0.jpg,3078,54,100,154,66,123,True,25
O,71,kaist_dataset/English/Digital_Camera/(E.S)C-outdoor2/DSC03191.JPG,char_data/O/DSC03191.JPG_0.jpg,4615,65,151,216,227,298,True,25
O,45,kaist_dataset/English/Digital_Camera/(E.S)C-outdoor2/DSC04361.JPG,char_data/O/DSC04361.JPG_0.jpg,1080,24,266,290,235,280,True,25
O,64,kaist_dataset/English/Digital_Camera/(E.S)C-outdoor2/DSC03161.JPG,char_data/O/DSC03161.JPG_0.jpg,1920,30,455,485,202,266,True,25
O,53,kaist_dataset/English/Digital_Camera/(E.S)C-outdoor2/IMG_2481.JPG,char_data/O/IMG_2481.JPG_0.jpg,3392,64,222,286,261,314,True,25
O,57,kaist_dataset/English/Digital_Camera/(E.S)C-outdoor2/IMG_2481.JPG,char_data/O/IMG_2481.JPG_0.jpg,3477,61,296,357,192,249,True,25
O,47,kaist_dataset/English/Digital_Camera/(E.S)C-outdoor2/DSC03203.JPG,char_data/O/DSC03203.JPG_0.jpg,1927,41,282,323,313,360,True,25
O,65,kaist_dataset/English/Digital_Camera/(E.S)C-outdoor2/DSC03865.JPG,char_data/O/DSC03865.JPG_0.jpg,3185,49,533,582,97,162,True,25
O,60,kaist_dataset/English/Digital_Camera/(E.S)C-outdoor2/DSC03294.JPG,char_data/O/DSC03294.JPG_0.jpg,1980,33,286,319,291,351,True,25
O,50,kaist_dataset/English/Digital_Camera/(E.S)C-outdoor2/DSC03412.JPG,char_data/O/DSC03412.JPG_0.jpg,3000,60,148,208,399,449,True,25
O,58,kaist_dataset/English/Digital_Camera/(E.S)C-outdoor2/DSC03412.JPG,char_data/O/DSC03412.JPG_0.jpg,3306,57,257,314,398,456,True,25
O,66,kaist_dataset/English/Digital_Camera/(E.S)C-outdoor2/DSC03412.JPG,char_data/O/DSC03412.JPG_0.jpg,4026,61,372,433,398,464,True,25
O,63,kaist_dataset/English/Digital_Camera/(E.S)C-outdoor2/DSC03412.JPG,char_data/O/DSC03412.JPG_0.jpg,4032,64,363,427,271,334,True,25
O,46,kaist_dataset/English/Digital_Camera/(E.S)C-outdoor2/DSC03575.JPG,char_data/O/DSC03575.JPG_0.jpg,1426,31,259,290,179,225,True,25
O,53,kaist_dataset/English/Digital_Camera/(E.S)C-outdoor2/DSC03575.JPG,char_data/O/DSC03575.JPG_0.jpg,2067,39,129,168,260,313,True,25
O,81,kaist_dataset/English/Digital_Camera/(E.S)C-outdoor2/DSC03414.JPG,char_data/O/DSC03414.JPG_0.jpg,7533,93,248,341,253,334,True,25
O,58,kaist_dataset/English/Digital_Camera/(E.S)C-outdoor2/DSC03414.JPG,char_data/O/DSC03414.JPG_0.jpg,4408,76,43,119,354,412,True,25
O,59,kaist_dataset/English/Digital_Camera/(E.S)C-outdoor2/DSC03297.JPG,char_data/O/DSC03297.JPG_0.jpg,2537,43,183,226,258,317,True,25
O,57,kaist_dataset/English/Digital_Camera/(E.S)C-outdoor2/DSC04464.JPG,char_data/O/DSC04464.JPG_0.jpg,2565,45,304,349,330,387,True,25
O,53,kaist_dataset/English/Digital_Camera/(E.S)C-outdoor2/DSC03413.JPG,char_data/O/DSC03413.JPG_0.jpg,2809,53,428,481,210,263,True,25
O,39,kaist_dataset/English/Digital_Camera/(E.S)C-outdoor2/DSC03831.JPG,char_data/O/DSC03831.JPG_0.jpg,858,22,340,362,124,163,True,25
O,39,kaist_dataset/English/Digital_Camera/(E.S)C-outdoor2/DSC03831.JPG,char_data/O/DSC03831.JPG_0.jpg,897,23,429,452,128,167,True,25
O,78,kaist_dataset/English/Digital_Camera/(E.S)C-outdoor2/DSC03432.JPG,char_data/O/DSC03432.JPG_0.jpg,4290,55,188,243,359,437,True,25
O,86,kaist_dataset/English/Digital_Camera/(E.S)C-outdoor2/DSC03432.JPG,char_data/O/DSC03432.JPG_0.jpg,4300,50,482,532,357,443,True,25
O,75,kaist_dataset/English/Digital_Camera/(E.S)C-outdoor2/DSC03225.JPG,char_data/O/DSC03225.JPG_0.jpg,4350,58,108,166,47,122,True,25
O,68,kaist_dataset/English/Digital_Camera/(E.S)C-outdoor2/DSC03012.JPG,char_data/O/DSC03012.JPG_0.jpg,4216,62,374,436,211,279,True,25
O,79,kaist_dataset/English/Digital_Camera/(E.S)C-outdoor2/DSC03012.JPG,char_data/O/DSC03012.JPG_0.jpg,4187,53,437,490,208,287,True,25
O,70,kaist_dataset/English/Digital_Camera/(E.S)C-outdoor2/DSC03264.JPG,char_data/O/DSC03264.JPG_0.jpg,4550,65,167,232,157,227,True,25
O,42,kaist_dataset/English/Digital_Camera/(E.S)C-outdoor2/DSC04080.JPG,char_data/O/DSC04080.JPG_0.jpg,1848,44,464,508,306,348,True,25
O,34,kaist_dataset/English/Digital_Camera/(E.S)C-outdoor2/DSC04437.JPG,char_data/O/DSC04437.JPG_0.jpg,578,17,173,190,39,73,True,25
O,32,kaist_dataset/English/Digital_Camera/(E.S)C-outdoor2/DSC04437.JPG,char_data/O/DSC04437.JPG_0.jpg,416,13,176,189,75,107,True,25
O,74,kaist_dataset/English/Digital_Camera/(E.S)C-outdoor2/DSC04437.JPG,char_data/O/DSC04437.JPG_0.jpg,4810,65,370,435,107,181,True,25
O,85,kaist_dataset/English/Digital_Camera/(E.S)C-outdoor2/P1010015.JPG,char_data/O/P1010015.JPG_0.jpg,5440,64,19,83,132,217,True,25
O,66,kaist_dataset/English/Digital_Camera/(E.S)C-outdoor2/DSC03759.JPG,char_data/O/DSC03759.JPG_0.jpg,6930,105,177,282,194,260,True,25
O,64,kaist_dataset/English/Digital_Camera/(E.S)C-outdoor2/DSC03759.JPG,char_data/O/DSC03759.JPG_0.jpg,7168,112,281,393,197,261,True,25
O,60,kaist_dataset/English/Digital_Camera/(E.S)C-outdoor2/DSC03759.JPG,char_data/O/DSC03759.JPG_0.jpg,7560,126,424,550,124,184,True,25
O,73,kaist_dataset/English/Digital_Camera/(E.S)C-outdoor1/DSC02356.JPG,char_data/O/DSC02356.JPG_0.jpg,4307,59,99,158,166,239,True,25
O,124,kaist_dataset/English/Digital_Camera/(E.S)C-outdoor1/DSC02427.JPG,char_data/O/DSC02427.JPG_0.jpg,9300,75,137,212,105,229,True,25
O,50,kaist_dataset/English/Digital_Camera/(E.S)C-outdoor1/DSC02427.JPG,char_data/O/DSC02427.JPG_0.jpg,1450,29,447,476,235,285,True,25
O,50,kaist_dataset/English/Digital_Camera/(E.S)C-outdoor1/DSC02427.JPG,char_data/O/DSC02427.JPG_0.jpg,1500,30,526,556,236,286,True,25
O,94,kaist_dataset/English/Digital_Camera/(E.S)C-outdoor1/DSC02514.JPG,char_data/O/DSC02514.JPG_0.jpg,5358,57,11,68,146,240,True,25
O,68,kaist_dataset/English/Digital_Camera/(E.S)C-outdoor1/DSC02394.JPG,char_data/O/DSC02394.JPG_0.jpg,4624,68,65,133,260,328,True,25
O,119,kaist_dataset/English/Digital_Camera/(E.S)C-outdoor1/DSC02450.JPG,char_data/O/DSC02450.JPG_0.jpg,6426,54,111,165,68,187,True,25
O,116,kaist_dataset/English/Digital_Camera/(E.S)C-outdoor1/DSC02450.JPG,char_data/O/DSC02450.JPG_0.jpg,6148,53,420,473,74,190,True,25
O,35,kaist_dataset/English/Digital_Camera/(E.S)C-outdoor1/DSC02618.JPG,char_data/O/DSC02618.JPG_0.jpg,630,18,266,284,173,208,True,25
O,189,kaist_dataset/English/Digital_Camera/(E.S)C-outdoor1/2007-12-08-day-099.jpg,char_data/O/2007-12-08-day-099.jpg_0.jpg,21546,114,1375,1489,468,657,True,25
O,98,kaist_dataset/English/Digital_Camera/(E.S)C-outdoor1/DSC02345.JPG,char_data/O/DSC02345.JPG_0.jpg,11662,119,408,527,131,229,True,25
O,30,kaist_dataset/English/Digital_Camera/(E.S)C-outdoor1/DSC02345.JPG,char_data/O/DSC02345.JPG_0.jpg,690,23,306,329,237,267,True,25
O,35,kaist_dataset/English/Digital_Camera/(E.S)C-outdoor1/DSC02345.JPG,char_data/O/DSC02345.JPG_0.jpg,735,21,329,350,236,271,True,25
O,30,kaist_dataset/English/Digital_Camera/(E.S)C-outdoor1/DSC02345.JPG,char_data/O/DSC02345.JPG_0.jpg,720,24,467,491,236,266,True,25
O,235,kaist_dataset/English/Digital_Camera/(E.S)C-outdoor1/080119-0004.jpg,char_data/O/080119-0004.jpg_0.jpg,60395,257,1032,1289,520,755,True,25
O,23,kaist_dataset/English/Digital_Camera/(E.S)C-outdoor1/056.JPG,char_data/O/056.JPG_0.jpg,391,17,146,163,242,265,True,25
O,103,kaist_dataset/English/Digital_Camera/(E.S)C-outdoor1/DSC02590.JPG,char_data/O/DSC02590.JPG_0.jpg,7210,70,424,494,126,229,True,25
O,52,kaist_dataset/English/Digital_Camera/(E.S)C-outdoor1/113.jpg,char_data/O/113.jpg_0.jpg,2132,41,254,295,167,219,True,25
O,43,kaist_dataset/English/Digital_Camera/(E.S)C-outdoor1/080116-0065.jpg,char_data/O/080116-0065.jpg_0.jpg,1247,29,319,348,327,370,True,25
O,41,kaist_dataset/English/Digital_Camera/(E.S)C-outdoor1/080116-0065.jpg,char_data/O/080116-0065.jpg_0.jpg,1271,31,504,535,343,384,True,25
O,202,kaist_dataset/English/Digital_Camera/(E.S)C-outdoor1/2007-12-08-day-117.jpg,char_data/O/2007-12-08-day-117.jpg_0.jpg,31714,157,455,612,519,721,True,25
O,70,kaist_dataset/English/Digital_Camera/(E.S)C-outdoor1/DSC02408.JPG,char_data/O/DSC02408.JPG_0.jpg,5180,74,429,503,273,343,True,25
O,48,kaist_dataset/English/Digital_Camera/(E.S)C-outdoor1/DSC02559.JPG,char_data/O/DSC02559.JPG_0.jpg,2592,54,372,426,113,161,True,25
O,118,kaist_dataset/English/Digital_Camera/(E.S)C-outdoor1/2007-12-09-day-exterior-063.jpg,char_data/O/2007-12-09-day-exterior-063.jpg_0.jpg,11800,100,1064,1164,452,570,True,25
O,69,kaist_dataset/English/Digital_Camera/(E.S)C-outdoor1/DSC02417.JPG,char_data/O/DSC02417.JPG_0.jpg,5175,75,117,192,138,207,True,25
O,162,kaist_dataset/English/Digital_Camera/(E.S)C-outdoor1/DSC02475.JPG,char_data/O/DSC02475.JPG_0.jpg,20088,124,235,359,73,235,True,25
O,44,kaist_dataset/English/Digital_Camera/(E.S)C-outdoor1/004.jpg,char_data/O/004.jpg_0.jpg,1628,37,98,135,34,78,True,25
O,54,kaist_dataset/English/Digital_Camera/(E.S)C-outdoor1/080118-0011.jpg,char_data/O/080118-0011.jpg_0.jpg,2808,52,754,806,943,997,True,25
O,66,kaist_dataset/English/Digital_Camera/(E.S)C-outdoor1/080118-0011.jpg,char_data/O/080118-0011.jpg_0.jpg,3102,47,1082,1129,930,996,True,25
O,71,kaist_dataset/English/Digital_Camera/(E.S)C-outdoor1/080118-0011.jpg,char_data/O/080118-0011.jpg_0.jpg,4402,62,689,751,526,597,True,25
O,142,kaist_dataset/English/Digital_Camera/(E.S)C-outdoor1/DSC02406.JPG,char_data/O/DSC02406.JPG_0.jpg,18602,131,258,389,267,409,True,25
O,77,kaist_dataset/English/Digital_Camera/(E.S)C-outdoor1/DSC02395.JPG,char_data/O/DSC02395.JPG_0.jpg,6314,82,263,345,217,294,True,25
O,370,kaist_dataset/English/Digital_Camera/(E.S)C-outdoor1/080120-0001.jpg,char_data/O/080120-0001.jpg_0.jpg,145040,392,404,796,486,856,True,25
O,59,kaist_dataset/English/Digital_Camera/(E.S)C-outdoor1/DSC02501.JPG,char_data/O/DSC02501.JPG_0.jpg,3540,60,455,515,294,353,True,25
O,83,kaist_dataset/English/Digital_Camera/(E.S)C-outdoor1/DSC02491.JPG,char_data/O/DSC02491.JPG_0.jpg,6972,84,76,160,128,211,True,25
O,83,kaist_dataset/English/Digital_Camera/(E.S)C-outdoor1/110.jpg,char_data/O/110.jpg_0.jpg,4067,49,377,426,193,276,True,25
O,80,kaist_dataset/English/Digital_Camera/(E.S)C-outdoor1/110.jpg,char_data/O/110.jpg_0.jpg,5120,64,503,567,192,272,True,25
O,94,kaist_dataset/English/Digital_Camera/(E.S)B-light/크기변환_%B0%A3%C6%C7_ktimt007.jpg,char_data/O/크기변환_%B0%A3%C6%C7_ktimt007.jpg_0.jpg,7144,76,400,476,209,303,True,25
O,48,kaist_dataset/English/Digital_Camera/(E.S)B-light/DSC02712.JPG,char_data/O/DSC02712.JPG_0.jpg,1632,34,184,218,217,265,True,25
O,51,kaist_dataset/English/Digital_Camera/(E.S)B-light/DSC02712.JPG,char_data/O/DSC02712.JPG_0.jpg,1683,33,307,340,219,270,True,25
O,113,kaist_dataset/English/Digital_Camera/(E.S)B-light/080116-0053.jpg,char_data/O/080116-0053.jpg_0.jpg,10057,89,511,600,224,337,True,25
O,46,kaist_dataset/English/Digital_Camera/(E.S)B-light/DSC03007.JPG,char_data/O/DSC03007.JPG_0.jpg,1426,31,183,214,274,320,True,25
O,42,kaist_dataset/English/Digital_Camera/(E.S)B-light/DSC03007.JPG,char_data/O/DSC03007.JPG_0.jpg,1344,32,213,245,276,318,True,25
O,44,kaist_dataset/English/Digital_Camera/(E.S)B-light/DSC03007.JPG,char_data/O/DSC03007.JPG_0.jpg,1364,31,319,350,274,318,True,25
O,42,kaist_dataset/English/Digital_Camera/(E.S)B-light/DSC03007.JPG,char_data/O/DSC03007.JPG_0.jpg,1344,32,415,447,278,320,True,25
O,91,kaist_dataset/English/Digital_Camera/(E.S)B-light/DSC03007.JPG,char_data/O/DSC03007.JPG_0.jpg,5733,63,400,463,160,251,True,25
O,205,kaist_dataset/English/Digital_Camera/(E.S)B-light/080116-0059.jpg,char_data/O/080116-0059.jpg_0.jpg,42230,206,310,516,9,214,True,25
O,189,kaist_dataset/English/Digital_Camera/(E.S)B-light/080116-0059.jpg,char_data/O/080116-0059.jpg_0.jpg,28161,149,1242,1391,99,288,True,25
O,231,kaist_dataset/English/Digital_Camera/(E.S)B-light/080116-0059.jpg,char_data/O/080116-0059.jpg_0.jpg,27027,117,984,1101,508,739,True,25
O,29,kaist_dataset/English/Digital_Camera/(E.S)B-light/080116-0059.jpg,char_data/O/080116-0059.jpg_0.jpg,435,15,644,659,799,828,True,25
O,28,kaist_dataset/English/Digital_Camera/(E.S)B-light/080116-0059.jpg,char_data/O/080116-0059.jpg_0.jpg,532,19,1086,1105,798,826,True,25
O,33,kaist_dataset/English/Digital_Camera/(E.S)B-light/080116-0059.jpg,char_data/O/080116-0059.jpg_0.jpg,528,16,694,710,771,804,True,25
O,32,kaist_dataset/English/Digital_Camera/(E.S)B-light/080116-0059.jpg,char_data/O/080116-0059.jpg_0.jpg,448,14,1120,1134,767,799,False,25
O,77,kaist_dataset/English/Digital_Camera/(E.S)B-light/080119-0038.jpg,char_data/O/080119-0038.jpg_0.jpg,5775,75,262,337,684,761,False,25
O,30,kaist_dataset/English/Digital_Camera/(E.S)B-light/v.jpg,char_data/O/v.jpg_0.jpg,690,23,119,142,57,87,False,25
O,21,kaist_dataset/English/Digital_Camera/(E.S)B-light/v.jpg,char_data/O/v.jpg_0.jpg,504,24,224,248,60,81,False,25
O,200,kaist_dataset/English/Digital_Camera/(E.S)F-others/080119-0013.jpg,char_data/O/080119-0013.jpg_0.jpg,36400,182,373,555,475,675,False,25
O,192,kaist_dataset/English/Digital_Camera/(E.S)F-others/2007-12-09-day-exterior-047.jpg,char_data/O/2007-12-09-day-exterior-047.jpg_0.jpg,28608,149,790,939,456,648,False,25
O,163,kaist_dataset/English/Digital_Camera/(E.S)F-others/2007-12-09-day-exterior-047.jpg,char_data/O/2007-12-09-day-exterior-047.jpg_0.jpg,20701,127,1167,1294,517,680,False,25
O,42,kaist_dataset/English/Digital_Camera/(E.S)F-others/2007-12-09-day-exterior-047.jpg,char_data/O/2007-12-09-day-exterior-047.jpg_0.jpg,1134,27,663,690,1070,1112,False,25
O,38,kaist_dataset/English/Digital_Camera/(E.S)F-others/2007-12-09-day-exterior-047.jpg,char_data/O/2007-12-09-day-exterior-047.jpg_0.jpg,1064,28,732,760,1071,1109,False,25
O,166,kaist_dataset/English/Digital_Camera/(E.S)F-others/080116-0060.jpg,char_data/O/080116-0060.jpg_0.jpg,30876,186,193,379,462,628,False,25
O,134,kaist_dataset/English/Digital_Camera/(E.S)F-others/080116-0060.jpg,char_data/O/080116-0060.jpg_0.jpg,15946,119,1185,1304,389,523,False,25
O,112,kaist_dataset/English/Digital_Camera/(E.S)F-others/DSC02646.JPG,char_data/O/DSC02646.JPG_0.jpg,4704,42,47,89,302,414,False,25
O,101,kaist_dataset/English/Digital_Camera/(E.S)F-others/DSC02646.JPG,char_data/O/DSC02646.JPG_0.jpg,4848,48,235,283,241,342,False,25
O,32,kaist_dataset/English/Digital_Camera/(E.S)F-others/m.jpg,char_data/O/m.jpg_0.jpg,768,24,258,282,92,124,False,25
O,291,kaist_dataset/English/Digital_Camera/(E.S)F-others/080119-0011.jpg,char_data/O/080119-0011.jpg_0.jpg,38994,134,1178,1312,569,860,False,25
O,160,kaist_dataset/English/Digital_Camera/(E.S)F-others/080116-0058.jpg,char_data/O/080116-0058.jpg_0.jpg,13600,85,750,835,361,521,False,25
O,127,kaist_dataset/English/Digital_Camera/(E.S)F-others/080116-0058.jpg,char_data/O/080116-0058.jpg_0.jpg,5969,47,1048,1095,498,625,False,25
O,137,kaist_dataset/English/Digital_Camera/(E.S)F-others/080116-0058.jpg,char_data/O/080116-0058.jpg_0.jpg,4110,30,962,992,742,879,False,25
O,100,kaist_dataset/English/Digital_Camera/(E.S)F-others/DSC02923.JPG,char_data/O/DSC02923.JPG_0.jpg,9200,92,229,321,281,381,False,25
O,80,kaist_dataset/English/Digital_Camera/(E.S)F-others/크기변환_%C4%BF%C7%C7%B5%B9%C3%E2%B0%A3%C6%C7_%281%29_alto99kr.jpg,char_data/O/크기변환_%C4%BF%C7%C7%B5%B9%C3%E2%B0%A3%C6%C7_%281%29_alto99kr.jpg_0.jpg,5760,72,200,272,278,358,False,25
O,49,kaist_dataset/English/Digital_Camera/(E.S)F-others/086.jpg,char_data/O/086.jpg_0.jpg,1225,25,197,222,287,336,False,25
O,55,kaist_dataset/English/Digital_Camera/(E.S)F-others/086.jpg,char_data/O/086.jpg_0.jpg,880,16,337,353,314,369,False,25
O,69,kaist_dataset/English/Digital_Camera/(E.S)F-others/032.jpg,char_data/O/032.jpg_0.jpg,3864,56,114,170,30,99,False,25
O,101,kaist_dataset/English/Digital_Camera/(E.S)A-shadow/DSC02629.JPG,char_data/O/DSC02629.JPG_0.jpg,7070,70,301,371,304,405,False,25
O,78,kaist_dataset/English/Digital_Camera/(E.S)A-shadow/DSC02423.JPG,char_data/O/DSC02423.JPG_0.jpg,6318,81,82,163,148,226,False,25
O,73,kaist_dataset/English/Digital_Camera/(E.S)A-shadow/DSC02423.JPG,char_data/O/DSC02423.JPG_0.jpg,6059,83,249,332,157,230,False,25
O,97,kaist_dataset/English/Digital_Camera/(E.S)A-shadow/DSC02633.JPG,char_data/O/DSC02633.JPG_0.jpg,6111,63,77,140,173,270,False,25
O,96,kaist_dataset/English/Digital_Camera/(E.S)A-shadow/DSC02633.JPG,char_data/O/DSC02633.JPG_0.jpg,5760,60,373,433,180,276,False,25
O,40,kaist_dataset/English/Digital_Camera/(E.S)A-shadow/P1010044.JPG,char_data/O/P1010044.JPG_0.jpg,1240,31,245,276,357,397,False,25
O,44,kaist_dataset/English/Digital_Camera/(E.S)A-shadow/P1010044.JPG,char_data/O/P1010044.JPG_0.jpg,1232,28,433,461,352,396,False,25
O,35,kaist_dataset/English/Digital_Camera/(E.S)A-shadow/P1010044.JPG,char_data/O/P1010044.JPG_0.jpg,1155,33,217,250,151,186,False,25
O,34,kaist_dataset/English/Digital_Camera/(E.S)D-indoor/DSC03896.JPG,char_data/O/DSC03896.JPG_0.jpg,1156,34,449,483,348,382,False,25
O,111,kaist_dataset/English/Digital_Camera/(E.S)D-indoor/DSC02852.JPG,char_data/O/DSC02852.JPG_0.jpg,7770,70,157,227,313,424,False,25
O,104,kaist_dataset/English/Digital_Camera/(E.S)D-indoor/DSC02852.JPG,char_data/O/DSC02852.JPG_0.jpg,6864,66,430,496,314,418,False,25
O,30,kaist_dataset/English/Digital_Camera/(E.S)D-indoor/DSC03901.JPG,char_data/O/DSC03901.JPG_0.jpg,780,26,347,373,263,293,False,25
O,33,kaist_dataset/English/Digital_Camera/(E.S)D-indoor/DSC03901.JPG,char_data/O/DSC03901.JPG_0.jpg,891,27,308,335,124,157,False,25
O,37,kaist_dataset/English/Digital_Camera/(E.S)D-indoor/DSC03901.JPG,char_data/O/DSC03901.JPG_0.jpg,1110,30,418,448,117,154,False,25
O,33,kaist_dataset/English/Digital_Camera/(E.S)D-indoor/z.jpg,char_data/O/z.jpg_0.jpg,594,18,111,129,64,97,False,25
O,88,kaist_dataset/English/Digital_Camera/(E.S)D-indoor/DSC03365.JPG,char_data/O/DSC03365.JPG_0.jpg,7568,86,206,292,368,456,False,25
O,114,kaist_dataset/English/Digital_Camera/(E.S)D-indoor/DSC02842.JPG,char_data/O/DSC02842.JPG_0.jpg,13224,116,233,349,351,465,False,25
O,42,kaist_dataset/English/Digital_Camera/(E.S)D-indoor/DSC03942.JPG,char_data/O/DSC03942.JPG_0.jpg,840,20,124,144,3,45,False,25
O,37,kaist_dataset/English/Digital_Camera/(E.S)D-indoor/DSC03942.JPG,char_data/O/DSC03942.JPG_0.jpg,629,17,144,161,5,42,False,25
O,60,kaist_dataset/English/Digital_Camera/(E.S)D-indoor/DSC03918.JPG,char_data/O/DSC03918.JPG_0.jpg,2040,34,184,218,405,465,False,25
O,49,kaist_dataset/English/Digital_Camera/(E.S)D-indoor/DSC03401.JPG,char_data/O/DSC03401.JPG_0.jpg,1862,38,351,389,234,283,False,25
O,108,kaist_dataset/English/Digital_Camera/(E.S)D-indoor/DSC03911.JPG,char_data/O/DSC03911.JPG_0.jpg,7560,70,450,520,322,430,False,25
O,37,kaist_dataset/English/Digital_Camera/(E.S)D-indoor/DSC03943.JPG,char_data/O/DSC03943.JPG_0.jpg,740,20,332,352,311,348,False,25
O,67,kaist_dataset/English/Digital_Camera/(E.S)D-indoor/DSC03887.JPG,char_data/O/DSC03887.JPG_0.jpg,3886,58,265,323,168,235,False,25
O,69,kaist_dataset/English/Digital_Camera/(E.S)D-indoor/DSC02769.JPG,char_data/O/DSC02769.JPG_0.jpg,3450,50,134,184,217,286,False,25
O,65,kaist_dataset/English/Digital_Camera/(E.S)D-indoor/DSC02769.JPG,char_data/O/DSC02769.JPG_0.jpg,2990,46,185,231,218,283,False,25
O,59,kaist_dataset/English/Digital_Camera/(E.S)D-indoor/DSC02769.JPG,char_data/O/DSC02769.JPG_0.jpg,2891,49,265,314,136,195,False,25
O,58,kaist_dataset/English/Digital_Camera/(E.S)D-indoor/DSC02769.JPG,char_data/O/DSC02769.JPG_0.jpg,2784,48,315,363,136,194,False,25
O,76,kaist_dataset/English/Digital_Camera/(E.S)D-indoor/DSC04255.JPG,char_data/O/DSC04255.JPG_0.jpg,6840,90,215,305,301,377,False,25
O,70,kaist_dataset/English/Digital_Camera/(E.S)D-indoor/DSC03091.JPG,char_data/O/DSC03091.JPG_0.jpg,4340,62,374,436,199,269,False,25
O,41,kaist_dataset/English/Digital_Camera/(E.S)D-indoor/DSC03947.JPG,char_data/O/DSC03947.JPG_0.jpg,1353,33,472,505,413,454,False,25
O,116,kaist_dataset/English/Digital_Camera/(E.S)D-indoor/080119-0015.jpg,char_data/O/080119-0015.jpg_0.jpg,16124,139,652,791,509,625,False,25
O,30,kaist_dataset/English/Digital_Camera/(E.S)D-indoor/080119-0015.jpg,char_data/O/080119-0015.jpg_0.jpg,990,33,703,736,635,665,False,25
O,30,kaist_dataset/English/Digital_Camera/(E.S)D-indoor/080119-0015.jpg,char_data/O/080119-0015.jpg_0.jpg,1080,36,845,881,625,655,False,25
O,67,kaist_dataset/English/Digital_Camera/(E.S)D-indoor/DSC03883.JPG,char_data/O/DSC03883.JPG_0.jpg,2747,41,84,125,321,388,False,25
O,57,kaist_dataset/English/Digital_Camera/(E.S)D-indoor/DSC03883.JPG,char_data/O/DSC03883.JPG_0.jpg,2451,43,517,560,310,367,False,25
O,29,kaist_dataset/English/Digital_Camera/(E.S)D-indoor/080119-0009.jpg,char_data/O/080119-0009.jpg_0.jpg,667,23,61,84,1056,1085,False,25
O,25,kaist_dataset/English/Digital_Camera/(E.S)D-indoor/080119-0009.jpg,char_data/O/080119-0009.jpg_0.jpg,575,23,88,111,1055,1080,False,25
O,35,kaist_dataset/English/Digital_Camera/(E.S)C-outdoor3/u.jpg,char_data/O/u.jpg_0.jpg,1190,34,163,197,92,127,False,25
O,36,kaist_dataset/English/Digital_Camera/(E.S)C-outdoor3/u.jpg,char_data/O/u.jpg_0.jpg,1548,43,202,245,96,132,False,25
O,82,kaist_dataset/English/Digital_Camera/(E.S)C-outdoor3/P1010064.JPG,char_data/O/P1010064.JPG_0.jpg,4428,54,190,244,313,395,False,25
O,39,kaist_dataset/English/Digital_Camera/(E.S)C-outdoor3/r.jpg,char_data/O/r.jpg_0.jpg,1482,38,91,129,53,92,False,25
O,79,kaist_dataset/English/Digital_Camera/(E.S)C-outdoor3/P1010138.JPG,char_data/O/P1010138.JPG_0.jpg,5214,66,183,249,76,155,False,25
O,75,kaist_dataset/English/Digital_Camera/(E.S)C-outdoor3/DSC03046.JPG,char_data/O/DSC03046.JPG_0.jpg,4425,59,468,527,117,192,False,25
O,60,kaist_dataset/English/Digital_Camera/(E.S)C-outdoor3/DSC02788.JPG,char_data/O/DSC02788.JPG_0.jpg,1920,32,201,233,317,377,False,25
O,58,kaist_dataset/English/Digital_Camera/(E.S)C-outdoor3/DSC02788.JPG,char_data/O/DSC02788.JPG_0.jpg,2146,37,233,270,315,373,False,25
O,63,kaist_dataset/English/Digital_Camera/(E.S)C-outdoor3/DSC02788.JPG,char_data/O/DSC02788.JPG_0.jpg,2709,43,301,344,216,279,False,25
O,60,kaist_dataset/English/Digital_Camera/(E.S)C-outdoor3/DSC02788.JPG,char_data/O/DSC02788.JPG_0.jpg,2100,35,345,380,213,273,False,25
O,94,kaist_dataset/English/Digital_Camera/(E.S)C-outdoor3/P1010133.JPG,char_data/O/P1010133.JPG_0.jpg,8178,87,303,390,155,249,False,25
O,91,kaist_dataset/English/Digital_Camera/(E.S)C-outdoor3/P1010133.JPG,char_data/O/P1010133.JPG_0.jpg,7098,78,389,467,151,242,False,25
O,58,kaist_dataset/English/Digital_Camera/(E.S)C-outdoor3/크기변환_P1010028.JPG,char_data/O/크기변환_P1010028.JPG_0.jpg,3248,56,192,248,169,227,False,25
O,58,kaist_dataset/English/Digital_Camera/(E.S)C-outdoor3/크기변환_P1010028.JPG,char_data/O/크기변환_P1010028.JPG_0.jpg,3132,54,450,504,174,232,False,25
O,48,kaist_dataset/English/Digital_Camera/(E.S)C-outdoor3/DSC02690.JPG,char_data/O/DSC02690.JPG_0.jpg,2304,48,235,283,226,274,False,25
A,71,kaist_dataset/Korean/Digital_Camera/outdoor2/2007-12-09-day-exterior-016.jpg,char_data/A/2007-12-09-day-exterior-016.jpg_2.jpg,4331,61,4,65,730,801,True,12
A,31,kaist_dataset/Korean/Digital_Camera/outdoor2/2007-12-08-day-101.jpg,char_data/A/2007-12-08-day-101.jpg_2.jpg,620,20,294,314,1051,1082,True,12
A,53,kaist_dataset/Korean/Digital_Camera/outdoor2/2007-12-09-day-exterior-035.jpg,char_data/A/2007-12-09-day-exterior-035.jpg_0.jpg,1749,33,1135,1168,719,772,True,12
A,17,kaist_dataset/Korean/Digital_Camera/E-night/103.jpg,char_data/A/103.jpg_0.jpg,255,15,398,413,154,171,True,12
A,19,kaist_dataset/Korean/Digital_Camera/G-others/5.jpg,char_data/A/5.jpg_0.jpg,228,12,43,55,38,57,True,12
A,18,kaist_dataset/Korean/Digital_Camera/G-others/5.jpg,char_data/A/5.jpg_0.jpg,234,13,107,120,39,57,True,12
A,17,kaist_dataset/Korean/Digital_Camera/G-others/5.jpg,char_data/A/5.jpg_0.jpg,221,13,138,151,39,56,True,12
A,39,kaist_dataset/Mixed/Mobile_Phone/(C.M)B-indoor/P090831021.jpg,char_data/A/P090831021.jpg_0.jpg,897,23,258,281,44,83,True,12
A,109,kaist_dataset/Mixed/Mobile_Phone/(C.M)C-bookCover/P090831136.jpg,char_data/A/P090831136.jpg_0.jpg,9592,88,51,139,114,223,True,12
A,113,kaist_dataset/Mixed/Mobile_Phone/(C.M)C-bookCover/P090831136.jpg,char_data/A/P090831136.jpg_0.jpg,11187,99,226,325,113,226,True,12
A,110,kaist_dataset/Mixed/Mobile_Phone/(C.M)C-bookCover/P090831136.jpg,char_data/A/P090831136.jpg_0.jpg,10670,97,488,585,120,230,True,12
A,98,kaist_dataset/Mixed/Mobile_Phone/(C.M)C-bookCover/P090905002.jpg,char_data/A/P090905002.jpg_0.jpg,8134,83,130,213,33,131,True,12
A,45,kaist_dataset/Mixed/Mobile_Phone/(C.M)C-bookCover/P090831115.jpg,char_data/A/P090831115.jpg_0.jpg,1710,38,215,253,162,207,True,12
A,67,kaist_dataset/Mixed/Mobile_Phone/(C.M)C-bookCover/P090831124.jpg,char_data/A/P090831124.jpg_0.jpg,2948,44,302,346,110,177,True,12
A,63,kaist_dataset/Mixed/Mobile_Phone/(C.M)C-bookCover/P090903083.jpg,char_data/A/P090903083.jpg_0.jpg,3024,48,263,311,169,232,True,12
A,134,kaist_dataset/Mixed/Digital_Camera/(C.S)C-outdoor1/113.JPG,char_data/A/113.JPG_0.jpg,7772,58,200,258,79,213,True,12
A,121,kaist_dataset/Mixed/Digital_Camera/(C.S)C-outdoor1/P1010008.JPG,char_data/A/P1010008.JPG_0.jpg,13431,111,213,324,219,340,True,12
A,144,kaist_dataset/Mixed/Digital_Camera/(C.S)C-outdoor1/049.JPG,char_data/A/049.JPG_0.jpg,8064,56,413,469,177,321,True,12
A,72,kaist_dataset/Mixed/Digital_Camera/(C.S)C-outdoor1/046.JPG,char_data/A/046.JPG_0.jpg,4248,59,95,154,205,277,True,12
A,178,kaist_dataset/Mixed/Digital_Camera/(C.S)C-outdoor1/080119-0017.jpg,char_data/A/080119-0017.jpg_0.jpg,21538,121,879,1000,552,730,True,12
A,91,kaist_dataset/Mixed/Digital_Camera/(C.S)C-outdoor1/038.JPG,char_data/A/038.JPG_0.jpg,4004,44,495,539,211,302,True,12
A,50,kaist_dataset/Mixed/Digital_Camera/(C.S)C-outdoor1/080119-0006.jpg,char_data/A/080119-0006.jpg_0.jpg,2850,57,468,525,737,787,True,12
A,59,kaist_dataset/Mixed/Digital_Camera/(C.S)C-outdoor1/080119-0006.jpg,char_data/A/080119-0006.jpg_0.jpg,3658,62,750,812,733,792,True,12
A,32,kaist_dataset/Mixed/Digital_Camera/(C.S)C-outdoor1/DSC02240.JPG,char_data/A/DSC02240.JPG_0.jpg,960,30,254,284,281,313,True,12
A,28,kaist_dataset/Mixed/Digital_Camera/(C.S)C-outdoor1/121.JPG,char_data/A/121.JPG_0.jpg,532,19,73,92,216,244,True,12
A,117,kaist_dataset/Mixed/Digital_Camera/(C.S)C-outdoor1/008.JPG,char_data/A/008.JPG_0.jpg,7020,60,114,174,136,253,True,12
A,126,kaist_dataset/Mixed/Digital_Camera/(C.S)C-outdoor1/008.JPG,char_data/A/008.JPG_0.jpg,7812,62,401,463,132,258,True,12
A,22,kaist_dataset/Mixed/Digital_Camera/(C.S)C-outdoor1/135.JPG,char_data/A/135.JPG_0.jpg,374,17,295,312,199,221,True,12
A,22,kaist_dataset/Mixed/Digital_Camera/(C.S)C-outdoor1/135.JPG,char_data/A/135.JPG_0.jpg,418,19,327,346,197,219,True,12
A,48,kaist_dataset/Mixed/Digital_Camera/(C.S)C-outdoor1/3.JPG,char_data/A/3.JPG_0.jpg,1056,22,636,658,417,465,True,12
A,80,kaist_dataset/Mixed/Digital_Camera/(C.S)C-outdoor1/080119-0027.jpg,char_data/A/080119-0027.jpg_0.jpg,4400,55,697,752,720,800,True,12
A,25,kaist_dataset/Mixed/Digital_Camera/(C.S)C-outdoor1/021.JPG,char_data/A/021.JPG_0.jpg,350,14,465,479,206,231,True,12
A,32,kaist_dataset/Mixed/Digital_Camera/(C.S)C-outdoor1/054.JPG,char_data/A/054.JPG_0.jpg,800,25,351,376,273,305,True,12
A,155,kaist_dataset/Mixed/Digital_Camera/(C.S)C-outdoor1/080119-0003.jpg,char_data/A/080119-0003.jpg_0.jpg,15345,99,386,485,125,280,True,12
A,133,kaist_dataset/Mixed/Digital_Camera/(C.S)C-outdoor1/080119-0037.jpg,char_data/A/080119-0037.jpg_0.jpg,11571,87,642,729,861,994,True,12
A,81,kaist_dataset/Mixed/Digital_Camera/(C.S)C-outdoor1/2007-12-09-day-exterior-051.jpg,char_data/A/2007-12-09-day-exterior-051.jpg_0.jpg,7452,92,754,846,377,458,True,12
A,76,kaist_dataset/Mixed/Digital_Camera/(C.S)C-outdoor1/2007-12-09-day-exterior-051.jpg,char_data/A/2007-12-09-day-exterior-051.jpg_0.jpg,7752,102,914,1016,376,452,True,12
A,88,kaist_dataset/Mixed/Digital_Camera/(C.S)C-outdoor1/2007-12-09-day-exterior-051.jpg,char_data/A/2007-12-09-day-exterior-051.jpg_0.jpg,7920,90,193,283,1093,1181,True,12
A,83,kaist_dataset/Mixed/Digital_Camera/(C.S)C-outdoor1/2007-12-09-day-exterior-051.jpg,char_data/A/2007-12-09-day-exterior-051.jpg_0.jpg,9628,116,1361,1477,1103,1186,True,12
A,39,kaist_dataset/Mixed/Digital_Camera/(C.S)C-outdoor1/2007-12-08-day-103.jpg,char_data/A/2007-12-08-day-103.jpg_0.jpg,1209,31,556,587,610,649,True,12
A,42,kaist_dataset/Mixed/Digital_Camera/(C.S)C-outdoor1/2007-12-08-day-103.jpg,char_data/A/2007-12-08-day-103.jpg_0.jpg,1386,33,658,691,618,660,True,12
A,54,kaist_dataset/Mixed/Digital_Camera/(C.S)C-outdoor1/2007-12-08-day-130.jpg,char_data/A/2007-12-08-day-130.jpg_0.jpg,2322,43,774,817,694,748,True,12
A,66,kaist_dataset/Mixed/Digital_Camera/(C.S)C-outdoor1/080119-0008.jpg,char_data/A/080119-0008.jpg_0.jpg,2640,40,1203,1243,655,721,True,12
A,75,kaist_dataset/Mixed/Digital_Camera/(C.S)C-outdoor1/2.JPG,char_data/A/2.JPG_0.jpg,3375,45,298,343,208,283,True,12
A,63,kaist_dataset/Mixed/Digital_Camera/(C.S)C-outdoor1/2.JPG,char_data/A/2.JPG_0.jpg,2772,44,385,429,208,271,True,12
A,27,kaist_dataset/Mixed/Digital_Camera/(C.S)C-outdoor1/2.JPG,char_data/A/2.JPG_0.jpg,324,12,539,551,369,396,True,12
A,29,kaist_dataset/Mixed/Digital_Camera/(C.S)C-outdoor1/063.JPG,char_data/A/063.JPG_0.jpg,522,18,361,379,154,183,True,12
A,55,kaist_dataset/Mixed/Digital_Camera/(C.S)C-outdoor1/1.JPG,char_data/A/1.JPG_0.jpg,1980,36,528,564,281,336,True,12
A,62,kaist_dataset/Mixed/Digital_Camera/(C.S)C-outdoor1/014.JPG,char_data/A/014.JPG_0.jpg,1674,27,176,203,198,260,True,12
A,61,kaist_dataset/Mixed/Digital_Camera/(C.S)C-outdoor1/2007-12-08-day-091.jpg,char_data/A/2007-12-08-day-091.jpg_0.jpg,2928,48,285,333,608,669,True,12
A,64,kaist_dataset/Mixed/Digital_Camera/(C.S)C-outdoor1/2007-12-08-day-091.jpg,char_data/A/2007-12-08-day-091.jpg_0.jpg,3520,55,574,629,596,660,True,12
A,27,kaist_dataset/Mixed/Digital_Camera/(C.S)C-outdoor1/090.JPG,char_data/A/090.JPG_0.jpg,702,26,414,440,364,391,True,12
A,124,kaist_dataset/Mixed/Digital_Camera/(C.S)F-others/DSC02504.JPG,char_data/A/DSC02504.JPG_0.jpg,14756,119,47,166,135,259,True,12
A,47,kaist_dataset/Mixed/Digital_Camera/(C.S)F-others/DSC02504.JPG,char_data/A/DSC02504.JPG_0.jpg,1598,34,126,160,262,309,True,12
A,42,kaist_dataset/Mixed/Digital_Camera/(C.S)F-others/DSC02504.JPG,char_data/A/DSC02504.JPG_0.jpg,1134,27,373,400,320,362,True,12
A,35,kaist_dataset/Mixed/Digital_Camera/(C.S)F-others/DSC02504.JPG,char_data/A/DSC02504.JPG_0.jpg,1190,34,450,484,339,374,True,12
A,62,kaist_dataset/Mixed/Digital_Camera/(C.S)F-others/DSC02611.JPG,char_data/A/DSC02611.JPG_0.jpg,3410,55,258,313,79,141,True,12
A,32,kaist_dataset/Mixed/Digital_Camera/(C.S)F-others/097.jpg,char_data/A/097.jpg_0.jpg,544,17,196,213,163,195,True,12
A,52,kaist_dataset/Mixed/Digital_Camera/(C.S)F-others/085.jpg,char_data/A/085.jpg_0.jpg,1664,32,440,472,164,216,True,12
A,164,kaist_dataset/Mixed/Digital_Camera/(C.S)F-others/2007-12-09-day-exterior-032.jpg,char_data/A/2007-12-09-day-exterior-032.jpg_0.jpg,13940,85,539,624,977,1141,True,12
A,77,kaist_dataset/Mixed/Digital_Camera/(C.S)D-indoor2/P090911016.jpg,char_data/A/P090911016.jpg_0.jpg,4851,63,421,484,305,382,True,12
A,51,kaist_dataset/Mixed/Digital_Camera/(C.S)D-indoor2/DSC04421.JPG,char_data/A/DSC04421.JPG_0.jpg,2142,42,83,125,205,256,True,12
A,58,kaist_dataset/Mixed/Digital_Camera/(C.S)E-night/DSC02672.JPG,char_data/A/DSC02672.JPG_0.jpg,2320,40,74,114,93,151,True,12
A,51,kaist_dataset/Mixed/Digital_Camera/(C.S)E-night/DSC02672.JPG,char_data/A/DSC02672.JPG_0.jpg,1122,22,476,498,170,221,True,12
A,66,kaist_dataset/Mixed/Digital_Camera/(C.S)E-night/DSC02660.JPG,char_data/A/DSC02660.JPG_0.jpg,4356,66,262,328,74,140,True,12
A,32,kaist_dataset/Mixed/Digital_Camera/(C.S)E-night/DSC02660.JPG,char_data/A/DSC02660.JPG_0.jpg,704,22,347,369,380,412,True,12
A,43,kaist_dataset/Mixed/Digital_Camera/(C.S)E-night/DSC02574.JPG,char_data/A/DSC02574.JPG_0.jpg,1032,24,299,323,148,191,True,12
A,75,kaist_dataset/Mixed/Digital_Camera/(C.S)E-night/DSC03031.JPG,char_data/A/DSC03031.JPG_0.jpg,4125,55,350,405,66,141,True,12
A,29,kaist_dataset/Mixed/Digital_Camera/(C.S)E-night/DSC02673.JPG,char_data/A/DSC02673.JPG_0.jpg,319,11,422,433,306,335,True,12
A,30,kaist_dataset/Mixed/Digital_Camera/(C.S)E-night/DSC02569.JPG,char_data/A/DSC02569.JPG_0.jpg,810,27,273,300,276,306,True,12
A,38,kaist_dataset/Mixed/Digital_Camera/(C.S)E-night/DSC03871.JPG,char_data/A/DSC03871.JPG_0.jpg,874,23,243,266,183,221,True,12
A,39,kaist_dataset/Mixed/Digital_Camera/(C.S)E-night/DSC03871.JPG,char_data/A/DSC03871.JPG_0.jpg,819,21,405,426,188,227,True,12
A,32,kaist_dataset/Mixed/Digital_Camera/(C.S)E-night/DSC03871.JPG,char_data/A/DSC03871.JPG_0.jpg,576,18,478,496,195,227,True,12
A,91,kaist_dataset/Mixed/Digital_Camera/(C.S)D-indoor1/DSC02732.JPG,char_data/A/DSC02732.JPG_0.jpg,6734,74,259,333,139,230,True,12
A,45,kaist_dataset/Mixed/Digital_Camera/(C.S)D-indoor1/DSC03483.JPG,char_data/A/DSC03483.JPG_0.jpg,1440,32,317,349,374,419,True,12
A,42,kaist_dataset/Mixed/Digital_Camera/(C.S)D-indoor1/DSC04203.JPG,char_data/A/DSC04203.JPG_0.jpg,1092,26,68,94,287,329,True,12
A,53,kaist_dataset/Mixed/Digital_Camera/(C.S)D-indoor1/082.JPG,char_data/A/082.JPG_0.jpg,1908,36,128,164,174,227,True,12
A,81,kaist_dataset/Mixed/Digital_Camera/(C.S)D-indoor1/DSC03472.JPG,char_data/A/DSC03472.JPG_0.jpg,4617,57,313,370,18,99,True,12
A,35,kaist_dataset/Mixed/Digital_Camera/(C.S)D-indoor1/DSC02785.JPG,char_data/A/DSC02785.JPG_0.jpg,2100,60,79,139,244,279,True,12
A,117,kaist_dataset/Mixed/Digital_Camera/(C.S)D-indoor1/DSC02840.JPG,char_data/A/DSC02840.JPG_0.jpg,13455,115,408,523,236,353,True,12
A,35,kaist_dataset/Mixed/Digital_Camera/(C.S)D-indoor1/DSC03904.JPG,char_data/A/DSC03904.JPG_0.jpg,665,19,291,310,213,248,True,12
A,57,kaist_dataset/Mixed/Digital_Camera/(C.S)D-indoor1/DSC03479.JPG,char_data/A/DSC03479.JPG_0.jpg,2508,44,147,191,275,332,True,12
A,45,kaist_dataset/Mixed/Digital_Camera/(C.S)D-indoor1/DSC04183.JPG,char_data/A/DSC04183.JPG_0.jpg,1395,31,293,324,249,294,True,12
A,43,kaist_dataset/Mixed/Digital_Camera/(C.S)D-indoor1/DSC03980.JPG,char_data/A/DSC03980.JPG_0.jpg,946,22,236,258,133,176,True,12
A,35,kaist_dataset/Mixed/Digital_Camera/(C.S)D-indoor1/DSC03980.JPG,char_data/A/DSC03980.JPG_0.jpg,840,24,396,420,147,182,True,12
A,38,kaist_dataset/Mixed/Digital_Camera/(C.S)D-indoor1/DSC03980.JPG,char_data/A/DSC03980.JPG_0.jpg,950,25,511,536,145,183,True,12
A,178,kaist_dataset/Mixed/Digital_Camera/(C.S)D-indoor1/DSC04223.JPG,char_data/A/DSC04223.JPG_0.jpg,22250,125,62,187,12,190,True,12
A,45,kaist_dataset/Mixed/Digital_Camera/(C.S)D-indoor1/DSC02782.JPG,char_data/A/DSC02782.JPG_0.jpg,2340,52,97,149,177,222,True,12
A,39,kaist_dataset/Mixed/Digital_Camera/(C.S)D-indoor1/DSC02714.JPG,char_data/A/DSC02714.JPG_0.jpg,1599,41,235,276,75,114,True,12
A,40,kaist_dataset/Mixed/Digital_Camera/(C.S)C-outdoor5/DSC04098.JPG,char_data/A/DSC04098.JPG_0.jpg,1640,41,133,174,91,131,True,12
A,35,kaist_dataset/Mixed/Digital_Camera/(C.S)C-outdoor5/DSC04098.JPG,char_data/A/DSC04098.JPG_0.jpg,1190,34,216,250,78,113,True,12
A,55,kaist_dataset/Mixed/Digital_Camera/(C.S)C-outdoor5/DSC04060.JPG,char_data/A/DSC04060.JPG_0.jpg,2090,38,314,352,179,234,True,12
A,43,kaist_dataset/Mixed/Digital_Camera/(C.S)C-outdoor5/DSC04312.JPG,char_data/A/DSC04312.JPG_0.jpg,1290,30,360,390,103,146,True,12
A,54,kaist_dataset/Mixed/Digital_Camera/(C.S)C-outdoor5/DSC04119.JPG,char_data/A/DSC04119.JPG_0.jpg,2106,39,381,420,125,179,True,12
A,26,kaist_dataset/Mixed/Digital_Camera/(C.S)C-outdoor5/DSC04357.JPG,char_data/A/DSC04357.JPG_0.jpg,546,21,244,265,352,378,True,12
A,50,kaist_dataset/Mixed/Digital_Camera/(C.S)C-outdoor5/DSC04305.JPG,char_data/A/DSC04305.JPG_0.jpg,1850,37,360,397,81,131,True,12
A,51,kaist_dataset/Mixed/Digital_Camera/(C.S)C-outdoor5/DSC04305.JPG,char_data/A/DSC04305.JPG_0.jpg,1581,31,471,502,79,130,True,12
A,55,kaist_dataset/Mixed/Digital_Camera/(C.S)C-outdoor5/DSC04014.JPG,char_data/A/DSC04014.JPG_0.jpg,2090,38,232,270,99,154,True,12
A,29,kaist_dataset/Mixed/Digital_Camera/(C.S)C-outdoor5/DSC03829.JPG,char_data/A/DSC03829.JPG_0.jpg,551,19,303,322,178,207,True,12
A,40,kaist_dataset/Mixed/Digital_Camera/(C.S)C-outdoor5/DSC03837.JPG,char_data/A/DSC03837.JPG_0.jpg,1200,30,244,274,379,419,True,12
A,32,kaist_dataset/Mixed/Digital_Camera/(C.S)C-outdoor5/P1010004.JPG,char_data/A/P1010004.JPG_0.jpg,1504,47,497,544,249,281,True,12
A,22,kaist_dataset/Mixed/Digital_Camera/(C.S)C-outdoor5/DSC04031.JPG,char_data/A/DSC04031.JPG_0.jpg,242,11,433,444,384,406,True,12
A,25,kaist_dataset/Mixed/Digital_Camera/(C.S)C-outdoor5/DSC04091.JPG,char_data/A/DSC04091.JPG_0.jpg,475,19,321,340,428,453,True,12
A,37,kaist_dataset/Mixed/Digital_Camera/(C.S)C-outdoor5/DSC04338.JPG,char_data/A/DSC04338.JPG_0.jpg,851,23,119,142,197,234,True,12
A,40,kaist_dataset/Mixed/Digital_Camera/(C.S)C-outdoor5/DSC04338.JPG,char_data/A/DSC04338.JPG_0.jpg,1400,35,246,281,197,237,True,12
A,49,kaist_dataset/Mixed/Digital_Camera/(C.S)C-outdoor5/DSC04055.JPG,char_data/A/DSC04055.JPG_0.jpg,1813,37,294,331,179,228,True,12
A,108,kaist_dataset/Mixed/Digital_Camera/(C.S)C-outdoor5/DSC04055.JPG,char_data/A/DSC04055.JPG_0.jpg,10260,95,184,279,245,353,True,12
A,36,kaist_dataset/Mixed/Digital_Camera/(C.S)C-outdoor5/DSC04434.JPG,char_data/A/DSC04434.JPG_0.jpg,576,16,177,193,266,302,True,12
A,30,kaist_dataset/Mixed/Digital_Camera/(C.S)C-outdoor5/DSC04434.JPG,char_data/A/DSC04434.JPG_0.jpg,540,18,215,233,273,303,True,12
A,35,kaist_dataset/Mixed/Digital_Camera/(C.S)C-outdoor5/DSC04434.JPG,char_data/A/DSC04434.JPG_0.jpg,490,14,296,310,270,305,True,12
A,37,kaist_dataset/Mixed/Digital_Camera/(C.S)C-outdoor5/DSC04434.JPG,char_data/A/DSC04434.JPG_0.jpg,962,26,213,239,388,425,True,12
A,35,kaist_dataset/Mixed/Digital_Camera/(C.S)C-outdoor5/DSC04434.JPG,char_data/A/DSC04434.JPG_0.jpg,840,24,267,291,389,424,True,12
A,30,kaist_dataset/Mixed/Digital_Camera/(C.S)C-outdoor5/DSC04056.JPG,char_data/A/DSC04056.JPG_0.jpg,870,29,147,176,284,314,True,12
A,26,kaist_dataset/Mixed/Digital_Camera/(C.S)C-outdoor3/DSC03255.JPG,char_data/A/DSC03255.JPG_0.jpg,364,14,524,538,178,204,True,12
A,67,kaist_dataset/Mixed/Digital_Camera/(C.S)C-outdoor3/DSC03048.JPG,char_data/A/DSC03048.JPG_0.jpg,2881,43,376,419,128,195,True,12
A,78,kaist_dataset/Mixed/Digital_Camera/(C.S)C-outdoor3/DSC03164.JPG,char_data/A/DSC03164.JPG_0.jpg,5850,75,140,215,80,158,True,12
A,35,kaist_dataset/Mixed/Digital_Camera/(C.S)C-outdoor3/DSC03209.JPG,char_data/A/DSC03209.JPG_0.jpg,1050,30,175,205,415,450,True,12
A,121,kaist_dataset/Mixed/Digital_Camera/(C.S)C-outdoor3/DSC03186.JPG,char_data/A/DSC03186.JPG_0.jpg,14762,122,367,489,33,154,True,12
A,47,kaist_dataset/Mixed/Digital_Camera/(C.S)C-outdoor3/DSC03249.JPG,char_data/A/DSC03249.JPG_0.jpg,1551,33,195,228,238,285,True,12
A,39,kaist_dataset/Mixed/Digital_Camera/(C.S)C-outdoor3/DSC03210.JPG,char_data/A/DSC03210.JPG_0.jpg,663,17,157,174,143,182,True,12
A,37,kaist_dataset/Mixed/Digital_Camera/(C.S)C-outdoor3/DSC03035.JPG,char_data/A/DSC03035.JPG_0.jpg,666,18,266,284,364,401,True,12
A,81,kaist_dataset/Mixed/Digital_Camera/(C.S)C-outdoor3/DSC03422.JPG,char_data/A/DSC03422.JPG_0.jpg,3402,42,271,313,239,320,True,12
A,63,kaist_dataset/Mixed/Digital_Camera/(C.S)C-outdoor3/DSC03306.JPG,char_data/A/DSC03306.JPG_0.jpg,2142,34,426,460,391,454,True,12
A,162,kaist_dataset/Mixed/Digital_Camera/(C.S)C-outdoor3/DSC03006.JPG,char_data/A/DSC03006.JPG_0.jpg,14256,88,255,343,97,259,True,12
A,143,kaist_dataset/Mixed/Digital_Camera/(C.S)C-outdoor3/DSC03006.JPG,char_data/A/DSC03006.JPG_0.jpg,9867,69,568,637,117,260,True,12
A,23,kaist_dataset/Mixed/Digital_Camera/(C.S)C-outdoor3/DSC03033.JPG,char_data/A/DSC03033.JPG_0.jpg,368,16,113,129,127,150,True,12
A,99,kaist_dataset/Mixed/Digital_Camera/(C.S)C-outdoor3/DSC03247.JPG,char_data/A/DSC03247.JPG_0.jpg,5643,57,136,193,135,234,True,12
A,105,kaist_dataset/Mixed/Digital_Camera/(C.S)C-outdoor3/DSC03217.JPG,char_data/A/DSC03217.JPG_0.jpg,15540,148,36,184,222,327,True,12
A,59,kaist_dataset/Mixed/Digital_Camera/(C.S)C-outdoor3/DSC03283.JPG,char_data/A/DSC03283.JPG_0.jpg,3186,54,184,238,72,131,True,12
A,119,kaist_dataset/Mixed/Digital_Camera/(C.S)C-outdoor3/DSC03259.JPG,char_data/A/DSC03259.JPG_0.jpg,14399,121,396,517,66,185,True,12
A,44,kaist_dataset/Mixed/Digital_Camera/(C.S)C-outdoor3/DSC03020.JPG,char_data/A/DSC03020.JPG_0.jpg,924,21,288,309,255,299,True,12
A,39,kaist_dataset/Mixed/Digital_Camera/(C.S)C-outdoor3/DSC03020.JPG,char_data/A/DSC03020.JPG_0.jpg,975,25,401,426,260,299,True,12
A,30,kaist_dataset/Mixed/Digital_Camera/(C.S)C-outdoor3/DSC03020.JPG,char_data/A/DSC03020.JPG_0.jpg,690,23,476,499,267,297,True,12
A,72,kaist_dataset/Mixed/Digital_Camera/(C.S)C-outdoor3/DSC03415.JPG,char_data/A/DSC03415.JPG_0.jpg,2592,36,363,399,160,232,True,12
A,41,kaist_dataset/Mixed/Digital_Camera/(C.S)C-outdoor3/DSC03061.JPG,char_data/A/DSC03061.JPG_0.jpg,1804,44,355,399,157,198,True,12
A,39,kaist_dataset/Mixed/Digital_Camera/(C.S)C-outdoor3/DSC02989.JPG,char_data/A/DSC02989.JPG_0.jpg,1170,30,262,292,267,306,True,12
A,33,kaist_dataset/Mixed/Digital_Camera/(C.S)C-outdoor6/DSC03324.JPG,char_data/A/DSC03324.JPG_0.jpg,693,21,39,60,60,93,True,12
A,27,kaist_dataset/Mixed/Digital_Camera/(C.S)C-outdoor6/P1010088.JPG,char_data/A/P1010088.JPG_0.jpg,513,19,287,306,181,208,True,12
A,28,kaist_dataset/Mixed/Digital_Camera/(C.S)C-outdoor6/P1010088.JPG,char_data/A/P1010088.JPG_0.jpg,672,24,384,408,178,206,True,12
A,28,kaist_dataset/Mixed/Digital_Camera/(C.S)C-outdoor6/P1010090.JPG,char_data/A/P1010090.JPG_0.jpg,588,21,222,243,202,230,True,12
A,234,kaist_dataset/Mixed/Digital_Camera/(C.S)C-outdoor6/080116-0057.jpg,char_data/A/080116-0057.jpg_0.jpg,41418,177,152,329,277,511,True,12
A,16,kaist_dataset/Mixed/Digital_Camera/(C.S)C-outdoor6/P1010065.JPG,char_data/A/P1010065.JPG_0.jpg,176,11,105,116,110,126,True,12
A,22,kaist_dataset/Mixed/Digital_Camera/(C.S)C-outdoor6/P1010065.JPG,char_data/A/P1010065.JPG_0.jpg,308,14,186,200,107,129,True,12
A,20,kaist_dataset/Mixed/Digital_Camera/(C.S)C-outdoor6/P1010065.JPG,char_data/A/P1010065.JPG_0.jpg,220,11,227,238,108,128,True,12
A,52,kaist_dataset/Mixed/Digital_Camera/(C.S)C-outdoor6/117.JPG,char_data/A/117.JPG_0.jpg,3692,71,83,154,191,243,True,12
A,28,kaist_dataset/Mixed/Digital_Camera/(C.S)C-outdoor6/P1010095.JPG,char_data/A/P1010095.JPG_0.jpg,280,10,148,158,183,211,True,12
A,36,kaist_dataset/Mixed/Digital_Camera/(C.S)C-outdoor4/DSC03716.JPG,char_data/A/DSC03716.JPG_0.jpg,468,13,389,402,237,273,True,12
A,34,kaist_dataset/Mixed/Digital_Camera/(C.S)C-outdoor4/DSC03716.JPG,char_data/A/DSC03716.JPG_0.jpg,442,13,414,427,239,273,True,12
A,48,kaist_dataset/Mixed/Digital_Camera/(C.S)C-outdoor4/DSC03531.JPG,char_data/A/DSC03531.JPG_0.jpg,1968,41,437,478,350,398,True,12
A,42,kaist_dataset/Mixed/Digital_Camera/(C.S)C-outdoor4/DSC03711.JPG,char_data/A/DSC03711.JPG_0.jpg,1008,24,384,408,381,423,True,12
A,74,kaist_dataset/Mixed/Digital_Camera/(C.S)C-outdoor4/DSC03640.JPG,char_data/A/DSC03640.JPG_0.jpg,4440,60,448,508,304,378,True,12
A,46,kaist_dataset/Mixed/Digital_Camera/(C.S)C-outdoor4/DSC03781.JPG,char_data/A/DSC03781.JPG_0.jpg,3404,74,174,248,217,263,True,12
A,63,kaist_dataset/Mixed/Digital_Camera/(C.S)C-outdoor4/DSC03673.JPG,char_data/A/DSC03673.JPG_0.jpg,2331,37,135,172,182,245,True,12
A,89,kaist_dataset/Mixed/Digital_Camera/(C.S)C-outdoor4/DSC03571.JPG,char_data/A/DSC03571.JPG_0.jpg,5429,61,414,475,186,275,True,12
A,40,kaist_dataset/Mixed/Digital_Camera/(C.S)C-outdoor4/DSC03679.JPG,char_data/A/DSC03679.JPG_0.jpg,920,23,57,80,96,136,True,12
A,53,kaist_dataset/Mixed/Digital_Camera/(C.S)C-outdoor4/DSC03666.JPG,char_data/A/DSC03666.JPG_0.jpg,2067,39,26,65,143,196,True,12
A,69,kaist_dataset/Mixed/Digital_Camera/(C.S)C-outdoor4/DSC03687.JPG,char_data/A/DSC03687.JPG_0.jpg,4071,59,278,337,324,393,True,12
A,67,kaist_dataset/Mixed/Digital_Camera/(C.S)C-outdoor4/DSC03687.JPG,char_data/A/DSC03687.JPG_0.jpg,3417,51,392,443,323,390,True,12
A,23,kaist_dataset/Mixed/Digital_Camera/(C.S)C-outdoor4/DSC03687.JPG,char_data/A/DSC03687.JPG_0.jpg,368,16,174,190,296,319,True,12
A,29,kaist_dataset/Mixed/Digital_Camera/(C.S)C-outdoor4/DSC03687.JPG,char_data/A/DSC03687.JPG_0.jpg,435,15,220,235,294,323,True,12
A,20,kaist_dataset/Mixed/Digital_Camera/(C.S)C-outdoor2/DSC02421.JPG,char_data/A/DSC02421.JPG_0.jpg,620,31,403,434,210,230,True,12
A,33,kaist_dataset/Mixed/Digital_Camera/(C.S)C-outdoor2/DSC02624.JPG,char_data/A/DSC02624.JPG_0.jpg,627,19,192,211,396,429,True,12
A,120,kaist_dataset/Mixed/Digital_Camera/(C.S)C-outdoor2/DSC02551.JPG,char_data/A/DSC02551.JPG_0.jpg,12600,105,161,266,270,390,True,12
A,33,kaist_dataset/Mixed/Digital_Camera/(C.S)C-outdoor2/DSC02419.JPG,char_data/A/DSC02419.JPG_0.jpg,990,30,117,147,208,241,True,12
A,31,kaist_dataset/Mixed/Digital_Camera/(C.S)C-outdoor2/DSC02419.JPG,char_data/A/DSC02419.JPG_0.jpg,992,32,182,214,210,241,True,12
A,24,kaist_dataset/Mixed/Digital_Camera/(C.S)C-outdoor2/DSC02555.JPG,char_data/A/DSC02555.JPG_0.jpg,408,17,111,128,152,176,True,12
A,23,kaist_dataset/Mixed/Digital_Camera/(C.S)C-outdoor2/DSC02477.JPG,char_data/A/DSC02477.JPG_0.jpg,322,14,100,114,157,180,True,12
A,50,kaist_dataset/Mixed/Digital_Camera/(C.S)C-outdoor2/DSC02502.JPG,char_data/A/DSC02502.JPG_0.jpg,2050,41,141,182,81,131,True,12
A,37,kaist_dataset/Mixed/Digital_Camera/(C.S)C-outdoor2/DSC02910.JPG,char_data/A/DSC02910.JPG_0.jpg,703,19,354,373,54,91,True,12
A,36,kaist_dataset/Mixed/Digital_Camera/(C.S)C-outdoor2/DSC02910.JPG,char_data/A/DSC02910.JPG_0.jpg,828,23,460,483,55,91,True,12
A,34,kaist_dataset/Mixed/Digital_Camera/(C.S)C-outdoor2/DSC02385.JPG,char_data/A/DSC02385.JPG_0.jpg,612,18,498,516,137,171,True,12
A,24,kaist_dataset/Mixed/Digital_Camera/(C.S)C-outdoor2/DSC02439.JPG,char_data/A/DSC02439.JPG_0.jpg,528,22,438,460,108,132,True,12
A,49,kaist_dataset/Mixed/Digital_Camera/(C.S)C-outdoor2/DSC02872.JPG,char_data/A/DSC02872.JPG_0.jpg,1323,27,266,293,217,266,True,12
A,34,kaist_dataset/Mixed/Digital_Camera/(C.S)C-outdoor2/DSC02568.JPG,char_data/A/DSC02568.JPG_0.jpg,1122,33,121,154,143,177,True,12
A,51,kaist_dataset/Mixed/Digital_Camera/(C.S)C-outdoor2/DSC02924.JPG,char_data/A/DSC02924.JPG_0.jpg,2040,40,210,250,314,365,True,12
A,33,kaist_dataset/Mixed/Digital_Camera/(C.S)A-shadow/DSC02624.JPG,char_data/A/DSC02624.JPG_0.jpg,627,19,192,211,396,429,True,12
A,34,kaist_dataset/Mixed/Digital_Camera/(C.S)A-shadow/DSC02568.JPG,char_data/A/DSC02568.JPG_0.jpg,1122,33,121,154,143,177,True,12
A,115,kaist_dataset/English/Mobile_Phone/(E.M)A-outdoor/P090911085.jpg,char_data/A/P090911085.jpg_0.jpg,12075,105,28,133,120,235,True,12
A,112,kaist_dataset/English/Mobile_Phone/(E.M)A-outdoor/P090911064.jpg,char_data/A/P090911064.jpg_0.jpg,14448,129,307,436,121,233,True,12
A,78,kaist_dataset/English/Mobile_Phone/(E.M)B-indoor/P090902018.jpg,char_data/A/P090902018.jpg_0.jpg,3354,43,365,408,59,137,True,12
A,102,kaist_dataset/English/Mobile_Phone/(E.M)B-indoor/P090911086.jpg,char_data/A/P090911086.jpg_0.jpg,10098,99,11,110,226,328,True,12
A,118,kaist_dataset/English/Mobile_Phone/(E.M)B-indoor/P090903002.jpg,char_data/A/P090903002.jpg_0.jpg,13334,113,10,123,278,396,True,12
A,80,kaist_dataset/English/Mobile_Phone/(E.M)C-bookCover/P090903056.jpg,char_data/A/P090903056.jpg_0.jpg,7840,98,387,485,308,388,True,12
A,97,kaist_dataset/English/Mobile_Phone/(E.M)C-bookCover/P090903076.jpg,char_data/A/P090903076.jpg_0.jpg,7566,78,295,373,288,385,True,12
A,50,kaist_dataset/English/Mobile_Phone/(E.M)C-bookCover/P090903076.jpg,char_data/A/P090903076.jpg_0.jpg,2100,42,208,250,387,437,True,12
A,81,kaist_dataset/English/Mobile_Phone/(E.M)C-bookCover/P090903071.jpg,char_data/A/P090903071.jpg_0.jpg,5103,63,176,239,141,222,True,12
A,69,kaist_dataset/English/Mobile_Phone/(E.M)C-bookCover/P090903071.jpg,char_data/A/P090903071.jpg_0.jpg,3726,54,159,213,223,292,True,12
A,71,kaist_dataset/English/Mobile_Phone/(E.M)C-bookCover/P090903071.jpg,char_data/A/P090903071.jpg_0.jpg,4331,61,271,332,220,291,True,12
A,33,kaist_dataset/English/Mobile_Phone/(E.M)C-bookCover/P090903071.jpg,char_data/A/P090903071.jpg_0.jpg,990,30,251,281,301,334,True,12
A,105,kaist_dataset/English/Mobile_Phone/(E.M)C-bookCover/P090905007.jpg,char_data/A/P090905007.jpg_0.jpg,9450,90,15,105,143,248,True,12
A,82,kaist_dataset/English/Mobile_Phone/(E.M)C-bookCover/P090905007.jpg,char_data/A/P090905007.jpg_0.jpg,5084,62,428,490,170,252,True,12
A,73,kaist_dataset/English/Mobile_Phone/(E.M)C-bookCover/P090903041.jpg,char_data/A/P090903041.jpg_0.jpg,5110,70,6,76,11,84,True,12
A,132,kaist_dataset/English/Mobile_Phone/(E.M)C-bookCover/P090831039.jpg,char_data/A/P090831039.jpg_0.jpg,15312,116,20,136,216,348,True,12
A,59,kaist_dataset/English/Mobile_Phone/(E.M)C-bookCover/P090903054.jpg,char_data/A/P090903054.jpg_0.jpg,1829,31,140,171,354,413,True,12
A,100,kaist_dataset/English/Mobile_Phone/(E.M)C-bookCover/P090903050.jpg,char_data/A/P090903050.jpg_0.jpg,9000,90,244,334,83,183,True,12
A,133,kaist_dataset/English/Mobile_Phone/(E.M)C-bookCover/P090831037.jpg,char_data/A/P090831037.jpg_0.jpg,14364,108,60,168,50,183,True,12
A,157,kaist_dataset/English/Mobile_Phone/(E.M)C-bookCover/P090903081.jpg,char_data/A/P090903081.jpg_0.jpg,12089,77,132,209,99,256,True,12
A,168,kaist_dataset/English/Mobile_Phone/(E.M)C-bookCover/P090903081.jpg,char_data/A/P090903081.jpg_0.jpg,14616,87,498,585,111,279,True,12
A,65,kaist_dataset/English/Mobile_Phone/(E.M)C-bookCover/P090831075.jpg,char_data/A/P090831075.jpg_0.jpg,3770,58,509,567,158,223,True,12
A,63,kaist_dataset/English/Mobile_Phone/(E.M)C-bookCover/P090831075.jpg,char_data/A/P090831075.jpg_0.jpg,3276,52,348,400,282,345,True,12
A,74,kaist_dataset/English/Mobile_Phone/(E.M)C-bookCover/P090903055.jpg,char_data/A/P090903055.jpg_0.jpg,6068,82,396,478,166,240,True,12
A,83,kaist_dataset/English/Mobile_Phone/(E.M)C-bookCover/P090831042.jpg,char_data/A/P090831042.jpg_0.jpg,4648,56,342,398,194,277,True,12
A,47,kaist_dataset/English/Mobile_Phone/(E.M)C-bookCover/P090903015.jpg,char_data/A/P090903015.jpg_0.jpg,1833,39,234,273,148,195,True,12
A,90,kaist_dataset/English/Digital_Camera/(E.S)E-night/크기변환_P1010163.JPG,char_data/A/크기변환_P1010163.JPG_0.jpg,7920,88,15,103,84,174,True,12
A,34,kaist_dataset/English/Digital_Camera/(E.S)E-night/t.jpg,char_data/A/t.jpg_0.jpg,816,24,129,153,69,103,True,12
A,90,kaist_dataset/English/Digital_Camera/(E.S)E-night/DSC02641.JPG,char_data/A/DSC02641.JPG_0.jpg,5220,58,197,255,268,358,True,12
A,92,kaist_dataset/English/Digital_Camera/(E.S)E-night/DSC02675.JPG,char_data/A/DSC02675.JPG_0.jpg,6624,72,132,204,176,268,True,12
A,15,kaist_dataset/English/Digital_Camera/(E.S)E-night/111.jpg,char_data/A/111.jpg_0.jpg,135,9,232,241,285,300,True,12
A,16,kaist_dataset/English/Digital_Camera/(E.S)E-night/111.jpg,char_data/A/111.jpg_0.jpg,192,12,305,317,269,285,True,12
A,99,kaist_dataset/English/Digital_Camera/(E.S)E-night/DSC02674.JPG,char_data/A/DSC02674.JPG_0.jpg,8514,86,312,398,198,297,True,12
A,48,kaist_dataset/English/Digital_Camera/(E.S)C-outdoor2/DSC03023.JPG,char_data/A/DSC03023.JPG_0.jpg,1152,24,192,216,301,349,True,12
A,51,kaist_dataset/English/Digital_Camera/(E.S)C-outdoor2/DSC03023.JPG,char_data/A/DSC03023.JPG_0.jpg,1530,30,285,315,303,354,True,12
A,87,kaist_dataset/English/Digital_Camera/(E.S)C-outdoor2/DSC02993.JPG,char_data/A/DSC02993.JPG_0.jpg,5481,63,218,281,117,204,True,12
A,43,kaist_dataset/English/Digital_Camera/(E.S)C-outdoor2/DSC03317.JPG,char_data/A/DSC03317.JPG_0.jpg,946,22,438,460,259,302,True,12
A,37,kaist_dataset/English/Digital_Camera/(E.S)C-outdoor2/DSC03317.JPG,char_data/A/DSC03317.JPG_0.jpg,777,21,433,454,200,237,True,12
A,43,kaist_dataset/English/Digital_Camera/(E.S)C-outdoor2/DSC03317.JPG,char_data/A/DSC03317.JPG_0.jpg,946,22,493,515,197,240,True,12
A,75,kaist_dataset/English/Digital_Camera/(E.S)C-outdoor2/DSC04079.JPG,char_data/A/DSC04079.JPG_0.jpg,3900,52,461,513,269,344,True,12
A,68,kaist_dataset/English/Digital_Camera/(E.S)C-outdoor2/DSC03208.JPG,char_data/A/DSC03208.JPG_0.jpg,5848,86,254,340,200,268,True,12
A,180,kaist_dataset/English/Digital_Camera/(E.S)C-outdoor2/DSC02949.JPG,char_data/A/DSC02949.JPG_0.jpg,6660,37,250,287,63,243,True,12
A,68,kaist_dataset/English/Digital_Camera/(E.S)C-outdoor2/DSC03025.JPG,char_data/A/DSC03025.JPG_0.jpg,2516,37,216,253,125,193,True,12
A,59,kaist_dataset/English/Digital_Camera/(E.S)C-outdoor2/DSC04120.JPG,char_data/A/DSC04120.JPG_0.jpg,2065,35,85,120,146,205,True,12
A,54,kaist_dataset/English/Digital_Camera/(E.S)C-outdoor2/DSC04120.JPG,char_data/A/DSC04120.JPG_0.jpg,1998,37,301,338,149,203,True,12
A,48,kaist_dataset/English/Digital_Camera/(E.S)C-outdoor2/DSC03650.JPG,char_data/A/DSC03650.JPG_0.jpg,1536,32,145,177,211,259,True,12
A,46,kaist_dataset/English/Digital_Camera/(E.S)C-outdoor2/DSC03650.JPG,char_data/A/DSC03650.JPG_0.jpg,1426,31,251,282,212,258,True,12
A,68,kaist_dataset/English/Digital_Camera/(E.S)C-outdoor2/DSC03191.JPG,char_data/A/DSC03191.JPG_0.jpg,3672,54,137,191,141,209,True,12
A,54,kaist_dataset/English/Digital_Camera/(E.S)C-outdoor2/DSC03161.JPG,char_data/A/DSC03161.JPG_0.jpg,1404,26,336,362,212,266,True,12
A,65,kaist_dataset/English/Digital_Camera/(E.S)C-outdoor2/DSC03161.JPG,char_data/A/DSC03161.JPG_0.jpg,2015,31,390,421,206,271,True,12
A,69,kaist_dataset/English/Digital_Camera/(E.S)C-outdoor2/DSC04410.JPG,char_data/A/DSC04410.JPG_0.jpg,4416,64,273,337,148,217,True,12
A,44,kaist_dataset/English/Digital_Camera/(E.S)C-outdoor2/DSC03203.JPG,char_data/A/DSC03203.JPG_0.jpg,1540,35,469,504,316,360,True,12
A,69,kaist_dataset/English/Digital_Camera/(E.S)C-outdoor2/DSC03865.JPG,char_data/A/DSC03865.JPG_0.jpg,3243,47,340,387,87,156,True,12
A,67,kaist_dataset/English/Digital_Camera/(E.S)C-outdoor2/DSC03865.JPG,char_data/A/DSC03865.JPG_0.jpg,3015,45,450,495,95,162,True,12
A,67,kaist_dataset/English/Digital_Camera/(E.S)C-outdoor2/DSC03412.JPG,char_data/A/DSC03412.JPG_0.jpg,4355,65,472,537,397,464,True,12
A,75,kaist_dataset/English/Digital_Camera/(E.S)C-outdoor2/DSC03412.JPG,char_data/A/DSC03412.JPG_0.jpg,4725,63,145,208,135,210,True,12
A,52,kaist_dataset/English/Digital_Camera/(E.S)C-outdoor2/DSC03575.JPG,char_data/A/DSC03575.JPG_0.jpg,1664,32,233,265,261,313,True,12
A,142,kaist_dataset/English/Digital_Camera/(E.S)C-outdoor2/DSC03786.JPG,char_data/A/DSC03786.JPG_0.jpg,16188,114,90,204,17,159,True,12
A,65,kaist_dataset/English/Digital_Camera/(E.S)C-outdoor2/DSC03307.JPG,char_data/A/DSC03307.JPG_0.jpg,2665,41,265,306,224,289,True,12
A,61,kaist_dataset/English/Digital_Camera/(E.S)C-outdoor2/DSC04464.JPG,char_data/A/DSC04464.JPG_0.jpg,2318,38,131,169,317,378,True,12
A,69,kaist_dataset/English/Digital_Camera/(E.S)C-outdoor2/DSC03413.JPG,char_data/A/DSC03413.JPG_0.jpg,3381,49,232,281,192,261,True,12
A,80,kaist_dataset/English/Digital_Camera/(E.S)C-outdoor2/DSC03432.JPG,char_data/A/DSC03432.JPG_0.jpg,5040,63,353,416,357,437,True,12
A,69,kaist_dataset/English/Digital_Camera/(E.S)C-outdoor2/DSC03225.JPG,char_data/A/DSC03225.JPG_0.jpg,4071,59,241,300,51,120,True,12
A,68,kaist_dataset/English/Digital_Camera/(E.S)C-outdoor2/DSC03264.JPG,char_data/A/DSC03264.JPG_0.jpg,3536,52,242,294,229,297,True,12
A,165,kaist_dataset/English/Digital_Camera/(E.S)C-outdoor2/DSC03160.JPG,char_data/A/DSC03160.JPG_0.jpg,25410,154,193,347,214,379,True,12
A,154,kaist_dataset/English/Digital_Camera/(E.S)C-outdoor2/DSC03160.JPG,char_data/A/DSC03160.JPG_0.jpg,24640,160,442,602,216,370,True,12
A,98,kaist_dataset/English/Digital_Camera/(E.S)C-outdoor2/DSC02984.JPG,char_data/A/DSC02984.JPG_0.jpg,6860,70,148,218,101,199,True,12
A,36,kaist_dataset/English/Digital_Camera/(E.S)C-outdoor2/DSC04080.JPG,char_data/A/DSC04080.JPG_0.jpg,1368,38,288,326,357,393,True,12
A,67,kaist_dataset/English/Digital_Camera/(E.S)C-outdoor2/DSC04131.JPG,char_data/A/DSC04131.JPG_0.jpg,5293,79,318,397,134,201,True,12
A,65,kaist_dataset/English/Digital_Camera/(E.S)C-outdoor2/DSC03684.JPG,char_data/A/DSC03684.JPG_0.jpg,2600,40,380,420,88,153,True,12
A,96,kaist_dataset/English/Digital_Camera/(E.S)C-outdoor1/DSC02306.JPG,char_data/A/DSC02306.JPG_0.jpg,7968,83,251,334,146,242,True,12
A,93,kaist_dataset/English/Digital_Camera/(E.S)C-outdoor1/DSC02306.JPG,char_data/A/DSC02306.JPG_0.jpg,8277,89,538,627,154,247,True,12
A,78,kaist_dataset/English/Digital_Camera/(E.S)C-outdoor1/DSC02356.JPG,char_data/A/DSC02356.JPG_0.jpg,4368,56,494,550,166,244,True,12
A,83,kaist_dataset/English/Digital_Camera/(E.S)C-outdoor1/DSC02514.JPG,char_data/A/DSC02514.JPG_0.jpg,3652,44,157,201,155,238,True,12
A,137,kaist_dataset/English/Digital_Camera/(E.S)C-outdoor1/DSC02618.JPG,char_data/A/DSC02618.JPG_0.jpg,16577,121,261,382,212,349,True,12
A,210,kaist_dataset/English/Digital_Camera/(E.S)C-outdoor1/2007-12-08-day-099.jpg,char_data/A/2007-12-08-day-099.jpg_0.jpg,25410,121,1024,1145,461,671,True,12
A,34,kaist_dataset/English/Digital_Camera/(E.S)C-outdoor1/DSC02345.JPG,char_data/A/DSC02345.JPG_0.jpg,680,20,424,444,233,267,True,12
A,97,kaist_dataset/English/Digital_Camera/(E.S)C-outdoor1/083.JPG,char_data/A/083.JPG_0.jpg,7566,78,235,313,175,272,True,12
A,97,kaist_dataset/English/Digital_Camera/(E.S)C-outdoor1/DSC02410.JPG,char_data/A/DSC02410.JPG_0.jpg,8342,86,23,109,115,212,True,12
A,86,kaist_dataset/English/Digital_Camera/(E.S)C-outdoor1/DSC02410.JPG,char_data/A/DSC02410.JPG_0.jpg,6794,79,314,393,117,203,True,12
A,74,kaist_dataset/English/Digital_Camera/(E.S)C-outdoor1/DSC02897.JPG,char_data/A/DSC02897.JPG_0.jpg,4218,57,203,260,293,367,True,12
A,24,kaist_dataset/English/Digital_Camera/(E.S)C-outdoor1/056.JPG,char_data/A/056.JPG_0.jpg,312,13,163,176,242,266,True,12
A,58,kaist_dataset/English/Digital_Camera/(E.S)C-outdoor1/035.jpg,char_data/A/035.jpg_0.jpg,1682,29,127,156,24,82,True,12
A,65,kaist_dataset/English/Digital_Camera/(E.S)C-outdoor1/035.jpg,char_data/A/035.jpg_0.jpg,2080,32,147,179,83,148,True,12
A,68,kaist_dataset/English/Digital_Camera/(E.S)C-outdoor1/042.JPG,char_data/A/042.JPG_0.jpg,3876,57,508,565,214,282,True,12
A,96,kaist_dataset/English/Digital_Camera/(E.S)C-outdoor1/029.jpg,char_data/A/029.jpg_0.jpg,9696,101,159,260,61,157,True,12
A,43,kaist_dataset/English/Digital_Camera/(E.S)C-outdoor1/080116-0065.jpg,char_data/A/080116-0065.jpg_0.jpg,1419,33,487,520,204,247,True,12
A,91,kaist_dataset/English/Digital_Camera/(E.S)C-outdoor1/080116-0065.jpg,char_data/A/080116-0065.jpg_0.jpg,4550,50,203,253,236,327,True,12
A,186,kaist_dataset/English/Digital_Camera/(E.S)C-outdoor1/DSC02355.JPG,char_data/A/DSC02355.JPG_0.jpg,25110,135,314,449,211,397,True,12
A,55,kaist_dataset/English/Digital_Camera/(E.S)C-outdoor1/064.JPG,char_data/A/064.JPG_0.jpg,1980,36,173,209,180,235,True,12
A,52,kaist_dataset/English/Digital_Camera/(E.S)C-outdoor1/064.JPG,char_data/A/064.JPG_0.jpg,1612,31,362,393,185,237,True,12
A,175,kaist_dataset/English/Digital_Camera/(E.S)C-outdoor1/080119-0020.jpg,char_data/A/080119-0020.jpg_0.jpg,21350,122,432,554,468,643,True,12
A,56,kaist_dataset/English/Digital_Camera/(E.S)C-outdoor1/034.JPG,char_data/A/034.JPG_0.jpg,3360,60,110,170,194,250,True,12
A,56,kaist_dataset/English/Digital_Camera/(E.S)C-outdoor1/034.JPG,char_data/A/034.JPG_0.jpg,2856,51,489,540,199,255,True,12
A,64,kaist_dataset/English/Digital_Camera/(E.S)C-outdoor1/080.jpg,char_data/A/080.jpg_0.jpg,1600,25,238,263,91,155,True,12
A,77,kaist_dataset/English/Digital_Camera/(E.S)C-outdoor1/DSC02398.JPG,char_data/A/DSC02398.JPG_0.jpg,4004,52,171,223,240,317,True,12
A,67,kaist_dataset/English/Digital_Camera/(E.S)C-outdoor1/080118-0011.jpg,char_data/A/080118-0011.jpg_0.jpg,3752,56,756,812,596,663,True,12
A,72,kaist_dataset/English/Digital_Camera/(E.S)C-outdoor1/055.JPG,char_data/A/055.JPG_0.jpg,3312,46,382,428,185,257,True,12
A,72,kaist_dataset/English/Digital_Camera/(E.S)C-outdoor1/DSC02395.JPG,char_data/A/DSC02395.JPG_0.jpg,4608,64,184,248,296,368,True,12
A,31,kaist_dataset/English/Digital_Camera/(E.S)C-outdoor1/041.JPG,char_data/A/041.JPG_0.jpg,837,27,560,587,254,285,True,12
A,118,kaist_dataset/English/Digital_Camera/(E.S)C-outdoor1/DSC02500.JPG,char_data/A/DSC02500.JPG_0.jpg,8024,68,106,174,169,287,True,12
A,110,kaist_dataset/English/Digital_Camera/(E.S)C-outdoor1/DSC02500.JPG,char_data/A/DSC02500.JPG_0.jpg,8030,73,399,472,169,279,True,12
A,60,kaist_dataset/English/Digital_Camera/(E.S)C-outdoor1/DSC02501.JPG,char_data/A/DSC02501.JPG_0.jpg,3240,54,289,343,299,359,True,12
A,73,kaist_dataset/English/Digital_Camera/(E.S)C-outdoor1/DSC02243.JPG,char_data/A/DSC02243.JPG_0.jpg,2701,37,286,323,201,274,True,12
A,50,kaist_dataset/English/Digital_Camera/(E.S)C-outdoor1/DSC02918.JPG,char_data/A/DSC02918.JPG_0.jpg,2950,59,167,226,174,224,True,12
A,47,kaist_dataset/English/Digital_Camera/(E.S)C-outdoor1/089.jpg,char_data/A/089.jpg_0.jpg,1081,23,231,254,289,336,True,12
A,64,kaist_dataset/English/Digital_Camera/(E.S)C-outdoor1/089.jpg,char_data/A/089.jpg_0.jpg,1344,21,391,412,269,333,True,12
A,71,kaist_dataset/English/Digital_Camera/(E.S)C-outdoor1/089.jpg,char_data/A/089.jpg_0.jpg,1491,21,464,485,261,332,True,12
A,47,kaist_dataset/English/Digital_Camera/(E.S)C-outdoor1/6.jpg,char_data/A/6.jpg_0.jpg,1692,36,99,135,99,146,True,12
A,42,kaist_dataset/English/Digital_Camera/(E.S)C-outdoor1/6.jpg,char_data/A/6.jpg_0.jpg,1848,44,302,346,99,141,True,12
A,20,kaist_dataset/English/Digital_Camera/(E.S)C-outdoor1/061.jpg,char_data/A/061.jpg_0.jpg,400,20,154,174,87,107,True,12
A,19,kaist_dataset/English/Digital_Camera/(E.S)C-outdoor1/061.jpg,char_data/A/061.jpg_0.jpg,418,22,151,173,71,90,True,12
A,75,kaist_dataset/English/Digital_Camera/(E.S)C-outdoor1/110.jpg,char_data/A/110.jpg_0.jpg,4500,60,148,208,193,268,True,12
A,83,kaist_dataset/English/Digital_Camera/(E.S)B-light/크기변환_%B0%A3%C6%C74_fabdent.jpg,char_data/A/크기변환_%B0%A3%C6%C74_fabdent.jpg_0.jpg,4565,55,220,275,151,234,True,12
A,130,kaist_dataset/English/Digital_Camera/(E.S)B-light/080116-0053.jpg,char_data/A/080116-0053.jpg_0.jpg,11570,89,190,279,213,343,True,12
A,34,kaist_dataset/English/Digital_Camera/(E.S)B-light/x.jpg,char_data/A/x.jpg_0.jpg,1326,39,128,167,71,105,True,12
A,22,kaist_dataset/English/Digital_Camera/(E.S)B-light/x.jpg,char_data/A/x.jpg_0.jpg,396,18,203,221,103,125,True,12
A,184,kaist_dataset/English/Digital_Camera/(E.S)B-light/080116-0059.jpg,char_data/A/080116-0059.jpg_0.jpg,18584,101,581,682,307,491,True,12
A,236,kaist_dataset/English/Digital_Camera/(E.S)B-light/080116-0059.jpg,char_data/A/080116-0059.jpg_0.jpg,33748,143,553,696,491,727,True,12
A,26,kaist_dataset/English/Digital_Camera/(E.S)B-light/080116-0059.jpg,char_data/A/080116-0059.jpg_0.jpg,364,14,1114,1128,824,850,True,12
A,32,kaist_dataset/English/Digital_Camera/(E.S)B-light/080116-0059.jpg,char_data/A/080116-0059.jpg_0.jpg,544,17,657,674,825,857,False,12
A,28,kaist_dataset/English/Digital_Camera/(E.S)B-light/080116-0059.jpg,char_data/A/080116-0059.jpg_0.jpg,644,23,453,476,802,830,False,12
A,26,kaist_dataset/English/Digital_Camera/(E.S)B-light/080116-0059.jpg,char_data/A/080116-0059.jpg_0.jpg,390,15,521,536,803,829,False,12
A,25,kaist_dataset/English/Digital_Camera/(E.S)B-light/080116-0059.jpg,char_data/A/080116-0059.jpg_0.jpg,375,15,990,1005,801,826,False,12
A,31,kaist_dataset/English/Digital_Camera/(E.S)B-light/080116-0059.jpg,char_data/A/080116-0059.jpg_0.jpg,868,28,451,479,772,803,False,12
A,38,kaist_dataset/English/Digital_Camera/(E.S)B-light/080116-0059.jpg,char_data/A/080116-0059.jpg_0.jpg,646,17,496,513,767,805,False,12
A,27,kaist_dataset/English/Digital_Camera/(E.S)B-light/080116-0059.jpg,char_data/A/080116-0059.jpg_0.jpg,702,26,781,807,771,798,False,12
A,31,kaist_dataset/English/Digital_Camera/(E.S)B-light/080116-0059.jpg,char_data/A/080116-0059.jpg_0.jpg,527,17,856,873,769,800,False,12
A,213,kaist_dataset/English/Digital_Camera/(E.S)F-others/080119-0016.jpg,char_data/A/080119-0016.jpg_0.jpg,31524,148,1246,1394,583,796,False,12
A,195,kaist_dataset/English/Digital_Camera/(E.S)F-others/080119-0013.jpg,char_data/A/080119-0013.jpg_0.jpg,29250,150,565,715,566,761,False,12
A,70,kaist_dataset/English/Digital_Camera/(E.S)F-others/080119-0007.jpg,char_data/A/080119-0007.jpg_0.jpg,3290,47,709,756,770,840,False,12
A,49,kaist_dataset/English/Digital_Camera/(E.S)F-others/DSC02884.JPG,char_data/A/DSC02884.JPG_0.jpg,1715,35,147,182,99,148,False,12
A,43,kaist_dataset/English/Digital_Camera/(E.S)F-others/DSC02884.JPG,char_data/A/DSC02884.JPG_0.jpg,1720,40,381,421,54,97,False,12
A,43,kaist_dataset/English/Digital_Camera/(E.S)F-others/크기변환_%B0%A3%C6%C716_m_starfirm.jpg,char_data/A/크기변환_%B0%A3%C6%C716_m_starfirm.jpg_0.jpg,1161,27,304,331,209,252,False,12
A,41,kaist_dataset/English/Digital_Camera/(E.S)F-others/크기변환_%B0%A3%C6%C716_m_starfirm.jpg,char_data/A/크기변환_%B0%A3%C6%C716_m_starfirm.jpg_0.jpg,1025,25,365,390,218,259,False,12
A,126,kaist_dataset/English/Digital_Camera/(E.S)F-others/2007-12-09-day-exterior-047.jpg,char_data/A/2007-12-09-day-exterior-047.jpg_0.jpg,12852,102,344,446,440,566,False,12
A,61,kaist_dataset/English/Digital_Camera/(E.S)F-others/2007-12-09-day-exterior-047.jpg,char_data/A/2007-12-09-day-exterior-047.jpg_0.jpg,2806,46,1361,1407,541,602,False,12
A,60,kaist_dataset/English/Digital_Camera/(E.S)F-others/크기변환_%B0%A3%C6%C77_m_starfirm.jpg,char_data/A/크기변환_%B0%A3%C6%C77_m_starfirm.jpg_0.jpg,2340,39,323,362,109,169,False,12
A,60,kaist_dataset/English/Digital_Camera/(E.S)F-others/크기변환_%B0%A3%C6%C77_m_starfirm.jpg,char_data/A/크기변환_%B0%A3%C6%C77_m_starfirm.jpg_0.jpg,2220,37,283,320,163,223,False,12
A,44,kaist_dataset/English/Digital_Camera/(E.S)F-others/m.jpg,char_data/A/m.jpg_0.jpg,1320,30,200,230,96,140,False,12
A,401,kaist_dataset/English/Digital_Camera/(E.S)F-others/080119-0011.jpg,char_data/A/080119-0011.jpg_0.jpg,87017,217,597,814,314,715,False,12
A,88,kaist_dataset/English/Digital_Camera/(E.S)F-others/DSC03291.JPG,char_data/A/DSC03291.JPG_0.jpg,4224,48,192,240,170,258,False,12
A,190,kaist_dataset/English/Digital_Camera/(E.S)F-others/080119-0014.jpg,char_data/A/080119-0014.jpg_0.jpg,29260,154,319,473,390,580,False,12
A,122,kaist_dataset/English/Digital_Camera/(E.S)F-others/080116-0058.jpg,char_data/A/080116-0058.jpg_0.jpg,4270,35,828,863,594,716,False,12
A,148,kaist_dataset/English/Digital_Camera/(E.S)F-others/080116-0058.jpg,char_data/A/080116-0058.jpg_0.jpg,7992,54,815,869,724,872,False,12
A,55,kaist_dataset/English/Digital_Camera/(E.S)F-others/086.jpg,char_data/A/086.jpg_0.jpg,1265,23,243,266,296,351,False,12
A,63,kaist_dataset/English/Digital_Camera/(E.S)F-others/032.jpg,char_data/A/032.jpg_0.jpg,3339,53,300,353,101,164,False,12
A,73,kaist_dataset/English/Digital_Camera/(E.S)A-shadow/DSC02423.JPG,char_data/A/DSC02423.JPG_0.jpg,4526,62,467,529,163,236,False,12
A,45,kaist_dataset/English/Digital_Camera/(E.S)A-shadow/DSC02423.JPG,char_data/A/DSC02423.JPG_0.jpg,1665,37,188,225,239,284,False,12
A,40,kaist_dataset/English/Digital_Camera/(E.S)A-shadow/DSC02423.JPG,char_data/A/DSC02423.JPG_0.jpg,1520,38,407,445,242,282,False,12
A,35,kaist_dataset/English/Digital_Camera/(E.S)A-shadow/P1010044.JPG,char_data/A/P1010044.JPG_0.jpg,840,24,255,279,185,220,False,12
A,79,kaist_dataset/English/Digital_Camera/(E.S)A-shadow/DSC03084.JPG,char_data/A/DSC03084.JPG_0.jpg,3081,39,281,320,352,431,False,12
A,113,kaist_dataset/English/Digital_Camera/(E.S)A-shadow/DSC02317.JPG,char_data/A/DSC02317.JPG_0.jpg,9492,84,518,602,205,318,False,12
A,29,kaist_dataset/English/Digital_Camera/(E.S)D-indoor/308.jpg,char_data/A/308.jpg_0.jpg,696,24,67,91,47,76,False,12
A,34,kaist_dataset/English/Digital_Camera/(E.S)D-indoor/308.jpg,char_data/A/308.jpg_0.jpg,1020,30,219,249,49,83,False,12
A,76,kaist_dataset/English/Digital_Camera/(E.S)D-indoor/DSC03896.JPG,char_data/A/DSC03896.JPG_0.jpg,3572,47,190,237,260,336,False,12
A,98,kaist_dataset/English/Digital_Camera/(E.S)D-indoor/DSC03402.JPG,char_data/A/DSC03402.JPG_0.jpg,8134,83,289,372,182,280,False,12
A,92,kaist_dataset/English/Digital_Camera/(E.S)D-indoor/DSC02853.JPG,char_data/A/DSC02853.JPG_0.jpg,6348,69,192,261,126,218,False,12
A,53,kaist_dataset/English/Digital_Camera/(E.S)D-indoor/DSC03071.JPG,char_data/A/DSC03071.JPG_0.jpg,2173,41,361,402,231,284,False,12
A,31,kaist_dataset/English/Digital_Camera/(E.S)D-indoor/DSC03901.JPG,char_data/A/DSC03901.JPG_0.jpg,620,20,219,239,266,297,False,12
A,56,kaist_dataset/English/Digital_Camera/(E.S)D-indoor/DSC03901.JPG,char_data/A/DSC03901.JPG_0.jpg,2576,46,368,414,170,226,False,12
A,97,kaist_dataset/English/Digital_Camera/(E.S)D-indoor/DSC03080.JPG,char_data/A/DSC03080.JPG_0.jpg,12804,132,243,375,113,210,False,12
A,20,kaist_dataset/English/Digital_Camera/(E.S)D-indoor/z.jpg,char_data/A/z.jpg_0.jpg,280,14,144,158,75,95,False,12
A,41,kaist_dataset/English/Digital_Camera/(E.S)D-indoor/DSC03149.JPG,char_data/A/DSC03149.JPG_0.jpg,1804,44,52,96,380,421,False,12
A,80,kaist_dataset/English/Digital_Camera/(E.S)D-indoor/DSC03367.JPG,char_data/A/DSC03367.JPG_0.jpg,6080,76,169,245,34,114,False,12
A,129,kaist_dataset/English/Digital_Camera/(E.S)D-indoor/DSC02842.JPG,char_data/A/DSC02842.JPG_0.jpg,13287,103,460,563,339,468,False,12
A,43,kaist_dataset/English/Digital_Camera/(E.S)D-indoor/DSC03942.JPG,char_data/A/DSC03942.JPG_0.jpg,1247,29,428,457,370,413,False,12
A,39,kaist_dataset/English/Digital_Camera/(E.S)D-indoor/DSC03942.JPG,char_data/A/DSC03942.JPG_0.jpg,975,25,518,543,375,414,False,12
A,52,kaist_dataset/English/Digital_Camera/(E.S)D-indoor/DSC03918.JPG,char_data/A/DSC03918.JPG_0.jpg,1612,31,345,376,409,461,False,12
A,78,kaist_dataset/English/Digital_Camera/(E.S)D-indoor/DSC03943.JPG,char_data/A/DSC03943.JPG_0.jpg,4602,59,384,443,209,287,False,12
A,27,kaist_dataset/English/Digital_Camera/(E.S)D-indoor/DSC03943.JPG,char_data/A/DSC03943.JPG_0.jpg,621,23,219,242,319,346,False,12
A,67,kaist_dataset/English/Digital_Camera/(E.S)D-indoor/DSC03403.JPG,char_data/A/DSC03403.JPG_0.jpg,3886,58,278,336,202,269,False,12
A,64,kaist_dataset/English/Digital_Camera/(E.S)D-indoor/DSC02769.JPG,char_data/A/DSC02769.JPG_0.jpg,3200,50,137,187,135,199,False,12
A,63,kaist_dataset/English/Digital_Camera/(E.S)D-indoor/DSC03091.JPG,char_data/A/DSC03091.JPG_0.jpg,4284,68,518,586,208,271,False,12
A,118,kaist_dataset/English/Digital_Camera/(E.S)D-indoor/DSC02860.JPG,char_data/A/DSC02860.JPG_0.jpg,14278,121,124,245,42,160,False,12
A,66,kaist_dataset/English/Digital_Camera/(E.S)D-indoor/DSC03947.JPG,char_data/A/DSC03947.JPG_0.jpg,3894,59,463,522,184,250,False,12
A,37,kaist_dataset/English/Digital_Camera/(E.S)D-indoor/DSC03947.JPG,char_data/A/DSC03947.JPG_0.jpg,1110,30,268,298,418,455,False,12
A,61,kaist_dataset/English/Digital_Camera/(E.S)D-indoor/DSC03883.JPG,char_data/A/DSC03883.JPG_0.jpg,2684,44,340,384,310,371,False,12
A,96,kaist_dataset/English/Digital_Camera/(E.S)D-indoor/080119-0009.jpg,char_data/A/080119-0009.jpg_0.jpg,8160,85,839,924,573,669,False,12
A,91,kaist_dataset/English/Digital_Camera/(E.S)D-indoor/080119-0009.jpg,char_data/A/080119-0009.jpg_0.jpg,7280,80,1048,1128,583,674,False,12
A,40,kaist_dataset/English/Digital_Camera/(E.S)D-indoor/080119-0009.jpg,char_data/A/080119-0009.jpg_0.jpg,1160,29,5,34,1071,1111,False,12
A,31,kaist_dataset/English/Digital_Camera/(E.S)D-indoor/DSC03532.JPG,char_data/A/DSC03532.JPG_0.jpg,620,20,525,545,376,407,False,12
A,67,kaist_dataset/English/Digital_Camera/(E.S)D-indoor/DSC03396.JPG,char_data/A/DSC03396.JPG_0.jpg,3819,57,533,590,221,288,False,12
A,36,kaist_dataset/English/Digital_Camera/(E.S)D-indoor/DSC03935.JPG,char_data/A/DSC03935.JPG_0.jpg,792,22,308,330,43,79,False,12
A,34,kaist_dataset/English/Digital_Camera/(E.S)D-indoor/DSC03935.JPG,char_data/A/DSC03935.JPG_0.jpg,816,24,348,372,45,79,False,12
A,37,kaist_dataset/English/Digital_Camera/(E.S)D-indoor/DSC03935.JPG,char_data/A/DSC03935.JPG_0.jpg,814,22,387,409,48,85,False,12
A,43,kaist_dataset/English/Digital_Camera/(E.S)D-indoor/DSC03935.JPG,char_data/A/DSC03935.JPG_0.jpg,1032,24,463,487,48,91,False,12
A,90,kaist_dataset/English/Digital_Camera/(E.S)C-outdoor3/u.jpg,char_data/A/u.jpg_0.jpg,6030,67,32,99,64,154,False,12
A,95,kaist_dataset/English/Digital_Camera/(E.S)C-outdoor3/r.jpg,char_data/A/r.jpg_0.jpg,7600,80,96,176,94,189,False,12
A,81,kaist_dataset/English/Digital_Camera/(E.S)C-outdoor3/P1010138.JPG,char_data/A/P1010138.JPG_0.jpg,5751,71,476,547,74,155,False,12
A,59,kaist_dataset/English/Digital_Camera/(E.S)C-outdoor3/크기변환_%B0%A3%C6%C718_m_starfirm.jpg,char_data/A/크기변환_%B0%A3%C6%C718_m_starfirm.jpg_0.jpg,3009,51,414,465,203,262,False,12
A,48,kaist_dataset/English/Digital_Camera/(E.S)C-outdoor3/s.jpg,char_data/A/s.jpg_0.jpg,1968,41,183,224,79,127,False,12
A,59,kaist_dataset/English/Digital_Camera/(E.S)C-outdoor3/DSC02788.JPG,char_data/A/DSC02788.JPG_0.jpg,2006,34,204,238,230,289,False,12
A,47,kaist_dataset/English/Digital_Camera/(E.S)C-outdoor3/크기변환_P1010076.JPG,char_data/A/크기변환_P1010076.JPG_0.jpg,1833,39,244,283,125,172,False,12
A,65,kaist_dataset/English/Digital_Camera/(E.S)C-outdoor3/크기변환_P1010028.JPG,char_data/A/크기변환_P1010028.JPG_0.jpg,3055,47,350,397,170,235,False,12
n,65,kaist_dataset/Korean/Digital_Camera/outdoor2/2007-12-08-day-101.jpg,char_data/n/2007-12-08-day-101.jpg_2.jpg,3120,48,669,717,383,448,True,40
n,22,kaist_dataset/Korean/Digital_Camera/indoor1/080119-0029.jpg,char_data/n/080119-0029.jpg_0.jpg,286,13,707,720,656,678,True,40
n,21,kaist_dataset/Korean/Digital_Camera/indoor1/080119-0029.jpg,char_data/n/080119-0029.jpg_0.jpg,273,13,780,793,658,679,True,40
n,21,kaist_dataset/Korean/Digital_Camera/indoor1/145.JPG,char_data/n/145.JPG_0.jpg,294,14,255,269,306,327,True,40
n,29,kaist_dataset/Korean/Digital_Camera/G-others/080119-0005.jpg,char_data/n/080119-0005.jpg_0.jpg,754,26,760,786,622,651,True,40
n,41,kaist_dataset/Korean/Digital_Camera/G-others/2007-12-08-day-112.jpg,char_data/n/2007-12-08-day-112.jpg_0.jpg,820,20,696,716,577,618,True,40
n,22,kaist_dataset/Korean/Digital_Camera/A-shadow/2007-12-09-day-exterior-031.jpg,char_data/n/2007-12-09-day-exterior-031.jpg_0.jpg,484,22,396,418,623,645,True,40
n,24,kaist_dataset/Korean/Digital_Camera/A-shadow/2007-12-09-day-exterior-031.jpg,char_data/n/2007-12-09-day-exterior-031.jpg_0.jpg,432,18,563,581,616,640,True,40
n,25,kaist_dataset/Korean/Digital_Camera/outdoor1/001.JPG,char_data/n/001.JPG_0.jpg,375,15,325,340,241,266,True,40
n,15,kaist_dataset/Korean/Digital_Camera/outdoor1/001.JPG,char_data/n/001.JPG_0.jpg,150,10,230,240,245,260,True,40
n,13,kaist_dataset/Korean/Digital_Camera/outdoor1/001.JPG,char_data/n/001.JPG_0.jpg,130,10,388,398,245,258,True,40
n,19,kaist_dataset/Korean/Digital_Camera/outdoor1/001.JPG,char_data/n/001.JPG_0.jpg,152,8,530,538,240,259,True,40
n,31,kaist_dataset/Mixed/Mobile_Phone/(C.M)A-outdoor/P090912078.jpg,char_data/n/P090912078.jpg_0.jpg,837,27,162,189,312,343,True,40
n,28,kaist_dataset/Mixed/Mobile_Phone/(C.M)A-outdoor/P090912078.jpg,char_data/n/P090912078.jpg_0.jpg,896,32,448,480,300,328,True,40
n,29,kaist_dataset/Mixed/Mobile_Phone/(C.M)B-indoor/P090831005.jpg,char_data/n/P090831005.jpg_0.jpg,493,17,215,232,242,271,True,40
n,25,kaist_dataset/Mixed/Mobile_Phone/(C.M)B-indoor/P090831005.jpg,char_data/n/P090831005.jpg_0.jpg,400,16,302,318,246,271,True,40
n,66,kaist_dataset/Mixed/Mobile_Phone/(C.M)B-indoor/P090831019.jpg,char_data/n/P090831019.jpg_0.jpg,3696,56,221,277,157,223,True,40
n,49,kaist_dataset/Mixed/Mobile_Phone/(C.M)B-indoor/P090831010.jpg,char_data/n/P090831010.jpg_0.jpg,1813,37,257,294,292,341,True,40
n,57,kaist_dataset/Mixed/Mobile_Phone/(C.M)B-indoor/P090831018.jpg,char_data/n/P090831018.jpg_0.jpg,2280,40,252,292,234,291,True,40
n,49,kaist_dataset/Mixed/Mobile_Phone/(C.M)B-indoor/P090831013.jpg,char_data/n/P090831013.jpg_0.jpg,2107,43,136,179,194,243,True,40
n,49,kaist_dataset/Mixed/Mobile_Phone/(C.M)B-indoor/P090831017.jpg,char_data/n/P090831017.jpg_0.jpg,1617,33,325,358,246,295,True,40
n,46,kaist_dataset/Mixed/Mobile_Phone/(C.M)C-bookCover/P090831113.jpg,char_data/n/P090831113.jpg_0.jpg,1978,43,458,501,246,292,True,40
n,51,kaist_dataset/Mixed/Mobile_Phone/(C.M)C-bookCover/P090831119.jpg,char_data/n/P090831119.jpg_0.jpg,1683,33,374,407,223,274,True,40
n,35,kaist_dataset/Mixed/Mobile_Phone/(C.M)C-bookCover/P090831080.jpg,char_data/n/P090831080.jpg_0.jpg,1190,34,211,245,414,449,True,40
n,34,kaist_dataset/Mixed/Mobile_Phone/(C.M)C-bookCover/P090831080.jpg,char_data/n/P090831080.jpg_0.jpg,952,28,387,415,411,445,True,40
n,35,kaist_dataset/Mixed/Mobile_Phone/(C.M)C-bookCover/P090831080.jpg,char_data/n/P090831080.jpg_0.jpg,945,27,355,382,379,414,True,40
n,27,kaist_dataset/Mixed/Mobile_Phone/(C.M)C-bookCover/P090831115.jpg,char_data/n/P090831115.jpg_0.jpg,621,23,321,344,178,205,True,40
n,40,kaist_dataset/Mixed/Mobile_Phone/(C.M)C-bookCover/P090902019.jpg,char_data/n/P090902019.jpg_0.jpg,1480,37,319,356,303,343,True,40
n,45,kaist_dataset/Mixed/Mobile_Phone/(C.M)C-bookCover/P090903083.jpg,char_data/n/P090903083.jpg_0.jpg,2160,48,462,510,180,225,True,40
n,43,kaist_dataset/Mixed/Mobile_Phone/(C.M)C-bookCover/P090903083.jpg,char_data/n/P090903083.jpg_0.jpg,1978,46,156,202,176,219,True,40
n,34,kaist_dataset/Mixed/Mobile_Phone/(C.M)C-bookCover/P090831118.jpg,char_data/n/P090831118.jpg_0.jpg,986,29,154,183,223,257,True,40
n,42,kaist_dataset/Mixed/Mobile_Phone/(C.M)C-bookCover/P090831118.jpg,char_data/n/P090831118.jpg_0.jpg,1134,27,286,313,219,261,True,40
n,27,kaist_dataset/Mixed/Mobile_Phone/(C.M)C-bookCover/P090903024.jpg,char_data/n/P090903024.jpg_0.jpg,702,26,353,379,233,260,True,40
n,34,kaist_dataset/Mixed/Mobile_Phone/(C.M)C-bookCover/P090903024.jpg,char_data/n/P090903024.jpg_0.jpg,1020,30,529,559,225,259,True,40
n,41,kaist_dataset/Mixed/Digital_Camera/(C.S)C-outdoor1/133.JPG,char_data/n/133.JPG_0.jpg,820,20,564,584,339,380,True,40
n,43,kaist_dataset/Mixed/Digital_Camera/(C.S)C-outdoor1/133.JPG,char_data/n/133.JPG_0.jpg,989,23,583,606,338,381,True,40
n,59,kaist_dataset/Mixed/Digital_Camera/(C.S)C-outdoor1/DSC02344.JPG,char_data/n/DSC02344.JPG_0.jpg,2950,50,182,232,162,221,True,40
n,24,kaist_dataset/Mixed/Digital_Camera/(C.S)C-outdoor1/115.JPG,char_data/n/115.JPG_0.jpg,480,20,270,290,283,307,True,40
n,60,kaist_dataset/Mixed/Digital_Camera/(C.S)C-outdoor1/8.jpg,char_data/n/8.jpg_0.jpg,3420,57,303,360,171,231,True,40
n,30,kaist_dataset/Mixed/Digital_Camera/(C.S)C-outdoor1/086.JPG,char_data/n/086.JPG_0.jpg,390,13,235,248,336,366,True,40
n,25,kaist_dataset/Mixed/Digital_Camera/(C.S)C-outdoor1/086.JPG,char_data/n/086.JPG_0.jpg,400,16,320,336,338,363,True,40
n,23,kaist_dataset/Mixed/Digital_Camera/(C.S)C-outdoor1/080.JPG,char_data/n/080.JPG_0.jpg,805,35,183,218,85,108,True,40
n,35,kaist_dataset/Mixed/Digital_Camera/(C.S)C-outdoor1/080.JPG,char_data/n/080.JPG_0.jpg,1085,31,169,200,114,149,True,40
n,68,kaist_dataset/Mixed/Digital_Camera/(C.S)C-outdoor1/2007-12-08-day-118.jpg,char_data/n/2007-12-08-day-118.jpg_0.jpg,3468,51,1319,1370,412,480,True,40
n,21,kaist_dataset/Mixed/Digital_Camera/(C.S)C-outdoor1/DSC02242.JPG,char_data/n/DSC02242.JPG_0.jpg,231,11,255,266,174,195,True,40
n,56,kaist_dataset/Mixed/Digital_Camera/(C.S)C-outdoor1/2007-12-09-day-exterior-044.jpg,char_data/n/2007-12-09-day-exterior-044.jpg_0.jpg,2912,52,825,877,834,890,True,40
n,26,kaist_dataset/Mixed/Digital_Camera/(C.S)C-outdoor1/2.JPG,char_data/n/2.JPG_0.jpg,208,8,77,85,382,408,True,40
n,20,kaist_dataset/Mixed/Digital_Camera/(C.S)C-outdoor1/003.JPG,char_data/n/003.JPG_0.jpg,220,11,328,339,261,281,True,40
n,23,kaist_dataset/Mixed/Digital_Camera/(C.S)C-outdoor1/003.JPG,char_data/n/003.JPG_0.jpg,276,12,396,408,253,276,True,40
n,18,kaist_dataset/Mixed/Digital_Camera/(C.S)C-outdoor1/003.JPG,char_data/n/003.JPG_0.jpg,180,10,470,480,255,273,True,40
n,18,kaist_dataset/Mixed/Digital_Camera/(C.S)C-outdoor1/003.JPG,char_data/n/003.JPG_0.jpg,288,16,557,573,252,270,True,40
n,23,kaist_dataset/Mixed/Digital_Camera/(C.S)C-outdoor1/003.JPG,char_data/n/003.JPG_0.jpg,184,8,139,147,266,289,True,40
n,20,kaist_dataset/Mixed/Digital_Camera/(C.S)C-outdoor1/003.JPG,char_data/n/003.JPG_0.jpg,240,12,278,290,263,283,True,40
n,67,kaist_dataset/Mixed/Digital_Camera/(C.S)C-outdoor1/014.JPG,char_data/n/014.JPG_0.jpg,2010,30,107,137,195,262,True,40
n,35,kaist_dataset/Mixed/Digital_Camera/(C.S)C-outdoor1/DSC02325.JPG,char_data/n/DSC02325.JPG_0.jpg,595,17,262,279,319,354,True,40
n,44,kaist_dataset/Mixed/Digital_Camera/(C.S)F-others/2007-12-08-day-067.jpg,char_data/n/2007-12-08-day-067.jpg_0.jpg,2684,61,427,488,1116,1160,True,40
n,44,kaist_dataset/Mixed/Digital_Camera/(C.S)F-others/047.jpg,char_data/n/047.jpg_0.jpg,1716,39,163,202,71,115,True,40
n,35,kaist_dataset/Mixed/Digital_Camera/(C.S)D-indoor2/DSC04249.JPG,char_data/n/DSC04249.JPG_0.jpg,770,22,268,290,219,254,True,40
n,30,kaist_dataset/Mixed/Digital_Camera/(C.S)D-indoor2/DSC04254.JPG,char_data/n/DSC04254.JPG_0.jpg,630,21,201,222,346,376,True,40
n,33,kaist_dataset/Mixed/Digital_Camera/(C.S)D-indoor2/DSC04254.JPG,char_data/n/DSC04254.JPG_0.jpg,660,20,457,477,340,373,True,40
n,31,kaist_dataset/Mixed/Digital_Camera/(C.S)D-indoor2/DSC04254.JPG,char_data/n/DSC04254.JPG_0.jpg,558,18,519,537,342,373,True,40
n,33,kaist_dataset/Mixed/Digital_Camera/(C.S)D-indoor2/DSC04248.JPG,char_data/n/DSC04248.JPG_0.jpg,693,21,199,220,226,259,True,40
n,36,kaist_dataset/Mixed/Digital_Camera/(C.S)D-indoor2/DSC04248.JPG,char_data/n/DSC04248.JPG_0.jpg,900,25,297,322,222,258,True,40
n,46,kaist_dataset/Mixed/Digital_Camera/(C.S)E-night/DSC02647.JPG,char_data/n/DSC02647.JPG_0.jpg,2438,53,332,385,199,245,True,40
n,38,kaist_dataset/Mixed/Digital_Camera/(C.S)E-night/DSC02574.JPG,char_data/n/DSC02574.JPG_0.jpg,1140,30,545,575,151,189,True,40
n,102,kaist_dataset/Mixed/Digital_Camera/(C.S)E-night/DSC02586.JPG,char_data/n/DSC02586.JPG_0.jpg,10914,107,516,623,243,345,True,40
n,22,kaist_dataset/Mixed/Digital_Camera/(C.S)E-night/P1010151.JPG,char_data/n/P1010151.JPG_0.jpg,264,12,493,505,203,225,True,40
n,89,kaist_dataset/Mixed/Digital_Camera/(C.S)B-light/DSC04404.JPG,char_data/n/DSC04404.JPG_0.jpg,8188,92,310,402,228,317,True,40
n,38,kaist_dataset/Mixed/Digital_Camera/(C.S)B-light/134.JPG,char_data/n/134.JPG_0.jpg,1292,34,433,467,291,329,True,40
n,42,kaist_dataset/Mixed/Digital_Camera/(C.S)D-indoor1/DSC03118.JPG,char_data/n/DSC03118.JPG_0.jpg,1176,28,249,277,155,197,True,40
n,33,kaist_dataset/Mixed/Digital_Camera/(C.S)D-indoor1/DSC03118.JPG,char_data/n/DSC03118.JPG_0.jpg,792,24,440,464,157,190,True,40
n,28,kaist_dataset/Mixed/Digital_Camera/(C.S)D-indoor1/DSC03124.JPG,char_data/n/DSC03124.JPG_0.jpg,756,27,433,460,203,231,True,40
n,43,kaist_dataset/Mixed/Digital_Camera/(C.S)D-indoor1/DSC03119.JPG,char_data/n/DSC03119.JPG_0.jpg,1204,28,228,256,169,212,True,40
n,38,kaist_dataset/Mixed/Digital_Camera/(C.S)D-indoor1/DSC03119.JPG,char_data/n/DSC03119.JPG_0.jpg,1292,34,457,491,169,207,True,40
n,73,kaist_dataset/Mixed/Digital_Camera/(C.S)D-indoor1/DSC03909.JPG,char_data/n/DSC03909.JPG_0.jpg,3504,48,480,528,107,180,True,40
n,76,kaist_dataset/Mixed/Digital_Camera/(C.S)D-indoor1/DSC03909.JPG,char_data/n/DSC03909.JPG_0.jpg,3572,47,539,586,197,273,True,40
n,36,kaist_dataset/Mixed/Digital_Camera/(C.S)D-indoor1/DSC02787.JPG,char_data/n/DSC02787.JPG_0.jpg,612,17,119,136,388,424,True,40
n,32,kaist_dataset/Mixed/Digital_Camera/(C.S)D-indoor1/DSC02787.JPG,char_data/n/DSC02787.JPG_0.jpg,576,18,314,332,376,408,True,40
n,37,kaist_dataset/Mixed/Digital_Camera/(C.S)D-indoor1/DSC02787.JPG,char_data/n/DSC02787.JPG_0.jpg,777,21,388,409,372,409,True,40
n,32,kaist_dataset/Mixed/Digital_Camera/(C.S)D-indoor1/DSC02804.JPG,char_data/n/DSC02804.JPG_0.jpg,864,27,464,491,349,381,True,40
n,36,kaist_dataset/Mixed/Digital_Camera/(C.S)D-indoor1/DSC03132.JPG,char_data/n/DSC03132.JPG_0.jpg,1296,36,394,430,254,290,True,40
n,83,kaist_dataset/Mixed/Digital_Camera/(C.S)D-indoor1/DSC03469.JPG,char_data/n/DSC03469.JPG_0.jpg,4150,50,358,408,349,432,True,40
n,36,kaist_dataset/Mixed/Digital_Camera/(C.S)D-indoor1/DSC04206.JPG,char_data/n/DSC04206.JPG_0.jpg,648,18,424,442,294,330,True,40
n,46,kaist_dataset/Mixed/Digital_Camera/(C.S)D-indoor1/DSC03135.JPG,char_data/n/DSC03135.JPG_0.jpg,1518,33,306,339,187,233,True,40
n,32,kaist_dataset/Mixed/Digital_Camera/(C.S)D-indoor1/DSC03122.JPG,char_data/n/DSC03122.JPG_0.jpg,672,21,268,289,204,236,True,40
n,30,kaist_dataset/Mixed/Digital_Camera/(C.S)D-indoor1/DSC03122.JPG,char_data/n/DSC03122.JPG_0.jpg,750,25,324,349,153,183,True,40
n,40,kaist_dataset/Mixed/Digital_Camera/(C.S)D-indoor1/DSC03133.JPG,char_data/n/DSC03133.JPG_0.jpg,1440,36,292,328,157,197,True,40
n,34,kaist_dataset/Mixed/Digital_Camera/(C.S)D-indoor1/DSC03131.JPG,char_data/n/DSC03131.JPG_0.jpg,1088,32,339,371,139,173,True,40
n,46,kaist_dataset/Mixed/Digital_Camera/(C.S)D-indoor1/DSC03125.JPG,char_data/n/DSC03125.JPG_0.jpg,1380,30,288,318,188,234,True,40
n,27,kaist_dataset/Mixed/Digital_Camera/(C.S)D-indoor1/DSC03096.JPG,char_data/n/DSC03096.JPG_0.jpg,513,19,185,204,428,455,True,40
n,27,kaist_dataset/Mixed/Digital_Camera/(C.S)D-indoor1/DSC03096.JPG,char_data/n/DSC03096.JPG_0.jpg,486,18,467,485,431,458,True,40
n,29,kaist_dataset/Mixed/Digital_Camera/(C.S)D-indoor1/DSC03096.JPG,char_data/n/DSC03096.JPG_0.jpg,580,20,597,617,431,460,True,40
n,39,kaist_dataset/Mixed/Digital_Camera/(C.S)C-outdoor5/DSC04162.JPG,char_data/n/DSC04162.JPG_0.jpg,1209,31,214,245,332,371,True,40
n,49,kaist_dataset/Mixed/Digital_Camera/(C.S)C-outdoor5/DSC04456.JPG,char_data/n/DSC04456.JPG_0.jpg,1470,30,245,275,169,218,True,40
n,27,kaist_dataset/Mixed/Digital_Camera/(C.S)C-outdoor5/DSC04312.JPG,char_data/n/DSC04312.JPG_0.jpg,432,16,466,482,150,177,True,40
n,44,kaist_dataset/Mixed/Digital_Camera/(C.S)C-outdoor5/DSC04321.JPG,char_data/n/DSC04321.JPG_0.jpg,1056,24,101,125,187,231,True,40
n,34,kaist_dataset/Mixed/Digital_Camera/(C.S)C-outdoor5/DSC04321.JPG,char_data/n/DSC04321.JPG_0.jpg,782,23,146,169,196,230,True,40
n,39,kaist_dataset/Mixed/Digital_Camera/(C.S)C-outdoor5/DSC04321.JPG,char_data/n/DSC04321.JPG_0.jpg,897,23,333,356,197,236,True,40
n,36,kaist_dataset/Mixed/Digital_Camera/(C.S)C-outdoor5/DSC04321.JPG,char_data/n/DSC04321.JPG_0.jpg,756,21,430,451,205,241,True,40
n,42,kaist_dataset/Mixed/Digital_Camera/(C.S)C-outdoor5/DSC04076.JPG,char_data/n/DSC04076.JPG_0.jpg,1596,38,275,313,104,146,True,40
n,43,kaist_dataset/Mixed/Digital_Camera/(C.S)C-outdoor5/DSC04076.JPG,char_data/n/DSC04076.JPG_0.jpg,1591,37,396,433,100,143,True,40
n,23,kaist_dataset/Mixed/Digital_Camera/(C.S)C-outdoor5/DSC04076.JPG,char_data/n/DSC04076.JPG_0.jpg,437,19,420,439,403,426,True,40
n,27,kaist_dataset/Mixed/Digital_Camera/(C.S)C-outdoor5/DSC04357.JPG,char_data/n/DSC04357.JPG_0.jpg,513,19,320,339,381,408,True,40
n,62,kaist_dataset/Mixed/Digital_Camera/(C.S)C-outdoor5/DSC04122.JPG,char_data/n/DSC04122.JPG_0.jpg,3472,56,274,330,325,387,True,40
n,32,kaist_dataset/Mixed/Digital_Camera/(C.S)C-outdoor5/DSC04069.JPG,char_data/n/DSC04069.JPG_0.jpg,608,19,212,231,427,459,True,40
n,31,kaist_dataset/Mixed/Digital_Camera/(C.S)C-outdoor5/DSC04069.JPG,char_data/n/DSC04069.JPG_0.jpg,713,23,298,321,423,454,True,40
n,30,kaist_dataset/Mixed/Digital_Camera/(C.S)C-outdoor5/DSC04069.JPG,char_data/n/DSC04069.JPG_0.jpg,660,22,251,273,388,418,True,40
n,34,kaist_dataset/Mixed/Digital_Camera/(C.S)C-outdoor5/DSC04069.JPG,char_data/n/DSC04069.JPG_0.jpg,816,24,391,415,381,415,True,40
n,32,kaist_dataset/Mixed/Digital_Camera/(C.S)C-outdoor5/DSC04069.JPG,char_data/n/DSC04069.JPG_0.jpg,864,27,546,573,378,410,True,40
n,34,kaist_dataset/Mixed/Digital_Camera/(C.S)C-outdoor5/DSC03821.JPG,char_data/n/DSC03821.JPG_0.jpg,714,21,226,247,38,72,True,40
n,35,kaist_dataset/Mixed/Digital_Camera/(C.S)C-outdoor5/DSC03821.JPG,char_data/n/DSC03821.JPG_0.jpg,700,20,431,451,45,80,True,40
n,48,kaist_dataset/Mixed/Digital_Camera/(C.S)C-outdoor5/DSC04097.JPG,char_data/n/DSC04097.JPG_0.jpg,1872,39,366,405,198,246,True,40
n,46,kaist_dataset/Mixed/Digital_Camera/(C.S)C-outdoor5/DSC04399.JPG,char_data/n/DSC04399.JPG_0.jpg,1656,36,511,547,285,331,True,40
n,28,kaist_dataset/Mixed/Digital_Camera/(C.S)C-outdoor5/DSC04125.JPG,char_data/n/DSC04125.JPG_0.jpg,504,18,79,97,433,461,True,40
n,30,kaist_dataset/Mixed/Digital_Camera/(C.S)C-outdoor5/DSC04125.JPG,char_data/n/DSC04125.JPG_0.jpg,420,14,111,125,431,461,True,40
n,28,kaist_dataset/Mixed/Digital_Camera/(C.S)C-outdoor5/DSC04125.JPG,char_data/n/DSC04125.JPG_0.jpg,476,17,220,237,430,458,True,40
n,34,kaist_dataset/Mixed/Digital_Camera/(C.S)C-outdoor5/DSC04070.JPG,char_data/n/DSC04070.JPG_0.jpg,680,20,213,233,111,145,True,40
n,24,kaist_dataset/Mixed/Digital_Camera/(C.S)C-outdoor5/DSC04091.JPG,char_data/n/DSC04091.JPG_0.jpg,384,16,288,304,430,454,True,40
n,32,kaist_dataset/Mixed/Digital_Camera/(C.S)C-outdoor5/DSC04323.JPG,char_data/n/DSC04323.JPG_0.jpg,640,20,149,169,201,233,True,40
n,31,kaist_dataset/Mixed/Digital_Camera/(C.S)C-outdoor5/DSC04323.JPG,char_data/n/DSC04323.JPG_0.jpg,620,20,574,594,212,243,True,40
n,34,kaist_dataset/Mixed/Digital_Camera/(C.S)C-outdoor5/DSC04323.JPG,char_data/n/DSC04323.JPG_0.jpg,510,15,413,428,207,241,True,40
n,52,kaist_dataset/Mixed/Digital_Camera/(C.S)C-outdoor5/DSC04029.JPG,char_data/n/DSC04029.JPG_0.jpg,1664,32,386,418,178,230,True,40
n,49,kaist_dataset/Mixed/Digital_Camera/(C.S)C-outdoor5/DSC04338.JPG,char_data/n/DSC04338.JPG_0.jpg,980,20,405,425,190,239,True,40
n,36,kaist_dataset/Mixed/Digital_Camera/(C.S)C-outdoor5/DSC04338.JPG,char_data/n/DSC04338.JPG_0.jpg,684,19,456,475,200,236,True,40
n,32,kaist_dataset/Mixed/Digital_Camera/(C.S)C-outdoor5/DSC04338.JPG,char_data/n/DSC04338.JPG_0.jpg,640,20,611,631,202,234,True,40
n,41,kaist_dataset/Mixed/Digital_Camera/(C.S)C-outdoor5/DSC04322.JPG,char_data/n/DSC04322.JPG_0.jpg,1066,26,83,109,216,257,True,40
n,43,kaist_dataset/Mixed/Digital_Camera/(C.S)C-outdoor5/DSC04322.JPG,char_data/n/DSC04322.JPG_0.jpg,860,20,330,350,220,263,True,40
n,26,kaist_dataset/Mixed/Digital_Camera/(C.S)C-outdoor5/DSC04057.JPG,char_data/n/DSC04057.JPG_0.jpg,520,20,336,356,115,141,True,40
n,37,kaist_dataset/Mixed/Digital_Camera/(C.S)C-outdoor3/DSC03177.JPG,char_data/n/DSC03177.JPG_0.jpg,1073,29,361,390,150,187,True,40
n,74,kaist_dataset/Mixed/Digital_Camera/(C.S)C-outdoor3/DSC03299.JPG,char_data/n/DSC03299.JPG_0.jpg,5106,69,507,576,387,461,True,40
n,122,kaist_dataset/Mixed/Digital_Camera/(C.S)C-outdoor3/DSC03421.JPG,char_data/n/DSC03421.JPG_0.jpg,8174,67,392,459,69,191,True,40
n,57,kaist_dataset/Mixed/Digital_Camera/(C.S)C-outdoor3/DSC03047.JPG,char_data/n/DSC03047.JPG_0.jpg,1653,29,220,249,198,255,True,40
n,63,kaist_dataset/Mixed/Digital_Camera/(C.S)C-outdoor3/DSC03047.JPG,char_data/n/DSC03047.JPG_0.jpg,2079,33,330,363,196,259,True,40
n,59,kaist_dataset/Mixed/Digital_Camera/(C.S)C-outdoor3/DSC03047.JPG,char_data/n/DSC03047.JPG_0.jpg,1593,27,453,480,195,254,True,40
n,38,kaist_dataset/Mixed/Digital_Camera/(C.S)C-outdoor3/DSC02978.JPG,char_data/n/DSC02978.JPG_0.jpg,760,20,298,318,165,203,True,40
n,31,kaist_dataset/Mixed/Digital_Camera/(C.S)C-outdoor3/DSC02978.JPG,char_data/n/DSC02978.JPG_0.jpg,682,22,340,362,173,204,True,40
n,34,kaist_dataset/Mixed/Digital_Camera/(C.S)C-outdoor3/DSC03209.JPG,char_data/n/DSC03209.JPG_0.jpg,850,25,467,492,415,449,True,40
n,44,kaist_dataset/Mixed/Digital_Camera/(C.S)C-outdoor3/DSC03063.JPG,char_data/n/DSC03063.JPG_0.jpg,1144,26,235,261,285,329,True,40
n,46,kaist_dataset/Mixed/Digital_Camera/(C.S)C-outdoor3/DSC03063.JPG,char_data/n/DSC03063.JPG_0.jpg,966,21,314,335,290,336,True,40
n,29,kaist_dataset/Mixed/Digital_Camera/(C.S)C-outdoor3/DSC03227.JPG,char_data/n/DSC03227.JPG_0.jpg,406,14,198,212,107,136,True,40
n,75,kaist_dataset/Mixed/Digital_Camera/(C.S)C-outdoor3/DSC03017.JPG,char_data/n/DSC03017.JPG_0.jpg,7500,100,481,581,163,238,True,40
n,49,kaist_dataset/Mixed/Digital_Camera/(C.S)C-outdoor3/DSC02989.JPG,char_data/n/DSC02989.JPG_0.jpg,1813,37,596,633,207,256,True,40
n,27,kaist_dataset/Mixed/Digital_Camera/(C.S)C-outdoor3/DSC03271.JPG,char_data/n/DSC03271.JPG_0.jpg,621,23,311,334,83,110,True,40
n,35,kaist_dataset/Mixed/Digital_Camera/(C.S)C-outdoor6/P1010085.JPG,char_data/n/P1010085.JPG_0.jpg,945,27,169,196,131,166,True,40
n,26,kaist_dataset/Mixed/Digital_Camera/(C.S)C-outdoor6/P1010085.JPG,char_data/n/P1010085.JPG_0.jpg,598,23,78,101,99,125,True,40
n,134,kaist_dataset/Mixed/Digital_Camera/(C.S)C-outdoor6/080116-0057.jpg,char_data/n/080116-0057.jpg_0.jpg,17554,131,548,679,580,714,True,40
n,52,kaist_dataset/Mixed/Digital_Camera/(C.S)C-outdoor6/080116-0057.jpg,char_data/n/080116-0057.jpg_0.jpg,1456,28,1204,1232,827,879,True,40
n,52,kaist_dataset/Mixed/Digital_Camera/(C.S)C-outdoor6/080116-0057.jpg,char_data/n/080116-0057.jpg_0.jpg,1612,31,861,892,823,875,True,40
n,52,kaist_dataset/Mixed/Digital_Camera/(C.S)C-outdoor6/080116-0057.jpg,char_data/n/080116-0057.jpg_0.jpg,1768,34,961,995,827,879,True,40
n,48,kaist_dataset/Mixed/Digital_Camera/(C.S)C-outdoor6/080116-0057.jpg,char_data/n/080116-0057.jpg_0.jpg,1632,34,361,395,919,967,True,40
n,28,kaist_dataset/Mixed/Digital_Camera/(C.S)C-outdoor6/P1010048.JPG,char_data/n/P1010048.JPG_0.jpg,616,22,552,574,173,201,True,40
n,26,kaist_dataset/Mixed/Digital_Camera/(C.S)C-outdoor6/P1010065.JPG,char_data/n/P1010065.JPG_0.jpg,338,13,283,296,232,258,True,40
n,50,kaist_dataset/Mixed/Digital_Camera/(C.S)C-outdoor6/117.JPG,char_data/n/117.JPG_0.jpg,2800,56,171,227,193,243,True,40
n,73,kaist_dataset/Mixed/Digital_Camera/(C.S)C-outdoor4/DSC03572.JPG,char_data/n/DSC03572.JPG_0.jpg,4672,64,460,524,129,202,True,40
n,31,kaist_dataset/Mixed/Digital_Camera/(C.S)C-outdoor4/DSC03719.JPG,char_data/n/DSC03719.JPG_0.jpg,558,18,237,255,32,63,True,40
n,39,kaist_dataset/Mixed/Digital_Camera/(C.S)C-outdoor4/DSC03642.JPG,char_data/n/DSC03642.JPG_0.jpg,1014,26,351,377,252,291,True,40
n,41,kaist_dataset/Mixed/Digital_Camera/(C.S)C-outdoor4/DSC03642.JPG,char_data/n/DSC03642.JPG_0.jpg,1066,26,488,514,244,285,True,40
n,37,kaist_dataset/Mixed/Digital_Camera/(C.S)C-outdoor4/DSC03773.JPG,char_data/n/DSC03773.JPG_0.jpg,1258,34,187,221,276,313,True,40
n,64,kaist_dataset/Mixed/Digital_Camera/(C.S)C-outdoor4/DSC03784.JPG,char_data/n/DSC03784.JPG_0.jpg,2688,42,138,180,321,385,True,40
n,61,kaist_dataset/Mixed/Digital_Camera/(C.S)C-outdoor4/DSC03784.JPG,char_data/n/DSC03784.JPG_0.jpg,1891,31,554,585,318,379,True,40
n,27,kaist_dataset/Mixed/Digital_Camera/(C.S)C-outdoor4/DSC03718.JPG,char_data/n/DSC03718.JPG_0.jpg,540,20,230,250,261,288,True,40
n,45,kaist_dataset/Mixed/Digital_Camera/(C.S)C-outdoor4/DSC03781.JPG,char_data/n/DSC03781.JPG_0.jpg,2160,48,231,279,265,310,True,40
n,42,kaist_dataset/Mixed/Digital_Camera/(C.S)C-outdoor4/DSC03781.JPG,char_data/n/DSC03781.JPG_0.jpg,1722,41,249,290,222,264,True,40
n,42,kaist_dataset/Mixed/Digital_Camera/(C.S)C-outdoor4/DSC03781.JPG,char_data/n/DSC03781.JPG_0.jpg,1806,43,292,335,223,265,True,40
n,33,kaist_dataset/Mixed/Digital_Camera/(C.S)C-outdoor4/DSC03672.JPG,char_data/n/DSC03672.JPG_0.jpg,594,18,229,247,414,447,True,40
n,54,kaist_dataset/Mixed/Digital_Camera/(C.S)C-outdoor4/DSC03643.JPG,char_data/n/DSC03643.JPG_0.jpg,2052,38,326,364,270,324,True,40
n,46,kaist_dataset/Mixed/Digital_Camera/(C.S)C-outdoor4/DSC03643.JPG,char_data/n/DSC03643.JPG_0.jpg,1564,34,470,504,276,322,True,40
n,33,kaist_dataset/Mixed/Digital_Camera/(C.S)C-outdoor4/DSC03682.JPG,char_data/n/DSC03682.JPG_0.jpg,825,25,435,460,328,361,True,40
n,77,kaist_dataset/Mixed/Digital_Camera/(C.S)C-outdoor4/DSC03630.JPG,char_data/n/DSC03630.JPG_0.jpg,3696,48,367,415,351,428,True,40
n,36,kaist_dataset/Mixed/Digital_Camera/(C.S)C-outdoor4/DSC03556.JPG,char_data/n/DSC03556.JPG_0.jpg,396,11,171,182,317,353,True,40
n,32,kaist_dataset/Mixed/Digital_Camera/(C.S)C-outdoor4/DSC03556.JPG,char_data/n/DSC03556.JPG_0.jpg,384,12,180,192,319,351,True,40
n,27,kaist_dataset/Mixed/Digital_Camera/(C.S)C-outdoor4/DSC03556.JPG,char_data/n/DSC03556.JPG_0.jpg,270,10,230,240,324,351,True,40
n,30,kaist_dataset/Mixed/Digital_Camera/(C.S)C-outdoor4/DSC03556.JPG,char_data/n/DSC03556.JPG_0.jpg,360,12,541,553,323,353,True,40
n,23,kaist_dataset/Mixed/Digital_Camera/(C.S)C-outdoor4/DSC03670.JPG,char_data/n/DSC03670.JPG_0.jpg,322,14,269,283,322,345,True,40
n,24,kaist_dataset/Mixed/Digital_Camera/(C.S)C-outdoor4/DSC03670.JPG,char_data/n/DSC03670.JPG_0.jpg,480,20,375,395,323,347,True,40
n,24,kaist_dataset/Mixed/Digital_Camera/(C.S)C-outdoor4/DSC03670.JPG,char_data/n/DSC03670.JPG_0.jpg,360,15,519,534,321,345,True,40
n,38,kaist_dataset/Mixed/Digital_Camera/(C.S)C-outdoor4/DSC03586.JPG,char_data/n/DSC03586.JPG_0.jpg,722,19,172,191,155,193,True,40
n,36,kaist_dataset/Mixed/Digital_Camera/(C.S)C-outdoor4/DSC03586.JPG,char_data/n/DSC03586.JPG_0.jpg,792,22,191,213,156,192,True,40
n,34,kaist_dataset/Mixed/Digital_Camera/(C.S)C-outdoor4/DSC03586.JPG,char_data/n/DSC03586.JPG_0.jpg,680,20,281,301,160,194,True,40
n,24,kaist_dataset/Mixed/Digital_Camera/(C.S)C-outdoor2/DSC02421.JPG,char_data/n/DSC02421.JPG_0.jpg,600,25,225,250,212,236,True,40
n,22,kaist_dataset/Mixed/Digital_Camera/(C.S)C-outdoor2/DSC02421.JPG,char_data/n/DSC02421.JPG_0.jpg,572,26,320,346,213,235,True,40
n,29,kaist_dataset/Mixed/Digital_Camera/(C.S)C-outdoor2/DSC02912.JPG,char_data/n/DSC02912.JPG_0.jpg,493,17,256,273,14,43,True,40
n,25,kaist_dataset/Mixed/Digital_Camera/(C.S)C-outdoor2/DSC02624.JPG,char_data/n/DSC02624.JPG_0.jpg,425,17,158,175,402,427,True,40
n,25,kaist_dataset/Mixed/Digital_Camera/(C.S)C-outdoor2/DSC02624.JPG,char_data/n/DSC02624.JPG_0.jpg,375,15,212,227,403,428,True,40
n,28,kaist_dataset/Mixed/Digital_Camera/(C.S)C-outdoor2/DSC02886.JPG,char_data/n/DSC02886.JPG_0.jpg,672,24,318,342,145,173,True,40
n,25,kaist_dataset/Mixed/Digital_Camera/(C.S)C-outdoor2/DSC02483.JPG,char_data/n/DSC02483.JPG_0.jpg,350,14,297,311,154,179,True,40
n,43,kaist_dataset/Mixed/Digital_Camera/(C.S)C-outdoor2/DSC02869.JPG,char_data/n/DSC02869.JPG_0.jpg,860,20,203,223,140,183,True,40
n,42,kaist_dataset/Mixed/Digital_Camera/(C.S)C-outdoor2/DSC02869.JPG,char_data/n/DSC02869.JPG_0.jpg,798,19,287,306,143,185,True,40
n,23,kaist_dataset/Mixed/Digital_Camera/(C.S)C-outdoor2/DSC02385.JPG,char_data/n/DSC02385.JPG_0.jpg,345,15,461,476,147,170,True,40
n,69,kaist_dataset/Mixed/Digital_Camera/(C.S)C-outdoor2/DSC02436.JPG,char_data/n/DSC02436.JPG_0.jpg,2277,33,437,470,186,255,True,40
n,21,kaist_dataset/Mixed/Digital_Camera/(C.S)C-outdoor2/DSC02439.JPG,char_data/n/DSC02439.JPG_0.jpg,357,17,401,418,113,134,True,40
n,55,kaist_dataset/Mixed/Digital_Camera/(C.S)C-outdoor2/DSC02416.JPG,char_data/n/DSC02416.JPG_0.jpg,3025,55,433,488,207,262,True,40
n,116,kaist_dataset/Mixed/Digital_Camera/(C.S)C-outdoor2/DSC02919.JPG,char_data/n/DSC02919.JPG_0.jpg,15776,136,501,637,348,464,True,40
n,26,kaist_dataset/Mixed/Digital_Camera/(C.S)C-outdoor2/DSC02545.JPG,char_data/n/DSC02545.JPG_0.jpg,624,24,519,543,365,391,True,40
n,62,kaist_dataset/Mixed/Digital_Camera/(C.S)C-outdoor2/DSC02433.JPG,char_data/n/DSC02433.JPG_0.jpg,2604,42,112,154,188,250,True,40
n,71,kaist_dataset/Mixed/Digital_Camera/(C.S)C-outdoor2/DSC02425.JPG,char_data/n/DSC02425.JPG_0.jpg,4615,65,383,448,166,237,True,40
n,54,kaist_dataset/Mixed/Digital_Camera/(C.S)C-outdoor2/DSC02936.JPG,char_data/n/DSC02936.JPG_0.jpg,2538,47,440,487,138,192,True,40
n,31,kaist_dataset/Mixed/Digital_Camera/(C.S)C-outdoor2/DSC02936.JPG,char_data/n/DSC02936.JPG_0.jpg,620,20,164,184,81,112,True,40
n,30,kaist_dataset/Mixed/Digital_Camera/(C.S)C-outdoor2/DSC02511.JPG,char_data/n/DSC02511.JPG_0.jpg,690,23,231,254,213,243,True,40
n,47,kaist_dataset/Mixed/Digital_Camera/(C.S)C-outdoor2/DSC02407.JPG,char_data/n/DSC02407.JPG_0.jpg,1457,31,248,279,179,226,True,40
n,41,kaist_dataset/Mixed/Digital_Camera/(C.S)C-outdoor2/DSC02532.JPG,char_data/n/DSC02532.JPG_0.jpg,779,19,450,469,83,124,True,40
n,72,kaist_dataset/Mixed/Digital_Camera/(C.S)C-outdoor2/DSC02434.JPG,char_data/n/DSC02434.JPG_0.jpg,4680,65,571,636,204,276,True,40
n,25,kaist_dataset/Mixed/Digital_Camera/(C.S)A-shadow/DSC02624.JPG,char_data/n/DSC02624.JPG_0.jpg,425,17,158,175,402,427,True,40
n,25,kaist_dataset/Mixed/Digital_Camera/(C.S)A-shadow/DSC02624.JPG,char_data/n/DSC02624.JPG_0.jpg,375,15,212,227,403,428,True,40
n,56,kaist_dataset/Mixed/Digital_Camera/(C.S)A-shadow/DSC03207.JPG,char_data/n/DSC03207.JPG_0.jpg,2184,39,481,520,206,262,True,40
n,50,kaist_dataset/English/Mobile_Phone/(E.M)A-outdoor/P090911071.jpg,char_data/n/P090911071.jpg_0.jpg,1400,28,415,443,134,184,True,40
n,106,kaist_dataset/English/Mobile_Phone/(E.M)A-outdoor/P090911070.jpg,char_data/n/P090911070.jpg_0.jpg,11978,113,21,134,159,265,True,40
n,108,kaist_dataset/English/Mobile_Phone/(E.M)A-outdoor/P090911070.jpg,char_data/n/P090911070.jpg_0.jpg,13392,124,448,572,168,276,True,40
n,140,kaist_dataset/English/Mobile_Phone/(E.M)B-indoor/P090911075.jpg,char_data/n/P090911075.jpg_0.jpg,16940,121,482,603,243,383,True,40
n,64,kaist_dataset/English/Mobile_Phone/(E.M)B-indoor/P090911080.jpg,char_data/n/P090911080.jpg_0.jpg,2752,43,371,414,237,301,True,40
n,45,kaist_dataset/English/Mobile_Phone/(E.M)B-indoor/P090902018.jpg,char_data/n/P090902018.jpg_0.jpg,2250,50,576,626,204,249,True,40
n,63,kaist_dataset/English/Mobile_Phone/(E.M)B-indoor/P090911067.jpg,char_data/n/P090911067.jpg_0.jpg,1701,27,406,433,225,288,True,40
n,65,kaist_dataset/English/Mobile_Phone/(E.M)B-indoor/P090911081.jpg,char_data/n/P090911081.jpg_0.jpg,3185,49,397,446,214,279,True,40
n,79,kaist_dataset/English/Mobile_Phone/(E.M)B-indoor/P090903004.jpg,char_data/n/P090903004.jpg_0.jpg,7031,89,66,155,255,334,True,40
n,44,kaist_dataset/English/Mobile_Phone/(E.M)B-indoor/P090911084.jpg,char_data/n/P090911084.jpg_0.jpg,1188,27,319,346,162,206,True,40
n,46,kaist_dataset/English/Mobile_Phone/(E.M)B-indoor/P090911084.jpg,char_data/n/P090911084.jpg_0.jpg,1426,31,494,525,157,203,True,40
n,57,kaist_dataset/English/Mobile_Phone/(E.M)B-indoor/P090903008.jpg,char_data/n/P090903008.jpg_0.jpg,3021,53,294,347,36,93,True,40
n,91,kaist_dataset/English/Mobile_Phone/(E.M)C-bookCover/P090831077.jpg,char_data/n/P090831077.jpg_0.jpg,8463,93,216,309,281,372,True,40
n,105,kaist_dataset/English/Mobile_Phone/(E.M)C-bookCover/P090831077.jpg,char_data/n/P090831077.jpg_0.jpg,9345,89,421,510,273,378,True,40
n,81,kaist_dataset/English/Mobile_Phone/(E.M)C-bookCover/P090831039.jpg,char_data/n/P090831039.jpg_0.jpg,4860,60,54,114,122,203,True,40
n,72,kaist_dataset/English/Mobile_Phone/(E.M)C-bookCover/P090831039.jpg,char_data/n/P090831039.jpg_0.jpg,4392,61,225,286,130,202,True,40
n,66,kaist_dataset/English/Mobile_Phone/(E.M)C-bookCover/P090831039.jpg,char_data/n/P090831039.jpg_0.jpg,4422,67,418,485,128,194,True,40
n,74,kaist_dataset/English/Mobile_Phone/(E.M)C-bookCover/P090831039.jpg,char_data/n/P090831039.jpg_0.jpg,4810,65,287,352,236,310,True,40
n,83,kaist_dataset/English/Mobile_Phone/(E.M)C-bookCover/P090903054.jpg,char_data/n/P090903054.jpg_0.jpg,6059,73,170,243,228,311,True,40
n,36,kaist_dataset/English/Mobile_Phone/(E.M)C-bookCover/P090903030.jpg,char_data/n/P090903030.jpg_0.jpg,828,23,253,276,76,112,True,40
n,39,kaist_dataset/English/Mobile_Phone/(E.M)C-bookCover/P090903030.jpg,char_data/n/P090903030.jpg_0.jpg,858,22,371,393,78,117,True,40
n,73,kaist_dataset/English/Digital_Camera/(E.S)E-night/DSC02570.JPG,char_data/n/DSC02570.JPG_0.jpg,4380,60,203,263,252,325,True,40
n,66,kaist_dataset/English/Digital_Camera/(E.S)E-night/크기변환_P1010163.JPG,char_data/n/크기변환_P1010163.JPG_0.jpg,4752,72,103,175,105,171,True,40
n,83,kaist_dataset/English/Digital_Camera/(E.S)E-night/크기변환_P1010163.JPG,char_data/n/크기변환_P1010163.JPG_0.jpg,6225,75,393,468,99,182,True,40
n,99,kaist_dataset/English/Digital_Camera/(E.S)E-night/DSC02981.JPG,char_data/n/DSC02981.JPG_0.jpg,6336,64,320,384,195,294,True,40
n,38,kaist_dataset/English/Digital_Camera/(E.S)E-night/DSC02610.JPG,char_data/n/DSC02610.JPG_0.jpg,1140,30,76,106,276,314,True,40
n,100,kaist_dataset/English/Digital_Camera/(E.S)E-night/DSC02604.JPG,char_data/n/DSC02604.JPG_0.jpg,11100,111,464,575,236,336,True,40
n,47,kaist_dataset/English/Digital_Camera/(E.S)C-outdoor2/DSC02998.JPG,char_data/n/DSC02998.JPG_0.jpg,1645,35,352,387,423,470,True,40
n,40,kaist_dataset/English/Digital_Camera/(E.S)C-outdoor2/DSC04079.JPG,char_data/n/DSC04079.JPG_0.jpg,1040,26,144,170,198,238,True,40
n,99,kaist_dataset/English/Digital_Camera/(E.S)C-outdoor2/DSC04430.JPG,char_data/n/DSC04430.JPG_0.jpg,9801,99,261,360,298,397,True,40
n,98,kaist_dataset/English/Digital_Camera/(E.S)C-outdoor2/DSC04397.JPG,char_data/n/DSC04397.JPG_0.jpg,6958,71,199,270,217,315,True,40
n,52,kaist_dataset/English/Digital_Camera/(E.S)C-outdoor2/DSC04052.JPG,char_data/n/DSC04052.JPG_0.jpg,1820,35,345,380,173,225,True,40
n,68,kaist_dataset/English/Digital_Camera/(E.S)C-outdoor2/DSC03281.JPG,char_data/n/DSC03281.JPG_0.jpg,3672,54,268,322,237,305,True,40
n,98,kaist_dataset/English/Digital_Camera/(E.S)C-outdoor2/DSC03281.JPG,char_data/n/DSC03281.JPG_0.jpg,6370,65,511,576,207,305,True,40
n,106,kaist_dataset/English/Digital_Camera/(E.S)C-outdoor2/DSC04431.JPG,char_data/n/DSC04431.JPG_0.jpg,9646,91,289,380,284,390,True,40
n,61,kaist_dataset/English/Digital_Camera/(E.S)C-outdoor2/DSC03229.JPG,char_data/n/DSC03229.JPG_0.jpg,2989,49,397,446,163,224,True,40
n,46,kaist_dataset/English/Digital_Camera/(E.S)C-outdoor2/DSC03290.JPG,char_data/n/DSC03290.JPG_0.jpg,1288,28,255,283,413,459,True,40
n,46,kaist_dataset/English/Digital_Camera/(E.S)C-outdoor2/DSC03290.JPG,char_data/n/DSC03290.JPG_0.jpg,1426,31,283,314,313,359,True,40
n,41,kaist_dataset/English/Digital_Camera/(E.S)C-outdoor2/DSC03203.JPG,char_data/n/DSC03203.JPG_0.jpg,1189,29,149,178,376,417,True,40
n,40,kaist_dataset/English/Digital_Camera/(E.S)C-outdoor2/DSC03865.JPG,char_data/n/DSC03865.JPG_0.jpg,1080,27,217,244,103,143,True,40
n,38,kaist_dataset/English/Digital_Camera/(E.S)C-outdoor2/DSC03865.JPG,char_data/n/DSC03865.JPG_0.jpg,1064,28,150,178,61,99,True,40
n,52,kaist_dataset/English/Digital_Camera/(E.S)C-outdoor2/DSC03000.JPG,char_data/n/DSC03000.JPG_0.jpg,1976,38,191,229,291,343,True,40
n,50,kaist_dataset/English/Digital_Camera/(E.S)C-outdoor2/DSC03000.JPG,char_data/n/DSC03000.JPG_0.jpg,2000,40,227,267,290,340,True,40
n,51,kaist_dataset/English/Digital_Camera/(E.S)C-outdoor2/DSC03001.JPG,char_data/n/DSC03001.JPG_0.jpg,2193,43,164,207,200,251,True,40
n,65,kaist_dataset/English/Digital_Camera/(E.S)C-outdoor2/DSC03412.JPG,char_data/n/DSC03412.JPG_0.jpg,3055,47,205,252,148,213,True,40
n,46,kaist_dataset/English/Digital_Camera/(E.S)C-outdoor2/DSC03201.JPG,char_data/n/DSC03201.JPG_0.jpg,1840,40,195,235,140,186,True,40
n,106,kaist_dataset/English/Digital_Camera/(E.S)C-outdoor2/DSC03786.JPG,char_data/n/DSC03786.JPG_0.jpg,9752,92,205,297,52,158,True,40
n,100,kaist_dataset/English/Digital_Camera/(E.S)C-outdoor2/DSC03786.JPG,char_data/n/DSC03786.JPG_0.jpg,8900,89,295,384,50,150,True,40
n,113,kaist_dataset/English/Digital_Camera/(E.S)C-outdoor2/DSC03786.JPG,char_data/n/DSC03786.JPG_0.jpg,10396,92,171,263,188,301,True,40
n,101,kaist_dataset/English/Digital_Camera/(E.S)C-outdoor2/P1010060.JPG,char_data/n/P1010060.JPG_0.jpg,11413,113,342,455,133,234,True,40
n,60,kaist_dataset/English/Digital_Camera/(E.S)C-outdoor2/DSC03761.JPG,char_data/n/DSC03761.JPG_0.jpg,3240,54,269,323,351,411,True,40
n,40,kaist_dataset/English/Digital_Camera/(E.S)C-outdoor2/DSC04064.JPG,char_data/n/DSC04064.JPG_0.jpg,1240,31,157,188,133,173,True,40
n,46,kaist_dataset/English/Digital_Camera/(E.S)C-outdoor2/DSC04064.JPG,char_data/n/DSC04064.JPG_0.jpg,1380,30,213,243,131,177,True,40
n,47,kaist_dataset/English/Digital_Camera/(E.S)C-outdoor2/DSC03262.JPG,char_data/n/DSC03262.JPG_0.jpg,1457,31,54,85,129,176,True,40
n,47,kaist_dataset/English/Digital_Camera/(E.S)C-outdoor2/DSC03262.JPG,char_data/n/DSC03262.JPG_0.jpg,1410,30,314,344,147,194,True,40
n,53,kaist_dataset/English/Digital_Camera/(E.S)C-outdoor2/DSC03765.JPG,char_data/n/DSC03765.JPG_0.jpg,2067,39,256,295,90,143,True,40
n,51,kaist_dataset/English/Digital_Camera/(E.S)C-outdoor2/DSC04035.JPG,char_data/n/DSC04035.JPG_0.jpg,1683,33,159,192,193,244,True,40
n,43,kaist_dataset/English/Digital_Camera/(E.S)C-outdoor2/DSC04035.JPG,char_data/n/DSC04035.JPG_0.jpg,1462,34,396,430,200,243,True,40
n,36,kaist_dataset/English/Digital_Camera/(E.S)C-outdoor2/DSC03225.JPG,char_data/n/DSC03225.JPG_0.jpg,864,24,333,357,82,118,True,40
n,32,kaist_dataset/English/Digital_Camera/(E.S)C-outdoor2/DSC03225.JPG,char_data/n/DSC03225.JPG_0.jpg,800,25,504,529,91,123,True,40
n,37,kaist_dataset/English/Digital_Camera/(E.S)C-outdoor2/DSC03440.JPG,char_data/n/DSC03440.JPG_0.jpg,1258,34,245,279,35,72,True,40
n,53,kaist_dataset/English/Digital_Camera/(E.S)C-outdoor2/DSC04047.JPG,char_data/n/DSC04047.JPG_0.jpg,3127,59,241,300,234,287,True,40
n,112,kaist_dataset/English/Digital_Camera/(E.S)C-outdoor2/DSC03663.JPG,char_data/n/DSC03663.JPG_0.jpg,8848,79,531,610,177,289,True,40
n,45,kaist_dataset/English/Digital_Camera/(E.S)C-outdoor2/DSC03170.JPG,char_data/n/DSC03170.JPG_0.jpg,1710,38,409,447,316,361,True,40
n,21,kaist_dataset/English/Digital_Camera/(E.S)C-outdoor2/DSC04437.JPG,char_data/n/DSC04437.JPG_0.jpg,315,15,365,380,82,103,True,40
n,65,kaist_dataset/English/Digital_Camera/(E.S)C-outdoor2/DSC04437.JPG,char_data/n/DSC04437.JPG_0.jpg,3185,49,166,215,118,183,True,40
n,64,kaist_dataset/English/Digital_Camera/(E.S)C-outdoor2/DSC04437.JPG,char_data/n/DSC04437.JPG_0.jpg,2880,45,215,260,118,182,True,40
n,39,kaist_dataset/English/Digital_Camera/(E.S)C-outdoor2/DSC03165.JPG,char_data/n/DSC03165.JPG_0.jpg,1365,35,276,311,245,284,True,40
n,38,kaist_dataset/English/Digital_Camera/(E.S)C-outdoor2/DSC03165.JPG,char_data/n/DSC03165.JPG_0.jpg,1596,42,387,429,246,284,True,40
n,33,kaist_dataset/English/Digital_Camera/(E.S)C-outdoor1/077.JPG,char_data/n/077.JPG_0.jpg,1320,40,324,364,209,242,True,40
n,69,kaist_dataset/English/Digital_Camera/(E.S)C-outdoor1/DSC02524.JPG,char_data/n/DSC02524.JPG_0.jpg,3726,54,160,214,330,399,True,40
n,133,kaist_dataset/English/Digital_Camera/(E.S)C-outdoor1/DSC02354.JPG,char_data/n/DSC02354.JPG_0.jpg,12369,93,336,429,188,321,True,40
n,40,kaist_dataset/English/Digital_Camera/(E.S)C-outdoor1/DSC02480.JPG,char_data/n/DSC02480.JPG_0.jpg,1280,32,332,364,403,443,True,40
n,62,kaist_dataset/English/Digital_Camera/(E.S)C-outdoor1/056.JPG,char_data/n/056.JPG_0.jpg,3534,57,206,263,176,238,True,40
n,61,kaist_dataset/English/Digital_Camera/(E.S)C-outdoor1/056.JPG,char_data/n/056.JPG_0.jpg,3233,53,418,471,178,239,True,40
n,78,kaist_dataset/English/Digital_Camera/(E.S)C-outdoor1/7.jpg,char_data/n/7.jpg_0.jpg,4368,56,393,449,264,342,True,40
n,116,kaist_dataset/English/Digital_Camera/(E.S)C-outdoor1/DSC02415.JPG,char_data/n/DSC02415.JPG_0.jpg,12644,109,518,627,83,199,True,40
n,35,kaist_dataset/English/Digital_Camera/(E.S)C-outdoor1/036.jpg,char_data/n/036.jpg_0.jpg,1050,30,83,113,75,110,True,40
n,34,kaist_dataset/English/Digital_Camera/(E.S)C-outdoor1/DSC02355.JPG,char_data/n/DSC02355.JPG_0.jpg,918,27,160,187,305,339,True,40
n,84,kaist_dataset/English/Digital_Camera/(E.S)C-outdoor1/DSC02355.JPG,char_data/n/DSC02355.JPG_0.jpg,5628,67,458,525,286,370,True,40
n,87,kaist_dataset/English/Digital_Camera/(E.S)C-outdoor1/DSC02355.JPG,char_data/n/DSC02355.JPG_0.jpg,6873,79,527,606,284,371,True,40
n,56,kaist_dataset/English/Digital_Camera/(E.S)C-outdoor1/033.jpg,char_data/n/033.jpg_0.jpg,2912,52,227,279,61,117,True,40
n,61,kaist_dataset/English/Digital_Camera/(E.S)C-outdoor1/109.jpg,char_data/n/109.jpg_0.jpg,2074,34,376,410,182,243,True,40
n,86,kaist_dataset/English/Digital_Camera/(E.S)C-outdoor1/2007-12-08-day-111.jpg,char_data/n/2007-12-08-day-111.jpg_0.jpg,5848,68,1030,1098,501,587,True,40
n,160,kaist_dataset/English/Digital_Camera/(E.S)C-outdoor1/2007-12-08-day-015.jpg,char_data/n/2007-12-08-day-015.jpg_0.jpg,35520,222,832,1054,500,660,True,40
n,39,kaist_dataset/English/Digital_Camera/(E.S)C-outdoor1/2007-12-08-day-015.jpg,char_data/n/2007-12-08-day-015.jpg_0.jpg,1209,31,868,899,820,859,True,40
n,37,kaist_dataset/English/Digital_Camera/(E.S)C-outdoor1/2007-12-08-day-015.jpg,char_data/n/2007-12-08-day-015.jpg_0.jpg,1147,31,974,1005,827,864,True,40
n,50,kaist_dataset/English/Digital_Camera/(E.S)C-outdoor1/138.JPG,char_data/n/138.JPG_0.jpg,1750,35,310,345,258,308,True,40
n,35,kaist_dataset/English/Digital_Camera/(E.S)C-outdoor1/DSC02500.JPG,char_data/n/DSC02500.JPG_0.jpg,1155,33,428,461,303,338,True,40
n,55,kaist_dataset/English/Digital_Camera/(E.S)C-outdoor1/001.jpg,char_data/n/001.jpg_0.jpg,2860,52,154,206,100,155,True,40
n,38,kaist_dataset/English/Digital_Camera/(E.S)C-outdoor1/DSC02868.JPG,char_data/n/DSC02868.JPG_0.jpg,494,13,323,336,403,441,True,40
n,118,kaist_dataset/English/Digital_Camera/(E.S)C-outdoor1/2007-12-09-day-exterior-056.jpg,char_data/n/2007-12-09-day-exterior-056.jpg_0.jpg,10384,88,955,1043,507,625,False,40
n,38,kaist_dataset/English/Digital_Camera/(E.S)C-outdoor1/DSC02918.JPG,char_data/n/DSC02918.JPG_0.jpg,1178,31,157,188,233,271,False,40
n,31,kaist_dataset/English/Digital_Camera/(E.S)C-outdoor1/DSC02918.JPG,char_data/n/DSC02918.JPG_0.jpg,1178,38,519,557,229,260,False,40
n,74,kaist_dataset/English/Digital_Camera/(E.S)C-outdoor1/DSC02491.JPG,char_data/n/DSC02491.JPG_0.jpg,3700,50,199,249,231,305,False,40
n,66,kaist_dataset/English/Digital_Camera/(E.S)C-outdoor1/DSC02491.JPG,char_data/n/DSC02491.JPG_0.jpg,3366,51,259,310,143,209,False,40
n,64,kaist_dataset/English/Digital_Camera/(E.S)C-outdoor1/DSC02491.JPG,char_data/n/DSC02491.JPG_0.jpg,3328,52,383,435,62,126,False,40
n,91,kaist_dataset/English/Digital_Camera/(E.S)B-light/크기변환_%B0%A3%C6%C7_ktimt007.jpg,char_data/n/크기변환_%B0%A3%C6%C7_ktimt007.jpg_0.jpg,5005,55,202,257,208,299,False,40
n,83,kaist_dataset/English/Digital_Camera/(E.S)B-light/DSC02587.JPG,char_data/n/DSC02587.JPG_0.jpg,4897,59,540,599,342,425,False,40
n,80,kaist_dataset/English/Digital_Camera/(E.S)B-light/DSC02980.JPG,char_data/n/DSC02980.JPG_0.jpg,5920,74,440,514,180,260,False,40
n,51,kaist_dataset/English/Digital_Camera/(E.S)F-others/080119-0007.jpg,char_data/n/080119-0007.jpg_0.jpg,2295,45,1013,1058,787,838,False,40
n,60,kaist_dataset/English/Digital_Camera/(E.S)F-others/080119-0007.jpg,char_data/n/080119-0007.jpg_0.jpg,2580,43,19,62,732,792,False,40
n,37,kaist_dataset/English/Digital_Camera/(E.S)F-others/080119-0007.jpg,char_data/n/080119-0007.jpg_0.jpg,814,22,943,965,877,914,False,40
n,51,kaist_dataset/English/Digital_Camera/(E.S)F-others/080119-0007.jpg,char_data/n/080119-0007.jpg_0.jpg,2040,40,756,796,779,830,False,40
n,83,kaist_dataset/English/Digital_Camera/(E.S)F-others/크기변환_%B0%A3%C6%C72_ktimt007.jpg,char_data/n/크기변환_%B0%A3%C6%C72_ktimt007.jpg_0.jpg,4316,52,186,238,239,322,False,40
n,95,kaist_dataset/English/Digital_Camera/(E.S)F-others/크기변환_%B0%A3%C6%C72_ktimt007.jpg,char_data/n/크기변환_%B0%A3%C6%C72_ktimt007.jpg_0.jpg,9405,99,508,607,189,284,False,40
n,138,kaist_dataset/English/Digital_Camera/(E.S)F-others/080116-0060.jpg,char_data/n/080116-0060.jpg_0.jpg,12420,90,1387,1477,368,506,False,40
n,26,kaist_dataset/English/Digital_Camera/(E.S)F-others/크기변환_%C4%BF%C7%C7%B5%B9%C3%E2%B0%A3%C6%C7_%281%29_alto99kr.jpg,char_data/n/크기변환_%C4%BF%C7%C7%B5%B9%C3%E2%B0%A3%C6%C7_%281%29_alto99kr.jpg_0.jpg,754,29,459,488,204,230,False,40
n,79,kaist_dataset/English/Digital_Camera/(E.S)A-shadow/DSC03077.JPG,char_data/n/DSC03077.JPG_0.jpg,6557,83,348,431,353,432,False,40
n,46,kaist_dataset/English/Digital_Camera/(E.S)A-shadow/P090912074.jpg,char_data/n/P090912074.jpg_0.jpg,1610,35,573,608,90,136,False,40
n,53,kaist_dataset/English/Digital_Camera/(E.S)A-shadow/DSC03084.JPG,char_data/n/DSC03084.JPG_0.jpg,1696,32,238,270,372,425,False,40
n,57,kaist_dataset/English/Digital_Camera/(E.S)A-shadow/DSC03084.JPG,char_data/n/DSC03084.JPG_0.jpg,1653,29,519,548,369,426,False,40
n,55,kaist_dataset/English/Digital_Camera/(E.S)A-shadow/DSC03079.JPG,char_data/n/DSC03079.JPG_0.jpg,1265,23,304,327,334,389,False,40
n,54,kaist_dataset/English/Digital_Camera/(E.S)A-shadow/IMG_2647.JPG,char_data/n/IMG_2647.JPG_0.jpg,2376,44,400,444,186,240,False,40
n,29,kaist_dataset/English/Digital_Camera/(E.S)D-indoor/DSC03144.JPG,char_data/n/DSC03144.JPG_0.jpg,696,24,184,208,242,271,False,40
n,34,kaist_dataset/English/Digital_Camera/(E.S)D-indoor/DSC03144.JPG,char_data/n/DSC03144.JPG_0.jpg,816,24,325,349,239,273,False,40
n,33,kaist_dataset/English/Digital_Camera/(E.S)D-indoor/DSC03144.JPG,char_data/n/DSC03144.JPG_0.jpg,726,22,181,203,290,323,False,40
n,30,kaist_dataset/English/Digital_Camera/(E.S)D-indoor/DSC03144.JPG,char_data/n/DSC03144.JPG_0.jpg,750,25,322,347,292,322,False,40
n,31,kaist_dataset/English/Digital_Camera/(E.S)D-indoor/DSC03144.JPG,char_data/n/DSC03144.JPG_0.jpg,744,24,368,392,290,321,False,40
n,58,kaist_dataset/English/Digital_Camera/(E.S)D-indoor/DSC03136.JPG,char_data/n/DSC03136.JPG_0.jpg,1914,33,327,360,260,318,False,40
n,45,kaist_dataset/English/Digital_Camera/(E.S)D-indoor/DSC03150.JPG,char_data/n/DSC03150.JPG_0.jpg,1890,42,225,267,35,80,False,40
n,30,kaist_dataset/English/Digital_Camera/(E.S)D-indoor/DSC03146.JPG,char_data/n/DSC03146.JPG_0.jpg,750,25,399,424,237,267,False,40
n,32,kaist_dataset/English/Digital_Camera/(E.S)D-indoor/DSC03146.JPG,char_data/n/DSC03146.JPG_0.jpg,768,24,356,380,177,209,False,40
n,33,kaist_dataset/English/Digital_Camera/(E.S)D-indoor/DSC03146.JPG,char_data/n/DSC03146.JPG_0.jpg,858,26,460,486,183,216,False,40
n,42,kaist_dataset/English/Digital_Camera/(E.S)D-indoor/DSC03345.JPG,char_data/n/DSC03345.JPG_0.jpg,1722,41,276,317,107,149,False,40
n,40,kaist_dataset/English/Digital_Camera/(E.S)D-indoor/DSC03345.JPG,char_data/n/DSC03345.JPG_0.jpg,1280,32,530,562,104,144,False,40
n,33,kaist_dataset/English/Digital_Camera/(E.S)D-indoor/DSC03090.JPG,char_data/n/DSC03090.JPG_0.jpg,693,21,373,394,247,280,False,40
n,43,kaist_dataset/English/Digital_Camera/(E.S)D-indoor/크기변환_%B0%A3%C6%C76_fabdent.jpg,char_data/n/크기변환_%B0%A3%C6%C76_fabdent.jpg_0.jpg,1118,26,220,246,194,237,False,40
n,42,kaist_dataset/English/Digital_Camera/(E.S)D-indoor/DSC03149.JPG,char_data/n/DSC03149.JPG_0.jpg,1386,33,171,204,388,430,False,40
n,33,kaist_dataset/English/Digital_Camera/(E.S)D-indoor/DSC03147.JPG,char_data/n/DSC03147.JPG_0.jpg,792,24,234,258,299,332,False,40
n,29,kaist_dataset/English/Digital_Camera/(E.S)D-indoor/DSC03147.JPG,char_data/n/DSC03147.JPG_0.jpg,696,24,332,356,299,328,False,40
n,29,kaist_dataset/English/Digital_Camera/(E.S)D-indoor/DSC03147.JPG,char_data/n/DSC03147.JPG_0.jpg,667,23,383,406,298,327,False,40
n,31,kaist_dataset/English/Digital_Camera/(E.S)D-indoor/DSC03147.JPG,char_data/n/DSC03147.JPG_0.jpg,806,26,237,263,243,274,False,40
n,31,kaist_dataset/English/Digital_Camera/(E.S)D-indoor/DSC03147.JPG,char_data/n/DSC03147.JPG_0.jpg,775,25,337,362,240,271,False,40
n,32,kaist_dataset/English/Digital_Camera/(E.S)D-indoor/DSC03142.JPG,char_data/n/DSC03142.JPG_0.jpg,992,31,375,406,433,465,False,40
n,32,kaist_dataset/English/Digital_Camera/(E.S)D-indoor/DSC03142.JPG,char_data/n/DSC03142.JPG_0.jpg,736,23,418,441,370,402,False,40
n,28,kaist_dataset/English/Digital_Camera/(E.S)D-indoor/DSC04023.JPG,char_data/n/DSC04023.JPG_0.jpg,756,27,266,293,320,348,False,40
n,57,kaist_dataset/English/Digital_Camera/(E.S)D-indoor/DSC03074.JPG,char_data/n/DSC03074.JPG_0.jpg,1197,21,164,185,266,323,False,40
n,68,kaist_dataset/English/Digital_Camera/(E.S)D-indoor/DSC03074.JPG,char_data/n/DSC03074.JPG_0.jpg,1360,20,333,353,259,327,False,40
n,57,kaist_dataset/English/Digital_Camera/(E.S)D-indoor/DSC03074.JPG,char_data/n/DSC03074.JPG_0.jpg,1140,20,475,495,261,318,False,40
n,47,kaist_dataset/English/Digital_Camera/(E.S)D-indoor/DSC03376.JPG,char_data/n/DSC03376.JPG_0.jpg,1786,38,358,396,401,448,False,40
n,63,kaist_dataset/English/Digital_Camera/(E.S)D-indoor/DSC03076.JPG,char_data/n/DSC03076.JPG_0.jpg,2205,35,287,322,298,361,False,40
n,52,kaist_dataset/English/Digital_Camera/(E.S)D-indoor/DSC03085.JPG,char_data/n/DSC03085.JPG_0.jpg,1456,28,140,168,378,430,False,40
n,47,kaist_dataset/English/Digital_Camera/(E.S)D-indoor/DSC03936.JPG,char_data/n/DSC03936.JPG_0.jpg,1692,36,396,432,90,137,False,40
n,29,kaist_dataset/English/Digital_Camera/(E.S)D-indoor/DSC03145.JPG,char_data/n/DSC03145.JPG_0.jpg,667,23,260,283,181,210,False,40
n,58,kaist_dataset/English/Digital_Camera/(E.S)D-indoor/DSC03087.JPG,char_data/n/DSC03087.JPG_0.jpg,2320,40,301,341,372,430,False,40
n,39,kaist_dataset/English/Digital_Camera/(E.S)D-indoor/DSC03151.JPG,char_data/n/DSC03151.JPG_0.jpg,1365,35,241,276,113,152,False,40
n,44,kaist_dataset/English/Digital_Camera/(E.S)D-indoor/DSC03151.JPG,char_data/n/DSC03151.JPG_0.jpg,1672,38,524,562,110,154,False,40
n,47,kaist_dataset/English/Digital_Camera/(E.S)D-indoor/DSC03078.JPG,char_data/n/DSC03078.JPG_0.jpg,1927,41,444,485,314,361,False,40
n,29,kaist_dataset/English/Digital_Camera/(E.S)D-indoor/080119-0009.jpg,char_data/n/080119-0009.jpg_0.jpg,870,30,861,891,692,721,False,40
n,23,kaist_dataset/English/Digital_Camera/(E.S)D-indoor/080119-0009.jpg,char_data/n/080119-0009.jpg_0.jpg,621,27,1109,1136,700,723,False,40
n,34,kaist_dataset/English/Digital_Camera/(E.S)D-indoor/080119-0009.jpg,char_data/n/080119-0009.jpg_0.jpg,544,16,632,648,1033,1067,False,40
n,35,kaist_dataset/English/Digital_Camera/(E.S)D-indoor/080119-0009.jpg,char_data/n/080119-0009.jpg_0.jpg,700,20,837,857,1079,1114,False,40
n,42,kaist_dataset/English/Digital_Camera/(E.S)D-indoor/080119-0009.jpg,char_data/n/080119-0009.jpg_0.jpg,798,19,909,928,1085,1127,False,40
n,42,kaist_dataset/English/Digital_Camera/(E.S)D-indoor/DSC03532.JPG,char_data/n/DSC03532.JPG_0.jpg,1512,36,240,276,435,477,False,40
n,38,kaist_dataset/English/Digital_Camera/(E.S)D-indoor/DSC03532.JPG,char_data/n/DSC03532.JPG_0.jpg,1482,39,397,436,435,473,False,40
n,26,kaist_dataset/English/Digital_Camera/(E.S)D-indoor/DSC03532.JPG,char_data/n/DSC03532.JPG_0.jpg,416,16,35,51,377,403,False,40
n,27,kaist_dataset/English/Digital_Camera/(E.S)D-indoor/DSC03532.JPG,char_data/n/DSC03532.JPG_0.jpg,594,22,172,194,384,411,False,40
n,24,kaist_dataset/English/Digital_Camera/(E.S)D-indoor/DSC03532.JPG,char_data/n/DSC03532.JPG_0.jpg,408,17,323,340,387,411,False,40
n,28,kaist_dataset/English/Digital_Camera/(E.S)D-indoor/DSC03532.JPG,char_data/n/DSC03532.JPG_0.jpg,364,13,591,604,376,404,False,40
n,50,kaist_dataset/English/Digital_Camera/(E.S)C-outdoor3/크기변환_%B0%A3%C6%C71_fabdent.jpg,char_data/n/크기변환_%B0%A3%C6%C71_fabdent.jpg_0.jpg,2450,49,485,534,247,297,False,40
n,19,kaist_dataset/English/Digital_Camera/(E.S)C-outdoor3/크기변환_P1010076.JPG,char_data/n/크기변환_P1010076.JPG_0.jpg,247,13,208,221,106,125,False,40
n,24,kaist_dataset/English/Digital_Camera/(E.S)C-outdoor3/P1010123.JPG,char_data/n/P1010123.JPG_0.jpg,312,13,542,555,71,95,False,40
n,25,kaist_dataset/English/Digital_Camera/(E.S)C-outdoor3/P1010123.JPG,char_data/n/P1010123.JPG_0.jpg,400,16,561,577,136,161,False,40
n,23,kaist_dataset/English/Digital_Camera/(E.S)C-outdoor3/P1010123.JPG,char_data/n/P1010123.JPG_0.jpg,322,14,50,64,75,98,False,40
n,25,kaist_dataset/English/Digital_Camera/(E.S)C-outdoor3/P1010123.JPG,char_data/n/P1010123.JPG_0.jpg,525,21,58,79,145,170,False,40
S,26,kaist_dataset/Korean/Digital_Camera/outdoor2/2007-12-08-day-109.jpg,char_data/S/2007-12-08-day-109.jpg_2.jpg,286,11,140,151,829,855,True,28
S,15,kaist_dataset/Korean/Digital_Camera/E-night/103.jpg,char_data/S/103.jpg_0.jpg,120,8,380,388,154,169,True,28
S,17,kaist_dataset/Korean/Digital_Camera/indoor1/146.JPG,char_data/S/146.JPG_0.jpg,187,11,311,322,271,288,True,28
S,21,kaist_dataset/Korean/Digital_Camera/G-others/5.jpg,char_data/S/5.jpg_0.jpg,294,14,17,31,38,59,True,28
S,19,kaist_dataset/Korean/Digital_Camera/G-others/5.jpg,char_data/S/5.jpg_0.jpg,247,13,173,186,39,58,True,28
S,84,kaist_dataset/Korean/Digital_Camera/outdoor6/DSC04439.JPG,char_data/S/DSC04439.JPG_0.jpg,4704,56,165,221,53,137,True,28
S,22,kaist_dataset/Korean/Digital_Camera/outdoor1/001.JPG,char_data/S/001.JPG_0.jpg,374,17,77,94,244,266,True,28
S,31,kaist_dataset/Mixed/Mobile_Phone/(C.M)A-outdoor/P090908006.jpg,char_data/S/P090908006.jpg_0.jpg,496,16,54,70,375,406,True,28
S,27,kaist_dataset/Mixed/Mobile_Phone/(C.M)A-outdoor/P090908006.jpg,char_data/S/P090908006.jpg_0.jpg,621,23,123,146,373,400,True,28
S,29,kaist_dataset/Mixed/Mobile_Phone/(C.M)A-outdoor/P090908006.jpg,char_data/S/P090908006.jpg_0.jpg,522,18,162,180,373,402,True,28
S,45,kaist_dataset/Mixed/Mobile_Phone/(C.M)A-outdoor/P090912078.jpg,char_data/S/P090912078.jpg_0.jpg,1125,25,230,255,301,346,True,28
S,39,kaist_dataset/Mixed/Mobile_Phone/(C.M)A-outdoor/P090912078.jpg,char_data/S/P090912078.jpg_0.jpg,1131,29,320,349,296,335,True,28
S,39,kaist_dataset/Mixed/Mobile_Phone/(C.M)B-indoor/P090831005.jpg,char_data/S/P090831005.jpg_0.jpg,1014,26,125,151,232,271,True,28
S,49,kaist_dataset/Mixed/Mobile_Phone/(C.M)B-indoor/P090831016.jpg,char_data/S/P090831016.jpg_0.jpg,2107,43,214,257,183,232,True,28
S,38,kaist_dataset/Mixed/Mobile_Phone/(C.M)B-indoor/P090831021.jpg,char_data/S/P090831021.jpg_0.jpg,874,23,291,314,42,80,True,28
S,40,kaist_dataset/Mixed/Mobile_Phone/(C.M)B-indoor/P090831021.jpg,char_data/S/P090831021.jpg_0.jpg,1200,30,345,375,380,420,True,28
S,64,kaist_dataset/Mixed/Mobile_Phone/(C.M)B-indoor/P090831017.jpg,char_data/S/P090831017.jpg_0.jpg,2944,46,163,209,228,292,True,28
S,85,kaist_dataset/Mixed/Mobile_Phone/(C.M)B-indoor/P090831008.jpg,char_data/S/P090831008.jpg_0.jpg,5865,69,63,132,305,390,True,28
S,101,kaist_dataset/Mixed/Mobile_Phone/(C.M)C-bookCover/P090831136.jpg,char_data/S/P090831136.jpg_0.jpg,7676,76,326,402,226,327,True,28
S,50,kaist_dataset/Mixed/Mobile_Phone/(C.M)C-bookCover/P090902016.jpg,char_data/S/P090902016.jpg_0.jpg,1100,22,39,61,197,247,True,28
S,38,kaist_dataset/Mixed/Mobile_Phone/(C.M)C-bookCover/P090902016.jpg,char_data/S/P090902016.jpg_0.jpg,836,22,441,463,274,312,True,28
S,73,kaist_dataset/Mixed/Mobile_Phone/(C.M)C-bookCover/P090902019.jpg,char_data/S/P090902019.jpg_0.jpg,2920,40,168,208,278,351,True,28
S,38,kaist_dataset/Mixed/Mobile_Phone/(C.M)C-bookCover/P090831062.jpg,char_data/S/P090831062.jpg_0.jpg,1216,32,190,222,300,338,True,28
S,60,kaist_dataset/Mixed/Mobile_Phone/(C.M)C-bookCover/P090831118.jpg,char_data/S/P090831118.jpg_0.jpg,1440,24,222,246,203,263,True,28
S,55,kaist_dataset/Mixed/Digital_Camera/(C.S)C-outdoor1/51.JPG,char_data/S/51.JPG_0.jpg,2365,43,109,152,213,268,True,28
S,72,kaist_dataset/Mixed/Digital_Camera/(C.S)C-outdoor1/046.JPG,char_data/S/046.JPG_0.jpg,3528,49,533,582,197,269,True,28
S,49,kaist_dataset/Mixed/Digital_Camera/(C.S)C-outdoor1/119.JPG,char_data/S/119.JPG_0.jpg,1666,34,423,457,192,241,True,28
S,117,kaist_dataset/Mixed/Digital_Camera/(C.S)C-outdoor1/080116-0084.jpg,char_data/S/080116-0084.jpg_0.jpg,10413,89,129,218,143,260,True,28
S,53,kaist_dataset/Mixed/Digital_Camera/(C.S)C-outdoor1/080116-0084.jpg,char_data/S/080116-0084.jpg_0.jpg,1696,32,324,356,294,347,True,28
S,37,kaist_dataset/Mixed/Digital_Camera/(C.S)C-outdoor1/114.jpg,char_data/S/114.jpg_0.jpg,1591,43,384,427,320,357,True,28
S,66,kaist_dataset/Mixed/Digital_Camera/(C.S)C-outdoor1/080119-0006.jpg,char_data/S/080119-0006.jpg_0.jpg,3036,46,1134,1180,734,800,True,28
S,27,kaist_dataset/Mixed/Digital_Camera/(C.S)C-outdoor1/121.JPG,char_data/S/121.JPG_0.jpg,540,20,54,74,216,243,True,28
S,30,kaist_dataset/Mixed/Digital_Camera/(C.S)C-outdoor1/121.JPG,char_data/S/121.JPG_0.jpg,570,19,118,137,215,245,True,28
S,193,kaist_dataset/Mixed/Digital_Camera/(C.S)C-outdoor1/080118-0007.jpg,char_data/S/080118-0007.jpg_0.jpg,24704,128,29,157,436,629,True,28
S,269,kaist_dataset/Mixed/Digital_Camera/(C.S)C-outdoor1/080119-0033.jpg,char_data/S/080119-0033.jpg_0.jpg,42771,159,406,565,431,700,True,28
S,52,kaist_dataset/Mixed/Digital_Camera/(C.S)C-outdoor1/3.JPG,char_data/S/3.JPG_0.jpg,1664,32,439,471,228,280,True,28
S,49,kaist_dataset/Mixed/Digital_Camera/(C.S)C-outdoor1/3.JPG,char_data/S/3.JPG_0.jpg,980,20,615,635,417,466,True,28
S,23,kaist_dataset/Mixed/Digital_Camera/(C.S)C-outdoor1/3.JPG,char_data/S/3.JPG_0.jpg,230,10,611,621,293,316,True,28
S,18,kaist_dataset/Mixed/Digital_Camera/(C.S)C-outdoor1/3.JPG,char_data/S/3.JPG_0.jpg,252,14,135,149,291,309,True,28
S,81,kaist_dataset/Mixed/Digital_Camera/(C.S)C-outdoor1/080119-0027.jpg,char_data/S/080119-0027.jpg_0.jpg,3645,45,753,798,720,801,True,28
S,46,kaist_dataset/Mixed/Digital_Camera/(C.S)C-outdoor1/080119-0027.jpg,char_data/S/080119-0027.jpg_0.jpg,1656,36,941,977,1056,1102,True,28
S,47,kaist_dataset/Mixed/Digital_Camera/(C.S)C-outdoor1/P1010009.JPG,char_data/S/P1010009.JPG_0.jpg,1692,36,517,553,196,243,True,28
S,51,kaist_dataset/Mixed/Digital_Camera/(C.S)C-outdoor1/P1010009.JPG,char_data/S/P1010009.JPG_0.jpg,2448,48,551,599,192,243,True,28
S,30,kaist_dataset/Mixed/Digital_Camera/(C.S)C-outdoor1/054.JPG,char_data/S/054.JPG_0.jpg,780,26,217,243,274,304,True,28
S,34,kaist_dataset/Mixed/Digital_Camera/(C.S)C-outdoor1/054.JPG,char_data/S/054.JPG_0.jpg,714,21,329,350,272,306,True,28
S,132,kaist_dataset/Mixed/Digital_Camera/(C.S)C-outdoor1/080119-0003.jpg,char_data/S/080119-0003.jpg_0.jpg,12672,96,204,300,129,261,True,28
S,157,kaist_dataset/Mixed/Digital_Camera/(C.S)C-outdoor1/080119-0003.jpg,char_data/S/080119-0003.jpg_0.jpg,12717,81,486,567,125,282,True,28
S,114,kaist_dataset/Mixed/Digital_Camera/(C.S)C-outdoor1/080119-0037.jpg,char_data/S/080119-0037.jpg_0.jpg,7296,64,1186,1250,836,950,True,28
S,43,kaist_dataset/Mixed/Digital_Camera/(C.S)C-outdoor1/2007-12-08-day-103.jpg,char_data/S/2007-12-08-day-103.jpg_0.jpg,1720,40,517,557,606,649,True,28
S,83,kaist_dataset/Mixed/Digital_Camera/(C.S)C-outdoor1/2007-12-09-day-exterior-044.jpg,char_data/S/2007-12-09-day-exterior-044.jpg_0.jpg,8715,105,394,499,326,409,True,28
S,80,kaist_dataset/Mixed/Digital_Camera/(C.S)C-outdoor1/2007-12-09-day-exterior-044.jpg,char_data/S/2007-12-09-day-exterior-044.jpg_0.jpg,5360,67,952,1019,811,891,True,28
S,88,kaist_dataset/Mixed/Digital_Camera/(C.S)C-outdoor1/2007-12-09-day-exterior-044.jpg,char_data/S/2007-12-09-day-exterior-044.jpg_0.jpg,4840,55,1286,1341,958,1046,True,28
S,55,kaist_dataset/Mixed/Digital_Camera/(C.S)C-outdoor1/2007-12-08-day-130.jpg,char_data/S/2007-12-08-day-130.jpg_0.jpg,2805,51,533,584,686,741,True,28
S,51,kaist_dataset/Mixed/Digital_Camera/(C.S)C-outdoor1/2007-12-08-day-130.jpg,char_data/S/2007-12-08-day-130.jpg_0.jpg,2295,45,729,774,695,746,True,28
S,30,kaist_dataset/Mixed/Digital_Camera/(C.S)C-outdoor1/DSC02320.JPG,char_data/S/DSC02320.JPG_0.jpg,660,22,494,516,245,275,True,28
S,29,kaist_dataset/Mixed/Digital_Camera/(C.S)C-outdoor1/DSC02318.JPG,char_data/S/DSC02318.JPG_0.jpg,667,23,266,289,321,350,True,28
S,196,kaist_dataset/Mixed/Digital_Camera/(C.S)C-outdoor1/080118-0014.jpg,char_data/S/080118-0014.jpg_0.jpg,21364,109,362,471,679,875,True,28
S,72,kaist_dataset/Mixed/Digital_Camera/(C.S)C-outdoor1/003.JPG,char_data/S/003.JPG_0.jpg,2016,28,317,345,81,153,True,28
S,26,kaist_dataset/Mixed/Digital_Camera/(C.S)C-outdoor1/003.JPG,char_data/S/003.JPG_0.jpg,260,10,238,248,260,286,True,28
S,79,kaist_dataset/Mixed/Digital_Camera/(C.S)C-outdoor1/014.JPG,char_data/S/014.JPG_0.jpg,2291,29,3,32,184,263,True,28
S,80,kaist_dataset/Mixed/Digital_Camera/(C.S)C-outdoor1/DSC02325.JPG,char_data/S/DSC02325.JPG_0.jpg,3920,49,169,218,212,292,True,28
S,39,kaist_dataset/Mixed/Digital_Camera/(C.S)F-others/DSC02504.JPG,char_data/S/DSC02504.JPG_0.jpg,1170,30,319,349,312,351,True,28
S,28,kaist_dataset/Mixed/Digital_Camera/(C.S)F-others/097.jpg,char_data/S/097.jpg_0.jpg,448,16,169,185,164,192,True,28
S,31,kaist_dataset/Mixed/Digital_Camera/(C.S)F-others/097.jpg,char_data/S/097.jpg_0.jpg,465,15,338,353,170,201,True,28
S,39,kaist_dataset/Mixed/Digital_Camera/(C.S)F-others/085.jpg,char_data/S/085.jpg_0.jpg,1404,36,307,343,193,232,True,28
S,104,kaist_dataset/Mixed/Digital_Camera/(C.S)F-others/DSC02609.JPG,char_data/S/DSC02609.JPG_0.jpg,7176,69,157,226,205,309,True,28
S,37,kaist_dataset/Mixed/Digital_Camera/(C.S)F-others/DSC02609.JPG,char_data/S/DSC02609.JPG_0.jpg,925,25,162,187,319,356,True,28
S,48,kaist_dataset/Mixed/Digital_Camera/(C.S)F-others/047.jpg,char_data/S/047.jpg_0.jpg,1248,26,275,301,114,162,True,28
S,83,kaist_dataset/Mixed/Digital_Camera/(C.S)D-indoor2/DSC04442.JPG,char_data/S/DSC04442.JPG_0.jpg,4482,54,201,255,286,369,True,28
S,53,kaist_dataset/Mixed/Digital_Camera/(C.S)D-indoor2/DSC04487.JPG,char_data/S/DSC04487.JPG_0.jpg,1431,27,154,181,161,214,True,28
S,55,kaist_dataset/Mixed/Digital_Camera/(C.S)E-night/DSC02672.JPG,char_data/S/DSC02672.JPG_0.jpg,2475,45,28,73,95,150,True,28
S,62,kaist_dataset/Mixed/Digital_Camera/(C.S)E-night/DSC02672.JPG,char_data/S/DSC02672.JPG_0.jpg,2480,40,161,201,93,155,True,28
S,48,kaist_dataset/Mixed/Digital_Camera/(C.S)E-night/DSC02672.JPG,char_data/S/DSC02672.JPG_0.jpg,912,19,409,428,169,217,True,28
S,51,kaist_dataset/Mixed/Digital_Camera/(C.S)E-night/DSC03517.JPG,char_data/S/DSC03517.JPG_0.jpg,1173,23,216,239,81,132,True,28
S,64,kaist_dataset/Mixed/Digital_Camera/(C.S)E-night/DSC03840.JPG,char_data/S/DSC03840.JPG_0.jpg,4096,64,34,98,99,163,True,28
S,28,kaist_dataset/Mixed/Digital_Camera/(C.S)E-night/P1010151.JPG,char_data/S/P1010151.JPG_0.jpg,616,22,466,488,201,229,True,28
S,61,kaist_dataset/Mixed/Digital_Camera/(C.S)E-night/DSC02595.JPG,char_data/S/DSC02595.JPG_0.jpg,3050,50,130,180,356,417,True,28
S,30,kaist_dataset/Mixed/Digital_Camera/(C.S)E-night/DSC02569.JPG,char_data/S/DSC02569.JPG_0.jpg,780,26,210,236,278,308,True,28
S,39,kaist_dataset/Mixed/Digital_Camera/(C.S)E-night/DSC03871.JPG,char_data/S/DSC03871.JPG_0.jpg,741,19,362,381,186,225,True,28
S,116,kaist_dataset/Mixed/Digital_Camera/(C.S)E-night/DSC02571.JPG,char_data/S/DSC02571.JPG_0.jpg,4292,37,191,228,195,311,True,28
S,34,kaist_dataset/Mixed/Digital_Camera/(C.S)B-light/134.JPG,char_data/S/134.JPG_0.jpg,748,22,188,210,293,327,True,28
S,32,kaist_dataset/Mixed/Digital_Camera/(C.S)B-light/134.JPG,char_data/S/134.JPG_0.jpg,704,22,330,352,293,325,True,28
S,65,kaist_dataset/Mixed/Digital_Camera/(C.S)D-indoor1/DSC03959.JPG,char_data/S/DSC03959.JPG_0.jpg,2340,36,411,447,103,168,True,28
S,58,kaist_dataset/Mixed/Digital_Camera/(C.S)D-indoor1/DSC03119.JPG,char_data/S/DSC03119.JPG_0.jpg,1798,31,141,172,155,213,True,28
S,61,kaist_dataset/Mixed/Digital_Camera/(C.S)D-indoor1/DSC03455.JPG,char_data/S/DSC03455.JPG_0.jpg,2806,46,129,175,387,448,True,28
S,161,kaist_dataset/Mixed/Digital_Camera/(C.S)D-indoor1/DSC04173.JPG,char_data/S/DSC04173.JPG_0.jpg,10626,66,177,243,313,474,True,28
S,67,kaist_dataset/Mixed/Digital_Camera/(C.S)D-indoor1/DSC03913.JPG,char_data/S/DSC03913.JPG_0.jpg,2814,42,356,398,101,168,True,28
S,40,kaist_dataset/Mixed/Digital_Camera/(C.S)D-indoor1/DSC02804.JPG,char_data/S/DSC02804.JPG_0.jpg,800,20,269,289,352,392,True,28
S,54,kaist_dataset/Mixed/Digital_Camera/(C.S)D-indoor1/DSC03132.JPG,char_data/S/DSC03132.JPG_0.jpg,1620,30,282,312,166,220,True,28
S,49,kaist_dataset/Mixed/Digital_Camera/(C.S)D-indoor1/DSC03132.JPG,char_data/S/DSC03132.JPG_0.jpg,1421,29,313,342,243,292,True,28
S,109,kaist_dataset/Mixed/Digital_Camera/(C.S)D-indoor1/DSC03469.JPG,char_data/S/DSC03469.JPG_0.jpg,7521,69,32,101,316,425,True,28
S,37,kaist_dataset/Mixed/Digital_Camera/(C.S)D-indoor1/DSC03980.JPG,char_data/S/DSC03980.JPG_0.jpg,740,20,420,440,145,182,True,28
S,40,kaist_dataset/Mixed/Digital_Camera/(C.S)D-indoor1/DSC03980.JPG,char_data/S/DSC03980.JPG_0.jpg,760,19,440,459,144,184,True,28
S,41,kaist_dataset/Mixed/Digital_Camera/(C.S)D-indoor1/DSC04022.JPG,char_data/S/DSC04022.JPG_0.jpg,1189,29,286,315,160,201,True,28
S,175,kaist_dataset/Mixed/Digital_Camera/(C.S)D-indoor1/DSC04223.JPG,char_data/S/DSC04223.JPG_0.jpg,16275,93,498,591,7,182,True,28
S,80,kaist_dataset/Mixed/Digital_Camera/(C.S)D-indoor1/DSC02756.JPG,char_data/S/DSC02756.JPG_0.jpg,4480,56,159,215,186,266,True,28
S,34,kaist_dataset/Mixed/Digital_Camera/(C.S)D-indoor1/DSC02756.JPG,char_data/S/DSC02756.JPG_0.jpg,714,21,380,401,145,179,True,28
S,41,kaist_dataset/Mixed/Digital_Camera/(C.S)D-indoor1/DSC04246.JPG,char_data/S/DSC04246.JPG_0.jpg,1107,27,295,322,243,284,True,28
S,46,kaist_dataset/Mixed/Digital_Camera/(C.S)C-outdoor5/DSC04098.JPG,char_data/S/DSC04098.JPG_0.jpg,1610,35,463,498,84,130,True,28
S,47,kaist_dataset/Mixed/Digital_Camera/(C.S)C-outdoor5/DSC03847.JPG,char_data/S/DSC03847.JPG_0.jpg,1316,28,313,341,86,133,True,28
S,46,kaist_dataset/Mixed/Digital_Camera/(C.S)C-outdoor5/DSC04065.JPG,char_data/S/DSC04065.JPG_0.jpg,1288,28,449,477,135,181,True,28
S,40,kaist_dataset/Mixed/Digital_Camera/(C.S)C-outdoor5/DSC04065.JPG,char_data/S/DSC04065.JPG_0.jpg,1320,33,576,609,144,184,True,28
S,57,kaist_dataset/Mixed/Digital_Camera/(C.S)C-outdoor5/DSC04111.JPG,char_data/S/DSC04111.JPG_0.jpg,1596,28,444,472,113,170,True,28
S,29,kaist_dataset/Mixed/Digital_Camera/(C.S)C-outdoor5/DSC04360.JPG,char_data/S/DSC04360.JPG_0.jpg,551,19,121,140,314,343,True,28
S,30,kaist_dataset/Mixed/Digital_Camera/(C.S)C-outdoor5/DSC04360.JPG,char_data/S/DSC04360.JPG_0.jpg,360,12,126,138,345,375,True,28
S,35,kaist_dataset/Mixed/Digital_Camera/(C.S)C-outdoor5/DSC04360.JPG,char_data/S/DSC04360.JPG_0.jpg,805,23,50,73,375,410,True,28
S,39,kaist_dataset/Mixed/Digital_Camera/(C.S)C-outdoor5/DSC04063.JPG,char_data/S/DSC04063.JPG_0.jpg,663,17,584,601,310,349,True,28
S,57,kaist_dataset/Mixed/Digital_Camera/(C.S)C-outdoor5/DSC04060.JPG,char_data/S/DSC04060.JPG_0.jpg,2622,46,67,113,184,241,True,28
S,62,kaist_dataset/Mixed/Digital_Camera/(C.S)C-outdoor5/DSC04060.JPG,char_data/S/DSC04060.JPG_0.jpg,2604,42,240,282,175,237,True,28
S,72,kaist_dataset/Mixed/Digital_Camera/(C.S)C-outdoor5/DSC04368.JPG,char_data/S/DSC04368.JPG_0.jpg,3672,51,273,324,277,349,True,28
S,43,kaist_dataset/Mixed/Digital_Camera/(C.S)C-outdoor5/DSC03839.JPG,char_data/S/DSC03839.JPG_0.jpg,989,23,171,194,31,74,True,28
S,43,kaist_dataset/Mixed/Digital_Camera/(C.S)C-outdoor5/DSC03839.JPG,char_data/S/DSC03839.JPG_0.jpg,946,22,344,366,31,74,True,28
S,89,kaist_dataset/Mixed/Digital_Camera/(C.S)C-outdoor5/DSC03839.JPG,char_data/S/DSC03839.JPG_0.jpg,7209,81,235,316,201,290,True,28
S,45,kaist_dataset/Mixed/Digital_Camera/(C.S)C-outdoor5/DSC04119.JPG,char_data/S/DSC04119.JPG_0.jpg,1530,34,481,515,138,183,True,28
S,95,kaist_dataset/Mixed/Digital_Camera/(C.S)C-outdoor5/DSC04151.JPG,char_data/S/DSC04151.JPG_0.jpg,7030,74,415,489,238,333,True,28
S,133,kaist_dataset/Mixed/Digital_Camera/(C.S)C-outdoor5/DSC03819.JPG,char_data/S/DSC03819.JPG_0.jpg,9975,75,294,369,57,190,True,28
S,83,kaist_dataset/Mixed/Digital_Camera/(C.S)C-outdoor5/DSC04122.JPG,char_data/S/DSC04122.JPG_0.jpg,5146,62,330,392,302,385,True,28
S,64,kaist_dataset/Mixed/Digital_Camera/(C.S)C-outdoor5/DSC04401.JPG,char_data/S/DSC04401.JPG_0.jpg,2816,44,156,200,13,77,True,28
S,54,kaist_dataset/Mixed/Digital_Camera/(C.S)C-outdoor5/DSC04014.JPG,char_data/S/DSC04014.JPG_0.jpg,2214,41,269,310,102,156,True,28
S,34,kaist_dataset/Mixed/Digital_Camera/(C.S)C-outdoor5/DSC03829.JPG,char_data/S/DSC03829.JPG_0.jpg,714,21,404,425,176,210,True,28
S,39,kaist_dataset/Mixed/Digital_Camera/(C.S)C-outdoor5/DSC04338.JPG,char_data/S/DSC04338.JPG_0.jpg,663,17,31,48,195,234,True,28
S,121,kaist_dataset/Mixed/Digital_Camera/(C.S)C-outdoor5/DSC04055.JPG,char_data/S/DSC04055.JPG_0.jpg,9801,81,469,550,239,360,True,28
S,48,kaist_dataset/Mixed/Digital_Camera/(C.S)C-outdoor5/DSC04322.JPG,char_data/S/DSC04322.JPG_0.jpg,1440,30,433,463,215,263,True,28
S,35,kaist_dataset/Mixed/Digital_Camera/(C.S)C-outdoor3/DSC03233.JPG,char_data/S/DSC03233.JPG_0.jpg,840,24,41,65,287,322,True,28
S,61,kaist_dataset/Mixed/Digital_Camera/(C.S)C-outdoor3/DSC03429.JPG,char_data/S/DSC03429.JPG_0.jpg,2562,42,396,438,137,198,True,28
S,76,kaist_dataset/Mixed/Digital_Camera/(C.S)C-outdoor3/DSC03311.JPG,char_data/S/DSC03311.JPG_0.jpg,5852,77,16,93,308,384,True,28
S,22,kaist_dataset/Mixed/Digital_Camera/(C.S)C-outdoor3/DSC03033.JPG,char_data/S/DSC03033.JPG_0.jpg,308,14,115,129,153,175,True,28
S,100,kaist_dataset/Mixed/Digital_Camera/(C.S)C-outdoor3/DSC03247.JPG,char_data/S/DSC03247.JPG_0.jpg,5700,57,524,581,164,264,True,28
S,93,kaist_dataset/Mixed/Digital_Camera/(C.S)C-outdoor3/DSC03247.JPG,char_data/S/DSC03247.JPG_0.jpg,4743,51,223,274,141,234,True,28
S,74,kaist_dataset/Mixed/Digital_Camera/(C.S)C-outdoor3/DSC03265.JPG,char_data/S/DSC03265.JPG_0.jpg,3996,54,151,205,187,261,True,28
S,75,kaist_dataset/Mixed/Digital_Camera/(C.S)C-outdoor3/DSC03274.JPG,char_data/S/DSC03274.JPG_0.jpg,4800,64,342,406,83,158,True,28
S,46,kaist_dataset/Mixed/Digital_Camera/(C.S)C-outdoor3/DSC03223.JPG,char_data/S/DSC03223.JPG_0.jpg,1426,31,99,130,430,476,True,28
S,36,kaist_dataset/Mixed/Digital_Camera/(C.S)C-outdoor3/DSC02986.JPG,char_data/S/DSC02986.JPG_0.jpg,1260,35,326,361,281,317,True,28
S,40,kaist_dataset/Mixed/Digital_Camera/(C.S)C-outdoor3/DSC03020.JPG,char_data/S/DSC03020.JPG_0.jpg,1360,34,521,555,261,301,True,28
S,80,kaist_dataset/Mixed/Digital_Camera/(C.S)C-outdoor3/DSC03266.JPG,char_data/S/DSC03266.JPG_0.jpg,4160,52,132,184,169,249,True,28
S,63,kaist_dataset/Mixed/Digital_Camera/(C.S)C-outdoor3/DSC02989.JPG,char_data/S/DSC02989.JPG_0.jpg,3276,52,399,451,191,254,True,28
S,42,kaist_dataset/Mixed/Digital_Camera/(C.S)C-outdoor3/DSC02989.JPG,char_data/S/DSC02989.JPG_0.jpg,1260,30,500,530,271,313,True,28
S,30,kaist_dataset/Mixed/Digital_Camera/(C.S)C-outdoor3/DSC03271.JPG,char_data/S/DSC03271.JPG_0.jpg,720,24,256,280,113,143,True,28
S,23,kaist_dataset/Mixed/Digital_Camera/(C.S)C-outdoor6/P1010063.JPG,char_data/S/P1010063.JPG_0.jpg,299,13,222,235,435,458,True,28
S,29,kaist_dataset/Mixed/Digital_Camera/(C.S)C-outdoor6/P1010090.JPG,char_data/S/P1010090.JPG_0.jpg,754,26,196,222,203,232,True,28
S,195,kaist_dataset/Mixed/Digital_Camera/(C.S)C-outdoor6/080116-0057.jpg,char_data/S/080116-0057.jpg_0.jpg,23400,120,881,1001,522,717,True,28
S,89,kaist_dataset/Mixed/Digital_Camera/(C.S)C-outdoor6/P1010116.JPG,char_data/S/P1010116.JPG_0.jpg,2403,27,230,257,182,271,True,28
S,25,kaist_dataset/Mixed/Digital_Camera/(C.S)C-outdoor6/P1010114.JPG,char_data/S/P1010114.JPG_0.jpg,400,16,221,237,220,245,True,28
S,25,kaist_dataset/Mixed/Digital_Camera/(C.S)C-outdoor6/P1010114.JPG,char_data/S/P1010114.JPG_0.jpg,350,14,274,288,219,244,True,28
S,22,kaist_dataset/Mixed/Digital_Camera/(C.S)C-outdoor6/P1010065.JPG,char_data/S/P1010065.JPG_0.jpg,264,12,163,175,106,128,True,28
S,51,kaist_dataset/Mixed/Digital_Camera/(C.S)C-outdoor6/P1010132.JPG,char_data/S/P1010132.JPG_0.jpg,2040,40,533,573,150,201,True,28
S,95,kaist_dataset/Mixed/Digital_Camera/(C.S)C-outdoor4/DSC03651.JPG,char_data/S/DSC03651.JPG_0.jpg,7315,77,270,347,167,262,True,28
S,34,kaist_dataset/Mixed/Digital_Camera/(C.S)C-outdoor4/DSC03716.JPG,char_data/S/DSC03716.JPG_0.jpg,578,17,427,444,240,274,True,28
S,44,kaist_dataset/Mixed/Digital_Camera/(C.S)C-outdoor4/DSC03604.JPG,char_data/S/DSC03604.JPG_0.jpg,1452,33,344,377,212,256,True,28
S,36,kaist_dataset/Mixed/Digital_Camera/(C.S)C-outdoor4/DSC03711.JPG,char_data/S/DSC03711.JPG_0.jpg,648,18,310,328,389,425,True,28
S,41,kaist_dataset/Mixed/Digital_Camera/(C.S)C-outdoor4/DSC03711.JPG,char_data/S/DSC03711.JPG_0.jpg,984,24,440,464,382,423,True,28
S,72,kaist_dataset/Mixed/Digital_Camera/(C.S)C-outdoor4/DSC03661.JPG,char_data/S/DSC03661.JPG_0.jpg,2016,28,457,485,240,312,True,28
S,35,kaist_dataset/Mixed/Digital_Camera/(C.S)C-outdoor4/DSC03718.JPG,char_data/S/DSC03718.JPG_0.jpg,525,15,336,351,93,128,True,28
S,64,kaist_dataset/Mixed/Digital_Camera/(C.S)C-outdoor4/DSC03673.JPG,char_data/S/DSC03673.JPG_0.jpg,3072,48,86,134,181,245,True,28
S,39,kaist_dataset/Mixed/Digital_Camera/(C.S)C-outdoor4/DSC03679.JPG,char_data/S/DSC03679.JPG_0.jpg,1014,26,123,149,99,138,True,28
S,36,kaist_dataset/Mixed/Digital_Camera/(C.S)C-outdoor4/DSC03666.JPG,char_data/S/DSC03666.JPG_0.jpg,1188,33,114,147,116,152,True,28
S,26,kaist_dataset/Mixed/Digital_Camera/(C.S)C-outdoor4/DSC03687.JPG,char_data/S/DSC03687.JPG_0.jpg,442,17,143,160,296,322,True,28
S,30,kaist_dataset/Mixed/Digital_Camera/(C.S)C-outdoor2/DSC02421.JPG,char_data/S/DSC02421.JPG_0.jpg,870,29,54,83,209,239,True,28
S,31,kaist_dataset/Mixed/Digital_Camera/(C.S)C-outdoor2/DSC02421.JPG,char_data/S/DSC02421.JPG_0.jpg,930,30,170,200,208,239,True,28
S,35,kaist_dataset/Mixed/Digital_Camera/(C.S)C-outdoor2/DSC02912.JPG,char_data/S/DSC02912.JPG_0.jpg,1155,33,210,243,9,44,True,28
S,69,kaist_dataset/Mixed/Digital_Camera/(C.S)C-outdoor2/DSC02418.JPG,char_data/S/DSC02418.JPG_0.jpg,4830,70,25,95,155,224,True,28
S,113,kaist_dataset/Mixed/Digital_Camera/(C.S)C-outdoor2/DSC02917.JPG,char_data/S/DSC02917.JPG_0.jpg,7910,70,210,280,68,181,True,28
S,119,kaist_dataset/Mixed/Digital_Camera/(C.S)C-outdoor2/DSC02917.JPG,char_data/S/DSC02917.JPG_0.jpg,8568,72,277,349,64,183,True,28
S,113,kaist_dataset/Mixed/Digital_Camera/(C.S)C-outdoor2/DSC02917.JPG,char_data/S/DSC02917.JPG_0.jpg,8136,72,425,497,68,181,True,28
S,36,kaist_dataset/Mixed/Digital_Camera/(C.S)C-outdoor2/DSC02917.JPG,char_data/S/DSC02917.JPG_0.jpg,720,20,40,60,220,256,True,28
S,34,kaist_dataset/Mixed/Digital_Camera/(C.S)C-outdoor2/DSC02917.JPG,char_data/S/DSC02917.JPG_0.jpg,680,20,59,79,222,256,True,28
S,33,kaist_dataset/Mixed/Digital_Camera/(C.S)C-outdoor2/DSC02917.JPG,char_data/S/DSC02917.JPG_0.jpg,693,21,101,122,226,259,True,28
S,31,kaist_dataset/Mixed/Digital_Camera/(C.S)C-outdoor2/DSC02483.JPG,char_data/S/DSC02483.JPG_0.jpg,682,22,382,404,147,178,True,28
S,48,kaist_dataset/Mixed/Digital_Camera/(C.S)C-outdoor2/DSC02869.JPG,char_data/S/DSC02869.JPG_0.jpg,912,19,112,131,133,181,True,28
S,38,kaist_dataset/Mixed/Digital_Camera/(C.S)C-outdoor2/DSC02910.JPG,char_data/S/DSC02910.JPG_0.jpg,798,21,313,334,53,91,True,28
S,36,kaist_dataset/Mixed/Digital_Camera/(C.S)C-outdoor2/DSC02910.JPG,char_data/S/DSC02910.JPG_0.jpg,684,19,424,443,54,90,True,28
S,33,kaist_dataset/Mixed/Digital_Camera/(C.S)C-outdoor2/DSC02385.JPG,char_data/S/DSC02385.JPG_0.jpg,495,15,385,400,147,180,True,28
S,69,kaist_dataset/Mixed/Digital_Camera/(C.S)C-outdoor2/DSC02870.JPG,char_data/S/DSC02870.JPG_0.jpg,3657,53,175,228,274,343,True,28
S,28,kaist_dataset/Mixed/Digital_Camera/(C.S)C-outdoor2/DSC02439.JPG,char_data/S/DSC02439.JPG_0.jpg,560,20,317,337,107,135,True,28
S,72,kaist_dataset/Mixed/Digital_Camera/(C.S)C-outdoor2/DSC02866.JPG,char_data/S/DSC02866.JPG_0.jpg,2520,35,594,629,104,176,True,28
S,39,kaist_dataset/Mixed/Digital_Camera/(C.S)C-outdoor2/DSC02864.JPG,char_data/S/DSC02864.JPG_0.jpg,1131,29,527,556,257,296,True,28
S,100,kaist_dataset/Mixed/Digital_Camera/(C.S)C-outdoor2/DSC02433.JPG,char_data/S/DSC02433.JPG_0.jpg,4300,43,37,80,165,265,True,28
S,39,kaist_dataset/Mixed/Digital_Camera/(C.S)C-outdoor2/DSC02557.JPG,char_data/S/DSC02557.JPG_0.jpg,1014,26,52,78,223,262,True,28
S,31,kaist_dataset/Mixed/Digital_Camera/(C.S)C-outdoor2/DSC02568.JPG,char_data/S/DSC02568.JPG_0.jpg,837,27,209,236,149,180,True,28
S,44,kaist_dataset/Mixed/Digital_Camera/(C.S)C-outdoor2/DSC02867.JPG,char_data/S/DSC02867.JPG_0.jpg,1364,31,311,342,401,445,True,28
S,104,kaist_dataset/Mixed/Digital_Camera/(C.S)A-shadow/DSC02609.JPG,char_data/S/DSC02609.JPG_0.jpg,7176,69,157,226,205,309,True,28
S,37,kaist_dataset/Mixed/Digital_Camera/(C.S)A-shadow/DSC02609.JPG,char_data/S/DSC02609.JPG_0.jpg,925,25,162,187,319,356,True,28
S,55,kaist_dataset/Mixed/Digital_Camera/(C.S)A-shadow/DSC02902.JPG,char_data/S/DSC02902.JPG_0.jpg,1925,35,167,202,382,437,True,28
S,31,kaist_dataset/Mixed/Digital_Camera/(C.S)A-shadow/DSC02568.JPG,char_data/S/DSC02568.JPG_0.jpg,837,27,209,236,149,180,True,28
S,80,kaist_dataset/Mixed/Digital_Camera/(C.S)A-shadow/DSC03207.JPG,char_data/S/DSC03207.JPG_0.jpg,4400,55,139,194,183,263,True,28
S,122,kaist_dataset/English/Mobile_Phone/(E.M)A-outdoor/P090911085.jpg,char_data/S/P090911085.jpg_0.jpg,8784,72,132,204,120,242,True,28
S,72,kaist_dataset/English/Mobile_Phone/(E.M)B-indoor/P090902018.jpg,char_data/S/P090902018.jpg_0.jpg,2736,38,408,446,62,134,True,28
S,74,kaist_dataset/English/Mobile_Phone/(E.M)B-indoor/P090902018.jpg,char_data/S/P090902018.jpg_0.jpg,3552,48,445,493,59,133,True,28
S,77,kaist_dataset/English/Mobile_Phone/(E.M)B-indoor/P090902018.jpg,char_data/S/P090902018.jpg_0.jpg,2772,36,59,95,162,239,True,28
S,69,kaist_dataset/English/Mobile_Phone/(E.M)B-indoor/P090902018.jpg,char_data/S/P090902018.jpg_0.jpg,3381,49,104,153,290,359,True,28
S,37,kaist_dataset/English/Mobile_Phone/(E.M)C-bookCover/P090903056.jpg,char_data/S/P090903056.jpg_0.jpg,1258,34,328,362,203,240,True,28
S,90,kaist_dataset/English/Mobile_Phone/(E.M)C-bookCover/P090903076.jpg,char_data/S/P090903076.jpg_0.jpg,5940,66,476,542,296,386,True,28
S,43,kaist_dataset/English/Mobile_Phone/(E.M)C-bookCover/P090903076.jpg,char_data/S/P090903076.jpg_0.jpg,1462,34,447,481,397,440,True,28
S,77,kaist_dataset/English/Mobile_Phone/(E.M)C-bookCover/P090903071.jpg,char_data/S/P090903071.jpg_0.jpg,4312,56,338,394,146,223,True,28
S,69,kaist_dataset/English/Mobile_Phone/(E.M)C-bookCover/P090903071.jpg,char_data/S/P090903071.jpg_0.jpg,2898,42,420,462,228,297,True,28
S,40,kaist_dataset/English/Mobile_Phone/(E.M)C-bookCover/P090903071.jpg,char_data/S/P090903071.jpg_0.jpg,1200,30,419,449,302,342,True,28
S,49,kaist_dataset/English/Mobile_Phone/(E.M)C-bookCover/P090903041.jpg,char_data/S/P090903041.jpg_0.jpg,2205,45,168,213,26,75,True,28
S,119,kaist_dataset/English/Mobile_Phone/(E.M)C-bookCover/P090903050.jpg,char_data/S/P090903050.jpg_0.jpg,11067,93,34,127,71,190,True,28
S,67,kaist_dataset/English/Mobile_Phone/(E.M)C-bookCover/P090831075.jpg,char_data/S/P090831075.jpg_0.jpg,2077,31,307,338,159,226,True,28
S,63,kaist_dataset/English/Mobile_Phone/(E.M)C-bookCover/P090831075.jpg,char_data/S/P090831075.jpg_0.jpg,2142,34,340,374,160,223,True,28
S,34,kaist_dataset/English/Mobile_Phone/(E.M)C-bookCover/P090903055.jpg,char_data/S/P090903055.jpg_0.jpg,1326,39,327,366,72,106,True,28
S,76,kaist_dataset/English/Mobile_Phone/(E.M)C-bookCover/P090831042.jpg,char_data/S/P090831042.jpg_0.jpg,4560,60,561,621,195,271,True,28
S,42,kaist_dataset/English/Mobile_Phone/(E.M)C-bookCover/P090903015.jpg,char_data/S/P090903015.jpg_0.jpg,1176,28,485,513,78,120,True,28
S,148,kaist_dataset/English/Digital_Camera/(E.S)E-night/DSC02570.JPG,char_data/S/DSC02570.JPG_0.jpg,8732,59,90,149,203,351,True,28
S,114,kaist_dataset/English/Digital_Camera/(E.S)E-night/크기변환_%BA%F7%BD%BA%BD%C5%B8%DE%B4%BA_01_tjtjdska2008.jpg,char_data/S/크기변환_%BA%F7%BD%BA%BD%C5%B8%DE%B4%BA_01_tjtjdska2008.jpg_0.jpg,7980,70,378,448,156,270,True,28
S,28,kaist_dataset/English/Digital_Camera/(E.S)E-night/크기변환_%BA%F7%BD%BA%BD%C5%B8%DE%B4%BA_01_tjtjdska2008.jpg,char_data/S/크기변환_%BA%F7%BD%BA%BD%C5%B8%DE%B4%BA_01_tjtjdska2008.jpg_0.jpg,616,22,241,263,274,302,True,28
S,26,kaist_dataset/English/Digital_Camera/(E.S)E-night/111.jpg,char_data/S/111.jpg_0.jpg,234,9,261,270,282,308,True,28
S,25,kaist_dataset/English/Digital_Camera/(E.S)E-night/111.jpg,char_data/S/111.jpg_0.jpg,250,10,271,281,282,307,True,28
S,18,kaist_dataset/English/Digital_Camera/(E.S)E-night/111.jpg,char_data/S/111.jpg_0.jpg,162,9,269,278,266,284,True,28
S,22,kaist_dataset/English/Digital_Camera/(E.S)E-night/111.jpg,char_data/S/111.jpg_0.jpg,198,9,318,327,267,289,True,28
S,112,kaist_dataset/English/Digital_Camera/(E.S)E-night/DSC02610.JPG,char_data/S/DSC02610.JPG_0.jpg,10528,94,86,180,151,263,True,28
S,88,kaist_dataset/English/Digital_Camera/(E.S)E-night/DSC02674.JPG,char_data/S/DSC02674.JPG_0.jpg,8272,94,526,620,197,285,True,28
S,55,kaist_dataset/English/Digital_Camera/(E.S)C-outdoor2/DSC03023.JPG,char_data/S/DSC03023.JPG_0.jpg,1210,22,266,288,299,354,True,28
S,54,kaist_dataset/English/Digital_Camera/(E.S)C-outdoor2/DSC03317.JPG,char_data/S/DSC03317.JPG_0.jpg,1134,21,392,413,190,244,True,28
S,62,kaist_dataset/English/Digital_Camera/(E.S)C-outdoor2/DSC04079.JPG,char_data/S/DSC04079.JPG_0.jpg,2232,36,432,468,42,104,True,28
S,130,kaist_dataset/English/Digital_Camera/(E.S)C-outdoor2/DSC04430.JPG,char_data/S/DSC04430.JPG_0.jpg,17030,131,36,167,266,396,True,28
S,65,kaist_dataset/English/Digital_Camera/(E.S)C-outdoor2/DSC03277.JPG,char_data/S/DSC03277.JPG_0.jpg,3640,56,70,126,177,242,True,28
S,184,kaist_dataset/English/Digital_Camera/(E.S)C-outdoor2/DSC02949.JPG,char_data/S/DSC02949.JPG_0.jpg,11776,64,188,252,63,247,True,28
S,68,kaist_dataset/English/Digital_Camera/(E.S)C-outdoor2/DSC03025.JPG,char_data/S/DSC03025.JPG_0.jpg,2516,37,287,324,129,197,True,28
S,58,kaist_dataset/English/Digital_Camera/(E.S)C-outdoor2/DSC04120.JPG,char_data/S/DSC04120.JPG_0.jpg,2088,36,422,458,142,200,True,28
S,48,kaist_dataset/English/Digital_Camera/(E.S)C-outdoor2/DSC03650.JPG,char_data/S/DSC03650.JPG_0.jpg,1392,29,331,360,213,261,True,28
S,76,kaist_dataset/English/Digital_Camera/(E.S)C-outdoor2/DSC03411.JPG,char_data/S/DSC03411.JPG_0.jpg,5624,74,223,297,163,239,True,28
S,74,kaist_dataset/English/Digital_Camera/(E.S)C-outdoor2/DSC03191.JPG,char_data/S/DSC03191.JPG_0.jpg,3996,54,84,138,137,211,True,28
S,37,kaist_dataset/English/Digital_Camera/(E.S)C-outdoor2/DSC04361.JPG,char_data/S/DSC04361.JPG_0.jpg,925,25,386,411,243,280,True,28
S,141,kaist_dataset/English/Digital_Camera/(E.S)C-outdoor2/DSC04431.JPG,char_data/S/DSC04431.JPG_0.jpg,16074,114,62,176,93,234,True,28
S,142,kaist_dataset/English/Digital_Camera/(E.S)C-outdoor2/DSC04431.JPG,char_data/S/DSC04431.JPG_0.jpg,15762,111,76,187,250,392,True,28
S,49,kaist_dataset/English/Digital_Camera/(E.S)C-outdoor2/DSC03161.JPG,char_data/S/DSC03161.JPG_0.jpg,1274,26,543,569,221,270,True,28
S,63,kaist_dataset/English/Digital_Camera/(E.S)C-outdoor2/IMG_2481.JPG,char_data/S/IMG_2481.JPG_0.jpg,2079,33,356,389,188,251,True,28
S,44,kaist_dataset/English/Digital_Camera/(E.S)C-outdoor2/DSC03203.JPG,char_data/S/DSC03203.JPG_0.jpg,1540,35,213,248,313,357,True,28
S,65,kaist_dataset/English/Digital_Camera/(E.S)C-outdoor2/DSC03865.JPG,char_data/S/DSC03865.JPG_0.jpg,2535,39,493,532,93,158,True,28
S,61,kaist_dataset/English/Digital_Camera/(E.S)C-outdoor2/DSC03167.JPG,char_data/S/DSC03167.JPG_0.jpg,3477,57,207,264,294,355,True,28
S,57,kaist_dataset/English/Digital_Camera/(E.S)C-outdoor2/DSC03001.JPG,char_data/S/DSC03001.JPG_0.jpg,2679,47,210,257,187,244,True,28
S,45,kaist_dataset/English/Digital_Camera/(E.S)C-outdoor2/DSC03575.JPG,char_data/S/DSC03575.JPG_0.jpg,1485,33,384,417,180,225,True,28
S,51,kaist_dataset/English/Digital_Camera/(E.S)C-outdoor2/DSC03575.JPG,char_data/S/DSC03575.JPG_0.jpg,1581,31,440,471,261,312,True,28
S,54,kaist_dataset/English/Digital_Camera/(E.S)C-outdoor2/DSC03575.JPG,char_data/S/DSC03575.JPG_0.jpg,1890,35,471,506,263,317,True,28
S,70,kaist_dataset/English/Digital_Camera/(E.S)C-outdoor2/DSC03414.JPG,char_data/S/DSC03414.JPG_0.jpg,5250,75,176,251,257,327,True,28
S,66,kaist_dataset/English/Digital_Camera/(E.S)C-outdoor2/DSC03414.JPG,char_data/S/DSC03414.JPG_0.jpg,3762,57,364,421,346,412,True,28
S,101,kaist_dataset/English/Digital_Camera/(E.S)C-outdoor2/DSC03761.JPG,char_data/S/DSC03761.JPG_0.jpg,6767,67,154,221,320,421,True,28
S,43,kaist_dataset/English/Digital_Camera/(E.S)C-outdoor2/DSC04064.JPG,char_data/S/DSC04064.JPG_0.jpg,1161,27,499,526,137,180,True,28
S,32,kaist_dataset/English/Digital_Camera/(E.S)C-outdoor2/DSC04064.JPG,char_data/S/DSC04064.JPG_0.jpg,832,26,598,624,150,182,True,28
S,53,kaist_dataset/English/Digital_Camera/(E.S)C-outdoor2/DSC03705.JPG,char_data/S/DSC03705.JPG_0.jpg,1961,37,325,362,313,366,True,28
S,61,kaist_dataset/English/Digital_Camera/(E.S)C-outdoor2/DSC03765.JPG,char_data/S/DSC03765.JPG_0.jpg,3294,54,170,224,83,144,True,28
S,60,kaist_dataset/English/Digital_Camera/(E.S)C-outdoor2/DSC04464.JPG,char_data/S/DSC04464.JPG_0.jpg,2820,47,210,257,324,384,True,28
S,58,kaist_dataset/English/Digital_Camera/(E.S)C-outdoor2/DSC03413.JPG,char_data/S/DSC03413.JPG_0.jpg,2668,46,335,381,205,263,True,28
S,36,kaist_dataset/English/Digital_Camera/(E.S)C-outdoor2/DSC03831.JPG,char_data/S/DSC03831.JPG_0.jpg,828,23,406,429,128,164,True,28
S,133,kaist_dataset/English/Digital_Camera/(E.S)C-outdoor2/DSC04163.JPG,char_data/S/DSC04163.JPG_0.jpg,13965,105,419,524,112,245,True,28
S,48,kaist_dataset/English/Digital_Camera/(E.S)C-outdoor2/DSC03279.JPG,char_data/S/DSC03279.JPG_0.jpg,1440,30,140,170,208,256,True,28
S,46,kaist_dataset/English/Digital_Camera/(E.S)C-outdoor2/DSC03279.JPG,char_data/S/DSC03279.JPG_0.jpg,1242,27,235,262,211,257,True,28
S,69,kaist_dataset/English/Digital_Camera/(E.S)C-outdoor2/DSC03012.JPG,char_data/S/DSC03012.JPG_0.jpg,3174,46,28,74,212,281,True,28
S,63,kaist_dataset/English/Digital_Camera/(E.S)C-outdoor2/DSC03012.JPG,char_data/S/DSC03012.JPG_0.jpg,2709,43,295,338,215,278,True,28
S,41,kaist_dataset/English/Digital_Camera/(E.S)C-outdoor2/DSC03160.JPG,char_data/S/DSC03160.JPG_0.jpg,820,20,246,266,399,440,True,28
S,138,kaist_dataset/English/Digital_Camera/(E.S)C-outdoor2/DSC03408.JPG,char_data/S/DSC03408.JPG_0.jpg,12420,90,18,108,296,434,True,28
S,135,kaist_dataset/English/Digital_Camera/(E.S)C-outdoor2/DSC03663.JPG,char_data/S/DSC03663.JPG_0.jpg,12420,92,228,320,153,288,True,28
S,73,kaist_dataset/English/Digital_Camera/(E.S)C-outdoor2/DSC03050.JPG,char_data/S/DSC03050.JPG_0.jpg,5840,80,241,321,211,284,True,28
S,62,kaist_dataset/English/Digital_Camera/(E.S)C-outdoor2/DSC03684.JPG,char_data/S/DSC03684.JPG_0.jpg,2604,42,216,258,83,145,True,28
S,135,kaist_dataset/English/Digital_Camera/(E.S)C-outdoor2/DSC03410.JPG,char_data/S/DSC03410.JPG_0.jpg,20520,152,56,208,287,422,True,28
S,78,kaist_dataset/English/Digital_Camera/(E.S)C-outdoor2/P1010015.JPG,char_data/S/P1010015.JPG_0.jpg,5070,65,344,409,139,217,True,28
S,68,kaist_dataset/English/Digital_Camera/(E.S)C-outdoor2/DSC04087.JPG,char_data/S/DSC04087.JPG_0.jpg,3400,50,214,264,124,192,True,28
S,94,kaist_dataset/English/Digital_Camera/(E.S)C-outdoor1/DSC02524.JPG,char_data/S/DSC02524.JPG_0.jpg,6768,72,31,103,306,400,True,28
S,124,kaist_dataset/English/Digital_Camera/(E.S)C-outdoor1/DSC02427.JPG,char_data/S/DSC02427.JPG_0.jpg,8680,70,211,281,104,228,True,28
S,51,kaist_dataset/English/Digital_Camera/(E.S)C-outdoor1/DSC02427.JPG,char_data/S/DSC02427.JPG_0.jpg,1377,27,279,306,237,288,True,28
S,50,kaist_dataset/English/Digital_Camera/(E.S)C-outdoor1/DSC02427.JPG,char_data/S/DSC02427.JPG_0.jpg,1200,24,395,419,235,285,True,28
S,49,kaist_dataset/English/Digital_Camera/(E.S)C-outdoor1/DSC02427.JPG,char_data/S/DSC02427.JPG_0.jpg,1176,24,422,446,235,284,True,28
S,93,kaist_dataset/English/Digital_Camera/(E.S)C-outdoor1/DSC02514.JPG,char_data/S/DSC02514.JPG_0.jpg,4650,50,63,113,146,239,True,28
S,120,kaist_dataset/English/Digital_Camera/(E.S)C-outdoor1/DSC02450.JPG,char_data/S/DSC02450.JPG_0.jpg,5880,49,524,573,73,193,True,28
S,37,kaist_dataset/English/Digital_Camera/(E.S)C-outdoor1/DSC02618.JPG,char_data/S/DSC02618.JPG_0.jpg,481,13,330,343,174,211,True,28
S,37,kaist_dataset/English/Digital_Camera/(E.S)C-outdoor1/DSC02618.JPG,char_data/S/DSC02618.JPG_0.jpg,629,17,340,357,175,212,True,28
S,100,kaist_dataset/English/Digital_Camera/(E.S)C-outdoor1/DSC02345.JPG,char_data/S/DSC02345.JPG_0.jpg,11400,114,76,190,131,231,True,28
S,35,kaist_dataset/English/Digital_Camera/(E.S)C-outdoor1/DSC02345.JPG,char_data/S/DSC02345.JPG_0.jpg,1085,31,79,110,239,274,True,28
S,32,kaist_dataset/English/Digital_Camera/(E.S)C-outdoor1/DSC02345.JPG,char_data/S/DSC02345.JPG_0.jpg,704,22,174,196,241,273,True,28
S,65,kaist_dataset/English/Digital_Camera/(E.S)C-outdoor1/DSC02480.JPG,char_data/S/DSC02480.JPG_0.jpg,3965,61,353,414,192,257,True,28
S,137,kaist_dataset/English/Digital_Camera/(E.S)C-outdoor1/DSC02448.JPG,char_data/S/DSC02448.JPG_0.jpg,12193,89,106,195,189,326,True,28
S,87,kaist_dataset/English/Digital_Camera/(E.S)C-outdoor1/DSC02897.JPG,char_data/S/DSC02897.JPG_0.jpg,4263,49,260,309,285,372,True,28
S,47,kaist_dataset/English/Digital_Camera/(E.S)C-outdoor1/064.JPG,char_data/S/064.JPG_0.jpg,1269,27,267,294,182,229,True,28
S,54,kaist_dataset/English/Digital_Camera/(E.S)C-outdoor1/080119-0012.jpg,char_data/S/080119-0012.jpg_0.jpg,1296,24,701,725,579,633,True,28
S,81,kaist_dataset/English/Digital_Camera/(E.S)C-outdoor1/DSC02408.JPG,char_data/S/DSC02408.JPG_0.jpg,5184,64,306,370,264,345,True,28
S,188,kaist_dataset/English/Digital_Camera/(E.S)C-outdoor1/2007-12-08-day-015.jpg,char_data/S/2007-12-08-day-015.jpg_0.jpg,34028,181,188,369,445,633,True,28
S,132,kaist_dataset/English/Digital_Camera/(E.S)C-outdoor1/2007-12-09-day-exterior-063.jpg,char_data/S/2007-12-09-day-exterior-063.jpg_0.jpg,9504,72,894,966,428,560,True,28
S,157,kaist_dataset/English/Digital_Camera/(E.S)C-outdoor1/080119-0020.jpg,char_data/S/080119-0020.jpg_0.jpg,20096,128,1032,1160,478,635,True,28
S,154,kaist_dataset/English/Digital_Camera/(E.S)C-outdoor1/DSC02475.JPG,char_data/S/DSC02475.JPG_0.jpg,17094,111,366,477,72,226,True,28
S,85,kaist_dataset/English/Digital_Camera/(E.S)C-outdoor1/080116-0064.jpg,char_data/S/080116-0064.jpg_0.jpg,2720,32,389,421,226,311,True,28
S,67,kaist_dataset/English/Digital_Camera/(E.S)C-outdoor1/DSC02619.JPG,char_data/S/DSC02619.JPG_0.jpg,2412,36,120,156,219,286,False,28
S,68,kaist_dataset/English/Digital_Camera/(E.S)C-outdoor1/DSC02619.JPG,char_data/S/DSC02619.JPG_0.jpg,2856,42,271,313,215,283,False,28
S,69,kaist_dataset/English/Digital_Camera/(E.S)C-outdoor1/DSC02619.JPG,char_data/S/DSC02619.JPG_0.jpg,3519,51,310,361,213,282,False,28
S,136,kaist_dataset/English/Digital_Camera/(E.S)C-outdoor1/129.JPG,char_data/S/129.JPG_0.jpg,12376,91,103,194,174,310,False,28
S,69,kaist_dataset/English/Digital_Camera/(E.S)C-outdoor1/080118-0011.jpg,char_data/S/080118-0011.jpg_0.jpg,3381,49,660,709,938,1007,False,28
S,138,kaist_dataset/English/Digital_Camera/(E.S)C-outdoor1/DSC02406.JPG,char_data/S/DSC02406.JPG_0.jpg,14214,103,62,165,269,407,False,28
S,37,kaist_dataset/English/Digital_Camera/(E.S)C-outdoor1/041.JPG,char_data/S/041.JPG_0.jpg,1073,29,394,423,249,286,False,28
S,22,kaist_dataset/English/Digital_Camera/(E.S)C-outdoor1/DSC02500.JPG,char_data/S/DSC02500.JPG_0.jpg,330,15,7,22,105,127,False,28
S,25,kaist_dataset/English/Digital_Camera/(E.S)C-outdoor1/DSC02500.JPG,char_data/S/DSC02500.JPG_0.jpg,325,13,68,81,83,108,False,28
S,47,kaist_dataset/English/Digital_Camera/(E.S)C-outdoor1/089.jpg,char_data/S/089.jpg_0.jpg,705,15,353,368,284,331,False,28
S,40,kaist_dataset/English/Digital_Camera/(E.S)C-outdoor1/6.jpg,char_data/S/6.jpg_0.jpg,1520,38,189,227,100,140,False,28
S,83,kaist_dataset/English/Digital_Camera/(E.S)C-outdoor1/DSC02491.JPG,char_data/S/DSC02491.JPG_0.jpg,4399,53,80,133,44,127,False,28
S,47,kaist_dataset/English/Digital_Camera/(E.S)B-light/DSC03007.JPG,char_data/S/DSC03007.JPG_0.jpg,1363,29,385,414,277,324,False,28
S,18,kaist_dataset/English/Digital_Camera/(E.S)B-light/x.jpg,char_data/S/x.jpg_0.jpg,288,16,81,97,116,134,False,28
S,205,kaist_dataset/English/Digital_Camera/(E.S)B-light/080116-0059.jpg,char_data/S/080116-0059.jpg_0.jpg,25010,122,927,1049,47,252,False,28
S,227,kaist_dataset/English/Digital_Camera/(E.S)B-light/080116-0059.jpg,char_data/S/080116-0059.jpg_0.jpg,26559,117,695,812,502,729,False,28
S,229,kaist_dataset/English/Digital_Camera/(E.S)B-light/080116-0059.jpg,char_data/S/080116-0059.jpg_0.jpg,26335,115,814,929,504,733,False,28
S,38,kaist_dataset/English/Digital_Camera/(E.S)B-light/080116-0059.jpg,char_data/S/080116-0059.jpg_0.jpg,570,15,489,504,825,863,False,28
S,25,kaist_dataset/English/Digital_Camera/(E.S)B-light/080116-0059.jpg,char_data/S/080116-0059.jpg_0.jpg,350,14,1004,1018,826,851,False,28
S,29,kaist_dataset/English/Digital_Camera/(E.S)B-light/080116-0059.jpg,char_data/S/080116-0059.jpg_0.jpg,406,14,801,815,825,854,False,28
S,29,kaist_dataset/English/Digital_Camera/(E.S)B-light/080116-0059.jpg,char_data/S/080116-0059.jpg_0.jpg,551,19,782,801,799,828,False,28
S,32,kaist_dataset/English/Digital_Camera/(E.S)B-light/080116-0059.jpg,char_data/S/080116-0059.jpg_0.jpg,512,16,541,557,772,804,False,28
S,35,kaist_dataset/English/Digital_Camera/(E.S)B-light/080116-0059.jpg,char_data/S/080116-0059.jpg_0.jpg,840,24,621,645,769,804,False,28
S,70,kaist_dataset/English/Digital_Camera/(E.S)B-light/080119-0038.jpg,char_data/S/080119-0038.jpg_0.jpg,3850,55,1091,1146,684,754,False,28
S,25,kaist_dataset/English/Digital_Camera/(E.S)B-light/v.jpg,char_data/S/v.jpg_0.jpg,400,16,187,203,56,81,False,28
S,45,kaist_dataset/English/Digital_Camera/(E.S)F-others/080119-0007.jpg,char_data/S/080119-0007.jpg_0.jpg,2340,52,1193,1245,651,696,False,28
S,187,kaist_dataset/English/Digital_Camera/(E.S)F-others/2007-12-09-day-exterior-047.jpg,char_data/S/2007-12-09-day-exterior-047.jpg_0.jpg,20944,112,940,1052,471,658,False,28
S,39,kaist_dataset/English/Digital_Camera/(E.S)F-others/2007-12-09-day-exterior-047.jpg,char_data/S/2007-12-09-day-exterior-047.jpg_0.jpg,819,21,690,711,1070,1109,False,28
S,61,kaist_dataset/English/Digital_Camera/(E.S)F-others/크기변환_%B0%A3%C6%C77_m_starfirm.jpg,char_data/S/크기변환_%B0%A3%C6%C77_m_starfirm.jpg_0.jpg,2867,47,241,288,83,144,False,28
S,60,kaist_dataset/English/Digital_Camera/(E.S)F-others/크기변환_%B0%A3%C6%C77_m_starfirm.jpg,char_data/S/크기변환_%B0%A3%C6%C77_m_starfirm.jpg_0.jpg,2460,41,287,328,96,156,False,28
S,151,kaist_dataset/English/Digital_Camera/(E.S)F-others/080116-0060.jpg,char_data/S/080116-0060.jpg_0.jpg,11778,78,977,1055,399,550,False,28
S,114,kaist_dataset/English/Digital_Camera/(E.S)F-others/080119-0014.jpg,char_data/S/080119-0014.jpg_0.jpg,7752,68,1372,1440,765,879,False,28
S,135,kaist_dataset/English/Digital_Camera/(E.S)F-others/080116-0058.jpg,char_data/S/080116-0058.jpg_0.jpg,6210,46,955,1001,459,594,False,28
S,151,kaist_dataset/English/Digital_Camera/(E.S)F-others/080116-0058.jpg,char_data/S/080116-0058.jpg_0.jpg,5587,37,868,905,725,876,False,28
S,143,kaist_dataset/English/Digital_Camera/(E.S)F-others/080116-0058.jpg,char_data/S/080116-0058.jpg_0.jpg,5005,35,907,942,735,878,False,28
S,98,kaist_dataset/English/Digital_Camera/(E.S)F-others/DSC02923.JPG,char_data/S/DSC02923.JPG_0.jpg,8330,85,39,124,307,405,False,28
S,97,kaist_dataset/English/Digital_Camera/(E.S)F-others/DSC02923.JPG,char_data/S/DSC02923.JPG_0.jpg,8148,84,123,207,299,396,False,28
S,54,kaist_dataset/English/Digital_Camera/(E.S)F-others/DSC03218.JPG,char_data/S/DSC03218.JPG_0.jpg,2160,40,110,150,316,370,False,28
S,113,kaist_dataset/English/Digital_Camera/(E.S)A-shadow/DSC03077.JPG,char_data/S/DSC03077.JPG_0.jpg,11413,101,57,158,315,428,False,28
S,95,kaist_dataset/English/Digital_Camera/(E.S)A-shadow/DSC02633.JPG,char_data/S/DSC02633.JPG_0.jpg,5985,63,494,557,187,282,False,28
S,38,kaist_dataset/English/Digital_Camera/(E.S)A-shadow/P1010044.JPG,char_data/S/P1010044.JPG_0.jpg,1178,31,188,219,358,396,False,28
S,121,kaist_dataset/English/Digital_Camera/(E.S)A-shadow/P1010035.JPG,char_data/S/P1010035.JPG_0.jpg,12221,101,213,314,162,283,False,28
S,109,kaist_dataset/English/Digital_Camera/(E.S)D-indoor/DSC03402.JPG,char_data/S/DSC03402.JPG_0.jpg,8175,75,118,193,186,295,False,28
S,136,kaist_dataset/English/Digital_Camera/(E.S)D-indoor/DSC02842.JPG,char_data/S/DSC02842.JPG_0.jpg,18904,139,424,563,199,335,False,28
S,80,kaist_dataset/English/Digital_Camera/(E.S)D-indoor/DSC03941.JPG,char_data/S/DSC03941.JPG_0.jpg,4000,50,384,434,228,308,False,28
S,41,kaist_dataset/English/Digital_Camera/(E.S)D-indoor/DSC03147.JPG,char_data/S/DSC03147.JPG_0.jpg,943,23,284,307,292,333,False,28
S,48,kaist_dataset/English/Digital_Camera/(E.S)D-indoor/DSC03147.JPG,char_data/S/DSC03147.JPG_0.jpg,1248,26,286,312,230,278,False,28
S,37,kaist_dataset/English/Digital_Camera/(E.S)D-indoor/DSC03942.JPG,char_data/S/DSC03942.JPG_0.jpg,925,25,349,374,370,407,False,28
S,42,kaist_dataset/English/Digital_Camera/(E.S)D-indoor/DSC03942.JPG,char_data/S/DSC03942.JPG_0.jpg,882,21,374,395,368,410,False,28
S,43,kaist_dataset/English/Digital_Camera/(E.S)D-indoor/DSC03942.JPG,char_data/S/DSC03942.JPG_0.jpg,1032,24,468,492,372,415,False,28
S,43,kaist_dataset/English/Digital_Camera/(E.S)D-indoor/DSC03142.JPG,char_data/S/DSC03142.JPG_0.jpg,1376,32,176,208,357,400,False,28
S,56,kaist_dataset/English/Digital_Camera/(E.S)D-indoor/DSC03918.JPG,char_data/S/DSC03918.JPG_0.jpg,1960,35,399,434,409,465,False,28
S,101,kaist_dataset/English/Digital_Camera/(E.S)D-indoor/DSC03366.JPG,char_data/S/DSC03366.JPG_0.jpg,7070,70,294,364,349,450,False,28
S,63,kaist_dataset/English/Digital_Camera/(E.S)D-indoor/DSC03887.JPG,char_data/S/DSC03887.JPG_0.jpg,3087,49,346,395,167,230,False,28
S,81,kaist_dataset/English/Digital_Camera/(E.S)D-indoor/DSC03403.JPG,char_data/S/DSC03403.JPG_0.jpg,5184,64,146,210,202,283,False,28
S,82,kaist_dataset/English/Digital_Camera/(E.S)D-indoor/DSC03076.JPG,char_data/S/DSC03076.JPG_0.jpg,4264,52,147,199,286,368,False,28
S,82,kaist_dataset/English/Digital_Camera/(E.S)D-indoor/DSC04255.JPG,char_data/S/DSC04255.JPG_0.jpg,6314,77,442,519,298,380,False,28
S,115,kaist_dataset/English/Digital_Camera/(E.S)D-indoor/080119-0015.jpg,char_data/S/080119-0015.jpg_0.jpg,11845,103,792,895,500,615,False,28
S,120,kaist_dataset/English/Digital_Camera/(E.S)D-indoor/080119-0015.jpg,char_data/S/080119-0015.jpg_0.jpg,12240,102,895,997,491,611,False,28
S,34,kaist_dataset/English/Digital_Camera/(E.S)D-indoor/080119-0015.jpg,char_data/S/080119-0015.jpg_0.jpg,1020,30,902,932,619,653,False,28
S,36,kaist_dataset/English/Digital_Camera/(E.S)D-indoor/080119-0015.jpg,char_data/S/080119-0015.jpg_0.jpg,900,25,957,982,613,649,False,28
S,62,kaist_dataset/English/Digital_Camera/(E.S)D-indoor/DSC03881.JPG,char_data/S/DSC03881.JPG_0.jpg,2480,40,401,441,302,364,False,28
S,46,kaist_dataset/English/Digital_Camera/(E.S)D-indoor/080119-0009.jpg,char_data/S/080119-0009.jpg_0.jpg,1012,22,561,583,994,1040,False,28
S,74,kaist_dataset/English/Digital_Camera/(E.S)D-indoor/080119-0009.jpg,char_data/S/080119-0009.jpg_0.jpg,2294,31,1444,1475,69,143,False,28
S,39,kaist_dataset/English/Digital_Camera/(E.S)D-indoor/DSC03935.JPG,char_data/S/DSC03935.JPG_0.jpg,663,17,196,213,39,78,False,28
S,98,kaist_dataset/English/Digital_Camera/(E.S)C-outdoor3/r.jpg,char_data/S/r.jpg_0.jpg,7350,75,21,96,94,192,False,28
S,76,kaist_dataset/English/Digital_Camera/(E.S)C-outdoor3/DSC03046.JPG,char_data/S/DSC03046.JPG_0.jpg,3724,49,299,348,126,202,False,28
S,75,kaist_dataset/English/Digital_Camera/(E.S)C-outdoor3/DSC03046.JPG,char_data/S/DSC03046.JPG_0.jpg,3900,52,368,420,125,200,False,28
S,84,kaist_dataset/English/Digital_Camera/(E.S)C-outdoor3/P1010133.JPG,char_data/S/P1010133.JPG_0.jpg,4704,56,394,450,72,156,False,28
S,50,kaist_dataset/English/Digital_Camera/(E.S)C-outdoor3/DSC02690.JPG,char_data/S/DSC02690.JPG_0.jpg,2550,51,413,464,209,259,False,28
S,72,kaist_dataset/English/Digital_Camera/(E.S)C-outdoor3/P1010123.JPG,char_data/S/P1010123.JPG_0.jpg,4248,59,215,274,73,145,False,28
9,52,"kaist_dataset/Korean/Mobile_Phone/(M,K)E-bookCover/P090912015.jpg",char_data/9/P090912015.jpg_2.jpg,1560,30,394,424,64,116,True,11
9,39,kaist_dataset/Korean/Digital_Camera/outdoor5/DSC03768.JPG,char_data/9/DSC03768.JPG_2.jpg,936,24,523,547,240,279,True,11
9,30,kaist_dataset/Korean/Digital_Camera/outdoor5/DSC03744.JPG,char_data/9/DSC03744.JPG_2.jpg,930,31,436,467,297,327,True,11
9,23,kaist_dataset/Korean/Digital_Camera/outdoor5/DSC03780.JPG,char_data/9/DSC03780.JPG_4.jpg,414,18,174,192,441,464,True,11
9,25,kaist_dataset/Korean/Digital_Camera/outdoor5/DSC03780.JPG,char_data/9/DSC03780.JPG_4.jpg,525,21,208,229,440,465,True,11
9,45,kaist_dataset/Korean/Digital_Camera/outdoor5/DSC03717.JPG,char_data/9/DSC03717.JPG_4.jpg,1530,34,294,328,351,396,True,11
9,43,kaist_dataset/Korean/Digital_Camera/outdoor5/DSC03717.JPG,char_data/9/DSC03717.JPG_4.jpg,1505,35,364,399,346,389,True,11
9,36,kaist_dataset/Korean/Digital_Camera/outdoor5/DSC03736.JPG,char_data/9/DSC03736.JPG_2.jpg,468,13,371,384,403,439,True,11
9,34,kaist_dataset/Korean/Digital_Camera/outdoor5/DSC03671.JPG,char_data/9/DSC03671.JPG_10.jpg,544,16,307,323,412,446,True,11
9,35,kaist_dataset/Korean/Digital_Camera/outdoor5/DSC03671.JPG,char_data/9/DSC03671.JPG_10.jpg,630,18,337,355,409,444,True,11
9,33,kaist_dataset/Korean/Digital_Camera/outdoor5/DSC03671.JPG,char_data/9/DSC03671.JPG_10.jpg,495,15,428,443,413,446,True,11
9,36,kaist_dataset/Korean/Digital_Camera/outdoor5/DSC03671.JPG,char_data/9/DSC03671.JPG_10.jpg,756,21,521,542,411,447,True,11
9,35,kaist_dataset/Korean/Digital_Camera/outdoor5/DSC03671.JPG,char_data/9/DSC03671.JPG_10.jpg,665,19,560,579,409,444,True,11
9,29,kaist_dataset/Korean/Digital_Camera/outdoor5/DSC03752.JPG,char_data/9/DSC03752.JPG_4.jpg,377,13,212,225,408,437,True,11
9,25,kaist_dataset/Korean/Digital_Camera/outdoor5/DSC03752.JPG,char_data/9/DSC03752.JPG_4.jpg,425,17,226,243,411,436,True,11
9,36,kaist_dataset/Korean/Digital_Camera/outdoor5/DSC03685.JPG,char_data/9/DSC03685.JPG_2.jpg,720,20,486,506,184,220,True,11
9,40,kaist_dataset/Korean/Digital_Camera/outdoor5/DSC03770.JPG,char_data/9/DSC03770.JPG_2.jpg,920,23,547,570,420,460,True,11
9,39,kaist_dataset/Korean/Digital_Camera/outdoor5/DSC04040.JPG,char_data/9/DSC04040.JPG_2.jpg,1365,35,511,546,340,379,True,11
9,39,kaist_dataset/Korean/Digital_Camera/outdoor5/DSC03709.JPG,char_data/9/DSC03709.JPG_4.jpg,663,17,499,516,365,404,True,11
9,44,kaist_dataset/Korean/Digital_Camera/outdoor5/DSC03709.JPG,char_data/9/DSC03709.JPG_4.jpg,836,19,530,549,361,405,True,11
9,32,kaist_dataset/Korean/Digital_Camera/outdoor5/DSC03710.JPG,char_data/9/DSC03710.JPG_4.jpg,896,28,367,395,410,442,True,11
9,34,kaist_dataset/Korean/Digital_Camera/outdoor5/DSC03710.JPG,char_data/9/DSC03710.JPG_4.jpg,1122,33,426,459,408,442,True,11
9,40,kaist_dataset/Korean/Digital_Camera/outdoor5/DSC03626.JPG,char_data/9/DSC03626.JPG_2.jpg,1120,28,185,213,296,336,True,11
9,27,kaist_dataset/Korean/Digital_Camera/outdoor5/DSC04028.JPG,char_data/9/DSC04028.JPG_2.jpg,675,25,368,393,344,371,True,11
9,16,kaist_dataset/Korean/Digital_Camera/outdoor5/DSC03776.JPG,char_data/9/DSC03776.JPG_4.jpg,160,10,545,555,443,459,True,11
9,20,kaist_dataset/Korean/Digital_Camera/outdoor5/DSC03776.JPG,char_data/9/DSC03776.JPG_4.jpg,320,16,567,583,442,462,True,11
9,32,kaist_dataset/Korean/Digital_Camera/outdoor4/DSC03293.JPG,char_data/9/DSC03293.JPG_2.jpg,768,24,387,411,289,321,True,11
9,51,kaist_dataset/Korean/Digital_Camera/outdoor4/DSC03605.JPG,char_data/9/DSC03605.JPG_4.jpg,1989,39,119,158,233,284,True,11
9,55,kaist_dataset/Korean/Digital_Camera/outdoor4/DSC03605.JPG,char_data/9/DSC03605.JPG_4.jpg,1980,36,92,128,145,200,True,11
9,104,kaist_dataset/Korean/Digital_Camera/outdoor4/DSC03542.JPG,char_data/9/DSC03542.JPG_4.jpg,5512,53,389,442,234,338,True,11
9,110,kaist_dataset/Korean/Digital_Camera/outdoor4/DSC03542.JPG,char_data/9/DSC03542.JPG_4.jpg,5060,46,489,535,230,340,True,11
9,51,kaist_dataset/Korean/Digital_Camera/outdoor4/DSC03608.JPG,char_data/9/DSC03608.JPG_2.jpg,1836,36,551,587,387,438,True,11
9,52,kaist_dataset/Korean/Digital_Camera/outdoor4/DSC03600.JPG,char_data/9/DSC03600.JPG_4.jpg,1976,38,328,366,270,322,True,11
9,29,kaist_dataset/Korean/Digital_Camera/outdoor4/DSC03600.JPG,char_data/9/DSC03600.JPG_4.jpg,638,22,343,365,329,358,True,11
9,38,kaist_dataset/Korean/Digital_Camera/outdoor4/DSC03592.JPG,char_data/9/DSC03592.JPG_2.jpg,684,18,522,540,124,162,True,11
9,54,kaist_dataset/Korean/Digital_Camera/outdoor4/DSC03319.JPG,char_data/9/DSC03319.JPG_4.jpg,1998,37,337,374,384,438,True,11
9,53,kaist_dataset/Korean/Digital_Camera/outdoor4/DSC03319.JPG,char_data/9/DSC03319.JPG_4.jpg,1802,34,375,409,384,437,True,11
9,39,kaist_dataset/Korean/Digital_Camera/outdoor4/DSC03545.JPG,char_data/9/DSC03545.JPG_2.jpg,858,22,213,235,41,80,True,11
9,59,kaist_dataset/Korean/Digital_Camera/outdoor4/DSC03580.JPG,char_data/9/DSC03580.JPG_2.jpg,1770,30,320,350,202,261,True,11
9,30,kaist_dataset/Korean/Digital_Camera/outdoor4/DSC03555.JPG,char_data/9/DSC03555.JPG_2.jpg,780,26,343,369,428,458,True,11
9,52,kaist_dataset/Korean/Digital_Camera/outdoor2/2007-12-09-day-exterior-016.jpg,char_data/9/2007-12-09-day-exterior-016.jpg_4.jpg,2080,40,691,731,750,802,True,11
9,45,kaist_dataset/Korean/Digital_Camera/outdoor2/2007-12-09-day-exterior-016.jpg,char_data/9/2007-12-09-day-exterior-016.jpg_4.jpg,1170,26,39,65,910,955,True,11
9,40,kaist_dataset/Korean/Digital_Camera/outdoor2/2007-12-08-day-101.jpg,char_data/9/2007-12-08-day-101.jpg_4.jpg,680,17,861,878,744,784,True,11
9,38,kaist_dataset/Korean/Digital_Camera/outdoor2/2007-12-08-day-101.jpg,char_data/9/2007-12-08-day-101.jpg_4.jpg,722,19,878,897,745,783,True,11
9,31,kaist_dataset/Korean/Digital_Camera/outdoor2/2007-12-08-day-122.jpg,char_data/9/2007-12-08-day-122.jpg_2.jpg,1612,52,888,940,325,356,True,11
9,30,kaist_dataset/Korean/Digital_Camera/outdoor2/2007-12-08-day-122.jpg,char_data/9/2007-12-08-day-122.jpg_2.jpg,1710,57,888,945,295,325,True,11
9,66,kaist_dataset/Korean/Digital_Camera/outdoor2/2007-12-09-day-exterior-033.jpg,char_data/9/2007-12-09-day-exterior-033.jpg_0.jpg,4686,71,754,825,726,792,True,11
9,71,kaist_dataset/Korean/Digital_Camera/outdoor2/2007-12-09-day-exterior-033.jpg,char_data/9/2007-12-09-day-exterior-033.jpg_0.jpg,5041,71,1055,1126,727,798,True,11
9,53,kaist_dataset/Korean/Digital_Camera/outdoor2/DSC02305.JPG,char_data/9/DSC02305.JPG_0.jpg,1855,35,484,519,252,305,True,11
9,25,kaist_dataset/Korean/Digital_Camera/outdoor2/DSC02326.JPG,char_data/9/DSC02326.JPG_0.jpg,350,14,429,443,341,366,True,11
9,39,kaist_dataset/Korean/Digital_Camera/outdoor2/DSC02393.JPG,char_data/9/DSC02393.JPG_0.jpg,975,25,543,568,303,342,True,11
9,48,kaist_dataset/Korean/Digital_Camera/outdoor2/DSC02366.JPG,char_data/9/DSC02366.JPG_0.jpg,1152,24,469,493,404,452,True,11
9,48,kaist_dataset/Korean/Digital_Camera/outdoor2/DSC02366.JPG,char_data/9/DSC02366.JPG_0.jpg,1296,27,495,522,404,452,True,11
9,43,kaist_dataset/Korean/Digital_Camera/outdoor2/DSC02381.JPG,char_data/9/DSC02381.JPG_0.jpg,1075,25,290,315,317,360,True,11
9,45,kaist_dataset/Korean/Digital_Camera/outdoor2/DSC02414.JPG,char_data/9/DSC02414.JPG_0.jpg,1800,40,443,483,242,287,True,11
9,29,kaist_dataset/Korean/Digital_Camera/outdoor2/DSC02435.JPG,char_data/9/DSC02435.JPG_0.jpg,464,16,545,561,246,275,True,11
9,82,kaist_dataset/Korean/Digital_Camera/outdoor2/DSC02451.JPG,char_data/9/DSC02451.JPG_0.jpg,4346,53,264,317,322,404,True,11
9,33,kaist_dataset/Korean/Digital_Camera/outdoor2/DSC02321.JPG,char_data/9/DSC02321.JPG_0.jpg,792,24,294,318,378,411,True,11
9,35,kaist_dataset/Korean/Digital_Camera/outdoor2/DSC02371.JPG,char_data/9/DSC02371.JPG_0.jpg,770,22,215,237,241,276,True,11
9,31,kaist_dataset/Korean/Digital_Camera/outdoor2/DSC02371.JPG,char_data/9/DSC02371.JPG_0.jpg,682,22,237,259,242,273,True,11
9,58,kaist_dataset/Korean/Digital_Camera/outdoor2/2007-12-09-day-exterior-035.jpg,char_data/9/2007-12-09-day-exterior-035.jpg_0.jpg,1740,30,710,740,708,766,True,11
9,71,kaist_dataset/Korean/Digital_Camera/outdoor2/2007-12-09-day-exterior-009.jpg,char_data/9/2007-12-09-day-exterior-009.jpg_0.jpg,2982,42,897,939,662,733,True,11
9,30,kaist_dataset/Korean/Digital_Camera/outdoor2/DSC02327.JPG,char_data/9/DSC02327.JPG_0.jpg,810,27,313,340,365,395,True,11
9,34,kaist_dataset/Korean/Digital_Camera/outdoor2/DSC02327.JPG,char_data/9/DSC02327.JPG_0.jpg,986,29,344,373,362,396,True,11
9,42,kaist_dataset/Korean/Digital_Camera/outdoor2/DSC02327.JPG,char_data/9/DSC02327.JPG_0.jpg,1092,26,376,402,358,400,True,11
9,54,kaist_dataset/Korean/Digital_Camera/outdoor2/DSC02515.JPG,char_data/9/DSC02515.JPG_0.jpg,2376,44,373,417,334,388,True,11
9,29,kaist_dataset/Korean/Digital_Camera/outdoor2/DSC02470.JPG,char_data/9/DSC02470.JPG_0.jpg,725,25,288,313,175,204,True,11
9,33,kaist_dataset/Korean/Digital_Camera/outdoor2/DSC02470.JPG,char_data/9/DSC02470.JPG_0.jpg,891,27,334,361,173,206,True,11
9,64,kaist_dataset/Korean/Digital_Camera/outdoor2/DSC02470.JPG,char_data/9/DSC02470.JPG_0.jpg,2496,39,457,496,373,437,True,11
9,36,kaist_dataset/Korean/Digital_Camera/outdoor2/DSC02521.JPG,char_data/9/DSC02521.JPG_0.jpg,864,24,434,458,325,361,True,11
9,46,kaist_dataset/Korean/Digital_Camera/E-night/DSC02645.JPG,char_data/9/DSC02645.JPG_0.jpg,1242,27,394,421,333,379,True,11
9,24,kaist_dataset/Korean/Digital_Camera/E-night/P1010146.JPG,char_data/9/P1010146.JPG_0.jpg,504,21,241,262,252,276,True,11
9,29,kaist_dataset/Korean/Digital_Camera/E-night/DSC02626.JPG,char_data/9/DSC02626.JPG_0.jpg,551,19,135,154,375,404,True,11
9,32,kaist_dataset/Korean/Digital_Camera/E-night/DSC02626.JPG,char_data/9/DSC02626.JPG_0.jpg,608,19,162,181,372,404,True,11
9,44,kaist_dataset/Korean/Digital_Camera/E-night/DSC03515.JPG,char_data/9/DSC03515.JPG_0.jpg,792,18,544,562,270,314,True,11
9,86,kaist_dataset/Korean/Digital_Camera/indoor1/DSC03364.JPG,char_data/9/DSC03364.JPG_0.jpg,5504,64,353,417,240,326,True,11
9,154,kaist_dataset/Korean/Digital_Camera/indoor1/DSC02700.JPG,char_data/9/DSC02700.JPG_0.jpg,15862,103,240,343,214,368,True,11
9,32,kaist_dataset/Korean/Digital_Camera/indoor1/DSC02700.JPG,char_data/9/DSC02700.JPG_0.jpg,544,17,128,145,420,452,True,11
9,30,kaist_dataset/Korean/Digital_Camera/indoor1/DSC02700.JPG,char_data/9/DSC02700.JPG_0.jpg,540,18,241,259,424,454,True,11
9,192,kaist_dataset/Korean/Digital_Camera/indoor1/DSC02699.JPG,char_data/9/DSC02699.JPG_0.jpg,23424,122,154,276,232,424,True,11
9,28,kaist_dataset/Korean/Digital_Camera/outdoor7/P1010054.JPG,char_data/9/P1010054.JPG_0.jpg,728,26,529,555,230,258,True,11
9,42,kaist_dataset/Korean/Digital_Camera/outdoor7/k.jpg,char_data/9/k.jpg_0.jpg,1344,32,155,187,147,189,True,11
9,37,kaist_dataset/Korean/Digital_Camera/outdoor7/P1010101.JPG,char_data/9/P1010101.JPG_0.jpg,888,24,367,391,230,267,True,11
9,29,kaist_dataset/Korean/Digital_Camera/outdoor7/P1010101.JPG,char_data/9/P1010101.JPG_0.jpg,551,19,445,464,234,263,True,11
9,45,kaist_dataset/Korean/Digital_Camera/outdoor7/P1010003.JPG,char_data/9/P1010003.JPG_0.jpg,1035,23,426,449,272,317,True,11
9,26,kaist_dataset/Korean/Digital_Camera/outdoor7/P1010005.JPG,char_data/9/P1010005.JPG_0.jpg,676,26,447,473,192,218,True,11
9,52,kaist_dataset/Korean/Digital_Camera/outdoor7/P1010085.JPG,char_data/9/P1010085.JPG_0.jpg,1664,32,383,415,267,319,True,11
9,33,kaist_dataset/Korean/Digital_Camera/outdoor7/P1010078.JPG,char_data/9/P1010078.JPG_0.jpg,858,26,214,240,251,284,True,11
9,34,kaist_dataset/Korean/Digital_Camera/outdoor7/P1010078.JPG,char_data/9/P1010078.JPG_0.jpg,850,25,338,363,255,289,True,11
9,76,kaist_dataset/Korean/Digital_Camera/outdoor7/P1010086.JPG,char_data/9/P1010086.JPG_0.jpg,5092,67,349,416,252,328,True,11
9,21,kaist_dataset/Korean/Digital_Camera/outdoor7/P1010124.JPG,char_data/9/P1010124.JPG_0.jpg,315,15,394,409,152,173,True,11
9,40,kaist_dataset/Korean/Digital_Camera/outdoor7/P1010009.JPG,char_data/9/P1010009.JPG_0.jpg,1280,32,487,519,267,307,True,11
9,53,kaist_dataset/Korean/Digital_Camera/outdoor7/P1010023.JPG,char_data/9/P1010023.JPG_0.jpg,1749,33,132,165,291,344,True,11
9,58,kaist_dataset/Korean/Digital_Camera/outdoor7/P1010023.JPG,char_data/9/P1010023.JPG_0.jpg,1798,31,196,227,288,346,True,11
9,55,kaist_dataset/Korean/Digital_Camera/outdoor7/P1010023.JPG,char_data/9/P1010023.JPG_0.jpg,1760,32,467,499,283,338,True,11
9,35,kaist_dataset/Korean/Digital_Camera/outdoor7/P1010035.JPG,char_data/9/P1010035.JPG_0.jpg,595,17,103,120,202,237,True,11
9,33,kaist_dataset/Korean/Digital_Camera/outdoor7/P1010057.JPG,char_data/9/P1010057.JPG_0.jpg,594,18,608,626,230,263,True,11
9,70,kaist_dataset/Korean/Digital_Camera/outdoor8/P1010160.JPG,char_data/9/P1010160.JPG_0.jpg,3640,52,245,297,226,296,True,11
9,41,kaist_dataset/Korean/Digital_Camera/outdoor8/P1011112.JPG,char_data/9/P1011112.JPG_0.jpg,984,24,319,343,207,248,True,11
9,79,kaist_dataset/Korean/Digital_Camera/indoor2/DSC04006.JPG,char_data/9/DSC04006.JPG_0.jpg,2370,30,338,368,144,223,True,11
9,33,kaist_dataset/Korean/Digital_Camera/indoor2/DSC03564.JPG,char_data/9/DSC03564.JPG_0.jpg,660,20,400,420,400,433,True,11
9,58,kaist_dataset/Korean/Digital_Camera/indoor2/DSC03474.JPG,char_data/9/DSC03474.JPG_0.jpg,2146,37,305,342,151,209,True,11
9,41,kaist_dataset/Korean/Digital_Camera/indoor2/DSC03530.JPG,char_data/9/DSC03530.JPG_0.jpg,779,19,271,290,218,259,True,11
9,35,kaist_dataset/Korean/Digital_Camera/indoor2/DSC03975.JPG,char_data/9/DSC03975.JPG_0.jpg,525,15,243,258,289,324,True,11
9,101,kaist_dataset/Korean/Digital_Camera/G-others/2007-12-09-day-exterior-062.jpg,char_data/9/2007-12-09-day-exterior-062.jpg_0.jpg,3232,32,665,697,1407,1508,True,11
9,104,kaist_dataset/Korean/Digital_Camera/G-others/2007-12-09-day-exterior-062.jpg,char_data/9/2007-12-09-day-exterior-062.jpg_0.jpg,4264,41,698,739,1406,1510,True,11
9,48,kaist_dataset/Korean/Digital_Camera/G-others/2007-12-08-day-045.jpg,char_data/9/2007-12-08-day-045.jpg_0.jpg,672,14,176,190,790,838,True,11
9,47,kaist_dataset/Korean/Digital_Camera/G-others/2007-12-08-day-045.jpg,char_data/9/2007-12-08-day-045.jpg_0.jpg,658,14,211,225,789,836,True,11
9,43,kaist_dataset/Korean/Digital_Camera/G-others/005.JPG,char_data/9/005.JPG_0.jpg,903,21,330,351,411,454,True,11
9,20,kaist_dataset/Korean/Digital_Camera/G-others/2007-12-08-day-112.jpg,char_data/9/2007-12-08-day-112.jpg_0.jpg,200,10,416,426,1178,1198,True,11
9,92,kaist_dataset/Korean/Digital_Camera/G-others/2007-12-08-day-108.jpg,char_data/9/2007-12-08-day-108.jpg_0.jpg,3956,43,651,694,695,787,True,11
9,38,kaist_dataset/Korean/Digital_Camera/outdoor6/DSC04081.JPG,char_data/9/DSC04081.JPG_0.jpg,1862,49,519,568,320,358,True,11
9,82,kaist_dataset/Korean/Digital_Camera/outdoor6/DSC04359.JPG,char_data/9/DSC04359.JPG_0.jpg,3854,47,376,423,107,189,True,11
9,132,kaist_dataset/Korean/Digital_Camera/outdoor6/DSC04445.JPG,char_data/9/DSC04445.JPG_0.jpg,13596,103,170,273,261,393,True,11
9,52,kaist_dataset/Korean/Digital_Camera/outdoor6/DSC04308.JPG,char_data/9/DSC04308.JPG_0.jpg,1508,29,384,413,387,439,True,11
9,51,kaist_dataset/Korean/Digital_Camera/outdoor6/DSC04308.JPG,char_data/9/DSC04308.JPG_0.jpg,1479,29,413,442,388,439,True,11
9,30,kaist_dataset/Korean/Digital_Camera/outdoor6/DSC04132.JPG,char_data/9/DSC04132.JPG_0.jpg,570,19,351,370,150,180,True,11
9,45,kaist_dataset/Korean/Digital_Camera/outdoor6/DSC04400.JPG,char_data/9/DSC04400.JPG_0.jpg,1035,23,353,376,396,441,True,11
9,35,kaist_dataset/Korean/Digital_Camera/outdoor6/DSC04041.JPG,char_data/9/DSC04041.JPG_0.jpg,455,13,533,546,136,171,True,11
9,42,kaist_dataset/Korean/Digital_Camera/outdoor6/DSC04099.JPG,char_data/9/DSC04099.JPG_0.jpg,966,23,507,530,411,453,True,11
9,28,kaist_dataset/Korean/Digital_Camera/outdoor6/DSC04341.JPG,char_data/9/DSC04341.JPG_0.jpg,672,24,598,622,223,251,True,11
9,50,kaist_dataset/Korean/Digital_Camera/outdoor6/DSC04089.JPG,char_data/9/DSC04089.JPG_0.jpg,1250,25,351,376,275,325,True,11
9,44,kaist_dataset/Korean/Digital_Camera/outdoor6/DSC04148.JPG,char_data/9/DSC04148.JPG_0.jpg,1012,23,448,471,303,347,True,11
9,46,kaist_dataset/Korean/Digital_Camera/outdoor6/DSC04148.JPG,char_data/9/DSC04148.JPG_0.jpg,1104,24,450,474,406,452,True,11
9,32,kaist_dataset/Korean/Digital_Camera/outdoor6/DSC04112.JPG,char_data/9/DSC04112.JPG_0.jpg,512,16,389,405,275,307,True,11
9,36,kaist_dataset/Korean/Digital_Camera/outdoor6/DSC04112.JPG,char_data/9/DSC04112.JPG_0.jpg,648,18,468,486,272,308,True,11
9,80,kaist_dataset/Korean/Digital_Camera/outdoor6/DSC04147.JPG,char_data/9/DSC04147.JPG_0.jpg,3200,40,387,427,176,256,True,11
9,31,kaist_dataset/Korean/Digital_Camera/outdoor6/DSC04046.JPG,char_data/9/DSC04046.JPG_0.jpg,372,12,363,375,260,291,True,11
9,54,kaist_dataset/Korean/Digital_Camera/outdoor6/DSC04332.JPG,char_data/9/DSC04332.JPG_0.jpg,2538,47,325,372,351,405,True,11
9,68,kaist_dataset/Korean/Digital_Camera/A-shadow/2007-12-09-day-exterior-026.jpg,char_data/9/2007-12-09-day-exterior-026.jpg_0.jpg,2584,38,1074,1112,759,827,True,11
9,68,kaist_dataset/Korean/Digital_Camera/A-shadow/2007-12-09-day-exterior-026.jpg,char_data/9/2007-12-09-day-exterior-026.jpg_0.jpg,2652,39,1109,1148,759,827,True,11
9,72,kaist_dataset/Korean/Digital_Camera/A-shadow/2007-12-09-day-exterior-026.jpg,char_data/9/2007-12-09-day-exterior-026.jpg_0.jpg,3528,49,1148,1197,759,831,True,11
9,46,kaist_dataset/Korean/Digital_Camera/A-shadow/DSC02598.JPG,char_data/9/DSC02598.JPG_0.jpg,782,17,612,629,416,462,True,11
9,37,kaist_dataset/Korean/Digital_Camera/A-shadow/DSC04297.JPG,char_data/9/DSC04297.JPG_0.jpg,555,15,360,375,206,243,True,11
9,36,kaist_dataset/Korean/Digital_Camera/A-shadow/DSC04297.JPG,char_data/9/DSC04297.JPG_0.jpg,504,14,478,492,207,243,True,11
9,74,kaist_dataset/Korean/Digital_Camera/A-shadow/DSC03535.JPG,char_data/9/DSC03535.JPG_0.jpg,3108,42,415,457,246,320,True,11
9,65,kaist_dataset/Korean/Digital_Camera/A-shadow/DSC03535.JPG,char_data/9/DSC03535.JPG_0.jpg,2470,38,489,527,247,312,True,11
9,121,kaist_dataset/Korean/Digital_Camera/A-shadow/DSC04300.JPG,char_data/9/DSC04300.JPG_0.jpg,6292,52,300,352,236,357,True,11
9,53,kaist_dataset/Korean/Digital_Camera/outdoor3/DSC02546.JPG,char_data/9/DSC02546.JPG_0.jpg,1908,36,374,410,118,171,True,11
9,41,kaist_dataset/Korean/Digital_Camera/outdoor3/DSC02686.JPG,char_data/9/DSC02686.JPG_0.jpg,1066,26,520,546,225,266,True,11
9,45,kaist_dataset/Korean/Digital_Camera/outdoor3/DSC02686.JPG,char_data/9/DSC02686.JPG_0.jpg,1125,25,547,572,225,270,True,11
9,37,kaist_dataset/Korean/Digital_Camera/outdoor3/DSC02899.JPG,char_data/9/DSC02899.JPG_0.jpg,1295,35,552,587,225,262,True,11
9,50,kaist_dataset/Korean/Digital_Camera/outdoor3/DSC02698.JPG,char_data/9/DSC02698.JPG_0.jpg,1200,24,188,212,394,444,True,11
9,44,kaist_dataset/Korean/Digital_Camera/outdoor3/DSC02698.JPG,char_data/9/DSC02698.JPG_0.jpg,924,21,315,336,395,439,True,11
9,33,kaist_dataset/Korean/Digital_Camera/outdoor3/DSC02975.JPG,char_data/9/DSC02975.JPG_0.jpg,891,27,386,413,246,279,True,11
9,36,kaist_dataset/Korean/Digital_Camera/outdoor3/DSC02975.JPG,char_data/9/DSC02975.JPG_0.jpg,936,26,413,439,242,278,True,11
9,46,kaist_dataset/Korean/Digital_Camera/outdoor3/DSC02598.JPG,char_data/9/DSC02598.JPG_0.jpg,782,17,612,629,416,462,True,11
9,22,kaist_dataset/Korean/Digital_Camera/outdoor3/DSC02529.JPG,char_data/9/DSC02529.JPG_0.jpg,220,10,513,523,374,396,True,11
9,29,kaist_dataset/Korean/Digital_Camera/outdoor3/DSC02529.JPG,char_data/9/DSC02529.JPG_0.jpg,290,10,570,580,371,400,True,11
9,30,kaist_dataset/Korean/Digital_Camera/outdoor3/DSC03219.JPG,char_data/9/DSC03219.JPG_0.jpg,660,22,369,391,414,444,True,11
9,39,kaist_dataset/Korean/Digital_Camera/outdoor3/DSC02888.JPG,char_data/9/DSC02888.JPG_0.jpg,1131,29,184,213,421,460,True,11
9,35,kaist_dataset/Korean/Digital_Camera/outdoor3/DSC03232.JPG,char_data/9/DSC03232.JPG_0.jpg,805,23,247,270,288,323,True,11
9,40,kaist_dataset/Korean/Digital_Camera/outdoor3/DSC02561.JPG,char_data/9/DSC02561.JPG_0.jpg,1080,27,320,347,353,393,True,11
9,26,kaist_dataset/Korean/Digital_Camera/outdoor1/071.JPG,char_data/9/071.JPG_0.jpg,546,21,334,355,259,285,True,11
9,25,kaist_dataset/Korean/Digital_Camera/outdoor1/017.JPG,char_data/9/017.JPG_0.jpg,475,19,485,504,268,293,True,11
9,33,kaist_dataset/Korean/Digital_Camera/outdoor1/102.JPG,char_data/9/102.JPG_0.jpg,594,18,428,446,307,340,True,11
9,34,kaist_dataset/Korean/Digital_Camera/outdoor1/069.JPG,char_data/9/069.JPG_0.jpg,476,14,352,366,266,300,True,11
9,29,kaist_dataset/Korean/Digital_Camera/outdoor1/126.JPG,char_data/9/126.JPG_0.jpg,435,15,539,554,256,285,True,11
9,27,kaist_dataset/Korean/Digital_Camera/outdoor1/040.JPG,char_data/9/040.JPG_0.jpg,891,33,386,419,301,328,True,11
9,51,kaist_dataset/Korean/Digital_Camera/outdoor1/098.JPG,char_data/9/098.JPG_0.jpg,1683,33,237,270,347,398,True,11
9,55,kaist_dataset/Korean/Digital_Camera/outdoor1/098.JPG,char_data/9/098.JPG_0.jpg,1925,35,269,304,345,400,True,11
9,23,kaist_dataset/Korean/Digital_Camera/outdoor1/011.JPG,char_data/9/011.JPG_0.jpg,529,23,426,449,258,281,True,11
9,22,kaist_dataset/Korean/Digital_Camera/outdoor1/011.JPG,char_data/9/011.JPG_0.jpg,484,22,467,489,258,280,True,11
9,40,kaist_dataset/Korean/Digital_Camera/outdoor1/54.JPG,char_data/9/54.JPG_0.jpg,1000,25,549,574,366,406,True,11
9,41,kaist_dataset/Korean/Digital_Camera/outdoor1/123.JPG,char_data/9/123.JPG_0.jpg,861,21,288,309,273,314,True,11
9,36,kaist_dataset/Korean/Digital_Camera/outdoor1/123.JPG,char_data/9/123.JPG_0.jpg,756,21,267,288,275,311,True,11
9,29,kaist_dataset/Korean/Digital_Camera/outdoor1/035.JPG,char_data/9/035.JPG_0.jpg,551,19,339,358,288,317,True,11
9,45,kaist_dataset/Korean/Digital_Camera/outdoor1/2007-12-08-day-047.jpg,char_data/9/2007-12-08-day-047.jpg_0.jpg,1395,31,979,1010,714,759,True,11
9,46,kaist_dataset/Korean/Digital_Camera/outdoor1/2007-12-08-day-047.jpg,char_data/9/2007-12-08-day-047.jpg_0.jpg,1472,32,1039,1071,719,765,True,11
9,31,kaist_dataset/Mixed/Mobile_Phone/(C.M)A-outdoor/P090908006.jpg,char_data/9/P090908006.jpg_0.jpg,589,19,451,470,363,394,True,11
9,37,kaist_dataset/Mixed/Mobile_Phone/(C.M)A-outdoor/P090912038.jpg,char_data/9/P090912038.jpg_0.jpg,777,21,372,393,158,195,True,11
9,36,kaist_dataset/Mixed/Mobile_Phone/(C.M)A-outdoor/P090912047.jpg,char_data/9/P090912047.jpg_0.jpg,756,21,332,353,276,312,True,11
9,123,kaist_dataset/Mixed/Mobile_Phone/(C.M)A-outdoor/P090911087.jpg,char_data/9/P090911087.jpg_0.jpg,10701,87,61,148,41,164,True,11
9,110,kaist_dataset/Mixed/Mobile_Phone/(C.M)A-outdoor/P090911087.jpg,char_data/9/P090911087.jpg_0.jpg,8030,73,149,222,43,153,True,11
9,67,kaist_dataset/Mixed/Mobile_Phone/(C.M)B-indoor/P090831007.jpg,char_data/9/P090831007.jpg_0.jpg,2948,44,436,480,275,342,True,11
9,43,kaist_dataset/Mixed/Mobile_Phone/(C.M)C-bookCover/P090902016.jpg,char_data/9/P090902016.jpg_0.jpg,946,22,113,135,201,244,True,11
9,45,kaist_dataset/Mixed/Digital_Camera/(C.S)C-outdoor1/081.JPG,char_data/9/081.JPG_0.jpg,1890,42,296,338,250,295,True,11
9,38,kaist_dataset/Mixed/Digital_Camera/(C.S)C-outdoor1/081.JPG,char_data/9/081.JPG_0.jpg,1748,46,413,459,255,293,True,11
9,35,kaist_dataset/Mixed/Digital_Camera/(C.S)C-outdoor1/2007-12-09-day-exterior-078.jpg,char_data/9/2007-12-09-day-exterior-078.jpg_0.jpg,1155,33,169,202,1009,1044,True,11
9,33,kaist_dataset/Mixed/Digital_Camera/(C.S)C-outdoor1/118.JPG,char_data/9/118.JPG_0.jpg,825,25,483,508,360,393,True,11
9,31,kaist_dataset/Mixed/Digital_Camera/(C.S)C-outdoor1/121.JPG,char_data/9/121.JPG_0.jpg,558,18,352,370,274,305,True,11
9,33,kaist_dataset/Mixed/Digital_Camera/(C.S)C-outdoor1/121.JPG,char_data/9/121.JPG_0.jpg,594,18,368,386,274,307,True,11
9,28,kaist_dataset/Mixed/Digital_Camera/(C.S)C-outdoor1/121.JPG,char_data/9/121.JPG_0.jpg,448,16,521,537,274,302,True,11
9,33,kaist_dataset/Mixed/Digital_Camera/(C.S)C-outdoor1/009.JPG,char_data/9/009.JPG_0.jpg,726,22,365,387,320,353,True,11
9,40,kaist_dataset/Mixed/Digital_Camera/(C.S)C-outdoor1/P1010011.JPG,char_data/9/P1010011.JPG_0.jpg,960,24,572,596,312,352,True,11
9,26,kaist_dataset/Mixed/Digital_Camera/(C.S)C-outdoor1/008.JPG,char_data/9/008.JPG_0.jpg,390,15,520,535,268,294,True,11
9,40,kaist_dataset/Mixed/Digital_Camera/(C.S)C-outdoor1/P1010009.JPG,char_data/9/P1010009.JPG_0.jpg,1000,25,204,229,240,280,True,11
9,30,kaist_dataset/Mixed/Digital_Camera/(C.S)C-outdoor1/57.JPG,char_data/9/57.JPG_0.jpg,480,16,512,528,294,324,True,11
9,28,kaist_dataset/Mixed/Digital_Camera/(C.S)C-outdoor1/57.JPG,char_data/9/57.JPG_0.jpg,476,17,558,575,296,324,True,11
9,26,kaist_dataset/Mixed/Digital_Camera/(C.S)C-outdoor1/57.JPG,char_data/9/57.JPG_0.jpg,416,16,346,362,454,480,True,11
9,26,kaist_dataset/Mixed/Digital_Camera/(C.S)C-outdoor1/57.JPG,char_data/9/57.JPG_0.jpg,364,14,392,406,455,481,True,11
9,22,kaist_dataset/Mixed/Digital_Camera/(C.S)C-outdoor1/054.JPG,char_data/9/054.JPG_0.jpg,418,19,514,533,305,327,True,11
9,46,kaist_dataset/Mixed/Digital_Camera/(C.S)C-outdoor1/2007-12-09-day-exterior-037.jpg,char_data/9/2007-12-09-day-exterior-037.jpg_0.jpg,1564,34,809,843,704,750,True,11
9,43,kaist_dataset/Mixed/Digital_Camera/(C.S)C-outdoor1/2007-12-08-day-130.jpg,char_data/9/2007-12-08-day-130.jpg_0.jpg,1075,25,1046,1071,759,802,True,11
9,29,kaist_dataset/Mixed/Digital_Camera/(C.S)C-outdoor1/063.JPG,char_data/9/063.JPG_0.jpg,348,12,419,431,256,285,True,11
9,24,kaist_dataset/Mixed/Digital_Camera/(C.S)C-outdoor1/063.JPG,char_data/9/063.JPG_0.jpg,336,14,432,446,257,281,True,11
9,41,kaist_dataset/Mixed/Digital_Camera/(C.S)C-outdoor1/DSC02322.JPG,char_data/9/DSC02322.JPG_0.jpg,1148,28,296,324,364,405,True,11
9,19,kaist_dataset/Mixed/Digital_Camera/(C.S)C-outdoor1/014.JPG,char_data/9/014.JPG_0.jpg,285,15,260,275,279,298,True,11
9,40,kaist_dataset/Mixed/Digital_Camera/(C.S)C-outdoor1/DSC02325.JPG,char_data/9/DSC02325.JPG_0.jpg,880,22,347,369,312,352,True,11
9,38,kaist_dataset/Mixed/Digital_Camera/(C.S)C-outdoor1/090.JPG,char_data/9/090.JPG_0.jpg,836,22,449,471,389,427,True,11
9,53,kaist_dataset/Mixed/Digital_Camera/(C.S)F-others/2007-12-08-day-113.jpg,char_data/9/2007-12-08-day-113.jpg_0.jpg,954,18,965,983,432,485,True,11
9,35,kaist_dataset/Mixed/Digital_Camera/(C.S)F-others/2007-12-08-day-044.jpg,char_data/9/2007-12-08-day-044.jpg_0.jpg,420,12,1079,1091,830,865,True,11
9,42,kaist_dataset/Mixed/Digital_Camera/(C.S)D-indoor2/DSC04256.JPG,char_data/9/DSC04256.JPG_0.jpg,924,22,566,588,147,189,True,11
9,24,kaist_dataset/Mixed/Digital_Camera/(C.S)E-night/P1010155.JPG,char_data/9/P1010155.JPG_0.jpg,336,14,517,531,287,311,True,11
9,77,kaist_dataset/Mixed/Digital_Camera/(C.S)E-night/P1010152.JPG,char_data/9/P1010152.JPG_0.jpg,4312,56,378,434,218,295,True,11
9,27,kaist_dataset/Mixed/Digital_Camera/(C.S)E-night/P1010156.JPG,char_data/9/P1010156.JPG_0.jpg,540,20,342,362,246,273,True,11
9,29,kaist_dataset/Mixed/Digital_Camera/(C.S)E-night/P1010156.JPG,char_data/9/P1010156.JPG_0.jpg,551,19,428,447,240,269,True,11
9,65,kaist_dataset/Mixed/Digital_Camera/(C.S)E-night/DSC02574.JPG,char_data/9/DSC02574.JPG_0.jpg,2145,33,407,440,408,473,True,11
9,73,kaist_dataset/Mixed/Digital_Camera/(C.S)E-night/DSC02574.JPG,char_data/9/DSC02574.JPG_0.jpg,2263,31,476,507,408,481,True,11
9,32,kaist_dataset/Mixed/Digital_Camera/(C.S)E-night/DSC02586.JPG,char_data/9/DSC02586.JPG_0.jpg,448,14,381,395,393,425,True,11
9,27,kaist_dataset/Mixed/Digital_Camera/(C.S)E-night/P1010151.JPG,char_data/9/P1010151.JPG_0.jpg,324,12,543,555,202,229,True,11
9,17,kaist_dataset/Mixed/Digital_Camera/(C.S)E-night/P1010151.JPG,char_data/9/P1010151.JPG_0.jpg,187,11,555,566,209,226,True,11
9,27,kaist_dataset/Mixed/Digital_Camera/(C.S)E-night/P1010151.JPG,char_data/9/P1010151.JPG_0.jpg,459,17,565,582,201,228,True,11
9,48,kaist_dataset/Mixed/Digital_Camera/(C.S)E-night/DSC02575.JPG,char_data/9/DSC02575.JPG_0.jpg,1392,29,442,471,360,408,True,11
9,34,kaist_dataset/Mixed/Digital_Camera/(C.S)E-night/DSC02673.JPG,char_data/9/DSC02673.JPG_0.jpg,408,12,526,538,302,336,True,11
9,60,kaist_dataset/Mixed/Digital_Camera/(C.S)E-night/DSC02595.JPG,char_data/9/DSC02595.JPG_0.jpg,2520,42,408,450,345,405,True,11
9,72,kaist_dataset/Mixed/Digital_Camera/(C.S)E-night/DSC02600.JPG,char_data/9/DSC02600.JPG_0.jpg,5328,74,225,299,394,466,True,11
9,57,kaist_dataset/Mixed/Digital_Camera/(C.S)E-night/P1010147.JPG,char_data/9/P1010147.JPG_0.jpg,2679,47,343,390,254,311,True,11
9,50,kaist_dataset/Mixed/Digital_Camera/(C.S)E-night/P1010147.JPG,char_data/9/P1010147.JPG_0.jpg,2050,41,425,466,260,310,True,11
9,58,kaist_dataset/Mixed/Digital_Camera/(C.S)E-night/P1010147.JPG,char_data/9/P1010147.JPG_0.jpg,2552,44,466,510,258,316,True,11
9,34,kaist_dataset/Mixed/Digital_Camera/(C.S)B-light/DSC03298.JPG,char_data/9/DSC03298.JPG_0.jpg,374,11,441,452,290,324,True,11
9,29,kaist_dataset/Mixed/Digital_Camera/(C.S)D-indoor1/DSC04005.JPG,char_data/9/DSC04005.JPG_0.jpg,493,17,504,521,437,466,True,11
9,28,kaist_dataset/Mixed/Digital_Camera/(C.S)D-indoor1/DSC04005.JPG,char_data/9/DSC04005.JPG_0.jpg,588,21,520,541,436,464,True,11
9,54,kaist_dataset/Mixed/Digital_Camera/(C.S)D-indoor1/DSC03986.JPG,char_data/9/DSC03986.JPG_0.jpg,864,16,145,161,158,212,True,11
9,50,kaist_dataset/Mixed/Digital_Camera/(C.S)D-indoor1/DSC03986.JPG,char_data/9/DSC03986.JPG_0.jpg,900,18,360,378,158,208,True,11
9,51,kaist_dataset/Mixed/Digital_Camera/(C.S)D-indoor1/DSC03980.JPG,char_data/9/DSC03980.JPG_0.jpg,1938,38,426,464,312,363,True,11
9,44,kaist_dataset/Mixed/Digital_Camera/(C.S)D-indoor1/DSC03980.JPG,char_data/9/DSC03980.JPG_0.jpg,1804,41,503,544,316,360,True,11
9,63,kaist_dataset/Mixed/Digital_Camera/(C.S)C-outdoor5/DSC03847.JPG,char_data/9/DSC03847.JPG_0.jpg,1512,24,571,595,10,73,True,11
9,85,kaist_dataset/Mixed/Digital_Camera/(C.S)C-outdoor5/DSC04063.JPG,char_data/9/DSC04063.JPG_0.jpg,1785,21,82,103,268,353,True,11
9,51,kaist_dataset/Mixed/Digital_Camera/(C.S)C-outdoor5/DSC04094.JPG,char_data/9/DSC04094.JPG_0.jpg,2142,42,407,449,387,438,True,11
9,52,kaist_dataset/Mixed/Digital_Camera/(C.S)C-outdoor5/DSC04094.JPG,char_data/9/DSC04094.JPG_0.jpg,2704,52,445,497,387,439,True,11
9,26,kaist_dataset/Mixed/Digital_Camera/(C.S)C-outdoor5/DSC04086.JPG,char_data/9/DSC04086.JPG_0.jpg,390,15,391,406,371,397,True,11
9,35,kaist_dataset/Mixed/Digital_Camera/(C.S)C-outdoor5/DSC03839.JPG,char_data/9/DSC03839.JPG_0.jpg,560,16,335,351,365,400,True,11
9,44,kaist_dataset/Mixed/Digital_Camera/(C.S)C-outdoor5/DSC04337.JPG,char_data/9/DSC04337.JPG_0.jpg,968,22,423,445,319,363,True,11
9,76,kaist_dataset/Mixed/Digital_Camera/(C.S)C-outdoor5/DSC04016.JPG,char_data/9/DSC04016.JPG_0.jpg,3572,47,260,307,105,181,True,11
9,74,kaist_dataset/Mixed/Digital_Camera/(C.S)C-outdoor5/DSC04016.JPG,char_data/9/DSC04016.JPG_0.jpg,3700,50,474,524,325,399,True,11
9,38,kaist_dataset/Mixed/Digital_Camera/(C.S)C-outdoor5/DSC04122.JPG,char_data/9/DSC04122.JPG_0.jpg,494,13,413,426,410,448,True,11
9,30,kaist_dataset/Mixed/Digital_Camera/(C.S)C-outdoor5/DSC04124.JPG,char_data/9/DSC04124.JPG_0.jpg,360,12,436,448,308,338,True,11
9,33,kaist_dataset/Mixed/Digital_Camera/(C.S)C-outdoor5/DSC04124.JPG,char_data/9/DSC04124.JPG_0.jpg,561,17,462,479,307,340,True,11
9,58,kaist_dataset/Mixed/Digital_Camera/(C.S)C-outdoor5/DSC04401.JPG,char_data/9/DSC04401.JPG_0.jpg,2320,40,497,537,248,306,True,11
9,42,kaist_dataset/Mixed/Digital_Camera/(C.S)C-outdoor5/DSC03821.JPG,char_data/9/DSC03821.JPG_0.jpg,1008,24,328,352,79,121,True,11
9,43,kaist_dataset/Mixed/Digital_Camera/(C.S)C-outdoor5/DSC04125.JPG,char_data/9/DSC04125.JPG_0.jpg,903,21,185,206,179,222,True,11
9,40,kaist_dataset/Mixed/Digital_Camera/(C.S)C-outdoor5/DSC04125.JPG,char_data/9/DSC04125.JPG_0.jpg,1160,29,204,233,180,220,True,11
9,43,kaist_dataset/Mixed/Digital_Camera/(C.S)C-outdoor5/DSC04125.JPG,char_data/9/DSC04125.JPG_0.jpg,1075,25,508,533,413,456,True,11
9,32,kaist_dataset/Mixed/Digital_Camera/(C.S)C-outdoor5/DSC04056.JPG,char_data/9/DSC04056.JPG_0.jpg,736,23,497,520,261,293,True,11
9,28,kaist_dataset/Mixed/Digital_Camera/(C.S)C-outdoor5/DSC04056.JPG,char_data/9/DSC04056.JPG_0.jpg,560,20,526,546,301,329,True,11
9,41,kaist_dataset/Mixed/Digital_Camera/(C.S)C-outdoor5/DSC04115.JPG,char_data/9/DSC04115.JPG_0.jpg,1189,29,397,426,352,393,True,11
9,35,kaist_dataset/Mixed/Digital_Camera/(C.S)C-outdoor3/DSC03316.JPG,char_data/9/DSC03316.JPG_0.jpg,595,17,264,281,86,121,True,11
9,34,kaist_dataset/Mixed/Digital_Camera/(C.S)C-outdoor3/DSC03316.JPG,char_data/9/DSC03316.JPG_0.jpg,578,17,420,437,84,118,True,11
9,59,kaist_dataset/Mixed/Digital_Camera/(C.S)C-outdoor3/DSC03177.JPG,char_data/9/DSC03177.JPG_0.jpg,1947,33,256,289,200,259,True,11
9,60,kaist_dataset/Mixed/Digital_Camera/(C.S)C-outdoor3/DSC03177.JPG,char_data/9/DSC03177.JPG_0.jpg,1860,31,291,322,201,261,True,11
9,41,kaist_dataset/Mixed/Digital_Camera/(C.S)C-outdoor3/DSC03312.JPG,char_data/9/DSC03312.JPG_0.jpg,1271,31,352,383,279,320,True,11
9,38,kaist_dataset/Mixed/Digital_Camera/(C.S)C-outdoor3/DSC03312.JPG,char_data/9/DSC03312.JPG_0.jpg,1330,35,390,425,282,320,True,11
9,39,kaist_dataset/Mixed/Digital_Camera/(C.S)C-outdoor3/DSC02970.JPG,char_data/9/DSC02970.JPG_0.jpg,1287,33,405,438,361,400,True,11
9,35,kaist_dataset/Mixed/Digital_Camera/(C.S)C-outdoor3/DSC03301.JPG,char_data/9/DSC03301.JPG_0.jpg,630,18,461,479,140,175,True,11
9,64,kaist_dataset/Mixed/Digital_Camera/(C.S)C-outdoor3/DSC03332.JPG,char_data/9/DSC03332.JPG_0.jpg,2304,36,210,246,334,398,True,11
9,46,kaist_dataset/Mixed/Digital_Camera/(C.S)C-outdoor3/DSC02989.JPG,char_data/9/DSC02989.JPG_0.jpg,1012,22,598,620,350,396,True,11
9,21,kaist_dataset/Mixed/Digital_Camera/(C.S)C-outdoor6/P1010063.JPG,char_data/9/P1010063.JPG_0.jpg,294,14,207,221,445,466,True,11
9,32,kaist_dataset/Mixed/Digital_Camera/(C.S)C-outdoor6/P1010075.JPG,char_data/9/P1010075.JPG_0.jpg,512,16,517,533,307,339,True,11
9,31,kaist_dataset/Mixed/Digital_Camera/(C.S)C-outdoor6/DSC03324.JPG,char_data/9/DSC03324.JPG_0.jpg,465,15,463,478,153,184,True,11
9,26,kaist_dataset/Mixed/Digital_Camera/(C.S)C-outdoor6/P1010094.JPG,char_data/9/P1010094.JPG_0.jpg,520,20,539,559,218,244,True,11
9,31,kaist_dataset/Mixed/Digital_Camera/(C.S)C-outdoor6/P1010020.JPG,char_data/9/P1010020.JPG_0.jpg,589,19,245,264,337,368,True,11
9,37,kaist_dataset/Mixed/Digital_Camera/(C.S)C-outdoor6/P1010080.JPG,char_data/9/P1010080.JPG_0.jpg,1110,30,435,465,248,285,True,11
9,64,kaist_dataset/Mixed/Digital_Camera/(C.S)C-outdoor6/P1010017.JPG,char_data/9/P1010017.JPG_0.jpg,1728,27,362,389,179,243,True,11
9,62,kaist_dataset/Mixed/Digital_Camera/(C.S)C-outdoor6/080116-0057.jpg,char_data/9/080116-0057.jpg_0.jpg,2356,38,617,655,820,882,True,11
9,23,kaist_dataset/Mixed/Digital_Camera/(C.S)C-outdoor6/P1010129.JPG,char_data/9/P1010129.JPG_0.jpg,483,21,500,521,236,259,True,11
9,35,kaist_dataset/Mixed/Digital_Camera/(C.S)C-outdoor6/P1010103.JPG,char_data/9/P1010103.JPG_0.jpg,735,21,516,537,199,234,True,11
9,34,kaist_dataset/Mixed/Digital_Camera/(C.S)C-outdoor6/P1010103.JPG,char_data/9/P1010103.JPG_0.jpg,510,15,553,568,199,233,True,11
9,31,kaist_dataset/Mixed/Digital_Camera/(C.S)C-outdoor6/P1010065.JPG,char_data/9/P1010065.JPG_0.jpg,558,18,453,471,234,265,True,11
9,56,kaist_dataset/Mixed/Digital_Camera/(C.S)C-outdoor6/P1010087.JPG,char_data/9/P1010087.JPG_0.jpg,2520,45,392,437,178,234,True,11
9,53,kaist_dataset/Mixed/Digital_Camera/(C.S)C-outdoor6/P1010087.JPG,char_data/9/P1010087.JPG_0.jpg,2120,40,515,555,176,229,True,11
9,40,kaist_dataset/Mixed/Digital_Camera/(C.S)C-outdoor6/P1010074.JPG,char_data/9/P1010074.JPG_0.jpg,1720,43,384,427,303,343,True,11
9,37,kaist_dataset/Mixed/Digital_Camera/(C.S)C-outdoor4/DSC03719.JPG,char_data/9/DSC03719.JPG_0.jpg,703,19,559,578,180,217,True,11
9,50,kaist_dataset/Mixed/Digital_Camera/(C.S)C-outdoor4/DSC03613.JPG,char_data/9/DSC03613.JPG_0.jpg,1050,21,554,575,28,78,True,11
9,66,kaist_dataset/Mixed/Digital_Camera/(C.S)C-outdoor4/DSC03702.JPG,char_data/9/DSC03702.JPG_0.jpg,2838,43,268,311,338,404,True,11
9,26,kaist_dataset/Mixed/Digital_Camera/(C.S)C-outdoor4/DSC03674.JPG,char_data/9/DSC03674.JPG_0.jpg,312,12,551,563,423,449,True,11
9,22,kaist_dataset/Mixed/Digital_Camera/(C.S)C-outdoor4/DSC03674.JPG,char_data/9/DSC03674.JPG_0.jpg,264,12,576,588,424,446,True,11
9,49,kaist_dataset/Mixed/Digital_Camera/(C.S)C-outdoor4/DSC03693.JPG,char_data/9/DSC03693.JPG_0.jpg,1029,21,529,550,349,398,True,11
9,28,kaist_dataset/Mixed/Digital_Camera/(C.S)C-outdoor4/DSC03769.JPG,char_data/9/DSC03769.JPG_0.jpg,392,14,216,230,419,447,False,11
9,93,kaist_dataset/Mixed/Digital_Camera/(C.S)C-outdoor4/DSC03544.JPG,char_data/9/DSC03544.JPG_0.jpg,3720,40,298,338,166,259,False,11
9,48,kaist_dataset/Mixed/Digital_Camera/(C.S)C-outdoor4/DSC03548.JPG,char_data/9/DSC03548.JPG_0.jpg,2160,45,285,330,394,442,False,11
9,34,kaist_dataset/Mixed/Digital_Camera/(C.S)C-outdoor4/DSC03661.JPG,char_data/9/DSC03661.JPG_0.jpg,646,19,522,541,328,362,False,11
9,26,kaist_dataset/Mixed/Digital_Camera/(C.S)C-outdoor4/DSC03718.JPG,char_data/9/DSC03718.JPG_0.jpg,442,17,550,567,406,432,False,11
9,38,kaist_dataset/Mixed/Digital_Camera/(C.S)C-outdoor4/DSC03745.JPG,char_data/9/DSC03745.JPG_0.jpg,608,16,561,577,268,306,False,11
9,31,kaist_dataset/Mixed/Digital_Camera/(C.S)C-outdoor4/DSC03745.JPG,char_data/9/DSC03745.JPG_0.jpg,589,19,593,612,274,305,False,11
9,28,kaist_dataset/Mixed/Digital_Camera/(C.S)C-outdoor4/DSC03737.JPG,char_data/9/DSC03737.JPG_0.jpg,532,19,249,268,164,192,False,11
9,31,kaist_dataset/Mixed/Digital_Camera/(C.S)C-outdoor4/DSC03737.JPG,char_data/9/DSC03737.JPG_0.jpg,403,13,423,436,168,199,False,11
9,48,kaist_dataset/Mixed/Digital_Camera/(C.S)C-outdoor4/DSC03655.JPG,char_data/9/DSC03655.JPG_0.jpg,1488,31,590,621,389,437,False,11
9,44,kaist_dataset/Mixed/Digital_Camera/(C.S)C-outdoor4/DSC03569.JPG,char_data/9/DSC03569.JPG_0.jpg,1452,33,427,460,168,212,False,11
9,53,kaist_dataset/Mixed/Digital_Camera/(C.S)C-outdoor4/DSC03569.JPG,char_data/9/DSC03569.JPG_0.jpg,1802,34,479,513,162,215,False,11
9,37,kaist_dataset/Mixed/Digital_Camera/(C.S)C-outdoor4/DSC03734.JPG,char_data/9/DSC03734.JPG_0.jpg,444,12,526,538,344,381,False,11
9,39,kaist_dataset/Mixed/Digital_Camera/(C.S)C-outdoor4/DSC03673.JPG,char_data/9/DSC03673.JPG_0.jpg,780,20,286,306,306,345,False,11
9,35,kaist_dataset/Mixed/Digital_Camera/(C.S)C-outdoor4/DSC03673.JPG,char_data/9/DSC03673.JPG_0.jpg,735,21,306,327,304,339,False,11
9,28,kaist_dataset/Mixed/Digital_Camera/(C.S)C-outdoor4/DSC03676.JPG,char_data/9/DSC03676.JPG_0.jpg,364,13,141,154,274,302,False,11
9,29,kaist_dataset/Mixed/Digital_Camera/(C.S)C-outdoor4/DSC03689.JPG,char_data/9/DSC03689.JPG_0.jpg,348,12,581,593,133,162,False,11
9,34,kaist_dataset/Mixed/Digital_Camera/(C.S)C-outdoor4/DSC03741.JPG,char_data/9/DSC03741.JPG_0.jpg,1088,32,509,541,370,404,False,11
9,26,kaist_dataset/Mixed/Digital_Camera/(C.S)C-outdoor4/DSC03757.JPG,char_data/9/DSC03757.JPG_0.jpg,338,13,340,353,340,366,False,11
9,35,kaist_dataset/Mixed/Digital_Camera/(C.S)C-outdoor4/DSC03757.JPG,char_data/9/DSC03757.JPG_0.jpg,420,12,514,526,339,374,False,11
9,48,kaist_dataset/Mixed/Digital_Camera/(C.S)C-outdoor4/DSC03621.JPG,char_data/9/DSC03621.JPG_0.jpg,1152,24,490,514,333,381,False,11
9,50,kaist_dataset/Mixed/Digital_Camera/(C.S)C-outdoor4/DSC03621.JPG,char_data/9/DSC03621.JPG_0.jpg,1450,29,539,568,335,385,False,11
9,34,kaist_dataset/Mixed/Digital_Camera/(C.S)C-outdoor4/DSC03722.JPG,char_data/9/DSC03722.JPG_0.jpg,986,29,405,434,204,238,False,11
9,36,kaist_dataset/Mixed/Digital_Camera/(C.S)C-outdoor2/DSC02912.JPG,char_data/9/DSC02912.JPG_0.jpg,1296,36,341,377,441,477,False,11
9,31,kaist_dataset/Mixed/Digital_Camera/(C.S)C-outdoor2/DSC02447.JPG,char_data/9/DSC02447.JPG_0.jpg,527,17,570,587,228,259,False,11
9,39,kaist_dataset/Mixed/Digital_Camera/(C.S)C-outdoor2/DSC02954.JPG,char_data/9/DSC02954.JPG_0.jpg,1053,27,143,170,257,296,False,11
9,40,kaist_dataset/Mixed/Digital_Camera/(C.S)C-outdoor2/DSC02954.JPG,char_data/9/DSC02954.JPG_0.jpg,920,23,444,467,263,303,False,11
9,30,kaist_dataset/Mixed/Digital_Camera/(C.S)C-outdoor2/DSC02555.JPG,char_data/9/DSC02555.JPG_0.jpg,660,22,176,198,248,278,False,11
9,30,kaist_dataset/Mixed/Digital_Camera/(C.S)C-outdoor2/DSC02397.JPG,char_data/9/DSC02397.JPG_0.jpg,660,22,512,534,206,236,False,11
9,24,kaist_dataset/Mixed/Digital_Camera/(C.S)C-outdoor2/DSC02477.JPG,char_data/9/DSC02477.JPG_0.jpg,480,20,154,174,253,277,False,11
9,33,kaist_dataset/Mixed/Digital_Camera/(C.S)C-outdoor2/DSC02361.JPG,char_data/9/DSC02361.JPG_0.jpg,462,14,560,574,379,412,False,11
9,33,kaist_dataset/Mixed/Digital_Camera/(C.S)C-outdoor2/DSC02361.JPG,char_data/9/DSC02361.JPG_0.jpg,528,16,592,608,377,410,False,11
9,53,kaist_dataset/Mixed/Digital_Camera/(C.S)C-outdoor2/DSC02400.JPG,char_data/9/DSC02400.JPG_0.jpg,1696,32,375,407,397,450,False,11
9,65,kaist_dataset/Mixed/Digital_Camera/(C.S)C-outdoor2/DSC02502.JPG,char_data/9/DSC02502.JPG_0.jpg,2665,41,268,309,346,411,False,11
9,43,kaist_dataset/Mixed/Digital_Camera/(C.S)C-outdoor2/DSC02411.JPG,char_data/9/DSC02411.JPG_0.jpg,946,22,484,506,348,391,False,11
9,40,kaist_dataset/Mixed/Digital_Camera/(C.S)C-outdoor2/DSC02413.JPG,char_data/9/DSC02413.JPG_0.jpg,880,22,448,470,207,247,False,11
9,74,kaist_dataset/Mixed/Digital_Camera/(C.S)C-outdoor2/DSC02513.JPG,char_data/9/DSC02513.JPG_0.jpg,3922,53,319,372,142,216,False,11
9,77,kaist_dataset/Mixed/Digital_Camera/(C.S)C-outdoor2/DSC02513.JPG,char_data/9/DSC02513.JPG_0.jpg,3773,49,419,468,145,222,False,11
9,36,kaist_dataset/Mixed/Digital_Camera/(C.S)C-outdoor2/DSC02479.JPG,char_data/9/DSC02479.JPG_0.jpg,576,16,526,542,219,255,False,11
9,32,kaist_dataset/Mixed/Digital_Camera/(C.S)C-outdoor2/DSC02887.JPG,char_data/9/DSC02887.JPG_0.jpg,736,23,355,378,118,150,False,11
9,39,kaist_dataset/Mixed/Digital_Camera/(C.S)C-outdoor2/DSC02368.JPG,char_data/9/DSC02368.JPG_0.jpg,663,17,212,229,382,421,False,11
9,54,kaist_dataset/Mixed/Digital_Camera/(C.S)C-outdoor2/P1010013.JPG,char_data/9/P1010013.JPG_0.jpg,1566,29,281,310,365,419,False,11
9,35,kaist_dataset/Mixed/Digital_Camera/(C.S)C-outdoor2/DSC02894.JPG,char_data/9/DSC02894.JPG_0.jpg,840,24,311,335,253,288,False,11
9,59,kaist_dataset/Mixed/Digital_Camera/(C.S)C-outdoor2/DSC02359.JPG,char_data/9/DSC02359.JPG_0.jpg,2419,41,403,444,410,469,False,11
9,31,kaist_dataset/Mixed/Digital_Camera/(C.S)C-outdoor2/DSC02422.JPG,char_data/9/DSC02422.JPG_0.jpg,806,26,503,529,226,257,False,11
9,38,kaist_dataset/Mixed/Digital_Camera/(C.S)C-outdoor2/DSC02933.JPG,char_data/9/DSC02933.JPG_0.jpg,684,18,619,637,247,285,False,11
9,34,kaist_dataset/Mixed/Digital_Camera/(C.S)C-outdoor2/DSC02511.JPG,char_data/9/DSC02511.JPG_0.jpg,646,19,434,453,215,249,False,11
9,39,kaist_dataset/Mixed/Digital_Camera/(C.S)C-outdoor2/DSC02511.JPG,char_data/9/DSC02511.JPG_0.jpg,1209,31,452,483,215,254,False,11
9,47,kaist_dataset/Mixed/Digital_Camera/(C.S)C-outdoor2/DSC02938.JPG,char_data/9/DSC02938.JPG_0.jpg,1128,24,563,587,241,288,False,11
9,33,kaist_dataset/Mixed/Digital_Camera/(C.S)C-outdoor2/DSC02560.JPG,char_data/9/DSC02560.JPG_0.jpg,594,18,597,615,305,338,False,11
9,44,kaist_dataset/Mixed/Digital_Camera/(C.S)C-outdoor2/DSC02389.JPG,char_data/9/DSC02389.JPG_0.jpg,1452,33,337,370,37,81,False,11
9,118,kaist_dataset/Mixed/Digital_Camera/(C.S)C-outdoor2/DSC02430.JPG,char_data/9/DSC02430.JPG_0.jpg,14750,125,313,438,53,171,False,11
9,109,kaist_dataset/Mixed/Digital_Camera/(C.S)C-outdoor2/DSC02430.JPG,char_data/9/DSC02430.JPG_0.jpg,12317,113,395,508,106,215,False,11
9,21,kaist_dataset/Mixed/Digital_Camera/(C.S)C-outdoor2/DSC02430.JPG,char_data/9/DSC02430.JPG_0.jpg,168,8,47,55,29,50,False,11
9,24,kaist_dataset/Mixed/Digital_Camera/(C.S)C-outdoor2/DSC02430.JPG,char_data/9/DSC02430.JPG_0.jpg,312,13,54,67,27,51,False,11
9,35,kaist_dataset/Mixed/Digital_Camera/(C.S)C-outdoor2/DSC02430.JPG,char_data/9/DSC02430.JPG_0.jpg,595,17,550,567,306,341,False,11
9,28,kaist_dataset/Mixed/Digital_Camera/(C.S)C-outdoor2/DSC02430.JPG,char_data/9/DSC02430.JPG_0.jpg,420,15,563,578,323,351,False,11
9,66,kaist_dataset/Mixed/Digital_Camera/(C.S)A-shadow/DSC04326.JPG,char_data/9/DSC04326.JPG_0.jpg,2244,34,443,477,17,83,False,11
9,69,kaist_dataset/Mixed/Digital_Camera/(C.S)A-shadow/DSC04326.JPG,char_data/9/DSC04326.JPG_0.jpg,2484,36,533,569,13,82,False,11
9,39,kaist_dataset/Mixed/Digital_Camera/(C.S)A-shadow/P1010017.JPG,char_data/9/P1010017.JPG_0.jpg,741,19,94,113,129,168,False,11
9,40,kaist_dataset/Mixed/Digital_Camera/(C.S)A-shadow/P1010019.JPG,char_data/9/P1010019.JPG_0.jpg,1040,26,382,408,201,241,False,11
9,36,kaist_dataset/Mixed/Digital_Camera/(C.S)A-shadow/P1010019.JPG,char_data/9/P1010019.JPG_0.jpg,720,20,409,429,204,240,False,11
9,28,kaist_dataset/English/Digital_Camera/(E.S)E-night/크기변환_%BA%F7%BD%BA%BD%C5%B8%DE%B4%BA_01_tjtjdska2008.jpg,char_data/9/크기변환_%BA%F7%BD%BA%BD%C5%B8%DE%B4%BA_01_tjtjdska2008.jpg_0.jpg,392,14,354,368,277,305,False,11
9,28,kaist_dataset/English/Digital_Camera/(E.S)E-night/크기변환_%BA%F7%BD%BA%BD%C5%B8%DE%B4%BA_01_tjtjdska2008.jpg,char_data/9/크기변환_%BA%F7%BD%BA%BD%C5%B8%DE%B4%BA_01_tjtjdska2008.jpg_0.jpg,392,14,368,382,275,303,False,11
9,51,kaist_dataset/English/Digital_Camera/(E.S)C-outdoor2/DSC03650.JPG,char_data/9/DSC03650.JPG_0.jpg,1377,27,393,420,293,344,False,11
9,39,kaist_dataset/English/Digital_Camera/(E.S)C-outdoor1/DSC02415.JPG,char_data/9/DSC02415.JPG_0.jpg,858,22,577,599,250,289,False,11
9,165,kaist_dataset/English/Digital_Camera/(E.S)C-outdoor1/2007-12-08-day-111.jpg,char_data/9/2007-12-08-day-111.jpg_0.jpg,22605,137,425,562,436,601,False,11
9,36,kaist_dataset/English/Digital_Camera/(E.S)F-others/m.jpg,char_data/9/m.jpg_0.jpg,612,17,145,162,167,203,False,11
9,35,kaist_dataset/English/Digital_Camera/(E.S)F-others/DSC02923.JPG,char_data/9/DSC02923.JPG_0.jpg,700,20,307,327,398,433,False,11
9,25,kaist_dataset/English/Digital_Camera/(E.S)C-outdoor3/크기변환_P1010076.JPG,char_data/9/크기변환_P1010076.JPG_0.jpg,350,14,625,639,178,203,False,11
i,75,kaist_dataset/Korean/Digital_Camera/outdoor2/2007-12-08-day-101.jpg,char_data/i/2007-12-08-day-101.jpg_4.jpg,1800,24,504,528,365,440,True,37
i,75,kaist_dataset/Korean/Digital_Camera/outdoor2/2007-12-08-day-101.jpg,char_data/i/2007-12-08-day-101.jpg_4.jpg,1725,23,878,901,382,457,True,37
i,39,kaist_dataset/Korean/Digital_Camera/outdoor2/2007-12-09-day-exterior-036.jpg,char_data/i/2007-12-09-day-exterior-036.jpg_2.jpg,702,18,1395,1413,548,587,True,37
i,64,kaist_dataset/Korean/Digital_Camera/outdoor2/080118-0018.jpg,char_data/i/080118-0018.jpg_0.jpg,1472,23,1292,1315,680,744,True,37
i,25,kaist_dataset/Korean/Digital_Camera/indoor1/080119-0029.jpg,char_data/i/080119-0029.jpg_0.jpg,150,6,921,927,657,682,True,37
i,39,kaist_dataset/Korean/Digital_Camera/G-others/080119-0005.jpg,char_data/i/080119-0005.jpg_0.jpg,546,14,561,575,581,620,True,37
i,36,kaist_dataset/Korean/Digital_Camera/G-others/080119-0005.jpg,char_data/i/080119-0005.jpg_0.jpg,288,8,749,757,609,645,True,37
i,55,kaist_dataset/Korean/Digital_Camera/G-others/2007-12-08-day-112.jpg,char_data/i/2007-12-08-day-112.jpg_0.jpg,660,12,855,867,487,542,True,37
i,55,kaist_dataset/Korean/Digital_Camera/outdoor1/2007-12-08-day-087.jpg,char_data/i/2007-12-08-day-087.jpg_0.jpg,935,17,1281,1298,668,723,True,37
i,26,kaist_dataset/Korean/Digital_Camera/outdoor1/001.JPG,char_data/i/001.JPG_0.jpg,234,9,305,314,239,265,True,37
i,23,kaist_dataset/Korean/Digital_Camera/outdoor1/001.JPG,char_data/i/001.JPG_0.jpg,207,9,538,547,238,261,True,37
i,39,kaist_dataset/Mixed/Mobile_Phone/(C.M)A-outdoor/P090912078.jpg,char_data/i/P090912078.jpg_0.jpg,468,12,410,422,292,331,True,37
i,34,kaist_dataset/Mixed/Mobile_Phone/(C.M)A-outdoor/P090912078.jpg,char_data/i/P090912078.jpg_0.jpg,374,11,538,549,289,323,True,37
i,46,kaist_dataset/Mixed/Mobile_Phone/(C.M)B-indoor/P090831014.jpg,char_data/i/P090831014.jpg_0.jpg,828,18,326,344,165,211,True,37
i,57,kaist_dataset/Mixed/Mobile_Phone/(C.M)B-indoor/P090831015.jpg,char_data/i/P090831015.jpg_0.jpg,855,15,386,401,207,264,True,37
i,49,kaist_dataset/Mixed/Mobile_Phone/(C.M)B-indoor/P090831017.jpg,char_data/i/P090831017.jpg_0.jpg,931,19,306,325,241,290,True,37
i,65,kaist_dataset/Mixed/Mobile_Phone/(C.M)B-indoor/P090831023.jpg,char_data/i/P090831023.jpg_0.jpg,1430,22,129,151,264,329,True,37
i,68,kaist_dataset/Mixed/Mobile_Phone/(C.M)B-indoor/P090831023.jpg,char_data/i/P090831023.jpg_0.jpg,1428,21,241,262,262,330,True,37
i,66,kaist_dataset/Mixed/Mobile_Phone/(C.M)C-bookCover/P090831113.jpg,char_data/i/P090831113.jpg_0.jpg,1650,25,370,395,228,294,True,37
i,50,kaist_dataset/Mixed/Mobile_Phone/(C.M)C-bookCover/P090831119.jpg,char_data/i/P090831119.jpg_0.jpg,1000,20,352,372,220,270,True,37
i,35,kaist_dataset/Mixed/Mobile_Phone/(C.M)C-bookCover/P090902016.jpg,char_data/i/P090902016.jpg_0.jpg,385,11,124,135,270,305,True,37
i,39,kaist_dataset/Mixed/Mobile_Phone/(C.M)C-bookCover/P090904005.jpg,char_data/i/P090904005.jpg_0.jpg,468,12,446,458,118,157,True,37
i,50,kaist_dataset/Mixed/Mobile_Phone/(C.M)C-bookCover/P090831080.jpg,char_data/i/P090831080.jpg_0.jpg,700,14,287,301,401,451,True,37
i,49,kaist_dataset/Mixed/Mobile_Phone/(C.M)C-bookCover/P090831115.jpg,char_data/i/P090831115.jpg_0.jpg,637,13,380,393,161,210,True,37
i,55,kaist_dataset/Mixed/Mobile_Phone/(C.M)C-bookCover/P090902019.jpg,char_data/i/P090902019.jpg_0.jpg,1210,22,296,318,292,347,True,37
i,70,kaist_dataset/Mixed/Mobile_Phone/(C.M)C-bookCover/P090831122.jpg,char_data/i/P090831122.jpg_0.jpg,1470,21,315,336,252,322,True,37
i,68,kaist_dataset/Mixed/Mobile_Phone/(C.M)C-bookCover/P090831062.jpg,char_data/i/P090831062.jpg_0.jpg,1904,28,474,502,270,338,True,37
i,52,kaist_dataset/Mixed/Mobile_Phone/(C.M)C-bookCover/P090831118.jpg,char_data/i/P090831118.jpg_0.jpg,1040,20,267,287,211,263,True,37
i,49,kaist_dataset/Mixed/Mobile_Phone/(C.M)C-bookCover/P090831118.jpg,char_data/i/P090831118.jpg_0.jpg,980,20,393,413,213,262,True,37
i,40,kaist_dataset/Mixed/Mobile_Phone/(C.M)C-bookCover/P090903024.jpg,char_data/i/P090903024.jpg_0.jpg,640,16,348,364,110,150,True,37
i,30,kaist_dataset/Mixed/Mobile_Phone/(C.M)C-bookCover/P090903024.jpg,char_data/i/P090903024.jpg_0.jpg,540,18,332,350,231,261,True,37
i,38,kaist_dataset/Mixed/Digital_Camera/(C.S)C-outdoor1/115.JPG,char_data/i/115.JPG_0.jpg,342,9,331,340,272,310,True,37
i,29,kaist_dataset/Mixed/Digital_Camera/(C.S)C-outdoor1/080.JPG,char_data/i/080.JPG_0.jpg,609,21,162,183,80,109,True,37
i,38,kaist_dataset/Mixed/Digital_Camera/(C.S)C-outdoor1/080.JPG,char_data/i/080.JPG_0.jpg,836,22,145,167,109,147,True,37
i,78,kaist_dataset/Mixed/Digital_Camera/(C.S)C-outdoor1/2007-12-08-day-118.jpg,char_data/i/2007-12-08-day-118.jpg_0.jpg,2652,34,1284,1318,401,479,True,37
i,241,kaist_dataset/Mixed/Digital_Camera/(C.S)C-outdoor1/080119-0033.jpg,char_data/i/080119-0033.jpg_0.jpg,23618,98,745,843,453,694,True,37
i,30,kaist_dataset/Mixed/Digital_Camera/(C.S)C-outdoor1/021.JPG,char_data/i/021.JPG_0.jpg,240,8,492,500,136,166,True,37
i,73,kaist_dataset/Mixed/Digital_Camera/(C.S)C-outdoor1/2007-12-09-day-exterior-044.jpg,char_data/i/2007-12-09-day-exterior-044.jpg_0.jpg,1752,24,801,825,817,890,True,37
i,32,kaist_dataset/Mixed/Digital_Camera/(C.S)C-outdoor1/DSC02318.JPG,char_data/i/DSC02318.JPG_0.jpg,256,8,454,462,317,349,True,37
i,180,kaist_dataset/Mixed/Digital_Camera/(C.S)C-outdoor1/080118-0014.jpg,char_data/i/080118-0014.jpg_0.jpg,7920,44,1192,1236,706,886,True,37
i,52,kaist_dataset/Mixed/Digital_Camera/(C.S)C-outdoor1/003.JPG,char_data/i/003.JPG_0.jpg,1040,20,297,317,97,149,True,37
i,57,kaist_dataset/Mixed/Digital_Camera/(C.S)C-outdoor1/003.JPG,char_data/i/003.JPG_0.jpg,1140,20,376,396,94,151,True,37
i,31,kaist_dataset/Mixed/Digital_Camera/(C.S)C-outdoor1/003.JPG,char_data/i/003.JPG_0.jpg,279,9,538,547,247,278,True,37
i,27,kaist_dataset/Mixed/Digital_Camera/(C.S)C-outdoor1/003.JPG,char_data/i/003.JPG_0.jpg,162,6,261,267,259,286,True,37
i,22,kaist_dataset/Mixed/Digital_Camera/(C.S)C-outdoor1/003.JPG,char_data/i/003.JPG_0.jpg,132,6,166,172,264,286,True,37
i,37,kaist_dataset/Mixed/Digital_Camera/(C.S)C-outdoor1/1.JPG,char_data/i/1.JPG_0.jpg,370,10,476,486,5,42,True,37
i,34,kaist_dataset/Mixed/Digital_Camera/(C.S)C-outdoor1/DSC02325.JPG,char_data/i/DSC02325.JPG_0.jpg,544,16,243,259,319,353,True,37
i,108,kaist_dataset/Mixed/Digital_Camera/(C.S)F-others/DSC03489.JPG,char_data/i/DSC03489.JPG_0.jpg,2808,26,333,359,315,423,True,37
i,32,kaist_dataset/Mixed/Digital_Camera/(C.S)F-others/2007-12-09-day-exterior-032.jpg,char_data/i/2007-12-09-day-exterior-032.jpg_0.jpg,544,17,588,605,281,313,True,37
i,50,kaist_dataset/Mixed/Digital_Camera/(C.S)D-indoor2/DSC04249.JPG,char_data/i/DSC04249.JPG_0.jpg,650,13,255,268,208,258,True,37
i,35,kaist_dataset/Mixed/Digital_Camera/(C.S)D-indoor2/DSC04254.JPG,char_data/i/DSC04254.JPG_0.jpg,350,10,429,439,338,373,True,37
i,150,kaist_dataset/Mixed/Digital_Camera/(C.S)E-night/DSC02585.JPG,char_data/i/DSC02585.JPG_0.jpg,9450,63,268,331,227,377,True,37
i,35,kaist_dataset/Mixed/Digital_Camera/(C.S)E-night/DSC03031.JPG,char_data/i/DSC03031.JPG_0.jpg,350,10,211,221,22,57,True,37
i,70,kaist_dataset/Mixed/Digital_Camera/(C.S)E-night/DSC03840.JPG,char_data/i/DSC03840.JPG_0.jpg,2520,36,178,214,100,170,True,37
i,23,kaist_dataset/Mixed/Digital_Camera/(C.S)E-night/P1010151.JPG,char_data/i/P1010151.JPG_0.jpg,207,9,485,494,202,225,True,37
i,30,kaist_dataset/Mixed/Digital_Camera/(C.S)E-night/DSC02569.JPG,char_data/i/DSC02569.JPG_0.jpg,420,14,443,457,269,299,True,37
i,52,kaist_dataset/Mixed/Digital_Camera/(C.S)E-night/DSC02623.JPG,char_data/i/DSC02623.JPG_0.jpg,624,12,298,310,384,436,True,37
i,33,kaist_dataset/Mixed/Digital_Camera/(C.S)E-night/DSC03516.JPG,char_data/i/DSC03516.JPG_0.jpg,528,16,92,108,112,145,True,37
i,44,kaist_dataset/Mixed/Digital_Camera/(C.S)B-light/134.JPG,char_data/i/134.JPG_0.jpg,352,8,404,412,288,332,True,37
i,43,kaist_dataset/Mixed/Digital_Camera/(C.S)D-indoor1/DSC03118.JPG,char_data/i/DSC03118.JPG_0.jpg,344,8,384,392,151,194,True,37
i,53,kaist_dataset/Mixed/Digital_Camera/(C.S)D-indoor1/DSC03118.JPG,char_data/i/DSC03118.JPG_0.jpg,424,8,408,416,146,199,True,37
i,55,kaist_dataset/Mixed/Digital_Camera/(C.S)D-indoor1/DSC03118.JPG,char_data/i/DSC03118.JPG_0.jpg,495,9,321,330,219,274,True,37
i,44,kaist_dataset/Mixed/Digital_Camera/(C.S)D-indoor1/DSC03124.JPG,char_data/i/DSC03124.JPG_0.jpg,748,17,459,476,189,233,True,37
i,44,kaist_dataset/Mixed/Digital_Camera/(C.S)D-indoor1/DSC03129.JPG,char_data/i/DSC03129.JPG_0.jpg,396,9,389,398,200,244,True,37
i,51,kaist_dataset/Mixed/Digital_Camera/(C.S)D-indoor1/082.JPG,char_data/i/082.JPG_0.jpg,816,16,353,369,170,221,True,37
i,46,kaist_dataset/Mixed/Digital_Camera/(C.S)D-indoor1/DSC03126.JPG,char_data/i/DSC03126.JPG_0.jpg,598,13,296,309,220,266,True,37
i,98,kaist_dataset/Mixed/Digital_Camera/(C.S)D-indoor1/DSC03909.JPG,char_data/i/DSC03909.JPG_0.jpg,2548,26,455,481,82,180,True,37
i,102,kaist_dataset/Mixed/Digital_Camera/(C.S)D-indoor1/DSC03909.JPG,char_data/i/DSC03909.JPG_0.jpg,2244,22,515,537,176,278,True,37
i,67,kaist_dataset/Mixed/Digital_Camera/(C.S)D-indoor1/DSC03455.JPG,char_data/i/DSC03455.JPG_0.jpg,1072,16,270,286,387,454,True,37
i,66,kaist_dataset/Mixed/Digital_Camera/(C.S)D-indoor1/DSC03460.JPG,char_data/i/DSC03460.JPG_0.jpg,1122,17,288,305,381,447,True,37
i,44,kaist_dataset/Mixed/Digital_Camera/(C.S)D-indoor1/DSC02787.JPG,char_data/i/DSC02787.JPG_0.jpg,352,8,306,314,367,411,True,37
i,42,kaist_dataset/Mixed/Digital_Camera/(C.S)D-indoor1/DSC02787.JPG,char_data/i/DSC02787.JPG_0.jpg,252,6,363,369,363,405,True,37
i,71,kaist_dataset/Mixed/Digital_Camera/(C.S)D-indoor1/DSC03913.JPG,char_data/i/DSC03913.JPG_0.jpg,1420,20,281,301,93,164,True,37
i,43,kaist_dataset/Mixed/Digital_Camera/(C.S)D-indoor1/DSC03073.JPG,char_data/i/DSC03073.JPG_0.jpg,559,13,234,247,284,327,True,37
i,41,kaist_dataset/Mixed/Digital_Camera/(C.S)D-indoor1/DSC02804.JPG,char_data/i/DSC02804.JPG_0.jpg,533,13,433,446,346,387,True,37
i,41,kaist_dataset/Mixed/Digital_Camera/(C.S)D-indoor1/DSC03132.JPG,char_data/i/DSC03132.JPG_0.jpg,451,11,337,348,175,216,True,37
i,46,kaist_dataset/Mixed/Digital_Camera/(C.S)D-indoor1/DSC04183.JPG,char_data/i/DSC04183.JPG_0.jpg,598,13,167,180,245,291,True,37
i,48,kaist_dataset/Mixed/Digital_Camera/(C.S)D-indoor1/DSC04183.JPG,char_data/i/DSC04183.JPG_0.jpg,624,13,365,378,246,294,True,37
i,47,kaist_dataset/Mixed/Digital_Camera/(C.S)D-indoor1/DSC04206.JPG,char_data/i/DSC04206.JPG_0.jpg,611,13,395,408,285,332,True,37
i,42,kaist_dataset/Mixed/Digital_Camera/(C.S)D-indoor1/DSC03122.JPG,char_data/i/DSC03122.JPG_0.jpg,504,12,256,268,199,241,True,37
i,33,kaist_dataset/Mixed/Digital_Camera/(C.S)D-indoor1/DSC03122.JPG,char_data/i/DSC03122.JPG_0.jpg,429,13,379,392,200,233,True,37
i,52,kaist_dataset/Mixed/Digital_Camera/(C.S)D-indoor1/DSC03133.JPG,char_data/i/DSC03133.JPG_0.jpg,468,9,422,431,143,195,True,37
i,49,kaist_dataset/Mixed/Digital_Camera/(C.S)D-indoor1/DSC03133.JPG,char_data/i/DSC03133.JPG_0.jpg,784,16,476,492,147,196,True,37
i,52,kaist_dataset/Mixed/Digital_Camera/(C.S)D-indoor1/DSC03912.JPG,char_data/i/DSC03912.JPG_0.jpg,988,19,367,386,38,90,True,37
i,74,kaist_dataset/Mixed/Digital_Camera/(C.S)D-indoor1/DSC02770.JPG,char_data/i/DSC02770.JPG_0.jpg,1406,19,259,278,342,416,True,37
i,32,kaist_dataset/Mixed/Digital_Camera/(C.S)D-indoor1/DSC03096.JPG,char_data/i/DSC03096.JPG_0.jpg,256,8,176,184,423,455,True,37
i,32,kaist_dataset/Mixed/Digital_Camera/(C.S)D-indoor1/DSC03096.JPG,char_data/i/DSC03096.JPG_0.jpg,320,10,308,318,423,455,True,37
i,37,kaist_dataset/Mixed/Digital_Camera/(C.S)D-indoor1/DSC03096.JPG,char_data/i/DSC03096.JPG_0.jpg,333,9,357,366,419,456,True,37
i,35,kaist_dataset/Mixed/Digital_Camera/(C.S)D-indoor1/DSC03096.JPG,char_data/i/DSC03096.JPG_0.jpg,350,10,567,577,422,457,True,37
i,45,kaist_dataset/Mixed/Digital_Camera/(C.S)D-indoor1/DSC04246.JPG,char_data/i/DSC04246.JPG_0.jpg,450,10,447,457,241,286,True,37
i,116,kaist_dataset/Mixed/Digital_Camera/(C.S)C-outdoor5/DSC04395.JPG,char_data/i/DSC04395.JPG_0.jpg,4872,42,296,338,139,255,True,37
i,156,kaist_dataset/Mixed/Digital_Camera/(C.S)C-outdoor5/DSC04465.JPG,char_data/i/DSC04465.JPG_0.jpg,8580,55,66,121,261,417,True,37
i,33,kaist_dataset/Mixed/Digital_Camera/(C.S)C-outdoor5/DSC04312.JPG,char_data/i/DSC04312.JPG_0.jpg,297,9,420,429,145,178,True,37
i,34,kaist_dataset/Mixed/Digital_Camera/(C.S)C-outdoor5/DSC04312.JPG,char_data/i/DSC04312.JPG_0.jpg,272,8,443,451,142,176,True,37
i,42,kaist_dataset/Mixed/Digital_Camera/(C.S)C-outdoor5/DSC04154.JPG,char_data/i/DSC04154.JPG_0.jpg,546,13,541,554,237,279,True,37
i,43,kaist_dataset/Mixed/Digital_Camera/(C.S)C-outdoor5/DSC04321.JPG,char_data/i/DSC04321.JPG_0.jpg,430,10,540,550,202,245,True,37
i,43,kaist_dataset/Mixed/Digital_Camera/(C.S)C-outdoor5/DSC04321.JPG,char_data/i/DSC04321.JPG_0.jpg,430,10,302,312,195,238,True,37
i,39,kaist_dataset/Mixed/Digital_Camera/(C.S)C-outdoor5/DSC04321.JPG,char_data/i/DSC04321.JPG_0.jpg,390,10,451,461,200,239,True,37
i,82,kaist_dataset/Mixed/Digital_Camera/(C.S)C-outdoor5/DSC03820.JPG,char_data/i/DSC03820.JPG_0.jpg,1394,17,86,103,353,435,True,37
i,47,kaist_dataset/Mixed/Digital_Camera/(C.S)C-outdoor5/DSC04076.JPG,char_data/i/DSC04076.JPG_0.jpg,987,21,175,196,101,148,True,37
i,44,kaist_dataset/Mixed/Digital_Camera/(C.S)C-outdoor5/DSC04076.JPG,char_data/i/DSC04076.JPG_0.jpg,1100,25,222,247,101,145,True,37
i,98,kaist_dataset/Mixed/Digital_Camera/(C.S)C-outdoor5/DSC04349.JPG,char_data/i/DSC04349.JPG_0.jpg,3724,38,183,221,82,180,True,37
i,92,kaist_dataset/Mixed/Digital_Camera/(C.S)C-outdoor5/DSC04349.JPG,char_data/i/DSC04349.JPG_0.jpg,1196,13,429,442,280,372,True,37
i,39,kaist_dataset/Mixed/Digital_Camera/(C.S)C-outdoor5/DSC03839.JPG,char_data/i/DSC03839.JPG_0.jpg,546,14,259,273,34,73,True,37
i,25,kaist_dataset/Mixed/Digital_Camera/(C.S)C-outdoor5/DSC04357.JPG,char_data/i/DSC04357.JPG_0.jpg,200,8,362,370,380,405,True,37
i,25,kaist_dataset/Mixed/Digital_Camera/(C.S)C-outdoor5/DSC04357.JPG,char_data/i/DSC04357.JPG_0.jpg,125,5,219,224,353,378,True,37
i,28,kaist_dataset/Mixed/Digital_Camera/(C.S)C-outdoor5/DSC04357.JPG,char_data/i/DSC04357.JPG_0.jpg,308,11,307,318,350,378,True,37
i,27,kaist_dataset/Mixed/Digital_Camera/(C.S)C-outdoor5/DSC04357.JPG,char_data/i/DSC04357.JPG_0.jpg,216,8,380,388,352,379,True,37
i,41,kaist_dataset/Mixed/Digital_Camera/(C.S)C-outdoor5/DSC04069.JPG,char_data/i/DSC04069.JPG_0.jpg,287,7,293,300,418,459,True,37
i,43,kaist_dataset/Mixed/Digital_Camera/(C.S)C-outdoor5/DSC04069.JPG,char_data/i/DSC04069.JPG_0.jpg,559,13,514,527,371,414,True,37
i,45,kaist_dataset/Mixed/Digital_Camera/(C.S)C-outdoor5/DSC03821.JPG,char_data/i/DSC03821.JPG_0.jpg,585,13,314,327,29,74,True,37
i,63,kaist_dataset/Mixed/Digital_Camera/(C.S)C-outdoor5/DSC04097.JPG,char_data/i/DSC04097.JPG_0.jpg,1071,17,244,261,174,237,True,37
i,33,kaist_dataset/Mixed/Digital_Camera/(C.S)C-outdoor5/DSC04125.JPG,char_data/i/DSC04125.JPG_0.jpg,264,8,170,178,425,458,True,37
i,37,kaist_dataset/Mixed/Digital_Camera/(C.S)C-outdoor5/DSC04070.JPG,char_data/i/DSC04070.JPG_0.jpg,185,5,180,185,107,144,True,37
i,52,kaist_dataset/Mixed/Digital_Camera/(C.S)C-outdoor5/DSC04015.JPG,char_data/i/DSC04015.JPG_0.jpg,832,16,272,288,117,169,True,37
i,40,kaist_dataset/Mixed/Digital_Camera/(C.S)C-outdoor5/DSC04429.JPG,char_data/i/DSC04429.JPG_0.jpg,440,11,318,329,248,288,True,37
i,34,kaist_dataset/Mixed/Digital_Camera/(C.S)C-outdoor5/DSC04091.JPG,char_data/i/DSC04091.JPG_0.jpg,238,7,280,287,426,460,True,37
i,40,kaist_dataset/Mixed/Digital_Camera/(C.S)C-outdoor5/DSC04323.JPG,char_data/i/DSC04323.JPG_0.jpg,480,12,377,389,201,241,True,37
i,45,kaist_dataset/Mixed/Digital_Camera/(C.S)C-outdoor5/DSC04323.JPG,char_data/i/DSC04323.JPG_0.jpg,450,10,544,554,200,245,True,37
i,39,kaist_dataset/Mixed/Digital_Camera/(C.S)C-outdoor5/DSC04338.JPG,char_data/i/DSC04338.JPG_0.jpg,312,8,581,589,194,233,True,37
i,85,kaist_dataset/Mixed/Digital_Camera/(C.S)C-outdoor5/DSC04115.JPG,char_data/i/DSC04115.JPG_0.jpg,1870,22,243,265,193,278,True,37
i,43,kaist_dataset/Mixed/Digital_Camera/(C.S)C-outdoor3/DSC03177.JPG,char_data/i/DSC03177.JPG_0.jpg,860,20,235,255,138,181,True,37
i,55,kaist_dataset/Mixed/Digital_Camera/(C.S)C-outdoor3/DSC03310.JPG,char_data/i/DSC03310.JPG_0.jpg,770,14,289,303,113,168,True,37
i,59,kaist_dataset/Mixed/Digital_Camera/(C.S)C-outdoor3/DSC02962.JPG,char_data/i/DSC02962.JPG_0.jpg,944,16,265,281,253,312,True,37
i,120,kaist_dataset/Mixed/Digital_Camera/(C.S)C-outdoor3/DSC03421.JPG,char_data/i/DSC03421.JPG_0.jpg,4680,39,353,392,73,193,True,37
i,31,kaist_dataset/Mixed/Digital_Camera/(C.S)C-outdoor3/DSC03328.JPG,char_data/i/DSC03328.JPG_0.jpg,248,8,484,492,229,260,True,37
i,45,kaist_dataset/Mixed/Digital_Camera/(C.S)C-outdoor3/DSC03063.JPG,char_data/i/DSC03063.JPG_0.jpg,720,16,297,313,287,332,True,37
i,49,kaist_dataset/Mixed/Digital_Camera/(C.S)C-outdoor3/DSC03063.JPG,char_data/i/DSC03063.JPG_0.jpg,686,14,463,477,294,343,True,37
i,81,kaist_dataset/Mixed/Digital_Camera/(C.S)C-outdoor3/DSC02989.JPG,char_data/i/DSC02989.JPG_0.jpg,3564,44,312,356,168,249,True,37
i,54,kaist_dataset/Mixed/Digital_Camera/(C.S)C-outdoor3/DSC02989.JPG,char_data/i/DSC02989.JPG_0.jpg,864,16,541,557,202,256,True,37
i,43,kaist_dataset/Mixed/Digital_Camera/(C.S)C-outdoor6/P1010085.JPG,char_data/i/P1010085.JPG_0.jpg,301,7,100,107,127,170,True,37
i,207,kaist_dataset/Mixed/Digital_Camera/(C.S)C-outdoor6/080116-0057.jpg,char_data/i/080116-0057.jpg_0.jpg,10971,53,1102,1155,295,502,True,37
i,81,kaist_dataset/Mixed/Digital_Camera/(C.S)C-outdoor6/P1010116.JPG,char_data/i/P1010116.JPG_0.jpg,1296,16,321,337,182,263,True,37
i,52,kaist_dataset/Mixed/Digital_Camera/(C.S)C-outdoor6/P1010052.JPG,char_data/i/P1010052.JPG_0.jpg,1196,23,513,536,131,183,True,37
i,69,kaist_dataset/Mixed/Digital_Camera/(C.S)C-outdoor6/117.JPG,char_data/i/117.JPG_0.jpg,2622,38,428,466,178,247,True,37
i,66,kaist_dataset/Mixed/Digital_Camera/(C.S)C-outdoor4/DSC03730.JPG,char_data/i/DSC03730.JPG_0.jpg,1518,23,164,187,340,406,True,37
i,39,kaist_dataset/Mixed/Digital_Camera/(C.S)C-outdoor4/DSC03719.JPG,char_data/i/DSC03719.JPG_0.jpg,234,6,135,141,28,67,True,37
i,38,kaist_dataset/Mixed/Digital_Camera/(C.S)C-outdoor4/DSC03719.JPG,char_data/i/DSC03719.JPG_0.jpg,190,5,217,222,27,65,True,37
i,89,kaist_dataset/Mixed/Digital_Camera/(C.S)C-outdoor4/DSC03733.JPG,char_data/i/DSC03733.JPG_0.jpg,2670,30,347,377,191,280,True,37
i,53,kaist_dataset/Mixed/Digital_Camera/(C.S)C-outdoor4/DSC03642.JPG,char_data/i/DSC03642.JPG_0.jpg,636,12,314,326,240,293,True,37
i,41,kaist_dataset/Mixed/Digital_Camera/(C.S)C-outdoor4/DSC03773.JPG,char_data/i/DSC03773.JPG_0.jpg,738,18,356,374,280,321,True,37
i,27,kaist_dataset/Mixed/Digital_Camera/(C.S)C-outdoor4/DSC03661.JPG,char_data/i/DSC03661.JPG_0.jpg,351,13,134,147,273,300,True,37
i,79,kaist_dataset/Mixed/Digital_Camera/(C.S)C-outdoor4/DSC03784.JPG,char_data/i/DSC03784.JPG_0.jpg,1422,18,122,140,303,382,True,37
i,33,kaist_dataset/Mixed/Digital_Camera/(C.S)C-outdoor4/DSC03718.JPG,char_data/i/DSC03718.JPG_0.jpg,264,8,312,320,95,128,True,37
i,33,kaist_dataset/Mixed/Digital_Camera/(C.S)C-outdoor4/DSC03718.JPG,char_data/i/DSC03718.JPG_0.jpg,198,6,129,135,255,288,True,37
i,35,kaist_dataset/Mixed/Digital_Camera/(C.S)C-outdoor4/DSC03718.JPG,char_data/i/DSC03718.JPG_0.jpg,210,6,209,215,253,288,True,37
i,126,kaist_dataset/Mixed/Digital_Camera/(C.S)C-outdoor4/DSC03519.JPG,char_data/i/DSC03519.JPG_0.jpg,6552,52,251,303,122,248,True,37
i,50,kaist_dataset/Mixed/Digital_Camera/(C.S)C-outdoor4/DSC03781.JPG,char_data/i/DSC03781.JPG_0.jpg,1000,20,346,366,262,312,True,37
i,47,kaist_dataset/Mixed/Digital_Camera/(C.S)C-outdoor4/DSC03781.JPG,char_data/i/DSC03781.JPG_0.jpg,1034,22,333,355,216,263,True,37
i,41,kaist_dataset/Mixed/Digital_Camera/(C.S)C-outdoor4/DSC03672.JPG,char_data/i/DSC03672.JPG_0.jpg,451,11,247,258,403,444,True,37
i,91,kaist_dataset/Mixed/Digital_Camera/(C.S)C-outdoor4/DSC03638.JPG,char_data/i/DSC03638.JPG_0.jpg,1820,20,207,227,110,201,True,37
i,57,kaist_dataset/Mixed/Digital_Camera/(C.S)C-outdoor4/DSC03643.JPG,char_data/i/DSC03643.JPG_0.jpg,855,15,270,285,258,315,True,37
i,44,kaist_dataset/Mixed/Digital_Camera/(C.S)C-outdoor4/DSC03682.JPG,char_data/i/DSC03682.JPG_0.jpg,396,9,373,382,316,360,True,37
i,94,kaist_dataset/Mixed/Digital_Camera/(C.S)C-outdoor4/DSC03635.JPG,char_data/i/DSC03635.JPG_0.jpg,2256,24,189,213,146,240,True,37
i,93,kaist_dataset/Mixed/Digital_Camera/(C.S)C-outdoor4/DSC03630.JPG,char_data/i/DSC03630.JPG_0.jpg,2697,29,338,367,337,430,True,37
i,29,kaist_dataset/Mixed/Digital_Camera/(C.S)C-outdoor4/DSC03556.JPG,char_data/i/DSC03556.JPG_0.jpg,174,6,336,342,324,353,True,37
i,28,kaist_dataset/Mixed/Digital_Camera/(C.S)C-outdoor4/DSC03670.JPG,char_data/i/DSC03670.JPG_0.jpg,196,7,356,363,320,348,True,37
i,42,kaist_dataset/Mixed/Digital_Camera/(C.S)C-outdoor4/DSC03586.JPG,char_data/i/DSC03586.JPG_0.jpg,420,10,468,478,158,200,True,37
i,36,kaist_dataset/Mixed/Digital_Camera/(C.S)C-outdoor2/DSC02912.JPG,char_data/i/DSC02912.JPG_0.jpg,432,12,243,255,9,45,True,37
i,40,kaist_dataset/Mixed/Digital_Camera/(C.S)C-outdoor2/DSC02886.JPG,char_data/i/DSC02886.JPG_0.jpg,520,13,482,495,130,170,True,37
i,25,kaist_dataset/Mixed/Digital_Camera/(C.S)C-outdoor2/DSC02483.JPG,char_data/i/DSC02483.JPG_0.jpg,175,7,335,342,151,176,True,37
i,30,kaist_dataset/Mixed/Digital_Camera/(C.S)C-outdoor2/DSC02385.JPG,char_data/i/DSC02385.JPG_0.jpg,210,7,453,460,139,169,True,37
i,84,kaist_dataset/Mixed/Digital_Camera/(C.S)C-outdoor2/DSC02436.JPG,char_data/i/DSC02436.JPG_0.jpg,1512,18,120,138,171,255,True,37
i,26,kaist_dataset/Mixed/Digital_Camera/(C.S)C-outdoor2/DSC02439.JPG,char_data/i/DSC02439.JPG_0.jpg,234,9,392,401,108,134,True,37
i,69,kaist_dataset/Mixed/Digital_Camera/(C.S)C-outdoor2/DSC02416.JPG,char_data/i/DSC02416.JPG_0.jpg,2139,31,488,519,191,260,True,37
i,57,kaist_dataset/Mixed/Digital_Camera/(C.S)C-outdoor2/DSC02519.JPG,char_data/i/DSC02519.JPG_0.jpg,855,15,241,256,216,273,True,37
i,33,kaist_dataset/Mixed/Digital_Camera/(C.S)C-outdoor2/DSC02545.JPG,char_data/i/DSC02545.JPG_0.jpg,462,14,403,417,365,398,True,37
i,28,kaist_dataset/Mixed/Digital_Camera/(C.S)C-outdoor2/DSC02545.JPG,char_data/i/DSC02545.JPG_0.jpg,364,13,505,518,361,389,True,37
i,28,kaist_dataset/Mixed/Digital_Camera/(C.S)C-outdoor2/DSC02545.JPG,char_data/i/DSC02545.JPG_0.jpg,308,11,543,554,360,388,True,37
i,66,kaist_dataset/Mixed/Digital_Camera/(C.S)C-outdoor2/DSC02907.JPG,char_data/i/DSC02907.JPG_0.jpg,1584,24,275,299,91,157,True,37
i,68,kaist_dataset/Mixed/Digital_Camera/(C.S)C-outdoor2/DSC02936.JPG,char_data/i/DSC02936.JPG_0.jpg,2040,30,373,403,124,192,True,37
i,37,kaist_dataset/Mixed/Digital_Camera/(C.S)C-outdoor2/DSC02936.JPG,char_data/i/DSC02936.JPG_0.jpg,407,11,199,210,77,114,True,37
i,39,kaist_dataset/Mixed/Digital_Camera/(C.S)C-outdoor2/DSC02936.JPG,char_data/i/DSC02936.JPG_0.jpg,390,10,367,377,81,120,True,37
i,99,kaist_dataset/Mixed/Digital_Camera/(C.S)C-outdoor2/DSC02493.JPG,char_data/i/DSC02493.JPG_0.jpg,2871,29,369,398,269,368,True,37
i,63,kaist_dataset/Mixed/Digital_Camera/(C.S)C-outdoor2/DSC02407.JPG,char_data/i/DSC02407.JPG_0.jpg,1197,19,227,246,170,233,True,37
i,60,kaist_dataset/Mixed/Digital_Camera/(C.S)C-outdoor2/DSC02407.JPG,char_data/i/DSC02407.JPG_0.jpg,1140,19,282,301,171,231,True,37
i,23,kaist_dataset/Mixed/Digital_Camera/(C.S)C-outdoor2/DSC02430.JPG,char_data/i/DSC02430.JPG_0.jpg,161,7,39,46,28,51,True,37
i,58,kaist_dataset/Mixed/Digital_Camera/(C.S)A-shadow/DSC03207.JPG,char_data/i/DSC03207.JPG_0.jpg,696,12,313,325,201,259,True,37
i,126,kaist_dataset/English/Mobile_Phone/(E.M)A-outdoor/P090911070.jpg,char_data/i/P090911070.jpg_0.jpg,6048,48,347,395,141,267,True,37
i,136,kaist_dataset/English/Mobile_Phone/(E.M)A-outdoor/P090911070.jpg,char_data/i/P090911070.jpg_0.jpg,7480,55,392,447,137,273,True,37
i,67,kaist_dataset/English/Mobile_Phone/(E.M)B-indoor/P090911080.jpg,char_data/i/P090911080.jpg_0.jpg,1139,17,357,374,227,294,True,37
i,77,kaist_dataset/English/Mobile_Phone/(E.M)B-indoor/P090902018.jpg,char_data/i/P090902018.jpg_0.jpg,1463,19,301,320,175,252,True,37
i,81,kaist_dataset/English/Mobile_Phone/(E.M)B-indoor/P090911067.jpg,char_data/i/P090911067.jpg_0.jpg,2268,28,351,379,202,283,True,37
i,64,kaist_dataset/English/Mobile_Phone/(E.M)B-indoor/P090911081.jpg,char_data/i/P090911081.jpg_0.jpg,1408,22,376,398,216,280,True,37
i,109,kaist_dataset/English/Mobile_Phone/(E.M)B-indoor/P090903002.jpg,char_data/i/P090903002.jpg_0.jpg,4251,39,257,296,284,393,True,37
i,105,kaist_dataset/English/Mobile_Phone/(E.M)B-indoor/P090903002.jpg,char_data/i/P090903002.jpg_0.jpg,4935,47,380,427,290,395,True,37
i,112,kaist_dataset/English/Mobile_Phone/(E.M)B-indoor/P090903003.jpg,char_data/i/P090903003.jpg_0.jpg,4928,44,262,306,245,357,True,37
i,68,kaist_dataset/English/Mobile_Phone/(E.M)B-indoor/P090903008.jpg,char_data/i/P090903008.jpg_0.jpg,1768,26,128,154,27,95,True,37
i,114,kaist_dataset/English/Mobile_Phone/(E.M)C-bookCover/P090831077.jpg,char_data/i/P090831077.jpg_0.jpg,4560,40,422,462,75,189,True,37
i,118,kaist_dataset/English/Mobile_Phone/(E.M)C-bookCover/P090831077.jpg,char_data/i/P090831077.jpg_0.jpg,4012,34,184,218,254,372,True,37
i,124,kaist_dataset/English/Mobile_Phone/(E.M)C-bookCover/P090831077.jpg,char_data/i/P090831077.jpg_0.jpg,4464,36,385,421,255,379,True,37
i,86,kaist_dataset/English/Mobile_Phone/(E.M)C-bookCover/P090831039.jpg,char_data/i/P090831039.jpg_0.jpg,2838,33,325,358,114,200,True,37
i,164,kaist_dataset/English/Mobile_Phone/(E.M)C-bookCover/P090831022.jpg,char_data/i/P090831022.jpg_0.jpg,8200,50,461,511,120,284,True,37
i,39,kaist_dataset/English/Mobile_Phone/(E.M)C-bookCover/P090903030.jpg,char_data/i/P090903030.jpg_0.jpg,546,14,353,367,74,113,True,37
i,96,kaist_dataset/English/Digital_Camera/(E.S)E-night/크기변환_P1010163.JPG,char_data/i/크기변환_P1010163.JPG_0.jpg,4128,43,349,392,79,175,True,37
i,67,kaist_dataset/English/Digital_Camera/(E.S)E-night/111.jpg,char_data/i/111.jpg_0.jpg,2077,31,236,267,187,254,True,37
i,102,kaist_dataset/English/Digital_Camera/(E.S)E-night/DSC02981.JPG,char_data/i/DSC02981.JPG_0.jpg,2652,26,264,290,6,108,True,37
i,128,kaist_dataset/English/Digital_Camera/(E.S)E-night/DSC02981.JPG,char_data/i/DSC02981.JPG_0.jpg,3968,31,288,319,163,291,True,37
i,56,kaist_dataset/English/Digital_Camera/(E.S)C-outdoor2/DSC02998.JPG,char_data/i/DSC02998.JPG_0.jpg,784,14,337,351,413,469,True,37
i,41,kaist_dataset/English/Digital_Camera/(E.S)C-outdoor2/DSC04079.JPG,char_data/i/DSC04079.JPG_0.jpg,656,16,65,81,113,154,True,37
i,36,kaist_dataset/English/Digital_Camera/(E.S)C-outdoor2/DSC04079.JPG,char_data/i/DSC04079.JPG_0.jpg,612,17,269,286,157,193,True,37
i,30,kaist_dataset/English/Digital_Camera/(E.S)C-outdoor2/DSC03208.JPG,char_data/i/DSC03208.JPG_0.jpg,360,12,268,280,164,194,True,37
i,125,kaist_dataset/English/Digital_Camera/(E.S)C-outdoor2/DSC04430.JPG,char_data/i/DSC04430.JPG_0.jpg,6500,52,389,441,142,267,True,37
i,97,kaist_dataset/English/Digital_Camera/(E.S)C-outdoor2/DSC04160.JPG,char_data/i/DSC04160.JPG_0.jpg,3783,39,225,264,341,438,True,37
i,174,kaist_dataset/English/Digital_Camera/(E.S)C-outdoor2/DSC03197.JPG,char_data/i/DSC03197.JPG_0.jpg,10614,61,141,202,48,222,True,37
i,51,kaist_dataset/English/Digital_Camera/(E.S)C-outdoor2/DSC03166.JPG,char_data/i/DSC03166.JPG_0.jpg,867,17,335,352,266,317,True,37
i,71,kaist_dataset/English/Digital_Camera/(E.S)C-outdoor2/DSC04397.JPG,char_data/i/DSC04397.JPG_0.jpg,1420,20,245,265,117,188,True,37
i,92,kaist_dataset/English/Digital_Camera/(E.S)C-outdoor2/DSC03436.JPG,char_data/i/DSC03436.JPG_0.jpg,2576,28,371,399,24,116,True,37
i,57,kaist_dataset/English/Digital_Camera/(E.S)C-outdoor2/DSC03290.JPG,char_data/i/DSC03290.JPG_0.jpg,912,16,358,374,87,144,True,37
i,55,kaist_dataset/English/Digital_Camera/(E.S)C-outdoor2/DSC03290.JPG,char_data/i/DSC03290.JPG_0.jpg,935,17,236,253,404,459,True,37
i,58,kaist_dataset/English/Digital_Camera/(E.S)C-outdoor2/DSC03290.JPG,char_data/i/DSC03290.JPG_0.jpg,870,15,257,272,193,251,True,37
i,46,kaist_dataset/English/Digital_Camera/(E.S)C-outdoor2/DSC03203.JPG,char_data/i/DSC03203.JPG_0.jpg,552,12,137,149,372,418,True,37
i,102,kaist_dataset/English/Digital_Camera/(E.S)C-outdoor2/IMG_2618.JPG,char_data/i/IMG_2618.JPG_0.jpg,3264,32,350,382,161,263,True,37
i,89,kaist_dataset/English/Digital_Camera/(E.S)C-outdoor2/DSC03300.JPG,char_data/i/DSC03300.JPG_0.jpg,3026,34,303,337,141,230,True,37
i,62,kaist_dataset/English/Digital_Camera/(E.S)C-outdoor2/DSC03000.JPG,char_data/i/DSC03000.JPG_0.jpg,2046,33,158,191,287,349,True,37
i,53,kaist_dataset/English/Digital_Camera/(E.S)C-outdoor2/DSC03000.JPG,char_data/i/DSC03000.JPG_0.jpg,1378,26,265,291,290,343,True,37
i,58,kaist_dataset/English/Digital_Camera/(E.S)C-outdoor2/DSC03201.JPG,char_data/i/DSC03201.JPG_0.jpg,754,13,408,421,78,136,True,37
i,122,kaist_dataset/English/Digital_Camera/(E.S)C-outdoor2/DSC03786.JPG,char_data/i/DSC03786.JPG_0.jpg,4758,39,385,424,27,149,True,37
i,128,kaist_dataset/English/Digital_Camera/(E.S)C-outdoor2/DSC03786.JPG,char_data/i/DSC03786.JPG_0.jpg,3968,31,413,444,166,294,True,37
i,151,kaist_dataset/English/Digital_Camera/(E.S)C-outdoor2/DSC04433.JPG,char_data/i/DSC04433.JPG_0.jpg,8305,55,240,295,110,261,True,37
i,84,kaist_dataset/English/Digital_Camera/(E.S)C-outdoor2/DSC03761.JPG,char_data/i/DSC03761.JPG_0.jpg,1848,22,371,393,329,413,True,37
i,47,kaist_dataset/English/Digital_Camera/(E.S)C-outdoor2/DSC04064.JPG,char_data/i/DSC04064.JPG_0.jpg,517,11,347,358,130,177,True,37
i,53,kaist_dataset/English/Digital_Camera/(E.S)C-outdoor2/DSC03262.JPG,char_data/i/DSC03262.JPG_0.jpg,1113,21,144,165,123,176,True,37
i,68,kaist_dataset/English/Digital_Camera/(E.S)C-outdoor2/DSC03192.JPG,char_data/i/DSC03192.JPG_0.jpg,1700,25,358,383,154,222,True,37
i,60,kaist_dataset/English/Digital_Camera/(E.S)C-outdoor2/DSC04163.JPG,char_data/i/DSC04163.JPG_0.jpg,1560,26,465,491,254,314,True,37
i,57,kaist_dataset/English/Digital_Camera/(E.S)C-outdoor2/DSC04035.JPG,char_data/i/DSC04035.JPG_0.jpg,741,13,480,493,190,247,True,37
i,74,kaist_dataset/English/Digital_Camera/(E.S)C-outdoor2/DSC03731.JPG,char_data/i/DSC03731.JPG_0.jpg,2368,32,142,174,43,117,True,37
i,40,kaist_dataset/English/Digital_Camera/(E.S)C-outdoor2/DSC03225.JPG,char_data/i/DSC03225.JPG_0.jpg,520,13,393,406,78,118,True,37
i,40,kaist_dataset/English/Digital_Camera/(E.S)C-outdoor2/DSC03162.JPG,char_data/i/DSC03162.JPG_0.jpg,360,9,226,235,140,180,True,37
i,40,kaist_dataset/English/Digital_Camera/(E.S)C-outdoor2/DSC03162.JPG,char_data/i/DSC03162.JPG_0.jpg,400,10,244,254,138,178,True,37
i,51,kaist_dataset/English/Digital_Camera/(E.S)C-outdoor2/DSC03440.JPG,char_data/i/DSC03440.JPG_0.jpg,510,10,234,244,26,77,True,37
i,60,kaist_dataset/English/Digital_Camera/(E.S)C-outdoor2/DSC03440.JPG,char_data/i/DSC03440.JPG_0.jpg,960,16,295,311,135,195,True,37
i,46,kaist_dataset/English/Digital_Camera/(E.S)C-outdoor2/DSC03664.JPG,char_data/i/DSC03664.JPG_0.jpg,782,17,173,190,23,69,True,37
i,63,kaist_dataset/English/Digital_Camera/(E.S)C-outdoor2/DSC03170.JPG,char_data/i/DSC03170.JPG_0.jpg,1134,18,331,349,299,362,True,37
i,30,kaist_dataset/English/Digital_Camera/(E.S)C-outdoor2/DSC04437.JPG,char_data/i/DSC04437.JPG_0.jpg,330,11,204,215,40,70,True,37
i,26,kaist_dataset/English/Digital_Camera/(E.S)C-outdoor2/DSC04437.JPG,char_data/i/DSC04437.JPG_0.jpg,312,12,302,314,77,103,True,37
i,56,kaist_dataset/English/Digital_Camera/(E.S)C-outdoor2/P1010057.JPG,char_data/i/P1010057.JPG_0.jpg,1120,20,251,271,187,243,True,37
i,139,kaist_dataset/English/Digital_Camera/(E.S)C-outdoor2/DSC03406.JPG,char_data/i/DSC03406.JPG_0.jpg,5977,43,69,112,19,158,True,37
i,170,kaist_dataset/English/Digital_Camera/(E.S)C-outdoor2/DSC03406.JPG,char_data/i/DSC03406.JPG_0.jpg,6970,41,195,236,16,186,True,37
i,59,kaist_dataset/English/Digital_Camera/(E.S)C-outdoor1/DSC02356.JPG,char_data/i/DSC02356.JPG_0.jpg,826,14,317,331,294,353,True,37
i,166,kaist_dataset/English/Digital_Camera/(E.S)C-outdoor1/DSC02354.JPG,char_data/i/DSC02354.JPG_0.jpg,8466,51,285,336,165,331,True,37
i,77,kaist_dataset/English/Digital_Camera/(E.S)C-outdoor1/DSC02514.JPG,char_data/i/DSC02514.JPG_0.jpg,1694,22,299,321,172,249,True,37
i,68,kaist_dataset/English/Digital_Camera/(E.S)C-outdoor1/DSC02514.JPG,char_data/i/DSC02514.JPG_0.jpg,816,12,344,356,179,247,True,37
i,179,kaist_dataset/English/Digital_Camera/(E.S)C-outdoor1/DSC02387.JPG,char_data/i/DSC02387.JPG_0.jpg,9129,51,477,528,108,287,True,37
i,39,kaist_dataset/English/Digital_Camera/(E.S)C-outdoor1/DSC02387.JPG,char_data/i/DSC02387.JPG_0.jpg,312,8,421,429,292,331,True,37
i,65,kaist_dataset/English/Digital_Camera/(E.S)C-outdoor1/1.jpg,char_data/i/1.jpg_0.jpg,1495,23,328,351,123,188,True,37
i,116,kaist_dataset/English/Digital_Camera/(E.S)C-outdoor1/DSC02914.JPG,char_data/i/DSC02914.JPG_0.jpg,4872,42,458,500,186,302,True,37
i,52,kaist_dataset/English/Digital_Camera/(E.S)C-outdoor1/DSC02480.JPG,char_data/i/DSC02480.JPG_0.jpg,676,13,320,333,389,441,True,37
i,241,kaist_dataset/English/Digital_Camera/(E.S)C-outdoor1/080119-0004.jpg,char_data/i/080119-0004.jpg_0.jpg,23136,96,617,713,513,754,True,37
i,26,kaist_dataset/English/Digital_Camera/(E.S)C-outdoor1/056.JPG,char_data/i/056.JPG_0.jpg,156,6,101,107,241,267,True,37
i,24,kaist_dataset/English/Digital_Camera/(E.S)C-outdoor1/056.JPG,char_data/i/056.JPG_0.jpg,120,5,118,123,240,264,True,37
i,81,kaist_dataset/English/Digital_Camera/(E.S)C-outdoor1/056.JPG,char_data/i/056.JPG_0.jpg,2187,27,466,493,159,240,True,37
i,150,kaist_dataset/English/Digital_Camera/(E.S)C-outdoor1/DSC02415.JPG,char_data/i/DSC02415.JPG_0.jpg,8700,58,351,409,43,193,True,37
i,221,kaist_dataset/English/Digital_Camera/(E.S)C-outdoor1/080119-0036.jpg,char_data/i/080119-0036.jpg_0.jpg,14144,64,1013,1077,319,540,True,37
i,53,kaist_dataset/English/Digital_Camera/(E.S)C-outdoor1/DSC02355.JPG,char_data/i/DSC02355.JPG_0.jpg,530,10,130,140,294,347,True,37
i,154,kaist_dataset/English/Digital_Camera/(E.S)C-outdoor1/100.JPG,char_data/i/100.JPG_0.jpg,6160,40,205,245,36,190,True,37
i,149,kaist_dataset/English/Digital_Camera/(E.S)C-outdoor1/100.JPG,char_data/i/100.JPG_0.jpg,5215,35,362,397,40,189,True,37
i,59,kaist_dataset/English/Digital_Camera/(E.S)C-outdoor1/033.jpg,char_data/i/033.jpg_0.jpg,1475,25,115,140,58,117,True,37
i,70,kaist_dataset/English/Digital_Camera/(E.S)C-outdoor1/109.jpg,char_data/i/109.jpg_0.jpg,1470,21,354,375,167,237,True,37
i,148,kaist_dataset/English/Digital_Camera/(E.S)C-outdoor1/2007-12-08-day-015.jpg,char_data/i/2007-12-08-day-015.jpg_0.jpg,16872,114,816,930,627,775,True,37
i,43,kaist_dataset/English/Digital_Camera/(E.S)C-outdoor1/2007-12-08-day-015.jpg,char_data/i/2007-12-08-day-015.jpg_0.jpg,645,15,927,942,815,858,True,37
i,282,kaist_dataset/English/Digital_Camera/(E.S)C-outdoor1/080119-0035.jpg,char_data/i/080119-0035.jpg_0.jpg,25380,90,711,801,736,1018,True,37
i,57,kaist_dataset/English/Digital_Camera/(E.S)C-outdoor1/DSC02500.JPG,char_data/i/DSC02500.JPG_0.jpg,1026,18,515,533,286,343,True,37
i,70,kaist_dataset/English/Digital_Camera/(E.S)C-outdoor1/001.jpg,char_data/i/001.jpg_0.jpg,1890,27,127,154,87,157,True,37
i,164,kaist_dataset/English/Digital_Camera/(E.S)C-outdoor1/2007-12-08-day-098.jpg,char_data/i/2007-12-08-day-098.jpg_0.jpg,7872,48,478,526,486,650,True,37
i,168,kaist_dataset/English/Digital_Camera/(E.S)C-outdoor1/2007-12-08-day-098.jpg,char_data/i/2007-12-08-day-098.jpg_0.jpg,11088,66,1361,1427,468,636,True,37
i,51,kaist_dataset/English/Digital_Camera/(E.S)C-outdoor1/DSC02868.JPG,char_data/i/DSC02868.JPG_0.jpg,408,8,314,322,391,442,False,37
i,35,kaist_dataset/English/Digital_Camera/(E.S)C-outdoor1/DSC02918.JPG,char_data/i/DSC02918.JPG_0.jpg,350,10,312,322,232,267,False,37
i,37,kaist_dataset/English/Digital_Camera/(E.S)C-outdoor1/DSC02918.JPG,char_data/i/DSC02918.JPG_0.jpg,518,14,475,489,225,262,False,37
i,46,kaist_dataset/English/Digital_Camera/(E.S)C-outdoor1/DSC02918.JPG,char_data/i/DSC02918.JPG_0.jpg,1058,23,385,408,176,222,False,37
i,96,kaist_dataset/English/Digital_Camera/(E.S)C-outdoor1/DSC02491.JPG,char_data/i/DSC02491.JPG_0.jpg,1632,17,181,198,212,308,False,37
i,86,kaist_dataset/English/Digital_Camera/(E.S)C-outdoor1/DSC02491.JPG,char_data/i/DSC02491.JPG_0.jpg,1634,19,249,268,218,304,False,37
i,78,kaist_dataset/English/Digital_Camera/(E.S)C-outdoor1/DSC02491.JPG,char_data/i/DSC02491.JPG_0.jpg,1326,17,191,208,136,214,False,37
i,109,kaist_dataset/English/Digital_Camera/(E.S)C-outdoor1/104.jpg,char_data/i/104.jpg_0.jpg,3815,35,252,287,86,195,False,37
i,127,kaist_dataset/English/Digital_Camera/(E.S)B-light/크기변환_%B0%A3%C6%C7_ktimt007.jpg,char_data/i/크기변환_%B0%A3%C6%C7_ktimt007.jpg_0.jpg,4699,37,155,192,181,308,False,37
i,136,kaist_dataset/English/Digital_Camera/(E.S)B-light/크기변환_%B0%A3%C6%C7_ktimt007.jpg,char_data/i/크기변환_%B0%A3%C6%C7_ktimt007.jpg_0.jpg,5984,44,258,302,172,308,False,37
i,94,kaist_dataset/English/Digital_Camera/(E.S)B-light/DSC02587.JPG,char_data/i/DSC02587.JPG_0.jpg,2256,24,354,378,186,280,False,37
i,101,kaist_dataset/English/Digital_Camera/(E.S)B-light/DSC02587.JPG,char_data/i/DSC02587.JPG_0.jpg,2424,24,120,144,316,417,False,37
i,98,kaist_dataset/English/Digital_Camera/(E.S)B-light/DSC02980.JPG,char_data/i/DSC02980.JPG_0.jpg,3626,37,403,440,157,255,False,37
i,62,kaist_dataset/English/Digital_Camera/(E.S)F-others/080119-0007.jpg,char_data/i/080119-0007.jpg_0.jpg,1240,20,954,974,793,855,False,37
i,40,kaist_dataset/English/Digital_Camera/(E.S)F-others/080119-0007.jpg,char_data/i/080119-0007.jpg_0.jpg,520,13,896,909,884,924,False,37
i,40,kaist_dataset/English/Digital_Camera/(E.S)F-others/080119-0007.jpg,char_data/i/080119-0007.jpg_0.jpg,480,12,930,942,877,917,False,37
i,65,kaist_dataset/English/Digital_Camera/(E.S)F-others/080119-0007.jpg,char_data/i/080119-0007.jpg_0.jpg,1430,22,822,844,749,814,False,37
i,66,kaist_dataset/English/Digital_Camera/(E.S)F-others/080119-0007.jpg,char_data/i/080119-0007.jpg_0.jpg,1518,23,1047,1070,705,771,False,37
i,40,kaist_dataset/English/Digital_Camera/(E.S)F-others/DSC03218.JPG,char_data/i/DSC03218.JPG_0.jpg,600,15,227,242,324,364,False,37
i,62,kaist_dataset/English/Digital_Camera/(E.S)A-shadow/DSC03075.JPG,char_data/i/DSC03075.JPG_0.jpg,930,15,146,161,340,402,False,37
i,51,kaist_dataset/English/Digital_Camera/(E.S)A-shadow/DSC03075.JPG,char_data/i/DSC03075.JPG_0.jpg,663,13,336,349,349,400,False,37
i,111,kaist_dataset/English/Digital_Camera/(E.S)A-shadow/DSC03077.JPG,char_data/i/DSC03077.JPG_0.jpg,5328,48,223,271,326,437,False,37
i,56,kaist_dataset/English/Digital_Camera/(E.S)A-shadow/DSC03081.JPG,char_data/i/DSC03081.JPG_0.jpg,672,12,282,294,400,456,False,37
i,77,kaist_dataset/English/Digital_Camera/(E.S)A-shadow/DSC03084.JPG,char_data/i/DSC03084.JPG_0.jpg,924,12,204,216,353,430,False,37
i,79,kaist_dataset/English/Digital_Camera/(E.S)A-shadow/DSC03084.JPG,char_data/i/DSC03084.JPG_0.jpg,1422,18,470,488,350,429,False,37
i,73,kaist_dataset/English/Digital_Camera/(E.S)A-shadow/DSC03084.JPG,char_data/i/DSC03084.JPG_0.jpg,1241,17,503,520,356,429,False,37
i,70,kaist_dataset/English/Digital_Camera/(E.S)A-shadow/IMG_2647.JPG,char_data/i/IMG_2647.JPG_0.jpg,1260,18,188,206,319,389,False,37
i,67,kaist_dataset/English/Digital_Camera/(E.S)A-shadow/IMG_2647.JPG,char_data/i/IMG_2647.JPG_0.jpg,1876,28,369,397,171,238,False,37
i,73,kaist_dataset/English/Digital_Camera/(E.S)D-indoor/DSC03093.JPG,char_data/i/DSC03093.JPG_0.jpg,1752,24,346,370,117,190,False,37
i,74,kaist_dataset/English/Digital_Camera/(E.S)D-indoor/DSC03093.JPG,char_data/i/DSC03093.JPG_0.jpg,1776,24,464,488,116,190,False,37
i,55,kaist_dataset/English/Digital_Camera/(E.S)D-indoor/DSC03093.JPG,char_data/i/DSC03093.JPG_0.jpg,1045,19,420,439,200,255,False,37
i,65,kaist_dataset/English/Digital_Camera/(E.S)D-indoor/DSC03083.JPG,char_data/i/DSC03083.JPG_0.jpg,1040,16,253,269,386,451,False,37
i,66,kaist_dataset/English/Digital_Camera/(E.S)D-indoor/DSC03083.JPG,char_data/i/DSC03083.JPG_0.jpg,924,14,287,301,389,455,False,37
i,33,kaist_dataset/English/Digital_Camera/(E.S)D-indoor/DSC03146.JPG,char_data/i/DSC03146.JPG_0.jpg,429,13,471,484,235,268,False,37
i,64,kaist_dataset/English/Digital_Camera/(E.S)D-indoor/DSC03345.JPG,char_data/i/DSC03345.JPG_0.jpg,1408,22,257,279,87,151,False,37
i,99,kaist_dataset/English/Digital_Camera/(E.S)D-indoor/DSC03080.JPG,char_data/i/DSC03080.JPG_0.jpg,3267,33,180,213,342,441,False,37
i,51,kaist_dataset/English/Digital_Camera/(E.S)D-indoor/크기변환_%B0%A3%C6%C76_fabdent.jpg,char_data/i/크기변환_%B0%A3%C6%C76_fabdent.jpg_0.jpg,408,8,190,198,187,238,False,37
i,119,kaist_dataset/English/Digital_Camera/(E.S)D-indoor/DSC03398.JPG,char_data/i/DSC03398.JPG_0.jpg,3570,30,304,334,304,423,False,37
i,48,kaist_dataset/English/Digital_Camera/(E.S)D-indoor/DSC02859.JPG,char_data/i/DSC02859.JPG_0.jpg,912,19,463,482,343,391,False,37
i,110,kaist_dataset/English/Digital_Camera/(E.S)D-indoor/DSC03918.JPG,char_data/i/DSC03918.JPG_0.jpg,2750,25,269,294,264,374,False,37
i,38,kaist_dataset/English/Digital_Camera/(E.S)D-indoor/DSC04023.JPG,char_data/i/DSC04023.JPG_0.jpg,836,22,244,266,309,347,False,37
i,75,kaist_dataset/English/Digital_Camera/(E.S)D-indoor/DSC03076.JPG,char_data/i/DSC03076.JPG_0.jpg,1575,21,233,254,288,363,False,37
i,62,kaist_dataset/English/Digital_Camera/(E.S)D-indoor/DSC03085.JPG,char_data/i/DSC03085.JPG_0.jpg,1116,18,208,226,371,433,False,37
i,78,kaist_dataset/English/Digital_Camera/(E.S)D-indoor/DSC02860.JPG,char_data/i/DSC02860.JPG_0.jpg,1560,20,330,350,61,139,False,37
i,72,kaist_dataset/English/Digital_Camera/(E.S)D-indoor/DSC02860.JPG,char_data/i/DSC02860.JPG_0.jpg,1512,21,394,415,65,137,False,37
i,81,kaist_dataset/English/Digital_Camera/(E.S)D-indoor/DSC02860.JPG,char_data/i/DSC02860.JPG_0.jpg,1944,24,453,477,63,144,False,37
i,46,kaist_dataset/English/Digital_Camera/(E.S)D-indoor/DSC03947.JPG,char_data/i/DSC03947.JPG_0.jpg,460,10,506,516,410,456,False,37
i,80,kaist_dataset/English/Digital_Camera/(E.S)D-indoor/DSC03883.JPG,char_data/i/DSC03883.JPG_0.jpg,3200,40,243,283,305,385,False,37
i,58,kaist_dataset/English/Digital_Camera/(E.S)D-indoor/DSC03936.JPG,char_data/i/DSC03936.JPG_0.jpg,1044,18,432,450,76,134,False,37
i,61,kaist_dataset/English/Digital_Camera/(E.S)D-indoor/DSC03078.JPG,char_data/i/DSC03078.JPG_0.jpg,1037,17,135,152,222,283,False,37
i,62,kaist_dataset/English/Digital_Camera/(E.S)D-indoor/DSC03078.JPG,char_data/i/DSC03078.JPG_0.jpg,1054,17,431,448,224,286,False,37
i,61,kaist_dataset/English/Digital_Camera/(E.S)D-indoor/DSC03078.JPG,char_data/i/DSC03078.JPG_0.jpg,1098,18,395,413,299,360,False,37
i,35,kaist_dataset/English/Digital_Camera/(E.S)D-indoor/080119-0009.jpg,char_data/i/080119-0009.jpg_0.jpg,595,17,842,859,684,719,False,37
i,41,kaist_dataset/English/Digital_Camera/(E.S)D-indoor/080119-0009.jpg,char_data/i/080119-0009.jpg_0.jpg,451,11,786,797,1066,1107,False,37
i,48,kaist_dataset/English/Digital_Camera/(E.S)D-indoor/080119-0009.jpg,char_data/i/080119-0009.jpg_0.jpg,816,17,945,962,1079,1127,False,37
i,43,kaist_dataset/English/Digital_Camera/(E.S)D-indoor/080119-0009.jpg,char_data/i/080119-0009.jpg_0.jpg,430,10,760,770,1102,1145,False,37
i,48,kaist_dataset/English/Digital_Camera/(E.S)D-indoor/080119-0009.jpg,char_data/i/080119-0009.jpg_0.jpg,480,10,638,648,957,1005,False,37
i,43,kaist_dataset/English/Digital_Camera/(E.S)D-indoor/080119-0009.jpg,char_data/i/080119-0009.jpg_0.jpg,602,14,820,834,1001,1044,False,37
i,28,kaist_dataset/English/Digital_Camera/(E.S)D-indoor/DSC03532.JPG,char_data/i/DSC03532.JPG_0.jpg,224,8,145,153,381,409,False,37
i,31,kaist_dataset/English/Digital_Camera/(E.S)D-indoor/DSC03532.JPG,char_data/i/DSC03532.JPG_0.jpg,217,7,315,322,379,410,False,37
i,33,kaist_dataset/English/Digital_Camera/(E.S)D-indoor/DSC03532.JPG,char_data/i/DSC03532.JPG_0.jpg,264,8,582,590,372,405,False,37
i,51,kaist_dataset/English/Digital_Camera/(E.S)D-indoor/DSC03396.JPG,char_data/i/DSC03396.JPG_0.jpg,561,11,479,490,337,388,False,37
i,41,kaist_dataset/English/Digital_Camera/(E.S)D-indoor/DSC03112.JPG,char_data/i/DSC03112.JPG_0.jpg,328,8,413,421,208,249,False,37
i,76,kaist_dataset/English/Digital_Camera/(E.S)C-outdoor3/크기변환_%B0%A3%C6%C71_fabdent.jpg,char_data/i/크기변환_%B0%A3%C6%C71_fabdent.jpg_0.jpg,1824,24,460,484,227,303,False,37
i,19,kaist_dataset/English/Digital_Camera/(E.S)C-outdoor3/크기변환_P1010076.JPG,char_data/i/크기변환_P1010076.JPG_0.jpg,76,4,232,236,105,124,False,37
i,31,kaist_dataset/English/Digital_Camera/(E.S)C-outdoor3/P1010123.JPG,char_data/i/P1010123.JPG_0.jpg,217,7,524,531,65,96,False,37
i,28,kaist_dataset/English/Digital_Camera/(E.S)C-outdoor3/P1010123.JPG,char_data/i/P1010123.JPG_0.jpg,280,10,29,39,73,101,False,37
