char,height,origin_path,path,seg_areas,src_height,src_width,width,x1,x2,y1,y2,isTrain,label
8,24,kaist_dataset/English/Digital_Camera/(E.S)C-outdoor1/042.JPG,char_data/8/042.JPG_2.jpg,456,480,640,19,485,504,321,345,True,10
8,27,kaist_dataset/English/Digital_Camera/(E.S)C-outdoor1/056.JPG,char_data/8/056.JPG_2.jpg,432,480,640,16,513,529,249,276,True,10
8,32,kaist_dataset/English/Digital_Camera/(E.S)C-outdoor1/077.JPG,char_data/8/077.JPG_2.jpg,544,480,640,17,276,293,248,280,True,10
8,37,kaist_dataset/English/Digital_Camera/(E.S)C-outdoor1/DSC02364.JPG,char_data/8/DSC02364.JPG_6.jpg,518,480,640,14,325,339,350,387,True,10
8,36,kaist_dataset/English/Digital_Camera/(E.S)C-outdoor1/DSC02364.JPG,char_data/8/DSC02364.JPG_7.jpg,756,480,640,21,486,507,353,389,True,10
8,34,kaist_dataset/English/Digital_Camera/(E.S)C-outdoor1/DSC02364.JPG,char_data/8/DSC02364.JPG_8.jpg,544,480,640,16,549,565,353,387,True,10
8,44,kaist_dataset/English/Digital_Camera/(E.S)C-outdoor1/DSC02415.JPG,char_data/8/DSC02415.JPG_2.jpg,1144,480,640,26,393,419,250,294,True,10
8,42,kaist_dataset/English/Digital_Camera/(E.S)C-outdoor1/DSC02450.JPG,char_data/8/DSC02450.JPG_6.jpg,1386,480,640,33,109,142,222,264,True,10
8,43,kaist_dataset/English/Digital_Camera/(E.S)C-outdoor1/DSC02450.JPG,char_data/8/DSC02450.JPG_7.jpg,1462,480,640,34,265,299,222,265,True,10
8,41,kaist_dataset/English/Digital_Camera/(E.S)C-outdoor1/DSC02450.JPG,char_data/8/DSC02450.JPG_8.jpg,1189,480,640,29,353,382,221,262,True,10
8,82,kaist_dataset/English/Digital_Camera/(E.S)C-outdoor1/DSC02491.JPG,char_data/8/DSC02491.JPG_2.jpg,3772,480,640,46,238,284,315,397,True,10
8,44,kaist_dataset/English/Digital_Camera/(E.S)C-outdoor2/DSC03053.JPG,char_data/8/DSC03053.JPG_4.jpg,1188,480,640,27,335,362,128,172,True,10
8,42,kaist_dataset/English/Digital_Camera/(E.S)C-outdoor2/DSC03053.JPG,char_data/8/DSC03053.JPG_5.jpg,1176,480,640,28,513,541,128,170,True,10
8,54,kaist_dataset/English/Digital_Camera/(E.S)C-outdoor2/DSC03161.JPG,char_data/8/DSC03161.JPG_4.jpg,1674,480,640,31,138,169,221,275,True,10
8,50,kaist_dataset/English/Digital_Camera/(E.S)C-outdoor2/DSC03161.JPG,char_data/8/DSC03161.JPG_5.jpg,1650,480,640,33,200,233,223,273,True,10
8,32,kaist_dataset/English/Digital_Camera/(E.S)C-outdoor2/DSC03162.JPG,char_data/8/DSC03162.JPG_2.jpg,448,480,640,14,425,439,149,181,True,10
8,58,kaist_dataset/English/Digital_Camera/(E.S)C-outdoor2/DSC03201.JPG,char_data/8/DSC03201.JPG_2.jpg,2146,480,640,37,364,401,11,69,True,10
8,33,kaist_dataset/English/Digital_Camera/(E.S)C-outdoor2/DSC03436.JPG,char_data/8/DSC03436.JPG_2.jpg,825,480,640,25,221,246,126,159,True,10
8,65,kaist_dataset/English/Digital_Camera/(E.S)C-outdoor2/DSC04163.JPG,char_data/8/DSC04163.JPG_2.jpg,2535,480,640,39,194,233,316,381,True,10
8,50,kaist_dataset/English/Digital_Camera/(E.S)C-outdoor3/P1010086.JPG,char_data/8/P1010086.JPG_6.jpg,1550,480,640,31,423,454,96,146,True,10
8,49,kaist_dataset/English/Digital_Camera/(E.S)C-outdoor3/P1010086.JPG,char_data/8/P1010086.JPG_7.jpg,1323,480,640,27,453,480,96,145,True,10
8,22,kaist_dataset/English/Digital_Camera/(E.S)C-outdoor3/크기변환_P1010076.JPG,char_data/8/크기변환_P1010076.JPG_6.jpg,242,480,640,11,581,592,181,203,True,10
8,23,kaist_dataset/English/Digital_Camera/(E.S)C-outdoor3/크기변환_P1010076.JPG,char_data/8/크기변환_P1010076.JPG_7.jpg,207,480,640,9,595,604,182,205,True,10
8,24,kaist_dataset/English/Digital_Camera/(E.S)C-outdoor3/크기변환_P1010076.JPG,char_data/8/크기변환_P1010076.JPG_8.jpg,360,480,640,15,611,626,179,203,True,10
8,59,kaist_dataset/English/Digital_Camera/(E.S)E-night/DSC02610.JPG,char_data/8/DSC02610.JPG_4.jpg,2006,480,640,34,50,84,388,447,True,10
8,52,kaist_dataset/English/Digital_Camera/(E.S)E-night/DSC02610.JPG,char_data/8/DSC02610.JPG_5.jpg,2132,480,640,41,265,306,378,430,True,10
8,30,kaist_dataset/English/Digital_Camera/(E.S)F-others/DSC02923.JPG,char_data/8/DSC02923.JPG_4.jpg,360,480,640,12,295,307,401,431,True,10
8,31,kaist_dataset/English/Digital_Camera/(E.S)F-others/DSC02923.JPG,char_data/8/DSC02923.JPG_5.jpg,589,480,640,19,338,357,395,426,True,10
8,42,kaist_dataset/English/Digital_Camera/(E.S)F-others/m.jpg,char_data/8/m.jpg_2.jpg,672,240,320,16,111,127,171,213,True,10
8,48,kaist_dataset/Korean/Digital_Camera/A-shadow/2007-12-09-day-exterior-025.jpg,char_data/8/2007-12-09-day-exterior-025.jpg_4.jpg,1776,1200,1600,37,918,955,735,783,True,10
8,54,kaist_dataset/Korean/Digital_Camera/A-shadow/2007-12-09-day-exterior-025.jpg,char_data/8/2007-12-09-day-exterior-025.jpg_5.jpg,1728,1200,1600,32,1060,1092,735,789,True,10
8,73,kaist_dataset/Korean/Digital_Camera/A-shadow/2007-12-09-day-exterior-026.jpg,char_data/8/2007-12-09-day-exterior-026.jpg_2.jpg,3212,1200,1600,44,875,919,754,827,True,10
8,93,kaist_dataset/Korean/Digital_Camera/A-shadow/2007-12-09-day-exterior-031.jpg,char_data/8/2007-12-09-day-exterior-031.jpg_4.jpg,5580,1200,1600,60,543,603,658,751,True,10
8,78,kaist_dataset/Korean/Digital_Camera/A-shadow/2007-12-09-day-exterior-031.jpg,char_data/8/2007-12-09-day-exterior-031.jpg_5.jpg,3744,1200,1600,48,841,889,667,745,True,10
8,33,kaist_dataset/Korean/Digital_Camera/A-shadow/2007-12-09-day-exterior-040.jpg,char_data/8/2007-12-09-day-exterior-040.jpg_4.jpg,726,1200,1600,22,958,980,815,848,True,10
8,33,kaist_dataset/Korean/Digital_Camera/A-shadow/2007-12-09-day-exterior-040.jpg,char_data/8/2007-12-09-day-exterior-040.jpg_5.jpg,693,1200,1600,21,1076,1097,815,848,True,10
8,36,kaist_dataset/Korean/Digital_Camera/A-shadow/DSC02598.JPG,char_data/8/DSC02598.JPG_4.jpg,792,480,640,22,501,523,415,451,True,10
8,168,kaist_dataset/Korean/Digital_Camera/A-shadow/DSC02670.JPG,char_data/8/DSC02670.JPG_2.jpg,14112,480,640,84,6,90,24,192,True,10
8,51,kaist_dataset/Korean/Digital_Camera/A-shadow/DSC03536.JPG,char_data/8/DSC03536.JPG_4.jpg,1530,480,640,30,94,124,271,322,True,10
8,75,kaist_dataset/Korean/Digital_Camera/A-shadow/DSC03536.JPG,char_data/8/DSC03536.JPG_5.jpg,3150,480,640,42,226,268,244,319,True,10
8,132,kaist_dataset/Korean/Digital_Camera/A-shadow/DSC04300.JPG,char_data/8/DSC04300.JPG_2.jpg,8580,480,640,65,97,162,222,354,True,10
8,54,kaist_dataset/Korean/Digital_Camera/A-shadow/DSC04315.JPG,char_data/8/DSC04315.JPG_2.jpg,1944,480,640,36,104,140,410,464,True,10
8,29,kaist_dataset/Korean/Digital_Camera/B-light/DSC02987.JPG,char_data/8/DSC02987.JPG_10.jpg,377,480,640,13,405,418,277,306,True,10
8,28,kaist_dataset/Korean/Digital_Camera/B-light/DSC02987.JPG,char_data/8/DSC02987.JPG_11.jpg,336,480,640,12,511,523,280,308,True,10
8,28,kaist_dataset/Korean/Digital_Camera/B-light/DSC02987.JPG,char_data/8/DSC02987.JPG_12.jpg,392,480,640,14,523,537,278,306,True,10
8,31,kaist_dataset/Korean/Digital_Camera/B-light/DSC02987.JPG,char_data/8/DSC02987.JPG_13.jpg,403,480,640,13,557,570,279,310,True,10
8,34,kaist_dataset/Korean/Digital_Camera/B-light/DSC02987.JPG,char_data/8/DSC02987.JPG_14.jpg,476,480,640,14,570,584,277,311,True,10
8,20,kaist_dataset/Korean/Digital_Camera/E-night/103.jpg,char_data/8/103.jpg_2.jpg,120,480,640,6,177,183,313,333,True,10
8,59,kaist_dataset/Korean/Digital_Camera/E-night/DSC02594.JPG,char_data/8/DSC02594.JPG_6.jpg,2714,480,640,46,92,138,378,437,True,10
8,58,kaist_dataset/Korean/Digital_Camera/E-night/DSC02594.JPG,char_data/8/DSC02594.JPG_7.jpg,2088,480,640,36,334,370,371,429,True,10
8,57,kaist_dataset/Korean/Digital_Camera/E-night/DSC02594.JPG,char_data/8/DSC02594.JPG_8.jpg,2394,480,640,42,424,466,372,429,True,10
8,45,kaist_dataset/Korean/Digital_Camera/E-night/DSC02597.JPG,char_data/8/DSC02597.JPG_6.jpg,1530,480,640,34,374,408,290,335,True,10
8,55,kaist_dataset/Korean/Digital_Camera/E-night/DSC02597.JPG,char_data/8/DSC02597.JPG_7.jpg,1705,480,640,31,510,541,289,344,True,10
8,58,kaist_dataset/Korean/Digital_Camera/E-night/DSC02597.JPG,char_data/8/DSC02597.JPG_8.jpg,1798,480,640,31,573,604,285,343,True,10
8,33,kaist_dataset/Korean/Digital_Camera/E-night/DSC02626.JPG,char_data/8/DSC02626.JPG_4.jpg,528,480,640,16,85,101,377,410,True,10
8,32,kaist_dataset/Korean/Digital_Camera/E-night/DSC02626.JPG,char_data/8/DSC02626.JPG_5.jpg,544,480,640,17,270,287,368,400,True,10
8,49,kaist_dataset/Korean/Digital_Camera/E-night/DSC02645.JPG,char_data/8/DSC02645.JPG_2.jpg,1568,480,640,32,295,327,333,382,True,10
8,41,kaist_dataset/Korean/Digital_Camera/E-night/DSC02649.JPG,char_data/8/DSC02649.JPG_2.jpg,1066,480,640,26,445,471,393,434,True,10
8,37,kaist_dataset/Korean/Digital_Camera/E-night/DSC02658.JPG,char_data/8/DSC02658.JPG_2.jpg,1036,480,640,28,213,241,356,393,True,10
8,48,kaist_dataset/Korean/Digital_Camera/E-night/DSC03515.JPG,char_data/8/DSC03515.JPG_2.jpg,864,480,640,18,562,580,270,318,True,10
8,29,kaist_dataset/Korean/Digital_Camera/E-night/P1010146.JPG,char_data/8/P1010146.JPG_2.jpg,435,480,640,15,289,304,250,279,True,10
8,25,kaist_dataset/Korean/Digital_Camera/E-night/P1010149.JPG,char_data/8/P1010149.JPG_2.jpg,275,480,640,11,549,560,242,267,True,10
8,50,kaist_dataset/Korean/Digital_Camera/G-others/2007-12-08-day-045.jpg,char_data/8/2007-12-08-day-045.jpg_6.jpg,950,1200,1600,19,102,121,795,845,True,10
8,48,kaist_dataset/Korean/Digital_Camera/G-others/2007-12-08-day-045.jpg,char_data/8/2007-12-08-day-045.jpg_7.jpg,912,1200,1600,19,157,176,791,839,True,10
8,44,kaist_dataset/Korean/Digital_Camera/G-others/2007-12-08-day-045.jpg,char_data/8/2007-12-08-day-045.jpg_8.jpg,660,1200,1600,15,193,208,790,834,True,10
8,82,kaist_dataset/Korean/Digital_Camera/G-others/2007-12-08-day-108.jpg,char_data/8/2007-12-08-day-108.jpg_8.jpg,3608,1200,1600,44,728,772,632,714,True,10
8,79,kaist_dataset/Korean/Digital_Camera/G-others/2007-12-08-day-108.jpg,char_data/8/2007-12-08-day-108.jpg_9.jpg,3081,1200,1600,39,919,958,697,776,True,10
8,80,kaist_dataset/Korean/Digital_Camera/G-others/2007-12-08-day-108.jpg,char_data/8/2007-12-08-day-108.jpg_10.jpg,3120,1200,1600,39,808,847,745,825,True,10
8,75,kaist_dataset/Korean/Digital_Camera/G-others/2007-12-08-day-108.jpg,char_data/8/2007-12-08-day-108.jpg_11.jpg,3075,1200,1600,41,938,979,783,858,True,10
8,109,kaist_dataset/Korean/Digital_Camera/G-others/2007-12-09-day-exterior-062.jpg,char_data/8/2007-12-09-day-exterior-062.jpg_2.jpg,4142,1600,1200,38,466,504,1395,1504,True,10
8,39,kaist_dataset/Korean/Digital_Camera/G-others/2007-12-09-day-exterior-083.jpg,char_data/8/2007-12-09-day-exterior-083.jpg_4.jpg,1326,1600,1200,34,511,545,969,1008,True,10
8,53,kaist_dataset/Korean/Digital_Camera/G-others/2007-12-09-day-exterior-083.jpg,char_data/8/2007-12-09-day-exterior-083.jpg_5.jpg,2650,1600,1200,50,278,328,127,180,True,10
8,56,kaist_dataset/Korean/Digital_Camera/G-others/DSC03434.JPG,char_data/8/DSC03434.JPG_6.jpg,1624,480,640,29,265,294,24,80,True,10
8,50,kaist_dataset/Korean/Digital_Camera/G-others/DSC03434.JPG,char_data/8/DSC03434.JPG_7.jpg,1550,480,640,31,344,375,29,79,True,10
8,55,kaist_dataset/Korean/Digital_Camera/G-others/DSC03434.JPG,char_data/8/DSC03434.JPG_8.jpg,1760,480,640,32,397,429,29,84,True,10
8,28,kaist_dataset/Korean/Digital_Camera/G-others/DSC03863.JPG,char_data/8/DSC03863.JPG_2.jpg,308,480,640,11,180,191,407,435,True,10
8,63,kaist_dataset/Korean/Digital_Camera/indoor1/080119-0018.jpg,char_data/8/080119-0018.jpg_2.jpg,1953,1200,1600,31,854,885,439,502,True,10
8,56,kaist_dataset/Korean/Digital_Camera/indoor2/DSC03474.JPG,char_data/8/DSC03474.JPG_4.jpg,2016,480,640,36,271,307,151,207,True,10
8,56,kaist_dataset/Korean/Digital_Camera/indoor2/DSC03474.JPG,char_data/8/DSC03474.JPG_5.jpg,1512,480,640,27,410,437,150,206,True,10
8,57,kaist_dataset/Korean/Digital_Camera/indoor2/DSC03475.JPG,char_data/8/DSC03475.JPG_2.jpg,2166,480,640,38,494,532,89,146,True,10
8,88,kaist_dataset/Korean/Digital_Camera/indoor2/DSC03565.JPG,char_data/8/DSC03565.JPG_2.jpg,5544,480,640,63,228,291,274,362,True,10
8,30,kaist_dataset/Korean/Digital_Camera/indoor2/DSC03975.JPG,char_data/8/DSC03975.JPG_2.jpg,450,480,640,15,151,166,294,324,True,10
8,36,kaist_dataset/Korean/Digital_Camera/indoor2/DSC03983.JPG,char_data/8/DSC03983.JPG_2.jpg,864,480,640,24,279,303,325,361,True,10
8,75,kaist_dataset/Korean/Digital_Camera/indoor2/DSC04006.JPG,char_data/8/DSC04006.JPG_2.jpg,2400,480,640,32,275,307,149,224,True,10
8,55,kaist_dataset/Korean/Digital_Camera/indoor2/DSC04204.JPG,char_data/8/DSC04204.JPG_8.jpg,1870,480,640,34,283,317,202,257,True,10
8,53,kaist_dataset/Korean/Digital_Camera/indoor2/DSC04204.JPG,char_data/8/DSC04204.JPG_9.jpg,1696,480,640,32,318,350,202,255,True,10
8,40,kaist_dataset/Korean/Digital_Camera/indoor2/DSC04204.JPG,char_data/8/DSC04204.JPG_10.jpg,880,480,640,22,326,348,280,320,True,10
8,46,kaist_dataset/Korean/Digital_Camera/indoor2/DSC04204.JPG,char_data/8/DSC04204.JPG_11.jpg,1058,480,640,23,453,476,277,323,True,10
8,64,kaist_dataset/Korean/Digital_Camera/indoor2/P071209063.jpg,char_data/8/P071209063.jpg_2.jpg,4096,1200,1600,64,958,1022,1074,1138,True,10
8,86,kaist_dataset/Korean/Digital_Camera/indoor2/크기변환_%BD%C7%B3%BB%B0%A3%C6%C7_moon8481.jpg,char_data/8/크기변환_%BD%C7%B3%BB%B0%A3%C6%C7_moon8481.jpg_4.jpg,4214,480,640,49,383,432,338,424,True,10
8,82,kaist_dataset/Korean/Digital_Camera/indoor2/크기변환_%BD%C7%B3%BB%B0%A3%C6%C7_moon8481.jpg,char_data/8/크기변환_%BD%C7%B3%BB%B0%A3%C6%C7_moon8481.jpg_5.jpg,3608,480,640,44,474,518,342,424,True,10
8,24,kaist_dataset/Korean/Digital_Camera/outdoor1/002.JPG,char_data/8/002.JPG_2.jpg,360,480,640,15,333,348,374,398,True,10
8,19,kaist_dataset/Korean/Digital_Camera/outdoor1/006.JPG,char_data/8/006.JPG_4.jpg,342,480,640,18,275,293,256,275,True,10
8,18,kaist_dataset/Korean/Digital_Camera/outdoor1/006.JPG,char_data/8/006.JPG_5.jpg,324,480,640,18,402,420,254,272,True,10
8,24,kaist_dataset/Korean/Digital_Camera/outdoor1/011.JPG,char_data/8/011.JPG_2.jpg,552,480,640,23,342,365,256,280,True,10
8,15,kaist_dataset/Korean/Digital_Camera/outdoor1/013.JPG,char_data/8/013.JPG_4.jpg,255,480,640,17,358,375,254,269,True,10
8,16,kaist_dataset/Korean/Digital_Camera/outdoor1/013.JPG,char_data/8/013.JPG_5.jpg,144,480,640,9,405,414,251,267,True,10
8,20,kaist_dataset/Korean/Digital_Camera/outdoor1/017.JPG,char_data/8/017.JPG_2.jpg,400,480,640,20,406,426,273,293,True,10
8,27,kaist_dataset/Korean/Digital_Camera/outdoor1/023.JPG,char_data/8/023.JPG_2.jpg,621,480,640,23,144,167,271,298,True,10
8,21,kaist_dataset/Korean/Digital_Camera/outdoor1/028.JPG,char_data/8/028.JPG_2.jpg,357,480,640,17,283,300,265,286,True,10
8,38,kaist_dataset/Korean/Digital_Camera/outdoor1/029.JPG,char_data/8/029.JPG_2.jpg,950,480,640,25,232,257,286,324,True,10
8,31,kaist_dataset/Korean/Digital_Camera/outdoor1/032.JPG,char_data/8/032.JPG_6.jpg,713,480,640,23,64,87,256,287,True,10
8,22,kaist_dataset/Korean/Digital_Camera/outdoor1/032.JPG,char_data/8/032.JPG_7.jpg,418,480,640,19,245,264,260,282,True,10
8,30,kaist_dataset/Korean/Digital_Camera/outdoor1/032.JPG,char_data/8/032.JPG_8.jpg,600,480,640,20,418,438,255,285,True,10
8,31,kaist_dataset/Korean/Digital_Camera/outdoor1/035.JPG,char_data/8/035.JPG_4.jpg,744,480,640,24,249,273,287,318,True,10
8,30,kaist_dataset/Korean/Digital_Camera/outdoor1/035.JPG,char_data/8/035.JPG_5.jpg,570,480,640,19,455,474,288,318,True,10
8,28,kaist_dataset/Korean/Digital_Camera/outdoor1/040.JPG,char_data/8/040.JPG_2.jpg,868,480,640,31,217,248,297,325,True,10
8,44,kaist_dataset/Korean/Digital_Camera/outdoor1/052.JPG,char_data/8/052.JPG_2.jpg,1232,480,640,28,236,264,318,362,True,10
8,37,kaist_dataset/Korean/Digital_Camera/outdoor1/059.JPG,char_data/8/059.JPG_2.jpg,703,480,640,19,377,396,320,357,True,10
8,26,kaist_dataset/Korean/Digital_Camera/outdoor1/069.JPG,char_data/8/069.JPG_2.jpg,468,480,640,18,257,275,270,296,True,10
8,15,kaist_dataset/Korean/Digital_Camera/outdoor1/070.JPG,char_data/8/070.JPG_2.jpg,165,480,640,11,362,373,254,269,True,10
8,22,kaist_dataset/Korean/Digital_Camera/outdoor1/071.JPG,char_data/8/071.JPG_2.jpg,506,480,640,23,238,261,261,283,True,10
8,32,kaist_dataset/Korean/Digital_Camera/outdoor1/102.JPG,char_data/8/102.JPG_2.jpg,672,480,640,21,329,350,309,341,True,10
8,38,kaist_dataset/Korean/Digital_Camera/outdoor1/120.JPG,char_data/8/120.JPG_2.jpg,1596,480,640,42,197,239,294,332,True,10
8,33,kaist_dataset/Korean/Digital_Camera/outdoor1/123.JPG,char_data/8/123.JPG_4.jpg,660,480,640,20,343,363,273,306,True,10
8,30,kaist_dataset/Korean/Digital_Camera/outdoor1/123.JPG,char_data/8/123.JPG_5.jpg,630,480,640,21,168,189,280,310,True,10
8,27,kaist_dataset/Korean/Digital_Camera/outdoor1/125.JPG,char_data/8/125.JPG_2.jpg,540,480,640,20,267,287,259,286,True,10
8,21,kaist_dataset/Korean/Digital_Camera/outdoor1/126.JPG,char_data/8/126.JPG_4.jpg,525,480,640,25,218,243,267,288,True,10
8,26,kaist_dataset/Korean/Digital_Camera/outdoor1/126.JPG,char_data/8/126.JPG_5.jpg,312,480,640,12,492,504,256,282,True,10
8,45,kaist_dataset/Korean/Digital_Camera/outdoor1/127.JPG,char_data/8/127.JPG_4.jpg,1350,480,640,30,211,241,269,314,True,10
8,41,kaist_dataset/Korean/Digital_Camera/outdoor1/127.JPG,char_data/8/127.JPG_5.jpg,1025,480,640,25,342,367,270,311,True,10
8,51,kaist_dataset/Korean/Digital_Camera/outdoor1/2007-12-08-day-047.jpg,char_data/8/2007-12-08-day-047.jpg_2.jpg,1734,1200,1600,34,823,857,706,757,True,10
8,59,kaist_dataset/Korean/Digital_Camera/outdoor1/2007-12-08-day-057.jpg,char_data/8/2007-12-08-day-057.jpg_4.jpg,2537,1200,1600,43,793,836,602,661,True,10
8,76,kaist_dataset/Korean/Digital_Camera/outdoor1/2007-12-08-day-057.jpg,char_data/8/2007-12-08-day-057.jpg_5.jpg,3420,1200,1600,45,1069,1114,590,666,True,10
8,68,kaist_dataset/Korean/Digital_Camera/outdoor1/46.JPG,char_data/8/46.JPG_4.jpg,2992,576,768,44,157,201,368,436,True,10
8,70,kaist_dataset/Korean/Digital_Camera/outdoor1/46.JPG,char_data/8/46.JPG_5.jpg,2380,576,768,34,393,427,364,434,True,10
8,34,kaist_dataset/Korean/Digital_Camera/outdoor1/50.JPG,char_data/8/50.JPG_2.jpg,714,576,768,21,300,321,336,370,True,10
8,43,kaist_dataset/Korean/Digital_Camera/outdoor1/54.JPG,char_data/8/54.JPG_4.jpg,1462,523,767,34,374,408,364,407,True,10
8,45,kaist_dataset/Korean/Digital_Camera/outdoor1/54.JPG,char_data/8/54.JPG_5.jpg,1170,523,767,26,523,549,364,409,True,10
8,68,kaist_dataset/Korean/Digital_Camera/outdoor2/2007-12-08-day-101.jpg,char_data/8/2007-12-08-day-101.jpg_4.jpg,2448,1200,1600,36,723,759,634,702,True,10
8,37,kaist_dataset/Korean/Digital_Camera/outdoor2/2007-12-08-day-101.jpg,char_data/8/2007-12-08-day-101.jpg_5.jpg,703,1200,1600,19,808,827,743,780,True,10
8,67,kaist_dataset/Korean/Digital_Camera/outdoor2/2007-12-09-day-exterior-009.jpg,char_data/8/2007-12-09-day-exterior-009.jpg_2.jpg,2747,1200,1600,41,699,740,684,751,True,10
8,77,kaist_dataset/Korean/Digital_Camera/outdoor2/2007-12-09-day-exterior-012.jpg,char_data/8/2007-12-09-day-exterior-012.jpg_8.jpg,4158,1200,1600,54,1009,1063,621,698,True,10
8,78,kaist_dataset/Korean/Digital_Camera/outdoor2/2007-12-09-day-exterior-012.jpg,char_data/8/2007-12-09-day-exterior-012.jpg_9.jpg,4134,1200,1600,53,1179,1232,620,698,True,10
8,79,kaist_dataset/Korean/Digital_Camera/outdoor2/2007-12-09-day-exterior-012.jpg,char_data/8/2007-12-09-day-exterior-012.jpg_10.jpg,3713,1200,1600,47,1234,1281,620,699,True,10
8,75,kaist_dataset/Korean/Digital_Camera/outdoor2/2007-12-09-day-exterior-012.jpg,char_data/8/2007-12-09-day-exterior-012.jpg_11.jpg,3900,1200,1600,52,1281,1333,621,696,True,10
8,58,kaist_dataset/Korean/Digital_Camera/outdoor2/2007-12-09-day-exterior-016.jpg,char_data/8/2007-12-09-day-exterior-016.jpg_4.jpg,1740,1200,1600,30,27,57,355,413,True,10
8,59,kaist_dataset/Korean/Digital_Camera/outdoor2/2007-12-09-day-exterior-016.jpg,char_data/8/2007-12-09-day-exterior-016.jpg_5.jpg,2419,1200,1600,41,508,549,748,807,True,10
8,63,kaist_dataset/Korean/Digital_Camera/outdoor2/2007-12-09-day-exterior-033.jpg,char_data/8/2007-12-09-day-exterior-033.jpg_2.jpg,5607,1200,1600,89,403,492,726,789,True,10
8,51,kaist_dataset/Korean/Digital_Camera/outdoor2/2007-12-09-day-exterior-035.jpg,char_data/8/2007-12-09-day-exterior-035.jpg_4.jpg,1785,1200,1600,35,409,444,709,760,True,10
8,59,kaist_dataset/Korean/Digital_Camera/outdoor2/2007-12-09-day-exterior-035.jpg,char_data/8/2007-12-09-day-exterior-035.jpg_5.jpg,1947,1200,1600,33,601,634,708,767,True,10
8,35,kaist_dataset/Korean/Digital_Camera/outdoor2/2007-12-09-day-exterior-036.jpg,char_data/8/2007-12-09-day-exterior-036.jpg_2.jpg,805,1200,1600,23,1434,1457,629,664,True,10
8,40,kaist_dataset/Korean/Digital_Camera/outdoor2/2007-12-09-day-exterior-084.jpg,char_data/8/2007-12-09-day-exterior-084.jpg_2.jpg,1680,1200,1600,42,722,764,806,846,True,10
8,32,kaist_dataset/Korean/Digital_Camera/outdoor2/DSC02299.JPG,char_data/8/DSC02299.JPG_2.jpg,736,480,640,23,557,580,210,242,True,10
8,30,kaist_dataset/Korean/Digital_Camera/outdoor2/DSC02304.JPG,char_data/8/DSC02304.JPG_2.jpg,810,480,640,27,225,252,261,291,True,10
8,54,kaist_dataset/Korean/Digital_Camera/outdoor2/DSC02305.JPG,char_data/8/DSC02305.JPG_4.jpg,2268,480,640,42,321,363,248,302,True,10
8,52,kaist_dataset/Korean/Digital_Camera/outdoor2/DSC02305.JPG,char_data/8/DSC02305.JPG_5.jpg,1976,480,640,38,565,603,247,299,True,10
8,29,kaist_dataset/Korean/Digital_Camera/outdoor2/DSC02308.JPG,char_data/8/DSC02308.JPG_2.jpg,1044,480,640,36,222,258,241,270,True,10
8,32,kaist_dataset/Korean/Digital_Camera/outdoor2/DSC02310.JPG,char_data/8/DSC02310.JPG_2.jpg,1056,480,640,33,197,230,209,241,True,10
8,37,kaist_dataset/Korean/Digital_Camera/outdoor2/DSC02311.JPG,char_data/8/DSC02311.JPG_2.jpg,814,480,640,22,447,469,252,289,True,10
8,23,kaist_dataset/Korean/Digital_Camera/outdoor2/DSC02314.JPG,char_data/8/DSC02314.JPG_4.jpg,414,480,640,18,323,341,204,227,True,10
8,23,kaist_dataset/Korean/Digital_Camera/outdoor2/DSC02314.JPG,char_data/8/DSC02314.JPG_5.jpg,368,480,640,16,396,412,204,227,True,10
8,29,kaist_dataset/Korean/Digital_Camera/outdoor2/DSC02321.JPG,char_data/8/DSC02321.JPG_6.jpg,667,480,640,23,184,207,379,408,True,10
8,33,kaist_dataset/Korean/Digital_Camera/outdoor2/DSC02321.JPG,char_data/8/DSC02321.JPG_7.jpg,990,480,640,30,340,370,378,411,True,10
8,37,kaist_dataset/Korean/Digital_Camera/outdoor2/DSC02321.JPG,char_data/8/DSC02321.JPG_8.jpg,666,480,640,18,320,338,376,413,True,10
8,22,kaist_dataset/Korean/Digital_Camera/outdoor2/DSC02326.JPG,char_data/8/DSC02326.JPG_4.jpg,396,480,640,18,363,381,340,362,True,10
8,33,kaist_dataset/Korean/Digital_Camera/outdoor2/DSC02326.JPG,char_data/8/DSC02326.JPG_5.jpg,462,480,640,14,477,491,336,369,True,10
8,38,kaist_dataset/Korean/Digital_Camera/outdoor2/DSC02327.JPG,char_data/8/DSC02327.JPG_4.jpg,1330,480,640,35,143,178,351,389,True,10
8,40,kaist_dataset/Korean/Digital_Camera/outdoor2/DSC02327.JPG,char_data/8/DSC02327.JPG_5.jpg,1040,480,640,26,452,478,360,400,True,10
8,42,kaist_dataset/Korean/Digital_Camera/outdoor2/DSC02366.JPG,char_data/8/DSC02366.JPG_2.jpg,1176,480,640,28,316,344,404,446,True,10
8,35,kaist_dataset/Korean/Digital_Camera/outdoor2/DSC02371.JPG,char_data/8/DSC02371.JPG_2.jpg,945,480,640,27,109,136,240,275,True,10
8,30,kaist_dataset/Korean/Digital_Camera/outdoor2/DSC02372.JPG,char_data/8/DSC02372.JPG_2.jpg,300,480,640,10,465,475,293,323,True,10
8,25,kaist_dataset/Korean/Digital_Camera/outdoor2/DSC02373.JPG,char_data/8/DSC02373.JPG_4.jpg,400,480,640,16,339,355,337,362,True,10
8,21,kaist_dataset/Korean/Digital_Camera/outdoor2/DSC02373.JPG,char_data/8/DSC02373.JPG_5.jpg,336,480,640,16,420,436,340,361,True,10
8,34,kaist_dataset/Korean/Digital_Camera/outdoor2/DSC02380.JPG,char_data/8/DSC02380.JPG_2.jpg,714,480,640,21,339,360,238,272,True,10
8,37,kaist_dataset/Korean/Digital_Camera/outdoor2/DSC02381.JPG,char_data/8/DSC02381.JPG_2.jpg,999,480,640,27,201,228,316,353,True,10
8,37,kaist_dataset/Korean/Digital_Camera/outdoor2/DSC02383.JPG,char_data/8/DSC02383.JPG_2.jpg,740,480,640,20,26,46,296,333,True,10
8,33,kaist_dataset/Korean/Digital_Camera/outdoor2/DSC02386.JPG,char_data/8/DSC02386.JPG_2.jpg,660,480,640,20,426,446,260,293,True,10
8,34,kaist_dataset/Korean/Digital_Camera/outdoor2/DSC02393.JPG,char_data/8/DSC02393.JPG_4.jpg,646,480,640,19,456,475,307,341,True,10
8,35,kaist_dataset/Korean/Digital_Camera/outdoor2/DSC02393.JPG,char_data/8/DSC02393.JPG_5.jpg,805,480,640,23,586,609,305,340,True,10
8,31,kaist_dataset/Korean/Digital_Camera/outdoor2/DSC02396.JPG,char_data/8/DSC02396.JPG_2.jpg,806,480,640,26,346,372,375,406,True,10
8,42,kaist_dataset/Korean/Digital_Camera/outdoor2/DSC02414.JPG,char_data/8/DSC02414.JPG_2.jpg,1554,480,640,37,327,364,243,285,True,10
8,24,kaist_dataset/Korean/Digital_Camera/outdoor2/DSC02424.JPG,char_data/8/DSC02424.JPG_6.jpg,480,480,640,20,452,472,244,268,True,10
8,27,kaist_dataset/Korean/Digital_Camera/outdoor2/DSC02424.JPG,char_data/8/DSC02424.JPG_7.jpg,405,480,640,15,518,533,244,271,True,10
8,25,kaist_dataset/Korean/Digital_Camera/outdoor2/DSC02424.JPG,char_data/8/DSC02424.JPG_8.jpg,275,480,640,11,534,545,246,271,True,10
8,31,kaist_dataset/Korean/Digital_Camera/outdoor2/DSC02426.JPG,char_data/8/DSC02426.JPG_2.jpg,806,480,640,26,491,517,220,251,True,10
8,27,kaist_dataset/Korean/Digital_Camera/outdoor2/DSC02435.JPG,char_data/8/DSC02435.JPG_4.jpg,486,480,640,18,469,487,248,275,True,10
8,21,kaist_dataset/Korean/Digital_Camera/outdoor2/DSC02435.JPG,char_data/8/DSC02435.JPG_5.jpg,315,480,640,15,575,590,250,271,True,10
8,30,kaist_dataset/Korean/Digital_Camera/outdoor2/DSC02441.JPG,char_data/8/DSC02441.JPG_2.jpg,480,480,640,16,427,443,199,229,True,10
8,81,kaist_dataset/Korean/Digital_Camera/outdoor2/DSC02451.JPG,char_data/8/DSC02451.JPG_6.jpg,5022,480,640,62,55,117,330,411,True,10
8,80,kaist_dataset/Korean/Digital_Camera/outdoor2/DSC02451.JPG,char_data/8/DSC02451.JPG_7.jpg,4400,480,640,55,374,429,320,400,True,10
8,84,kaist_dataset/Korean/Digital_Camera/outdoor2/DSC02451.JPG,char_data/8/DSC02451.JPG_8.jpg,5040,480,640,60,429,489,319,403,True,10
8,30,kaist_dataset/Korean/Digital_Camera/outdoor2/DSC02467.JPG,char_data/8/DSC02467.JPG_4.jpg,1050,480,640,35,212,247,257,287,True,10
8,37,kaist_dataset/Korean/Digital_Camera/outdoor2/DSC02467.JPG,char_data/8/DSC02467.JPG_5.jpg,629,480,640,17,323,340,257,294,True,10
8,28,kaist_dataset/Korean/Digital_Camera/outdoor2/DSC02470.JPG,char_data/8/DSC02470.JPG_6.jpg,700,480,640,25,172,197,184,212,True,10
8,60,kaist_dataset/Korean/Digital_Camera/outdoor2/DSC02470.JPG,char_data/8/DSC02470.JPG_7.jpg,2040,480,640,34,258,292,374,434,True,10
8,63,kaist_dataset/Korean/Digital_Camera/outdoor2/DSC02470.JPG,char_data/8/DSC02470.JPG_8.jpg,2457,480,640,39,417,456,371,434,True,10
8,41,kaist_dataset/Korean/Digital_Camera/outdoor2/DSC02476.JPG,char_data/8/DSC02476.JPG_4.jpg,1230,480,640,30,213,243,275,316,True,10
8,40,kaist_dataset/Korean/Digital_Camera/outdoor2/DSC02476.JPG,char_data/8/DSC02476.JPG_5.jpg,1040,480,640,26,362,388,270,310,True,10
8,29,kaist_dataset/Korean/Digital_Camera/outdoor2/DSC02506.JPG,char_data/8/DSC02506.JPG_6.jpg,841,480,640,29,241,270,439,468,True,10
8,27,kaist_dataset/Korean/Digital_Camera/outdoor2/DSC02506.JPG,char_data/8/DSC02506.JPG_7.jpg,702,480,640,26,362,388,435,462,True,10
8,26,kaist_dataset/Korean/Digital_Camera/outdoor2/DSC02506.JPG,char_data/8/DSC02506.JPG_8.jpg,702,480,640,27,413,440,438,464,True,10
8,53,kaist_dataset/Korean/Digital_Camera/outdoor2/DSC02512.JPG,char_data/8/DSC02512.JPG_2.jpg,2014,480,640,38,385,423,290,343,True,10
8,53,kaist_dataset/Korean/Digital_Camera/outdoor2/DSC02515.JPG,char_data/8/DSC02515.JPG_2.jpg,2597,480,640,49,204,253,324,377,True,10
8,123,kaist_dataset/Korean/Digital_Camera/outdoor2/DSC02520.JPG,char_data/8/DSC02520.JPG_2.jpg,4182,480,640,34,459,493,296,419,True,10
8,31,kaist_dataset/Korean/Digital_Camera/outdoor2/DSC02521.JPG,char_data/8/DSC02521.JPG_2.jpg,837,480,640,27,282,309,328,359,True,10
8,39,kaist_dataset/Korean/Digital_Camera/outdoor2/DSC02523.JPG,char_data/8/DSC02523.JPG_4.jpg,702,480,640,18,456,474,337,376,True,10
8,38,kaist_dataset/Korean/Digital_Camera/outdoor2/DSC02523.JPG,char_data/8/DSC02523.JPG_5.jpg,722,480,640,19,579,598,340,378,True,10
8,45,kaist_dataset/Korean/Digital_Camera/outdoor3/DSC02528.JPG,char_data/8/DSC02528.JPG_6.jpg,1755,480,640,39,166,205,412,457,True,10
8,47,kaist_dataset/Korean/Digital_Camera/outdoor3/DSC02528.JPG,char_data/8/DSC02528.JPG_7.jpg,1504,480,640,32,332,364,409,456,True,10
8,52,kaist_dataset/Korean/Digital_Camera/outdoor3/DSC02528.JPG,char_data/8/DSC02528.JPG_8.jpg,1560,480,640,30,405,435,410,462,True,10
8,30,kaist_dataset/Korean/Digital_Camera/outdoor3/DSC02531.JPG,char_data/8/DSC02531.JPG_2.jpg,690,480,640,23,201,224,352,382,True,10
8,48,kaist_dataset/Korean/Digital_Camera/outdoor3/DSC02546.JPG,char_data/8/DSC02546.JPG_6.jpg,1440,480,640,30,219,249,121,169,True,10
8,48,kaist_dataset/Korean/Digital_Camera/outdoor3/DSC02546.JPG,char_data/8/DSC02546.JPG_7.jpg,1488,480,640,31,209,240,235,283,True,10
8,57,kaist_dataset/Korean/Digital_Camera/outdoor3/DSC02546.JPG,char_data/8/DSC02546.JPG_8.jpg,1653,480,640,29,209,238,357,414,True,10
8,30,kaist_dataset/Korean/Digital_Camera/outdoor3/DSC02558.JPG,char_data/8/DSC02558.JPG_8.jpg,540,480,640,18,482,500,220,250,True,10
8,31,kaist_dataset/Korean/Digital_Camera/outdoor3/DSC02558.JPG,char_data/8/DSC02558.JPG_9.jpg,620,480,640,20,537,557,221,252,True,10
8,34,kaist_dataset/Korean/Digital_Camera/outdoor3/DSC02558.JPG,char_data/8/DSC02558.JPG_10.jpg,442,480,640,13,558,571,219,253,True,10
8,31,kaist_dataset/Korean/Digital_Camera/outdoor3/DSC02558.JPG,char_data/8/DSC02558.JPG_11.jpg,434,480,640,14,572,586,218,249,True,10
8,38,kaist_dataset/Korean/Digital_Camera/outdoor3/DSC02561.JPG,char_data/8/DSC02561.JPG_2.jpg,988,480,640,26,212,238,352,390,True,10
8,62,kaist_dataset/Korean/Digital_Camera/outdoor3/DSC02562.JPG,char_data/8/DSC02562.JPG_2.jpg,2108,480,640,34,196,230,362,424,True,10
8,36,kaist_dataset/Korean/Digital_Camera/outdoor3/DSC02598.JPG,char_data/8/DSC02598.JPG_5.jpg,792,480,640,22,501,523,415,451,True,10
8,41,kaist_dataset/Korean/Digital_Camera/outdoor3/DSC02686.JPG,char_data/8/DSC02686.JPG_2.jpg,1230,480,640,30,413,443,225,266,True,10
8,58,kaist_dataset/Korean/Digital_Camera/outdoor3/DSC02697.JPG,char_data/8/DSC02697.JPG_4.jpg,1624,480,640,28,215,243,373,431,True,10
8,52,kaist_dataset/Korean/Digital_Camera/outdoor3/DSC02697.JPG,char_data/8/DSC02697.JPG_5.jpg,1664,480,640,32,244,276,373,425,True,10
8,31,kaist_dataset/Korean/Digital_Camera/outdoor3/DSC02888.JPG,char_data/8/DSC02888.JPG_2.jpg,775,480,640,25,160,185,425,456,True,10
8,24,kaist_dataset/Korean/Digital_Camera/outdoor3/DSC02891.JPG,char_data/8/DSC02891.JPG_4.jpg,264,480,640,11,521,532,306,330,True,10
8,22,kaist_dataset/Korean/Digital_Camera/outdoor3/DSC02891.JPG,char_data/8/DSC02891.JPG_5.jpg,286,480,640,13,532,545,304,326,True,10
8,45,kaist_dataset/Korean/Digital_Camera/outdoor3/DSC02899.JPG,char_data/8/DSC02899.JPG_2.jpg,1485,480,640,33,380,413,231,276,True,10
8,71,kaist_dataset/Korean/Digital_Camera/outdoor3/DSC02900.JPG,char_data/8/DSC02900.JPG_4.jpg,2698,480,640,38,294,332,256,327,True,10
8,74,kaist_dataset/Korean/Digital_Camera/outdoor3/DSC02900.JPG,char_data/8/DSC02900.JPG_5.jpg,2886,480,640,39,334,373,254,328,True,10
8,29,kaist_dataset/Korean/Digital_Camera/outdoor3/DSC02939.JPG,char_data/8/DSC02939.JPG_4.jpg,812,480,640,28,426,454,373,402,True,10
8,37,kaist_dataset/Korean/Digital_Camera/outdoor3/DSC02939.JPG,char_data/8/DSC02939.JPG_5.jpg,962,480,640,26,453,479,371,408,True,10
8,40,kaist_dataset/Korean/Digital_Camera/outdoor3/DSC02941.JPG,char_data/8/DSC02941.JPG_2.jpg,880,480,640,22,355,377,251,291,True,10
8,33,kaist_dataset/Korean/Digital_Camera/outdoor3/DSC02943.JPG,char_data/8/DSC02943.JPG_4.jpg,759,480,640,23,323,346,430,463,True,10
8,36,kaist_dataset/Korean/Digital_Camera/outdoor3/DSC02943.JPG,char_data/8/DSC02943.JPG_5.jpg,864,480,640,24,347,371,431,467,True,10
8,35,kaist_dataset/Korean/Digital_Camera/outdoor3/DSC02944.JPG,char_data/8/DSC02944.JPG_4.jpg,840,480,640,24,239,263,235,270,True,10
8,36,kaist_dataset/Korean/Digital_Camera/outdoor3/DSC02944.JPG,char_data/8/DSC02944.JPG_5.jpg,684,480,640,19,263,282,233,269,True,10
8,63,kaist_dataset/Korean/Digital_Camera/outdoor3/DSC02951.JPG,char_data/8/DSC02951.JPG_6.jpg,3276,480,640,52,122,174,389,452,True,10
8,75,kaist_dataset/Korean/Digital_Camera/outdoor3/DSC02951.JPG,char_data/8/DSC02951.JPG_7.jpg,4275,480,640,57,277,334,390,465,True,10
8,70,kaist_dataset/Korean/Digital_Camera/outdoor3/DSC02951.JPG,char_data/8/DSC02951.JPG_8.jpg,3710,480,640,53,387,440,389,459,True,10
8,55,kaist_dataset/Korean/Digital_Camera/outdoor3/DSC02953.JPG,char_data/8/DSC02953.JPG_6.jpg,1870,480,640,34,355,389,385,440,True,10
8,57,kaist_dataset/Korean/Digital_Camera/outdoor3/DSC02953.JPG,char_data/8/DSC02953.JPG_7.jpg,1653,480,640,29,389,418,382,439,True,10
8,64,kaist_dataset/Korean/Digital_Camera/outdoor3/DSC02953.JPG,char_data/8/DSC02953.JPG_8.jpg,1536,480,640,24,442,466,384,448,True,10
8,46,kaist_dataset/Korean/Digital_Camera/outdoor3/DSC02957.JPG,char_data/8/DSC02957.JPG_4.jpg,1472,480,640,32,253,285,401,447,True,10
8,50,kaist_dataset/Korean/Digital_Camera/outdoor3/DSC02957.JPG,char_data/8/DSC02957.JPG_5.jpg,1550,480,640,31,285,316,400,450,True,10
8,35,kaist_dataset/Korean/Digital_Camera/outdoor3/DSC02971.JPG,char_data/8/DSC02971.JPG_2.jpg,770,480,640,22,276,298,293,328,True,10
8,51,kaist_dataset/Korean/Digital_Camera/outdoor3/DSC02972.JPG,char_data/8/DSC02972.JPG_2.jpg,2142,480,640,42,350,392,41,92,True,10
8,42,kaist_dataset/Korean/Digital_Camera/outdoor3/DSC02975.JPG,char_data/8/DSC02975.JPG_4.jpg,1134,480,640,27,323,350,236,278,True,10
8,42,kaist_dataset/Korean/Digital_Camera/outdoor3/DSC02975.JPG,char_data/8/DSC02975.JPG_5.jpg,1134,480,640,27,350,377,238,280,True,10
8,114,kaist_dataset/Korean/Digital_Camera/outdoor3/DSC02983.JPG,char_data/8/DSC02983.JPG_2.jpg,6042,480,640,53,147,200,297,411,True,10
8,46,kaist_dataset/Korean/Digital_Camera/outdoor3/DSC02994.JPG,char_data/8/DSC02994.JPG_2.jpg,1380,480,640,30,224,254,285,331,True,10
8,34,kaist_dataset/Korean/Digital_Camera/outdoor3/DSC02999.JPG,char_data/8/DSC02999.JPG_2.jpg,680,480,640,20,278,298,432,466,True,10
8,46,kaist_dataset/Korean/Digital_Camera/outdoor3/DSC03064.JPG,char_data/8/DSC03064.JPG_2.jpg,1150,480,640,25,321,346,345,391,True,10
8,130,kaist_dataset/Korean/Digital_Camera/outdoor3/DSC03159.JPG,char_data/8/DSC03159.JPG_4.jpg,8320,480,640,64,61,125,209,339,True,10
8,130,kaist_dataset/Korean/Digital_Camera/outdoor3/DSC03159.JPG,char_data/8/DSC03159.JPG_5.jpg,7150,480,640,55,126,181,207,337,True,10
8,61,kaist_dataset/Korean/Digital_Camera/outdoor3/DSC03195.JPG,char_data/8/DSC03195.JPG_2.jpg,2257,480,640,37,277,314,253,314,True,10
8,64,kaist_dataset/Korean/Digital_Camera/outdoor3/DSC03198.JPG,char_data/8/DSC03198.JPG_2.jpg,2880,480,640,45,75,120,198,262,True,10
8,29,kaist_dataset/Korean/Digital_Camera/outdoor3/DSC03219.JPG,char_data/8/DSC03219.JPG_2.jpg,493,480,640,17,352,369,415,444,True,10
8,34,kaist_dataset/Korean/Digital_Camera/outdoor3/DSC03232.JPG,char_data/8/DSC03232.JPG_6.jpg,850,480,640,25,220,245,288,322,True,10
8,32,kaist_dataset/Korean/Digital_Camera/outdoor3/DSC03232.JPG,char_data/8/DSC03232.JPG_7.jpg,864,480,640,27,347,374,283,315,True,10
8,25,kaist_dataset/Korean/Digital_Camera/outdoor3/DSC03232.JPG,char_data/8/DSC03232.JPG_8.jpg,625,480,640,25,377,402,282,307,True,10
8,47,kaist_dataset/Korean/Digital_Camera/outdoor3/DSC03237.JPG,char_data/8/DSC03237.JPG_2.jpg,1316,480,640,28,229,257,400,447,True,10
8,56,kaist_dataset/Korean/Digital_Camera/outdoor4/DSC03261.JPG,char_data/8/DSC03261.JPG_2.jpg,2072,480,640,37,239,276,390,446,True,10
8,39,kaist_dataset/Korean/Digital_Camera/outdoor4/DSC03293.JPG,char_data/8/DSC03293.JPG_4.jpg,468,480,640,12,308,320,286,325,True,10
8,34,kaist_dataset/Korean/Digital_Camera/outdoor4/DSC03293.JPG,char_data/8/DSC03293.JPG_5.jpg,510,480,640,15,340,355,286,320,True,10
8,31,kaist_dataset/Korean/Digital_Camera/outdoor4/DSC03295.JPG,char_data/8/DSC03295.JPG_2.jpg,589,480,640,19,241,260,401,432,True,10
8,47,kaist_dataset/Korean/Digital_Camera/outdoor4/DSC03319.JPG,char_data/8/DSC03319.JPG_2.jpg,1316,480,640,28,242,270,82,129,True,10
8,57,kaist_dataset/Korean/Digital_Camera/outdoor4/DSC03537.JPG,char_data/8/DSC03537.JPG_8.jpg,2223,480,640,39,311,350,134,191,True,10
8,59,kaist_dataset/Korean/Digital_Camera/outdoor4/DSC03537.JPG,char_data/8/DSC03537.JPG_9.jpg,2478,480,640,42,423,465,127,186,True,10
8,62,kaist_dataset/Korean/Digital_Camera/outdoor4/DSC03537.JPG,char_data/8/DSC03537.JPG_10.jpg,2604,480,640,42,504,546,121,183,True,10
8,66,kaist_dataset/Korean/Digital_Camera/outdoor4/DSC03537.JPG,char_data/8/DSC03537.JPG_11.jpg,2640,480,640,40,548,588,117,183,True,10
8,103,kaist_dataset/Korean/Digital_Camera/outdoor4/DSC03542.JPG,char_data/8/DSC03542.JPG_2.jpg,4841,480,640,47,294,341,235,338,True,10
8,67,kaist_dataset/Korean/Digital_Camera/outdoor4/DSC03550.JPG,char_data/8/DSC03550.JPG_2.jpg,3484,480,640,52,207,259,307,374,True,10
8,27,kaist_dataset/Korean/Digital_Camera/outdoor4/DSC03555.JPG,char_data/8/DSC03555.JPG_2.jpg,648,480,640,24,319,343,426,453,True,10
8,91,kaist_dataset/Korean/Digital_Camera/outdoor4/DSC03566.JPG,char_data/8/DSC03566.JPG_4.jpg,5278,480,640,58,151,209,149,240,True,10
8,33,kaist_dataset/Korean/Digital_Camera/outdoor4/DSC03566.JPG,char_data/8/DSC03566.JPG_5.jpg,2079,480,640,63,106,169,92,125,True,10
8,48,kaist_dataset/Korean/Digital_Camera/outdoor4/DSC03580.JPG,char_data/8/DSC03580.JPG_2.jpg,1344,480,640,28,249,277,213,261,True,10
8,50,kaist_dataset/Korean/Digital_Camera/outdoor4/DSC03601.JPG,char_data/8/DSC03601.JPG_2.jpg,1950,480,640,39,280,319,239,289,True,10
8,49,kaist_dataset/Korean/Digital_Camera/outdoor4/DSC03607.JPG,char_data/8/DSC03607.JPG_2.jpg,1568,480,640,32,99,131,161,210,True,10
8,47,kaist_dataset/Korean/Digital_Camera/outdoor4/DSC03614.JPG,char_data/8/DSC03614.JPG_2.jpg,1175,480,640,25,337,362,392,439,True,10
8,45,kaist_dataset/Korean/Digital_Camera/outdoor5/DSC03626.JPG,char_data/8/DSC03626.JPG_8.jpg,1215,480,640,27,158,185,294,339,True,10
8,43,kaist_dataset/Korean/Digital_Camera/outdoor5/DSC03626.JPG,char_data/8/DSC03626.JPG_9.jpg,1376,480,640,32,319,351,298,341,True,10
8,43,kaist_dataset/Korean/Digital_Camera/outdoor5/DSC03626.JPG,char_data/8/DSC03626.JPG_10.jpg,1075,480,640,25,404,429,297,340,True,10
8,48,kaist_dataset/Korean/Digital_Camera/outdoor5/DSC03626.JPG,char_data/8/DSC03626.JPG_11.jpg,1392,480,640,29,530,559,293,341,True,10
8,37,kaist_dataset/Korean/Digital_Camera/outdoor5/DSC03627.JPG,char_data/8/DSC03627.JPG_2.jpg,1147,480,640,31,387,418,223,260,True,10
8,36,kaist_dataset/Korean/Digital_Camera/outdoor5/DSC03636.JPG,char_data/8/DSC03636.JPG_4.jpg,756,480,640,21,252,273,394,430,True,10
8,36,kaist_dataset/Korean/Digital_Camera/outdoor5/DSC03636.JPG,char_data/8/DSC03636.JPG_5.jpg,720,480,640,20,362,382,394,430,True,10
8,35,kaist_dataset/Korean/Digital_Camera/outdoor5/DSC03641.JPG,char_data/8/DSC03641.JPG_2.jpg,630,480,640,18,382,400,418,453,True,10
8,41,kaist_dataset/Korean/Digital_Camera/outdoor5/DSC03645.JPG,char_data/8/DSC03645.JPG_2.jpg,1025,480,640,25,353,378,351,392,True,10
8,37,kaist_dataset/Korean/Digital_Camera/outdoor5/DSC03669.JPG,char_data/8/DSC03669.JPG_2.jpg,1073,480,640,29,239,268,315,352,True,10
8,37,kaist_dataset/Korean/Digital_Camera/outdoor5/DSC03671.JPG,char_data/8/DSC03671.JPG_6.jpg,703,480,640,19,261,280,408,445,True,10
8,35,kaist_dataset/Korean/Digital_Camera/outdoor5/DSC03671.JPG,char_data/8/DSC03671.JPG_7.jpg,490,480,640,14,281,295,407,442,True,10
8,36,kaist_dataset/Korean/Digital_Camera/outdoor5/DSC03671.JPG,char_data/8/DSC03671.JPG_8.jpg,576,480,640,16,475,491,410,446,True,10
8,40,kaist_dataset/Korean/Digital_Camera/outdoor5/DSC03685.JPG,char_data/8/DSC03685.JPG_10.jpg,920,480,640,23,110,133,187,227,True,10
8,38,kaist_dataset/Korean/Digital_Camera/outdoor5/DSC03685.JPG,char_data/8/DSC03685.JPG_11.jpg,874,480,640,23,216,239,187,225,True,10
8,36,kaist_dataset/Korean/Digital_Camera/outdoor5/DSC03685.JPG,char_data/8/DSC03685.JPG_12.jpg,828,480,640,23,240,263,188,224,True,10
8,35,kaist_dataset/Korean/Digital_Camera/outdoor5/DSC03685.JPG,char_data/8/DSC03685.JPG_13.jpg,805,480,640,23,361,384,187,222,True,10
8,36,kaist_dataset/Korean/Digital_Camera/outdoor5/DSC03685.JPG,char_data/8/DSC03685.JPG_14.jpg,828,480,640,23,462,485,186,222,True,10
8,27,kaist_dataset/Korean/Digital_Camera/outdoor5/DSC03688.JPG,char_data/8/DSC03688.JPG_2.jpg,297,480,640,11,555,566,229,256,True,10
8,38,kaist_dataset/Korean/Digital_Camera/outdoor5/DSC03692.JPG,char_data/8/DSC03692.JPG_2.jpg,722,480,640,19,518,537,188,226,True,10
8,66,kaist_dataset/Korean/Digital_Camera/outdoor5/DSC03694.JPG,char_data/8/DSC03694.JPG_4.jpg,2046,480,640,31,439,470,113,179,True,10
8,68,kaist_dataset/Korean/Digital_Camera/outdoor5/DSC03694.JPG,char_data/8/DSC03694.JPG_5.jpg,1972,480,640,29,469,498,109,177,True,10
8,51,kaist_dataset/Korean/Digital_Camera/outdoor5/DSC03708.JPG,char_data/8/DSC03708.JPG_4.jpg,1581,480,640,31,354,385,264,315,True,10
8,48,kaist_dataset/Korean/Digital_Camera/outdoor5/DSC03708.JPG,char_data/8/DSC03708.JPG_5.jpg,1392,480,640,29,431,460,260,308,True,10
8,40,kaist_dataset/Korean/Digital_Camera/outdoor5/DSC03709.JPG,char_data/8/DSC03709.JPG_2.jpg,560,480,640,14,450,464,361,401,True,10
8,94,kaist_dataset/Korean/Digital_Camera/outdoor5/DSC03715.JPG,char_data/8/DSC03715.JPG_4.jpg,4136,480,640,44,273,317,80,174,True,10
8,90,kaist_dataset/Korean/Digital_Camera/outdoor5/DSC03715.JPG,char_data/8/DSC03715.JPG_5.jpg,4050,480,640,45,317,362,83,173,True,10
8,30,kaist_dataset/Korean/Digital_Camera/outdoor5/DSC03736.JPG,char_data/8/DSC03736.JPG_4.jpg,450,480,640,15,312,327,406,436,True,10
8,27,kaist_dataset/Korean/Digital_Camera/outdoor5/DSC03736.JPG,char_data/8/DSC03736.JPG_5.jpg,486,480,640,18,353,371,408,435,True,10
8,40,kaist_dataset/Korean/Digital_Camera/outdoor5/DSC03740.JPG,char_data/8/DSC03740.JPG_2.jpg,920,480,640,23,376,399,286,326,True,10
8,25,kaist_dataset/Korean/Digital_Camera/outdoor5/DSC03744.JPG,char_data/8/DSC03744.JPG_2.jpg,775,480,640,31,282,313,307,332,True,10
8,70,kaist_dataset/Korean/Digital_Camera/outdoor5/DSC03749.JPG,char_data/8/DSC03749.JPG_2.jpg,2310,480,640,33,368,401,404,474,True,10
8,24,kaist_dataset/Korean/Digital_Camera/outdoor5/DSC03751.JPG,char_data/8/DSC03751.JPG_2.jpg,504,480,640,21,243,264,416,440,True,10
8,24,kaist_dataset/Korean/Digital_Camera/outdoor5/DSC03752.JPG,char_data/8/DSC03752.JPG_4.jpg,408,480,640,17,105,122,412,436,True,10
8,30,kaist_dataset/Korean/Digital_Camera/outdoor5/DSC03752.JPG,char_data/8/DSC03752.JPG_5.jpg,420,480,640,14,151,165,409,439,True,10
8,36,kaist_dataset/Korean/Digital_Camera/outdoor5/DSC03768.JPG,char_data/8/DSC03768.JPG_6.jpg,756,480,640,21,443,464,241,277,True,10
8,35,kaist_dataset/Korean/Digital_Camera/outdoor5/DSC03768.JPG,char_data/8/DSC03768.JPG_7.jpg,735,480,640,21,466,487,241,276,True,10
8,36,kaist_dataset/Korean/Digital_Camera/outdoor5/DSC03768.JPG,char_data/8/DSC03768.JPG_8.jpg,792,480,640,22,503,525,239,275,True,10
8,36,kaist_dataset/Korean/Digital_Camera/outdoor5/DSC03770.JPG,char_data/8/DSC03770.JPG_6.jpg,792,480,640,22,462,484,423,459,True,10
8,36,kaist_dataset/Korean/Digital_Camera/outdoor5/DSC03770.JPG,char_data/8/DSC03770.JPG_7.jpg,756,480,640,21,485,506,421,457,True,10
8,39,kaist_dataset/Korean/Digital_Camera/outdoor5/DSC03770.JPG,char_data/8/DSC03770.JPG_8.jpg,858,480,640,22,524,546,423,462,True,10
8,17,kaist_dataset/Korean/Digital_Camera/outdoor5/DSC03776.JPG,char_data/8/DSC03776.JPG_8.jpg,204,480,640,12,498,510,440,457,True,10
8,21,kaist_dataset/Korean/Digital_Camera/outdoor5/DSC03776.JPG,char_data/8/DSC03776.JPG_9.jpg,210,480,640,10,497,507,420,441,True,10
8,18,kaist_dataset/Korean/Digital_Camera/outdoor5/DSC03776.JPG,char_data/8/DSC03776.JPG_10.jpg,198,480,640,11,554,565,424,442,True,10
8,20,kaist_dataset/Korean/Digital_Camera/outdoor5/DSC03776.JPG,char_data/8/DSC03776.JPG_11.jpg,260,480,640,13,565,578,424,444,True,10
8,36,kaist_dataset/Korean/Digital_Camera/outdoor5/DSC03778.JPG,char_data/8/DSC03778.JPG_6.jpg,612,480,640,17,319,336,338,374,True,10
8,38,kaist_dataset/Korean/Digital_Camera/outdoor5/DSC03778.JPG,char_data/8/DSC03778.JPG_7.jpg,494,480,640,13,405,418,339,377,True,10
8,39,kaist_dataset/Korean/Digital_Camera/outdoor5/DSC03778.JPG,char_data/8/DSC03778.JPG_8.jpg,741,480,640,19,420,439,337,376,True,10
8,38,kaist_dataset/Korean/Digital_Camera/outdoor5/DSC03779.JPG,char_data/8/DSC03779.JPG_2.jpg,722,480,640,19,487,506,240,278,True,10
8,23,kaist_dataset/Korean/Digital_Camera/outdoor5/DSC03780.JPG,char_data/8/DSC03780.JPG_2.jpg,345,480,640,15,159,174,443,466,True,10
8,35,kaist_dataset/Korean/Digital_Camera/outdoor5/DSC03789.JPG,char_data/8/DSC03789.JPG_2.jpg,700,480,640,20,249,269,212,247,True,10
8,39,kaist_dataset/Korean/Digital_Camera/outdoor5/DSC03970.JPG,char_data/8/DSC03970.JPG_4.jpg,1443,480,640,37,62,99,99,138,True,10
8,48,kaist_dataset/Korean/Digital_Camera/outdoor5/DSC03970.JPG,char_data/8/DSC03970.JPG_5.jpg,1728,480,640,36,202,238,93,141,True,10
8,62,kaist_dataset/Korean/Digital_Camera/outdoor5/DSC03979.JPG,char_data/8/DSC03979.JPG_2.jpg,4588,480,640,74,39,113,374,436,True,10
8,39,kaist_dataset/Korean/Digital_Camera/outdoor5/DSC03996.JPG,char_data/8/DSC03996.JPG_2.jpg,1248,480,640,32,224,256,286,325,True,10
8,29,kaist_dataset/Korean/Digital_Camera/outdoor5/DSC04028.JPG,char_data/8/DSC04028.JPG_6.jpg,725,480,640,25,303,328,344,373,True,10
8,24,kaist_dataset/Korean/Digital_Camera/outdoor5/DSC04028.JPG,char_data/8/DSC04028.JPG_7.jpg,552,480,640,23,328,351,345,369,True,10
8,26,kaist_dataset/Korean/Digital_Camera/outdoor5/DSC04028.JPG,char_data/8/DSC04028.JPG_8.jpg,572,480,640,22,391,413,344,370,True,10
8,36,kaist_dataset/Korean/Digital_Camera/outdoor5/DSC04040.JPG,char_data/8/DSC04040.JPG_2.jpg,1188,480,640,33,310,343,339,375,True,10
8,25,kaist_dataset/Korean/Digital_Camera/outdoor6/DSC04041.JPG,char_data/8/DSC04041.JPG_2.jpg,450,480,640,18,428,446,142,167,True,10
8,27,kaist_dataset/Korean/Digital_Camera/outdoor6/DSC04042.JPG,char_data/8/DSC04042.JPG_2.jpg,432,480,640,16,69,85,330,357,True,10
8,28,kaist_dataset/Korean/Digital_Camera/outdoor6/DSC04046.JPG,char_data/8/DSC04046.JPG_4.jpg,392,480,640,14,425,439,262,290,True,10
8,26,kaist_dataset/Korean/Digital_Camera/outdoor6/DSC04046.JPG,char_data/8/DSC04046.JPG_5.jpg,338,480,640,13,470,483,261,287,True,10
8,64,kaist_dataset/Korean/Digital_Camera/outdoor6/DSC04073.JPG,char_data/8/DSC04073.JPG_2.jpg,1920,480,640,30,424,454,30,94,True,10
8,44,kaist_dataset/Korean/Digital_Camera/outdoor6/DSC04081.JPG,char_data/8/DSC04081.JPG_6.jpg,1892,480,640,43,252,295,318,362,True,10
8,44,kaist_dataset/Korean/Digital_Camera/outdoor6/DSC04081.JPG,char_data/8/DSC04081.JPG_7.jpg,1980,480,640,45,297,342,320,364,True,10
8,43,kaist_dataset/Korean/Digital_Camera/outdoor6/DSC04081.JPG,char_data/8/DSC04081.JPG_8.jpg,1892,480,640,44,383,427,317,360,True,10
8,81,kaist_dataset/Korean/Digital_Camera/outdoor6/DSC04083.JPG,char_data/8/DSC04083.JPG_2.jpg,3159,480,640,39,399,438,160,241,True,10
8,49,kaist_dataset/Korean/Digital_Camera/outdoor6/DSC04089.JPG,char_data/8/DSC04089.JPG_2.jpg,1078,480,640,22,328,350,274,323,True,10
8,96,kaist_dataset/Korean/Digital_Camera/outdoor6/DSC04090.JPG,char_data/8/DSC04090.JPG_2.jpg,4608,480,640,48,205,253,190,286,True,10
8,92,kaist_dataset/Korean/Digital_Camera/outdoor6/DSC04096.JPG,char_data/8/DSC04096.JPG_2.jpg,3312,480,640,36,177,213,219,311,True,10
8,38,kaist_dataset/Korean/Digital_Camera/outdoor6/DSC04099.JPG,char_data/8/DSC04099.JPG_2.jpg,988,480,640,26,412,438,412,450,True,10
8,54,kaist_dataset/Korean/Digital_Camera/outdoor6/DSC04100.JPG,char_data/8/DSC04100.JPG_2.jpg,1620,480,640,30,521,551,54,108,True,10
8,36,kaist_dataset/Korean/Digital_Camera/outdoor6/DSC04112.JPG,char_data/8/DSC04112.JPG_2.jpg,504,480,640,14,428,442,273,309,True,10
8,40,kaist_dataset/Korean/Digital_Camera/outdoor6/DSC04116.JPG,char_data/8/DSC04116.JPG_4.jpg,560,480,640,14,190,204,318,358,True,10
8,38,kaist_dataset/Korean/Digital_Camera/outdoor6/DSC04116.JPG,char_data/8/DSC04116.JPG_5.jpg,646,480,640,17,342,359,318,356,True,10
8,61,kaist_dataset/Korean/Digital_Camera/outdoor6/DSC04118.JPG,char_data/8/DSC04118.JPG_4.jpg,1830,480,640,30,312,342,250,311,True,10
8,54,kaist_dataset/Korean/Digital_Camera/outdoor6/DSC04118.JPG,char_data/8/DSC04118.JPG_5.jpg,1782,480,640,33,341,374,252,306,True,10
8,41,kaist_dataset/Korean/Digital_Camera/outdoor6/DSC04121.JPG,char_data/8/DSC04121.JPG_4.jpg,1230,480,640,30,213,243,179,220,True,10
8,35,kaist_dataset/Korean/Digital_Camera/outdoor6/DSC04121.JPG,char_data/8/DSC04121.JPG_5.jpg,1085,480,640,31,308,339,181,216,True,10
8,27,kaist_dataset/Korean/Digital_Camera/outdoor6/DSC04132.JPG,char_data/8/DSC04132.JPG_2.jpg,432,480,640,16,263,279,158,185,True,10
8,54,kaist_dataset/Korean/Digital_Camera/outdoor6/DSC04136.JPG,char_data/8/DSC04136.JPG_2.jpg,2052,480,640,38,375,413,328,382,True,10
8,31,kaist_dataset/Korean/Digital_Camera/outdoor6/DSC04138.JPG,char_data/8/DSC04138.JPG_4.jpg,868,480,640,28,274,302,152,183,True,10
8,29,kaist_dataset/Korean/Digital_Camera/outdoor6/DSC04138.JPG,char_data/8/DSC04138.JPG_5.jpg,870,480,640,30,436,466,155,184,True,10
8,57,kaist_dataset/Korean/Digital_Camera/outdoor6/DSC04143.JPG,char_data/8/DSC04143.JPG_6.jpg,1824,480,640,32,225,257,353,410,True,10
8,51,kaist_dataset/Korean/Digital_Camera/outdoor6/DSC04143.JPG,char_data/8/DSC04143.JPG_7.jpg,1734,480,640,34,318,352,362,413,True,10
8,51,kaist_dataset/Korean/Digital_Camera/outdoor6/DSC04143.JPG,char_data/8/DSC04143.JPG_8.jpg,1734,480,640,34,382,416,357,408,True,10
8,70,kaist_dataset/Korean/Digital_Camera/outdoor6/DSC04147.JPG,char_data/8/DSC04147.JPG_2.jpg,2520,480,640,36,195,231,178,248,True,10
8,57,kaist_dataset/Korean/Digital_Camera/outdoor6/DSC04296.JPG,char_data/8/DSC04296.JPG_4.jpg,1311,480,640,23,360,383,305,362,True,10
8,57,kaist_dataset/Korean/Digital_Camera/outdoor6/DSC04296.JPG,char_data/8/DSC04296.JPG_5.jpg,1425,480,640,25,379,404,303,360,True,10
8,71,kaist_dataset/Korean/Digital_Camera/outdoor6/DSC04301.JPG,char_data/8/DSC04301.JPG_4.jpg,4828,480,640,68,58,126,361,432,True,10
8,69,kaist_dataset/Korean/Digital_Camera/outdoor6/DSC04301.JPG,char_data/8/DSC04301.JPG_5.jpg,4623,480,640,67,445,512,364,433,True,10
8,53,kaist_dataset/Korean/Digital_Camera/outdoor6/DSC04308.JPG,char_data/8/DSC04308.JPG_2.jpg,1272,480,640,24,273,297,384,437,True,10
8,53,kaist_dataset/Korean/Digital_Camera/outdoor6/DSC04332.JPG,char_data/8/DSC04332.JPG_2.jpg,2862,480,640,54,83,137,350,403,True,10
8,41,kaist_dataset/Korean/Digital_Camera/outdoor6/DSC04339.JPG,char_data/8/DSC04339.JPG_4.jpg,1107,480,640,27,271,298,208,249,True,10
8,43,kaist_dataset/Korean/Digital_Camera/outdoor6/DSC04339.JPG,char_data/8/DSC04339.JPG_5.jpg,688,480,640,16,399,415,205,248,True,10
8,25,kaist_dataset/Korean/Digital_Camera/outdoor6/DSC04341.JPG,char_data/8/DSC04341.JPG_4.jpg,450,480,640,18,483,501,223,248,True,10
8,29,kaist_dataset/Korean/Digital_Camera/outdoor6/DSC04341.JPG,char_data/8/DSC04341.JPG_5.jpg,406,480,640,14,584,598,222,251,True,10
8,21,kaist_dataset/Korean/Digital_Camera/outdoor6/DSC04343.JPG,char_data/8/DSC04343.JPG_2.jpg,525,480,640,25,277,302,210,231,True,10
8,49,kaist_dataset/Korean/Digital_Camera/outdoor6/DSC04352.JPG,char_data/8/DSC04352.JPG_2.jpg,1274,480,640,26,483,509,280,329,True,10
8,69,kaist_dataset/Korean/Digital_Camera/outdoor6/DSC04359.JPG,char_data/8/DSC04359.JPG_8.jpg,3243,480,640,47,101,148,119,188,True,10
8,75,kaist_dataset/Korean/Digital_Camera/outdoor6/DSC04359.JPG,char_data/8/DSC04359.JPG_9.jpg,3450,480,640,46,253,299,113,188,True,10
8,79,kaist_dataset/Korean/Digital_Camera/outdoor6/DSC04359.JPG,char_data/8/DSC04359.JPG_10.jpg,3397,480,640,43,297,340,109,188,True,10
8,77,kaist_dataset/Korean/Digital_Camera/outdoor6/DSC04359.JPG,char_data/8/DSC04359.JPG_11.jpg,3080,480,640,40,338,378,108,185,True,10
8,51,kaist_dataset/Korean/Digital_Camera/outdoor6/DSC04370.JPG,char_data/8/DSC04370.JPG_4.jpg,2448,480,640,48,123,171,320,371,True,10
8,62,kaist_dataset/Korean/Digital_Camera/outdoor6/DSC04370.JPG,char_data/8/DSC04370.JPG_5.jpg,3410,480,640,55,436,491,322,384,True,10
8,44,kaist_dataset/Korean/Digital_Camera/outdoor6/DSC04400.JPG,char_data/8/DSC04400.JPG_6.jpg,1100,480,640,25,256,281,222,266,True,10
8,38,kaist_dataset/Korean/Digital_Camera/outdoor6/DSC04400.JPG,char_data/8/DSC04400.JPG_7.jpg,912,480,640,24,352,376,226,264,True,10
8,37,kaist_dataset/Korean/Digital_Camera/outdoor6/DSC04400.JPG,char_data/8/DSC04400.JPG_8.jpg,1036,480,640,28,248,276,399,436,True,10
8,71,kaist_dataset/Korean/Digital_Camera/outdoor7/DSC04483.JPG,char_data/8/DSC04483.JPG_2.jpg,2769,480,640,39,168,207,365,436,True,10
8,35,kaist_dataset/Korean/Digital_Camera/outdoor7/P1010003.JPG,char_data/8/P1010003.JPG_4.jpg,980,480,640,28,279,307,278,313,True,10
8,33,kaist_dataset/Korean/Digital_Camera/outdoor7/P1010003.JPG,char_data/8/P1010003.JPG_5.jpg,792,480,640,24,309,333,279,312,True,10
8,27,kaist_dataset/Korean/Digital_Camera/outdoor7/P1010005.JPG,char_data/8/P1010005.JPG_4.jpg,783,480,640,29,418,447,191,218,True,10
8,31,kaist_dataset/Korean/Digital_Camera/outdoor7/P1010005.JPG,char_data/8/P1010005.JPG_5.jpg,868,480,640,28,516,544,189,220,True,10
8,34,kaist_dataset/Korean/Digital_Camera/outdoor7/P1010009.JPG,char_data/8/P1010009.JPG_4.jpg,1156,480,640,34,377,411,269,303,True,10
8,52,kaist_dataset/Korean/Digital_Camera/outdoor7/P1010011.JPG,char_data/8/P1010011.JPG_2.jpg,2132,480,640,41,267,308,227,279,True,10
8,41,kaist_dataset/Korean/Digital_Camera/outdoor7/P1010012.JPG,char_data/8/P1010012.JPG_6.jpg,1681,480,640,41,207,248,221,262,True,10
8,54,kaist_dataset/Korean/Digital_Camera/outdoor7/P1010023.JPG,char_data/8/P1010023.JPG_2.jpg,1674,480,640,31,514,545,284,338,True,10
8,29,kaist_dataset/Korean/Digital_Camera/outdoor7/P1010035.JPG,char_data/8/P1010035.JPG_2.jpg,464,480,640,16,57,73,208,237,True,10
8,33,kaist_dataset/Korean/Digital_Camera/outdoor7/P1010054.JPG,char_data/8/P1010054.JPG_2.jpg,759,480,640,23,507,530,227,260,True,10
8,34,kaist_dataset/Korean/Digital_Camera/outdoor7/P1010056.JPG,char_data/8/P1010056.JPG_2.jpg,680,480,640,20,414,434,265,299,True,10
8,33,kaist_dataset/Korean/Digital_Camera/outdoor7/P1010057.JPG,char_data/8/P1010057.JPG_2.jpg,627,480,640,19,526,545,228,261,True,10
8,38,kaist_dataset/Korean/Digital_Camera/outdoor7/P1010061.JPG,char_data/8/P1010061.JPG_2.jpg,1026,480,640,27,370,397,318,356,True,10
8,40,kaist_dataset/Korean/Digital_Camera/outdoor7/P1010067.JPG,char_data/8/P1010067.JPG_10.jpg,1280,480,640,32,337,369,312,352,True,10
8,42,kaist_dataset/Korean/Digital_Camera/outdoor7/P1010067.JPG,char_data/8/P1010067.JPG_11.jpg,1554,480,640,37,370,407,310,352,True,10
8,48,kaist_dataset/Korean/Digital_Camera/outdoor7/P1010069.JPG,char_data/8/P1010069.JPG_10.jpg,1248,480,640,26,338,364,309,357,True,10
8,51,kaist_dataset/Korean/Digital_Camera/outdoor7/P1010069.JPG,char_data/8/P1010069.JPG_11.jpg,1581,480,640,31,391,422,311,362,True,10
8,47,kaist_dataset/Korean/Digital_Camera/outdoor7/P1010069.JPG,char_data/8/P1010069.JPG_12.jpg,1410,480,640,30,422,452,312,359,True,10
8,52,kaist_dataset/Korean/Digital_Camera/outdoor7/P1010077.JPG,char_data/8/P1010077.JPG_4.jpg,1404,480,640,27,383,410,244,296,True,10
8,59,kaist_dataset/Korean/Digital_Camera/outdoor7/P1010077.JPG,char_data/8/P1010077.JPG_5.jpg,2065,480,640,35,407,442,242,301,True,10
8,30,kaist_dataset/Korean/Digital_Camera/outdoor7/P1010078.JPG,char_data/8/P1010078.JPG_2.jpg,690,480,640,23,191,214,252,282,True,10
8,104,kaist_dataset/Korean/Digital_Camera/outdoor7/P1010079.JPG,char_data/8/P1010079.JPG_2.jpg,7176,480,640,69,453,522,340,444,True,10
8,57,kaist_dataset/Korean/Digital_Camera/outdoor7/P1010081.JPG,char_data/8/P1010081.JPG_2.jpg,3135,480,640,55,155,210,219,276,True,10
8,43,kaist_dataset/Korean/Digital_Camera/outdoor7/P1010082.JPG,char_data/8/P1010082.JPG_8.jpg,1290,480,640,30,155,185,47,90,True,10
8,40,kaist_dataset/Korean/Digital_Camera/outdoor7/P1010082.JPG,char_data/8/P1010082.JPG_9.jpg,1040,480,640,26,182,208,51,91,True,10
8,49,kaist_dataset/Korean/Digital_Camera/outdoor7/P1010085.JPG,char_data/8/P1010085.JPG_6.jpg,1470,480,640,30,353,383,268,317,True,10
8,74,kaist_dataset/Korean/Digital_Camera/outdoor7/P1010086.JPG,char_data/8/P1010086.JPG_8.jpg,4588,480,640,62,292,354,257,331,True,10
8,24,kaist_dataset/Korean/Digital_Camera/outdoor7/P1010100.JPG,char_data/8/P1010100.JPG_14.jpg,336,480,640,14,233,247,224,248,True,10
8,24,kaist_dataset/Korean/Digital_Camera/outdoor7/P1010100.JPG,char_data/8/P1010100.JPG_15.jpg,432,480,640,18,313,331,222,246,True,10
8,24,kaist_dataset/Korean/Digital_Camera/outdoor7/P1010100.JPG,char_data/8/P1010100.JPG_16.jpg,456,480,640,19,333,352,222,246,True,10
8,30,kaist_dataset/Korean/Digital_Camera/outdoor7/P1010100.JPG,char_data/8/P1010100.JPG_17.jpg,510,480,640,17,393,410,217,247,True,10
8,44,kaist_dataset/Korean/Digital_Camera/outdoor7/P1010100.JPG,char_data/8/P1010100.JPG_18.jpg,1364,480,640,31,196,227,349,393,True,10
8,43,kaist_dataset/Korean/Digital_Camera/outdoor7/P1010100.JPG,char_data/8/P1010100.JPG_19.jpg,1376,480,640,32,355,387,347,390,True,10
8,45,kaist_dataset/Korean/Digital_Camera/outdoor7/P1010100.JPG,char_data/8/P1010100.JPG_20.jpg,1665,480,640,37,387,424,347,392,True,10
8,36,kaist_dataset/Korean/Digital_Camera/outdoor7/P1010101.JPG,char_data/8/P1010101.JPG_4.jpg,684,480,640,19,349,368,232,268,True,10
8,33,kaist_dataset/Korean/Digital_Camera/outdoor7/P1010101.JPG,char_data/8/P1010101.JPG_5.jpg,858,480,640,26,465,491,232,265,True,10
8,29,kaist_dataset/Korean/Digital_Camera/outdoor7/P1010107.JPG,char_data/8/P1010107.JPG_4.jpg,464,480,640,16,287,303,230,259,True,10
8,29,kaist_dataset/Korean/Digital_Camera/outdoor7/P1010107.JPG,char_data/8/P1010107.JPG_5.jpg,580,480,640,20,301,321,227,256,True,10
8,48,kaist_dataset/Korean/Digital_Camera/outdoor7/P1010111.JPG,char_data/8/P1010111.JPG_8.jpg,1680,480,640,35,381,416,220,268,True,10
8,51,kaist_dataset/Korean/Digital_Camera/outdoor7/P1010111.JPG,char_data/8/P1010111.JPG_9.jpg,1683,480,640,33,418,451,218,269,True,10
8,43,kaist_dataset/Korean/Digital_Camera/outdoor7/P1010111.JPG,char_data/8/P1010111.JPG_10.jpg,1720,480,640,40,488,528,221,264,True,10
8,25,kaist_dataset/Korean/Digital_Camera/outdoor7/P1010112.JPG,char_data/8/P1010112.JPG_6.jpg,500,480,640,20,480,500,361,386,True,10
8,29,kaist_dataset/Korean/Digital_Camera/outdoor7/P1010112.JPG,char_data/8/P1010112.JPG_7.jpg,493,480,640,17,520,537,357,386,True,10
8,30,kaist_dataset/Korean/Digital_Camera/outdoor7/P1010112.JPG,char_data/8/P1010112.JPG_8.jpg,330,480,640,11,538,549,356,386,True,10
8,36,kaist_dataset/Korean/Digital_Camera/outdoor7/P1010121.JPG,char_data/8/P1010121.JPG_2.jpg,792,480,640,22,467,489,204,240,True,10
8,19,kaist_dataset/Korean/Digital_Camera/outdoor7/P1010124.JPG,char_data/8/P1010124.JPG_4.jpg,247,480,640,13,304,317,153,172,True,10
8,21,kaist_dataset/Korean/Digital_Camera/outdoor7/P1010124.JPG,char_data/8/P1010124.JPG_5.jpg,273,480,640,13,366,379,152,173,True,10
8,35,kaist_dataset/Korean/Digital_Camera/outdoor7/P1010136.JPG,char_data/8/P1010136.JPG_2.jpg,630,480,640,18,322,340,264,299,True,10
8,41,kaist_dataset/Korean/Digital_Camera/outdoor7/P1010138.JPG,char_data/8/P1010138.JPG_10.jpg,738,480,640,18,274,292,282,323,True,10
8,34,kaist_dataset/Korean/Digital_Camera/outdoor7/P1010138.JPG,char_data/8/P1010138.JPG_11.jpg,612,480,640,18,327,345,285,319,True,10
8,41,kaist_dataset/Korean/Digital_Camera/outdoor7/P1010138.JPG,char_data/8/P1010138.JPG_12.jpg,738,480,640,18,363,381,279,320,True,10
8,42,kaist_dataset/Korean/Digital_Camera/outdoor7/P1010138.JPG,char_data/8/P1010138.JPG_13.jpg,882,480,640,21,381,402,280,322,True,10
8,57,kaist_dataset/Korean/Digital_Camera/outdoor8/DSC02950.JPG,char_data/8/DSC02950.JPG_2.jpg,2736,480,640,48,194,242,281,338,True,10
8,26,kaist_dataset/Korean/Digital_Camera/outdoor8/P090912069.jpg,char_data/8/P090912069.jpg_4.jpg,676,480,640,26,273,299,259,285,True,10
8,28,kaist_dataset/Korean/Digital_Camera/outdoor8/P090912069.jpg,char_data/8/P090912069.jpg_5.jpg,952,480,640,34,387,421,232,260,True,10
8,37,kaist_dataset/Korean/Digital_Camera/outdoor8/P1010142.JPG,char_data/8/P1010142.JPG_8.jpg,814,480,640,22,285,307,281,318,True,10
8,37,kaist_dataset/Korean/Digital_Camera/outdoor8/P1010142.JPG,char_data/8/P1010142.JPG_9.jpg,814,480,640,22,355,377,280,317,True,10
8,39,kaist_dataset/Korean/Digital_Camera/outdoor8/P1010142.JPG,char_data/8/P1010142.JPG_10.jpg,936,480,640,24,426,450,279,318,True,10
8,38,kaist_dataset/Korean/Digital_Camera/outdoor8/P1010142.JPG,char_data/8/P1010142.JPG_11.jpg,798,480,640,21,404,425,278,316,True,10
8,36,kaist_dataset/Korean/Digital_Camera/outdoor8/P1010143.JPG,char_data/8/P1010143.JPG_2.jpg,828,480,640,23,334,357,266,302,True,10
8,44,kaist_dataset/Korean/Digital_Camera/outdoor8/P1010147.JPG,char_data/8/P1010147.JPG_8.jpg,1320,480,640,30,384,414,315,359,True,10
8,41,kaist_dataset/Korean/Digital_Camera/outdoor8/P1010147.JPG,char_data/8/P1010147.JPG_9.jpg,1107,480,640,27,414,441,317,358,True,10
8,51,kaist_dataset/Korean/Digital_Camera/outdoor8/P1010147.JPG,char_data/8/P1010147.JPG_10.jpg,1632,480,640,32,489,521,314,365,True,10
8,67,kaist_dataset/Korean/Digital_Camera/outdoor8/P1010160.JPG,char_data/8/P1010160.JPG_2.jpg,3618,480,640,54,191,245,228,295,True,10
8,39,kaist_dataset/Korean/Digital_Camera/outdoor8/P1010170.JPG,char_data/8/P1010170.JPG_2.jpg,858,480,640,22,355,377,274,313,True,10
8,30,kaist_dataset/Korean/Digital_Camera/outdoor8/P1010178.JPG,char_data/8/P1010178.JPG_2.jpg,570,480,640,19,295,314,392,422,True,10
8,38,kaist_dataset/Korean/Digital_Camera/outdoor8/P1010189.JPG,char_data/8/P1010189.JPG_4.jpg,1026,480,640,27,342,369,230,268,True,10
8,36,kaist_dataset/Korean/Digital_Camera/outdoor8/P1010189.JPG,char_data/8/P1010189.JPG_5.jpg,1080,480,640,30,432,462,232,268,True,10
8,36,kaist_dataset/Korean/Digital_Camera/outdoor8/P1011112.JPG,char_data/8/P1011112.JPG_2.jpg,828,480,640,23,298,321,208,244,True,10
8,41,kaist_dataset/Korean/Digital_Camera/outdoor8/크기변환_P1010033.JPG,char_data/8/크기변환_P1010033.JPG_2.jpg,902,480,640,22,600,622,170,211,True,10
8,50,"kaist_dataset/Korean/Mobile_Phone/(M,K)C-outdoor/P090912033.jpg",char_data/8/P090912033.jpg_2.jpg,2000,480,640,40,207,247,354,404,True,10
8,43,"kaist_dataset/Korean/Mobile_Phone/(M,K)C-outdoor/P090912034.jpg",char_data/8/P090912034.jpg_4.jpg,1204,480,640,28,97,125,258,301,True,10
8,44,"kaist_dataset/Korean/Mobile_Phone/(M,K)C-outdoor/P090912034.jpg",char_data/8/P090912034.jpg_5.jpg,1144,480,640,26,235,261,258,302,True,10
8,28,"kaist_dataset/Korean/Mobile_Phone/(M,K)C-outdoor/P090912042.jpg",char_data/8/P090912042.jpg_2.jpg,504,480,640,18,347,365,256,284,True,10
8,48,kaist_dataset/Mixed/Digital_Camera/(C.S)A-shadow/DSC02567.JPG,char_data/8/DSC02567.JPG_4.jpg,2064,480,640,43,178,221,143,191,True,10
8,38,kaist_dataset/Mixed/Digital_Camera/(C.S)A-shadow/DSC02579.JPG,char_data/8/DSC02579.JPG_2.jpg,988,480,640,26,211,237,399,437,True,10
8,42,kaist_dataset/Mixed/Digital_Camera/(C.S)A-shadow/DSC02581.JPG,char_data/8/DSC02581.JPG_4.jpg,798,480,640,19,231,250,385,427,True,10
8,36,kaist_dataset/Mixed/Digital_Camera/(C.S)A-shadow/DSC02581.JPG,char_data/8/DSC02581.JPG_5.jpg,720,480,640,20,372,392,385,421,True,10
8,31,kaist_dataset/Mixed/Digital_Camera/(C.S)A-shadow/DSC02624.JPG,char_data/8/DSC02624.JPG_4.jpg,527,480,640,17,426,443,398,429,True,10
8,34,kaist_dataset/Mixed/Digital_Camera/(C.S)A-shadow/DSC03257.JPG,char_data/8/DSC03257.JPG_6.jpg,680,480,640,20,277,297,384,418,True,10
8,39,kaist_dataset/Mixed/Digital_Camera/(C.S)A-shadow/DSC03257.JPG,char_data/8/DSC03257.JPG_7.jpg,897,480,640,23,337,360,383,422,True,10
8,39,kaist_dataset/Mixed/Digital_Camera/(C.S)A-shadow/DSC03257.JPG,char_data/8/DSC03257.JPG_8.jpg,858,480,640,22,384,406,380,419,True,10
8,59,kaist_dataset/Mixed/Digital_Camera/(C.S)A-shadow/DSC04304.JPG,char_data/8/DSC04304.JPG_4.jpg,2360,480,640,40,332,372,282,341,True,10
8,60,kaist_dataset/Mixed/Digital_Camera/(C.S)A-shadow/DSC04304.JPG,char_data/8/DSC04304.JPG_5.jpg,1980,480,640,33,542,575,278,338,True,10
8,31,kaist_dataset/Mixed/Digital_Camera/(C.S)A-shadow/DSC04306.JPG,char_data/8/DSC04306.JPG_2.jpg,558,480,640,18,236,254,412,443,True,10
8,58,kaist_dataset/Mixed/Digital_Camera/(C.S)A-shadow/DSC04326.JPG,char_data/8/DSC04326.JPG_4.jpg,1914,480,640,33,319,352,20,78,True,10
8,67,kaist_dataset/Mixed/Digital_Camera/(C.S)A-shadow/DSC04326.JPG,char_data/8/DSC04326.JPG_5.jpg,2010,480,640,30,507,537,15,82,True,10
8,35,kaist_dataset/Mixed/Digital_Camera/(C.S)B-light/DSC03298.JPG,char_data/8/DSC03298.JPG_2.jpg,455,480,640,13,373,386,286,321,True,10
8,31,kaist_dataset/Mixed/Digital_Camera/(C.S)C-outdoor1/008.JPG,char_data/8/008.JPG_2.jpg,589,480,640,19,438,457,265,296,True,10
8,38,kaist_dataset/Mixed/Digital_Camera/(C.S)C-outdoor1/009.JPG,char_data/8/009.JPG_4.jpg,874,480,640,23,257,280,320,358,True,10
8,35,kaist_dataset/Mixed/Digital_Camera/(C.S)C-outdoor1/009.JPG,char_data/8/009.JPG_5.jpg,770,480,640,22,340,362,320,355,True,10
8,27,kaist_dataset/Mixed/Digital_Camera/(C.S)C-outdoor1/014.JPG,char_data/8/014.JPG_2.jpg,378,480,640,14,153,167,272,299,True,10
8,58,kaist_dataset/Mixed/Digital_Camera/(C.S)C-outdoor1/025.JPG,char_data/8/025.JPG_12.jpg,1624,480,640,28,123,151,331,389,True,10
8,55,kaist_dataset/Mixed/Digital_Camera/(C.S)C-outdoor1/025.JPG,char_data/8/025.JPG_13.jpg,1760,480,640,32,226,258,334,389,True,10
8,55,kaist_dataset/Mixed/Digital_Camera/(C.S)C-outdoor1/025.JPG,char_data/8/025.JPG_14.jpg,1595,480,640,29,281,310,335,390,True,10
8,54,kaist_dataset/Mixed/Digital_Camera/(C.S)C-outdoor1/025.JPG,char_data/8/025.JPG_15.jpg,1674,480,640,31,380,411,340,394,True,10
8,52,kaist_dataset/Mixed/Digital_Camera/(C.S)C-outdoor1/025.JPG,char_data/8/025.JPG_16.jpg,1404,480,640,27,485,512,340,392,True,10
8,51,kaist_dataset/Mixed/Digital_Camera/(C.S)C-outdoor1/025.JPG,char_data/8/025.JPG_17.jpg,1428,480,640,28,535,563,341,392,True,10
8,31,kaist_dataset/Mixed/Digital_Camera/(C.S)C-outdoor1/027.JPG,char_data/8/027.JPG_4.jpg,496,480,640,16,394,410,274,305,True,10
8,27,kaist_dataset/Mixed/Digital_Camera/(C.S)C-outdoor1/027.JPG,char_data/8/027.JPG_5.jpg,405,480,640,15,482,497,278,305,True,10
8,19,kaist_dataset/Mixed/Digital_Camera/(C.S)C-outdoor1/047.JPG,char_data/8/047.JPG_6.jpg,190,480,640,10,552,562,175,194,True,10
8,24,kaist_dataset/Mixed/Digital_Camera/(C.S)C-outdoor1/047.JPG,char_data/8/047.JPG_7.jpg,288,480,640,12,591,603,241,265,True,10
8,24,kaist_dataset/Mixed/Digital_Camera/(C.S)C-outdoor1/047.JPG,char_data/8/047.JPG_8.jpg,312,480,640,13,610,623,241,265,True,10
8,29,kaist_dataset/Mixed/Digital_Camera/(C.S)C-outdoor1/048.JPG,char_data/8/048.JPG_2.jpg,580,480,640,20,260,280,258,287,True,10
8,23,kaist_dataset/Mixed/Digital_Camera/(C.S)C-outdoor1/054.JPG,char_data/8/054.JPG_6.jpg,414,480,640,18,454,472,304,327,True,10
8,21,kaist_dataset/Mixed/Digital_Camera/(C.S)C-outdoor1/054.JPG,char_data/8/054.JPG_7.jpg,378,480,640,18,553,571,309,330,True,10
8,22,kaist_dataset/Mixed/Digital_Camera/(C.S)C-outdoor1/054.JPG,char_data/8/054.JPG_8.jpg,374,480,640,17,572,589,306,328,True,10
8,157,kaist_dataset/Mixed/Digital_Camera/(C.S)C-outdoor1/080118-0007.jpg,char_data/8/080118-0007.jpg_2.jpg,14915,1200,1600,95,135,230,199,356,True,10
8,54,kaist_dataset/Mixed/Digital_Camera/(C.S)C-outdoor1/1.JPG,char_data/8/1.JPG_2.jpg,1350,576,768,25,167,192,457,511,True,10
8,41,kaist_dataset/Mixed/Digital_Camera/(C.S)C-outdoor1/105.jpg,char_data/8/105.jpg_2.jpg,861,480,640,21,297,318,383,424,True,10
8,36,kaist_dataset/Mixed/Digital_Camera/(C.S)C-outdoor1/118.JPG,char_data/8/118.JPG_4.jpg,684,480,640,19,334,353,357,393,True,10
8,29,kaist_dataset/Mixed/Digital_Camera/(C.S)C-outdoor1/118.JPG,char_data/8/118.JPG_5.jpg,609,480,640,21,462,483,361,390,True,10
8,30,kaist_dataset/Mixed/Digital_Camera/(C.S)C-outdoor1/121.JPG,char_data/8/121.JPG_6.jpg,450,480,640,15,276,291,275,305,True,10
8,34,kaist_dataset/Mixed/Digital_Camera/(C.S)C-outdoor1/121.JPG,char_data/8/121.JPG_7.jpg,476,480,640,14,412,426,270,304,True,10
8,22,kaist_dataset/Mixed/Digital_Camera/(C.S)C-outdoor1/121.JPG,char_data/8/121.JPG_8.jpg,286,480,640,13,507,520,279,301,True,10
8,43,kaist_dataset/Mixed/Digital_Camera/(C.S)C-outdoor1/2.JPG,char_data/8/2.JPG_4.jpg,860,576,768,20,264,284,64,107,True,10
8,20,kaist_dataset/Mixed/Digital_Camera/(C.S)C-outdoor1/2.JPG,char_data/8/2.JPG_5.jpg,220,576,768,11,558,569,396,416,True,10
8,56,kaist_dataset/Mixed/Digital_Camera/(C.S)C-outdoor1/2007-12-08-day-091.jpg,char_data/8/2007-12-08-day-091.jpg_4.jpg,2520,1200,1600,45,1085,1130,636,692,True,10
8,70,kaist_dataset/Mixed/Digital_Camera/(C.S)C-outdoor1/2007-12-08-day-091.jpg,char_data/8/2007-12-08-day-091.jpg_5.jpg,2870,1200,1600,41,1270,1311,621,691,True,10
8,94,kaist_dataset/Mixed/Digital_Camera/(C.S)C-outdoor1/2007-12-08-day-092.jpg,char_data/8/2007-12-08-day-092.jpg_4.jpg,5922,1200,1600,63,534,597,664,758,True,10
8,93,kaist_dataset/Mixed/Digital_Camera/(C.S)C-outdoor1/2007-12-08-day-092.jpg,char_data/8/2007-12-08-day-092.jpg_5.jpg,6417,1200,1600,69,828,897,659,752,True,10
8,220,kaist_dataset/Mixed/Digital_Camera/(C.S)C-outdoor1/2007-12-08-day-118.jpg,char_data/8/2007-12-08-day-118.jpg_2.jpg,28380,1200,1600,129,756,885,501,721,True,10
8,46,kaist_dataset/Mixed/Digital_Camera/(C.S)C-outdoor1/2007-12-08-day-130.jpg,char_data/8/2007-12-08-day-130.jpg_6.jpg,1380,1200,1600,30,950,980,750,796,True,10
8,37,kaist_dataset/Mixed/Digital_Camera/(C.S)C-outdoor1/2007-12-08-day-130.jpg,char_data/8/2007-12-08-day-130.jpg_7.jpg,1110,1200,1600,30,1102,1132,762,799,True,10
8,42,kaist_dataset/Mixed/Digital_Camera/(C.S)C-outdoor1/2007-12-08-day-130.jpg,char_data/8/2007-12-08-day-130.jpg_8.jpg,1470,1200,1600,35,1131,1166,761,803,True,10
8,59,kaist_dataset/Mixed/Digital_Camera/(C.S)C-outdoor1/2007-12-09-day-exterior-004.jpg,char_data/8/2007-12-09-day-exterior-004.jpg_2.jpg,2891,1200,1600,49,979,1028,662,721,True,10
8,47,kaist_dataset/Mixed/Digital_Camera/(C.S)C-outdoor1/2007-12-09-day-exterior-037.jpg,char_data/8/2007-12-09-day-exterior-037.jpg_2.jpg,1786,1200,1600,38,661,699,709,756,True,10
8,48,kaist_dataset/Mixed/Digital_Camera/(C.S)C-outdoor1/2007-12-09-day-exterior-078.jpg,char_data/8/2007-12-09-day-exterior-078.jpg_2.jpg,1200,1200,1600,25,420,445,597,645,True,10
8,71,kaist_dataset/Mixed/Digital_Camera/(C.S)C-outdoor1/2007-12-09-day-exterior-086.jpg,char_data/8/2007-12-09-day-exterior-086.jpg_2.jpg,4828,1200,1600,68,688,756,718,789,True,10
8,39,kaist_dataset/Mixed/Digital_Camera/(C.S)C-outdoor1/45.JPG,char_data/8/45.JPG_2.jpg,1443,576,768,37,269,306,364,403,True,10
8,27,kaist_dataset/Mixed/Digital_Camera/(C.S)C-outdoor1/47.JPG,char_data/8/47.JPG_2.jpg,486,576,768,18,305,323,475,502,True,10
8,24,kaist_dataset/Mixed/Digital_Camera/(C.S)C-outdoor1/48.JPG,char_data/8/48.JPG_2.jpg,432,576,768,18,197,215,340,364,True,10
8,42,kaist_dataset/Mixed/Digital_Camera/(C.S)C-outdoor1/51.JPG,char_data/8/51.JPG_2.jpg,1092,576,768,26,498,524,375,417,True,10
8,33,kaist_dataset/Mixed/Digital_Camera/(C.S)C-outdoor1/55.JPG,char_data/8/55.JPG_2.jpg,891,576,768,27,279,306,371,404,True,10
8,39,kaist_dataset/Mixed/Digital_Camera/(C.S)C-outdoor1/56.JPG,char_data/8/56.JPG_2.jpg,1287,576,768,33,319,352,303,342,True,10
8,28,kaist_dataset/Mixed/Digital_Camera/(C.S)C-outdoor1/57.JPG,char_data/8/57.JPG_4.jpg,392,500,766,14,324,338,291,319,True,10
8,26,kaist_dataset/Mixed/Digital_Camera/(C.S)C-outdoor1/57.JPG,char_data/8/57.JPG_5.jpg,364,500,766,14,402,416,295,321,True,10
8,38,kaist_dataset/Mixed/Digital_Camera/(C.S)C-outdoor1/DSC02242.JPG,char_data/8/DSC02242.JPG_2.jpg,798,480,640,21,537,558,257,295,True,10
8,80,kaist_dataset/Mixed/Digital_Camera/(C.S)C-outdoor1/DSC02244.JPG,char_data/8/DSC02244.JPG_2.jpg,4160,480,640,52,176,228,351,431,True,10
8,43,kaist_dataset/Mixed/Digital_Camera/(C.S)C-outdoor1/DSC02312.JPG,char_data/8/DSC02312.JPG_2.jpg,1634,480,640,38,128,166,220,263,True,10
8,42,kaist_dataset/Mixed/Digital_Camera/(C.S)C-outdoor1/DSC02322.JPG,char_data/8/DSC02322.JPG_2.jpg,1470,480,640,35,154,189,365,407,True,10
8,33,kaist_dataset/Mixed/Digital_Camera/(C.S)C-outdoor1/DSC02344.JPG,char_data/8/DSC02344.JPG_2.jpg,528,480,640,16,494,510,255,288,True,10
8,37,kaist_dataset/Mixed/Digital_Camera/(C.S)C-outdoor1/DSC02349.JPG,char_data/8/DSC02349.JPG_4.jpg,999,480,640,27,265,292,196,233,True,10
8,38,kaist_dataset/Mixed/Digital_Camera/(C.S)C-outdoor1/DSC02349.JPG,char_data/8/DSC02349.JPG_5.jpg,950,480,640,25,346,371,426,464,True,10
8,42,kaist_dataset/Mixed/Digital_Camera/(C.S)C-outdoor1/DSC02350.JPG,char_data/8/DSC02350.JPG_2.jpg,1050,480,640,25,242,267,396,438,True,10
8,49,kaist_dataset/Mixed/Digital_Camera/(C.S)C-outdoor1/P1010009.JPG,char_data/8/P1010009.JPG_5.jpg,1078,480,640,22,182,204,237,286,True,10
8,51,kaist_dataset/Mixed/Digital_Camera/(C.S)C-outdoor1/P1010012.JPG,char_data/8/P1010012.JPG_7.jpg,1581,480,640,31,328,359,234,285,True,10
8,57,kaist_dataset/Mixed/Digital_Camera/(C.S)C-outdoor1/P1010012.JPG,char_data/8/P1010012.JPG_8.jpg,1710,480,640,30,426,456,231,288,True,10
8,56,kaist_dataset/Mixed/Digital_Camera/(C.S)C-outdoor2/DSC02359.JPG,char_data/8/DSC02359.JPG_6.jpg,1288,480,640,23,235,258,411,467,True,10
8,53,kaist_dataset/Mixed/Digital_Camera/(C.S)C-outdoor2/DSC02359.JPG,char_data/8/DSC02359.JPG_7.jpg,1590,480,640,30,331,361,414,467,True,10
8,51,kaist_dataset/Mixed/Digital_Camera/(C.S)C-outdoor2/DSC02359.JPG,char_data/8/DSC02359.JPG_8.jpg,1071,480,640,21,363,384,414,465,True,10
8,36,kaist_dataset/Mixed/Digital_Camera/(C.S)C-outdoor2/DSC02361.JPG,char_data/8/DSC02361.JPG_2.jpg,612,480,640,17,498,515,376,412,True,10
8,32,kaist_dataset/Mixed/Digital_Camera/(C.S)C-outdoor2/DSC02368.JPG,char_data/8/DSC02368.JPG_2.jpg,448,480,640,14,127,141,385,417,True,10
8,42,kaist_dataset/Mixed/Digital_Camera/(C.S)C-outdoor2/DSC02374.JPG,char_data/8/DSC02374.JPG_4.jpg,798,480,640,19,244,263,301,343,True,10
8,41,kaist_dataset/Mixed/Digital_Camera/(C.S)C-outdoor2/DSC02374.JPG,char_data/8/DSC02374.JPG_5.jpg,984,480,640,24,391,415,294,335,True,10
8,38,kaist_dataset/Mixed/Digital_Camera/(C.S)C-outdoor2/DSC02376.JPG,char_data/8/DSC02376.JPG_4.jpg,950,480,640,25,420,445,338,376,True,10
8,40,kaist_dataset/Mixed/Digital_Camera/(C.S)C-outdoor2/DSC02376.JPG,char_data/8/DSC02376.JPG_5.jpg,1000,480,640,25,530,555,336,376,True,10
8,36,kaist_dataset/Mixed/Digital_Camera/(C.S)C-outdoor2/DSC02377.JPG,char_data/8/DSC02377.JPG_4.jpg,828,480,640,23,423,446,354,390,True,10
8,38,kaist_dataset/Mixed/Digital_Camera/(C.S)C-outdoor2/DSC02377.JPG,char_data/8/DSC02377.JPG_5.jpg,988,480,640,26,531,557,352,390,True,10
8,31,kaist_dataset/Mixed/Digital_Camera/(C.S)C-outdoor2/DSC02379.JPG,char_data/8/DSC02379.JPG_2.jpg,651,480,640,21,388,409,289,320,True,10
8,44,kaist_dataset/Mixed/Digital_Camera/(C.S)C-outdoor2/DSC02389.JPG,char_data/8/DSC02389.JPG_4.jpg,1320,480,640,30,219,249,46,90,True,10
8,36,kaist_dataset/Mixed/Digital_Camera/(C.S)C-outdoor2/DSC02389.JPG,char_data/8/DSC02389.JPG_5.jpg,1764,480,640,49,125,174,259,295,True,10
8,41,kaist_dataset/Mixed/Digital_Camera/(C.S)C-outdoor2/DSC02391.JPG,char_data/8/DSC02391.JPG_2.jpg,902,480,640,22,191,213,332,373,True,10
8,30,kaist_dataset/Mixed/Digital_Camera/(C.S)C-outdoor2/DSC02397.JPG,char_data/8/DSC02397.JPG_4.jpg,690,480,640,23,419,442,209,239,True,10
8,33,kaist_dataset/Mixed/Digital_Camera/(C.S)C-outdoor2/DSC02397.JPG,char_data/8/DSC02397.JPG_5.jpg,726,480,640,22,555,577,204,237,True,10
8,49,kaist_dataset/Mixed/Digital_Camera/(C.S)C-outdoor2/DSC02400.JPG,char_data/8/DSC02400.JPG_2.jpg,1568,480,640,32,179,211,397,446,True,10
8,42,kaist_dataset/Mixed/Digital_Camera/(C.S)C-outdoor2/DSC02411.JPG,char_data/8/DSC02411.JPG_2.jpg,1134,480,640,27,373,400,349,391,True,10
8,44,kaist_dataset/Mixed/Digital_Camera/(C.S)C-outdoor2/DSC02413.JPG,char_data/8/DSC02413.JPG_4.jpg,1496,480,640,34,318,352,208,252,True,10
8,38,kaist_dataset/Mixed/Digital_Camera/(C.S)C-outdoor2/DSC02413.JPG,char_data/8/DSC02413.JPG_5.jpg,988,480,640,26,469,495,208,246,True,10
8,37,kaist_dataset/Mixed/Digital_Camera/(C.S)C-outdoor2/DSC02419.JPG,char_data/8/DSC02419.JPG_2.jpg,851,480,640,23,455,478,212,249,True,10
8,31,kaist_dataset/Mixed/Digital_Camera/(C.S)C-outdoor2/DSC02422.JPG,char_data/8/DSC02422.JPG_2.jpg,589,480,640,19,344,363,223,254,True,10
8,29,kaist_dataset/Mixed/Digital_Camera/(C.S)C-outdoor2/DSC02447.JPG,char_data/8/DSC02447.JPG_4.jpg,435,480,640,15,473,488,227,256,True,10
8,32,kaist_dataset/Mixed/Digital_Camera/(C.S)C-outdoor2/DSC02447.JPG,char_data/8/DSC02447.JPG_5.jpg,416,480,640,13,529,542,224,256,True,10
8,32,kaist_dataset/Mixed/Digital_Camera/(C.S)C-outdoor2/DSC02460.JPG,char_data/8/DSC02460.JPG_2.jpg,704,480,640,22,301,323,305,337,True,10
8,49,kaist_dataset/Mixed/Digital_Camera/(C.S)C-outdoor2/DSC02461.JPG,char_data/8/DSC02461.JPG_2.jpg,3185,480,640,65,102,167,286,335,True,10
8,35,kaist_dataset/Mixed/Digital_Camera/(C.S)C-outdoor2/DSC02466.JPG,char_data/8/DSC02466.JPG_4.jpg,1260,480,640,36,156,192,258,293,True,10
8,36,kaist_dataset/Mixed/Digital_Camera/(C.S)C-outdoor2/DSC02466.JPG,char_data/8/DSC02466.JPG_5.jpg,1116,480,640,31,283,314,255,291,True,10
8,25,kaist_dataset/Mixed/Digital_Camera/(C.S)C-outdoor2/DSC02477.JPG,char_data/8/DSC02477.JPG_6.jpg,450,480,640,18,59,77,256,281,True,10
8,27,kaist_dataset/Mixed/Digital_Camera/(C.S)C-outdoor2/DSC02477.JPG,char_data/8/DSC02477.JPG_7.jpg,594,480,640,22,281,303,248,275,True,10
8,26,kaist_dataset/Mixed/Digital_Camera/(C.S)C-outdoor2/DSC02477.JPG,char_data/8/DSC02477.JPG_8.jpg,702,480,640,27,398,425,244,270,True,10
8,31,kaist_dataset/Mixed/Digital_Camera/(C.S)C-outdoor2/DSC02479.JPG,char_data/8/DSC02479.JPG_2.jpg,620,480,640,20,444,464,222,253,True,10
8,39,kaist_dataset/Mixed/Digital_Camera/(C.S)C-outdoor2/DSC02482.JPG,char_data/8/DSC02482.JPG_4.jpg,1053,480,640,27,345,372,324,363,True,10
8,43,kaist_dataset/Mixed/Digital_Camera/(C.S)C-outdoor2/DSC02482.JPG,char_data/8/DSC02482.JPG_5.jpg,1462,480,640,34,483,517,321,364,True,10
8,34,kaist_dataset/Mixed/Digital_Camera/(C.S)C-outdoor2/DSC02489.JPG,char_data/8/DSC02489.JPG_4.jpg,612,480,640,18,262,280,262,296,True,10
8,41,kaist_dataset/Mixed/Digital_Camera/(C.S)C-outdoor2/DSC02489.JPG,char_data/8/DSC02489.JPG_5.jpg,984,480,640,24,396,420,258,299,True,10
8,40,kaist_dataset/Mixed/Digital_Camera/(C.S)C-outdoor2/DSC02490.JPG,char_data/8/DSC02490.JPG_2.jpg,840,480,640,21,274,295,342,382,True,10
8,34,kaist_dataset/Mixed/Digital_Camera/(C.S)C-outdoor2/DSC02492.JPG,char_data/8/DSC02492.JPG_2.jpg,714,480,640,21,353,374,325,359,True,10
8,68,kaist_dataset/Mixed/Digital_Camera/(C.S)C-outdoor2/DSC02502.JPG,char_data/8/DSC02502.JPG_2.jpg,3128,480,640,46,82,128,350,418,True,10
8,69,kaist_dataset/Mixed/Digital_Camera/(C.S)C-outdoor2/DSC02503.JPG,char_data/8/DSC02503.JPG_4.jpg,3381,480,640,49,315,364,348,417,True,10
8,60,kaist_dataset/Mixed/Digital_Camera/(C.S)C-outdoor2/DSC02503.JPG,char_data/8/DSC02503.JPG_5.jpg,2880,480,640,48,416,464,349,409,True,10
8,34,kaist_dataset/Mixed/Digital_Camera/(C.S)C-outdoor2/DSC02511.JPG,char_data/8/DSC02511.JPG_4.jpg,748,480,640,22,289,311,209,243,True,10
8,40,kaist_dataset/Mixed/Digital_Camera/(C.S)C-outdoor2/DSC02511.JPG,char_data/8/DSC02511.JPG_5.jpg,1000,480,640,25,240,265,393,433,True,10
8,82,kaist_dataset/Mixed/Digital_Camera/(C.S)C-outdoor2/DSC02513.JPG,char_data/8/DSC02513.JPG_2.jpg,4838,480,640,59,133,192,140,222,True,10
8,36,kaist_dataset/Mixed/Digital_Camera/(C.S)C-outdoor2/DSC02543.JPG,char_data/8/DSC02543.JPG_2.jpg,828,480,640,23,312,335,350,386,True,10
8,37,kaist_dataset/Mixed/Digital_Camera/(C.S)C-outdoor2/DSC02545.JPG,char_data/8/DSC02545.JPG_2.jpg,1147,480,640,31,216,247,402,439,True,10
8,35,kaist_dataset/Mixed/Digital_Camera/(C.S)C-outdoor2/DSC02553.JPG,char_data/8/DSC02553.JPG_2.jpg,770,480,640,22,303,325,298,333,True,10
8,25,kaist_dataset/Mixed/Digital_Camera/(C.S)C-outdoor2/DSC02555.JPG,char_data/8/DSC02555.JPG_6.jpg,675,480,640,27,62,89,252,277,True,10
8,27,kaist_dataset/Mixed/Digital_Camera/(C.S)C-outdoor2/DSC02555.JPG,char_data/8/DSC02555.JPG_7.jpg,756,480,640,28,317,345,251,278,True,10
8,24,kaist_dataset/Mixed/Digital_Camera/(C.S)C-outdoor2/DSC02555.JPG,char_data/8/DSC02555.JPG_8.jpg,576,480,640,24,442,466,251,275,True,10
8,33,kaist_dataset/Mixed/Digital_Camera/(C.S)C-outdoor2/DSC02556.JPG,char_data/8/DSC02556.JPG_4.jpg,924,480,640,28,279,307,341,374,True,10
8,34,kaist_dataset/Mixed/Digital_Camera/(C.S)C-outdoor2/DSC02556.JPG,char_data/8/DSC02556.JPG_5.jpg,918,480,640,27,429,456,343,377,True,10
8,37,kaist_dataset/Mixed/Digital_Camera/(C.S)C-outdoor2/DSC02557.JPG,char_data/8/DSC02557.JPG_2.jpg,999,480,640,27,363,390,212,249,True,10
8,32,kaist_dataset/Mixed/Digital_Camera/(C.S)C-outdoor2/DSC02560.JPG,char_data/8/DSC02560.JPG_2.jpg,832,480,640,26,502,528,304,336,True,10
8,48,kaist_dataset/Mixed/Digital_Camera/(C.S)C-outdoor2/DSC02567.JPG,char_data/8/DSC02567.JPG_5.jpg,2064,480,640,43,178,221,143,191,True,10
8,31,kaist_dataset/Mixed/Digital_Camera/(C.S)C-outdoor2/DSC02624.JPG,char_data/8/DSC02624.JPG_5.jpg,527,480,640,17,426,443,398,429,True,10
8,98,kaist_dataset/Mixed/Digital_Camera/(C.S)C-outdoor2/DSC02865.JPG,char_data/8/DSC02865.JPG_4.jpg,5292,480,640,54,166,220,304,402,True,10
8,98,kaist_dataset/Mixed/Digital_Camera/(C.S)C-outdoor2/DSC02865.JPG,char_data/8/DSC02865.JPG_5.jpg,5978,480,640,61,218,279,307,405,True,10
8,27,kaist_dataset/Mixed/Digital_Camera/(C.S)C-outdoor2/DSC02877.JPG,char_data/8/DSC02877.JPG_2.jpg,351,480,640,13,517,530,218,245,True,10
8,25,kaist_dataset/Mixed/Digital_Camera/(C.S)C-outdoor2/DSC02879.JPG,char_data/8/DSC02879.JPG_2.jpg,300,480,640,12,285,297,280,305,True,10
8,33,kaist_dataset/Mixed/Digital_Camera/(C.S)C-outdoor2/DSC02887.JPG,char_data/8/DSC02887.JPG_4.jpg,660,480,640,20,262,282,121,154,True,10
8,37,kaist_dataset/Mixed/Digital_Camera/(C.S)C-outdoor2/DSC02887.JPG,char_data/8/DSC02887.JPG_5.jpg,925,480,640,25,375,400,115,152,True,10
8,36,kaist_dataset/Mixed/Digital_Camera/(C.S)C-outdoor2/DSC02894.JPG,char_data/8/DSC02894.JPG_4.jpg,1008,480,640,28,385,413,245,281,True,10
8,39,kaist_dataset/Mixed/Digital_Camera/(C.S)C-outdoor2/DSC02894.JPG,char_data/8/DSC02894.JPG_5.jpg,1092,480,640,28,283,311,256,295,True,10
8,34,kaist_dataset/Mixed/Digital_Camera/(C.S)C-outdoor2/DSC02895.JPG,char_data/8/DSC02895.JPG_2.jpg,646,480,640,19,219,238,360,394,True,10
8,37,kaist_dataset/Mixed/Digital_Camera/(C.S)C-outdoor2/DSC02912.JPG,char_data/8/DSC02912.JPG_4.jpg,1258,480,640,34,201,235,439,476,True,10
8,36,kaist_dataset/Mixed/Digital_Camera/(C.S)C-outdoor2/DSC02912.JPG,char_data/8/DSC02912.JPG_5.jpg,1296,480,640,36,305,341,441,477,True,10
8,29,kaist_dataset/Mixed/Digital_Camera/(C.S)C-outdoor2/DSC02917.JPG,char_data/8/DSC02917.JPG_4.jpg,522,480,640,18,577,595,227,256,True,10
8,29,kaist_dataset/Mixed/Digital_Camera/(C.S)C-outdoor2/DSC02917.JPG,char_data/8/DSC02917.JPG_5.jpg,609,480,640,21,595,616,228,257,True,10
8,33,kaist_dataset/Mixed/Digital_Camera/(C.S)C-outdoor2/DSC02930.JPG,char_data/8/DSC02930.JPG_4.jpg,594,480,640,18,392,410,192,225,True,10
8,35,kaist_dataset/Mixed/Digital_Camera/(C.S)C-outdoor2/DSC02930.JPG,char_data/8/DSC02930.JPG_5.jpg,805,480,640,23,409,432,191,226,True,10
8,37,kaist_dataset/Mixed/Digital_Camera/(C.S)C-outdoor2/DSC02933.JPG,char_data/8/DSC02933.JPG_4.jpg,666,480,640,18,495,513,242,279,True,10
8,34,kaist_dataset/Mixed/Digital_Camera/(C.S)C-outdoor2/DSC02933.JPG,char_data/8/DSC02933.JPG_5.jpg,612,480,640,18,585,603,245,279,True,10
8,44,kaist_dataset/Mixed/Digital_Camera/(C.S)C-outdoor2/DSC02937.JPG,char_data/8/DSC02937.JPG_2.jpg,1012,480,640,23,126,149,202,246,True,10
8,29,kaist_dataset/Mixed/Digital_Camera/(C.S)C-outdoor2/DSC02947.JPG,char_data/8/DSC02947.JPG_6.jpg,609,480,640,21,481,502,235,264,True,10
8,24,kaist_dataset/Mixed/Digital_Camera/(C.S)C-outdoor2/DSC02947.JPG,char_data/8/DSC02947.JPG_7.jpg,360,480,640,15,502,517,240,264,True,10
8,31,kaist_dataset/Mixed/Digital_Camera/(C.S)C-outdoor2/DSC02947.JPG,char_data/8/DSC02947.JPG_8.jpg,682,480,640,22,516,538,237,268,True,10
8,38,kaist_dataset/Mixed/Digital_Camera/(C.S)C-outdoor2/DSC02954.JPG,char_data/8/DSC02954.JPG_8.jpg,950,480,640,25,118,143,254,292,True,10
8,38,kaist_dataset/Mixed/Digital_Camera/(C.S)C-outdoor2/DSC02954.JPG,char_data/8/DSC02954.JPG_9.jpg,760,480,640,20,219,239,258,296,True,10
8,39,kaist_dataset/Mixed/Digital_Camera/(C.S)C-outdoor2/DSC02954.JPG,char_data/8/DSC02954.JPG_10.jpg,858,480,640,22,467,489,265,304,True,10
8,36,kaist_dataset/Mixed/Digital_Camera/(C.S)C-outdoor2/DSC02954.JPG,char_data/8/DSC02954.JPG_11.jpg,720,480,640,20,558,578,267,303,True,10
8,48,kaist_dataset/Mixed/Digital_Camera/(C.S)C-outdoor2/P1010013.JPG,char_data/8/P1010013.JPG_2.jpg,1392,480,640,29,251,280,365,413,True,10
8,21,kaist_dataset/Mixed/Digital_Camera/(C.S)C-outdoor2/P1010015.JPG,char_data/8/P1010015.JPG_2.jpg,252,480,640,12,356,368,189,210,True,10
8,44,kaist_dataset/Mixed/Digital_Camera/(C.S)C-outdoor3/DSC02958.JPG,char_data/8/DSC02958.JPG_4.jpg,1144,480,640,26,360,386,400,444,True,10
8,39,kaist_dataset/Mixed/Digital_Camera/(C.S)C-outdoor3/DSC02958.JPG,char_data/8/DSC02958.JPG_5.jpg,1209,480,640,31,384,415,403,442,True,10
8,46,kaist_dataset/Mixed/Digital_Camera/(C.S)C-outdoor3/DSC02989.JPG,char_data/8/DSC02989.JPG_2.jpg,1058,480,640,23,511,534,351,397,True,10
8,30,kaist_dataset/Mixed/Digital_Camera/(C.S)C-outdoor3/DSC03051.JPG,char_data/8/DSC03051.JPG_4.jpg,690,480,640,23,243,266,325,355,True,10
8,37,kaist_dataset/Mixed/Digital_Camera/(C.S)C-outdoor3/DSC03051.JPG,char_data/8/DSC03051.JPG_5.jpg,888,480,640,24,377,401,314,351,True,10
8,36,kaist_dataset/Mixed/Digital_Camera/(C.S)C-outdoor3/DSC03061.JPG,char_data/8/DSC03061.JPG_2.jpg,756,480,640,21,284,305,253,289,True,10
8,31,kaist_dataset/Mixed/Digital_Camera/(C.S)C-outdoor3/DSC03062.JPG,char_data/8/DSC03062.JPG_4.jpg,527,480,640,17,263,280,248,279,True,10
8,31,kaist_dataset/Mixed/Digital_Camera/(C.S)C-outdoor3/DSC03062.JPG,char_data/8/DSC03062.JPG_5.jpg,527,480,640,17,324,341,245,276,True,10
8,62,kaist_dataset/Mixed/Digital_Camera/(C.S)C-outdoor3/DSC03067.JPG,char_data/8/DSC03067.JPG_4.jpg,2356,480,640,38,202,240,192,254,True,10
8,60,kaist_dataset/Mixed/Digital_Camera/(C.S)C-outdoor3/DSC03067.JPG,char_data/8/DSC03067.JPG_5.jpg,2040,480,640,34,240,274,191,251,True,10
8,57,kaist_dataset/Mixed/Digital_Camera/(C.S)C-outdoor3/DSC03177.JPG,char_data/8/DSC03177.JPG_8.jpg,1995,480,640,35,171,206,186,243,True,10
8,63,kaist_dataset/Mixed/Digital_Camera/(C.S)C-outdoor3/DSC03177.JPG,char_data/8/DSC03177.JPG_9.jpg,2016,480,640,32,207,239,184,247,True,10
8,52,kaist_dataset/Mixed/Digital_Camera/(C.S)C-outdoor3/DSC03177.JPG,char_data/8/DSC03177.JPG_10.jpg,1716,480,640,33,321,354,194,246,True,10
8,57,kaist_dataset/Mixed/Digital_Camera/(C.S)C-outdoor3/DSC03177.JPG,char_data/8/DSC03177.JPG_11.jpg,1995,480,640,35,355,390,193,250,True,10
8,43,kaist_dataset/Mixed/Digital_Camera/(C.S)C-outdoor3/DSC03185.JPG,char_data/8/DSC03185.JPG_2.jpg,2064,480,640,48,241,289,147,190,True,10
8,34,kaist_dataset/Mixed/Digital_Camera/(C.S)C-outdoor3/DSC03187.JPG,char_data/8/DSC03187.JPG_4.jpg,884,480,640,26,287,313,389,423,True,10
8,38,kaist_dataset/Mixed/Digital_Camera/(C.S)C-outdoor3/DSC03187.JPG,char_data/8/DSC03187.JPG_5.jpg,950,480,640,25,313,338,390,428,True,10
8,51,kaist_dataset/Mixed/Digital_Camera/(C.S)C-outdoor3/DSC03189.JPG,char_data/8/DSC03189.JPG_2.jpg,1632,480,640,32,471,503,298,349,True,10
8,49,kaist_dataset/Mixed/Digital_Camera/(C.S)C-outdoor3/DSC03236.JPG,char_data/8/DSC03236.JPG_6.jpg,1323,480,640,27,244,271,418,467,True,10
8,47,kaist_dataset/Mixed/Digital_Camera/(C.S)C-outdoor3/DSC03236.JPG,char_data/8/DSC03236.JPG_7.jpg,1363,480,640,29,273,302,417,464,True,10
8,44,kaist_dataset/Mixed/Digital_Camera/(C.S)C-outdoor3/DSC03236.JPG,char_data/8/DSC03236.JPG_8.jpg,1276,480,640,29,419,448,422,466,True,10
8,33,kaist_dataset/Mixed/Digital_Camera/(C.S)C-outdoor3/DSC03250.JPG,char_data/8/DSC03250.JPG_2.jpg,693,480,640,21,464,485,399,432,True,10
8,28,kaist_dataset/Mixed/Digital_Camera/(C.S)C-outdoor3/DSC03255.JPG,char_data/8/DSC03255.JPG_2.jpg,532,480,640,19,231,250,186,214,True,10
8,35,kaist_dataset/Mixed/Digital_Camera/(C.S)C-outdoor3/DSC03259.JPG,char_data/8/DSC03259.JPG_6.jpg,490,480,640,14,366,380,361,396,True,10
8,40,kaist_dataset/Mixed/Digital_Camera/(C.S)C-outdoor3/DSC03259.JPG,char_data/8/DSC03259.JPG_7.jpg,600,480,640,15,430,445,355,395,True,10
8,40,kaist_dataset/Mixed/Digital_Camera/(C.S)C-outdoor3/DSC03259.JPG,char_data/8/DSC03259.JPG_8.jpg,840,480,640,21,463,484,355,395,True,10
8,24,kaist_dataset/Mixed/Digital_Camera/(C.S)C-outdoor3/DSC03292.JPG,char_data/8/DSC03292.JPG_2.jpg,312,480,640,13,513,526,120,144,True,10
8,49,kaist_dataset/Mixed/Digital_Camera/(C.S)C-outdoor3/DSC03309.JPG,char_data/8/DSC03309.JPG_6.jpg,1176,480,640,24,241,265,255,304,True,10
8,39,kaist_dataset/Mixed/Digital_Camera/(C.S)C-outdoor3/DSC03309.JPG,char_data/8/DSC03309.JPG_7.jpg,741,480,640,19,266,285,261,300,True,10
8,36,kaist_dataset/Mixed/Digital_Camera/(C.S)C-outdoor3/DSC03309.JPG,char_data/8/DSC03309.JPG_8.jpg,756,480,640,21,306,327,260,296,True,10
8,30,kaist_dataset/Mixed/Digital_Camera/(C.S)C-outdoor3/DSC03316.JPG,char_data/8/DSC03316.JPG_8.jpg,390,480,640,13,231,244,90,120,True,10
8,36,kaist_dataset/Mixed/Digital_Camera/(C.S)C-outdoor3/DSC03316.JPG,char_data/8/DSC03316.JPG_9.jpg,432,480,640,12,281,293,85,121,True,10
8,33,kaist_dataset/Mixed/Digital_Camera/(C.S)C-outdoor3/DSC03316.JPG,char_data/8/DSC03316.JPG_10.jpg,396,480,640,12,387,399,83,116,True,10
8,34,kaist_dataset/Mixed/Digital_Camera/(C.S)C-outdoor3/DSC03316.JPG,char_data/8/DSC03316.JPG_11.jpg,612,480,640,18,436,454,83,117,True,10
8,44,kaist_dataset/Mixed/Digital_Camera/(C.S)C-outdoor3/DSC03323.JPG,char_data/8/DSC03323.JPG_2.jpg,1056,480,640,24,294,318,294,338,True,10
8,38,kaist_dataset/Mixed/Digital_Camera/(C.S)C-outdoor3/DSC03328.JPG,char_data/8/DSC03328.JPG_4.jpg,494,480,640,13,161,174,401,439,True,10
8,41,kaist_dataset/Mixed/Digital_Camera/(C.S)C-outdoor3/DSC03328.JPG,char_data/8/DSC03328.JPG_5.jpg,656,480,640,16,338,354,398,439,True,10
8,64,kaist_dataset/Mixed/Digital_Camera/(C.S)C-outdoor3/DSC03332.JPG,char_data/8/DSC03332.JPG_8.jpg,2304,480,640,36,78,114,342,406,True,10
8,67,kaist_dataset/Mixed/Digital_Camera/(C.S)C-outdoor3/DSC03332.JPG,char_data/8/DSC03332.JPG_9.jpg,2345,480,640,35,176,211,335,402,True,10
8,65,kaist_dataset/Mixed/Digital_Camera/(C.S)C-outdoor3/DSC03332.JPG,char_data/8/DSC03332.JPG_10.jpg,2470,480,640,38,245,283,333,398,True,10
8,68,kaist_dataset/Mixed/Digital_Camera/(C.S)C-outdoor3/DSC03332.JPG,char_data/8/DSC03332.JPG_11.jpg,2720,480,640,40,281,321,332,400,True,10
8,38,kaist_dataset/Mixed/Digital_Camera/(C.S)C-outdoor4/DSC03435.JPG,char_data/8/DSC03435.JPG_8.jpg,684,480,640,18,225,243,411,449,True,10
8,37,kaist_dataset/Mixed/Digital_Camera/(C.S)C-outdoor4/DSC03435.JPG,char_data/8/DSC03435.JPG_9.jpg,814,480,640,22,243,265,412,449,True,10
8,38,kaist_dataset/Mixed/Digital_Camera/(C.S)C-outdoor4/DSC03435.JPG,char_data/8/DSC03435.JPG_10.jpg,798,480,640,21,266,287,412,450,True,10
8,39,kaist_dataset/Mixed/Digital_Camera/(C.S)C-outdoor4/DSC03435.JPG,char_data/8/DSC03435.JPG_11.jpg,741,480,640,19,290,309,412,451,True,10
8,31,kaist_dataset/Mixed/Digital_Camera/(C.S)C-outdoor4/DSC03446.JPG,char_data/8/DSC03446.JPG_4.jpg,558,480,640,18,249,267,290,321,True,10
8,33,kaist_dataset/Mixed/Digital_Camera/(C.S)C-outdoor4/DSC03446.JPG,char_data/8/DSC03446.JPG_5.jpg,693,480,640,21,349,370,290,323,True,10
8,88,kaist_dataset/Mixed/Digital_Camera/(C.S)C-outdoor4/DSC03544.JPG,char_data/8/DSC03544.JPG_2.jpg,3872,480,640,44,254,298,167,255,True,10
8,46,kaist_dataset/Mixed/Digital_Camera/(C.S)C-outdoor4/DSC03548.JPG,char_data/8/DSC03548.JPG_2.jpg,2162,480,640,47,145,192,394,440,True,10
8,44,kaist_dataset/Mixed/Digital_Camera/(C.S)C-outdoor4/DSC03549.JPG,char_data/8/DSC03549.JPG_4.jpg,748,480,640,17,560,577,176,220,True,10
8,31,kaist_dataset/Mixed/Digital_Camera/(C.S)C-outdoor4/DSC03549.JPG,char_data/8/DSC03549.JPG_5.jpg,434,480,640,14,305,319,423,454,True,10
8,30,kaist_dataset/Mixed/Digital_Camera/(C.S)C-outdoor4/DSC03552.JPG,char_data/8/DSC03552.JPG_6.jpg,480,480,640,16,371,387,319,349,True,10
8,27,kaist_dataset/Mixed/Digital_Camera/(C.S)C-outdoor4/DSC03552.JPG,char_data/8/DSC03552.JPG_7.jpg,459,480,640,17,430,447,320,347,True,10
8,29,kaist_dataset/Mixed/Digital_Camera/(C.S)C-outdoor4/DSC03552.JPG,char_data/8/DSC03552.JPG_8.jpg,493,480,640,17,461,478,318,347,True,10
8,48,kaist_dataset/Mixed/Digital_Camera/(C.S)C-outdoor4/DSC03569.JPG,char_data/8/DSC03569.JPG_4.jpg,1440,480,640,30,397,427,167,215,True,10
8,42,kaist_dataset/Mixed/Digital_Camera/(C.S)C-outdoor4/DSC03569.JPG,char_data/8/DSC03569.JPG_5.jpg,1428,480,640,34,581,615,167,209,True,10
8,31,kaist_dataset/Mixed/Digital_Camera/(C.S)C-outdoor4/DSC03570.JPG,char_data/8/DSC03570.JPG_2.jpg,589,480,640,19,269,288,424,455,True,10
8,50,kaist_dataset/Mixed/Digital_Camera/(C.S)C-outdoor4/DSC03613.JPG,char_data/8/DSC03613.JPG_2.jpg,1050,480,640,21,473,494,25,75,True,10
8,31,kaist_dataset/Mixed/Digital_Camera/(C.S)C-outdoor4/DSC03616.JPG,char_data/8/DSC03616.JPG_2.jpg,496,480,640,16,569,585,153,184,True,10
8,46,kaist_dataset/Mixed/Digital_Camera/(C.S)C-outdoor4/DSC03617.JPG,char_data/8/DSC03617.JPG_6.jpg,1242,480,640,27,244,271,377,423,True,10
8,41,kaist_dataset/Mixed/Digital_Camera/(C.S)C-outdoor4/DSC03617.JPG,char_data/8/DSC03617.JPG_7.jpg,1558,480,640,38,404,442,383,424,True,10
8,38,kaist_dataset/Mixed/Digital_Camera/(C.S)C-outdoor4/DSC03617.JPG,char_data/8/DSC03617.JPG_8.jpg,1596,480,640,42,442,484,383,421,True,10
8,31,kaist_dataset/Mixed/Digital_Camera/(C.S)C-outdoor4/DSC03618.JPG,char_data/8/DSC03618.JPG_4.jpg,775,480,640,25,262,287,407,438,True,10
8,30,kaist_dataset/Mixed/Digital_Camera/(C.S)C-outdoor4/DSC03618.JPG,char_data/8/DSC03618.JPG_5.jpg,690,480,640,23,381,404,412,442,True,10
8,49,kaist_dataset/Mixed/Digital_Camera/(C.S)C-outdoor4/DSC03621.JPG,char_data/8/DSC03621.JPG_2.jpg,1176,480,640,24,385,409,335,384,True,10
8,44,kaist_dataset/Mixed/Digital_Camera/(C.S)C-outdoor4/DSC03633.JPG,char_data/8/DSC03633.JPG_2.jpg,1320,480,640,30,151,181,266,310,True,10
8,37,kaist_dataset/Mixed/Digital_Camera/(C.S)C-outdoor4/DSC03634.JPG,char_data/8/DSC03634.JPG_2.jpg,814,480,640,22,528,550,424,461,True,10
8,31,kaist_dataset/Mixed/Digital_Camera/(C.S)C-outdoor4/DSC03637.JPG,char_data/8/DSC03637.JPG_2.jpg,403,480,640,13,261,274,297,328,True,10
8,33,kaist_dataset/Mixed/Digital_Camera/(C.S)C-outdoor4/DSC03640.JPG,char_data/8/DSC03640.JPG_2.jpg,693,480,640,21,170,191,396,429,True,10
8,30,kaist_dataset/Mixed/Digital_Camera/(C.S)C-outdoor4/DSC03642.JPG,char_data/8/DSC03642.JPG_2.jpg,480,480,640,16,447,463,400,430,True,10
8,20,kaist_dataset/Mixed/Digital_Camera/(C.S)C-outdoor4/DSC03643.JPG,char_data/8/DSC03643.JPG_2.jpg,340,480,640,17,487,504,329,349,True,10
8,52,kaist_dataset/Mixed/Digital_Camera/(C.S)C-outdoor4/DSC03651.JPG,char_data/8/DSC03651.JPG_2.jpg,1404,480,640,27,239,266,355,407,True,10
8,92,kaist_dataset/Mixed/Digital_Camera/(C.S)C-outdoor4/DSC03654.JPG,char_data/8/DSC03654.JPG_4.jpg,3312,480,640,36,501,537,151,243,True,10
8,86,kaist_dataset/Mixed/Digital_Camera/(C.S)C-outdoor4/DSC03654.JPG,char_data/8/DSC03654.JPG_5.jpg,2408,480,640,28,536,564,151,237,True,10
8,55,kaist_dataset/Mixed/Digital_Camera/(C.S)C-outdoor4/DSC03655.JPG,char_data/8/DSC03655.JPG_4.jpg,1265,480,640,23,245,268,384,439,True,10
8,35,kaist_dataset/Mixed/Digital_Camera/(C.S)C-outdoor4/DSC03655.JPG,char_data/8/DSC03655.JPG_5.jpg,735,480,640,21,471,492,403,438,True,10
8,38,kaist_dataset/Mixed/Digital_Camera/(C.S)C-outdoor4/DSC03656.JPG,char_data/8/DSC03656.JPG_4.jpg,1102,480,640,29,525,554,414,452,True,10
8,37,kaist_dataset/Mixed/Digital_Camera/(C.S)C-outdoor4/DSC03656.JPG,char_data/8/DSC03656.JPG_5.jpg,1036,480,640,28,555,583,413,450,True,10
8,24,kaist_dataset/Mixed/Digital_Camera/(C.S)C-outdoor4/DSC03657.JPG,char_data/8/DSC03657.JPG_4.jpg,432,480,640,18,292,310,423,447,True,10
8,31,kaist_dataset/Mixed/Digital_Camera/(C.S)C-outdoor4/DSC03657.JPG,char_data/8/DSC03657.JPG_5.jpg,558,480,640,18,335,353,423,454,True,10
8,36,kaist_dataset/Mixed/Digital_Camera/(C.S)C-outdoor4/DSC03658.JPG,char_data/8/DSC03658.JPG_2.jpg,576,480,640,16,321,337,416,452,True,10
8,35,kaist_dataset/Mixed/Digital_Camera/(C.S)C-outdoor4/DSC03660.JPG,char_data/8/DSC03660.JPG_4.jpg,910,480,640,26,309,335,94,129,True,10
8,39,kaist_dataset/Mixed/Digital_Camera/(C.S)C-outdoor4/DSC03660.JPG,char_data/8/DSC03660.JPG_5.jpg,1053,480,640,27,404,431,95,134,True,10
8,41,kaist_dataset/Mixed/Digital_Camera/(C.S)C-outdoor4/DSC03662.JPG,char_data/8/DSC03662.JPG_2.jpg,779,480,640,19,459,478,422,463,True,10
8,37,kaist_dataset/Mixed/Digital_Camera/(C.S)C-outdoor4/DSC03665.JPG,char_data/8/DSC03665.JPG_2.jpg,1369,480,640,37,283,320,156,193,True,10
8,30,kaist_dataset/Mixed/Digital_Camera/(C.S)C-outdoor4/DSC03670.JPG,char_data/8/DSC03670.JPG_2.jpg,360,480,640,12,441,453,445,475,True,10
8,44,kaist_dataset/Mixed/Digital_Camera/(C.S)C-outdoor4/DSC03674.JPG,char_data/8/DSC03674.JPG_6.jpg,1364,480,640,31,492,523,358,402,True,10
8,30,kaist_dataset/Mixed/Digital_Camera/(C.S)C-outdoor4/DSC03674.JPG,char_data/8/DSC03674.JPG_7.jpg,330,480,640,11,522,533,419,449,True,10
8,28,kaist_dataset/Mixed/Digital_Camera/(C.S)C-outdoor4/DSC03674.JPG,char_data/8/DSC03674.JPG_8.jpg,420,480,640,15,589,604,422,450,True,10
8,42,kaist_dataset/Mixed/Digital_Camera/(C.S)C-outdoor4/DSC03675.JPG,char_data/8/DSC03675.JPG_4.jpg,882,480,640,21,450,471,341,383,True,10
8,43,kaist_dataset/Mixed/Digital_Camera/(C.S)C-outdoor4/DSC03675.JPG,char_data/8/DSC03675.JPG_5.jpg,817,480,640,19,478,497,340,383,True,10
8,33,kaist_dataset/Mixed/Digital_Camera/(C.S)C-outdoor4/DSC03676.JPG,char_data/8/DSC03676.JPG_8.jpg,495,480,640,15,96,111,270,303,True,10
8,32,kaist_dataset/Mixed/Digital_Camera/(C.S)C-outdoor4/DSC03676.JPG,char_data/8/DSC03676.JPG_9.jpg,512,480,640,16,111,127,270,302,True,10
8,36,kaist_dataset/Mixed/Digital_Camera/(C.S)C-outdoor4/DSC03676.JPG,char_data/8/DSC03676.JPG_10.jpg,504,480,640,14,168,182,271,307,True,10
8,28,kaist_dataset/Mixed/Digital_Camera/(C.S)C-outdoor4/DSC03676.JPG,char_data/8/DSC03676.JPG_11.jpg,420,480,640,15,183,198,275,303,True,10
8,35,kaist_dataset/Mixed/Digital_Camera/(C.S)C-outdoor4/DSC03677.JPG,char_data/8/DSC03677.JPG_2.jpg,420,480,640,12,547,559,311,346,True,10
8,44,kaist_dataset/Mixed/Digital_Camera/(C.S)C-outdoor4/DSC03679.JPG,char_data/8/DSC03679.JPG_4.jpg,1144,480,640,26,236,262,273,317,True,10
8,41,kaist_dataset/Mixed/Digital_Camera/(C.S)C-outdoor4/DSC03679.JPG,char_data/8/DSC03679.JPG_5.jpg,902,480,640,22,338,360,281,322,True,10
8,30,kaist_dataset/Mixed/Digital_Camera/(C.S)C-outdoor4/DSC03687.JPG,char_data/8/DSC03687.JPG_2.jpg,390,480,640,13,432,445,398,428,True,10
8,27,kaist_dataset/Mixed/Digital_Camera/(C.S)C-outdoor4/DSC03689.JPG,char_data/8/DSC03689.JPG_4.jpg,270,480,640,10,540,550,132,159,True,10
8,28,kaist_dataset/Mixed/Digital_Camera/(C.S)C-outdoor4/DSC03689.JPG,char_data/8/DSC03689.JPG_5.jpg,280,480,640,10,571,581,135,163,True,10
8,33,kaist_dataset/Mixed/Digital_Camera/(C.S)C-outdoor4/DSC03691.JPG,char_data/8/DSC03691.JPG_6.jpg,528,480,640,16,395,411,222,255,True,10
8,35,kaist_dataset/Mixed/Digital_Camera/(C.S)C-outdoor4/DSC03691.JPG,char_data/8/DSC03691.JPG_7.jpg,490,480,640,14,411,425,221,256,True,10
8,31,kaist_dataset/Mixed/Digital_Camera/(C.S)C-outdoor4/DSC03691.JPG,char_data/8/DSC03691.JPG_8.jpg,403,480,640,13,549,562,223,254,True,10
8,53,kaist_dataset/Mixed/Digital_Camera/(C.S)C-outdoor4/DSC03693.JPG,char_data/8/DSC03693.JPG_2.jpg,1166,480,640,22,428,450,352,405,True,10
8,69,kaist_dataset/Mixed/Digital_Camera/(C.S)C-outdoor4/DSC03702.JPG,char_data/8/DSC03702.JPG_2.jpg,3588,480,640,52,122,174,333,402,True,10
8,30,kaist_dataset/Mixed/Digital_Camera/(C.S)C-outdoor4/DSC03716.JPG,char_data/8/DSC03716.JPG_4.jpg,360,480,640,12,552,564,253,283,True,10
8,31,kaist_dataset/Mixed/Digital_Camera/(C.S)C-outdoor4/DSC03716.JPG,char_data/8/DSC03716.JPG_5.jpg,558,480,640,18,588,606,254,285,True,10
8,29,kaist_dataset/Mixed/Digital_Camera/(C.S)C-outdoor4/DSC03718.JPG,char_data/8/DSC03718.JPG_2.jpg,551,480,640,19,477,496,402,431,True,10
8,29,kaist_dataset/Mixed/Digital_Camera/(C.S)C-outdoor4/DSC03719.JPG,char_data/8/DSC03719.JPG_2.jpg,464,480,640,16,482,498,184,213,True,10
8,30,kaist_dataset/Mixed/Digital_Camera/(C.S)C-outdoor4/DSC03722.JPG,char_data/8/DSC03722.JPG_2.jpg,690,480,640,23,248,271,205,235,True,10
8,30,kaist_dataset/Mixed/Digital_Camera/(C.S)C-outdoor4/DSC03723.JPG,char_data/8/DSC03723.JPG_4.jpg,690,480,640,23,416,439,198,228,True,10
8,28,kaist_dataset/Mixed/Digital_Camera/(C.S)C-outdoor4/DSC03723.JPG,char_data/8/DSC03723.JPG_5.jpg,644,480,640,23,539,562,198,226,True,10
8,33,kaist_dataset/Mixed/Digital_Camera/(C.S)C-outdoor4/DSC03730.JPG,char_data/8/DSC03730.JPG_2.jpg,726,480,640,22,352,374,254,287,True,10
8,42,kaist_dataset/Mixed/Digital_Camera/(C.S)C-outdoor4/DSC03732.JPG,char_data/8/DSC03732.JPG_2.jpg,1050,480,640,25,348,373,392,434,True,10
8,31,kaist_dataset/Mixed/Digital_Camera/(C.S)C-outdoor4/DSC03733.JPG,char_data/8/DSC03733.JPG_2.jpg,372,480,640,12,505,517,178,209,True,10
8,32,kaist_dataset/Mixed/Digital_Camera/(C.S)C-outdoor4/DSC03734.JPG,char_data/8/DSC03734.JPG_2.jpg,384,480,640,12,514,526,348,380,False,10
8,30,kaist_dataset/Mixed/Digital_Camera/(C.S)C-outdoor4/DSC03735.JPG,char_data/8/DSC03735.JPG_2.jpg,510,480,640,17,470,487,148,178,False,10
8,30,kaist_dataset/Mixed/Digital_Camera/(C.S)C-outdoor4/DSC03737.JPG,char_data/8/DSC03737.JPG_12.jpg,510,480,640,17,172,189,161,191,False,10
8,31,kaist_dataset/Mixed/Digital_Camera/(C.S)C-outdoor4/DSC03737.JPG,char_data/8/DSC03737.JPG_13.jpg,589,480,640,19,189,208,159,190,False,10
8,28,kaist_dataset/Mixed/Digital_Camera/(C.S)C-outdoor4/DSC03737.JPG,char_data/8/DSC03737.JPG_14.jpg,560,480,640,20,269,289,164,192,False,10
8,25,kaist_dataset/Mixed/Digital_Camera/(C.S)C-outdoor4/DSC03737.JPG,char_data/8/DSC03737.JPG_15.jpg,500,480,640,20,342,362,167,192,False,10
8,33,kaist_dataset/Mixed/Digital_Camera/(C.S)C-outdoor4/DSC03737.JPG,char_data/8/DSC03737.JPG_16.jpg,660,480,640,20,362,382,166,199,False,10
8,29,kaist_dataset/Mixed/Digital_Camera/(C.S)C-outdoor4/DSC03737.JPG,char_data/8/DSC03737.JPG_17.jpg,493,480,640,17,441,458,169,198,False,10
8,42,kaist_dataset/Mixed/Digital_Camera/(C.S)C-outdoor4/DSC03738.JPG,char_data/8/DSC03738.JPG_2.jpg,1554,480,640,37,525,562,239,281,False,10
8,31,kaist_dataset/Mixed/Digital_Camera/(C.S)C-outdoor4/DSC03745.JPG,char_data/8/DSC03745.JPG_8.jpg,651,480,640,21,137,158,271,302,False,10
8,35,kaist_dataset/Mixed/Digital_Camera/(C.S)C-outdoor4/DSC03745.JPG,char_data/8/DSC03745.JPG_9.jpg,875,480,640,25,276,301,271,306,False,10
8,33,kaist_dataset/Mixed/Digital_Camera/(C.S)C-outdoor4/DSC03745.JPG,char_data/8/DSC03745.JPG_10.jpg,462,480,640,14,494,508,272,305,False,10
8,31,kaist_dataset/Mixed/Digital_Camera/(C.S)C-outdoor4/DSC03745.JPG,char_data/8/DSC03745.JPG_11.jpg,620,480,640,20,508,528,274,305,False,10
8,28,kaist_dataset/Mixed/Digital_Camera/(C.S)C-outdoor4/DSC03757.JPG,char_data/8/DSC03757.JPG_4.jpg,308,480,640,11,329,340,340,368,False,10
8,37,kaist_dataset/Mixed/Digital_Camera/(C.S)C-outdoor4/DSC03757.JPG,char_data/8/DSC03757.JPG_5.jpg,555,480,640,15,499,514,338,375,False,10
8,28,kaist_dataset/Mixed/Digital_Camera/(C.S)C-outdoor4/DSC03758.JPG,char_data/8/DSC03758.JPG_2.jpg,420,480,640,15,280,295,305,333,False,10
8,27,kaist_dataset/Mixed/Digital_Camera/(C.S)C-outdoor4/DSC03764.JPG,char_data/8/DSC03764.JPG_2.jpg,540,480,640,20,242,262,271,298,False,10
8,29,kaist_dataset/Mixed/Digital_Camera/(C.S)C-outdoor4/DSC03769.JPG,char_data/8/DSC03769.JPG_6.jpg,377,480,640,13,180,193,417,446,False,10
8,22,kaist_dataset/Mixed/Digital_Camera/(C.S)C-outdoor4/DSC03769.JPG,char_data/8/DSC03769.JPG_7.jpg,286,480,640,13,243,256,421,443,False,10
8,34,kaist_dataset/Mixed/Digital_Camera/(C.S)C-outdoor4/DSC03769.JPG,char_data/8/DSC03769.JPG_8.jpg,612,480,640,18,256,274,413,447,False,10
8,89,kaist_dataset/Mixed/Digital_Camera/(C.S)C-outdoor4/DSC03787.JPG,char_data/8/DSC03787.JPG_4.jpg,2581,480,640,29,508,537,135,224,False,10
8,79,kaist_dataset/Mixed/Digital_Camera/(C.S)C-outdoor4/DSC03787.JPG,char_data/8/DSC03787.JPG_5.jpg,2054,480,640,26,539,565,145,224,False,10
8,112,kaist_dataset/Mixed/Digital_Camera/(C.S)C-outdoor5/DSC03821.JPG,char_data/8/DSC03821.JPG_6.jpg,8512,480,640,76,494,570,127,239,False,10
8,39,kaist_dataset/Mixed/Digital_Camera/(C.S)C-outdoor5/DSC03821.JPG,char_data/8/DSC03821.JPG_7.jpg,780,480,640,20,308,328,81,120,False,10
8,41,kaist_dataset/Mixed/Digital_Camera/(C.S)C-outdoor5/DSC03821.JPG,char_data/8/DSC03821.JPG_8.jpg,902,480,640,22,403,425,83,124,False,10
8,106,kaist_dataset/Mixed/Digital_Camera/(C.S)C-outdoor5/DSC03824.JPG,char_data/8/DSC03824.JPG_2.jpg,5512,480,640,52,503,555,90,196,False,10
8,35,kaist_dataset/Mixed/Digital_Camera/(C.S)C-outdoor5/DSC03839.JPG,char_data/8/DSC03839.JPG_4.jpg,630,480,640,18,286,304,366,401,False,10
8,31,kaist_dataset/Mixed/Digital_Camera/(C.S)C-outdoor5/DSC03839.JPG,char_data/8/DSC03839.JPG_5.jpg,558,480,640,18,303,321,368,399,False,10
8,54,kaist_dataset/Mixed/Digital_Camera/(C.S)C-outdoor5/DSC03847.JPG,char_data/8/DSC03847.JPG_4.jpg,1134,480,640,21,452,473,16,70,False,10
8,52,kaist_dataset/Mixed/Digital_Camera/(C.S)C-outdoor5/DSC03847.JPG,char_data/8/DSC03847.JPG_5.jpg,1404,480,640,27,473,500,15,67,False,10
8,77,kaist_dataset/Mixed/Digital_Camera/(C.S)C-outdoor5/DSC04016.JPG,char_data/8/DSC04016.JPG_4.jpg,3619,480,640,47,216,263,107,184,False,10
8,73,kaist_dataset/Mixed/Digital_Camera/(C.S)C-outdoor5/DSC04016.JPG,char_data/8/DSC04016.JPG_5.jpg,2847,480,640,39,404,443,323,396,False,10
8,54,kaist_dataset/Mixed/Digital_Camera/(C.S)C-outdoor5/DSC04017.JPG,char_data/8/DSC04017.JPG_2.jpg,1728,480,640,32,244,276,424,478,False,10
8,22,kaist_dataset/Mixed/Digital_Camera/(C.S)C-outdoor5/DSC04031.JPG,char_data/8/DSC04031.JPG_4.jpg,220,480,640,10,474,484,381,403,False,10
8,26,kaist_dataset/Mixed/Digital_Camera/(C.S)C-outdoor5/DSC04031.JPG,char_data/8/DSC04031.JPG_5.jpg,286,480,640,11,168,179,379,405,False,10
8,54,kaist_dataset/Mixed/Digital_Camera/(C.S)C-outdoor5/DSC04033.JPG,char_data/8/DSC04033.JPG_2.jpg,2052,480,640,38,144,182,283,337,False,10
8,97,kaist_dataset/Mixed/Digital_Camera/(C.S)C-outdoor5/DSC04054.JPG,char_data/8/DSC04054.JPG_2.jpg,8924,480,640,92,422,514,66,163,False,10
8,40,kaist_dataset/Mixed/Digital_Camera/(C.S)C-outdoor5/DSC04055.JPG,char_data/8/DSC04055.JPG_2.jpg,1240,480,640,31,140,171,369,409,False,10
8,35,kaist_dataset/Mixed/Digital_Camera/(C.S)C-outdoor5/DSC04056.JPG,char_data/8/DSC04056.JPG_8.jpg,910,480,640,26,429,455,261,296,False,10
8,35,kaist_dataset/Mixed/Digital_Camera/(C.S)C-outdoor5/DSC04056.JPG,char_data/8/DSC04056.JPG_9.jpg,1015,480,640,29,568,597,257,292,False,10
8,30,kaist_dataset/Mixed/Digital_Camera/(C.S)C-outdoor5/DSC04056.JPG,char_data/8/DSC04056.JPG_10.jpg,570,480,640,19,437,456,300,330,False,10
8,30,kaist_dataset/Mixed/Digital_Camera/(C.S)C-outdoor5/DSC04056.JPG,char_data/8/DSC04056.JPG_11.jpg,720,480,640,24,455,479,300,330,False,10
8,39,kaist_dataset/Mixed/Digital_Camera/(C.S)C-outdoor5/DSC04070.JPG,char_data/8/DSC04070.JPG_4.jpg,780,480,640,20,384,404,105,144,False,10
8,36,kaist_dataset/Mixed/Digital_Camera/(C.S)C-outdoor5/DSC04070.JPG,char_data/8/DSC04070.JPG_5.jpg,720,480,640,20,419,439,106,142,False,10
8,36,kaist_dataset/Mixed/Digital_Camera/(C.S)C-outdoor5/DSC04071.JPG,char_data/8/DSC04071.JPG_6.jpg,576,480,640,16,433,449,366,402,False,10
8,36,kaist_dataset/Mixed/Digital_Camera/(C.S)C-outdoor5/DSC04071.JPG,char_data/8/DSC04071.JPG_7.jpg,684,480,640,19,449,468,364,400,False,10
8,40,kaist_dataset/Mixed/Digital_Camera/(C.S)C-outdoor5/DSC04071.JPG,char_data/8/DSC04071.JPG_8.jpg,840,480,640,21,528,549,363,403,False,10
8,22,kaist_dataset/Mixed/Digital_Camera/(C.S)C-outdoor5/DSC04086.JPG,char_data/8/DSC04086.JPG_2.jpg,286,480,640,13,378,391,374,396,False,10
8,51,kaist_dataset/Mixed/Digital_Camera/(C.S)C-outdoor5/DSC04094.JPG,char_data/8/DSC04094.JPG_2.jpg,2346,480,640,46,236,282,385,436,False,10
8,36,kaist_dataset/Mixed/Digital_Camera/(C.S)C-outdoor5/DSC04098.JPG,char_data/8/DSC04098.JPG_8.jpg,504,480,640,14,449,463,313,349,False,10
8,32,kaist_dataset/Mixed/Digital_Camera/(C.S)C-outdoor5/DSC04098.JPG,char_data/8/DSC04098.JPG_9.jpg,480,480,640,15,490,505,315,347,False,10
8,41,kaist_dataset/Mixed/Digital_Camera/(C.S)C-outdoor5/DSC04098.JPG,char_data/8/DSC04098.JPG_10.jpg,656,480,640,16,521,537,310,351,False,10
8,38,kaist_dataset/Mixed/Digital_Camera/(C.S)C-outdoor5/DSC04098.JPG,char_data/8/DSC04098.JPG_11.jpg,722,480,640,19,537,556,312,350,False,10
8,65,kaist_dataset/Mixed/Digital_Camera/(C.S)C-outdoor5/DSC04108.JPG,char_data/8/DSC04108.JPG_2.jpg,2080,480,640,32,357,389,239,304,False,10
8,44,kaist_dataset/Mixed/Digital_Camera/(C.S)C-outdoor5/DSC04115.JPG,char_data/8/DSC04115.JPG_4.jpg,1144,480,640,26,373,399,353,397,False,10
8,42,kaist_dataset/Mixed/Digital_Camera/(C.S)C-outdoor5/DSC04115.JPG,char_data/8/DSC04115.JPG_5.jpg,1050,480,640,25,517,542,350,392,False,10
8,31,kaist_dataset/Mixed/Digital_Camera/(C.S)C-outdoor5/DSC04124.JPG,char_data/8/DSC04124.JPG_2.jpg,465,480,640,15,418,433,308,339,False,10
8,45,kaist_dataset/Mixed/Digital_Camera/(C.S)C-outdoor5/DSC04125.JPG,char_data/8/DSC04125.JPG_6.jpg,990,480,640,22,69,91,175,220,False,10
8,38,kaist_dataset/Mixed/Digital_Camera/(C.S)C-outdoor5/DSC04125.JPG,char_data/8/DSC04125.JPG_7.jpg,722,480,640,19,449,468,417,455,False,10
8,42,kaist_dataset/Mixed/Digital_Camera/(C.S)C-outdoor5/DSC04125.JPG,char_data/8/DSC04125.JPG_8.jpg,840,480,640,20,551,571,414,456,False,10
8,45,kaist_dataset/Mixed/Digital_Camera/(C.S)C-outdoor5/DSC04139.JPG,char_data/8/DSC04139.JPG_2.jpg,540,480,640,12,298,310,394,439,False,10
8,38,kaist_dataset/Mixed/Digital_Camera/(C.S)C-outdoor5/DSC04140.JPG,char_data/8/DSC04140.JPG_6.jpg,456,480,640,12,518,530,345,383,False,10
8,35,kaist_dataset/Mixed/Digital_Camera/(C.S)C-outdoor5/DSC04140.JPG,char_data/8/DSC04140.JPG_7.jpg,455,480,640,13,550,563,345,380,False,10
8,38,kaist_dataset/Mixed/Digital_Camera/(C.S)C-outdoor5/DSC04140.JPG,char_data/8/DSC04140.JPG_8.jpg,532,480,640,14,574,588,342,380,False,10
8,41,kaist_dataset/Mixed/Digital_Camera/(C.S)C-outdoor5/DSC04144.JPG,char_data/8/DSC04144.JPG_2.jpg,697,480,640,17,268,285,416,457,False,10
8,28,kaist_dataset/Mixed/Digital_Camera/(C.S)C-outdoor5/DSC04150.JPG,char_data/8/DSC04150.JPG_2.jpg,392,480,640,14,568,582,368,396,False,10
8,28,kaist_dataset/Mixed/Digital_Camera/(C.S)C-outdoor5/DSC04151.JPG,char_data/8/DSC04151.JPG_2.jpg,476,480,640,17,448,465,346,374,False,10
8,32,kaist_dataset/Mixed/Digital_Camera/(C.S)C-outdoor5/DSC04155.JPG,char_data/8/DSC04155.JPG_2.jpg,384,480,640,12,499,511,263,295,False,10
8,36,kaist_dataset/Mixed/Digital_Camera/(C.S)C-outdoor5/DSC04330.JPG,char_data/8/DSC04330.JPG_6.jpg,828,480,640,23,351,374,182,218,False,10
8,37,kaist_dataset/Mixed/Digital_Camera/(C.S)C-outdoor5/DSC04330.JPG,char_data/8/DSC04330.JPG_7.jpg,1110,480,640,30,373,403,178,215,False,10
8,52,kaist_dataset/Mixed/Digital_Camera/(C.S)C-outdoor5/DSC04330.JPG,char_data/8/DSC04330.JPG_8.jpg,1352,480,640,26,362,388,369,421,False,10
8,35,kaist_dataset/Mixed/Digital_Camera/(C.S)C-outdoor5/DSC04337.JPG,char_data/8/DSC04337.JPG_4.jpg,1085,480,640,31,320,351,319,354,False,10
8,43,kaist_dataset/Mixed/Digital_Camera/(C.S)C-outdoor5/DSC04337.JPG,char_data/8/DSC04337.JPG_5.jpg,1118,480,640,26,444,470,317,360,False,10
8,63,kaist_dataset/Mixed/Digital_Camera/(C.S)C-outdoor5/DSC04364.JPG,char_data/8/DSC04364.JPG_2.jpg,2268,480,640,36,146,182,392,455,False,10
8,61,kaist_dataset/Mixed/Digital_Camera/(C.S)C-outdoor5/DSC04401.JPG,char_data/8/DSC04401.JPG_2.jpg,2440,480,640,40,356,396,245,306,False,10
8,114,kaist_dataset/Mixed/Digital_Camera/(C.S)C-outdoor5/DSC04449.JPG,char_data/8/DSC04449.JPG_4.jpg,6954,480,640,61,90,151,38,152,False,10
8,134,kaist_dataset/Mixed/Digital_Camera/(C.S)C-outdoor5/DSC04449.JPG,char_data/8/DSC04449.JPG_5.jpg,9916,480,640,74,550,624,34,168,False,10
8,35,kaist_dataset/Mixed/Digital_Camera/(C.S)C-outdoor5/P1010002.JPG,char_data/8/P1010002.JPG_6.jpg,980,480,640,28,436,464,283,318,False,10
8,43,kaist_dataset/Mixed/Digital_Camera/(C.S)C-outdoor5/P1010002.JPG,char_data/8/P1010002.JPG_7.jpg,1333,480,640,31,518,549,280,323,False,10
8,40,kaist_dataset/Mixed/Digital_Camera/(C.S)C-outdoor5/P1010002.JPG,char_data/8/P1010002.JPG_8.jpg,960,480,640,24,575,599,279,319,False,10
8,24,kaist_dataset/Mixed/Digital_Camera/(C.S)C-outdoor5/P1010004.JPG,char_data/8/P1010004.JPG_2.jpg,360,480,640,15,269,284,312,336,False,10
8,40,kaist_dataset/Mixed/Digital_Camera/(C.S)C-outdoor5/P1010007.JPG,char_data/8/P1010007.JPG_2.jpg,1120,480,640,28,259,287,271,311,False,10
8,61,kaist_dataset/Mixed/Digital_Camera/(C.S)C-outdoor6/080116-0057.jpg,char_data/8/080116-0057.jpg_2.jpg,1952,1200,1600,32,654,686,819,880,False,10
8,27,kaist_dataset/Mixed/Digital_Camera/(C.S)C-outdoor6/117.JPG,char_data/8/117.JPG_4.jpg,324,480,640,12,426,438,263,290,False,10
8,22,kaist_dataset/Mixed/Digital_Camera/(C.S)C-outdoor6/117.JPG,char_data/8/117.JPG_5.jpg,396,480,640,18,264,282,263,285,False,10
8,28,kaist_dataset/Mixed/Digital_Camera/(C.S)C-outdoor6/DSC03324.JPG,char_data/8/DSC03324.JPG_4.jpg,364,480,640,13,408,421,153,181,False,10
8,25,kaist_dataset/Mixed/Digital_Camera/(C.S)C-outdoor6/DSC03324.JPG,char_data/8/DSC03324.JPG_5.jpg,325,480,640,13,449,462,153,178,False,10
8,64,kaist_dataset/Mixed/Digital_Camera/(C.S)C-outdoor6/P1010017.JPG,char_data/8/P1010017.JPG_2.jpg,1664,480,640,26,282,308,178,242,False,10
8,42,kaist_dataset/Mixed/Digital_Camera/(C.S)C-outdoor6/P1010018.JPG,char_data/8/P1010018.JPG_4.jpg,1008,480,640,24,137,161,239,281,False,10
8,34,kaist_dataset/Mixed/Digital_Camera/(C.S)C-outdoor6/P1010018.JPG,char_data/8/P1010018.JPG_5.jpg,748,480,640,22,432,454,245,279,False,10
8,29,kaist_dataset/Mixed/Digital_Camera/(C.S)C-outdoor6/P1010020.JPG,char_data/8/P1010020.JPG_2.jpg,696,480,640,24,193,217,233,262,False,10
8,40,kaist_dataset/Mixed/Digital_Camera/(C.S)C-outdoor6/P1010021.JPG,char_data/8/P1010021.JPG_4.jpg,1120,480,640,28,110,138,210,250,False,10
8,36,kaist_dataset/Mixed/Digital_Camera/(C.S)C-outdoor6/P1010021.JPG,char_data/8/P1010021.JPG_5.jpg,1008,480,640,28,562,590,205,241,False,10
8,54,kaist_dataset/Mixed/Digital_Camera/(C.S)C-outdoor6/P1010067.JPG,char_data/8/P1010067.JPG_12.jpg,2160,480,640,40,379,419,311,365,False,10
8,54,kaist_dataset/Mixed/Digital_Camera/(C.S)C-outdoor6/P1010067.JPG,char_data/8/P1010067.JPG_13.jpg,2106,480,640,39,420,459,310,364,False,10
8,57,kaist_dataset/Mixed/Digital_Camera/(C.S)C-outdoor6/P1010067.JPG,char_data/8/P1010067.JPG_14.jpg,2622,480,640,46,482,528,306,363,False,10
8,37,kaist_dataset/Mixed/Digital_Camera/(C.S)C-outdoor6/P1010069.JPG,char_data/8/P1010069.JPG_13.jpg,962,480,640,26,420,446,303,340,False,10
8,35,kaist_dataset/Mixed/Digital_Camera/(C.S)C-outdoor6/P1010069.JPG,char_data/8/P1010069.JPG_14.jpg,875,480,640,25,447,472,305,340,False,10
8,31,kaist_dataset/Mixed/Digital_Camera/(C.S)C-outdoor6/P1010073.JPG,char_data/8/P1010073.JPG_2.jpg,341,480,640,11,348,359,242,273,False,10
8,31,kaist_dataset/Mixed/Digital_Camera/(C.S)C-outdoor6/P1010074.JPG,char_data/8/P1010074.JPG_2.jpg,1023,480,640,33,201,234,311,342,False,10
8,38,kaist_dataset/Mixed/Digital_Camera/(C.S)C-outdoor6/P1010075.JPG,char_data/8/P1010075.JPG_2.jpg,646,480,640,17,450,467,307,345,False,10
8,34,kaist_dataset/Mixed/Digital_Camera/(C.S)C-outdoor6/P1010080.JPG,char_data/8/P1010080.JPG_2.jpg,1190,480,640,35,394,429,246,280,False,10
8,32,kaist_dataset/Mixed/Digital_Camera/(C.S)C-outdoor6/P1010082.JPG,char_data/8/P1010082.JPG_10.jpg,544,480,640,17,200,217,230,262,False,10
8,34,kaist_dataset/Mixed/Digital_Camera/(C.S)C-outdoor6/P1010082.JPG,char_data/8/P1010082.JPG_11.jpg,748,480,640,22,325,347,229,263,False,10
8,24,kaist_dataset/Mixed/Digital_Camera/(C.S)C-outdoor6/P1010085.JPG,char_data/8/P1010085.JPG_7.jpg,384,480,640,16,332,348,158,182,False,10
8,21,kaist_dataset/Mixed/Digital_Camera/(C.S)C-outdoor6/P1010085.JPG,char_data/8/P1010085.JPG_8.jpg,357,480,640,17,397,414,158,179,False,10
8,60,kaist_dataset/Mixed/Digital_Camera/(C.S)C-outdoor6/P1010087.JPG,char_data/8/P1010087.JPG_4.jpg,2100,480,640,35,269,304,174,234,False,10
8,66,kaist_dataset/Mixed/Digital_Camera/(C.S)C-outdoor6/P1010087.JPG,char_data/8/P1010087.JPG_5.jpg,2640,480,640,40,434,474,174,240,False,10
8,25,kaist_dataset/Mixed/Digital_Camera/(C.S)C-outdoor6/P1010088.JPG,char_data/8/P1010088.JPG_2.jpg,350,480,640,14,323,337,221,246,False,10
8,35,kaist_dataset/Mixed/Digital_Camera/(C.S)C-outdoor6/P1010093.JPG,char_data/8/P1010093.JPG_4.jpg,560,480,640,16,512,528,242,277,False,10
8,30,kaist_dataset/Mixed/Digital_Camera/(C.S)C-outdoor6/P1010093.JPG,char_data/8/P1010093.JPG_5.jpg,420,480,640,14,531,545,245,275,False,10
8,24,kaist_dataset/Mixed/Digital_Camera/(C.S)C-outdoor6/P1010094.JPG,char_data/8/P1010094.JPG_2.jpg,504,480,640,21,482,503,219,243,False,10
8,31,kaist_dataset/Mixed/Digital_Camera/(C.S)C-outdoor6/P1010097.JPG,char_data/8/P1010097.JPG_4.jpg,651,480,640,21,63,84,177,208,False,10
8,23,kaist_dataset/Mixed/Digital_Camera/(C.S)C-outdoor6/P1010097.JPG,char_data/8/P1010097.JPG_5.jpg,368,480,640,16,435,451,190,213,False,10
8,39,kaist_dataset/Mixed/Digital_Camera/(C.S)C-outdoor6/P1010098.JPG,char_data/8/P1010098.JPG_10.jpg,936,480,640,24,403,427,55,94,False,10
8,35,kaist_dataset/Mixed/Digital_Camera/(C.S)C-outdoor6/P1010098.JPG,char_data/8/P1010098.JPG_11.jpg,840,480,640,24,429,453,57,92,False,10
8,40,kaist_dataset/Mixed/Digital_Camera/(C.S)C-outdoor6/P1010098.JPG,char_data/8/P1010098.JPG_12.jpg,920,480,640,23,466,489,55,95,False,10
8,45,kaist_dataset/Mixed/Digital_Camera/(C.S)C-outdoor6/P1010098.JPG,char_data/8/P1010098.JPG_13.jpg,990,480,640,22,514,536,49,94,False,10
8,42,kaist_dataset/Mixed/Digital_Camera/(C.S)C-outdoor6/P1010098.JPG,char_data/8/P1010098.JPG_14.jpg,1260,480,640,30,536,566,52,94,False,10
8,24,kaist_dataset/Mixed/Digital_Camera/(C.S)C-outdoor6/P1010099.JPG,char_data/8/P1010099.JPG_2.jpg,312,480,640,13,474,487,208,232,False,10
8,32,kaist_dataset/Mixed/Digital_Camera/(C.S)C-outdoor6/P1010111.JPG,char_data/8/P1010111.JPG_11.jpg,800,480,640,25,264,289,210,242,False,10
8,26,kaist_dataset/Mixed/Digital_Camera/(C.S)C-outdoor6/P1010114.JPG,char_data/8/P1010114.JPG_2.jpg,624,480,640,24,448,472,219,245,False,10
8,41,kaist_dataset/Mixed/Digital_Camera/(C.S)C-outdoor6/P1010120.JPG,char_data/8/P1010120.JPG_2.jpg,902,480,640,22,330,352,192,233,False,10
8,24,kaist_dataset/Mixed/Digital_Camera/(C.S)C-outdoor6/P1010129.JPG,char_data/8/P1010129.JPG_6.jpg,360,480,640,15,399,414,236,260,False,10
8,22,kaist_dataset/Mixed/Digital_Camera/(C.S)C-outdoor6/P1010129.JPG,char_data/8/P1010129.JPG_7.jpg,374,480,640,17,446,463,236,258,False,10
8,26,kaist_dataset/Mixed/Digital_Camera/(C.S)C-outdoor6/P1010129.JPG,char_data/8/P1010129.JPG_8.jpg,416,480,640,16,482,498,234,260,False,10
8,36,kaist_dataset/Mixed/Digital_Camera/(C.S)C-outdoor6/P1010137.JPG,char_data/8/P1010137.JPG_2.jpg,756,480,640,21,71,92,72,108,False,10
8,29,kaist_dataset/Mixed/Digital_Camera/(C.S)C-outdoor6/P1010138.JPG,char_data/8/P1010138.JPG_14.jpg,667,480,640,23,369,392,184,213,False,10
8,60,kaist_dataset/Mixed/Digital_Camera/(C.S)C-outdoor6/크기변환_P1010029.JPG,char_data/8/크기변환_P1010029.JPG_2.jpg,3420,480,640,57,509,566,264,324,False,10
8,47,kaist_dataset/Mixed/Digital_Camera/(C.S)D-indoor1/DSC02733.JPG,char_data/8/DSC02733.JPG_2.jpg,1457,480,640,31,229,260,400,447,False,10
8,45,kaist_dataset/Mixed/Digital_Camera/(C.S)D-indoor1/DSC03980.JPG,char_data/8/DSC03980.JPG_4.jpg,1710,480,640,38,245,283,303,348,False,10
8,45,kaist_dataset/Mixed/Digital_Camera/(C.S)D-indoor1/DSC03980.JPG,char_data/8/DSC03980.JPG_5.jpg,2115,480,640,47,382,429,311,356,False,10
8,50,kaist_dataset/Mixed/Digital_Camera/(C.S)D-indoor1/DSC03986.JPG,char_data/8/DSC03986.JPG_4.jpg,1050,480,640,21,61,82,161,211,False,10
8,53,kaist_dataset/Mixed/Digital_Camera/(C.S)D-indoor1/DSC03986.JPG,char_data/8/DSC03986.JPG_5.jpg,1113,480,640,21,159,180,159,212,False,10
8,70,kaist_dataset/Mixed/Digital_Camera/(C.S)D-indoor1/DSC03998.JPG,char_data/8/DSC03998.JPG_4.jpg,2380,480,640,34,378,412,410,479,False,10
8,67,kaist_dataset/Mixed/Digital_Camera/(C.S)D-indoor1/DSC03998.JPG,char_data/8/DSC03998.JPG_5.jpg,2278,480,640,34,545,579,417,479,False,10
8,105,kaist_dataset/Mixed/Digital_Camera/(C.S)D-indoor1/DSC04002.JPG,char_data/8/DSC04002.JPG_4.jpg,7035,480,640,67,128,195,347,452,False,10
8,94,kaist_dataset/Mixed/Digital_Camera/(C.S)D-indoor1/DSC04002.JPG,char_data/8/DSC04002.JPG_5.jpg,4794,480,640,51,449,500,347,441,False,10
8,26,kaist_dataset/Mixed/Digital_Camera/(C.S)D-indoor1/DSC04005.JPG,char_data/8/DSC04005.JPG_6.jpg,468,480,640,18,260,278,442,468,False,10
8,25,kaist_dataset/Mixed/Digital_Camera/(C.S)D-indoor1/DSC04005.JPG,char_data/8/DSC04005.JPG_7.jpg,600,480,640,24,362,386,440,465,False,10
8,24,kaist_dataset/Mixed/Digital_Camera/(C.S)D-indoor1/DSC04005.JPG,char_data/8/DSC04005.JPG_8.jpg,408,480,640,17,424,441,440,464,False,10
8,33,kaist_dataset/Mixed/Digital_Camera/(C.S)E-night/DSC02569.JPG,char_data/8/DSC02569.JPG_2.jpg,594,480,640,18,333,351,415,448,False,10
8,53,kaist_dataset/Mixed/Digital_Camera/(C.S)E-night/DSC02573.JPG,char_data/8/DSC02573.JPG_4.jpg,1802,480,640,34,311,345,175,228,False,10
8,55,kaist_dataset/Mixed/Digital_Camera/(C.S)E-night/DSC02573.JPG,char_data/8/DSC02573.JPG_5.jpg,1925,480,640,35,560,595,143,198,False,10
8,63,kaist_dataset/Mixed/Digital_Camera/(C.S)E-night/DSC02574.JPG,char_data/8/DSC02574.JPG_2.jpg,2205,480,640,35,280,315,410,473,False,10
8,43,kaist_dataset/Mixed/Digital_Camera/(C.S)E-night/DSC02575.JPG,char_data/8/DSC02575.JPG_2.jpg,1290,480,640,30,263,293,358,401,False,10
8,37,kaist_dataset/Mixed/Digital_Camera/(C.S)E-night/DSC02585.JPG,char_data/8/DSC02585.JPG_2.jpg,481,480,640,13,331,344,412,449,False,10
8,36,kaist_dataset/Mixed/Digital_Camera/(C.S)E-night/DSC02586.JPG,char_data/8/DSC02586.JPG_2.jpg,612,480,640,17,308,325,394,430,False,10
8,51,kaist_dataset/Mixed/Digital_Camera/(C.S)E-night/DSC02595.JPG,char_data/8/DSC02595.JPG_2.jpg,1785,480,640,35,450,485,344,395,False,10
8,44,kaist_dataset/Mixed/Digital_Camera/(C.S)E-night/DSC02623.JPG,char_data/8/DSC02623.JPG_2.jpg,792,480,640,18,88,106,395,439,False,10
8,39,kaist_dataset/Mixed/Digital_Camera/(C.S)E-night/DSC02644.JPG,char_data/8/DSC02644.JPG_2.jpg,858,480,640,22,298,320,400,439,False,10
8,43,kaist_dataset/Mixed/Digital_Camera/(C.S)E-night/DSC02647.JPG,char_data/8/DSC02647.JPG_2.jpg,1118,480,640,26,194,220,285,328,False,10
8,37,kaist_dataset/Mixed/Digital_Camera/(C.S)E-night/DSC02660.JPG,char_data/8/DSC02660.JPG_2.jpg,814,480,640,22,200,222,416,453,False,10
8,33,kaist_dataset/Mixed/Digital_Camera/(C.S)E-night/DSC02673.JPG,char_data/8/DSC02673.JPG_4.jpg,594,480,640,18,281,299,306,339,False,10
8,34,kaist_dataset/Mixed/Digital_Camera/(C.S)E-night/DSC02673.JPG,char_data/8/DSC02673.JPG_5.jpg,612,480,640,18,449,467,302,336,False,10
8,30,kaist_dataset/Mixed/Digital_Camera/(C.S)E-night/DSC02678.JPG,char_data/8/DSC02678.JPG_2.jpg,420,480,640,14,371,385,396,426,False,10
8,36,kaist_dataset/Mixed/Digital_Camera/(C.S)E-night/DSC02903.JPG,char_data/8/DSC02903.JPG_2.jpg,648,480,640,18,320,338,265,301,False,10
8,48,kaist_dataset/Mixed/Digital_Camera/(C.S)E-night/DSC03561.JPG,char_data/8/DSC03561.JPG_4.jpg,1632,480,640,34,257,291,257,305,False,10
8,51,kaist_dataset/Mixed/Digital_Camera/(C.S)E-night/DSC03561.JPG,char_data/8/DSC03561.JPG_5.jpg,1734,480,640,34,399,433,249,300,False,10
8,30,kaist_dataset/Mixed/Digital_Camera/(C.S)E-night/DSC03840.JPG,char_data/8/DSC03840.JPG_6.jpg,390,480,640,13,451,464,207,237,False,10
8,31,kaist_dataset/Mixed/Digital_Camera/(C.S)E-night/DSC03840.JPG,char_data/8/DSC03840.JPG_7.jpg,496,480,640,16,465,481,207,238,False,10
8,31,kaist_dataset/Mixed/Digital_Camera/(C.S)E-night/DSC03840.JPG,char_data/8/DSC03840.JPG_8.jpg,651,480,640,21,500,521,209,240,False,10
8,60,kaist_dataset/Mixed/Digital_Camera/(C.S)E-night/P1010147.JPG,char_data/8/P1010147.JPG_11.jpg,2220,480,640,37,233,270,253,313,False,10
8,31,kaist_dataset/Mixed/Digital_Camera/(C.S)E-night/P1010156.JPG,char_data/8/P1010156.JPG_6.jpg,682,480,640,22,320,342,244,275,False,10
8,28,kaist_dataset/Mixed/Digital_Camera/(C.S)E-night/P1010156.JPG,char_data/8/P1010156.JPG_7.jpg,672,480,640,24,379,403,243,271,False,10
8,27,kaist_dataset/Mixed/Digital_Camera/(C.S)E-night/P1010156.JPG,char_data/8/P1010156.JPG_8.jpg,567,480,640,21,404,425,243,270,False,10
8,35,kaist_dataset/Mixed/Digital_Camera/(C.S)F-others/2007-12-08-day-044.jpg,char_data/8/2007-12-08-day-044.jpg_2.jpg,665,1200,1600,19,1025,1044,825,860,False,10
8,45,kaist_dataset/Mixed/Digital_Camera/(C.S)F-others/2007-12-08-day-113.jpg,char_data/8/2007-12-08-day-113.jpg_2.jpg,1035,1200,1600,23,826,849,395,440,False,10
8,52,kaist_dataset/Mixed/Digital_Camera/(C.S)F-others/2007-12-09-day-exterior-023.jpg,char_data/8/2007-12-09-day-exterior-023.jpg_4.jpg,2184,1200,1600,42,853,895,577,629,False,10
8,51,kaist_dataset/Mixed/Digital_Camera/(C.S)F-others/2007-12-09-day-exterior-023.jpg,char_data/8/2007-12-09-day-exterior-023.jpg_5.jpg,2040,1200,1600,40,1083,1123,602,653,False,10
8,39,kaist_dataset/Mixed/Digital_Camera/(C.S)F-others/DSC02504.JPG,char_data/8/DSC02504.JPG_2.jpg,1560,480,640,40,204,244,325,364,False,10
8,52,kaist_dataset/Mixed/Digital_Camera/(C.S)F-others/DSC02893.JPG,char_data/8/DSC02893.JPG_6.jpg,1664,480,640,32,298,330,336,388,False,10
8,45,kaist_dataset/Mixed/Digital_Camera/(C.S)F-others/DSC02893.JPG,char_data/8/DSC02893.JPG_7.jpg,1710,480,640,38,379,417,332,377,False,10
8,45,kaist_dataset/Mixed/Digital_Camera/(C.S)F-others/DSC02893.JPG,char_data/8/DSC02893.JPG_8.jpg,1485,480,640,33,451,484,325,370,False,10
8,90,kaist_dataset/Mixed/Digital_Camera/(C.S)F-others/DSC03224.JPG,char_data/8/DSC03224.JPG_2.jpg,3870,480,640,43,137,180,255,345,False,10
8,28,kaist_dataset/Mixed/Mobile_Phone/(C.M)A-outdoor/P090908006.jpg,char_data/8/P090908006.jpg_4.jpg,672,480,640,24,329,353,369,397,False,10
8,34,kaist_dataset/Mixed/Mobile_Phone/(C.M)A-outdoor/P090908006.jpg,char_data/8/P090908006.jpg_5.jpg,646,480,640,19,432,451,363,397,False,10
8,43,kaist_dataset/Mixed/Mobile_Phone/(C.M)A-outdoor/P090912038.jpg,char_data/8/P090912038.jpg_2.jpg,946,480,640,22,490,512,155,198,False,10
8,26,kaist_dataset/Mixed/Mobile_Phone/(C.M)A-outdoor/P090912040.jpg,char_data/8/P090912040.jpg_6.jpg,676,480,640,26,132,158,190,216,False,10
8,25,kaist_dataset/Mixed/Mobile_Phone/(C.M)A-outdoor/P090912040.jpg,char_data/8/P090912040.jpg_7.jpg,475,480,640,19,221,240,193,218,False,10
8,26,kaist_dataset/Mixed/Mobile_Phone/(C.M)A-outdoor/P090912040.jpg,char_data/8/P090912040.jpg_8.jpg,520,480,640,20,265,285,193,219,False,10
8,34,kaist_dataset/Mixed/Mobile_Phone/(C.M)A-outdoor/P090912047.jpg,char_data/8/P090912047.jpg_2.jpg,646,480,640,19,233,252,283,317,False,10
8,43,kaist_dataset/Mixed/Mobile_Phone/(C.M)C-bookCover/P090902016.jpg,char_data/8/P090902016.jpg_2.jpg,1204,480,640,28,83,111,200,243,False,10
2,40,kaist_dataset/English/Digital_Camera/(E.S)C-outdoor1/080116-0065.jpg,char_data/2/080116-0065.jpg_8.jpg,1160,600,800,29,340,369,201,241,True,4
2,41,kaist_dataset/English/Digital_Camera/(E.S)C-outdoor1/080116-0065.jpg,char_data/2/080116-0065.jpg_9.jpg,943,600,800,23,183,206,364,405,True,4
2,44,kaist_dataset/English/Digital_Camera/(E.S)C-outdoor1/080116-0065.jpg,char_data/2/080116-0065.jpg_10.jpg,1144,600,800,26,325,351,376,420,True,4
2,47,kaist_dataset/English/Digital_Camera/(E.S)C-outdoor1/080116-0065.jpg,char_data/2/080116-0065.jpg_11.jpg,1363,600,800,29,397,426,383,430,True,4
2,73,kaist_dataset/English/Digital_Camera/(E.S)C-outdoor1/080119-0020.jpg,char_data/2/080119-0020.jpg_2.jpg,3504,1200,1600,48,762,810,418,491,True,4
2,36,kaist_dataset/English/Digital_Camera/(E.S)C-outdoor1/107.jpg,char_data/2/107.jpg_2.jpg,1224,480,640,34,424,458,331,367,True,4
2,128,kaist_dataset/English/Digital_Camera/(E.S)C-outdoor1/108.JPG,char_data/2/108.JPG_2.jpg,10752,480,640,84,381,465,198,326,True,4
2,33,kaist_dataset/English/Digital_Camera/(E.S)C-outdoor1/2007-12-08-day-015.jpg,char_data/2/2007-12-08-day-015.jpg_2.jpg,858,1200,1600,26,1007,1033,814,847,True,4
2,37,kaist_dataset/English/Digital_Camera/(E.S)C-outdoor1/DSC02364.JPG,char_data/2/DSC02364.JPG_6.jpg,740,480,640,20,377,397,350,387,True,4
2,36,kaist_dataset/English/Digital_Camera/(E.S)C-outdoor1/DSC02364.JPG,char_data/2/DSC02364.JPG_7.jpg,432,480,640,12,510,522,352,388,True,4
2,34,kaist_dataset/English/Digital_Camera/(E.S)C-outdoor1/DSC02364.JPG,char_data/2/DSC02364.JPG_8.jpg,442,480,640,13,526,539,353,387,True,4
2,51,kaist_dataset/English/Digital_Camera/(E.S)C-outdoor1/DSC02415.JPG,char_data/2/DSC02415.JPG_4.jpg,1581,480,640,31,419,450,246,297,True,4
2,36,kaist_dataset/English/Digital_Camera/(E.S)C-outdoor1/DSC02415.JPG,char_data/2/DSC02415.JPG_5.jpg,1044,480,640,29,452,481,252,288,True,4
2,44,kaist_dataset/English/Digital_Camera/(E.S)C-outdoor1/DSC02450.JPG,char_data/2/DSC02450.JPG_4.jpg,1452,480,640,33,154,187,222,266,True,4
2,43,kaist_dataset/English/Digital_Camera/(E.S)C-outdoor1/DSC02450.JPG,char_data/2/DSC02450.JPG_5.jpg,1204,480,640,28,205,233,221,264,True,4
2,93,kaist_dataset/English/Digital_Camera/(E.S)C-outdoor1/DSC02491.JPG,char_data/2/DSC02491.JPG_4.jpg,4743,480,640,51,338,389,308,401,True,4
2,76,kaist_dataset/English/Digital_Camera/(E.S)C-outdoor1/DSC02491.JPG,char_data/2/DSC02491.JPG_5.jpg,4028,480,640,53,472,525,313,389,True,4
2,39,kaist_dataset/English/Digital_Camera/(E.S)C-outdoor2/DSC03160.JPG,char_data/2/DSC03160.JPG_4.jpg,975,480,640,25,294,319,399,438,True,4
2,42,kaist_dataset/English/Digital_Camera/(E.S)C-outdoor2/DSC03160.JPG,char_data/2/DSC03160.JPG_5.jpg,966,480,640,23,364,387,398,440,True,4
2,56,kaist_dataset/English/Digital_Camera/(E.S)C-outdoor2/DSC03201.JPG,char_data/2/DSC03201.JPG_2.jpg,2632,480,640,47,225,272,9,65,True,4
2,33,kaist_dataset/English/Digital_Camera/(E.S)C-outdoor2/DSC03294.JPG,char_data/2/DSC03294.JPG_2.jpg,693,480,640,21,268,289,397,430,True,4
2,85,kaist_dataset/English/Digital_Camera/(E.S)C-outdoor2/DSC03731.JPG,char_data/2/DSC03731.JPG_4.jpg,6035,480,640,71,314,385,27,112,True,4
2,26,kaist_dataset/English/Digital_Camera/(E.S)C-outdoor2/DSC03731.JPG,char_data/2/DSC03731.JPG_5.jpg,364,480,640,14,565,579,119,145,True,4
2,68,kaist_dataset/English/Digital_Camera/(E.S)C-outdoor2/DSC04163.JPG,char_data/2/DSC04163.JPG_2.jpg,2380,480,640,35,306,341,316,384,True,4
2,96,kaist_dataset/English/Digital_Camera/(E.S)C-outdoor3/P1010123.JPG,char_data/2/P1010123.JPG_2.jpg,8736,480,640,91,273,364,57,153,True,4
2,23,kaist_dataset/English/Digital_Camera/(E.S)C-outdoor3/크기변환_P1010076.JPG,char_data/2/크기변환_P1010076.JPG_2.jpg,253,480,640,11,544,555,180,203,True,4
2,98,kaist_dataset/English/Digital_Camera/(E.S)D-indoor/DSC02719.JPG,char_data/2/DSC02719.JPG_2.jpg,7448,480,640,76,223,299,168,266,True,4
2,31,kaist_dataset/English/Digital_Camera/(E.S)D-indoor/DSC03943.JPG,char_data/2/DSC03943.JPG_2.jpg,496,480,640,16,390,406,312,343,True,4
2,56,kaist_dataset/English/Digital_Camera/(E.S)F-others/080116-0058.jpg,char_data/2/080116-0058.jpg_2.jpg,1344,1200,1600,24,1230,1254,1019,1075,True,4
2,48,kaist_dataset/English/Digital_Camera/(E.S)F-others/080119-0007.jpg,char_data/2/080119-0007.jpg_4.jpg,1104,1200,1600,23,1079,1102,224,272,True,4
2,45,kaist_dataset/English/Digital_Camera/(E.S)F-others/080119-0007.jpg,char_data/2/080119-0007.jpg_5.jpg,1260,1200,1600,28,1102,1130,223,268,True,4
2,66,kaist_dataset/Korean/Digital_Camera/A-shadow/2007-12-09-day-exterior-026.jpg,char_data/2/2007-12-09-day-exterior-026.jpg_2.jpg,2772,1200,1600,42,1033,1075,759,825,True,4
2,81,kaist_dataset/Korean/Digital_Camera/A-shadow/2007-12-09-day-exterior-031.jpg,char_data/2/2007-12-09-day-exterior-031.jpg_2.jpg,3564,1200,1600,44,645,689,665,746,True,4
2,44,kaist_dataset/Korean/Digital_Camera/A-shadow/2007-12-09-day-exterior-040.jpg,char_data/2/2007-12-09-day-exterior-040.jpg_2.jpg,1012,1200,1600,23,1098,1121,812,856,True,4
2,39,kaist_dataset/Korean/Digital_Camera/A-shadow/DSC02598.JPG,char_data/2/DSC02598.JPG_4.jpg,741,480,640,19,541,560,414,453,True,4
2,67,kaist_dataset/Korean/Digital_Camera/A-shadow/DSC03755.JPG,char_data/2/DSC03755.JPG_4.jpg,1943,480,640,29,385,414,210,277,True,4
2,78,kaist_dataset/Korean/Digital_Camera/A-shadow/DSC03755.JPG,char_data/2/DSC03755.JPG_5.jpg,2496,480,640,32,548,580,207,285,True,4
2,128,kaist_dataset/Korean/Digital_Camera/A-shadow/DSC04300.JPG,char_data/2/DSC04300.JPG_4.jpg,6272,480,640,49,161,210,222,350,True,4
2,125,kaist_dataset/Korean/Digital_Camera/A-shadow/DSC04300.JPG,char_data/2/DSC04300.JPG_5.jpg,6625,480,640,53,350,403,239,364,True,4
2,82,kaist_dataset/Korean/Digital_Camera/A-shadow/DSC04311.JPG,char_data/2/DSC04311.JPG_2.jpg,4100,480,640,50,355,405,259,341,True,4
2,54,kaist_dataset/Korean/Digital_Camera/A-shadow/DSC04315.JPG,char_data/2/DSC04315.JPG_2.jpg,1458,480,640,27,141,168,408,462,True,4
2,22,kaist_dataset/Korean/Digital_Camera/E-night/103.jpg,char_data/2/103.jpg_4.jpg,176,480,640,8,168,176,314,336,True,4
2,21,kaist_dataset/Korean/Digital_Camera/E-night/103.jpg,char_data/2/103.jpg_5.jpg,168,480,640,8,210,218,314,335,True,4
2,59,kaist_dataset/Korean/Digital_Camera/E-night/DSC02594.JPG,char_data/2/DSC02594.JPG_4.jpg,2773,480,640,47,279,326,375,434,True,4
2,60,kaist_dataset/Korean/Digital_Camera/E-night/DSC02594.JPG,char_data/2/DSC02594.JPG_5.jpg,2280,480,640,38,380,418,370,430,True,4
2,48,kaist_dataset/Korean/Digital_Camera/E-night/DSC02597.JPG,char_data/2/DSC02597.JPG_4.jpg,1392,480,640,29,481,510,289,337,True,4
2,47,kaist_dataset/Korean/Digital_Camera/E-night/DSC02597.JPG,char_data/2/DSC02597.JPG_5.jpg,1410,480,640,30,540,570,290,337,True,4
2,29,kaist_dataset/Korean/Digital_Camera/E-night/DSC02626.JPG,char_data/2/DSC02626.JPG_6.jpg,377,480,640,13,64,77,380,409,True,4
2,30,kaist_dataset/Korean/Digital_Camera/E-night/DSC02626.JPG,char_data/2/DSC02626.JPG_7.jpg,450,480,640,15,114,129,377,407,True,4
2,35,kaist_dataset/Korean/Digital_Camera/E-night/DSC02626.JPG,char_data/2/DSC02626.JPG_8.jpg,420,480,640,12,153,165,373,408,True,4
2,78,kaist_dataset/Korean/Digital_Camera/E-night/DSC02631.JPG,char_data/2/DSC02631.JPG_2.jpg,5226,480,640,67,166,233,186,264,True,4
2,46,kaist_dataset/Korean/Digital_Camera/E-night/DSC02645.JPG,char_data/2/DSC02645.JPG_2.jpg,1242,480,640,27,423,450,332,378,True,4
2,48,kaist_dataset/Korean/Digital_Camera/E-night/DSC02649.JPG,char_data/2/DSC02649.JPG_2.jpg,960,480,640,20,491,511,391,439,True,4
2,35,kaist_dataset/Korean/Digital_Camera/E-night/DSC02658.JPG,char_data/2/DSC02658.JPG_2.jpg,945,480,640,27,302,329,357,392,True,4
2,43,kaist_dataset/Korean/Digital_Camera/E-night/DSC03515.JPG,char_data/2/DSC03515.JPG_2.jpg,731,480,640,17,454,471,274,317,True,4
2,38,kaist_dataset/Korean/Digital_Camera/E-night/DSC03850.JPG,char_data/2/DSC03850.JPG_2.jpg,722,480,640,19,354,373,425,463,True,4
2,24,kaist_dataset/Korean/Digital_Camera/E-night/DSC03870.JPG,char_data/2/DSC03870.JPG_2.jpg,288,480,640,12,394,406,222,246,True,4
2,29,kaist_dataset/Korean/Digital_Camera/E-night/P1010146.JPG,char_data/2/P1010146.JPG_2.jpg,522,480,640,18,342,360,246,275,True,4
2,25,kaist_dataset/Korean/Digital_Camera/E-night/P1010149.JPG,char_data/2/P1010149.JPG_2.jpg,425,480,640,17,612,629,242,267,True,4
2,92,kaist_dataset/Korean/Digital_Camera/F-bookCover/DSC02812.JPG,char_data/2/DSC02812.JPG_2.jpg,5796,480,640,63,389,452,27,119,True,4
2,89,kaist_dataset/Korean/Digital_Camera/F-bookCover/DSC02813.JPG,char_data/2/DSC02813.JPG_2.jpg,5340,480,640,60,349,409,28,117,True,4
2,92,kaist_dataset/Korean/Digital_Camera/F-bookCover/DSC02814.JPG,char_data/2/DSC02814.JPG_2.jpg,4784,480,640,52,364,416,27,119,True,4
2,69,kaist_dataset/Korean/Digital_Camera/F-bookCover/DSC02815.JPG,char_data/2/DSC02815.JPG_2.jpg,2829,480,640,41,346,387,35,104,True,4
2,145,kaist_dataset/Korean/Digital_Camera/F-bookCover/DSC02826.JPG,char_data/2/DSC02826.JPG_2.jpg,13630,480,640,94,31,125,225,370,True,4
2,98,kaist_dataset/Korean/Digital_Camera/F-bookCover/DSC02827.JPG,char_data/2/DSC02827.JPG_2.jpg,6664,480,640,68,134,202,43,141,True,4
2,110,kaist_dataset/Korean/Digital_Camera/F-bookCover/DSC02832.JPG,char_data/2/DSC02832.JPG_2.jpg,7920,480,640,72,124,196,29,139,True,4
2,93,kaist_dataset/Korean/Digital_Camera/F-bookCover/DSC02833.JPG,char_data/2/DSC02833.JPG_2.jpg,5673,480,640,61,135,196,45,138,True,4
2,164,kaist_dataset/Korean/Digital_Camera/F-bookCover/DSC02836.JPG,char_data/2/DSC02836.JPG_2.jpg,17220,480,640,105,8,113,154,318,True,4
2,87,kaist_dataset/Korean/Digital_Camera/F-bookCover/P090911043.jpg,char_data/2/P090911043.jpg_4.jpg,5916,480,640,68,292,360,222,309,True,4
2,43,kaist_dataset/Korean/Digital_Camera/F-bookCover/P090911043.jpg,char_data/2/P090911043.jpg_5.jpg,1591,480,640,37,558,595,205,248,True,4
2,84,kaist_dataset/Korean/Digital_Camera/G-others/2007-12-08-day-108.jpg,char_data/2/2007-12-08-day-108.jpg_6.jpg,3444,1200,1600,41,653,694,607,691,True,4
2,86,kaist_dataset/Korean/Digital_Camera/G-others/2007-12-08-day-108.jpg,char_data/2/2007-12-08-day-108.jpg_7.jpg,3440,1200,1600,40,770,810,647,733,True,4
2,80,kaist_dataset/Korean/Digital_Camera/G-others/2007-12-08-day-108.jpg,char_data/2/2007-12-08-day-108.jpg_8.jpg,3440,1200,1600,43,801,844,662,742,True,4
2,109,kaist_dataset/Korean/Digital_Camera/G-others/2007-12-09-day-exterior-062.jpg,char_data/2/2007-12-09-day-exterior-062.jpg_2.jpg,3379,1600,1200,31,536,567,1396,1505,True,4
2,66,kaist_dataset/Korean/Digital_Camera/G-others/DSC02584.JPG,char_data/2/DSC02584.JPG_2.jpg,3828,480,640,58,430,488,240,306,True,4
2,26,kaist_dataset/Korean/Digital_Camera/G-others/DSC03863.JPG,char_data/2/DSC03863.JPG_2.jpg,338,480,640,13,215,228,408,434,True,4
2,60,kaist_dataset/Korean/Digital_Camera/indoor1/080119-0018.jpg,char_data/2/080119-0018.jpg_6.jpg,2520,1200,1600,42,916,958,443,503,True,4
2,47,kaist_dataset/Korean/Digital_Camera/indoor1/080119-0018.jpg,char_data/2/080119-0018.jpg_7.jpg,1128,1200,1600,24,946,970,939,986,True,4
2,46,kaist_dataset/Korean/Digital_Camera/indoor1/080119-0018.jpg,char_data/2/080119-0018.jpg_8.jpg,1426,1200,1600,31,1004,1035,940,986,True,4
2,95,kaist_dataset/Korean/Digital_Camera/indoor1/080119-0029.jpg,char_data/2/080119-0029.jpg_6.jpg,4085,1200,1600,43,479,522,573,668,True,4
2,43,kaist_dataset/Korean/Digital_Camera/indoor1/080119-0029.jpg,char_data/2/080119-0029.jpg_7.jpg,989,1200,1600,23,1230,1253,619,662,True,4
2,88,kaist_dataset/Korean/Digital_Camera/indoor1/080119-0029.jpg,char_data/2/080119-0029.jpg_8.jpg,3608,1200,1600,41,658,699,971,1059,True,4
2,27,kaist_dataset/Korean/Digital_Camera/indoor1/080119-0030.jpg,char_data/2/080119-0030.jpg_2.jpg,432,1200,1600,16,745,761,868,895,True,4
2,32,kaist_dataset/Korean/Digital_Camera/indoor1/DSC03362.JPG,char_data/2/DSC03362.JPG_2.jpg,544,480,640,17,68,85,280,312,True,4
2,87,kaist_dataset/Korean/Digital_Camera/indoor1/DSC03364.JPG,char_data/2/DSC03364.JPG_2.jpg,5568,480,640,64,262,326,236,323,True,4
2,116,kaist_dataset/Korean/Digital_Camera/indoor1/DSC03375.JPG,char_data/2/DSC03375.JPG_2.jpg,13340,480,640,115,134,249,164,280,True,4
2,57,kaist_dataset/Korean/Digital_Camera/indoor2/DSC03474.JPG,char_data/2/DSC03474.JPG_2.jpg,2052,480,640,36,171,207,153,210,True,4
2,55,kaist_dataset/Korean/Digital_Camera/indoor2/DSC03475.JPG,char_data/2/DSC03475.JPG_2.jpg,2420,480,640,44,154,198,91,146,True,4
2,49,kaist_dataset/Korean/Digital_Camera/indoor2/DSC03497.JPG,char_data/2/DSC03497.JPG_2.jpg,1519,480,640,31,221,252,4,53,True,4
2,41,kaist_dataset/Korean/Digital_Camera/indoor2/DSC03530.JPG,char_data/2/DSC03530.JPG_2.jpg,943,480,640,23,209,232,217,258,True,4
2,55,kaist_dataset/Korean/Digital_Camera/indoor2/DSC03563.JPG,char_data/2/DSC03563.JPG_2.jpg,2750,480,640,50,433,483,260,315,True,4
2,91,kaist_dataset/Korean/Digital_Camera/indoor2/DSC03565.JPG,char_data/2/DSC03565.JPG_4.jpg,5733,480,640,63,393,456,269,360,True,4
2,95,kaist_dataset/Korean/Digital_Camera/indoor2/DSC03565.JPG,char_data/2/DSC03565.JPG_5.jpg,6555,480,640,69,508,577,263,358,True,4
2,38,kaist_dataset/Korean/Digital_Camera/indoor2/DSC03975.JPG,char_data/2/DSC03975.JPG_2.jpg,494,480,640,13,182,195,289,327,True,4
2,74,kaist_dataset/Korean/Digital_Camera/indoor2/DSC04006.JPG,char_data/2/DSC04006.JPG_6.jpg,2442,480,640,33,214,247,151,225,True,4
2,75,kaist_dataset/Korean/Digital_Camera/indoor2/DSC04006.JPG,char_data/2/DSC04006.JPG_7.jpg,2100,480,640,28,308,336,146,221,True,4
2,78,kaist_dataset/Korean/Digital_Camera/indoor2/DSC04006.JPG,char_data/2/DSC04006.JPG_8.jpg,2964,480,640,38,367,405,146,224,True,4
2,39,kaist_dataset/Korean/Digital_Camera/indoor2/DSC04204.JPG,char_data/2/DSC04204.JPG_4.jpg,936,480,640,24,347,371,280,319,True,4
2,44,kaist_dataset/Korean/Digital_Camera/indoor2/DSC04204.JPG,char_data/2/DSC04204.JPG_5.jpg,836,480,640,19,373,392,278,322,True,4
2,83,kaist_dataset/Korean/Digital_Camera/indoor2/크기변환_%BD%C7%B3%BB%B0%A3%C6%C7_moon8481.jpg,char_data/2/크기변환_%BD%C7%B3%BB%B0%A3%C6%C7_moon8481.jpg_2.jpg,3901,480,640,47,330,377,335,418,True,4
2,25,kaist_dataset/Korean/Digital_Camera/outdoor1/002.JPG,char_data/2/002.JPG_2.jpg,450,480,640,18,305,323,375,400,True,4
2,18,kaist_dataset/Korean/Digital_Camera/outdoor1/017.JPG,char_data/2/017.JPG_2.jpg,324,480,640,18,445,463,274,292,True,4
2,33,kaist_dataset/Korean/Digital_Camera/outdoor1/023.JPG,char_data/2/023.JPG_2.jpg,759,480,640,23,256,279,266,299,True,4
2,32,kaist_dataset/Korean/Digital_Camera/outdoor1/029.JPG,char_data/2/029.JPG_2.jpg,832,480,640,26,312,338,287,319,True,4
2,35,kaist_dataset/Korean/Digital_Camera/outdoor1/032.JPG,char_data/2/032.JPG_4.jpg,700,480,640,20,106,126,255,290,True,4
2,29,kaist_dataset/Korean/Digital_Camera/outdoor1/032.JPG,char_data/2/032.JPG_5.jpg,464,480,640,16,316,332,259,288,True,4
2,26,kaist_dataset/Korean/Digital_Camera/outdoor1/035.JPG,char_data/2/035.JPG_4.jpg,390,480,640,15,273,288,292,318,True,4
2,26,kaist_dataset/Korean/Digital_Camera/outdoor1/035.JPG,char_data/2/035.JPG_5.jpg,390,480,640,15,491,506,292,318,True,4
2,42,kaist_dataset/Korean/Digital_Camera/outdoor1/052.JPG,char_data/2/052.JPG_2.jpg,1008,480,640,24,350,374,321,363,True,4
2,38,kaist_dataset/Korean/Digital_Camera/outdoor1/059.JPG,char_data/2/059.JPG_2.jpg,646,480,640,17,432,449,320,358,True,4
2,30,kaist_dataset/Korean/Digital_Camera/outdoor1/069.JPG,char_data/2/069.JPG_2.jpg,510,480,640,17,300,317,268,298,True,4
2,16,kaist_dataset/Korean/Digital_Camera/outdoor1/070.JPG,char_data/2/070.JPG_2.jpg,176,480,640,11,387,398,254,270,True,4
2,35,kaist_dataset/Korean/Digital_Camera/outdoor1/091.JPG,char_data/2/091.JPG_4.jpg,980,480,640,28,231,259,288,323,True,4
2,36,kaist_dataset/Korean/Digital_Camera/outdoor1/091.JPG,char_data/2/091.JPG_5.jpg,972,480,640,27,257,284,286,322,True,4
2,44,kaist_dataset/Korean/Digital_Camera/outdoor1/098.JPG,char_data/2/098.JPG_6.jpg,1760,480,640,40,64,104,358,402,True,4
2,46,kaist_dataset/Korean/Digital_Camera/outdoor1/098.JPG,char_data/2/098.JPG_7.jpg,1564,480,640,34,104,138,355,401,True,4
2,49,kaist_dataset/Korean/Digital_Camera/outdoor1/098.JPG,char_data/2/098.JPG_8.jpg,1421,480,640,29,173,202,354,403,True,4
2,28,kaist_dataset/Korean/Digital_Camera/outdoor1/102.JPG,char_data/2/102.JPG_4.jpg,560,480,640,20,270,290,309,337,True,4
2,29,kaist_dataset/Korean/Digital_Camera/outdoor1/102.JPG,char_data/2/102.JPG_5.jpg,551,480,640,19,290,309,311,340,True,4
2,40,kaist_dataset/Korean/Digital_Camera/outdoor1/120.JPG,char_data/2/120.JPG_4.jpg,1520,480,640,38,239,277,296,336,True,4
2,32,kaist_dataset/Korean/Digital_Camera/outdoor1/120.JPG,char_data/2/120.JPG_5.jpg,1728,480,640,54,432,486,299,331,True,4
2,33,kaist_dataset/Korean/Digital_Camera/outdoor1/123.JPG,char_data/2/123.JPG_6.jpg,594,480,640,18,364,382,273,306,True,4
2,36,kaist_dataset/Korean/Digital_Camera/outdoor1/123.JPG,char_data/2/123.JPG_7.jpg,756,480,640,21,431,452,272,308,True,4
2,30,kaist_dataset/Korean/Digital_Camera/outdoor1/123.JPG,char_data/2/123.JPG_8.jpg,570,480,640,19,191,210,278,308,True,4
2,27,kaist_dataset/Korean/Digital_Camera/outdoor1/125.JPG,char_data/2/125.JPG_4.jpg,594,480,640,22,289,311,257,284,True,4
2,30,kaist_dataset/Korean/Digital_Camera/outdoor1/125.JPG,char_data/2/125.JPG_5.jpg,600,480,640,20,351,371,256,286,True,4
2,20,kaist_dataset/Korean/Digital_Camera/outdoor1/126.JPG,char_data/2/126.JPG_8.jpg,500,480,640,25,246,271,267,287,True,4
2,20,kaist_dataset/Korean/Digital_Camera/outdoor1/126.JPG,char_data/2/126.JPG_9.jpg,560,480,640,28,397,425,268,288,True,4
2,26,kaist_dataset/Korean/Digital_Camera/outdoor1/126.JPG,char_data/2/126.JPG_10.jpg,286,480,640,11,470,481,255,281,True,4
2,27,kaist_dataset/Korean/Digital_Camera/outdoor1/126.JPG,char_data/2/126.JPG_11.jpg,297,480,640,11,504,515,256,283,True,4
2,40,kaist_dataset/Korean/Digital_Camera/outdoor1/127.JPG,char_data/2/127.JPG_4.jpg,1040,480,640,26,241,267,270,310,True,4
2,43,kaist_dataset/Korean/Digital_Camera/outdoor1/127.JPG,char_data/2/127.JPG_5.jpg,1247,480,640,29,267,296,269,312,True,4
2,36,kaist_dataset/Korean/Digital_Camera/outdoor1/54.JPG,char_data/2/54.JPG_2.jpg,936,523,767,26,576,602,368,404,True,4
2,65,kaist_dataset/Korean/Digital_Camera/outdoor2/2007-12-08-day-101.jpg,char_data/2/2007-12-08-day-101.jpg_4.jpg,2210,1200,1600,34,770,804,638,703,True,4
2,62,kaist_dataset/Korean/Digital_Camera/outdoor2/2007-12-08-day-101.jpg,char_data/2/2007-12-08-day-101.jpg_5.jpg,2232,1200,1600,36,905,941,643,705,True,4
2,71,kaist_dataset/Korean/Digital_Camera/outdoor2/2007-12-09-day-exterior-009.jpg,char_data/2/2007-12-09-day-exterior-009.jpg_2.jpg,2911,1200,1600,41,778,819,673,744,True,4
2,54,kaist_dataset/Korean/Digital_Camera/outdoor2/2007-12-09-day-exterior-033.jpg,char_data/2/2007-12-09-day-exterior-033.jpg_2.jpg,4158,1200,1600,77,590,667,731,785,True,4
2,47,kaist_dataset/Korean/Digital_Camera/outdoor2/2007-12-09-day-exterior-035.jpg,char_data/2/2007-12-09-day-exterior-035.jpg_4.jpg,1598,1200,1600,34,476,510,709,756,True,4
2,51,kaist_dataset/Korean/Digital_Camera/outdoor2/2007-12-09-day-exterior-035.jpg,char_data/2/2007-12-09-day-exterior-035.jpg_5.jpg,1785,1200,1600,35,808,843,721,772,True,4
2,25,kaist_dataset/Korean/Digital_Camera/outdoor2/DSC02299.JPG,char_data/2/DSC02299.JPG_4.jpg,350,480,640,14,581,595,212,237,True,4
2,28,kaist_dataset/Korean/Digital_Camera/outdoor2/DSC02299.JPG,char_data/2/DSC02299.JPG_5.jpg,364,480,640,13,595,608,210,238,True,4
2,27,kaist_dataset/Korean/Digital_Camera/outdoor2/DSC02304.JPG,char_data/2/DSC02304.JPG_4.jpg,729,480,640,27,251,278,264,291,True,4
2,28,kaist_dataset/Korean/Digital_Camera/outdoor2/DSC02304.JPG,char_data/2/DSC02304.JPG_5.jpg,896,480,640,32,275,307,265,293,True,4
2,48,kaist_dataset/Korean/Digital_Camera/outdoor2/DSC02305.JPG,char_data/2/DSC02305.JPG_6.jpg,2160,480,640,45,365,410,252,300,True,4
2,54,kaist_dataset/Korean/Digital_Camera/outdoor2/DSC02305.JPG,char_data/2/DSC02305.JPG_7.jpg,2268,480,640,42,522,564,250,304,True,4
2,55,kaist_dataset/Korean/Digital_Camera/outdoor2/DSC02305.JPG,char_data/2/DSC02305.JPG_8.jpg,1760,480,640,32,606,638,249,304,True,4
2,34,kaist_dataset/Korean/Digital_Camera/outdoor2/DSC02308.JPG,char_data/2/DSC02308.JPG_2.jpg,952,480,640,28,258,286,239,273,True,4
2,32,kaist_dataset/Korean/Digital_Camera/outdoor2/DSC02310.JPG,char_data/2/DSC02310.JPG_6.jpg,1024,480,640,32,347,379,211,243,True,4
2,36,kaist_dataset/Korean/Digital_Camera/outdoor2/DSC02310.JPG,char_data/2/DSC02310.JPG_7.jpg,1404,480,640,39,409,448,209,245,True,4
2,30,kaist_dataset/Korean/Digital_Camera/outdoor2/DSC02310.JPG,char_data/2/DSC02310.JPG_8.jpg,840,480,640,28,231,259,209,239,True,4
2,35,kaist_dataset/Korean/Digital_Camera/outdoor2/DSC02311.JPG,char_data/2/DSC02311.JPG_4.jpg,770,480,640,22,470,492,252,287,True,4
2,37,kaist_dataset/Korean/Digital_Camera/outdoor2/DSC02311.JPG,char_data/2/DSC02311.JPG_5.jpg,851,480,640,23,557,580,251,288,True,4
2,22,kaist_dataset/Korean/Digital_Camera/outdoor2/DSC02314.JPG,char_data/2/DSC02314.JPG_6.jpg,286,480,640,13,344,357,203,225,True,4
2,24,kaist_dataset/Korean/Digital_Camera/outdoor2/DSC02314.JPG,char_data/2/DSC02314.JPG_7.jpg,336,480,640,14,357,371,204,228,True,4
2,21,kaist_dataset/Korean/Digital_Camera/outdoor2/DSC02314.JPG,char_data/2/DSC02314.JPG_8.jpg,273,480,640,13,384,397,205,226,True,4
2,31,kaist_dataset/Korean/Digital_Camera/outdoor2/DSC02321.JPG,char_data/2/DSC02321.JPG_4.jpg,713,480,640,23,208,231,377,408,True,4
2,35,kaist_dataset/Korean/Digital_Camera/outdoor2/DSC02321.JPG,char_data/2/DSC02321.JPG_5.jpg,735,480,640,21,233,254,377,412,True,4
2,24,kaist_dataset/Korean/Digital_Camera/outdoor2/DSC02326.JPG,char_data/2/DSC02326.JPG_6.jpg,336,480,640,14,383,397,339,363,True,4
2,25,kaist_dataset/Korean/Digital_Camera/outdoor2/DSC02326.JPG,char_data/2/DSC02326.JPG_7.jpg,350,480,640,14,399,413,338,363,True,4
2,32,kaist_dataset/Korean/Digital_Camera/outdoor2/DSC02326.JPG,char_data/2/DSC02326.JPG_8.jpg,608,480,640,19,39,58,325,357,True,4
2,33,kaist_dataset/Korean/Digital_Camera/outdoor2/DSC02327.JPG,char_data/2/DSC02327.JPG_2.jpg,957,480,640,29,183,212,357,390,True,4
2,35,kaist_dataset/Korean/Digital_Camera/outdoor2/DSC02371.JPG,char_data/2/DSC02371.JPG_4.jpg,700,480,640,20,138,158,241,276,True,4
2,37,kaist_dataset/Korean/Digital_Camera/outdoor2/DSC02371.JPG,char_data/2/DSC02371.JPG_5.jpg,703,480,640,19,157,176,240,277,True,4
2,26,kaist_dataset/Korean/Digital_Camera/outdoor2/DSC02372.JPG,char_data/2/DSC02372.JPG_4.jpg,390,480,640,15,475,490,294,320,True,4
2,28,kaist_dataset/Korean/Digital_Camera/outdoor2/DSC02372.JPG,char_data/2/DSC02372.JPG_5.jpg,336,480,640,12,490,502,289,317,True,4
2,23,kaist_dataset/Korean/Digital_Camera/outdoor2/DSC02373.JPG,char_data/2/DSC02373.JPG_4.jpg,322,480,640,14,356,370,337,360,True,4
2,24,kaist_dataset/Korean/Digital_Camera/outdoor2/DSC02373.JPG,char_data/2/DSC02373.JPG_5.jpg,384,480,640,16,370,386,335,359,True,4
2,39,kaist_dataset/Korean/Digital_Camera/outdoor2/DSC02380.JPG,char_data/2/DSC02380.JPG_2.jpg,507,480,640,13,361,374,233,272,True,4
2,34,kaist_dataset/Korean/Digital_Camera/outdoor2/DSC02381.JPG,char_data/2/DSC02381.JPG_4.jpg,884,480,640,26,228,254,316,350,True,4
2,42,kaist_dataset/Korean/Digital_Camera/outdoor2/DSC02381.JPG,char_data/2/DSC02381.JPG_5.jpg,1008,480,640,24,315,339,317,359,True,4
2,31,kaist_dataset/Korean/Digital_Camera/outdoor2/DSC02383.JPG,char_data/2/DSC02383.JPG_4.jpg,372,480,640,12,48,60,297,328,True,4
2,33,kaist_dataset/Korean/Digital_Camera/outdoor2/DSC02383.JPG,char_data/2/DSC02383.JPG_5.jpg,396,480,640,12,208,220,290,323,True,4
2,31,kaist_dataset/Korean/Digital_Camera/outdoor2/DSC02386.JPG,char_data/2/DSC02386.JPG_2.jpg,589,480,640,19,447,466,258,289,True,4
2,31,kaist_dataset/Korean/Digital_Camera/outdoor2/DSC02393.JPG,char_data/2/DSC02393.JPG_4.jpg,527,480,640,17,476,493,309,340,True,4
2,34,kaist_dataset/Korean/Digital_Camera/outdoor2/DSC02393.JPG,char_data/2/DSC02393.JPG_5.jpg,680,480,640,20,567,587,305,339,True,4
2,46,kaist_dataset/Korean/Digital_Camera/outdoor2/DSC02414.JPG,char_data/2/DSC02414.JPG_2.jpg,1564,480,640,34,250,284,238,284,True,4
2,27,kaist_dataset/Korean/Digital_Camera/outdoor2/DSC02424.JPG,char_data/2/DSC02424.JPG_2.jpg,378,480,640,14,471,485,244,271,True,4
2,33,kaist_dataset/Korean/Digital_Camera/outdoor2/DSC02426.JPG,char_data/2/DSC02426.JPG_4.jpg,891,480,640,27,388,415,221,254,True,4
2,34,kaist_dataset/Korean/Digital_Camera/outdoor2/DSC02426.JPG,char_data/2/DSC02426.JPG_5.jpg,850,480,640,25,466,491,217,251,True,4
2,26,kaist_dataset/Korean/Digital_Camera/outdoor2/DSC02435.JPG,char_data/2/DSC02435.JPG_2.jpg,338,480,640,13,488,501,246,272,True,4
2,31,kaist_dataset/Korean/Digital_Camera/outdoor2/DSC02441.JPG,char_data/2/DSC02441.JPG_2.jpg,496,480,640,16,443,459,199,230,True,4
2,81,kaist_dataset/Korean/Digital_Camera/outdoor2/DSC02451.JPG,char_data/2/DSC02451.JPG_4.jpg,4941,480,640,61,117,178,329,410,True,4
2,81,kaist_dataset/Korean/Digital_Camera/outdoor2/DSC02451.JPG,char_data/2/DSC02451.JPG_5.jpg,4617,480,640,57,177,234,326,407,True,4
2,31,kaist_dataset/Korean/Digital_Camera/outdoor2/DSC02467.JPG,char_data/2/DSC02467.JPG_4.jpg,651,480,640,21,339,360,258,289,True,4
2,37,kaist_dataset/Korean/Digital_Camera/outdoor2/DSC02467.JPG,char_data/2/DSC02467.JPG_5.jpg,814,480,640,22,360,382,256,293,True,4
2,31,kaist_dataset/Korean/Digital_Camera/outdoor2/DSC02470.JPG,char_data/2/DSC02470.JPG_4.jpg,682,480,640,22,221,243,182,213,True,4
2,65,kaist_dataset/Korean/Digital_Camera/outdoor2/DSC02470.JPG,char_data/2/DSC02470.JPG_5.jpg,2210,480,640,34,327,361,373,438,True,4
2,33,kaist_dataset/Korean/Digital_Camera/outdoor2/DSC02476.JPG,char_data/2/DSC02476.JPG_2.jpg,825,480,640,25,279,304,276,309,True,4
2,34,kaist_dataset/Korean/Digital_Camera/outdoor2/DSC02488.JPG,char_data/2/DSC02488.JPG_2.jpg,578,480,640,17,529,546,372,406,True,4
2,55,kaist_dataset/Korean/Digital_Camera/outdoor2/DSC02515.JPG,char_data/2/DSC02515.JPG_4.jpg,2145,480,640,39,455,494,335,390,True,4
2,49,kaist_dataset/Korean/Digital_Camera/outdoor2/DSC02515.JPG,char_data/2/DSC02515.JPG_5.jpg,1862,480,640,38,495,533,340,389,True,4
2,37,kaist_dataset/Korean/Digital_Camera/outdoor2/DSC02523.JPG,char_data/2/DSC02523.JPG_2.jpg,555,480,640,15,428,443,338,375,True,4
2,44,kaist_dataset/Korean/Digital_Camera/outdoor3/DSC02528.JPG,char_data/2/DSC02528.JPG_2.jpg,1496,480,640,34,241,275,413,457,True,4
2,54,kaist_dataset/Korean/Digital_Camera/outdoor3/DSC02546.JPG,char_data/2/DSC02546.JPG_6.jpg,2430,480,640,45,429,474,356,410,True,4
2,33,kaist_dataset/Korean/Digital_Camera/outdoor3/DSC02546.JPG,char_data/2/DSC02546.JPG_7.jpg,363,480,640,11,194,205,427,460,True,4
2,32,kaist_dataset/Korean/Digital_Camera/outdoor3/DSC02546.JPG,char_data/2/DSC02546.JPG_8.jpg,512,480,640,16,255,271,427,459,True,4
2,36,kaist_dataset/Korean/Digital_Camera/outdoor3/DSC02561.JPG,char_data/2/DSC02561.JPG_2.jpg,864,480,640,24,346,370,355,391,True,4
2,39,kaist_dataset/Korean/Digital_Camera/outdoor3/DSC02598.JPG,char_data/2/DSC02598.JPG_5.jpg,741,480,640,19,541,560,414,453,True,4
2,40,kaist_dataset/Korean/Digital_Camera/outdoor3/DSC02686.JPG,char_data/2/DSC02686.JPG_2.jpg,1000,480,640,25,442,467,225,265,True,4
2,53,kaist_dataset/Korean/Digital_Camera/outdoor3/DSC02697.JPG,char_data/2/DSC02697.JPG_2.jpg,1908,480,640,36,387,423,376,429,True,4
2,26,kaist_dataset/Korean/Digital_Camera/outdoor3/DSC02891.JPG,char_data/2/DSC02891.JPG_2.jpg,312,480,640,12,562,574,300,326,True,4
2,35,kaist_dataset/Korean/Digital_Camera/outdoor3/DSC02899.JPG,char_data/2/DSC02899.JPG_2.jpg,1190,480,640,34,518,552,230,265,True,4
2,35,kaist_dataset/Korean/Digital_Camera/outdoor3/DSC02939.JPG,char_data/2/DSC02939.JPG_4.jpg,805,480,640,23,287,310,364,399,True,4
2,41,kaist_dataset/Korean/Digital_Camera/outdoor3/DSC02939.JPG,char_data/2/DSC02939.JPG_5.jpg,1025,480,640,25,378,403,366,407,True,4
2,44,kaist_dataset/Korean/Digital_Camera/outdoor3/DSC02994.JPG,char_data/2/DSC02994.JPG_2.jpg,968,480,640,22,76,98,66,110,True,4
2,35,kaist_dataset/Korean/Digital_Camera/outdoor3/DSC02999.JPG,char_data/2/DSC02999.JPG_4.jpg,595,480,640,17,226,243,431,466,True,4
2,36,kaist_dataset/Korean/Digital_Camera/outdoor3/DSC02999.JPG,char_data/2/DSC02999.JPG_5.jpg,612,480,640,17,299,316,431,467,True,4
2,38,kaist_dataset/Korean/Digital_Camera/outdoor3/DSC03219.JPG,char_data/2/DSC03219.JPG_2.jpg,1102,480,640,29,468,497,407,445,True,4
2,47,kaist_dataset/Korean/Digital_Camera/outdoor3/DSC03237.JPG,char_data/2/DSC03237.JPG_4.jpg,1363,480,640,29,350,379,397,444,True,4
2,50,kaist_dataset/Korean/Digital_Camera/outdoor3/DSC03237.JPG,char_data/2/DSC03237.JPG_5.jpg,1650,480,640,33,379,412,396,446,True,4
2,34,kaist_dataset/Korean/Digital_Camera/outdoor4/DSC03293.JPG,char_data/2/DSC03293.JPG_2.jpg,578,480,640,17,257,274,289,323,True,4
2,31,kaist_dataset/Korean/Digital_Camera/outdoor4/DSC03295.JPG,char_data/2/DSC03295.JPG_4.jpg,682,480,640,22,260,282,400,431,True,4
2,31,kaist_dataset/Korean/Digital_Camera/outdoor4/DSC03295.JPG,char_data/2/DSC03295.JPG_5.jpg,558,480,640,18,293,311,402,433,True,4
2,55,kaist_dataset/Korean/Digital_Camera/outdoor4/DSC03313.JPG,char_data/2/DSC03313.JPG_6.jpg,1870,480,640,34,338,372,316,371,True,4
2,37,kaist_dataset/Korean/Digital_Camera/outdoor4/DSC03313.JPG,char_data/2/DSC03313.JPG_7.jpg,999,480,640,27,469,496,74,111,True,4
2,38,kaist_dataset/Korean/Digital_Camera/outdoor4/DSC03313.JPG,char_data/2/DSC03313.JPG_8.jpg,836,480,640,22,514,536,72,110,True,4
2,49,kaist_dataset/Korean/Digital_Camera/outdoor4/DSC03319.JPG,char_data/2/DSC03319.JPG_6.jpg,1617,480,640,33,244,277,389,438,True,4
2,48,kaist_dataset/Korean/Digital_Camera/outdoor4/DSC03319.JPG,char_data/2/DSC03319.JPG_7.jpg,1152,480,640,24,148,172,83,131,True,4
2,44,kaist_dataset/Korean/Digital_Camera/outdoor4/DSC03319.JPG,char_data/2/DSC03319.JPG_8.jpg,1276,480,640,29,190,219,83,127,True,4
2,83,kaist_dataset/Korean/Digital_Camera/outdoor4/DSC03320.JPG,char_data/2/DSC03320.JPG_2.jpg,5063,480,640,61,169,230,379,462,True,4
2,41,kaist_dataset/Korean/Digital_Camera/outdoor4/DSC03416.JPG,char_data/2/DSC03416.JPG_2.jpg,1107,480,640,27,44,71,307,348,True,4
2,90,kaist_dataset/Korean/Digital_Camera/outdoor4/DSC03452.JPG,char_data/2/DSC03452.JPG_2.jpg,3330,480,640,37,325,362,276,366,True,4
2,64,kaist_dataset/Korean/Digital_Camera/outdoor4/DSC03537.JPG,char_data/2/DSC03537.JPG_4.jpg,2688,480,640,42,203,245,132,196,True,4
2,61,kaist_dataset/Korean/Digital_Camera/outdoor4/DSC03537.JPG,char_data/2/DSC03537.JPG_5.jpg,2379,480,640,39,465,504,125,186,True,4
2,74,kaist_dataset/Korean/Digital_Camera/outdoor4/DSC03542.JPG,char_data/2/DSC03542.JPG_2.jpg,2738,480,640,37,120,157,258,332,True,4
2,40,kaist_dataset/Korean/Digital_Camera/outdoor4/DSC03545.JPG,char_data/2/DSC03545.JPG_2.jpg,720,480,640,18,130,148,40,80,True,4
2,80,kaist_dataset/Korean/Digital_Camera/outdoor4/DSC03553.JPG,char_data/2/DSC03553.JPG_2.jpg,5920,480,640,74,227,301,180,260,True,4
2,71,kaist_dataset/Korean/Digital_Camera/outdoor4/DSC03555.JPG,char_data/2/DSC03555.JPG_4.jpg,2840,480,640,40,209,249,354,425,True,4
2,32,kaist_dataset/Korean/Digital_Camera/outdoor4/DSC03555.JPG,char_data/2/DSC03555.JPG_5.jpg,960,480,640,30,461,491,428,460,True,4
2,96,kaist_dataset/Korean/Digital_Camera/outdoor4/DSC03566.JPG,char_data/2/DSC03566.JPG_8.jpg,5664,480,640,59,449,508,144,240,True,4
2,93,kaist_dataset/Korean/Digital_Camera/outdoor4/DSC03566.JPG,char_data/2/DSC03566.JPG_9.jpg,5115,480,640,55,510,565,144,237,True,4
2,42,kaist_dataset/Korean/Digital_Camera/outdoor4/DSC03566.JPG,char_data/2/DSC03566.JPG_10.jpg,2814,480,640,67,421,488,88,130,True,4
2,38,kaist_dataset/Korean/Digital_Camera/outdoor4/DSC03566.JPG,char_data/2/DSC03566.JPG_11.jpg,2736,480,640,72,486,558,89,127,True,4
2,54,kaist_dataset/Korean/Digital_Camera/outdoor4/DSC03580.JPG,char_data/2/DSC03580.JPG_2.jpg,1458,480,640,27,276,303,208,262,True,4
2,57,kaist_dataset/Korean/Digital_Camera/outdoor4/DSC03592.JPG,char_data/2/DSC03592.JPG_14.jpg,2223,480,640,39,24,63,55,112,True,4
2,51,kaist_dataset/Korean/Digital_Camera/outdoor4/DSC03592.JPG,char_data/2/DSC03592.JPG_15.jpg,1377,480,640,27,594,621,67,118,True,4
2,51,kaist_dataset/Korean/Digital_Camera/outdoor4/DSC03592.JPG,char_data/2/DSC03592.JPG_16.jpg,1683,480,640,33,480,513,63,114,True,4
2,51,kaist_dataset/Korean/Digital_Camera/outdoor4/DSC03592.JPG,char_data/2/DSC03592.JPG_17.jpg,1734,480,640,34,365,399,60,111,True,4
2,58,kaist_dataset/Korean/Digital_Camera/outdoor4/DSC03592.JPG,char_data/2/DSC03592.JPG_18.jpg,1682,480,640,29,257,286,53,111,True,4
2,55,kaist_dataset/Korean/Digital_Camera/outdoor4/DSC03592.JPG,char_data/2/DSC03592.JPG_19.jpg,1485,480,640,27,318,345,57,112,True,4
2,51,kaist_dataset/Korean/Digital_Camera/outdoor4/DSC03592.JPG,char_data/2/DSC03592.JPG_20.jpg,1938,480,640,38,146,184,56,107,True,4
2,55,kaist_dataset/Korean/Digital_Camera/outdoor4/DSC03598.JPG,char_data/2/DSC03598.JPG_2.jpg,1980,480,640,36,236,272,200,255,True,4
2,63,kaist_dataset/Korean/Digital_Camera/outdoor4/DSC03599.JPG,char_data/2/DSC03599.JPG_2.jpg,2331,480,640,37,266,303,234,297,True,4
2,44,kaist_dataset/Korean/Digital_Camera/outdoor4/DSC03601.JPG,char_data/2/DSC03601.JPG_2.jpg,1144,480,640,26,294,320,298,342,True,4
2,50,kaist_dataset/Korean/Digital_Camera/outdoor4/DSC03607.JPG,char_data/2/DSC03607.JPG_2.jpg,1600,480,640,32,69,101,162,212,True,4
2,78,kaist_dataset/Korean/Digital_Camera/outdoor4/DSC03608.JPG,char_data/2/DSC03608.JPG_2.jpg,3900,480,640,50,506,556,296,374,True,4
2,48,kaist_dataset/Korean/Digital_Camera/outdoor4/DSC03614.JPG,char_data/2/DSC03614.JPG_4.jpg,1008,480,640,21,362,383,392,440,True,4
2,36,kaist_dataset/Korean/Digital_Camera/outdoor4/DSC03614.JPG,char_data/2/DSC03614.JPG_5.jpg,648,480,640,18,538,556,384,420,True,4
2,42,kaist_dataset/Korean/Digital_Camera/outdoor5/DSC03626.JPG,char_data/2/DSC03626.JPG_6.jpg,1008,480,640,24,264,288,293,335,True,4
2,41,kaist_dataset/Korean/Digital_Camera/outdoor5/DSC03626.JPG,char_data/2/DSC03626.JPG_7.jpg,1435,480,640,35,426,461,298,339,True,4
2,49,kaist_dataset/Korean/Digital_Camera/outdoor5/DSC03626.JPG,char_data/2/DSC03626.JPG_8.jpg,1421,480,640,29,558,587,295,344,True,4
2,31,kaist_dataset/Korean/Digital_Camera/outdoor5/DSC03627.JPG,char_data/2/DSC03627.JPG_2.jpg,992,480,640,32,266,298,226,257,True,4
2,38,kaist_dataset/Korean/Digital_Camera/outdoor5/DSC03641.JPG,char_data/2/DSC03641.JPG_2.jpg,722,480,640,19,400,419,419,457,True,4
2,75,kaist_dataset/Korean/Digital_Camera/outdoor5/DSC03646.JPG,char_data/2/DSC03646.JPG_2.jpg,2925,480,640,39,478,517,194,269,True,4
2,38,kaist_dataset/Korean/Digital_Camera/outdoor5/DSC03671.JPG,char_data/2/DSC03671.JPG_2.jpg,684,480,640,18,212,230,408,446,True,4
2,39,kaist_dataset/Korean/Digital_Camera/outdoor5/DSC03685.JPG,char_data/2/DSC03685.JPG_8.jpg,897,480,640,23,133,156,186,225,True,4
2,40,kaist_dataset/Korean/Digital_Camera/outdoor5/DSC03685.JPG,char_data/2/DSC03685.JPG_9.jpg,880,480,640,22,193,215,185,225,True,4
2,31,kaist_dataset/Korean/Digital_Camera/outdoor5/DSC03685.JPG,char_data/2/DSC03685.JPG_10.jpg,620,480,640,20,385,405,191,222,True,4
2,37,kaist_dataset/Korean/Digital_Camera/outdoor5/DSC03685.JPG,char_data/2/DSC03685.JPG_11.jpg,703,480,640,19,442,461,187,224,True,4
2,47,kaist_dataset/Korean/Digital_Camera/outdoor5/DSC03709.JPG,char_data/2/DSC03709.JPG_4.jpg,658,480,640,14,516,530,359,406,True,4
2,34,kaist_dataset/Korean/Digital_Camera/outdoor5/DSC03709.JPG,char_data/2/DSC03709.JPG_5.jpg,680,480,640,20,575,595,369,403,True,4
2,33,kaist_dataset/Korean/Digital_Camera/outdoor5/DSC03736.JPG,char_data/2/DSC03736.JPG_2.jpg,495,480,640,15,326,341,405,438,True,4
2,42,kaist_dataset/Korean/Digital_Camera/outdoor5/DSC03740.JPG,char_data/2/DSC03740.JPG_2.jpg,1008,480,640,24,319,343,287,329,True,4
2,28,kaist_dataset/Korean/Digital_Camera/outdoor5/DSC03744.JPG,char_data/2/DSC03744.JPG_2.jpg,756,480,640,27,383,410,303,331,True,4
2,35,kaist_dataset/Korean/Digital_Camera/outdoor5/DSC03768.JPG,char_data/2/DSC03768.JPG_4.jpg,805,480,640,23,547,570,240,275,True,4
2,39,kaist_dataset/Korean/Digital_Camera/outdoor5/DSC03768.JPG,char_data/2/DSC03768.JPG_5.jpg,897,480,640,23,570,593,241,280,True,4
2,40,kaist_dataset/Korean/Digital_Camera/outdoor5/DSC03770.JPG,char_data/2/DSC03770.JPG_4.jpg,1000,480,640,25,570,595,420,460,True,4
2,36,kaist_dataset/Korean/Digital_Camera/outdoor5/DSC03770.JPG,char_data/2/DSC03770.JPG_5.jpg,720,480,640,20,596,616,424,460,True,4
2,21,kaist_dataset/Korean/Digital_Camera/outdoor5/DSC03776.JPG,char_data/2/DSC03776.JPG_2.jpg,189,480,640,9,512,521,438,459,True,4
2,32,kaist_dataset/Korean/Digital_Camera/outdoor5/DSC03779.JPG,char_data/2/DSC03779.JPG_2.jpg,736,480,640,23,578,601,244,276,True,4
2,41,kaist_dataset/Korean/Digital_Camera/outdoor5/DSC03789.JPG,char_data/2/DSC03789.JPG_4.jpg,902,480,640,22,268,290,169,210,True,4
2,37,kaist_dataset/Korean/Digital_Camera/outdoor5/DSC03789.JPG,char_data/2/DSC03789.JPG_5.jpg,629,480,640,17,270,287,212,249,True,4
2,84,kaist_dataset/Korean/Digital_Camera/outdoor5/DSC03790.JPG,char_data/2/DSC03790.JPG_2.jpg,4872,480,640,58,439,497,143,227,True,4
2,39,kaist_dataset/Korean/Digital_Camera/outdoor5/DSC03794.JPG,char_data/2/DSC03794.JPG_2.jpg,819,480,640,21,424,445,360,399,True,4
2,35,kaist_dataset/Korean/Digital_Camera/outdoor5/DSC03834.JPG,char_data/2/DSC03834.JPG_2.jpg,1015,480,640,29,154,183,305,340,True,4
2,49,kaist_dataset/Korean/Digital_Camera/outdoor5/DSC03838.JPG,char_data/2/DSC03838.JPG_2.jpg,1323,480,640,27,295,322,196,245,True,4
2,85,kaist_dataset/Korean/Digital_Camera/outdoor5/DSC03864.JPG,char_data/2/DSC03864.JPG_4.jpg,4080,480,640,48,218,266,162,247,True,4
2,91,kaist_dataset/Korean/Digital_Camera/outdoor5/DSC03864.JPG,char_data/2/DSC03864.JPG_5.jpg,4459,480,640,49,434,483,165,256,True,4
2,47,kaist_dataset/Korean/Digital_Camera/outdoor5/DSC03970.JPG,char_data/2/DSC03970.JPG_4.jpg,1551,480,640,33,133,166,93,140,True,4
2,44,kaist_dataset/Korean/Digital_Camera/outdoor5/DSC03970.JPG,char_data/2/DSC03970.JPG_5.jpg,1320,480,640,30,238,268,94,138,True,4
2,36,kaist_dataset/Korean/Digital_Camera/outdoor5/DSC03996.JPG,char_data/2/DSC03996.JPG_4.jpg,1080,480,640,30,255,285,286,322,True,4
2,35,kaist_dataset/Korean/Digital_Camera/outdoor5/DSC03996.JPG,char_data/2/DSC03996.JPG_5.jpg,1015,480,640,29,345,374,281,316,True,4
2,30,kaist_dataset/Korean/Digital_Camera/outdoor5/DSC04027.JPG,char_data/2/DSC04027.JPG_6.jpg,480,480,640,16,193,209,389,419,True,4
2,40,kaist_dataset/Korean/Digital_Camera/outdoor5/DSC04027.JPG,char_data/2/DSC04027.JPG_7.jpg,480,480,640,12,266,278,381,421,True,4
2,40,kaist_dataset/Korean/Digital_Camera/outdoor5/DSC04027.JPG,char_data/2/DSC04027.JPG_8.jpg,520,480,640,13,478,491,380,420,True,4
2,36,kaist_dataset/Korean/Digital_Camera/outdoor5/DSC04040.JPG,char_data/2/DSC04040.JPG_2.jpg,1260,480,640,35,475,510,342,378,True,4
2,31,kaist_dataset/Korean/Digital_Camera/outdoor6/DSC04041.JPG,char_data/2/DSC04041.JPG_2.jpg,527,480,640,17,514,531,142,173,True,4
2,28,kaist_dataset/Korean/Digital_Camera/outdoor6/DSC04046.JPG,char_data/2/DSC04046.JPG_6.jpg,476,480,640,17,300,317,262,290,True,4
2,27,kaist_dataset/Korean/Digital_Camera/outdoor6/DSC04046.JPG,char_data/2/DSC04046.JPG_7.jpg,351,480,640,13,529,542,264,291,True,4
2,30,kaist_dataset/Korean/Digital_Camera/outdoor6/DSC04046.JPG,char_data/2/DSC04046.JPG_8.jpg,570,480,640,19,557,576,262,292,True,4
2,67,kaist_dataset/Korean/Digital_Camera/outdoor6/DSC04073.JPG,char_data/2/DSC04073.JPG_2.jpg,1876,480,640,28,395,423,30,97,True,4
2,82,kaist_dataset/Korean/Digital_Camera/outdoor6/DSC04096.JPG,char_data/2/DSC04096.JPG_2.jpg,3854,480,640,47,374,421,225,307,True,4
2,36,kaist_dataset/Korean/Digital_Camera/outdoor6/DSC04099.JPG,char_data/2/DSC04099.JPG_2.jpg,972,480,640,27,481,508,413,449,True,4
2,53,kaist_dataset/Korean/Digital_Camera/outdoor6/DSC04100.JPG,char_data/2/DSC04100.JPG_2.jpg,1113,480,640,21,480,501,57,110,True,4
2,36,kaist_dataset/Korean/Digital_Camera/outdoor6/DSC04112.JPG,char_data/2/DSC04112.JPG_4.jpg,540,480,640,15,320,335,270,306,True,4
2,36,kaist_dataset/Korean/Digital_Camera/outdoor6/DSC04112.JPG,char_data/2/DSC04112.JPG_5.jpg,504,480,640,14,442,456,273,309,True,4
2,30,kaist_dataset/Korean/Digital_Camera/outdoor6/DSC04113.JPG,char_data/2/DSC04113.JPG_2.jpg,930,480,640,31,206,237,443,473,True,4
2,48,kaist_dataset/Korean/Digital_Camera/outdoor6/DSC04118.JPG,char_data/2/DSC04118.JPG_4.jpg,1440,480,640,30,398,428,256,304,True,4
2,51,kaist_dataset/Korean/Digital_Camera/outdoor6/DSC04118.JPG,char_data/2/DSC04118.JPG_5.jpg,1581,480,640,31,454,485,255,306,True,4
2,37,kaist_dataset/Korean/Digital_Camera/outdoor6/DSC04121.JPG,char_data/2/DSC04121.JPG_4.jpg,1036,480,640,28,262,290,181,218,True,4
2,38,kaist_dataset/Korean/Digital_Camera/outdoor6/DSC04121.JPG,char_data/2/DSC04121.JPG_5.jpg,1064,480,640,28,356,384,180,218,True,4
2,26,kaist_dataset/Korean/Digital_Camera/outdoor6/DSC04132.JPG,char_data/2/DSC04132.JPG_2.jpg,468,480,640,18,314,332,156,182,True,4
2,32,kaist_dataset/Korean/Digital_Camera/outdoor6/DSC04138.JPG,char_data/2/DSC04138.JPG_2.jpg,864,480,640,27,409,436,153,185,True,4
2,52,kaist_dataset/Korean/Digital_Camera/outdoor6/DSC04296.JPG,char_data/2/DSC04296.JPG_4.jpg,936,480,640,18,286,304,316,368,True,4
2,56,kaist_dataset/Korean/Digital_Camera/outdoor6/DSC04296.JPG,char_data/2/DSC04296.JPG_5.jpg,1008,480,640,18,326,344,310,366,True,4
2,73,kaist_dataset/Korean/Digital_Camera/outdoor6/DSC04301.JPG,char_data/2/DSC04301.JPG_2.jpg,4964,480,640,68,124,192,362,435,True,4
2,55,kaist_dataset/Korean/Digital_Camera/outdoor6/DSC04308.JPG,char_data/2/DSC04308.JPG_6.jpg,1540,480,640,28,219,247,384,439,True,4
2,55,kaist_dataset/Korean/Digital_Camera/outdoor6/DSC04308.JPG,char_data/2/DSC04308.JPG_7.jpg,1650,480,640,30,297,327,383,438,True,4
2,54,kaist_dataset/Korean/Digital_Camera/outdoor6/DSC04308.JPG,char_data/2/DSC04308.JPG_8.jpg,1458,480,640,27,326,353,384,438,True,4
2,52,kaist_dataset/Korean/Digital_Camera/outdoor6/DSC04332.JPG,char_data/2/DSC04332.JPG_2.jpg,2600,480,640,50,136,186,349,401,True,4
2,40,kaist_dataset/Korean/Digital_Camera/outdoor6/DSC04339.JPG,char_data/2/DSC04339.JPG_8.jpg,800,480,640,20,298,318,210,250,True,4
2,41,kaist_dataset/Korean/Digital_Camera/outdoor6/DSC04339.JPG,char_data/2/DSC04339.JPG_9.jpg,1025,480,640,25,316,341,208,249,True,4
2,40,kaist_dataset/Korean/Digital_Camera/outdoor6/DSC04339.JPG,char_data/2/DSC04339.JPG_10.jpg,920,480,640,23,375,398,207,247,True,4
2,45,kaist_dataset/Korean/Digital_Camera/outdoor6/DSC04339.JPG,char_data/2/DSC04339.JPG_11.jpg,1305,480,640,29,417,446,206,251,True,4
2,25,kaist_dataset/Korean/Digital_Camera/outdoor6/DSC04341.JPG,char_data/2/DSC04341.JPG_4.jpg,400,480,640,16,501,517,223,248,True,4
2,27,kaist_dataset/Korean/Digital_Camera/outdoor6/DSC04341.JPG,char_data/2/DSC04341.JPG_5.jpg,540,480,640,20,515,535,222,249,True,4
2,29,kaist_dataset/Korean/Digital_Camera/outdoor6/DSC04343.JPG,char_data/2/DSC04343.JPG_2.jpg,725,480,640,25,299,324,206,235,True,4
2,49,kaist_dataset/Korean/Digital_Camera/outdoor6/DSC04352.JPG,char_data/2/DSC04352.JPG_2.jpg,1372,480,640,28,509,537,280,329,True,4
2,75,kaist_dataset/Korean/Digital_Camera/outdoor6/DSC04359.JPG,char_data/2/DSC04359.JPG_2.jpg,3375,480,640,45,143,188,114,189,True,4
2,55,kaist_dataset/Korean/Digital_Camera/outdoor6/DSC04370.JPG,char_data/2/DSC04370.JPG_2.jpg,3135,480,640,57,170,227,318,373,True,4
2,44,kaist_dataset/Korean/Digital_Camera/outdoor6/DSC04400.JPG,char_data/2/DSC04400.JPG_4.jpg,1056,480,640,24,280,304,222,266,True,4
2,42,kaist_dataset/Korean/Digital_Camera/outdoor6/DSC04400.JPG,char_data/2/DSC04400.JPG_5.jpg,1134,480,640,27,274,301,398,440,True,4
2,158,kaist_dataset/Korean/Digital_Camera/outdoor7/DSC04470.JPG,char_data/2/DSC04470.JPG_2.jpg,13272,480,640,84,90,174,143,301,True,4
2,71,kaist_dataset/Korean/Digital_Camera/outdoor7/DSC04483.JPG,char_data/2/DSC04483.JPG_2.jpg,3550,480,640,50,45,95,361,432,True,4
2,135,kaist_dataset/Korean/Digital_Camera/outdoor7/P1010002.JPG,char_data/2/P1010002.JPG_2.jpg,18495,480,640,137,306,443,104,239,True,4
2,37,kaist_dataset/Korean/Digital_Camera/outdoor7/P1010004.JPG,char_data/2/P1010004.JPG_8.jpg,444,480,640,12,570,582,294,331,True,4
2,36,kaist_dataset/Korean/Digital_Camera/outdoor7/P1010004.JPG,char_data/2/P1010004.JPG_9.jpg,648,480,640,18,591,609,289,325,True,4
2,40,kaist_dataset/Korean/Digital_Camera/outdoor7/P1010009.JPG,char_data/2/P1010009.JPG_4.jpg,1240,480,640,31,411,442,267,307,True,4
2,50,kaist_dataset/Korean/Digital_Camera/outdoor7/P1010011.JPG,char_data/2/P1010011.JPG_6.jpg,2250,480,640,45,305,350,228,278,True,4
2,42,kaist_dataset/Korean/Digital_Camera/outdoor7/P1010012.JPG,char_data/2/P1010012.JPG_6.jpg,1176,480,640,28,250,278,220,262,True,4
2,40,kaist_dataset/Korean/Digital_Camera/outdoor7/P1010012.JPG,char_data/2/P1010012.JPG_7.jpg,1000,480,640,25,389,414,220,260,True,4
2,56,kaist_dataset/Korean/Digital_Camera/outdoor7/P1010023.JPG,char_data/2/P1010023.JPG_6.jpg,1736,480,640,31,167,198,291,347,True,4
2,52,kaist_dataset/Korean/Digital_Camera/outdoor7/P1010023.JPG,char_data/2/P1010023.JPG_7.jpg,1508,480,640,29,418,447,285,337,True,4
2,56,kaist_dataset/Korean/Digital_Camera/outdoor7/P1010023.JPG,char_data/2/P1010023.JPG_8.jpg,1456,480,640,26,570,596,281,337,True,4
2,43,kaist_dataset/Korean/Digital_Camera/outdoor7/P1010029.JPG,char_data/2/P1010029.JPG_2.jpg,1376,480,640,32,511,543,392,435,True,4
2,39,kaist_dataset/Korean/Digital_Camera/outdoor7/P1010035.JPG,char_data/2/P1010035.JPG_2.jpg,624,480,640,16,122,138,203,242,True,4
2,36,kaist_dataset/Korean/Digital_Camera/outdoor7/P1010054.JPG,char_data/2/P1010054.JPG_4.jpg,504,480,640,14,611,625,225,261,True,4
2,30,kaist_dataset/Korean/Digital_Camera/outdoor7/P1010054.JPG,char_data/2/P1010054.JPG_5.jpg,480,480,640,16,624,639,226,256,True,4
2,29,kaist_dataset/Korean/Digital_Camera/outdoor7/P1010055.JPG,char_data/2/P1010055.JPG_4.jpg,638,480,640,22,67,89,208,237,True,4
2,33,kaist_dataset/Korean/Digital_Camera/outdoor7/P1010055.JPG,char_data/2/P1010055.JPG_5.jpg,627,480,640,19,90,109,206,239,True,4
2,32,kaist_dataset/Korean/Digital_Camera/outdoor7/P1010056.JPG,char_data/2/P1010056.JPG_8.jpg,544,480,640,17,434,451,267,299,True,4
2,29,kaist_dataset/Korean/Digital_Camera/outdoor7/P1010056.JPG,char_data/2/P1010056.JPG_9.jpg,580,480,640,20,468,488,268,297,True,4
2,27,kaist_dataset/Korean/Digital_Camera/outdoor7/P1010056.JPG,char_data/2/P1010056.JPG_10.jpg,513,480,640,19,487,506,269,296,True,4
2,28,kaist_dataset/Korean/Digital_Camera/outdoor7/P1010056.JPG,char_data/2/P1010056.JPG_11.jpg,672,480,640,24,524,548,270,298,True,4
2,33,kaist_dataset/Korean/Digital_Camera/outdoor7/P1010057.JPG,char_data/2/P1010057.JPG_2.jpg,693,480,640,21,545,566,227,260,True,4
2,39,kaist_dataset/Korean/Digital_Camera/outdoor7/P1010067.JPG,char_data/2/P1010067.JPG_4.jpg,1209,480,640,31,202,233,314,353,True,4
2,40,kaist_dataset/Korean/Digital_Camera/outdoor7/P1010067.JPG,char_data/2/P1010067.JPG_5.jpg,1200,480,640,30,273,303,313,353,True,4
2,60,kaist_dataset/Korean/Digital_Camera/outdoor7/P1010068.JPG,char_data/2/P1010068.JPG_4.jpg,1860,480,640,31,326,357,273,333,True,4
2,68,kaist_dataset/Korean/Digital_Camera/outdoor7/P1010068.JPG,char_data/2/P1010068.JPG_5.jpg,2312,480,640,34,436,470,270,338,True,4
2,47,kaist_dataset/Korean/Digital_Camera/outdoor7/P1010069.JPG,char_data/2/P1010069.JPG_6.jpg,1175,480,640,25,293,318,311,358,True,4
2,48,kaist_dataset/Korean/Digital_Camera/outdoor7/P1010069.JPG,char_data/2/P1010069.JPG_7.jpg,1344,480,640,28,363,391,314,362,True,4
2,52,kaist_dataset/Korean/Digital_Camera/outdoor7/P1010077.JPG,char_data/2/P1010077.JPG_4.jpg,1560,480,640,30,262,292,247,299,True,4
2,51,kaist_dataset/Korean/Digital_Camera/outdoor7/P1010077.JPG,char_data/2/P1010077.JPG_5.jpg,1479,480,640,29,324,353,247,298,True,4
2,108,kaist_dataset/Korean/Digital_Camera/outdoor7/P1010079.JPG,char_data/2/P1010079.JPG_4.jpg,7020,480,640,65,222,287,338,446,True,4
2,96,kaist_dataset/Korean/Digital_Camera/outdoor7/P1010079.JPG,char_data/2/P1010079.JPG_5.jpg,6336,480,640,66,389,455,342,438,True,4
2,49,kaist_dataset/Korean/Digital_Camera/outdoor7/P1010085.JPG,char_data/2/P1010085.JPG_4.jpg,1568,480,640,32,283,315,268,317,True,4
2,74,kaist_dataset/Korean/Digital_Camera/outdoor7/P1010086.JPG,char_data/2/P1010086.JPG_2.jpg,4366,480,640,59,177,236,255,329,True,4
2,28,kaist_dataset/Korean/Digital_Camera/outdoor7/P1010091.JPG,char_data/2/P1010091.JPG_2.jpg,700,480,640,25,438,463,240,268,True,4
2,29,kaist_dataset/Korean/Digital_Camera/outdoor7/P1010107.JPG,char_data/2/P1010107.JPG_2.jpg,580,480,640,20,380,400,227,256,True,4
2,27,kaist_dataset/Korean/Digital_Camera/outdoor7/P1010112.JPG,char_data/2/P1010112.JPG_4.jpg,378,480,640,14,500,514,360,387,True,4
2,26,kaist_dataset/Korean/Digital_Camera/outdoor7/P1010112.JPG,char_data/2/P1010112.JPG_5.jpg,442,480,640,17,563,580,359,385,True,4
2,31,kaist_dataset/Korean/Digital_Camera/outdoor7/P1010136.JPG,char_data/2/P1010136.JPG_2.jpg,465,480,640,15,187,202,262,293,True,4
2,40,kaist_dataset/Korean/Digital_Camera/outdoor7/P1010138.JPG,char_data/2/P1010138.JPG_2.jpg,680,480,640,17,226,243,285,325,True,4
2,53,kaist_dataset/Korean/Digital_Camera/outdoor8/DSC02950.JPG,char_data/2/DSC02950.JPG_4.jpg,2438,480,640,46,449,495,302,355,True,4
2,60,kaist_dataset/Korean/Digital_Camera/outdoor8/DSC02950.JPG,char_data/2/DSC02950.JPG_5.jpg,3420,480,640,57,494,551,305,365,True,4
2,30,kaist_dataset/Korean/Digital_Camera/outdoor8/P090912069.jpg,char_data/2/P090912069.jpg_4.jpg,810,480,640,27,298,325,249,279,True,4
2,35,kaist_dataset/Korean/Digital_Camera/outdoor8/P090912069.jpg,char_data/2/P090912069.jpg_5.jpg,945,480,640,27,327,354,243,278,True,4
2,41,kaist_dataset/Korean/Digital_Camera/outdoor8/P1010142.JPG,char_data/2/P1010142.JPG_2.jpg,861,480,640,21,223,244,279,320,True,4
2,71,kaist_dataset/Korean/Digital_Camera/outdoor8/P1010160.JPG,char_data/2/P1010160.JPG_2.jpg,4331,480,640,61,378,439,223,294,True,4
2,36,kaist_dataset/Korean/Digital_Camera/outdoor8/P1010170.JPG,char_data/2/P1010170.JPG_2.jpg,828,480,640,23,377,400,276,312,True,4
2,53,kaist_dataset/Korean/Digital_Camera/outdoor8/P1010171.JPG,char_data/2/P1010171.JPG_2.jpg,1590,480,640,30,426,456,232,285,True,4
2,71,kaist_dataset/Korean/Digital_Camera/outdoor8/P1010172.JPG,char_data/2/P1010172.JPG_2.jpg,2982,480,640,42,237,279,227,298,True,4
2,31,kaist_dataset/Korean/Digital_Camera/outdoor8/P1010178.JPG,char_data/2/P1010178.JPG_8.jpg,589,480,640,19,351,370,391,422,True,4
2,33,kaist_dataset/Korean/Digital_Camera/outdoor8/P1010178.JPG,char_data/2/P1010178.JPG_9.jpg,528,480,640,16,372,388,390,423,True,4
2,34,kaist_dataset/Korean/Digital_Camera/outdoor8/P1010178.JPG,char_data/2/P1010178.JPG_10.jpg,748,480,640,22,406,428,393,427,True,4
2,32,kaist_dataset/Korean/Digital_Camera/outdoor8/P1010178.JPG,char_data/2/P1010178.JPG_11.jpg,736,480,640,23,345,368,307,339,True,4
2,69,kaist_dataset/Korean/Digital_Camera/outdoor8/P1010181.JPG,char_data/2/P1010181.JPG_4.jpg,2277,480,640,33,373,406,197,266,True,4
2,94,kaist_dataset/Korean/Digital_Camera/outdoor8/P1010181.JPG,char_data/2/P1010181.JPG_5.jpg,2820,480,640,30,383,413,293,387,True,4
2,36,kaist_dataset/Korean/Digital_Camera/outdoor8/P1011112.JPG,char_data/2/P1011112.JPG_6.jpg,576,480,640,16,376,392,215,251,True,4
2,35,kaist_dataset/Korean/Digital_Camera/outdoor8/P1011112.JPG,char_data/2/P1011112.JPG_7.jpg,595,480,640,17,575,592,223,258,True,4
2,34,kaist_dataset/Korean/Digital_Camera/outdoor8/P1011112.JPG,char_data/2/P1011112.JPG_8.jpg,442,480,640,13,610,623,231,265,True,4
2,52,"kaist_dataset/Korean/Mobile_Phone/(M,K)C-outdoor/P090912033.jpg",char_data/2/P090912033.jpg_4.jpg,1924,480,640,37,244,281,351,403,True,4
2,57,"kaist_dataset/Korean/Mobile_Phone/(M,K)C-outdoor/P090912033.jpg",char_data/2/P090912033.jpg_5.jpg,2280,480,640,40,398,438,355,412,True,4
2,43,"kaist_dataset/Korean/Mobile_Phone/(M,K)C-outdoor/P090912034.jpg",char_data/2/P090912034.jpg_2.jpg,1204,480,640,28,123,151,259,302,True,4
2,29,"kaist_dataset/Korean/Mobile_Phone/(M,K)C-outdoor/P090912042.jpg",char_data/2/P090912042.jpg_2.jpg,377,480,640,13,366,379,256,285,True,4
2,79,"kaist_dataset/Korean/Mobile_Phone/(M,K)E-bookCover/P090831047.jpg",char_data/2/P090831047.jpg_2.jpg,4108,480,640,52,7,59,144,223,True,4
2,162,"kaist_dataset/Korean/Mobile_Phone/(M,K)E-bookCover/P090831132.jpg",char_data/2/P090831132.jpg_2.jpg,23652,480,640,146,55,201,294,456,True,4
2,78,"kaist_dataset/Korean/Mobile_Phone/(M,K)E-bookCover/P090903085.jpg",char_data/2/P090903085.jpg_2.jpg,6318,480,640,81,505,586,330,408,True,4
2,118,"kaist_dataset/Korean/Mobile_Phone/(M,K)E-bookCover/P090911010.jpg",char_data/2/P090911010.jpg_2.jpg,11210,480,640,95,269,364,130,248,True,4
2,33,"kaist_dataset/Korean/Mobile_Phone/(M,K)F-others/P090912070.jpg",char_data/2/P090912070.jpg_2.jpg,891,480,640,27,239,266,289,322,True,4
2,47,kaist_dataset/Mixed/Digital_Camera/(C.S)A-shadow/DSC02567.JPG,char_data/2/DSC02567.JPG_12.jpg,1692,480,640,36,251,287,141,188,True,4
2,47,kaist_dataset/Mixed/Digital_Camera/(C.S)A-shadow/DSC02567.JPG,char_data/2/DSC02567.JPG_13.jpg,1363,480,640,29,345,374,141,188,True,4
2,48,kaist_dataset/Mixed/Digital_Camera/(C.S)A-shadow/DSC02567.JPG,char_data/2/DSC02567.JPG_14.jpg,1632,480,640,34,400,434,138,186,True,4
2,39,kaist_dataset/Mixed/Digital_Camera/(C.S)A-shadow/DSC02579.JPG,char_data/2/DSC02579.JPG_2.jpg,1092,480,640,28,265,293,397,436,True,4
2,33,kaist_dataset/Mixed/Digital_Camera/(C.S)A-shadow/DSC02624.JPG,char_data/2/DSC02624.JPG_8.jpg,495,480,640,15,453,468,398,431,True,4
2,28,kaist_dataset/Mixed/Digital_Camera/(C.S)A-shadow/DSC02624.JPG,char_data/2/DSC02624.JPG_9.jpg,392,480,640,14,502,516,401,429,True,4
2,34,kaist_dataset/Mixed/Digital_Camera/(C.S)A-shadow/DSC03257.JPG,char_data/2/DSC03257.JPG_2.jpg,816,480,640,24,360,384,384,418,True,4
2,54,kaist_dataset/Mixed/Digital_Camera/(C.S)A-shadow/DSC03305.JPG,char_data/2/DSC03305.JPG_2.jpg,1782,480,640,33,461,494,347,401,True,4
2,58,kaist_dataset/Mixed/Digital_Camera/(C.S)A-shadow/DSC04304.JPG,char_data/2/DSC04304.JPG_4.jpg,2494,480,640,43,367,410,280,338,True,4
2,60,kaist_dataset/Mixed/Digital_Camera/(C.S)A-shadow/DSC04304.JPG,char_data/2/DSC04304.JPG_5.jpg,2220,480,640,37,576,613,278,338,True,4
2,33,kaist_dataset/Mixed/Digital_Camera/(C.S)A-shadow/DSC04306.JPG,char_data/2/DSC04306.JPG_2.jpg,693,480,640,21,258,279,412,445,True,4
2,60,kaist_dataset/Mixed/Digital_Camera/(C.S)A-shadow/DSC04326.JPG,char_data/2/DSC04326.JPG_2.jpg,1800,480,640,30,353,383,20,80,True,4
2,38,kaist_dataset/Mixed/Digital_Camera/(C.S)A-shadow/P1010019.JPG,char_data/2/P1010019.JPG_2.jpg,1026,480,640,27,339,366,202,240,True,4
2,34,kaist_dataset/Mixed/Digital_Camera/(C.S)B-light/DSC03298.JPG,char_data/2/DSC03298.JPG_2.jpg,510,480,640,15,425,440,289,323,True,4
2,24,kaist_dataset/Mixed/Digital_Camera/(C.S)C-outdoor1/008.JPG,char_data/2/008.JPG_2.jpg,384,480,640,16,502,518,268,292,True,4
2,36,kaist_dataset/Mixed/Digital_Camera/(C.S)C-outdoor1/009.JPG,char_data/2/009.JPG_2.jpg,756,480,640,21,305,326,319,355,True,4
2,52,kaist_dataset/Mixed/Digital_Camera/(C.S)C-outdoor1/025.JPG,char_data/2/025.JPG_2.jpg,1404,480,640,27,436,463,342,394,True,4
2,22,kaist_dataset/Mixed/Digital_Camera/(C.S)C-outdoor1/047.JPG,char_data/2/047.JPG_2.jpg,242,480,640,11,562,573,173,195,True,4
2,31,kaist_dataset/Mixed/Digital_Camera/(C.S)C-outdoor1/048.JPG,char_data/2/048.JPG_2.jpg,558,480,640,18,282,300,257,288,True,4
2,19,kaist_dataset/Mixed/Digital_Camera/(C.S)C-outdoor1/054.JPG,char_data/2/054.JPG_2.jpg,342,480,640,18,534,552,308,327,True,4
2,52,kaist_dataset/Mixed/Digital_Camera/(C.S)C-outdoor1/080116-0084.jpg,char_data/2/080116-0084.jpg_2.jpg,1664,600,800,32,536,568,301,353,True,4
2,26,kaist_dataset/Mixed/Digital_Camera/(C.S)C-outdoor1/090.JPG,char_data/2/090.JPG_4.jpg,598,480,640,23,350,373,396,422,True,4
2,29,kaist_dataset/Mixed/Digital_Camera/(C.S)C-outdoor1/090.JPG,char_data/2/090.JPG_5.jpg,609,480,640,21,373,394,394,423,True,4
2,61,kaist_dataset/Mixed/Digital_Camera/(C.S)C-outdoor1/105.jpg,char_data/2/105.jpg_2.jpg,2379,480,640,39,402,441,365,426,True,4
2,118,kaist_dataset/Mixed/Digital_Camera/(C.S)C-outdoor1/113.JPG,char_data/2/113.JPG_2.jpg,8260,480,640,70,423,493,231,349,True,4
2,21,kaist_dataset/Mixed/Digital_Camera/(C.S)C-outdoor1/114.jpg,char_data/2/114.jpg_2.jpg,294,480,640,14,341,355,375,396,True,4
2,32,kaist_dataset/Mixed/Digital_Camera/(C.S)C-outdoor1/118.JPG,char_data/2/118.JPG_4.jpg,704,480,640,22,353,375,361,393,True,4
2,36,kaist_dataset/Mixed/Digital_Camera/(C.S)C-outdoor1/118.JPG,char_data/2/118.JPG_5.jpg,936,480,640,26,600,626,359,395,True,4
2,30,kaist_dataset/Mixed/Digital_Camera/(C.S)C-outdoor1/121.JPG,char_data/2/121.JPG_6.jpg,480,480,640,16,291,307,273,303,True,4
2,31,kaist_dataset/Mixed/Digital_Camera/(C.S)C-outdoor1/121.JPG,char_data/2/121.JPG_7.jpg,558,480,640,18,308,326,274,305,True,4
2,24,kaist_dataset/Mixed/Digital_Camera/(C.S)C-outdoor1/121.JPG,char_data/2/121.JPG_8.jpg,408,480,640,17,426,443,278,302,True,4
2,44,kaist_dataset/Mixed/Digital_Camera/(C.S)C-outdoor1/133.JPG,char_data/2/133.JPG_2.jpg,1056,480,640,24,18,42,221,265,True,4
2,22,kaist_dataset/Mixed/Digital_Camera/(C.S)C-outdoor1/2.JPG,char_data/2/2.JPG_2.jpg,242,576,768,11,570,581,397,419,True,4
2,56,kaist_dataset/Mixed/Digital_Camera/(C.S)C-outdoor1/2007-12-08-day-091.jpg,char_data/2/2007-12-08-day-091.jpg_4.jpg,2016,1200,1600,36,1133,1169,634,690,True,4
2,62,kaist_dataset/Mixed/Digital_Camera/(C.S)C-outdoor1/2007-12-08-day-091.jpg,char_data/2/2007-12-08-day-091.jpg_5.jpg,2356,1200,1600,38,1174,1212,630,692,True,4
2,99,kaist_dataset/Mixed/Digital_Camera/(C.S)C-outdoor1/2007-12-08-day-092.jpg,char_data/2/2007-12-08-day-092.jpg_4.jpg,6534,1200,1600,66,612,678,663,762,True,4
2,96,kaist_dataset/Mixed/Digital_Camera/(C.S)C-outdoor1/2007-12-08-day-092.jpg,char_data/2/2007-12-08-day-092.jpg_5.jpg,6336,1200,1600,66,679,745,664,760,True,4
2,55,kaist_dataset/Mixed/Digital_Camera/(C.S)C-outdoor1/2007-12-08-day-118.jpg,char_data/2/2007-12-08-day-118.jpg_4.jpg,4290,1200,1600,78,1316,1394,496,551,True,4
2,60,kaist_dataset/Mixed/Digital_Camera/(C.S)C-outdoor1/2007-12-08-day-118.jpg,char_data/2/2007-12-08-day-118.jpg_5.jpg,3780,1200,1600,63,1486,1549,495,555,True,4
2,37,kaist_dataset/Mixed/Digital_Camera/(C.S)C-outdoor1/2007-12-08-day-130.jpg,char_data/2/2007-12-08-day-130.jpg_2.jpg,1110,1200,1600,30,1071,1101,759,796,True,4
2,43,kaist_dataset/Mixed/Digital_Camera/(C.S)C-outdoor1/2007-12-09-day-exterior-037.jpg,char_data/2/2007-12-09-day-exterior-037.jpg_6.jpg,1763,1200,1600,41,739,780,707,750,True,4
2,50,kaist_dataset/Mixed/Digital_Camera/(C.S)C-outdoor1/2007-12-09-day-exterior-037.jpg,char_data/2/2007-12-09-day-exterior-037.jpg_7.jpg,2000,1200,1600,40,842,882,701,751,True,4
2,44,kaist_dataset/Mixed/Digital_Camera/(C.S)C-outdoor1/2007-12-09-day-exterior-037.jpg,char_data/2/2007-12-09-day-exterior-037.jpg_8.jpg,1628,1200,1600,37,885,922,706,750,True,4
2,49,kaist_dataset/Mixed/Digital_Camera/(C.S)C-outdoor1/2007-12-09-day-exterior-078.jpg,char_data/2/2007-12-09-day-exterior-078.jpg_2.jpg,1323,1200,1600,27,471,498,595,644,True,4
2,66,kaist_dataset/Mixed/Digital_Camera/(C.S)C-outdoor1/2007-12-09-day-exterior-086.jpg,char_data/2/2007-12-09-day-exterior-086.jpg_2.jpg,4290,1200,1600,65,1032,1097,725,791,True,4
2,39,kaist_dataset/Mixed/Digital_Camera/(C.S)C-outdoor1/45.JPG,char_data/2/45.JPG_4.jpg,1365,576,768,35,446,481,369,408,True,4
2,39,kaist_dataset/Mixed/Digital_Camera/(C.S)C-outdoor1/45.JPG,char_data/2/45.JPG_5.jpg,1482,576,768,38,509,547,369,408,True,4
2,22,kaist_dataset/Mixed/Digital_Camera/(C.S)C-outdoor1/48.JPG,char_data/2/48.JPG_4.jpg,264,576,768,12,231,243,342,364,True,4
2,24,kaist_dataset/Mixed/Digital_Camera/(C.S)C-outdoor1/48.JPG,char_data/2/48.JPG_5.jpg,312,576,768,13,423,436,343,367,True,4
2,41,kaist_dataset/Mixed/Digital_Camera/(C.S)C-outdoor1/56.JPG,char_data/2/56.JPG_2.jpg,1394,576,768,34,475,509,299,340,True,4
2,24,kaist_dataset/Mixed/Digital_Camera/(C.S)C-outdoor1/57.JPG,char_data/2/57.JPG_12.jpg,336,500,766,14,356,370,296,320,True,4
2,25,kaist_dataset/Mixed/Digital_Camera/(C.S)C-outdoor1/57.JPG,char_data/2/57.JPG_13.jpg,575,500,766,23,435,458,296,321,True,4
2,25,kaist_dataset/Mixed/Digital_Camera/(C.S)C-outdoor1/57.JPG,char_data/2/57.JPG_14.jpg,425,500,766,17,606,623,300,325,True,4
2,24,kaist_dataset/Mixed/Digital_Camera/(C.S)C-outdoor1/57.JPG,char_data/2/57.JPG_15.jpg,384,500,766,16,656,672,302,326,True,4
2,26,kaist_dataset/Mixed/Digital_Camera/(C.S)C-outdoor1/57.JPG,char_data/2/57.JPG_16.jpg,338,500,766,13,436,449,455,481,True,4
2,23,kaist_dataset/Mixed/Digital_Camera/(C.S)C-outdoor1/57.JPG,char_data/2/57.JPG_17.jpg,299,500,766,13,478,491,459,482,True,4
2,109,kaist_dataset/Mixed/Digital_Camera/(C.S)C-outdoor1/DSC02244.JPG,char_data/2/DSC02244.JPG_2.jpg,7848,480,640,72,267,339,113,222,True,4
2,40,kaist_dataset/Mixed/Digital_Camera/(C.S)C-outdoor1/DSC02312.JPG,char_data/2/DSC02312.JPG_6.jpg,1280,480,640,32,166,198,219,259,True,4
2,42,kaist_dataset/Mixed/Digital_Camera/(C.S)C-outdoor1/DSC02312.JPG,char_data/2/DSC02312.JPG_7.jpg,1638,480,640,39,331,370,221,263,True,4
2,36,kaist_dataset/Mixed/Digital_Camera/(C.S)C-outdoor1/DSC02312.JPG,char_data/2/DSC02312.JPG_8.jpg,1692,480,640,47,426,473,223,259,True,4
2,42,kaist_dataset/Mixed/Digital_Camera/(C.S)C-outdoor1/DSC02322.JPG,char_data/2/DSC02322.JPG_2.jpg,1092,480,640,26,190,216,364,406,True,4
2,32,kaist_dataset/Mixed/Digital_Camera/(C.S)C-outdoor1/DSC02349.JPG,char_data/2/DSC02349.JPG_4.jpg,736,480,640,23,292,315,200,232,True,4
2,38,kaist_dataset/Mixed/Digital_Camera/(C.S)C-outdoor1/DSC02349.JPG,char_data/2/DSC02349.JPG_5.jpg,722,480,640,19,370,389,426,464,True,4
2,37,kaist_dataset/Mixed/Digital_Camera/(C.S)C-outdoor1/DSC02350.JPG,char_data/2/DSC02350.JPG_8.jpg,962,480,640,26,267,293,399,436,True,4
2,43,kaist_dataset/Mixed/Digital_Camera/(C.S)C-outdoor1/DSC02350.JPG,char_data/2/DSC02350.JPG_9.jpg,1204,480,640,28,292,320,398,441,True,4
2,39,kaist_dataset/Mixed/Digital_Camera/(C.S)C-outdoor1/DSC02350.JPG,char_data/2/DSC02350.JPG_10.jpg,1092,480,640,28,342,370,396,435,True,4
2,44,kaist_dataset/Mixed/Digital_Camera/(C.S)C-outdoor1/DSC02350.JPG,char_data/2/DSC02350.JPG_11.jpg,1144,480,640,26,371,397,396,440,True,4
2,44,kaist_dataset/Mixed/Digital_Camera/(C.S)C-outdoor1/P1010009.JPG,char_data/2/P1010009.JPG_5.jpg,1100,480,640,25,117,142,234,278,True,4
2,37,kaist_dataset/Mixed/Digital_Camera/(C.S)C-outdoor1/P1010011.JPG,char_data/2/P1010011.JPG_7.jpg,740,480,640,20,464,484,308,345,True,4
2,39,kaist_dataset/Mixed/Digital_Camera/(C.S)C-outdoor1/P1010011.JPG,char_data/2/P1010011.JPG_8.jpg,897,480,640,23,482,505,309,348,True,4
2,49,kaist_dataset/Mixed/Digital_Camera/(C.S)C-outdoor1/P1010012.JPG,char_data/2/P1010012.JPG_8.jpg,1617,480,640,33,489,522,235,284,True,4
2,55,kaist_dataset/Mixed/Digital_Camera/(C.S)C-outdoor2/DSC02359.JPG,char_data/2/DSC02359.JPG_2.jpg,1375,480,640,25,262,287,412,467,True,4
2,34,kaist_dataset/Mixed/Digital_Camera/(C.S)C-outdoor2/DSC02361.JPG,char_data/2/DSC02361.JPG_4.jpg,510,480,640,15,516,531,374,408,True,4
2,41,kaist_dataset/Mixed/Digital_Camera/(C.S)C-outdoor2/DSC02361.JPG,char_data/2/DSC02361.JPG_5.jpg,615,480,640,15,532,547,375,416,True,4
2,35,kaist_dataset/Mixed/Digital_Camera/(C.S)C-outdoor2/DSC02368.JPG,char_data/2/DSC02368.JPG_2.jpg,525,480,640,15,141,156,385,420,True,4
2,43,kaist_dataset/Mixed/Digital_Camera/(C.S)C-outdoor2/DSC02374.JPG,char_data/2/DSC02374.JPG_4.jpg,903,480,640,21,265,286,300,343,True,4
2,45,kaist_dataset/Mixed/Digital_Camera/(C.S)C-outdoor2/DSC02374.JPG,char_data/2/DSC02374.JPG_5.jpg,1215,480,640,27,287,314,299,344,True,4
2,36,kaist_dataset/Mixed/Digital_Camera/(C.S)C-outdoor2/DSC02376.JPG,char_data/2/DSC02376.JPG_2.jpg,792,480,640,22,447,469,338,374,True,4
2,38,kaist_dataset/Mixed/Digital_Camera/(C.S)C-outdoor2/DSC02377.JPG,char_data/2/DSC02377.JPG_4.jpg,836,480,640,22,445,467,354,392,True,4
2,40,kaist_dataset/Mixed/Digital_Camera/(C.S)C-outdoor2/DSC02377.JPG,char_data/2/DSC02377.JPG_5.jpg,1080,480,640,27,467,494,351,391,True,4
2,33,kaist_dataset/Mixed/Digital_Camera/(C.S)C-outdoor2/DSC02379.JPG,char_data/2/DSC02379.JPG_2.jpg,627,480,640,19,409,428,290,323,True,4
2,49,kaist_dataset/Mixed/Digital_Camera/(C.S)C-outdoor2/DSC02389.JPG,char_data/2/DSC02389.JPG_8.jpg,1960,480,640,40,513,553,22,71,True,4
2,45,kaist_dataset/Mixed/Digital_Camera/(C.S)C-outdoor2/DSC02389.JPG,char_data/2/DSC02389.JPG_9.jpg,1260,480,640,28,250,278,42,87,True,4
2,37,kaist_dataset/Mixed/Digital_Camera/(C.S)C-outdoor2/DSC02389.JPG,char_data/2/DSC02389.JPG_10.jpg,1184,480,640,32,173,205,260,297,True,4
2,56,kaist_dataset/Mixed/Digital_Camera/(C.S)C-outdoor2/DSC02389.JPG,char_data/2/DSC02389.JPG_11.jpg,4480,480,640,80,592,639,314,370,True,4
2,34,kaist_dataset/Mixed/Digital_Camera/(C.S)C-outdoor2/DSC02397.JPG,char_data/2/DSC02397.JPG_6.jpg,646,480,640,19,442,461,208,242,True,4
2,32,kaist_dataset/Mixed/Digital_Camera/(C.S)C-outdoor2/DSC02397.JPG,char_data/2/DSC02397.JPG_7.jpg,608,480,640,19,534,553,206,238,True,4
2,36,kaist_dataset/Mixed/Digital_Camera/(C.S)C-outdoor2/DSC02397.JPG,char_data/2/DSC02397.JPG_8.jpg,864,480,640,24,607,631,206,242,True,4
2,49,kaist_dataset/Mixed/Digital_Camera/(C.S)C-outdoor2/DSC02400.JPG,char_data/2/DSC02400.JPG_6.jpg,1470,480,640,30,213,243,398,447,True,4
2,58,kaist_dataset/Mixed/Digital_Camera/(C.S)C-outdoor2/DSC02400.JPG,char_data/2/DSC02400.JPG_7.jpg,2262,480,640,39,336,375,397,455,True,4
2,52,kaist_dataset/Mixed/Digital_Camera/(C.S)C-outdoor2/DSC02400.JPG,char_data/2/DSC02400.JPG_8.jpg,1976,480,640,38,407,445,396,448,True,4
2,67,kaist_dataset/Mixed/Digital_Camera/(C.S)C-outdoor2/DSC02407.JPG,char_data/2/DSC02407.JPG_2.jpg,3082,480,640,46,61,107,79,146,True,4
2,41,kaist_dataset/Mixed/Digital_Camera/(C.S)C-outdoor2/DSC02411.JPG,char_data/2/DSC02411.JPG_2.jpg,943,480,640,23,402,425,350,391,True,4
2,40,kaist_dataset/Mixed/Digital_Camera/(C.S)C-outdoor2/DSC02413.JPG,char_data/2/DSC02413.JPG_4.jpg,800,480,640,20,355,375,208,248,True,4
2,37,kaist_dataset/Mixed/Digital_Camera/(C.S)C-outdoor2/DSC02413.JPG,char_data/2/DSC02413.JPG_5.jpg,1110,480,640,30,552,582,211,248,True,4
2,36,kaist_dataset/Mixed/Digital_Camera/(C.S)C-outdoor2/DSC02419.JPG,char_data/2/DSC02419.JPG_8.jpg,648,480,640,18,478,496,214,250,True,4
2,43,kaist_dataset/Mixed/Digital_Camera/(C.S)C-outdoor2/DSC02419.JPG,char_data/2/DSC02419.JPG_9.jpg,1118,480,640,26,525,551,208,251,True,4
2,38,kaist_dataset/Mixed/Digital_Camera/(C.S)C-outdoor2/DSC02419.JPG,char_data/2/DSC02419.JPG_10.jpg,456,480,640,12,552,564,216,254,True,4
2,29,kaist_dataset/Mixed/Digital_Camera/(C.S)C-outdoor2/DSC02419.JPG,char_data/2/DSC02419.JPG_11.jpg,435,480,640,15,566,581,217,246,True,4
2,34,kaist_dataset/Mixed/Digital_Camera/(C.S)C-outdoor2/DSC02422.JPG,char_data/2/DSC02422.JPG_6.jpg,748,480,640,22,173,195,222,256,True,4
2,31,kaist_dataset/Mixed/Digital_Camera/(C.S)C-outdoor2/DSC02422.JPG,char_data/2/DSC02422.JPG_7.jpg,589,480,640,19,366,385,223,254,True,4
2,38,kaist_dataset/Mixed/Digital_Camera/(C.S)C-outdoor2/DSC02422.JPG,char_data/2/DSC02422.JPG_8.jpg,950,480,640,25,385,410,218,256,True,4
2,35,kaist_dataset/Mixed/Digital_Camera/(C.S)C-outdoor2/DSC02447.JPG,char_data/2/DSC02447.JPG_2.jpg,595,480,640,17,488,505,223,258,True,4
2,47,kaist_dataset/Mixed/Digital_Camera/(C.S)C-outdoor2/DSC02461.JPG,char_data/2/DSC02461.JPG_6.jpg,2679,480,640,57,230,287,286,333,True,4
2,55,kaist_dataset/Mixed/Digital_Camera/(C.S)C-outdoor2/DSC02461.JPG,char_data/2/DSC02461.JPG_7.jpg,3520,480,640,64,401,465,272,327,True,4
2,55,kaist_dataset/Mixed/Digital_Camera/(C.S)C-outdoor2/DSC02461.JPG,char_data/2/DSC02461.JPG_8.jpg,3630,480,640,66,522,588,269,324,True,4
2,37,kaist_dataset/Mixed/Digital_Camera/(C.S)C-outdoor2/DSC02466.JPG,char_data/2/DSC02466.JPG_6.jpg,1073,480,640,29,222,251,255,292,True,4
2,34,kaist_dataset/Mixed/Digital_Camera/(C.S)C-outdoor2/DSC02466.JPG,char_data/2/DSC02466.JPG_7.jpg,1054,480,640,31,369,400,254,288,True,4
2,34,kaist_dataset/Mixed/Digital_Camera/(C.S)C-outdoor2/DSC02466.JPG,char_data/2/DSC02466.JPG_8.jpg,1326,480,640,39,450,489,257,291,True,4
2,23,kaist_dataset/Mixed/Digital_Camera/(C.S)C-outdoor2/DSC02477.JPG,char_data/2/DSC02477.JPG_4.jpg,552,480,640,24,173,197,253,276,True,4
2,23,kaist_dataset/Mixed/Digital_Camera/(C.S)C-outdoor2/DSC02477.JPG,char_data/2/DSC02477.JPG_5.jpg,575,480,640,25,196,221,254,277,True,4
2,43,kaist_dataset/Mixed/Digital_Camera/(C.S)C-outdoor2/DSC02482.JPG,char_data/2/DSC02482.JPG_6.jpg,1591,480,640,37,516,553,320,363,True,4
2,40,kaist_dataset/Mixed/Digital_Camera/(C.S)C-outdoor2/DSC02482.JPG,char_data/2/DSC02482.JPG_7.jpg,1480,480,640,37,556,593,324,364,True,4
2,42,kaist_dataset/Mixed/Digital_Camera/(C.S)C-outdoor2/DSC02482.JPG,char_data/2/DSC02482.JPG_8.jpg,1596,480,640,38,479,517,157,199,True,4
2,41,kaist_dataset/Mixed/Digital_Camera/(C.S)C-outdoor2/DSC02490.JPG,char_data/2/DSC02490.JPG_2.jpg,861,480,640,21,357,378,343,384,True,4
2,36,kaist_dataset/Mixed/Digital_Camera/(C.S)C-outdoor2/DSC02492.JPG,char_data/2/DSC02492.JPG_6.jpg,756,480,640,21,392,413,323,359,True,4
2,31,kaist_dataset/Mixed/Digital_Camera/(C.S)C-outdoor2/DSC02492.JPG,char_data/2/DSC02492.JPG_7.jpg,589,480,640,19,446,465,324,355,True,4
2,35,kaist_dataset/Mixed/Digital_Camera/(C.S)C-outdoor2/DSC02492.JPG,char_data/2/DSC02492.JPG_8.jpg,945,480,640,27,483,510,323,358,True,4
2,67,kaist_dataset/Mixed/Digital_Camera/(C.S)C-outdoor2/DSC02503.JPG,char_data/2/DSC02503.JPG_2.jpg,5025,480,640,75,45,120,360,427,True,4
2,78,kaist_dataset/Mixed/Digital_Camera/(C.S)C-outdoor2/DSC02513.JPG,char_data/2/DSC02513.JPG_4.jpg,3744,480,640,48,371,419,143,221,True,4
2,76,kaist_dataset/Mixed/Digital_Camera/(C.S)C-outdoor2/DSC02513.JPG,char_data/2/DSC02513.JPG_5.jpg,4028,480,640,53,467,520,143,219,True,4
2,36,kaist_dataset/Mixed/Digital_Camera/(C.S)C-outdoor2/DSC02545.JPG,char_data/2/DSC02545.JPG_8.jpg,1260,480,640,35,132,167,405,441,True,4
2,33,kaist_dataset/Mixed/Digital_Camera/(C.S)C-outdoor2/DSC02545.JPG,char_data/2/DSC02545.JPG_9.jpg,1188,480,640,36,353,389,399,432,True,4
2,34,kaist_dataset/Mixed/Digital_Camera/(C.S)C-outdoor2/DSC02545.JPG,char_data/2/DSC02545.JPG_10.jpg,1054,480,640,31,433,464,399,433,True,4
2,34,kaist_dataset/Mixed/Digital_Camera/(C.S)C-outdoor2/DSC02545.JPG,char_data/2/DSC02545.JPG_11.jpg,1122,480,640,33,463,496,398,432,True,4
2,36,kaist_dataset/Mixed/Digital_Camera/(C.S)C-outdoor2/DSC02553.JPG,char_data/2/DSC02553.JPG_6.jpg,792,480,640,22,349,371,297,333,True,4
2,37,kaist_dataset/Mixed/Digital_Camera/(C.S)C-outdoor2/DSC02553.JPG,char_data/2/DSC02553.JPG_7.jpg,777,480,640,21,410,431,298,335,True,4
2,37,kaist_dataset/Mixed/Digital_Camera/(C.S)C-outdoor2/DSC02553.JPG,char_data/2/DSC02553.JPG_8.jpg,925,480,640,25,456,481,298,335,True,4
2,31,kaist_dataset/Mixed/Digital_Camera/(C.S)C-outdoor2/DSC02555.JPG,char_data/2/DSC02555.JPG_4.jpg,744,480,640,24,199,223,253,284,True,4
2,23,kaist_dataset/Mixed/Digital_Camera/(C.S)C-outdoor2/DSC02555.JPG,char_data/2/DSC02555.JPG_5.jpg,644,480,640,28,224,252,255,278,True,4
2,30,kaist_dataset/Mixed/Digital_Camera/(C.S)C-outdoor2/DSC02556.JPG,char_data/2/DSC02556.JPG_2.jpg,690,480,640,23,336,359,344,374,True,4
2,39,kaist_dataset/Mixed/Digital_Camera/(C.S)C-outdoor2/DSC02557.JPG,char_data/2/DSC02557.JPG_2.jpg,897,480,640,23,492,515,207,246,True,4
2,31,kaist_dataset/Mixed/Digital_Camera/(C.S)C-outdoor2/DSC02560.JPG,char_data/2/DSC02560.JPG_2.jpg,589,480,640,19,544,563,303,334,True,4
2,47,kaist_dataset/Mixed/Digital_Camera/(C.S)C-outdoor2/DSC02567.JPG,char_data/2/DSC02567.JPG_15.jpg,1692,480,640,36,251,287,141,188,True,4
2,47,kaist_dataset/Mixed/Digital_Camera/(C.S)C-outdoor2/DSC02567.JPG,char_data/2/DSC02567.JPG_16.jpg,1363,480,640,29,345,374,141,188,True,4
2,48,kaist_dataset/Mixed/Digital_Camera/(C.S)C-outdoor2/DSC02567.JPG,char_data/2/DSC02567.JPG_17.jpg,1632,480,640,34,400,434,138,186,True,4
2,33,kaist_dataset/Mixed/Digital_Camera/(C.S)C-outdoor2/DSC02624.JPG,char_data/2/DSC02624.JPG_10.jpg,495,480,640,15,453,468,398,431,True,4
2,28,kaist_dataset/Mixed/Digital_Camera/(C.S)C-outdoor2/DSC02624.JPG,char_data/2/DSC02624.JPG_11.jpg,392,480,640,14,502,516,401,429,True,4
2,36,kaist_dataset/Mixed/Digital_Camera/(C.S)C-outdoor2/DSC02887.JPG,char_data/2/DSC02887.JPG_2.jpg,828,480,640,23,405,428,114,150,True,4
2,33,kaist_dataset/Mixed/Digital_Camera/(C.S)C-outdoor2/DSC02894.JPG,char_data/2/DSC02894.JPG_2.jpg,825,480,640,25,413,438,243,276,True,4
2,57,kaist_dataset/Mixed/Digital_Camera/(C.S)C-outdoor2/DSC02895.JPG,char_data/2/DSC02895.JPG_2.jpg,1710,480,640,30,73,103,352,409,True,4
2,33,kaist_dataset/Mixed/Digital_Camera/(C.S)C-outdoor2/DSC02912.JPG,char_data/2/DSC02912.JPG_2.jpg,495,480,640,15,333,348,9,42,True,4
2,30,kaist_dataset/Mixed/Digital_Camera/(C.S)C-outdoor2/DSC02926.JPG,char_data/2/DSC02926.JPG_4.jpg,660,480,640,22,465,487,151,181,True,4
2,29,kaist_dataset/Mixed/Digital_Camera/(C.S)C-outdoor2/DSC02926.JPG,char_data/2/DSC02926.JPG_5.jpg,725,480,640,25,505,530,152,181,True,4
2,37,kaist_dataset/Mixed/Digital_Camera/(C.S)C-outdoor2/DSC02930.JPG,char_data/2/DSC02930.JPG_6.jpg,888,480,640,24,323,347,192,229,True,4
2,32,kaist_dataset/Mixed/Digital_Camera/(C.S)C-outdoor2/DSC02930.JPG,char_data/2/DSC02930.JPG_7.jpg,672,480,640,21,369,390,193,225,True,4
2,37,kaist_dataset/Mixed/Digital_Camera/(C.S)C-outdoor2/DSC02930.JPG,char_data/2/DSC02930.JPG_8.jpg,962,480,640,26,434,460,191,228,True,4
2,29,kaist_dataset/Mixed/Digital_Camera/(C.S)C-outdoor2/DSC02936.JPG,char_data/2/DSC02936.JPG_2.jpg,406,480,640,14,522,536,227,256,True,4
2,42,kaist_dataset/Mixed/Digital_Camera/(C.S)C-outdoor2/DSC02938.JPG,char_data/2/DSC02938.JPG_2.jpg,924,480,640,22,521,543,243,285,True,4
2,26,kaist_dataset/Mixed/Digital_Camera/(C.S)C-outdoor2/DSC02947.JPG,char_data/2/DSC02947.JPG_2.jpg,494,480,640,19,566,585,244,270,True,4
2,36,kaist_dataset/Mixed/Digital_Camera/(C.S)C-outdoor2/DSC02954.JPG,char_data/2/DSC02954.JPG_2.jpg,972,480,640,27,39,66,86,122,True,4
2,42,kaist_dataset/Mixed/Digital_Camera/(C.S)C-outdoor3/DSC02956.JPG,char_data/2/DSC02956.JPG_2.jpg,1050,480,640,25,275,300,398,440,True,4
2,41,kaist_dataset/Mixed/Digital_Camera/(C.S)C-outdoor3/DSC02958.JPG,char_data/2/DSC02958.JPG_6.jpg,1107,480,640,27,284,311,401,442,True,4
2,40,kaist_dataset/Mixed/Digital_Camera/(C.S)C-outdoor3/DSC02958.JPG,char_data/2/DSC02958.JPG_7.jpg,1040,480,640,26,336,362,400,440,True,4
2,42,kaist_dataset/Mixed/Digital_Camera/(C.S)C-outdoor3/DSC02958.JPG,char_data/2/DSC02958.JPG_8.jpg,1176,480,640,28,412,440,402,444,True,4
2,37,kaist_dataset/Mixed/Digital_Camera/(C.S)C-outdoor3/DSC02969.JPG,char_data/2/DSC02969.JPG_2.jpg,925,480,640,25,312,337,231,268,True,4
2,51,kaist_dataset/Mixed/Digital_Camera/(C.S)C-outdoor3/DSC03004.JPG,char_data/2/DSC03004.JPG_2.jpg,1530,480,640,30,569,599,356,407,True,4
2,170,kaist_dataset/Mixed/Digital_Camera/(C.S)C-outdoor3/DSC03010.JPG,char_data/2/DSC03010.JPG_2.jpg,16830,480,640,99,182,281,171,341,True,4
2,30,kaist_dataset/Mixed/Digital_Camera/(C.S)C-outdoor3/DSC03062.JPG,char_data/2/DSC03062.JPG_2.jpg,540,480,640,18,296,314,247,277,True,4
2,50,kaist_dataset/Mixed/Digital_Camera/(C.S)C-outdoor3/DSC03164.JPG,char_data/2/DSC03164.JPG_2.jpg,1900,480,640,38,368,406,211,261,True,4
2,53,kaist_dataset/Mixed/Digital_Camera/(C.S)C-outdoor3/DSC03189.JPG,char_data/2/DSC03189.JPG_4.jpg,1484,480,640,28,413,441,300,353,True,4
2,51,kaist_dataset/Mixed/Digital_Camera/(C.S)C-outdoor3/DSC03189.JPG,char_data/2/DSC03189.JPG_5.jpg,1632,480,640,32,503,535,301,352,True,4
2,47,kaist_dataset/Mixed/Digital_Camera/(C.S)C-outdoor3/DSC03212.JPG,char_data/2/DSC03212.JPG_4.jpg,846,480,640,18,375,393,248,295,True,4
2,44,kaist_dataset/Mixed/Digital_Camera/(C.S)C-outdoor3/DSC03212.JPG,char_data/2/DSC03212.JPG_5.jpg,1056,480,640,24,498,522,252,296,True,4
2,47,kaist_dataset/Mixed/Digital_Camera/(C.S)C-outdoor3/DSC03236.JPG,char_data/2/DSC03236.JPG_2.jpg,940,480,640,20,62,82,186,233,True,4
2,48,kaist_dataset/Mixed/Digital_Camera/(C.S)C-outdoor3/DSC03241.JPG,char_data/2/DSC03241.JPG_2.jpg,1728,480,640,36,302,338,308,356,True,4
2,54,kaist_dataset/Mixed/Digital_Camera/(C.S)C-outdoor3/DSC03242.JPG,char_data/2/DSC03242.JPG_2.jpg,3510,480,640,65,199,264,367,421,True,4
2,30,kaist_dataset/Mixed/Digital_Camera/(C.S)C-outdoor3/DSC03250.JPG,char_data/2/DSC03250.JPG_6.jpg,570,480,640,19,485,504,403,433,True,4
2,35,kaist_dataset/Mixed/Digital_Camera/(C.S)C-outdoor3/DSC03250.JPG,char_data/2/DSC03250.JPG_7.jpg,735,480,640,21,533,554,402,437,True,4
2,33,kaist_dataset/Mixed/Digital_Camera/(C.S)C-outdoor3/DSC03250.JPG,char_data/2/DSC03250.JPG_8.jpg,726,480,640,22,553,575,403,436,True,4
2,26,kaist_dataset/Mixed/Digital_Camera/(C.S)C-outdoor3/DSC03255.JPG,char_data/2/DSC03255.JPG_4.jpg,442,480,640,17,314,331,184,210,True,4
2,28,kaist_dataset/Mixed/Digital_Camera/(C.S)C-outdoor3/DSC03255.JPG,char_data/2/DSC03255.JPG_5.jpg,644,480,640,23,330,353,182,210,True,4
2,38,kaist_dataset/Mixed/Digital_Camera/(C.S)C-outdoor3/DSC03259.JPG,char_data/2/DSC03259.JPG_2.jpg,684,480,640,18,445,463,352,390,True,4
2,57,kaist_dataset/Mixed/Digital_Camera/(C.S)C-outdoor3/DSC03269.JPG,char_data/2/DSC03269.JPG_2.jpg,2451,480,640,43,396,439,360,417,True,4
2,23,kaist_dataset/Mixed/Digital_Camera/(C.S)C-outdoor3/DSC03292.JPG,char_data/2/DSC03292.JPG_2.jpg,276,480,640,12,579,591,121,144,True,4
2,37,kaist_dataset/Mixed/Digital_Camera/(C.S)C-outdoor3/DSC03301.JPG,char_data/2/DSC03301.JPG_4.jpg,814,480,640,22,438,460,139,176,True,4
2,33,kaist_dataset/Mixed/Digital_Camera/(C.S)C-outdoor3/DSC03301.JPG,char_data/2/DSC03301.JPG_5.jpg,693,480,640,21,479,500,138,171,True,4
2,19,kaist_dataset/Mixed/Digital_Camera/(C.S)C-outdoor3/DSC03303.JPG,char_data/2/DSC03303.JPG_6.jpg,456,480,640,24,565,589,109,128,True,4
2,24,kaist_dataset/Mixed/Digital_Camera/(C.S)C-outdoor3/DSC03303.JPG,char_data/2/DSC03303.JPG_7.jpg,624,480,640,26,297,323,280,304,True,4
2,31,kaist_dataset/Mixed/Digital_Camera/(C.S)C-outdoor3/DSC03303.JPG,char_data/2/DSC03303.JPG_8.jpg,899,480,640,29,574,603,273,304,True,4
2,35,kaist_dataset/Mixed/Digital_Camera/(C.S)C-outdoor3/DSC03308.JPG,char_data/2/DSC03308.JPG_2.jpg,805,480,640,23,251,274,248,283,True,4
2,48,kaist_dataset/Mixed/Digital_Camera/(C.S)C-outdoor3/DSC03310.JPG,char_data/2/DSC03310.JPG_2.jpg,2592,480,640,54,525,579,323,371,True,4
2,33,kaist_dataset/Mixed/Digital_Camera/(C.S)C-outdoor3/DSC03311.JPG,char_data/2/DSC03311.JPG_2.jpg,462,480,640,14,320,334,370,403,True,4
2,35,kaist_dataset/Mixed/Digital_Camera/(C.S)C-outdoor3/DSC03312.JPG,char_data/2/DSC03312.JPG_2.jpg,1365,480,640,39,189,228,285,320,True,4
2,56,kaist_dataset/Mixed/Digital_Camera/(C.S)C-outdoor3/DSC03314.JPG,char_data/2/DSC03314.JPG_4.jpg,1904,480,640,34,294,328,362,418,True,4
2,57,kaist_dataset/Mixed/Digital_Camera/(C.S)C-outdoor3/DSC03314.JPG,char_data/2/DSC03314.JPG_5.jpg,1938,480,640,34,397,431,361,418,True,4
2,26,kaist_dataset/Mixed/Digital_Camera/(C.S)C-outdoor3/DSC03315.JPG,char_data/2/DSC03315.JPG_4.jpg,468,480,640,18,378,396,124,150,True,4
2,25,kaist_dataset/Mixed/Digital_Camera/(C.S)C-outdoor3/DSC03315.JPG,char_data/2/DSC03315.JPG_5.jpg,400,480,640,16,541,557,121,146,True,4
2,42,kaist_dataset/Mixed/Digital_Camera/(C.S)C-outdoor3/DSC03316.JPG,char_data/2/DSC03316.JPG_2.jpg,882,480,640,21,545,566,77,119,True,4
2,44,kaist_dataset/Mixed/Digital_Camera/(C.S)C-outdoor3/DSC03323.JPG,char_data/2/DSC03323.JPG_6.jpg,1100,480,640,25,244,269,299,343,True,4
2,48,kaist_dataset/Mixed/Digital_Camera/(C.S)C-outdoor3/DSC03323.JPG,char_data/2/DSC03323.JPG_7.jpg,1296,480,640,27,317,344,291,339,True,4
2,45,kaist_dataset/Mixed/Digital_Camera/(C.S)C-outdoor3/DSC03323.JPG,char_data/2/DSC03323.JPG_8.jpg,1440,480,640,32,371,403,291,336,True,4
2,34,kaist_dataset/Mixed/Digital_Camera/(C.S)C-outdoor3/DSC03328.JPG,char_data/2/DSC03328.JPG_4.jpg,544,480,640,16,233,249,403,437,True,4
2,39,kaist_dataset/Mixed/Digital_Camera/(C.S)C-outdoor3/DSC03328.JPG,char_data/2/DSC03328.JPG_5.jpg,741,480,640,19,420,439,399,438,True,4
2,40,kaist_dataset/Mixed/Digital_Camera/(C.S)C-outdoor4/DSC03439.JPG,char_data/2/DSC03439.JPG_4.jpg,1040,480,640,26,329,355,419,459,True,4
2,41,kaist_dataset/Mixed/Digital_Camera/(C.S)C-outdoor4/DSC03439.JPG,char_data/2/DSC03439.JPG_5.jpg,902,480,640,22,362,384,418,459,True,4
2,31,kaist_dataset/Mixed/Digital_Camera/(C.S)C-outdoor4/DSC03446.JPG,char_data/2/DSC03446.JPG_2.jpg,744,480,640,24,372,396,290,321,True,4
2,46,kaist_dataset/Mixed/Digital_Camera/(C.S)C-outdoor4/DSC03534.JPG,char_data/2/DSC03534.JPG_2.jpg,1518,480,640,33,259,292,284,330,True,4
2,86,kaist_dataset/Mixed/Digital_Camera/(C.S)C-outdoor4/DSC03544.JPG,char_data/2/DSC03544.JPG_2.jpg,3440,480,640,40,506,546,171,257,True,4
2,49,kaist_dataset/Mixed/Digital_Camera/(C.S)C-outdoor4/DSC03548.JPG,char_data/2/DSC03548.JPG_2.jpg,2303,480,640,47,488,535,392,441,True,4
2,37,kaist_dataset/Mixed/Digital_Camera/(C.S)C-outdoor4/DSC03549.JPG,char_data/2/DSC03549.JPG_2.jpg,777,480,640,21,592,613,218,255,True,4
2,39,kaist_dataset/Mixed/Digital_Camera/(C.S)C-outdoor4/DSC03569.JPG,char_data/2/DSC03569.JPG_2.jpg,1170,480,640,30,146,176,181,220,True,4
2,50,kaist_dataset/Mixed/Digital_Camera/(C.S)C-outdoor4/DSC03571.JPG,char_data/2/DSC03571.JPG_2.jpg,1350,480,640,27,450,477,298,348,True,4
2,28,kaist_dataset/Mixed/Digital_Camera/(C.S)C-outdoor4/DSC03581.JPG,char_data/2/DSC03581.JPG_4.jpg,476,480,640,17,524,541,122,150,True,4
2,23,kaist_dataset/Mixed/Digital_Camera/(C.S)C-outdoor4/DSC03581.JPG,char_data/2/DSC03581.JPG_5.jpg,575,480,640,25,105,130,147,170,True,4
2,46,kaist_dataset/Mixed/Digital_Camera/(C.S)C-outdoor4/DSC03613.JPG,char_data/2/DSC03613.JPG_2.jpg,874,480,640,19,417,436,26,72,True,4
2,38,kaist_dataset/Mixed/Digital_Camera/(C.S)C-outdoor4/DSC03618.JPG,char_data/2/DSC03618.JPG_2.jpg,1862,480,640,49,552,601,413,451,True,4
2,48,kaist_dataset/Mixed/Digital_Camera/(C.S)C-outdoor4/DSC03631.JPG,char_data/2/DSC03631.JPG_2.jpg,1488,480,640,31,173,204,354,402,True,4
2,45,kaist_dataset/Mixed/Digital_Camera/(C.S)C-outdoor4/DSC03633.JPG,char_data/2/DSC03633.JPG_2.jpg,1215,480,640,27,258,285,266,311,True,4
2,32,kaist_dataset/Mixed/Digital_Camera/(C.S)C-outdoor4/DSC03634.JPG,char_data/2/DSC03634.JPG_2.jpg,672,480,640,21,450,471,428,460,True,4
2,36,kaist_dataset/Mixed/Digital_Camera/(C.S)C-outdoor4/DSC03637.JPG,char_data/2/DSC03637.JPG_6.jpg,576,480,640,16,298,314,293,329,True,4
2,32,kaist_dataset/Mixed/Digital_Camera/(C.S)C-outdoor4/DSC03637.JPG,char_data/2/DSC03637.JPG_7.jpg,448,480,640,14,314,328,295,327,True,4
2,27,kaist_dataset/Mixed/Digital_Camera/(C.S)C-outdoor4/DSC03637.JPG,char_data/2/DSC03637.JPG_8.jpg,459,480,640,17,344,361,299,326,True,4
2,37,kaist_dataset/Mixed/Digital_Camera/(C.S)C-outdoor4/DSC03640.JPG,char_data/2/DSC03640.JPG_8.jpg,888,480,640,24,192,216,400,437,True,4
2,31,kaist_dataset/Mixed/Digital_Camera/(C.S)C-outdoor4/DSC03640.JPG,char_data/2/DSC03640.JPG_9.jpg,558,480,640,18,382,400,398,429,True,4
2,26,kaist_dataset/Mixed/Digital_Camera/(C.S)C-outdoor4/DSC03640.JPG,char_data/2/DSC03640.JPG_10.jpg,702,480,640,27,401,428,401,427,True,4
2,25,kaist_dataset/Mixed/Digital_Camera/(C.S)C-outdoor4/DSC03640.JPG,char_data/2/DSC03640.JPG_11.jpg,525,480,640,21,461,482,400,425,True,4
2,30,kaist_dataset/Mixed/Digital_Camera/(C.S)C-outdoor4/DSC03642.JPG,char_data/2/DSC03642.JPG_2.jpg,600,480,640,20,527,547,397,427,True,4
2,22,kaist_dataset/Mixed/Digital_Camera/(C.S)C-outdoor4/DSC03643.JPG,char_data/2/DSC03643.JPG_2.jpg,330,480,640,15,561,576,330,352,True,4
2,53,kaist_dataset/Mixed/Digital_Camera/(C.S)C-outdoor4/DSC03651.JPG,char_data/2/DSC03651.JPG_2.jpg,1590,480,640,30,266,296,356,409,True,4
2,36,kaist_dataset/Mixed/Digital_Camera/(C.S)C-outdoor4/DSC03655.JPG,char_data/2/DSC03655.JPG_2.jpg,936,480,640,26,445,471,399,435,True,4
2,25,kaist_dataset/Mixed/Digital_Camera/(C.S)C-outdoor4/DSC03657.JPG,char_data/2/DSC03657.JPG_2.jpg,400,480,640,16,310,326,425,450,True,4
2,34,kaist_dataset/Mixed/Digital_Camera/(C.S)C-outdoor4/DSC03660.JPG,char_data/2/DSC03660.JPG_2.jpg,986,480,640,29,456,485,96,130,True,4
2,47,kaist_dataset/Mixed/Digital_Camera/(C.S)C-outdoor4/DSC03662.JPG,char_data/2/DSC03662.JPG_2.jpg,1034,480,640,22,477,499,417,464,True,4
2,33,kaist_dataset/Mixed/Digital_Camera/(C.S)C-outdoor4/DSC03667.JPG,char_data/2/DSC03667.JPG_4.jpg,528,480,640,16,459,475,379,412,True,4
2,36,kaist_dataset/Mixed/Digital_Camera/(C.S)C-outdoor4/DSC03667.JPG,char_data/2/DSC03667.JPG_5.jpg,792,480,640,22,534,556,373,409,True,4
2,27,kaist_dataset/Mixed/Digital_Camera/(C.S)C-outdoor4/DSC03674.JPG,char_data/2/DSC03674.JPG_2.jpg,324,480,640,12,564,576,423,450,True,4
2,44,kaist_dataset/Mixed/Digital_Camera/(C.S)C-outdoor4/DSC03675.JPG,char_data/2/DSC03675.JPG_4.jpg,836,480,640,19,504,523,341,385,True,4
2,41,kaist_dataset/Mixed/Digital_Camera/(C.S)C-outdoor4/DSC03675.JPG,char_data/2/DSC03675.JPG_5.jpg,902,480,640,22,553,575,346,387,True,4
2,31,kaist_dataset/Mixed/Digital_Camera/(C.S)C-outdoor4/DSC03677.JPG,char_data/2/DSC03677.JPG_4.jpg,279,480,640,9,560,569,312,343,True,4
2,32,kaist_dataset/Mixed/Digital_Camera/(C.S)C-outdoor4/DSC03677.JPG,char_data/2/DSC03677.JPG_5.jpg,320,480,640,10,580,590,309,341,True,4
2,26,kaist_dataset/Mixed/Digital_Camera/(C.S)C-outdoor4/DSC03687.JPG,char_data/2/DSC03687.JPG_4.jpg,390,480,640,15,484,499,404,430,True,4
2,26,kaist_dataset/Mixed/Digital_Camera/(C.S)C-outdoor4/DSC03687.JPG,char_data/2/DSC03687.JPG_5.jpg,312,480,640,12,501,513,404,430,True,4
2,29,kaist_dataset/Mixed/Digital_Camera/(C.S)C-outdoor4/DSC03689.JPG,char_data/2/DSC03689.JPG_2.jpg,377,480,640,13,604,617,133,162,True,4
2,47,kaist_dataset/Mixed/Digital_Camera/(C.S)C-outdoor4/DSC03693.JPG,char_data/2/DSC03693.JPG_4.jpg,1222,480,640,26,549,575,351,398,True,4
2,36,kaist_dataset/Mixed/Digital_Camera/(C.S)C-outdoor4/DSC03693.JPG,char_data/2/DSC03693.JPG_5.jpg,432,480,640,12,590,602,357,393,True,4
2,46,kaist_dataset/Mixed/Digital_Camera/(C.S)C-outdoor4/DSC03702.JPG,char_data/2/DSC03702.JPG_2.jpg,1472,480,640,32,496,528,357,403,True,4
2,89,kaist_dataset/Mixed/Digital_Camera/(C.S)C-outdoor4/DSC03711.JPG,char_data/2/DSC03711.JPG_2.jpg,5429,480,640,61,467,528,99,188,True,4
2,35,kaist_dataset/Mixed/Digital_Camera/(C.S)C-outdoor4/DSC03722.JPG,char_data/2/DSC03722.JPG_2.jpg,1085,480,640,31,346,377,203,238,True,4
2,43,kaist_dataset/Mixed/Digital_Camera/(C.S)C-outdoor4/DSC03724.JPG,char_data/2/DSC03724.JPG_2.jpg,1032,480,640,24,400,424,275,318,True,4
2,35,kaist_dataset/Mixed/Digital_Camera/(C.S)C-outdoor4/DSC03730.JPG,char_data/2/DSC03730.JPG_4.jpg,840,480,640,24,529,553,247,282,True,4
2,71,kaist_dataset/Mixed/Digital_Camera/(C.S)C-outdoor4/DSC03730.JPG,char_data/2/DSC03730.JPG_5.jpg,4118,480,640,58,312,370,325,396,True,4
2,38,kaist_dataset/Mixed/Digital_Camera/(C.S)C-outdoor4/DSC03732.JPG,char_data/2/DSC03732.JPG_2.jpg,912,480,640,24,560,584,389,427,True,4
2,51,kaist_dataset/Mixed/Digital_Camera/(C.S)C-outdoor4/DSC03738.JPG,char_data/2/DSC03738.JPG_4.jpg,1734,480,640,34,371,405,232,283,True,4
2,49,kaist_dataset/Mixed/Digital_Camera/(C.S)C-outdoor4/DSC03738.JPG,char_data/2/DSC03738.JPG_5.jpg,1470,480,640,30,496,526,236,285,False,4
2,36,kaist_dataset/Mixed/Digital_Camera/(C.S)C-outdoor4/DSC03745.JPG,char_data/2/DSC03745.JPG_2.jpg,828,480,640,23,159,182,271,307,False,4
2,34,kaist_dataset/Mixed/Digital_Camera/(C.S)C-outdoor4/DSC03757.JPG,char_data/2/DSC03757.JPG_6.jpg,374,480,640,11,255,266,337,371,False,4
2,29,kaist_dataset/Mixed/Digital_Camera/(C.S)C-outdoor4/DSC03757.JPG,char_data/2/DSC03757.JPG_7.jpg,319,480,640,11,280,291,339,368,False,4
2,32,kaist_dataset/Mixed/Digital_Camera/(C.S)C-outdoor4/DSC03757.JPG,char_data/2/DSC03757.JPG_8.jpg,352,480,640,11,440,451,339,371,False,4
2,23,kaist_dataset/Mixed/Digital_Camera/(C.S)C-outdoor4/DSC03758.JPG,char_data/2/DSC03758.JPG_4.jpg,322,480,640,14,303,317,308,331,False,4
2,29,kaist_dataset/Mixed/Digital_Camera/(C.S)C-outdoor4/DSC03758.JPG,char_data/2/DSC03758.JPG_5.jpg,522,480,640,18,390,408,312,341,False,4
2,29,kaist_dataset/Mixed/Digital_Camera/(C.S)C-outdoor4/DSC03764.JPG,char_data/2/DSC03764.JPG_4.jpg,464,480,640,16,271,287,270,299,False,4
2,30,kaist_dataset/Mixed/Digital_Camera/(C.S)C-outdoor4/DSC03764.JPG,char_data/2/DSC03764.JPG_5.jpg,570,480,640,19,370,389,272,302,False,4
2,26,kaist_dataset/Mixed/Digital_Camera/(C.S)C-outdoor4/DSC03769.JPG,char_data/2/DSC03769.JPG_2.jpg,390,480,640,15,229,244,417,443,False,4
2,59,kaist_dataset/Mixed/Digital_Camera/(C.S)C-outdoor5/DSC03819.JPG,char_data/2/DSC03819.JPG_4.jpg,2478,480,640,42,223,265,118,177,False,4
2,36,kaist_dataset/Mixed/Digital_Camera/(C.S)C-outdoor5/DSC03819.JPG,char_data/2/DSC03819.JPG_5.jpg,432,480,640,12,454,466,373,409,False,4
2,41,kaist_dataset/Mixed/Digital_Camera/(C.S)C-outdoor5/DSC03821.JPG,char_data/2/DSC03821.JPG_2.jpg,984,480,640,24,254,278,78,119,False,4
2,67,kaist_dataset/Mixed/Digital_Camera/(C.S)C-outdoor5/DSC03837.JPG,char_data/2/DSC03837.JPG_2.jpg,2546,480,640,38,162,200,296,363,False,4
2,36,kaist_dataset/Mixed/Digital_Camera/(C.S)C-outdoor5/DSC03839.JPG,char_data/2/DSC03839.JPG_2.jpg,720,480,640,20,383,403,366,402,False,4
2,53,kaist_dataset/Mixed/Digital_Camera/(C.S)C-outdoor5/DSC03847.JPG,char_data/2/DSC03847.JPG_2.jpg,1431,480,640,27,382,409,16,69,False,4
2,44,kaist_dataset/Mixed/Digital_Camera/(C.S)C-outdoor5/DSC04014.JPG,char_data/2/DSC04014.JPG_4.jpg,792,480,640,18,246,264,300,344,False,4
2,38,kaist_dataset/Mixed/Digital_Camera/(C.S)C-outdoor5/DSC04014.JPG,char_data/2/DSC04014.JPG_5.jpg,950,480,640,25,421,446,303,341,False,4
2,80,kaist_dataset/Mixed/Digital_Camera/(C.S)C-outdoor5/DSC04016.JPG,char_data/2/DSC04016.JPG_2.jpg,4240,480,640,53,478,531,105,185,False,4
2,55,kaist_dataset/Mixed/Digital_Camera/(C.S)C-outdoor5/DSC04017.JPG,char_data/2/DSC04017.JPG_4.jpg,3850,480,640,70,110,180,3,58,False,4
2,50,kaist_dataset/Mixed/Digital_Camera/(C.S)C-outdoor5/DSC04017.JPG,char_data/2/DSC04017.JPG_5.jpg,1850,480,640,37,436,473,425,475,False,4
2,34,kaist_dataset/Mixed/Digital_Camera/(C.S)C-outdoor5/DSC04048.JPG,char_data/2/DSC04048.JPG_2.jpg,578,480,640,17,340,357,170,204,False,4
2,28,kaist_dataset/Mixed/Digital_Camera/(C.S)C-outdoor5/DSC04054.JPG,char_data/2/DSC04054.JPG_2.jpg,812,480,640,29,549,578,158,186,False,4
2,43,kaist_dataset/Mixed/Digital_Camera/(C.S)C-outdoor5/DSC04055.JPG,char_data/2/DSC04055.JPG_2.jpg,1505,480,640,35,540,575,373,416,False,4
2,36,kaist_dataset/Mixed/Digital_Camera/(C.S)C-outdoor5/DSC04056.JPG,char_data/2/DSC04056.JPG_4.jpg,1008,480,640,28,453,481,259,295,False,4
2,30,kaist_dataset/Mixed/Digital_Camera/(C.S)C-outdoor5/DSC04056.JPG,char_data/2/DSC04056.JPG_5.jpg,600,480,640,20,506,526,303,333,False,4
2,43,kaist_dataset/Mixed/Digital_Camera/(C.S)C-outdoor5/DSC04057.JPG,char_data/2/DSC04057.JPG_2.jpg,1376,480,640,32,502,534,323,366,False,4
2,43,kaist_dataset/Mixed/Digital_Camera/(C.S)C-outdoor5/DSC04071.JPG,char_data/2/DSC04071.JPG_6.jpg,1118,480,640,26,142,168,360,403,False,4
2,45,kaist_dataset/Mixed/Digital_Camera/(C.S)C-outdoor5/DSC04071.JPG,char_data/2/DSC04071.JPG_7.jpg,1080,480,640,24,212,236,358,403,False,4
2,34,kaist_dataset/Mixed/Digital_Camera/(C.S)C-outdoor5/DSC04071.JPG,char_data/2/DSC04071.JPG_8.jpg,646,480,640,19,510,529,366,400,False,4
2,44,kaist_dataset/Mixed/Digital_Camera/(C.S)C-outdoor5/DSC04094.JPG,char_data/2/DSC04094.JPG_2.jpg,1716,480,640,39,196,235,387,431,False,4
2,38,kaist_dataset/Mixed/Digital_Camera/(C.S)C-outdoor5/DSC04098.JPG,char_data/2/DSC04098.JPG_2.jpg,532,480,640,14,506,520,311,349,False,4
2,80,kaist_dataset/Mixed/Digital_Camera/(C.S)C-outdoor5/DSC04111.JPG,char_data/2/DSC04111.JPG_2.jpg,4400,480,640,55,473,528,103,183,False,4
2,35,kaist_dataset/Mixed/Digital_Camera/(C.S)C-outdoor5/DSC04122.JPG,char_data/2/DSC04122.JPG_2.jpg,420,480,640,12,359,371,413,448,False,4
2,32,kaist_dataset/Mixed/Digital_Camera/(C.S)C-outdoor5/DSC04124.JPG,char_data/2/DSC04124.JPG_2.jpg,512,480,640,16,493,509,307,339,False,4
2,45,kaist_dataset/Mixed/Digital_Camera/(C.S)C-outdoor5/DSC04125.JPG,char_data/2/DSC04125.JPG_6.jpg,1080,480,640,24,90,114,175,220,False,4
2,37,kaist_dataset/Mixed/Digital_Camera/(C.S)C-outdoor5/DSC04125.JPG,char_data/2/DSC04125.JPG_7.jpg,851,480,640,23,466,489,417,454,False,4
2,42,kaist_dataset/Mixed/Digital_Camera/(C.S)C-outdoor5/DSC04125.JPG,char_data/2/DSC04125.JPG_8.jpg,1218,480,640,29,569,598,413,455,False,4
2,46,kaist_dataset/Mixed/Digital_Camera/(C.S)C-outdoor5/DSC04135.JPG,char_data/2/DSC04135.JPG_4.jpg,1242,480,640,27,449,476,384,430,False,4
2,41,kaist_dataset/Mixed/Digital_Camera/(C.S)C-outdoor5/DSC04135.JPG,char_data/2/DSC04135.JPG_5.jpg,1025,480,640,25,487,512,392,433,False,4
2,41,kaist_dataset/Mixed/Digital_Camera/(C.S)C-outdoor5/DSC04144.JPG,char_data/2/DSC04144.JPG_2.jpg,820,480,640,20,284,304,414,455,False,4
2,30,kaist_dataset/Mixed/Digital_Camera/(C.S)C-outdoor5/DSC04146.JPG,char_data/2/DSC04146.JPG_4.jpg,510,480,640,17,306,323,406,436,False,4
2,28,kaist_dataset/Mixed/Digital_Camera/(C.S)C-outdoor5/DSC04146.JPG,char_data/2/DSC04146.JPG_5.jpg,532,480,640,19,332,351,409,437,False,4
2,29,kaist_dataset/Mixed/Digital_Camera/(C.S)C-outdoor5/DSC04150.JPG,char_data/2/DSC04150.JPG_2.jpg,348,480,640,12,518,530,364,393,False,4
2,25,kaist_dataset/Mixed/Digital_Camera/(C.S)C-outdoor5/DSC04151.JPG,char_data/2/DSC04151.JPG_2.jpg,425,480,640,17,512,529,349,374,False,4
2,30,kaist_dataset/Mixed/Digital_Camera/(C.S)C-outdoor5/DSC04155.JPG,char_data/2/DSC04155.JPG_2.jpg,450,480,640,15,557,572,264,294,False,4
2,139,kaist_dataset/Mixed/Digital_Camera/(C.S)C-outdoor5/DSC04330.JPG,char_data/2/DSC04330.JPG_8.jpg,8201,480,640,59,82,141,242,381,False,4
2,39,kaist_dataset/Mixed/Digital_Camera/(C.S)C-outdoor5/DSC04330.JPG,char_data/2/DSC04330.JPG_9.jpg,1092,480,640,28,421,449,171,210,False,4
2,51,kaist_dataset/Mixed/Digital_Camera/(C.S)C-outdoor5/DSC04330.JPG,char_data/2/DSC04330.JPG_10.jpg,1632,480,640,32,386,418,368,419,False,4
2,63,kaist_dataset/Mixed/Digital_Camera/(C.S)C-outdoor5/DSC04330.JPG,char_data/2/DSC04330.JPG_11.jpg,1638,480,640,26,461,487,360,423,False,4
2,42,kaist_dataset/Mixed/Digital_Camera/(C.S)C-outdoor5/DSC04337.JPG,char_data/2/DSC04337.JPG_4.jpg,882,480,640,21,352,373,318,360,False,4
2,41,kaist_dataset/Mixed/Digital_Camera/(C.S)C-outdoor5/DSC04337.JPG,char_data/2/DSC04337.JPG_5.jpg,1107,480,640,27,373,400,318,359,False,4
2,67,kaist_dataset/Mixed/Digital_Camera/(C.S)C-outdoor5/DSC04364.JPG,char_data/2/DSC04364.JPG_2.jpg,2345,480,640,35,182,217,391,458,False,4
2,63,kaist_dataset/Mixed/Digital_Camera/(C.S)C-outdoor5/DSC04401.JPG,char_data/2/DSC04401.JPG_2.jpg,2079,480,640,33,397,430,244,307,False,4
2,114,kaist_dataset/Mixed/Digital_Camera/(C.S)C-outdoor5/DSC04449.JPG,char_data/2/DSC04449.JPG_2.jpg,8550,480,640,75,142,217,37,151,False,4
2,67,kaist_dataset/Mixed/Digital_Camera/(C.S)C-outdoor5/DSC04450.JPG,char_data/2/DSC04450.JPG_2.jpg,4556,480,640,68,251,319,264,331,False,4
2,26,kaist_dataset/Mixed/Digital_Camera/(C.S)C-outdoor5/P1010004.JPG,char_data/2/P1010004.JPG_10.jpg,364,480,640,14,321,335,308,334,False,4
2,31,kaist_dataset/Mixed/Digital_Camera/(C.S)C-outdoor5/P1010004.JPG,char_data/2/P1010004.JPG_11.jpg,713,480,640,23,394,417,308,339,False,4
2,42,kaist_dataset/Mixed/Digital_Camera/(C.S)C-outdoor5/P1010007.JPG,char_data/2/P1010007.JPG_6.jpg,1218,480,640,29,288,317,269,311,False,4
2,38,kaist_dataset/Mixed/Digital_Camera/(C.S)C-outdoor5/P1010007.JPG,char_data/2/P1010007.JPG_7.jpg,988,480,640,26,441,467,273,311,False,4
2,39,kaist_dataset/Mixed/Digital_Camera/(C.S)C-outdoor5/P1010007.JPG,char_data/2/P1010007.JPG_8.jpg,1209,480,640,31,467,498,268,307,False,4
2,25,kaist_dataset/Mixed/Digital_Camera/(C.S)C-outdoor6/117.JPG,char_data/2/117.JPG_18.jpg,375,480,640,15,282,297,263,288,False,4
2,25,kaist_dataset/Mixed/Digital_Camera/(C.S)C-outdoor6/117.JPG,char_data/2/117.JPG_19.jpg,375,480,640,15,299,314,263,288,False,4
2,23,kaist_dataset/Mixed/Digital_Camera/(C.S)C-outdoor6/117.JPG,char_data/2/117.JPG_20.jpg,391,480,640,17,333,350,267,290,False,4
2,24,kaist_dataset/Mixed/Digital_Camera/(C.S)C-outdoor6/117.JPG,char_data/2/117.JPG_21.jpg,360,480,640,15,351,366,266,290,False,4
2,27,kaist_dataset/Mixed/Digital_Camera/(C.S)C-outdoor6/117.JPG,char_data/2/117.JPG_22.jpg,405,480,640,15,450,465,264,291,False,4
2,23,kaist_dataset/Mixed/Digital_Camera/(C.S)C-outdoor6/117.JPG,char_data/2/117.JPG_23.jpg,322,480,640,14,478,492,265,288,False,4
2,22,kaist_dataset/Mixed/Digital_Camera/(C.S)C-outdoor6/117.JPG,char_data/2/117.JPG_24.jpg,308,480,640,14,492,506,265,287,False,4
2,19,kaist_dataset/Mixed/Digital_Camera/(C.S)C-outdoor6/117.JPG,char_data/2/117.JPG_25.jpg,342,480,640,18,375,393,265,284,False,4
2,20,kaist_dataset/Mixed/Digital_Camera/(C.S)C-outdoor6/117.JPG,char_data/2/117.JPG_26.jpg,240,480,640,12,439,451,266,286,False,4
2,62,kaist_dataset/Mixed/Digital_Camera/(C.S)C-outdoor6/P1010017.JPG,char_data/2/P1010017.JPG_4.jpg,1798,480,640,29,389,418,181,243,False,4
2,67,kaist_dataset/Mixed/Digital_Camera/(C.S)C-outdoor6/P1010017.JPG,char_data/2/P1010017.JPG_5.jpg,1809,480,640,27,444,471,178,245,False,4
2,38,kaist_dataset/Mixed/Digital_Camera/(C.S)C-outdoor6/P1010018.JPG,char_data/2/P1010018.JPG_4.jpg,950,480,640,25,160,185,240,278,False,4
2,40,kaist_dataset/Mixed/Digital_Camera/(C.S)C-outdoor6/P1010018.JPG,char_data/2/P1010018.JPG_5.jpg,920,480,640,23,184,207,239,279,False,4
2,33,kaist_dataset/Mixed/Digital_Camera/(C.S)C-outdoor6/P1010020.JPG,char_data/2/P1010020.JPG_6.jpg,561,480,640,17,172,189,339,372,False,4
2,37,kaist_dataset/Mixed/Digital_Camera/(C.S)C-outdoor6/P1010020.JPG,char_data/2/P1010020.JPG_7.jpg,777,480,640,21,263,284,333,370,False,4
2,33,kaist_dataset/Mixed/Digital_Camera/(C.S)C-outdoor6/P1010020.JPG,char_data/2/P1010020.JPG_8.jpg,726,480,640,22,218,240,232,265,False,4
2,42,kaist_dataset/Mixed/Digital_Camera/(C.S)C-outdoor6/P1010021.JPG,char_data/2/P1010021.JPG_4.jpg,1092,480,640,26,140,166,210,252,False,4
2,39,kaist_dataset/Mixed/Digital_Camera/(C.S)C-outdoor6/P1010021.JPG,char_data/2/P1010021.JPG_5.jpg,936,480,640,24,589,613,201,240,False,4
2,48,kaist_dataset/Mixed/Digital_Camera/(C.S)C-outdoor6/P1010027.JPG,char_data/2/P1010027.JPG_2.jpg,1680,480,640,35,493,528,326,374,False,4
2,27,kaist_dataset/Mixed/Digital_Camera/(C.S)C-outdoor6/P1010062.JPG,char_data/2/P1010062.JPG_2.jpg,729,480,640,27,570,597,259,286,False,4
2,24,kaist_dataset/Mixed/Digital_Camera/(C.S)C-outdoor6/P1010063.JPG,char_data/2/P1010063.JPG_2.jpg,480,480,640,20,165,185,455,479,False,4
2,32,kaist_dataset/Mixed/Digital_Camera/(C.S)C-outdoor6/P1010065.JPG,char_data/2/P1010065.JPG_4.jpg,608,480,640,19,367,386,236,268,False,4
2,26,kaist_dataset/Mixed/Digital_Camera/(C.S)C-outdoor6/P1010065.JPG,char_data/2/P1010065.JPG_5.jpg,572,480,640,22,472,494,233,259,False,4
2,31,kaist_dataset/Mixed/Digital_Camera/(C.S)C-outdoor6/P1010069.JPG,char_data/2/P1010069.JPG_8.jpg,992,480,640,32,496,528,313,344,False,4
2,33,kaist_dataset/Mixed/Digital_Camera/(C.S)C-outdoor6/P1010080.JPG,char_data/2/P1010080.JPG_2.jpg,1122,480,640,34,584,618,247,280,False,4
2,49,kaist_dataset/Mixed/Digital_Camera/(C.S)C-outdoor6/P1010084.JPG,char_data/2/P1010084.JPG_2.jpg,1911,480,640,39,378,417,188,237,False,4
2,28,kaist_dataset/Mixed/Digital_Camera/(C.S)C-outdoor6/P1010085.JPG,char_data/2/P1010085.JPG_5.jpg,448,480,640,16,414,430,158,186,False,4
2,60,kaist_dataset/Mixed/Digital_Camera/(C.S)C-outdoor6/P1010087.JPG,char_data/2/P1010087.JPG_2.jpg,2580,480,640,43,304,347,171,231,False,4
2,28,kaist_dataset/Mixed/Digital_Camera/(C.S)C-outdoor6/P1010088.JPG,char_data/2/P1010088.JPG_4.jpg,336,480,640,12,386,398,215,243,False,4
2,27,kaist_dataset/Mixed/Digital_Camera/(C.S)C-outdoor6/P1010088.JPG,char_data/2/P1010088.JPG_5.jpg,567,480,640,21,398,419,217,244,False,4
2,32,kaist_dataset/Mixed/Digital_Camera/(C.S)C-outdoor6/P1010093.JPG,char_data/2/P1010093.JPG_2.jpg,480,480,640,15,554,569,243,275,False,4
2,18,kaist_dataset/Mixed/Digital_Camera/(C.S)C-outdoor6/P1010096.JPG,char_data/2/P1010096.JPG_2.jpg,288,480,640,16,433,449,207,225,False,4
2,39,kaist_dataset/Mixed/Digital_Camera/(C.S)C-outdoor6/P1010097.JPG,char_data/2/P1010097.JPG_6.jpg,741,480,640,19,158,177,174,213,False,4
2,32,kaist_dataset/Mixed/Digital_Camera/(C.S)C-outdoor6/P1010097.JPG,char_data/2/P1010097.JPG_7.jpg,864,480,640,27,175,202,177,209,False,4
2,30,kaist_dataset/Mixed/Digital_Camera/(C.S)C-outdoor6/P1010097.JPG,char_data/2/P1010097.JPG_8.jpg,600,480,640,20,553,573,182,212,False,4
2,39,kaist_dataset/Mixed/Digital_Camera/(C.S)C-outdoor6/P1010098.JPG,char_data/2/P1010098.JPG_2.jpg,1014,480,640,26,489,515,52,91,False,4
2,26,kaist_dataset/Mixed/Digital_Camera/(C.S)C-outdoor6/P1010103.JPG,char_data/2/P1010103.JPG_4.jpg,494,480,640,19,492,511,202,228,False,4
2,33,kaist_dataset/Mixed/Digital_Camera/(C.S)C-outdoor6/P1010103.JPG,char_data/2/P1010103.JPG_5.jpg,825,480,640,25,566,591,198,231,False,4
2,27,kaist_dataset/Mixed/Digital_Camera/(C.S)C-outdoor6/P1010114.JPG,char_data/2/P1010114.JPG_2.jpg,513,480,640,19,472,491,216,243,False,4
2,41,kaist_dataset/Mixed/Digital_Camera/(C.S)C-outdoor6/P1010120.JPG,char_data/2/P1010120.JPG_2.jpg,1148,480,640,28,395,423,192,233,False,4
2,50,kaist_dataset/Mixed/Digital_Camera/(C.S)C-outdoor6/P1010127.JPG,char_data/2/P1010127.JPG_2.jpg,2400,480,640,48,434,482,283,333,False,4
2,25,kaist_dataset/Mixed/Digital_Camera/(C.S)C-outdoor6/P1010129.JPG,char_data/2/P1010129.JPG_2.jpg,700,480,640,28,548,576,234,259,False,4
2,52,kaist_dataset/Mixed/Digital_Camera/(C.S)C-outdoor6/크기변환_20040626112330924_im_orz6564_netdkwk.jpg,char_data/2/크기변환_20040626112330924_im_orz6564_netdkwk.jpg_2.jpg,2132,480,640,41,384,425,358,410,False,4
2,33,kaist_dataset/Mixed/Digital_Camera/(C.S)C-outdoor6/크기변환_fadscf0009_creawell.jpg,char_data/2/크기변환_fadscf0009_creawell.jpg_4.jpg,528,480,640,16,324,340,157,190,False,4
2,34,kaist_dataset/Mixed/Digital_Camera/(C.S)C-outdoor6/크기변환_fadscf0009_creawell.jpg,char_data/2/크기변환_fadscf0009_creawell.jpg_5.jpg,510,480,640,15,440,455,166,200,False,4
2,32,kaist_dataset/Mixed/Digital_Camera/(C.S)C-outdoor6/크기변환_P1010029.JPG,char_data/2/크기변환_P1010029.JPG_2.jpg,608,480,640,19,13,32,13,45,False,4
2,38,kaist_dataset/Mixed/Digital_Camera/(C.S)D-indoor1/DSC02718.JPG,char_data/2/DSC02718.JPG_2.jpg,760,480,640,20,95,115,188,226,False,4
2,47,kaist_dataset/Mixed/Digital_Camera/(C.S)D-indoor1/DSC02733.JPG,char_data/2/DSC02733.JPG_4.jpg,1410,480,640,30,261,291,396,443,False,4
2,49,kaist_dataset/Mixed/Digital_Camera/(C.S)D-indoor1/DSC02733.JPG,char_data/2/DSC02733.JPG_5.jpg,1568,480,640,32,289,321,396,445,False,4
2,41,kaist_dataset/Mixed/Digital_Camera/(C.S)D-indoor1/DSC02782.JPG,char_data/2/DSC02782.JPG_2.jpg,1476,480,640,36,47,83,233,274,False,4
2,43,kaist_dataset/Mixed/Digital_Camera/(C.S)D-indoor1/DSC02785.JPG,char_data/2/DSC02785.JPG_2.jpg,1376,480,640,32,39,71,293,336,False,4
2,83,kaist_dataset/Mixed/Digital_Camera/(C.S)D-indoor1/DSC03466.JPG,char_data/2/DSC03466.JPG_2.jpg,6225,480,640,75,57,132,129,212,False,4
2,59,kaist_dataset/Mixed/Digital_Camera/(C.S)D-indoor1/DSC03980.JPG,char_data/2/DSC03980.JPG_2.jpg,2714,480,640,46,42,88,296,355,False,4
2,49,kaist_dataset/Mixed/Digital_Camera/(C.S)D-indoor1/DSC03986.JPG,char_data/2/DSC03986.JPG_4.jpg,784,480,640,16,181,197,161,210,False,4
2,45,kaist_dataset/Mixed/Digital_Camera/(C.S)D-indoor1/DSC03986.JPG,char_data/2/DSC03986.JPG_5.jpg,720,480,640,16,456,472,164,209,False,4
2,75,kaist_dataset/Mixed/Digital_Camera/(C.S)D-indoor1/DSC03999.JPG,char_data/2/DSC03999.JPG_2.jpg,3225,480,640,43,501,544,288,363,False,4
2,58,kaist_dataset/Mixed/Digital_Camera/(C.S)D-indoor1/DSC04002.JPG,char_data/2/DSC04002.JPG_2.jpg,2436,480,640,42,1,42,303,361,False,4
2,96,kaist_dataset/Mixed/Digital_Camera/(C.S)D-indoor1/DSC04003.JPG,char_data/2/DSC04003.JPG_2.jpg,6624,480,640,69,264,333,87,183,False,4
2,26,kaist_dataset/Mixed/Digital_Camera/(C.S)D-indoor1/DSC04005.JPG,char_data/2/DSC04005.JPG_2.jpg,442,480,640,17,440,457,439,465,False,4
2,43,kaist_dataset/Mixed/Digital_Camera/(C.S)D-indoor2/DSC04256.JPG,char_data/2/DSC04256.JPG_4.jpg,903,480,640,21,516,537,107,150,False,4
2,45,kaist_dataset/Mixed/Digital_Camera/(C.S)D-indoor2/DSC04256.JPG,char_data/2/DSC04256.JPG_5.jpg,900,480,640,20,475,495,142,187,False,4
2,64,kaist_dataset/Mixed/Digital_Camera/(C.S)D-indoor2/DSC04409.JPG,char_data/2/DSC04409.JPG_2.jpg,1600,480,640,25,499,524,156,220,False,4
2,39,kaist_dataset/Mixed/Digital_Camera/(C.S)E-night/DSC02569.JPG,char_data/2/DSC02569.JPG_2.jpg,819,480,640,21,292,313,412,451,False,4
2,66,kaist_dataset/Mixed/Digital_Camera/(C.S)E-night/DSC02573.JPG,char_data/2/DSC02573.JPG_2.jpg,2574,480,640,39,518,557,147,213,False,4
2,67,kaist_dataset/Mixed/Digital_Camera/(C.S)E-night/DSC02574.JPG,char_data/2/DSC02574.JPG_2.jpg,2144,480,640,32,441,473,409,476,False,4
2,50,kaist_dataset/Mixed/Digital_Camera/(C.S)E-night/DSC02575.JPG,char_data/2/DSC02575.JPG_4.jpg,1350,480,640,27,324,351,356,406,False,4
2,47,kaist_dataset/Mixed/Digital_Camera/(C.S)E-night/DSC02575.JPG,char_data/2/DSC02575.JPG_5.jpg,1504,480,640,32,496,528,363,410,False,4
2,36,kaist_dataset/Mixed/Digital_Camera/(C.S)E-night/DSC02585.JPG,char_data/2/DSC02585.JPG_2.jpg,612,480,640,17,481,498,417,453,False,4
2,68,kaist_dataset/Mixed/Digital_Camera/(C.S)E-night/DSC02600.JPG,char_data/2/DSC02600.JPG_2.jpg,5916,480,640,87,108,195,191,259,False,4
2,39,kaist_dataset/Mixed/Digital_Camera/(C.S)E-night/DSC02623.JPG,char_data/2/DSC02623.JPG_4.jpg,585,480,640,15,129,144,398,437,False,4
2,36,kaist_dataset/Mixed/Digital_Camera/(C.S)E-night/DSC02623.JPG,char_data/2/DSC02623.JPG_5.jpg,1188,480,640,33,571,604,406,442,False,4
2,32,kaist_dataset/Mixed/Digital_Camera/(C.S)E-night/DSC02644.JPG,char_data/2/DSC02644.JPG_2.jpg,544,480,640,17,395,412,401,433,False,4
2,40,kaist_dataset/Mixed/Digital_Camera/(C.S)E-night/DSC02673.JPG,char_data/2/DSC02673.JPG_6.jpg,600,480,640,15,314,329,301,341,False,4
2,28,kaist_dataset/Mixed/Digital_Camera/(C.S)E-night/DSC02673.JPG,char_data/2/DSC02673.JPG_7.jpg,476,480,640,17,482,499,305,333,False,4
2,36,kaist_dataset/Mixed/Digital_Camera/(C.S)E-night/DSC02673.JPG,char_data/2/DSC02673.JPG_8.jpg,612,480,640,17,507,524,304,340,False,4
2,31,kaist_dataset/Mixed/Digital_Camera/(C.S)E-night/DSC02678.JPG,char_data/2/DSC02678.JPG_2.jpg,527,480,640,17,461,478,389,420,False,4
2,29,kaist_dataset/Mixed/Digital_Camera/(C.S)E-night/DSC02903.JPG,char_data/2/DSC02903.JPG_2.jpg,522,480,640,18,336,354,269,298,False,4
2,51,kaist_dataset/Mixed/Digital_Camera/(C.S)E-night/DSC03561.JPG,char_data/2/DSC03561.JPG_2.jpg,1938,480,640,38,291,329,252,303,False,4
2,72,kaist_dataset/Mixed/Digital_Camera/(C.S)E-night/P1010151.JPG,char_data/2/P1010151.JPG_2.jpg,4104,480,640,57,275,332,355,427,False,4
2,23,kaist_dataset/Mixed/Digital_Camera/(C.S)E-night/P1010155.JPG,char_data/2/P1010155.JPG_4.jpg,299,480,640,13,462,475,286,309,False,4
2,23,kaist_dataset/Mixed/Digital_Camera/(C.S)E-night/P1010155.JPG,char_data/2/P1010155.JPG_5.jpg,299,480,640,13,493,506,288,311,False,4
2,98,kaist_dataset/Mixed/Digital_Camera/(C.S)F-others/097.jpg,char_data/2/097.jpg_2.jpg,6860,480,640,70,449,519,167,265,False,4
2,49,kaist_dataset/Mixed/Digital_Camera/(C.S)F-others/2007-12-08-day-113.jpg,char_data/2/2007-12-08-day-113.jpg_2.jpg,1176,1200,1600,24,919,943,422,471,False,4
2,36,kaist_dataset/Mixed/Digital_Camera/(C.S)F-others/DSC02504.JPG,char_data/2/DSC02504.JPG_2.jpg,1152,480,640,32,323,355,350,386,False,4
2,88,kaist_dataset/Mixed/Digital_Camera/(C.S)F-others/DSC03224.JPG,char_data/2/DSC03224.JPG_2.jpg,6160,480,640,70,186,256,341,429,False,4
2,36,kaist_dataset/Mixed/Mobile_Phone/(C.M)A-outdoor/P090908006.jpg,char_data/2/P090908006.jpg_2.jpg,504,480,640,14,354,368,367,403,False,4
2,35,kaist_dataset/Mixed/Mobile_Phone/(C.M)A-outdoor/P090912038.jpg,char_data/2/P090912038.jpg_2.jpg,630,480,640,18,393,411,159,194,False,4
2,33,kaist_dataset/Mixed/Mobile_Phone/(C.M)A-outdoor/P090912040.jpg,char_data/2/P090912040.jpg_4.jpg,660,480,640,20,158,178,189,222,False,4
2,26,kaist_dataset/Mixed/Mobile_Phone/(C.M)A-outdoor/P090912040.jpg,char_data/2/P090912040.jpg_5.jpg,572,480,640,22,178,200,193,219,False,4
2,38,kaist_dataset/Mixed/Mobile_Phone/(C.M)A-outdoor/P090912047.jpg,char_data/2/P090912047.jpg_4.jpg,760,480,640,20,251,271,277,315,False,4
2,40,kaist_dataset/Mixed/Mobile_Phone/(C.M)A-outdoor/P090912047.jpg,char_data/2/P090912047.jpg_5.jpg,800,480,640,20,272,292,279,319,False,4
2,63,kaist_dataset/Mixed/Mobile_Phone/(C.M)B-indoor/P090831007.jpg,char_data/2/P090831007.jpg_6.jpg,2835,480,640,45,123,168,200,263,False,4
2,61,kaist_dataset/Mixed/Mobile_Phone/(C.M)B-indoor/P090831007.jpg,char_data/2/P090831007.jpg_7.jpg,2562,480,640,42,315,357,207,268,False,4
2,68,kaist_dataset/Mixed/Mobile_Phone/(C.M)B-indoor/P090831007.jpg,char_data/2/P090831007.jpg_8.jpg,2924,480,640,43,440,483,203,271,False,4
2,120,kaist_dataset/Mixed/Mobile_Phone/(C.M)C-bookCover/P090831124.jpg,char_data/2/P090831124.jpg_2.jpg,9600,480,640,80,421,501,245,365,False,4
2,95,kaist_dataset/Mixed/Mobile_Phone/(C.M)C-bookCover/P090902019.jpg,char_data/2/P090902019.jpg_4.jpg,4750,480,640,50,36,86,74,169,False,4
2,75,kaist_dataset/Mixed/Mobile_Phone/(C.M)C-bookCover/P090902019.jpg,char_data/2/P090902019.jpg_5.jpg,3000,480,640,40,3,43,272,347,False,4
2,42,kaist_dataset/Mixed/Mobile_Phone/(C.M)C-bookCover/P090904004.jpg,char_data/2/P090904004.jpg_2.jpg,1260,480,640,30,578,608,399,441,False,4
0,26,kaist_dataset/English/Digital_Camera/(E.S)B-light/080116-0059.jpg,char_data/0/080116-0059.jpg_4.jpg,286,1200,1600,11,646,657,955,981,True,2
0,26,kaist_dataset/English/Digital_Camera/(E.S)B-light/080116-0059.jpg,char_data/0/080116-0059.jpg_5.jpg,338,1200,1600,13,656,669,953,979,True,2
0,37,kaist_dataset/English/Digital_Camera/(E.S)C-outdoor1/042.JPG,char_data/0/042.JPG_2.jpg,666,480,640,18,537,555,317,354,True,2
0,28,kaist_dataset/English/Digital_Camera/(E.S)C-outdoor1/056.JPG,char_data/0/056.JPG_4.jpg,252,480,640,9,570,579,248,276,True,2
0,33,kaist_dataset/English/Digital_Camera/(E.S)C-outdoor1/056.JPG,char_data/0/056.JPG_5.jpg,363,480,640,11,578,589,246,279,True,2
0,39,kaist_dataset/English/Digital_Camera/(E.S)C-outdoor1/080116-0065.jpg,char_data/0/080116-0065.jpg_6.jpg,975,600,800,25,369,394,203,242,True,2
0,39,kaist_dataset/English/Digital_Camera/(E.S)C-outdoor1/080116-0065.jpg,char_data/0/080116-0065.jpg_7.jpg,975,600,800,25,395,420,204,243,True,2
0,41,kaist_dataset/English/Digital_Camera/(E.S)C-outdoor1/080116-0065.jpg,char_data/0/080116-0065.jpg_8.jpg,902,600,800,22,352,374,380,421,True,2
0,45,kaist_dataset/English/Digital_Camera/(E.S)C-outdoor1/DSC02415.JPG,char_data/0/DSC02415.JPG_2.jpg,1350,480,640,30,604,634,248,293,True,2
0,37,kaist_dataset/English/Digital_Camera/(E.S)C-outdoor1/DSC02450.JPG,char_data/0/DSC02450.JPG_2.jpg,1147,480,640,31,394,425,224,261,True,2
0,194,kaist_dataset/English/Digital_Camera/(E.S)C-outdoor2/DSC02949.JPG,char_data/0/DSC02949.JPG_2.jpg,5626,480,640,29,390,419,58,252,True,2
0,46,kaist_dataset/English/Digital_Camera/(E.S)C-outdoor2/DSC03053.JPG,char_data/0/DSC03053.JPG_2.jpg,1150,480,640,25,487,512,126,172,True,2
0,40,kaist_dataset/English/Digital_Camera/(E.S)C-outdoor2/DSC03160.JPG,char_data/0/DSC03160.JPG_4.jpg,880,480,640,22,320,342,397,437,True,2
0,39,kaist_dataset/English/Digital_Camera/(E.S)C-outdoor2/DSC03160.JPG,char_data/0/DSC03160.JPG_5.jpg,858,480,640,22,342,364,399,438,True,2
0,56,kaist_dataset/English/Digital_Camera/(E.S)C-outdoor2/DSC03161.JPG,char_data/0/DSC03161.JPG_4.jpg,1792,480,640,32,169,201,223,279,True,2
0,55,kaist_dataset/English/Digital_Camera/(E.S)C-outdoor2/DSC03161.JPG,char_data/0/DSC03161.JPG_5.jpg,1925,480,640,35,233,268,221,276,True,2
0,34,kaist_dataset/English/Digital_Camera/(E.S)C-outdoor2/DSC03162.JPG,char_data/0/DSC03162.JPG_4.jpg,612,480,640,18,502,520,146,180,True,2
0,36,kaist_dataset/English/Digital_Camera/(E.S)C-outdoor2/DSC03162.JPG,char_data/0/DSC03162.JPG_5.jpg,648,480,640,18,522,540,146,182,True,2
0,53,kaist_dataset/English/Digital_Camera/(E.S)C-outdoor2/DSC03201.JPG,char_data/0/DSC03201.JPG_4.jpg,2332,480,640,44,271,315,9,62,True,2
0,50,kaist_dataset/English/Digital_Camera/(E.S)C-outdoor2/DSC03201.JPG,char_data/0/DSC03201.JPG_5.jpg,2100,480,640,42,319,361,11,61,True,2
0,39,kaist_dataset/English/Digital_Camera/(E.S)C-outdoor2/DSC03436.JPG,char_data/0/DSC03436.JPG_2.jpg,975,480,640,25,335,360,119,158,True,2
0,54,kaist_dataset/English/Digital_Camera/(E.S)C-outdoor2/DSC03650.JPG,char_data/0/DSC03650.JPG_2.jpg,1782,480,640,33,359,392,292,346,True,2
0,78,kaist_dataset/English/Digital_Camera/(E.S)C-outdoor2/DSC03731.JPG,char_data/0/DSC03731.JPG_8.jpg,5850,480,640,75,380,455,29,107,True,2
0,81,kaist_dataset/English/Digital_Camera/(E.S)C-outdoor2/DSC03731.JPG,char_data/0/DSC03731.JPG_9.jpg,6723,480,640,83,441,524,26,107,True,2
0,26,kaist_dataset/English/Digital_Camera/(E.S)C-outdoor2/DSC03731.JPG,char_data/0/DSC03731.JPG_10.jpg,286,480,640,11,579,590,116,142,True,2
0,28,kaist_dataset/English/Digital_Camera/(E.S)C-outdoor2/DSC03731.JPG,char_data/0/DSC03731.JPG_11.jpg,252,480,640,9,591,600,117,145,True,2
0,47,kaist_dataset/English/Digital_Camera/(E.S)C-outdoor3/P1010086.JPG,char_data/0/P1010086.JPG_4.jpg,1504,480,640,32,493,525,95,142,True,2
0,51,kaist_dataset/English/Digital_Camera/(E.S)C-outdoor3/P1010086.JPG,char_data/0/P1010086.JPG_5.jpg,1224,480,640,24,549,573,94,145,True,2
0,23,kaist_dataset/English/Digital_Camera/(E.S)C-outdoor3/크기변환_P1010076.JPG,char_data/0/크기변환_P1010076.JPG_2.jpg,414,480,640,18,512,530,182,205,True,2
0,54,kaist_dataset/English/Digital_Camera/(E.S)D-indoor/080119-0009.jpg,char_data/0/080119-0009.jpg_4.jpg,1296,1200,1600,24,346,370,1147,1199,True,2
0,53,kaist_dataset/English/Digital_Camera/(E.S)D-indoor/080119-0009.jpg,char_data/0/080119-0009.jpg_5.jpg,1219,1200,1600,23,371,394,1125,1178,True,2
0,56,kaist_dataset/English/Digital_Camera/(E.S)F-others/080116-0058.jpg,char_data/0/080116-0058.jpg_2.jpg,896,1200,1600,16,1255,1271,1019,1075,True,2
0,37,kaist_dataset/English/Digital_Camera/(E.S)F-others/m.jpg,char_data/0/m.jpg_6.jpg,555,240,320,15,181,196,162,199,True,2
0,40,kaist_dataset/English/Digital_Camera/(E.S)F-others/m.jpg,char_data/0/m.jpg_7.jpg,720,240,320,18,162,180,165,205,True,2
0,30,kaist_dataset/English/Digital_Camera/(E.S)F-others/m.jpg,char_data/0/m.jpg_8.jpg,630,240,320,21,197,218,163,193,True,2
0,43,kaist_dataset/Korean/Digital_Camera/A-shadow/2007-12-09-day-exterior-025.jpg,char_data/0/2007-12-09-day-exterior-025.jpg_4.jpg,1161,1200,1600,27,1093,1120,741,784,True,2
0,50,kaist_dataset/Korean/Digital_Camera/A-shadow/2007-12-09-day-exterior-025.jpg,char_data/0/2007-12-09-day-exterior-025.jpg_5.jpg,1650,1200,1600,33,1122,1155,741,791,True,2
0,48,kaist_dataset/Korean/Digital_Camera/A-shadow/2007-12-09-day-exterior-040.jpg,char_data/0/2007-12-09-day-exterior-040.jpg_2.jpg,912,1200,1600,19,1056,1075,809,857,True,2
0,44,kaist_dataset/Korean/Digital_Camera/A-shadow/DSC03536.JPG,char_data/0/DSC03536.JPG_4.jpg,1144,480,640,26,70,96,274,318,True,2
0,40,kaist_dataset/Korean/Digital_Camera/A-shadow/DSC03536.JPG,char_data/0/DSC03536.JPG_5.jpg,1120,480,640,28,124,152,274,314,True,2
0,75,kaist_dataset/Korean/Digital_Camera/A-shadow/DSC03755.JPG,char_data/0/DSC03755.JPG_4.jpg,2025,480,640,27,185,212,208,283,True,2
0,75,kaist_dataset/Korean/Digital_Camera/A-shadow/DSC03755.JPG,char_data/0/DSC03755.JPG_5.jpg,2850,480,640,38,245,283,209,284,True,2
0,25,kaist_dataset/Korean/Digital_Camera/A-shadow/DSC04297.JPG,char_data/0/DSC04297.JPG_4.jpg,425,480,640,17,330,347,210,235,True,2
0,34,kaist_dataset/Korean/Digital_Camera/A-shadow/DSC04297.JPG,char_data/0/DSC04297.JPG_5.jpg,612,480,640,18,492,510,207,241,True,2
0,124,kaist_dataset/Korean/Digital_Camera/A-shadow/DSC04300.JPG,char_data/0/DSC04300.JPG_2.jpg,6200,480,640,50,403,453,240,364,True,2
0,32,kaist_dataset/Korean/Digital_Camera/E-night/DSC02626.JPG,char_data/0/DSC02626.JPG_4.jpg,512,480,640,16,33,49,382,414,True,2
0,27,kaist_dataset/Korean/Digital_Camera/E-night/DSC02626.JPG,char_data/0/DSC02626.JPG_5.jpg,378,480,640,14,216,230,372,399,True,2
0,46,kaist_dataset/Korean/Digital_Camera/E-night/DSC02649.JPG,char_data/0/DSC02649.JPG_4.jpg,966,480,640,21,525,546,392,438,True,2
0,45,kaist_dataset/Korean/Digital_Camera/E-night/DSC02649.JPG,char_data/0/DSC02649.JPG_5.jpg,1125,480,640,25,581,606,390,435,True,2
0,50,kaist_dataset/Korean/Digital_Camera/E-night/DSC03019.JPG,char_data/0/DSC03019.JPG_4.jpg,2000,480,640,40,351,391,185,235,True,2
0,51,kaist_dataset/Korean/Digital_Camera/E-night/DSC03019.JPG,char_data/0/DSC03019.JPG_5.jpg,2499,480,640,49,457,506,180,231,True,2
0,41,kaist_dataset/Korean/Digital_Camera/E-night/DSC03515.JPG,char_data/0/DSC03515.JPG_4.jpg,902,480,640,22,380,402,274,315,True,2
0,45,kaist_dataset/Korean/Digital_Camera/E-night/DSC03515.JPG,char_data/0/DSC03515.JPG_5.jpg,1125,480,640,25,576,601,270,315,True,2
0,41,kaist_dataset/Korean/Digital_Camera/E-night/DSC03850.JPG,char_data/0/DSC03850.JPG_2.jpg,615,480,640,15,405,420,422,463,True,2
0,42,kaist_dataset/Korean/Digital_Camera/E-night/DSC03870.JPG,char_data/0/DSC03870.JPG_4.jpg,1008,480,640,24,275,299,154,196,True,2
0,44,kaist_dataset/Korean/Digital_Camera/E-night/DSC03870.JPG,char_data/0/DSC03870.JPG_5.jpg,1144,480,640,26,299,325,150,194,True,2
0,26,kaist_dataset/Korean/Digital_Camera/E-night/P1010146.JPG,char_data/0/P1010146.JPG_6.jpg,702,480,640,27,179,206,251,277,True,2
0,26,kaist_dataset/Korean/Digital_Camera/E-night/P1010146.JPG,char_data/0/P1010146.JPG_7.jpg,442,480,640,17,217,234,252,278,True,2
0,31,kaist_dataset/Korean/Digital_Camera/E-night/P1010146.JPG,char_data/0/P1010146.JPG_8.jpg,403,480,640,13,261,274,247,278,True,2
0,120,kaist_dataset/Korean/Digital_Camera/F-bookCover/DSC04229.JPG,char_data/0/DSC04229.JPG_6.jpg,11040,480,640,92,125,217,165,285,True,2
0,129,kaist_dataset/Korean/Digital_Camera/F-bookCover/DSC04229.JPG,char_data/0/DSC04229.JPG_7.jpg,10062,480,640,78,220,298,164,293,True,2
0,130,kaist_dataset/Korean/Digital_Camera/F-bookCover/DSC04229.JPG,char_data/0/DSC04229.JPG_8.jpg,10270,480,640,79,297,376,165,295,True,2
0,46,kaist_dataset/Korean/Digital_Camera/G-others/005.JPG,char_data/0/005.JPG_4.jpg,1012,768,576,22,348,370,394,440,True,2
0,50,kaist_dataset/Korean/Digital_Camera/G-others/005.JPG,char_data/0/005.JPG_5.jpg,1050,768,576,21,365,386,378,428,True,2
0,47,kaist_dataset/Korean/Digital_Camera/G-others/2007-12-08-day-045.jpg,char_data/0/2007-12-08-day-045.jpg_2.jpg,658,1200,1600,14,31,45,803,850,True,2
0,90,kaist_dataset/Korean/Digital_Camera/G-others/2007-12-08-day-108.jpg,char_data/0/2007-12-08-day-108.jpg_8.jpg,4680,1200,1600,52,559,611,574,664,True,2
0,80,kaist_dataset/Korean/Digital_Camera/G-others/2007-12-08-day-108.jpg,char_data/0/2007-12-08-day-108.jpg_9.jpg,3120,1200,1600,39,858,897,678,758,True,2
0,101,kaist_dataset/Korean/Digital_Camera/G-others/2007-12-08-day-108.jpg,char_data/0/2007-12-08-day-108.jpg_10.jpg,5656,1200,1600,56,568,624,676,777,True,2
0,82,kaist_dataset/Korean/Digital_Camera/G-others/2007-12-08-day-108.jpg,char_data/0/2007-12-08-day-108.jpg_11.jpg,3198,1200,1600,39,870,909,761,843,True,2
0,18,kaist_dataset/Korean/Digital_Camera/G-others/2007-12-08-day-112.jpg,char_data/0/2007-12-08-day-112.jpg_2.jpg,180,1200,1600,10,427,437,1183,1199,True,2
0,107,kaist_dataset/Korean/Digital_Camera/G-others/2007-12-09-day-exterior-062.jpg,char_data/0/2007-12-09-day-exterior-062.jpg_2.jpg,3638,1600,1200,34,597,631,1400,1507,True,2
0,45,kaist_dataset/Korean/Digital_Camera/G-others/DSC03862.JPG,char_data/0/DSC03862.JPG_4.jpg,900,480,640,20,353,373,351,396,True,2
0,42,kaist_dataset/Korean/Digital_Camera/G-others/DSC03862.JPG,char_data/0/DSC03862.JPG_5.jpg,882,480,640,21,373,394,354,396,True,2
0,69,kaist_dataset/Korean/Digital_Camera/indoor1/080119-0018.jpg,char_data/0/080119-0018.jpg_16.jpg,2415,1200,1600,35,818,853,432,501,True,2
0,57,kaist_dataset/Korean/Digital_Camera/indoor1/080119-0018.jpg,char_data/0/080119-0018.jpg_17.jpg,1995,1200,1600,35,1014,1049,770,827,True,2
0,53,kaist_dataset/Korean/Digital_Camera/indoor1/080119-0018.jpg,char_data/0/080119-0018.jpg_18.jpg,1696,1200,1600,32,1050,1082,774,827,True,2
0,49,kaist_dataset/Korean/Digital_Camera/indoor1/080119-0018.jpg,char_data/0/080119-0018.jpg_19.jpg,1421,1200,1600,29,1083,1112,776,825,True,2
0,50,kaist_dataset/Korean/Digital_Camera/indoor1/080119-0018.jpg,char_data/0/080119-0018.jpg_20.jpg,1750,1200,1600,35,1129,1164,777,827,True,2
0,49,kaist_dataset/Korean/Digital_Camera/indoor1/080119-0018.jpg,char_data/0/080119-0018.jpg_21.jpg,1421,1200,1600,29,1163,1192,777,826,True,2
0,49,kaist_dataset/Korean/Digital_Camera/indoor1/080119-0018.jpg,char_data/0/080119-0018.jpg_22.jpg,1519,1200,1600,31,1194,1225,775,824,True,2
0,48,kaist_dataset/Korean/Digital_Camera/indoor1/080119-0018.jpg,char_data/0/080119-0018.jpg_23.jpg,1632,1200,1600,34,912,946,934,982,True,2
0,81,kaist_dataset/Korean/Digital_Camera/indoor1/080119-0030.jpg,char_data/0/080119-0030.jpg_2.jpg,4212,1200,1600,52,1010,1062,439,520,True,2
0,195,kaist_dataset/Korean/Digital_Camera/indoor1/DSC02699.JPG,char_data/0/DSC02699.JPG_4.jpg,21645,480,640,111,273,384,229,424,True,2
0,191,kaist_dataset/Korean/Digital_Camera/indoor1/DSC02699.JPG,char_data/0/DSC02699.JPG_5.jpg,20055,480,640,105,385,490,229,420,True,2
0,148,kaist_dataset/Korean/Digital_Camera/indoor1/DSC02700.JPG,char_data/0/DSC02700.JPG_6.jpg,14652,480,640,99,342,441,215,363,True,2
0,146,kaist_dataset/Korean/Digital_Camera/indoor1/DSC02700.JPG,char_data/0/DSC02700.JPG_7.jpg,13724,480,640,94,441,535,215,361,True,2
0,32,kaist_dataset/Korean/Digital_Camera/indoor1/DSC02700.JPG,char_data/0/DSC02700.JPG_8.jpg,544,480,640,17,287,304,423,455,True,2
0,34,kaist_dataset/Korean/Digital_Camera/indoor1/DSC03362.JPG,char_data/0/DSC03362.JPG_4.jpg,408,480,640,12,85,97,281,315,True,2
0,36,kaist_dataset/Korean/Digital_Camera/indoor1/DSC03362.JPG,char_data/0/DSC03362.JPG_5.jpg,504,480,640,14,107,121,276,312,True,2
0,88,kaist_dataset/Korean/Digital_Camera/indoor1/DSC03364.JPG,char_data/0/DSC03364.JPG_4.jpg,5456,480,640,62,417,479,237,325,True,2
0,88,kaist_dataset/Korean/Digital_Camera/indoor1/DSC03364.JPG,char_data/0/DSC03364.JPG_5.jpg,5192,480,640,59,478,537,236,324,True,2
0,123,kaist_dataset/Korean/Digital_Camera/indoor1/DSC03374.JPG,char_data/0/DSC03374.JPG_6.jpg,9102,480,640,74,213,287,292,415,True,2
0,114,kaist_dataset/Korean/Digital_Camera/indoor1/DSC03374.JPG,char_data/0/DSC03374.JPG_7.jpg,8664,480,640,76,289,365,290,404,True,2
0,120,kaist_dataset/Korean/Digital_Camera/indoor1/DSC03374.JPG,char_data/0/DSC03374.JPG_8.jpg,10560,480,640,88,366,454,289,409,True,2
0,126,kaist_dataset/Korean/Digital_Camera/indoor1/DSC03375.JPG,char_data/0/DSC03375.JPG_4.jpg,9702,480,640,77,368,445,158,284,True,2
0,121,kaist_dataset/Korean/Digital_Camera/indoor1/DSC03375.JPG,char_data/0/DSC03375.JPG_5.jpg,9075,480,640,75,446,521,159,280,True,2
0,58,kaist_dataset/Korean/Digital_Camera/indoor2/DSC03474.JPG,char_data/0/DSC03474.JPG_2.jpg,2378,480,640,41,95,136,157,215,True,2
0,64,kaist_dataset/Korean/Digital_Camera/indoor2/DSC03475.JPG,char_data/0/DSC03475.JPG_2.jpg,3328,480,640,52,63,115,95,159,True,2
0,50,kaist_dataset/Korean/Digital_Camera/indoor2/DSC03497.JPG,char_data/0/DSC03497.JPG_6.jpg,1500,480,640,30,270,300,2,52,True,2
0,52,kaist_dataset/Korean/Digital_Camera/indoor2/DSC03497.JPG,char_data/0/DSC03497.JPG_7.jpg,1612,480,640,31,301,332,2,54,True,2
0,53,kaist_dataset/Korean/Digital_Camera/indoor2/DSC03497.JPG,char_data/0/DSC03497.JPG_8.jpg,1537,480,640,29,334,363,5,58,True,2
0,39,kaist_dataset/Korean/Digital_Camera/indoor2/DSC03530.JPG,char_data/0/DSC03530.JPG_4.jpg,702,480,640,18,232,250,216,255,True,2
0,41,kaist_dataset/Korean/Digital_Camera/indoor2/DSC03530.JPG,char_data/0/DSC03530.JPG_5.jpg,902,480,640,22,249,271,219,260,True,2
0,50,kaist_dataset/Korean/Digital_Camera/indoor2/DSC03560.JPG,char_data/0/DSC03560.JPG_2.jpg,1350,480,640,27,368,395,60,110,True,2
0,30,kaist_dataset/Korean/Digital_Camera/indoor2/DSC03564.JPG,char_data/0/DSC03564.JPG_8.jpg,600,480,640,20,255,275,410,440,True,2
0,27,kaist_dataset/Korean/Digital_Camera/indoor2/DSC03564.JPG,char_data/0/DSC03564.JPG_9.jpg,270,480,640,10,342,352,404,431,True,2
0,32,kaist_dataset/Korean/Digital_Camera/indoor2/DSC03564.JPG,char_data/0/DSC03564.JPG_10.jpg,480,480,640,15,421,436,401,433,True,2
0,26,kaist_dataset/Korean/Digital_Camera/indoor2/DSC03564.JPG,char_data/0/DSC03564.JPG_11.jpg,468,480,640,18,436,454,401,427,True,2
0,70,kaist_dataset/Korean/Digital_Camera/indoor2/DSC03902.JPG,char_data/0/DSC03902.JPG_4.jpg,3220,480,640,46,114,160,130,200,True,2
0,71,kaist_dataset/Korean/Digital_Camera/indoor2/DSC03902.JPG,char_data/0/DSC03902.JPG_5.jpg,3337,480,640,47,159,206,127,198,True,2
0,33,kaist_dataset/Korean/Digital_Camera/indoor2/DSC03975.JPG,char_data/0/DSC03975.JPG_2.jpg,660,480,640,20,207,227,289,322,True,2
0,52,kaist_dataset/Korean/Digital_Camera/indoor2/DSC03994.JPG,char_data/0/DSC03994.JPG_4.jpg,1560,480,640,30,428,458,288,340,True,2
0,52,kaist_dataset/Korean/Digital_Camera/indoor2/DSC03994.JPG,char_data/0/DSC03994.JPG_5.jpg,1456,480,640,28,487,515,290,342,True,2
0,43,kaist_dataset/Korean/Digital_Camera/indoor2/DSC03995.JPG,char_data/0/DSC03995.JPG_4.jpg,1161,480,640,27,495,522,267,310,True,2
0,42,kaist_dataset/Korean/Digital_Camera/indoor2/DSC03995.JPG,char_data/0/DSC03995.JPG_5.jpg,1092,480,640,26,546,572,263,305,True,2
0,53,kaist_dataset/Korean/Digital_Camera/indoor2/DSC04204.JPG,char_data/0/DSC04204.JPG_6.jpg,1643,480,640,31,444,475,204,257,True,2
0,55,kaist_dataset/Korean/Digital_Camera/indoor2/DSC04204.JPG,char_data/0/DSC04204.JPG_7.jpg,1815,480,640,33,475,508,205,260,True,2
0,38,kaist_dataset/Korean/Digital_Camera/indoor2/DSC04204.JPG,char_data/0/DSC04204.JPG_8.jpg,760,480,640,20,415,435,281,319,True,2
0,88,kaist_dataset/Korean/Digital_Camera/indoor2/크기변환_%BD%C7%B3%BB%B0%A3%C6%C7_moon8481.jpg,char_data/0/크기변환_%BD%C7%B3%BB%B0%A3%C6%C7_moon8481.jpg_6.jpg,5016,480,640,57,72,129,341,429,True,2
0,91,kaist_dataset/Korean/Digital_Camera/indoor2/크기변환_%BD%C7%B3%BB%B0%A3%C6%C7_moon8481.jpg,char_data/0/크기변환_%BD%C7%B3%BB%B0%A3%C6%C7_moon8481.jpg_7.jpg,3913,480,640,43,159,202,336,427,True,2
0,79,kaist_dataset/Korean/Digital_Camera/indoor2/크기변환_%BD%C7%B3%BB%B0%A3%C6%C7_moon8481.jpg,char_data/0/크기변환_%BD%C7%B3%BB%B0%A3%C6%C7_moon8481.jpg_8.jpg,3950,480,640,50,282,332,340,419,True,2
0,17,kaist_dataset/Korean/Digital_Camera/outdoor1/006.JPG,char_data/0/006.JPG_2.jpg,289,480,640,17,424,441,254,271,True,2
0,20,kaist_dataset/Korean/Digital_Camera/outdoor1/013.JPG,char_data/0/013.JPG_2.jpg,160,480,640,8,419,427,249,269,True,2
0,19,kaist_dataset/Korean/Digital_Camera/outdoor1/017.JPG,char_data/0/017.JPG_2.jpg,399,480,640,21,522,543,273,292,True,2
0,27,kaist_dataset/Korean/Digital_Camera/outdoor1/023.JPG,char_data/0/023.JPG_2.jpg,864,480,640,32,302,334,270,297,True,2
0,31,kaist_dataset/Korean/Digital_Camera/outdoor1/032.JPG,char_data/0/032.JPG_2.jpg,651,480,640,21,157,178,257,288,True,2
0,26,kaist_dataset/Korean/Digital_Camera/outdoor1/035.JPG,char_data/0/035.JPG_2.jpg,520,480,640,20,559,579,291,317,True,2
0,35,kaist_dataset/Korean/Digital_Camera/outdoor1/091.JPG,char_data/0/091.JPG_2.jpg,875,480,640,25,361,386,286,321,True,2
0,35,kaist_dataset/Korean/Digital_Camera/outdoor1/123.JPG,char_data/0/123.JPG_6.jpg,700,480,640,20,310,330,273,308,True,2
0,36,kaist_dataset/Korean/Digital_Camera/outdoor1/123.JPG,char_data/0/123.JPG_7.jpg,792,480,640,22,474,496,273,309,True,2
0,36,kaist_dataset/Korean/Digital_Camera/outdoor1/123.JPG,char_data/0/123.JPG_8.jpg,756,480,640,21,245,266,276,312,True,2
0,33,kaist_dataset/Korean/Digital_Camera/outdoor1/125.JPG,char_data/0/125.JPG_2.jpg,792,480,640,24,370,394,255,288,True,2
0,29,kaist_dataset/Korean/Digital_Camera/outdoor1/126.JPG,char_data/0/126.JPG_4.jpg,348,480,640,12,445,457,257,286,True,2
0,16,kaist_dataset/Korean/Digital_Camera/outdoor1/126.JPG,char_data/0/126.JPG_5.jpg,272,480,640,17,578,595,259,275,True,2
0,34,kaist_dataset/Korean/Digital_Camera/outdoor1/128.JPG,char_data/0/128.JPG_2.jpg,442,480,640,13,394,407,116,150,True,2
0,68,kaist_dataset/Korean/Digital_Camera/outdoor2/2007-12-08-day-101.jpg,char_data/0/2007-12-08-day-101.jpg_6.jpg,2720,1200,1600,40,858,898,638,706,True,2
0,41,kaist_dataset/Korean/Digital_Camera/outdoor2/2007-12-08-day-101.jpg,char_data/0/2007-12-08-day-101.jpg_7.jpg,820,1200,1600,20,770,790,741,782,True,2
0,41,kaist_dataset/Korean/Digital_Camera/outdoor2/2007-12-08-day-101.jpg,char_data/0/2007-12-08-day-101.jpg_8.jpg,738,1200,1600,18,790,808,743,784,True,2
0,38,kaist_dataset/Korean/Digital_Camera/outdoor2/2007-12-09-day-exterior-036.jpg,char_data/0/2007-12-09-day-exterior-036.jpg_4.jpg,836,1200,1600,22,1518,1540,630,668,True,2
0,39,kaist_dataset/Korean/Digital_Camera/outdoor2/2007-12-09-day-exterior-036.jpg,char_data/0/2007-12-09-day-exterior-036.jpg_5.jpg,819,1200,1600,21,1536,1557,630,669,True,2
0,31,kaist_dataset/Korean/Digital_Camera/outdoor2/DSC02299.JPG,char_data/0/DSC02299.JPG_2.jpg,496,480,640,16,613,629,211,242,True,2
0,29,kaist_dataset/Korean/Digital_Camera/outdoor2/DSC02310.JPG,char_data/0/DSC02310.JPG_2.jpg,783,480,640,27,321,348,211,240,True,2
0,38,kaist_dataset/Korean/Digital_Camera/outdoor2/DSC02327.JPG,char_data/0/DSC02327.JPG_6.jpg,1102,480,640,29,281,310,358,396,True,2
0,28,kaist_dataset/Korean/Digital_Camera/outdoor2/DSC02327.JPG,char_data/0/DSC02327.JPG_7.jpg,840,480,640,30,476,506,368,396,True,2
0,33,kaist_dataset/Korean/Digital_Camera/outdoor2/DSC02327.JPG,char_data/0/DSC02327.JPG_8.jpg,1122,480,640,34,506,540,367,400,True,2
0,30,kaist_dataset/Korean/Digital_Camera/outdoor2/DSC02380.JPG,char_data/0/DSC02380.JPG_4.jpg,510,480,640,17,400,417,236,266,True,2
0,30,kaist_dataset/Korean/Digital_Camera/outdoor2/DSC02380.JPG,char_data/0/DSC02380.JPG_5.jpg,510,480,640,17,446,463,236,266,True,2
0,30,kaist_dataset/Korean/Digital_Camera/outdoor2/DSC02383.JPG,char_data/0/DSC02383.JPG_6.jpg,480,480,640,16,145,161,293,323,True,2
0,37,kaist_dataset/Korean/Digital_Camera/outdoor2/DSC02383.JPG,char_data/0/DSC02383.JPG_7.jpg,444,480,640,12,223,235,286,323,True,2
0,34,kaist_dataset/Korean/Digital_Camera/outdoor2/DSC02383.JPG,char_data/0/DSC02383.JPG_8.jpg,544,480,640,16,262,278,288,322,True,2
0,35,kaist_dataset/Korean/Digital_Camera/outdoor2/DSC02396.JPG,char_data/0/DSC02396.JPG_8.jpg,735,480,640,21,191,212,184,219,True,2
0,30,kaist_dataset/Korean/Digital_Camera/outdoor2/DSC02396.JPG,char_data/0/DSC02396.JPG_9.jpg,480,480,640,16,215,231,186,216,True,2
0,38,kaist_dataset/Korean/Digital_Camera/outdoor2/DSC02396.JPG,char_data/0/DSC02396.JPG_10.jpg,798,480,640,21,457,478,368,406,True,2
0,42,kaist_dataset/Korean/Digital_Camera/outdoor2/DSC02396.JPG,char_data/0/DSC02396.JPG_11.jpg,966,480,640,23,477,500,363,405,True,2
0,47,kaist_dataset/Korean/Digital_Camera/outdoor2/DSC02414.JPG,char_data/0/DSC02414.JPG_4.jpg,2021,480,640,43,103,146,241,288,True,2
0,44,kaist_dataset/Korean/Digital_Camera/outdoor2/DSC02414.JPG,char_data/0/DSC02414.JPG_5.jpg,1892,480,640,43,402,445,242,286,True,2
0,24,kaist_dataset/Korean/Digital_Camera/outdoor2/DSC02424.JPG,char_data/0/DSC02424.JPG_2.jpg,480,480,640,20,554,574,245,269,True,2
0,34,kaist_dataset/Korean/Digital_Camera/outdoor2/DSC02426.JPG,char_data/0/DSC02426.JPG_4.jpg,1156,480,640,34,330,364,219,253,True,2
0,34,kaist_dataset/Korean/Digital_Camera/outdoor2/DSC02426.JPG,char_data/0/DSC02426.JPG_5.jpg,986,480,640,29,531,560,215,249,True,2
0,31,kaist_dataset/Korean/Digital_Camera/outdoor2/DSC02435.JPG,char_data/0/DSC02435.JPG_4.jpg,434,480,640,14,412,426,245,276,True,2
0,24,kaist_dataset/Korean/Digital_Camera/outdoor2/DSC02435.JPG,char_data/0/DSC02435.JPG_5.jpg,408,480,640,17,439,456,247,271,True,2
0,30,kaist_dataset/Korean/Digital_Camera/outdoor2/DSC02467.JPG,char_data/0/DSC02467.JPG_2.jpg,780,480,640,26,295,321,256,286,True,2
0,55,kaist_dataset/Korean/Digital_Camera/outdoor2/DSC02470.JPG,char_data/0/DSC02470.JPG_2.jpg,1815,480,640,33,361,394,376,431,True,2
0,32,kaist_dataset/Korean/Digital_Camera/outdoor2/DSC02476.JPG,char_data/0/DSC02476.JPG_2.jpg,768,480,640,24,395,419,271,303,True,2
0,104,kaist_dataset/Korean/Digital_Camera/outdoor2/DSC02486.JPG,char_data/0/DSC02486.JPG_8.jpg,3536,480,640,34,111,145,235,339,True,2
0,108,kaist_dataset/Korean/Digital_Camera/outdoor2/DSC02486.JPG,char_data/0/DSC02486.JPG_9.jpg,3996,480,640,37,145,182,234,342,True,2
0,113,kaist_dataset/Korean/Digital_Camera/outdoor2/DSC02486.JPG,char_data/0/DSC02486.JPG_10.jpg,4407,480,640,39,296,335,232,345,True,2
0,115,kaist_dataset/Korean/Digital_Camera/outdoor2/DSC02486.JPG,char_data/0/DSC02486.JPG_11.jpg,4370,480,640,38,333,371,231,346,True,2
0,33,kaist_dataset/Korean/Digital_Camera/outdoor2/DSC02488.JPG,char_data/0/DSC02488.JPG_2.jpg,528,480,640,16,547,563,373,406,True,2
0,34,kaist_dataset/Korean/Digital_Camera/outdoor2/DSC02506.JPG,char_data/0/DSC02506.JPG_4.jpg,986,480,640,29,333,362,434,468,True,2
0,35,kaist_dataset/Korean/Digital_Camera/outdoor2/DSC02506.JPG,char_data/0/DSC02506.JPG_5.jpg,980,480,640,28,387,415,432,467,True,2
0,46,kaist_dataset/Korean/Digital_Camera/outdoor2/DSC02512.JPG,char_data/0/DSC02512.JPG_4.jpg,1518,480,640,33,542,575,290,336,True,2
0,48,kaist_dataset/Korean/Digital_Camera/outdoor2/DSC02512.JPG,char_data/0/DSC02512.JPG_5.jpg,1488,480,640,31,575,606,292,340,True,2
0,127,kaist_dataset/Korean/Digital_Camera/outdoor2/DSC02520.JPG,char_data/0/DSC02520.JPG_4.jpg,5461,480,640,43,247,290,300,427,True,2
0,118,kaist_dataset/Korean/Digital_Camera/outdoor2/DSC02520.JPG,char_data/0/DSC02520.JPG_5.jpg,3894,480,640,33,314,347,303,421,True,2
0,36,kaist_dataset/Korean/Digital_Camera/outdoor2/DSC02523.JPG,char_data/0/DSC02523.JPG_4.jpg,1008,480,640,28,379,407,338,374,True,2
0,37,kaist_dataset/Korean/Digital_Camera/outdoor2/DSC02523.JPG,char_data/0/DSC02523.JPG_5.jpg,814,480,640,22,557,579,339,376,True,2
0,25,kaist_dataset/Korean/Digital_Camera/outdoor3/DSC02529.JPG,char_data/0/DSC02529.JPG_2.jpg,325,480,640,13,493,506,373,398,True,2
0,29,kaist_dataset/Korean/Digital_Camera/outdoor3/DSC02546.JPG,char_data/0/DSC02546.JPG_6.jpg,464,480,640,16,220,236,427,456,True,2
0,29,kaist_dataset/Korean/Digital_Camera/outdoor3/DSC02546.JPG,char_data/0/DSC02546.JPG_7.jpg,377,480,640,13,278,291,429,458,True,2
0,35,kaist_dataset/Korean/Digital_Camera/outdoor3/DSC02546.JPG,char_data/0/DSC02546.JPG_8.jpg,455,480,640,13,291,304,427,462,True,2
0,37,kaist_dataset/Korean/Digital_Camera/outdoor3/DSC02561.JPG,char_data/0/DSC02561.JPG_2.jpg,999,480,640,27,368,395,353,390,True,2
0,73,kaist_dataset/Korean/Digital_Camera/outdoor3/DSC02562.JPG,char_data/0/DSC02562.JPG_4.jpg,2555,480,640,35,330,365,360,433,True,2
0,80,kaist_dataset/Korean/Digital_Camera/outdoor3/DSC02562.JPG,char_data/0/DSC02562.JPG_5.jpg,2880,480,640,36,365,401,357,437,True,2
0,30,kaist_dataset/Korean/Digital_Camera/outdoor3/DSC02698.JPG,char_data/0/DSC02698.JPG_2.jpg,540,480,640,18,365,383,406,436,True,2
0,31,kaist_dataset/Korean/Digital_Camera/outdoor3/DSC02888.JPG,char_data/0/DSC02888.JPG_2.jpg,713,480,640,23,278,301,421,452,True,2
0,75,kaist_dataset/Korean/Digital_Camera/outdoor3/DSC02900.JPG,char_data/0/DSC02900.JPG_2.jpg,3525,480,640,47,423,470,247,322,True,2
0,33,kaist_dataset/Korean/Digital_Camera/outdoor3/DSC02939.JPG,char_data/0/DSC02939.JPG_2.jpg,990,480,640,30,232,262,367,400,True,2
0,40,kaist_dataset/Korean/Digital_Camera/outdoor3/DSC02941.JPG,char_data/0/DSC02941.JPG_4.jpg,1120,480,640,28,422,450,256,296,True,2
0,47,kaist_dataset/Korean/Digital_Camera/outdoor3/DSC02941.JPG,char_data/0/DSC02941.JPG_5.jpg,987,480,640,21,451,472,255,302,True,2
0,38,kaist_dataset/Korean/Digital_Camera/outdoor3/DSC02944.JPG,char_data/0/DSC02944.JPG_4.jpg,912,480,640,24,340,364,228,266,True,2
0,30,kaist_dataset/Korean/Digital_Camera/outdoor3/DSC02944.JPG,char_data/0/DSC02944.JPG_5.jpg,630,480,640,21,367,388,232,262,True,2
0,45,kaist_dataset/Korean/Digital_Camera/outdoor3/DSC02994.JPG,char_data/0/DSC02994.JPG_2.jpg,1395,480,640,31,338,369,286,331,True,2
0,37,kaist_dataset/Korean/Digital_Camera/outdoor3/DSC02999.JPG,char_data/0/DSC02999.JPG_4.jpg,925,480,640,25,181,206,429,466,True,2
0,37,kaist_dataset/Korean/Digital_Camera/outdoor3/DSC02999.JPG,char_data/0/DSC02999.JPG_5.jpg,777,480,640,21,387,408,430,467,True,2
0,166,kaist_dataset/Korean/Digital_Camera/outdoor3/DSC03066.JPG,char_data/0/DSC03066.JPG_2.jpg,26560,480,640,160,337,497,235,401,True,2
0,114,kaist_dataset/Korean/Digital_Camera/outdoor3/DSC03159.JPG,char_data/0/DSC03159.JPG_4.jpg,5244,480,640,46,341,387,223,337,True,2
0,122,kaist_dataset/Korean/Digital_Camera/outdoor3/DSC03159.JPG,char_data/0/DSC03159.JPG_5.jpg,5734,480,640,47,389,436,221,343,True,2
0,57,kaist_dataset/Korean/Digital_Camera/outdoor3/DSC03195.JPG,char_data/0/DSC03195.JPG_4.jpg,1824,480,640,32,315,347,252,309,True,2
0,61,kaist_dataset/Korean/Digital_Camera/outdoor3/DSC03195.JPG,char_data/0/DSC03195.JPG_5.jpg,2379,480,640,39,344,383,251,312,True,2
0,66,kaist_dataset/Korean/Digital_Camera/outdoor3/DSC03198.JPG,char_data/0/DSC03198.JPG_6.jpg,3498,480,640,53,265,318,199,265,True,2
0,59,kaist_dataset/Korean/Digital_Camera/outdoor3/DSC03198.JPG,char_data/0/DSC03198.JPG_7.jpg,3127,480,640,53,319,372,206,265,True,2
0,54,kaist_dataset/Korean/Digital_Camera/outdoor3/DSC03198.JPG,char_data/0/DSC03198.JPG_8.jpg,2970,480,640,55,373,428,204,258,True,2
0,34,kaist_dataset/Korean/Digital_Camera/outdoor3/DSC03219.JPG,char_data/0/DSC03219.JPG_4.jpg,748,480,640,22,426,448,411,445,True,2
0,32,kaist_dataset/Korean/Digital_Camera/outdoor3/DSC03219.JPG,char_data/0/DSC03219.JPG_5.jpg,608,480,640,19,449,468,411,443,True,2
0,64,kaist_dataset/Korean/Digital_Camera/outdoor4/DSC03261.JPG,char_data/0/DSC03261.JPG_4.jpg,2560,480,640,40,388,428,393,457,True,2
0,58,kaist_dataset/Korean/Digital_Camera/outdoor4/DSC03261.JPG,char_data/0/DSC03261.JPG_5.jpg,2088,480,640,36,467,503,404,462,True,2
0,31,kaist_dataset/Korean/Digital_Camera/outdoor4/DSC03295.JPG,char_data/0/DSC03295.JPG_4.jpg,713,480,640,23,312,335,400,431,True,2
0,31,kaist_dataset/Korean/Digital_Camera/outdoor4/DSC03295.JPG,char_data/0/DSC03295.JPG_5.jpg,775,480,640,25,359,384,403,434,True,2
0,53,kaist_dataset/Korean/Digital_Camera/outdoor4/DSC03313.JPG,char_data/0/DSC03313.JPG_4.jpg,1855,480,640,35,451,486,315,368,True,2
0,38,kaist_dataset/Korean/Digital_Camera/outdoor4/DSC03313.JPG,char_data/0/DSC03313.JPG_5.jpg,684,480,640,18,496,514,74,112,True,2
0,58,kaist_dataset/Korean/Digital_Camera/outdoor4/DSC03319.JPG,char_data/0/DSC03319.JPG_4.jpg,2146,480,640,37,409,446,384,442,True,2
0,49,kaist_dataset/Korean/Digital_Camera/outdoor4/DSC03319.JPG,char_data/0/DSC03319.JPG_5.jpg,1470,480,640,30,269,299,81,130,True,2
0,84,kaist_dataset/Korean/Digital_Camera/outdoor4/DSC03320.JPG,char_data/0/DSC03320.JPG_2.jpg,5208,480,640,62,229,291,379,463,True,2
0,85,kaist_dataset/Korean/Digital_Camera/outdoor4/DSC03452.JPG,char_data/0/DSC03452.JPG_6.jpg,3400,480,640,40,423,463,284,369,True,2
0,76,kaist_dataset/Korean/Digital_Camera/outdoor4/DSC03452.JPG,char_data/0/DSC03452.JPG_7.jpg,2280,480,640,30,498,528,284,360,True,2
0,76,kaist_dataset/Korean/Digital_Camera/outdoor4/DSC03452.JPG,char_data/0/DSC03452.JPG_8.jpg,2888,480,640,38,528,566,288,364,True,2
0,64,kaist_dataset/Korean/Digital_Camera/outdoor4/DSC03537.JPG,char_data/0/DSC03537.JPG_2.jpg,2880,480,640,45,119,164,134,198,True,2
0,80,kaist_dataset/Korean/Digital_Camera/outdoor4/DSC03542.JPG,char_data/0/DSC03542.JPG_2.jpg,4080,480,640,51,30,81,254,334,True,2
0,39,kaist_dataset/Korean/Digital_Camera/outdoor4/DSC03545.JPG,char_data/0/DSC03545.JPG_2.jpg,819,480,640,21,165,186,39,78,True,2
0,70,kaist_dataset/Korean/Digital_Camera/outdoor4/DSC03550.JPG,char_data/0/DSC03550.JPG_4.jpg,3990,480,640,57,392,449,304,374,True,2
0,73,kaist_dataset/Korean/Digital_Camera/outdoor4/DSC03550.JPG,char_data/0/DSC03550.JPG_5.jpg,4307,480,640,59,446,505,303,376,True,2
0,35,kaist_dataset/Korean/Digital_Camera/outdoor4/DSC03555.JPG,char_data/0/DSC03555.JPG_2.jpg,945,480,640,27,390,417,425,460,True,2
0,59,kaist_dataset/Korean/Digital_Camera/outdoor4/DSC03592.JPG,char_data/0/DSC03592.JPG_14.jpg,1947,480,640,33,60,93,53,112,True,2
0,58,kaist_dataset/Korean/Digital_Camera/outdoor4/DSC03592.JPG,char_data/0/DSC03592.JPG_15.jpg,1856,480,640,32,91,123,57,115,True,2
0,53,kaist_dataset/Korean/Digital_Camera/outdoor4/DSC03592.JPG,char_data/0/DSC03592.JPG_16.jpg,1272,480,640,24,620,639,63,116,True,2
0,52,kaist_dataset/Korean/Digital_Camera/outdoor4/DSC03592.JPG,char_data/0/DSC03592.JPG_17.jpg,1560,480,640,30,513,543,63,115,True,2
0,52,kaist_dataset/Korean/Digital_Camera/outdoor4/DSC03592.JPG,char_data/0/DSC03592.JPG_18.jpg,1716,480,640,33,398,431,58,110,True,2
0,60,kaist_dataset/Korean/Digital_Camera/outdoor4/DSC03592.JPG,char_data/0/DSC03592.JPG_19.jpg,1920,480,640,32,285,317,49,109,True,2
0,59,kaist_dataset/Korean/Digital_Camera/outdoor4/DSC03592.JPG,char_data/0/DSC03592.JPG_20.jpg,1947,480,640,33,184,217,52,111,True,2
0,57,kaist_dataset/Korean/Digital_Camera/outdoor4/DSC03598.JPG,char_data/0/DSC03598.JPG_2.jpg,2508,480,640,44,295,339,200,257,True,2
0,45,kaist_dataset/Korean/Digital_Camera/outdoor4/DSC03603.JPG,char_data/0/DSC03603.JPG_4.jpg,1710,480,640,38,224,262,53,98,True,2
0,53,kaist_dataset/Korean/Digital_Camera/outdoor4/DSC03603.JPG,char_data/0/DSC03603.JPG_5.jpg,2226,480,640,42,224,266,385,438,True,2
0,55,kaist_dataset/Korean/Digital_Camera/outdoor4/DSC03607.JPG,char_data/0/DSC03607.JPG_2.jpg,1925,480,640,35,588,623,102,157,True,2
0,49,kaist_dataset/Korean/Digital_Camera/outdoor5/DSC03626.JPG,char_data/0/DSC03626.JPG_4.jpg,1764,480,640,36,227,263,292,341,True,2
0,44,kaist_dataset/Korean/Digital_Camera/outdoor5/DSC03626.JPG,char_data/0/DSC03626.JPG_5.jpg,1276,480,640,29,289,318,295,339,True,2
0,31,kaist_dataset/Korean/Digital_Camera/outdoor5/DSC03627.JPG,char_data/0/DSC03627.JPG_4.jpg,961,480,640,31,325,356,225,256,True,2
0,32,kaist_dataset/Korean/Digital_Camera/outdoor5/DSC03627.JPG,char_data/0/DSC03627.JPG_5.jpg,960,480,640,30,418,448,223,255,True,2
0,37,kaist_dataset/Korean/Digital_Camera/outdoor5/DSC03636.JPG,char_data/0/DSC03636.JPG_6.jpg,925,480,640,25,69,94,335,372,True,2
0,40,kaist_dataset/Korean/Digital_Camera/outdoor5/DSC03636.JPG,char_data/0/DSC03636.JPG_7.jpg,920,480,640,23,93,116,332,372,True,2
0,34,kaist_dataset/Korean/Digital_Camera/outdoor5/DSC03636.JPG,char_data/0/DSC03636.JPG_8.jpg,646,480,640,19,343,362,396,430,True,2
0,38,kaist_dataset/Korean/Digital_Camera/outdoor5/DSC03669.JPG,char_data/0/DSC03669.JPG_2.jpg,1102,480,640,29,371,400,311,349,True,2
0,37,kaist_dataset/Korean/Digital_Camera/outdoor5/DSC03671.JPG,char_data/0/DSC03671.JPG_4.jpg,555,480,640,15,178,193,408,445,True,2
0,33,kaist_dataset/Korean/Digital_Camera/outdoor5/DSC03671.JPG,char_data/0/DSC03671.JPG_5.jpg,726,480,640,22,391,413,413,446,True,2
0,32,kaist_dataset/Korean/Digital_Camera/outdoor5/DSC03692.JPG,char_data/0/DSC03692.JPG_4.jpg,672,480,640,21,385,406,186,218,True,2
0,36,kaist_dataset/Korean/Digital_Camera/outdoor5/DSC03692.JPG,char_data/0/DSC03692.JPG_5.jpg,576,480,640,16,475,491,188,224,True,2
0,62,kaist_dataset/Korean/Digital_Camera/outdoor5/DSC03694.JPG,char_data/0/DSC03694.JPG_6.jpg,1488,480,640,24,548,572,116,178,True,2
0,57,kaist_dataset/Korean/Digital_Camera/outdoor5/DSC03694.JPG,char_data/0/DSC03694.JPG_7.jpg,1482,480,640,26,599,625,118,175,True,2
0,63,kaist_dataset/Korean/Digital_Camera/outdoor5/DSC03694.JPG,char_data/0/DSC03694.JPG_8.jpg,1764,480,640,28,315,343,248,311,True,2
0,90,kaist_dataset/Korean/Digital_Camera/outdoor5/DSC03715.JPG,char_data/0/DSC03715.JPG_4.jpg,3960,480,640,44,459,503,79,169,True,2
0,96,kaist_dataset/Korean/Digital_Camera/outdoor5/DSC03715.JPG,char_data/0/DSC03715.JPG_5.jpg,5184,480,640,54,547,601,77,173,True,2
0,36,kaist_dataset/Korean/Digital_Camera/outdoor5/DSC03740.JPG,char_data/0/DSC03740.JPG_2.jpg,864,480,640,24,274,298,288,324,True,2
0,28,kaist_dataset/Korean/Digital_Camera/outdoor5/DSC03744.JPG,char_data/0/DSC03744.JPG_4.jpg,812,480,640,29,353,382,303,331,True,2
0,32,kaist_dataset/Korean/Digital_Camera/outdoor5/DSC03744.JPG,char_data/0/DSC03744.JPG_5.jpg,768,480,640,24,412,436,298,330,True,2
0,65,kaist_dataset/Korean/Digital_Camera/outdoor5/DSC03749.JPG,char_data/0/DSC03749.JPG_4.jpg,1755,480,640,27,484,511,408,473,True,2
0,70,kaist_dataset/Korean/Digital_Camera/outdoor5/DSC03749.JPG,char_data/0/DSC03749.JPG_5.jpg,2380,480,640,34,512,546,404,474,True,2
0,30,kaist_dataset/Korean/Digital_Camera/outdoor5/DSC03752.JPG,char_data/0/DSC03752.JPG_2.jpg,450,480,640,15,186,201,410,440,True,2
0,103,kaist_dataset/Korean/Digital_Camera/outdoor5/DSC03760.JPG,char_data/0/DSC03760.JPG_4.jpg,6901,480,640,67,381,448,69,172,True,2
0,106,kaist_dataset/Korean/Digital_Camera/outdoor5/DSC03760.JPG,char_data/0/DSC03760.JPG_5.jpg,7526,480,640,71,451,522,68,174,True,2
0,21,kaist_dataset/Korean/Digital_Camera/outdoor5/DSC03776.JPG,char_data/0/DSC03776.JPG_2.jpg,231,480,640,11,543,554,422,443,True,2
0,30,kaist_dataset/Korean/Digital_Camera/outdoor5/DSC03777.JPG,char_data/0/DSC03777.JPG_2.jpg,540,480,640,18,71,89,342,372,True,2
0,23,kaist_dataset/Korean/Digital_Camera/outdoor5/DSC03780.JPG,char_data/0/DSC03780.JPG_2.jpg,414,480,640,18,229,247,438,461,True,2
0,54,kaist_dataset/Korean/Digital_Camera/outdoor5/DSC03838.JPG,char_data/0/DSC03838.JPG_2.jpg,1242,480,640,23,373,396,201,255,True,2
0,57,kaist_dataset/Korean/Digital_Camera/outdoor5/DSC03858.JPG,char_data/0/DSC03858.JPG_8.jpg,2622,480,640,46,181,227,397,454,True,2
0,64,kaist_dataset/Korean/Digital_Camera/outdoor5/DSC03858.JPG,char_data/0/DSC03858.JPG_9.jpg,3008,480,640,47,230,277,398,462,True,2
0,71,kaist_dataset/Korean/Digital_Camera/outdoor5/DSC03858.JPG,char_data/0/DSC03858.JPG_10.jpg,3408,480,640,48,279,327,394,465,True,2
0,42,kaist_dataset/Korean/Digital_Camera/outdoor5/DSC03858.JPG,char_data/0/DSC03858.JPG_11.jpg,966,480,640,23,488,511,413,455,True,2
0,89,kaist_dataset/Korean/Digital_Camera/outdoor5/DSC03864.JPG,char_data/0/DSC03864.JPG_2.jpg,4272,480,640,48,483,531,163,252,True,2
0,33,kaist_dataset/Korean/Digital_Camera/outdoor5/DSC04027.JPG,char_data/0/DSC04027.JPG_8.jpg,561,480,640,17,278,295,386,419,True,2
0,34,kaist_dataset/Korean/Digital_Camera/outdoor5/DSC04027.JPG,char_data/0/DSC04027.JPG_9.jpg,748,480,640,22,312,334,387,421,True,2
0,36,kaist_dataset/Korean/Digital_Camera/outdoor5/DSC04027.JPG,char_data/0/DSC04027.JPG_10.jpg,612,480,640,17,347,364,384,420,True,2
0,36,kaist_dataset/Korean/Digital_Camera/outdoor5/DSC04027.JPG,char_data/0/DSC04027.JPG_11.jpg,684,480,640,19,492,511,382,418,True,2
0,29,kaist_dataset/Korean/Digital_Camera/outdoor5/DSC04028.JPG,char_data/0/DSC04028.JPG_4.jpg,696,480,640,24,416,440,344,373,True,2
0,26,kaist_dataset/Korean/Digital_Camera/outdoor5/DSC04028.JPG,char_data/0/DSC04028.JPG_5.jpg,676,480,640,26,441,467,344,370,True,2
0,30,kaist_dataset/Korean/Digital_Camera/outdoor6/DSC04046.JPG,char_data/0/DSC04046.JPG_6.jpg,600,480,640,20,405,425,261,291,True,2
0,28,kaist_dataset/Korean/Digital_Camera/outdoor6/DSC04046.JPG,char_data/0/DSC04046.JPG_7.jpg,392,480,640,14,441,455,261,289,True,2
0,32,kaist_dataset/Korean/Digital_Camera/outdoor6/DSC04046.JPG,char_data/0/DSC04046.JPG_8.jpg,512,480,640,16,483,499,256,288,True,2
0,28,kaist_dataset/Korean/Digital_Camera/outdoor6/DSC04062.JPG,char_data/0/DSC04062.JPG_4.jpg,364,480,640,13,576,589,306,334,True,2
0,28,kaist_dataset/Korean/Digital_Camera/outdoor6/DSC04062.JPG,char_data/0/DSC04062.JPG_5.jpg,336,480,640,12,596,608,305,333,True,2
0,59,kaist_dataset/Korean/Digital_Camera/outdoor6/DSC04073.JPG,char_data/0/DSC04073.JPG_6.jpg,2006,480,640,34,481,515,35,94,True,2
0,66,kaist_dataset/Korean/Digital_Camera/outdoor6/DSC04073.JPG,char_data/0/DSC04073.JPG_7.jpg,2046,480,640,31,540,571,33,99,True,2
0,69,kaist_dataset/Korean/Digital_Camera/outdoor6/DSC04073.JPG,char_data/0/DSC04073.JPG_8.jpg,2139,480,640,31,572,603,32,101,True,2
0,56,kaist_dataset/Korean/Digital_Camera/outdoor6/DSC04100.JPG,char_data/0/DSC04100.JPG_4.jpg,1960,480,640,35,254,289,50,106,True,2
0,53,kaist_dataset/Korean/Digital_Camera/outdoor6/DSC04100.JPG,char_data/0/DSC04100.JPG_5.jpg,1325,480,640,25,456,481,55,108,True,2
0,38,kaist_dataset/Korean/Digital_Camera/outdoor6/DSC04112.JPG,char_data/0/DSC04112.JPG_6.jpg,532,480,640,14,306,320,270,308,True,2
0,33,kaist_dataset/Korean/Digital_Camera/outdoor6/DSC04112.JPG,char_data/0/DSC04112.JPG_7.jpg,429,480,640,13,360,373,274,307,True,2
0,32,kaist_dataset/Korean/Digital_Camera/outdoor6/DSC04112.JPG,char_data/0/DSC04112.JPG_8.jpg,416,480,640,13,374,387,273,305,True,2
0,31,kaist_dataset/Korean/Digital_Camera/outdoor6/DSC04113.JPG,char_data/0/DSC04113.JPG_2.jpg,992,480,640,32,338,370,441,472,True,2
0,40,kaist_dataset/Korean/Digital_Camera/outdoor6/DSC04116.JPG,char_data/0/DSC04116.JPG_2.jpg,680,480,640,17,238,255,318,358,True,2
0,79,kaist_dataset/Korean/Digital_Camera/outdoor6/DSC04147.JPG,char_data/0/DSC04147.JPG_2.jpg,3318,480,640,42,307,349,175,254,True,2
0,32,kaist_dataset/Korean/Digital_Camera/outdoor6/DSC04148.JPG,char_data/0/DSC04148.JPG_2.jpg,512,480,640,16,463,479,257,289,True,2
0,55,kaist_dataset/Korean/Digital_Camera/outdoor6/DSC04296.JPG,char_data/0/DSC04296.JPG_6.jpg,1210,480,640,22,189,211,317,372,True,2
0,59,kaist_dataset/Korean/Digital_Camera/outdoor6/DSC04296.JPG,char_data/0/DSC04296.JPG_7.jpg,1062,480,640,18,228,246,316,375,True,2
0,58,kaist_dataset/Korean/Digital_Camera/outdoor6/DSC04296.JPG,char_data/0/DSC04296.JPG_8.jpg,1102,480,640,19,404,423,304,362,True,2
0,54,kaist_dataset/Korean/Digital_Camera/outdoor6/DSC04308.JPG,char_data/0/DSC04308.JPG_6.jpg,1674,480,640,31,162,193,385,439,True,2
0,53,kaist_dataset/Korean/Digital_Camera/outdoor6/DSC04308.JPG,char_data/0/DSC04308.JPG_7.jpg,1537,480,640,29,443,472,387,440,True,2
0,57,kaist_dataset/Korean/Digital_Camera/outdoor6/DSC04308.JPG,char_data/0/DSC04308.JPG_8.jpg,1995,480,640,35,470,505,387,444,True,2
0,26,kaist_dataset/Korean/Digital_Camera/outdoor6/DSC04343.JPG,char_data/0/DSC04343.JPG_4.jpg,598,480,640,23,385,408,207,233,True,2
0,30,kaist_dataset/Korean/Digital_Camera/outdoor6/DSC04343.JPG,char_data/0/DSC04343.JPG_5.jpg,510,480,640,17,409,426,204,234,True,2
0,44,kaist_dataset/Korean/Digital_Camera/outdoor6/DSC04352.JPG,char_data/0/DSC04352.JPG_2.jpg,1056,480,640,24,462,486,284,328,True,2
0,43,kaist_dataset/Korean/Digital_Camera/outdoor6/DSC04400.JPG,char_data/0/DSC04400.JPG_6.jpg,946,480,640,22,376,398,221,264,True,2
0,45,kaist_dataset/Korean/Digital_Camera/outdoor6/DSC04400.JPG,char_data/0/DSC04400.JPG_7.jpg,1125,480,640,25,397,422,221,266,True,2
0,45,kaist_dataset/Korean/Digital_Camera/outdoor6/DSC04400.JPG,char_data/0/DSC04400.JPG_8.jpg,990,480,640,22,394,416,394,439,True,2
0,127,kaist_dataset/Korean/Digital_Camera/outdoor6/DSC04445.JPG,char_data/0/DSC04445.JPG_2.jpg,11811,480,640,93,271,364,258,385,True,2
0,155,kaist_dataset/Korean/Digital_Camera/outdoor6/DSC04446.JPG,char_data/0/DSC04446.JPG_2.jpg,14725,480,640,95,317,412,268,423,True,2
0,66,kaist_dataset/Korean/Digital_Camera/outdoor7/DSC04483.JPG,char_data/0/DSC04483.JPG_4.jpg,2376,480,640,36,94,130,363,429,True,2
0,67,kaist_dataset/Korean/Digital_Camera/outdoor7/DSC04483.JPG,char_data/0/DSC04483.JPG_5.jpg,2546,480,640,38,129,167,364,431,True,2
0,46,kaist_dataset/Korean/Digital_Camera/outdoor7/k.jpg,char_data/0/k.jpg_2.jpg,1518,240,320,33,122,155,147,193,True,2
0,33,kaist_dataset/Korean/Digital_Camera/outdoor7/P1010003.JPG,char_data/0/P1010003.JPG_2.jpg,825,480,640,25,397,422,277,310,True,2
0,30,kaist_dataset/Korean/Digital_Camera/outdoor7/P1010004.JPG,char_data/0/P1010004.JPG_6.jpg,420,480,640,14,455,469,297,327,True,2
0,28,kaist_dataset/Korean/Digital_Camera/outdoor7/P1010004.JPG,char_data/0/P1010004.JPG_7.jpg,336,480,640,12,480,492,298,326,True,2
0,34,kaist_dataset/Korean/Digital_Camera/outdoor7/P1010004.JPG,char_data/0/P1010004.JPG_8.jpg,272,480,640,8,518,526,295,329,True,2
0,39,kaist_dataset/Korean/Digital_Camera/outdoor7/P1010009.JPG,char_data/0/P1010009.JPG_6.jpg,1092,480,640,28,516,544,267,306,True,2
0,39,kaist_dataset/Korean/Digital_Camera/outdoor7/P1010009.JPG,char_data/0/P1010009.JPG_7.jpg,1209,480,640,31,577,608,265,304,True,2
0,53,kaist_dataset/Korean/Digital_Camera/outdoor7/P1010023.JPG,char_data/0/P1010023.JPG_2.jpg,1590,480,640,30,313,343,289,342,True,2
0,28,kaist_dataset/Korean/Digital_Camera/outdoor7/P1010054.JPG,char_data/0/P1010054.JPG_2.jpg,672,480,640,24,564,588,227,255,True,2
0,35,kaist_dataset/Korean/Digital_Camera/outdoor7/P1010055.JPG,char_data/0/P1010055.JPG_2.jpg,770,480,640,22,26,48,204,239,True,2
0,40,kaist_dataset/Korean/Digital_Camera/outdoor7/P1010061.JPG,char_data/0/P1010061.JPG_2.jpg,1000,480,640,25,493,518,317,357,True,2
0,53,kaist_dataset/Korean/Digital_Camera/outdoor7/P1010068.JPG,char_data/0/P1010068.JPG_2.jpg,1590,480,640,30,263,293,279,332,True,2
0,41,kaist_dataset/Korean/Digital_Camera/outdoor7/P1010069.JPG,char_data/0/P1010069.JPG_4.jpg,902,480,640,22,555,577,316,357,True,2
0,65,kaist_dataset/Korean/Digital_Camera/outdoor7/P1010080.JPG,char_data/0/P1010080.JPG_4.jpg,2535,480,640,39,417,456,195,260,True,2
0,59,kaist_dataset/Korean/Digital_Camera/outdoor7/P1010081.JPG,char_data/0/P1010081.JPG_4.jpg,2655,480,640,45,290,335,212,271,True,2
0,55,kaist_dataset/Korean/Digital_Camera/outdoor7/P1010081.JPG,char_data/0/P1010081.JPG_5.jpg,2640,480,640,48,429,477,213,268,True,2
0,45,kaist_dataset/Korean/Digital_Camera/outdoor7/P1010111.JPG,char_data/0/P1010111.JPG_8.jpg,1620,480,640,36,564,600,223,268,True,2
0,50,kaist_dataset/Korean/Digital_Camera/outdoor7/P1010111.JPG,char_data/0/P1010111.JPG_9.jpg,1950,480,640,39,600,639,222,272,True,2
0,33,kaist_dataset/Korean/Digital_Camera/outdoor7/P1010136.JPG,char_data/0/P1010136.JPG_4.jpg,396,480,640,12,203,215,262,295,True,2
0,32,kaist_dataset/Korean/Digital_Camera/outdoor7/P1010136.JPG,char_data/0/P1010136.JPG_5.jpg,512,480,640,16,340,356,266,298,True,2
0,33,kaist_dataset/Korean/Digital_Camera/outdoor7/P1010138.JPG,char_data/0/P1010138.JPG_2.jpg,726,480,640,22,186,208,286,319,True,2
0,31,kaist_dataset/Korean/Digital_Camera/outdoor8/P090912069.jpg,char_data/0/P090912069.jpg_4.jpg,806,480,640,26,426,452,226,257,True,2
0,29,kaist_dataset/Korean/Digital_Camera/outdoor8/P090912069.jpg,char_data/0/P090912069.jpg_5.jpg,870,480,640,30,454,484,220,249,True,2
0,38,kaist_dataset/Korean/Digital_Camera/outdoor8/P1010142.JPG,char_data/0/P1010142.JPG_2.jpg,874,480,640,23,177,200,282,320,True,2
0,35,kaist_dataset/Korean/Digital_Camera/outdoor8/P1010143.JPG,char_data/0/P1010143.JPG_4.jpg,910,480,640,26,409,435,271,306,True,2
0,33,kaist_dataset/Korean/Digital_Camera/outdoor8/P1010143.JPG,char_data/0/P1010143.JPG_5.jpg,726,480,640,22,436,458,274,307,True,2
0,47,kaist_dataset/Korean/Digital_Camera/outdoor8/P1010147.JPG,char_data/0/P1010147.JPG_4.jpg,1363,480,640,29,522,551,315,362,True,2
0,49,kaist_dataset/Korean/Digital_Camera/outdoor8/P1010147.JPG,char_data/0/P1010147.JPG_5.jpg,1519,480,640,31,551,582,311,360,True,2
0,30,kaist_dataset/Korean/Digital_Camera/outdoor8/P1010178.JPG,char_data/0/P1010178.JPG_2.jpg,660,480,640,22,367,389,308,338,True,2
0,73,kaist_dataset/Korean/Digital_Camera/outdoor8/P1010181.JPG,char_data/0/P1010181.JPG_4.jpg,2628,480,640,36,404,440,194,267,True,2
0,93,kaist_dataset/Korean/Digital_Camera/outdoor8/P1010181.JPG,char_data/0/P1010181.JPG_5.jpg,2976,480,640,32,413,445,292,385,True,2
0,41,kaist_dataset/Korean/Digital_Camera/outdoor8/P1010189.JPG,char_data/0/P1010189.JPG_4.jpg,1353,480,640,33,143,176,232,273,True,2
0,35,kaist_dataset/Korean/Digital_Camera/outdoor8/P1010189.JPG,char_data/0/P1010189.JPG_5.jpg,1225,480,640,35,487,522,232,267,True,2
0,32,kaist_dataset/Korean/Digital_Camera/outdoor8/P1011112.JPG,char_data/0/P1011112.JPG_4.jpg,672,480,640,21,452,473,221,253,True,2
0,35,kaist_dataset/Korean/Digital_Camera/outdoor8/P1011112.JPG,char_data/0/P1011112.JPG_5.jpg,665,480,640,19,548,567,224,259,True,2
0,48,"kaist_dataset/Korean/Mobile_Phone/(M,K)C-outdoor/P090912034.jpg",char_data/0/P090912034.jpg_4.jpg,1536,480,640,32,205,237,253,301,True,2
0,40,"kaist_dataset/Korean/Mobile_Phone/(M,K)C-outdoor/P090912034.jpg",char_data/0/P090912034.jpg_5.jpg,1200,480,640,30,285,315,262,302,True,2
0,77,"kaist_dataset/Korean/Mobile_Phone/(M,K)E-bookCover/P090831035.jpg",char_data/0/P090831035.jpg_2.jpg,3003,480,640,39,55,94,48,125,True,2
0,67,"kaist_dataset/Korean/Mobile_Phone/(M,K)E-bookCover/P090831082.jpg",char_data/0/P090831082.jpg_4.jpg,2546,480,640,38,379,417,38,105,True,2
0,67,"kaist_dataset/Korean/Mobile_Phone/(M,K)E-bookCover/P090831082.jpg",char_data/0/P090831082.jpg_5.jpg,2546,480,640,38,420,458,37,104,True,2
0,64,"kaist_dataset/Korean/Mobile_Phone/(M,K)E-bookCover/P090831084.jpg",char_data/0/P090831084.jpg_4.jpg,2432,480,640,38,343,381,43,107,True,2
0,65,"kaist_dataset/Korean/Mobile_Phone/(M,K)E-bookCover/P090831084.jpg",char_data/0/P090831084.jpg_5.jpg,2340,480,640,36,381,417,42,107,True,2
0,64,"kaist_dataset/Korean/Mobile_Phone/(M,K)E-bookCover/P090831086.jpg",char_data/0/P090831086.jpg_4.jpg,2240,480,640,35,377,412,40,104,True,2
0,69,"kaist_dataset/Korean/Mobile_Phone/(M,K)E-bookCover/P090831086.jpg",char_data/0/P090831086.jpg_5.jpg,2967,480,640,43,411,454,40,109,True,2
0,70,"kaist_dataset/Korean/Mobile_Phone/(M,K)E-bookCover/P090831087.jpg",char_data/0/P090831087.jpg_4.jpg,2240,480,640,32,388,420,22,92,True,2
0,66,"kaist_dataset/Korean/Mobile_Phone/(M,K)E-bookCover/P090831087.jpg",char_data/0/P090831087.jpg_5.jpg,2310,480,640,35,426,461,28,94,True,2
0,63,"kaist_dataset/Korean/Mobile_Phone/(M,K)E-bookCover/P090831088.jpg",char_data/0/P090831088.jpg_4.jpg,2142,480,640,34,379,413,18,81,True,2
0,66,"kaist_dataset/Korean/Mobile_Phone/(M,K)E-bookCover/P090831088.jpg",char_data/0/P090831088.jpg_5.jpg,2574,480,640,39,413,452,13,79,True,2
0,74,"kaist_dataset/Korean/Mobile_Phone/(M,K)E-bookCover/P090831089.jpg",char_data/0/P090831089.jpg_4.jpg,2886,480,640,39,419,458,26,100,True,2
0,74,"kaist_dataset/Korean/Mobile_Phone/(M,K)E-bookCover/P090831089.jpg",char_data/0/P090831089.jpg_5.jpg,3626,480,640,49,455,504,27,101,True,2
0,67,"kaist_dataset/Korean/Mobile_Phone/(M,K)E-bookCover/P090831090.jpg",char_data/0/P090831090.jpg_4.jpg,3216,480,640,48,458,506,36,103,True,2
0,70,"kaist_dataset/Korean/Mobile_Phone/(M,K)E-bookCover/P090831090.jpg",char_data/0/P090831090.jpg_5.jpg,3220,480,640,46,505,551,33,103,True,2
0,79,"kaist_dataset/Korean/Mobile_Phone/(M,K)E-bookCover/P090831091.jpg",char_data/0/P090831091.jpg_4.jpg,3318,480,640,42,450,492,26,105,True,2
0,80,"kaist_dataset/Korean/Mobile_Phone/(M,K)E-bookCover/P090831091.jpg",char_data/0/P090831091.jpg_5.jpg,3920,480,640,49,494,543,27,107,True,2
0,82,"kaist_dataset/Korean/Mobile_Phone/(M,K)E-bookCover/P090831094.jpg",char_data/0/P090831094.jpg_4.jpg,3772,480,640,46,433,479,34,116,True,2
0,76,"kaist_dataset/Korean/Mobile_Phone/(M,K)E-bookCover/P090831094.jpg",char_data/0/P090831094.jpg_5.jpg,3344,480,640,44,480,524,40,116,True,2
0,87,"kaist_dataset/Korean/Mobile_Phone/(M,K)E-bookCover/P090831095.jpg",char_data/0/P090831095.jpg_4.jpg,3654,480,640,42,462,504,36,123,True,2
0,92,"kaist_dataset/Korean/Mobile_Phone/(M,K)E-bookCover/P090831095.jpg",char_data/0/P090831095.jpg_5.jpg,4232,480,640,46,505,551,35,127,True,2
0,79,"kaist_dataset/Korean/Mobile_Phone/(M,K)E-bookCover/P090831096.jpg",char_data/0/P090831096.jpg_4.jpg,3397,480,640,43,436,479,38,117,True,2
0,72,"kaist_dataset/Korean/Mobile_Phone/(M,K)E-bookCover/P090831096.jpg",char_data/0/P090831096.jpg_5.jpg,3240,480,640,45,481,526,43,115,True,2
0,84,"kaist_dataset/Korean/Mobile_Phone/(M,K)E-bookCover/P090831097.jpg",char_data/0/P090831097.jpg_4.jpg,3696,480,640,44,447,491,35,119,True,2
0,78,"kaist_dataset/Korean/Mobile_Phone/(M,K)E-bookCover/P090831097.jpg",char_data/0/P090831097.jpg_5.jpg,3354,480,640,43,496,539,37,115,True,2
0,84,"kaist_dataset/Korean/Mobile_Phone/(M,K)E-bookCover/P090831098.jpg",char_data/0/P090831098.jpg_4.jpg,3528,480,640,42,456,498,30,114,True,2
0,78,"kaist_dataset/Korean/Mobile_Phone/(M,K)E-bookCover/P090831098.jpg",char_data/0/P090831098.jpg_5.jpg,3120,480,640,40,498,538,30,108,True,2
0,81,"kaist_dataset/Korean/Mobile_Phone/(M,K)E-bookCover/P090831099.jpg",char_data/0/P090831099.jpg_4.jpg,3483,480,640,43,457,500,19,100,True,2
0,83,"kaist_dataset/Korean/Mobile_Phone/(M,K)E-bookCover/P090831099.jpg",char_data/0/P090831099.jpg_5.jpg,3984,480,640,48,501,549,18,101,True,2
0,77,"kaist_dataset/Korean/Mobile_Phone/(M,K)E-bookCover/P090831100.jpg",char_data/0/P090831100.jpg_4.jpg,3157,480,640,41,451,492,45,122,True,2
0,71,"kaist_dataset/Korean/Mobile_Phone/(M,K)E-bookCover/P090831100.jpg",char_data/0/P090831100.jpg_5.jpg,2485,480,640,35,499,534,47,118,True,2
0,110,"kaist_dataset/Korean/Mobile_Phone/(M,K)E-bookCover/P090831105.jpg",char_data/0/P090831105.jpg_2.jpg,5940,480,640,54,563,617,96,206,True,2
0,31,kaist_dataset/Mixed/Digital_Camera/(C.S)A-shadow/DSC02624.JPG,char_data/0/DSC02624.JPG_4.jpg,434,480,640,14,478,492,398,429,True,2
0,62,kaist_dataset/Mixed/Digital_Camera/(C.S)A-shadow/DSC03305.JPG,char_data/0/DSC03305.JPG_2.jpg,1922,480,640,31,493,524,343,405,True,2
0,34,kaist_dataset/Mixed/Digital_Camera/(C.S)A-shadow/DSC04306.JPG,char_data/0/DSC04306.JPG_4.jpg,714,480,640,21,343,364,412,446,True,2
0,36,kaist_dataset/Mixed/Digital_Camera/(C.S)A-shadow/DSC04306.JPG,char_data/0/DSC04306.JPG_5.jpg,648,480,640,18,365,383,409,445,True,2
0,24,kaist_dataset/Mixed/Digital_Camera/(C.S)C-outdoor1/027.JPG,char_data/0/027.JPG_2.jpg,384,480,640,16,449,465,279,303,True,2
0,21,kaist_dataset/Mixed/Digital_Camera/(C.S)C-outdoor1/047.JPG,char_data/0/047.JPG_8.jpg,210,480,640,10,619,629,174,195,True,2
0,23,kaist_dataset/Mixed/Digital_Camera/(C.S)C-outdoor1/047.JPG,char_data/0/047.JPG_9.jpg,322,480,640,14,512,526,240,263,True,2
0,22,kaist_dataset/Mixed/Digital_Camera/(C.S)C-outdoor1/047.JPG,char_data/0/047.JPG_10.jpg,264,480,640,12,572,584,240,262,True,2
0,24,kaist_dataset/Mixed/Digital_Camera/(C.S)C-outdoor1/047.JPG,char_data/0/047.JPG_11.jpg,192,480,640,8,604,612,239,263,True,2
0,51,kaist_dataset/Mixed/Digital_Camera/(C.S)C-outdoor1/080116-0084.jpg,char_data/0/080116-0084.jpg_2.jpg,1836,600,800,36,651,687,305,356,True,2
0,146,kaist_dataset/Mixed/Digital_Camera/(C.S)C-outdoor1/080118-0007.jpg,char_data/0/080118-0007.jpg_6.jpg,13870,1200,1600,95,272,367,194,340,True,2
0,153,kaist_dataset/Mixed/Digital_Camera/(C.S)C-outdoor1/080118-0007.jpg,char_data/0/080118-0007.jpg_7.jpg,15453,1200,1600,101,366,467,190,343,True,2
0,154,kaist_dataset/Mixed/Digital_Camera/(C.S)C-outdoor1/080118-0007.jpg,char_data/0/080118-0007.jpg_8.jpg,15862,1200,1600,103,467,570,189,343,True,2
0,30,kaist_dataset/Mixed/Digital_Camera/(C.S)C-outdoor1/090.JPG,char_data/0/090.JPG_2.jpg,510,480,640,17,472,489,395,425,True,2
0,38,kaist_dataset/Mixed/Digital_Camera/(C.S)C-outdoor1/105.jpg,char_data/0/105.jpg_2.jpg,1216,480,640,32,364,396,384,422,True,2
0,27,kaist_dataset/Mixed/Digital_Camera/(C.S)C-outdoor1/121.JPG,char_data/0/121.JPG_2.jpg,459,480,640,17,387,404,275,302,True,2
0,44,kaist_dataset/Mixed/Digital_Camera/(C.S)C-outdoor1/2.JPG,char_data/0/2.JPG_14.jpg,1012,576,768,23,186,209,64,108,True,2
0,43,kaist_dataset/Mixed/Digital_Camera/(C.S)C-outdoor1/2.JPG,char_data/0/2.JPG_15.jpg,1118,576,768,26,222,248,64,107,True,2
0,41,kaist_dataset/Mixed/Digital_Camera/(C.S)C-outdoor1/2.JPG,char_data/0/2.JPG_16.jpg,738,576,768,18,325,343,67,108,True,2
0,40,kaist_dataset/Mixed/Digital_Camera/(C.S)C-outdoor1/2.JPG,char_data/0/2.JPG_17.jpg,840,576,768,21,400,421,64,104,True,2
0,27,kaist_dataset/Mixed/Digital_Camera/(C.S)C-outdoor1/2.JPG,char_data/0/2.JPG_18.jpg,270,576,768,10,604,614,393,420,True,2
0,26,kaist_dataset/Mixed/Digital_Camera/(C.S)C-outdoor1/2.JPG,char_data/0/2.JPG_19.jpg,286,576,768,11,624,635,393,419,True,2
0,22,kaist_dataset/Mixed/Digital_Camera/(C.S)C-outdoor1/2.JPG,char_data/0/2.JPG_20.jpg,352,576,768,16,636,652,395,417,True,2
0,51,kaist_dataset/Mixed/Digital_Camera/(C.S)C-outdoor1/2007-12-08-day-118.jpg,char_data/0/2007-12-08-day-118.jpg_4.jpg,2397,1200,1600,47,1390,1437,493,544,True,2
0,51,kaist_dataset/Mixed/Digital_Camera/(C.S)C-outdoor1/2007-12-08-day-118.jpg,char_data/0/2007-12-08-day-118.jpg_5.jpg,2295,1200,1600,45,1438,1483,496,547,True,2
0,303,kaist_dataset/Mixed/Digital_Camera/(C.S)C-outdoor1/2007-12-08-day-137.jpg,char_data/0/2007-12-08-day-137.jpg_2.jpg,73932,1200,1600,244,647,891,383,686,True,2
0,60,kaist_dataset/Mixed/Digital_Camera/(C.S)C-outdoor1/2007-12-09-day-exterior-037.jpg,char_data/0/2007-12-09-day-exterior-037.jpg_2.jpg,3360,1200,1600,56,925,981,707,767,True,2
0,47,kaist_dataset/Mixed/Digital_Camera/(C.S)C-outdoor1/2007-12-09-day-exterior-078.jpg,char_data/0/2007-12-09-day-exterior-078.jpg_8.jpg,1175,1200,1600,25,558,583,592,639,True,2
0,48,kaist_dataset/Mixed/Digital_Camera/(C.S)C-outdoor1/2007-12-09-day-exterior-078.jpg,char_data/0/2007-12-09-day-exterior-078.jpg_9.jpg,960,1200,1600,20,676,696,589,637,True,2
0,49,kaist_dataset/Mixed/Digital_Camera/(C.S)C-outdoor1/2007-12-09-day-exterior-078.jpg,char_data/0/2007-12-09-day-exterior-078.jpg_10.jpg,1029,1200,1600,21,760,781,583,632,True,2
0,50,kaist_dataset/Mixed/Digital_Camera/(C.S)C-outdoor1/2007-12-09-day-exterior-078.jpg,char_data/0/2007-12-09-day-exterior-078.jpg_11.jpg,900,1200,1600,18,848,866,580,630,True,2
0,65,kaist_dataset/Mixed/Digital_Camera/(C.S)C-outdoor1/2007-12-09-day-exterior-086.jpg,char_data/0/2007-12-09-day-exterior-086.jpg_2.jpg,4745,1200,1600,73,1167,1240,724,789,True,2
0,41,kaist_dataset/Mixed/Digital_Camera/(C.S)C-outdoor1/3.JPG,char_data/0/3.JPG_4.jpg,943,576,768,23,476,499,419,460,True,2
0,47,kaist_dataset/Mixed/Digital_Camera/(C.S)C-outdoor1/3.JPG,char_data/0/3.JPG_5.jpg,940,576,768,20,565,585,415,462,True,2
0,44,kaist_dataset/Mixed/Digital_Camera/(C.S)C-outdoor1/45.JPG,char_data/0/45.JPG_2.jpg,1628,576,768,37,407,444,363,407,True,2
0,26,kaist_dataset/Mixed/Digital_Camera/(C.S)C-outdoor1/48.JPG,char_data/0/48.JPG_6.jpg,468,576,768,18,319,337,340,366,True,2
0,25,kaist_dataset/Mixed/Digital_Camera/(C.S)C-outdoor1/48.JPG,char_data/0/48.JPG_7.jpg,300,576,768,12,388,400,341,366,True,2
0,20,kaist_dataset/Mixed/Digital_Camera/(C.S)C-outdoor1/48.JPG,char_data/0/48.JPG_8.jpg,220,576,768,11,449,460,344,364,True,2
0,40,kaist_dataset/Mixed/Digital_Camera/(C.S)C-outdoor1/56.JPG,char_data/0/56.JPG_2.jpg,1400,576,768,35,437,472,299,339,True,2
0,26,kaist_dataset/Mixed/Digital_Camera/(C.S)C-outdoor1/57.JPG,char_data/0/57.JPG_4.jpg,598,500,766,23,475,498,296,322,True,2
0,24,kaist_dataset/Mixed/Digital_Camera/(C.S)C-outdoor1/57.JPG,char_data/0/57.JPG_5.jpg,336,500,766,14,320,334,456,480,True,2
0,35,kaist_dataset/Mixed/Digital_Camera/(C.S)C-outdoor1/DSC02242.JPG,char_data/0/DSC02242.JPG_2.jpg,560,480,640,16,615,631,257,292,True,2
0,91,kaist_dataset/Mixed/Digital_Camera/(C.S)C-outdoor1/DSC02244.JPG,char_data/0/DSC02244.JPG_4.jpg,4368,480,640,48,411,459,342,433,True,2
0,83,kaist_dataset/Mixed/Digital_Camera/(C.S)C-outdoor1/DSC02244.JPG,char_data/0/DSC02244.JPG_5.jpg,4067,480,640,49,458,507,349,432,True,2
0,35,kaist_dataset/Mixed/Digital_Camera/(C.S)C-outdoor1/DSC02320.JPG,char_data/0/DSC02320.JPG_2.jpg,665,480,640,19,526,545,355,390,True,2
0,39,kaist_dataset/Mixed/Digital_Camera/(C.S)C-outdoor1/DSC02322.JPG,char_data/0/DSC02322.JPG_2.jpg,1170,480,640,30,351,381,366,405,True,2
0,40,kaist_dataset/Mixed/Digital_Camera/(C.S)C-outdoor1/DSC02344.JPG,char_data/0/DSC02344.JPG_2.jpg,760,480,640,19,599,618,259,299,True,2
0,43,kaist_dataset/Mixed/Digital_Camera/(C.S)C-outdoor1/DSC02349.JPG,char_data/0/DSC02349.JPG_8.jpg,817,480,640,19,412,431,195,238,True,2
0,37,kaist_dataset/Mixed/Digital_Camera/(C.S)C-outdoor1/DSC02349.JPG,char_data/0/DSC02349.JPG_9.jpg,962,480,640,26,434,460,197,234,True,2
0,34,kaist_dataset/Mixed/Digital_Camera/(C.S)C-outdoor1/DSC02349.JPG,char_data/0/DSC02349.JPG_10.jpg,714,480,640,21,456,477,429,463,True,2
0,30,kaist_dataset/Mixed/Digital_Camera/(C.S)C-outdoor1/DSC02349.JPG,char_data/0/DSC02349.JPG_11.jpg,750,480,640,25,476,501,427,457,True,2
0,44,kaist_dataset/Mixed/Digital_Camera/(C.S)C-outdoor1/DSC02350.JPG,char_data/0/DSC02350.JPG_2.jpg,1056,480,640,24,399,423,395,439,True,2
0,41,kaist_dataset/Mixed/Digital_Camera/(C.S)C-outdoor1/P1010009.JPG,char_data/0/P1010009.JPG_8.jpg,1230,480,640,30,62,92,233,274,True,2
0,43,kaist_dataset/Mixed/Digital_Camera/(C.S)C-outdoor1/P1010010.JPG,char_data/0/P1010010.JPG_4.jpg,1892,480,640,44,372,416,213,256,True,2
0,50,kaist_dataset/Mixed/Digital_Camera/(C.S)C-outdoor1/P1010010.JPG,char_data/0/P1010010.JPG_5.jpg,1050,480,640,21,390,411,359,409,True,2
0,36,kaist_dataset/Mixed/Digital_Camera/(C.S)C-outdoor2/DSC02368.JPG,char_data/0/DSC02368.JPG_4.jpg,576,480,640,16,398,414,382,418,True,2
0,36,kaist_dataset/Mixed/Digital_Camera/(C.S)C-outdoor2/DSC02368.JPG,char_data/0/DSC02368.JPG_5.jpg,612,480,640,17,473,490,378,414,True,2
0,38,kaist_dataset/Mixed/Digital_Camera/(C.S)C-outdoor2/DSC02376.JPG,char_data/0/DSC02376.JPG_2.jpg,988,480,640,26,577,603,335,373,True,2
0,40,kaist_dataset/Mixed/Digital_Camera/(C.S)C-outdoor2/DSC02377.JPG,char_data/0/DSC02377.JPG_2.jpg,1040,480,640,26,504,530,354,394,True,2
0,37,kaist_dataset/Mixed/Digital_Camera/(C.S)C-outdoor2/DSC02413.JPG,char_data/0/DSC02413.JPG_2.jpg,1221,480,640,33,493,526,207,244,True,2
0,90,kaist_dataset/Mixed/Digital_Camera/(C.S)C-outdoor2/DSC02430.JPG,char_data/0/DSC02430.JPG_6.jpg,9000,480,640,100,497,597,59,149,True,2
0,24,kaist_dataset/Mixed/Digital_Camera/(C.S)C-outdoor2/DSC02430.JPG,char_data/0/DSC02430.JPG_7.jpg,264,480,640,11,67,78,27,51,True,2
0,32,kaist_dataset/Mixed/Digital_Camera/(C.S)C-outdoor2/DSC02430.JPG,char_data/0/DSC02430.JPG_8.jpg,640,480,640,20,578,598,308,340,True,2
0,27,kaist_dataset/Mixed/Digital_Camera/(C.S)C-outdoor2/DSC02477.JPG,char_data/0/DSC02477.JPG_10.jpg,729,480,640,27,254,281,250,277,True,2
0,32,kaist_dataset/Mixed/Digital_Camera/(C.S)C-outdoor2/DSC02477.JPG,char_data/0/DSC02477.JPG_11.jpg,928,480,640,29,300,329,244,276,True,2
0,26,kaist_dataset/Mixed/Digital_Camera/(C.S)C-outdoor2/DSC02477.JPG,char_data/0/DSC02477.JPG_12.jpg,624,480,640,24,472,496,243,269,True,2
0,24,kaist_dataset/Mixed/Digital_Camera/(C.S)C-outdoor2/DSC02477.JPG,char_data/0/DSC02477.JPG_13.jpg,672,480,640,28,496,524,243,267,True,2
0,26,kaist_dataset/Mixed/Digital_Camera/(C.S)C-outdoor2/DSC02477.JPG,char_data/0/DSC02477.JPG_14.jpg,780,480,640,30,524,554,241,267,True,2
0,30,kaist_dataset/Mixed/Digital_Camera/(C.S)C-outdoor2/DSC02479.JPG,char_data/0/DSC02479.JPG_2.jpg,540,480,640,18,558,576,223,253,True,2
0,37,kaist_dataset/Mixed/Digital_Camera/(C.S)C-outdoor2/DSC02489.JPG,char_data/0/DSC02489.JPG_4.jpg,777,480,640,21,338,359,260,297,True,2
0,36,kaist_dataset/Mixed/Digital_Camera/(C.S)C-outdoor2/DSC02489.JPG,char_data/0/DSC02489.JPG_5.jpg,720,480,640,20,359,379,260,296,True,2
0,68,kaist_dataset/Mixed/Digital_Camera/(C.S)C-outdoor2/DSC02502.JPG,char_data/0/DSC02502.JPG_2.jpg,2720,480,640,40,228,268,344,412,True,2
0,65,kaist_dataset/Mixed/Digital_Camera/(C.S)C-outdoor2/DSC02503.JPG,char_data/0/DSC02503.JPG_2.jpg,3315,480,640,51,494,545,343,408,True,2
0,32,kaist_dataset/Mixed/Digital_Camera/(C.S)C-outdoor2/DSC02511.JPG,char_data/0/DSC02511.JPG_2.jpg,896,480,640,28,381,409,215,247,True,2
0,34,kaist_dataset/Mixed/Digital_Camera/(C.S)C-outdoor2/DSC02545.JPG,char_data/0/DSC02545.JPG_4.jpg,1564,480,640,46,52,98,404,438,True,2
0,33,kaist_dataset/Mixed/Digital_Camera/(C.S)C-outdoor2/DSC02545.JPG,char_data/0/DSC02545.JPG_5.jpg,1485,480,640,45,387,432,403,436,True,2
0,28,kaist_dataset/Mixed/Digital_Camera/(C.S)C-outdoor2/DSC02555.JPG,char_data/0/DSC02555.JPG_10.jpg,700,480,640,25,293,318,252,280,True,2
0,27,kaist_dataset/Mixed/Digital_Camera/(C.S)C-outdoor2/DSC02555.JPG,char_data/0/DSC02555.JPG_11.jpg,621,480,640,23,345,368,252,279,True,2
0,22,kaist_dataset/Mixed/Digital_Camera/(C.S)C-outdoor2/DSC02555.JPG,char_data/0/DSC02555.JPG_12.jpg,462,480,640,21,516,537,252,274,True,2
0,28,kaist_dataset/Mixed/Digital_Camera/(C.S)C-outdoor2/DSC02555.JPG,char_data/0/DSC02555.JPG_13.jpg,700,480,640,25,538,563,250,278,True,2
0,31,kaist_dataset/Mixed/Digital_Camera/(C.S)C-outdoor2/DSC02555.JPG,char_data/0/DSC02555.JPG_14.jpg,837,480,640,27,563,590,247,278,True,2
0,29,kaist_dataset/Mixed/Digital_Camera/(C.S)C-outdoor2/DSC02556.JPG,char_data/0/DSC02556.JPG_2.jpg,1160,480,640,40,456,496,346,375,True,2
0,39,kaist_dataset/Mixed/Digital_Camera/(C.S)C-outdoor2/DSC02557.JPG,char_data/0/DSC02557.JPG_2.jpg,1092,480,640,28,514,542,208,247,True,2
0,31,kaist_dataset/Mixed/Digital_Camera/(C.S)C-outdoor2/DSC02624.JPG,char_data/0/DSC02624.JPG_5.jpg,434,480,640,14,478,492,398,429,True,2
0,96,kaist_dataset/Mixed/Digital_Camera/(C.S)C-outdoor2/DSC02865.JPG,char_data/0/DSC02865.JPG_4.jpg,4992,480,640,52,411,463,307,403,True,2
0,95,kaist_dataset/Mixed/Digital_Camera/(C.S)C-outdoor2/DSC02865.JPG,char_data/0/DSC02865.JPG_5.jpg,5320,480,640,56,465,521,307,402,True,2
0,33,kaist_dataset/Mixed/Digital_Camera/(C.S)C-outdoor2/DSC02912.JPG,char_data/0/DSC02912.JPG_4.jpg,627,480,640,19,349,368,9,42,True,2
0,34,kaist_dataset/Mixed/Digital_Camera/(C.S)C-outdoor2/DSC02912.JPG,char_data/0/DSC02912.JPG_5.jpg,850,480,640,25,368,393,11,45,True,2
0,34,kaist_dataset/Mixed/Digital_Camera/(C.S)C-outdoor2/DSC02926.JPG,char_data/0/DSC02926.JPG_2.jpg,952,480,640,28,531,559,146,180,True,2
0,38,kaist_dataset/Mixed/Digital_Camera/(C.S)C-outdoor2/DSC02933.JPG,char_data/0/DSC02933.JPG_2.jpg,684,480,640,18,540,558,246,284,True,2
0,30,kaist_dataset/Mixed/Digital_Camera/(C.S)C-outdoor2/DSC02936.JPG,char_data/0/DSC02936.JPG_2.jpg,390,480,640,13,579,592,226,256,True,2
0,41,kaist_dataset/Mixed/Digital_Camera/(C.S)C-outdoor2/DSC02938.JPG,char_data/0/DSC02938.JPG_2.jpg,984,480,640,24,496,520,245,286,True,2
0,29,kaist_dataset/Mixed/Digital_Camera/(C.S)C-outdoor2/DSC02947.JPG,char_data/0/DSC02947.JPG_2.jpg,580,480,640,20,461,481,236,265,True,2
0,38,kaist_dataset/Mixed/Digital_Camera/(C.S)C-outdoor2/DSC02954.JPG,char_data/0/DSC02954.JPG_8.jpg,1064,480,640,28,261,289,259,297,True,2
0,37,kaist_dataset/Mixed/Digital_Camera/(C.S)C-outdoor2/DSC02954.JPG,char_data/0/DSC02954.JPG_9.jpg,888,480,640,24,371,395,263,300,True,2
0,41,kaist_dataset/Mixed/Digital_Camera/(C.S)C-outdoor2/DSC02954.JPG,char_data/0/DSC02954.JPG_10.jpg,656,480,640,16,491,507,263,304,True,2
0,36,kaist_dataset/Mixed/Digital_Camera/(C.S)C-outdoor2/DSC02954.JPG,char_data/0/DSC02954.JPG_11.jpg,720,480,640,20,590,610,269,305,True,2
0,56,kaist_dataset/Mixed/Digital_Camera/(C.S)C-outdoor2/P1010013.JPG,char_data/0/P1010013.JPG_4.jpg,1680,480,640,30,404,434,363,419,True,2
0,56,kaist_dataset/Mixed/Digital_Camera/(C.S)C-outdoor2/P1010013.JPG,char_data/0/P1010013.JPG_5.jpg,1736,480,640,31,434,465,364,420,True,2
0,40,kaist_dataset/Mixed/Digital_Camera/(C.S)C-outdoor3/DSC02969.JPG,char_data/0/DSC02969.JPG_4.jpg,800,480,640,20,347,367,227,267,True,2
0,35,kaist_dataset/Mixed/Digital_Camera/(C.S)C-outdoor3/DSC02969.JPG,char_data/0/DSC02969.JPG_5.jpg,665,480,640,19,442,461,231,266,True,2
0,37,kaist_dataset/Mixed/Digital_Camera/(C.S)C-outdoor3/DSC02970.JPG,char_data/0/DSC02970.JPG_4.jpg,1406,480,640,38,279,317,363,400,True,2
0,43,kaist_dataset/Mixed/Digital_Camera/(C.S)C-outdoor3/DSC02970.JPG,char_data/0/DSC02970.JPG_5.jpg,1333,480,640,31,347,378,358,401,True,2
0,36,kaist_dataset/Mixed/Digital_Camera/(C.S)C-outdoor3/DSC03051.JPG,char_data/0/DSC03051.JPG_2.jpg,720,480,640,20,357,377,315,351,True,2
0,53,kaist_dataset/Mixed/Digital_Camera/(C.S)C-outdoor3/DSC03067.JPG,char_data/0/DSC03067.JPG_4.jpg,1961,480,640,37,378,415,195,248,True,2
0,56,kaist_dataset/Mixed/Digital_Camera/(C.S)C-outdoor3/DSC03067.JPG,char_data/0/DSC03067.JPG_5.jpg,2016,480,640,36,415,451,196,252,True,2
0,41,kaist_dataset/Mixed/Digital_Camera/(C.S)C-outdoor3/DSC03185.JPG,char_data/0/DSC03185.JPG_4.jpg,1968,480,640,48,379,427,155,196,True,2
0,47,kaist_dataset/Mixed/Digital_Camera/(C.S)C-outdoor3/DSC03185.JPG,char_data/0/DSC03185.JPG_5.jpg,2162,480,640,46,425,471,152,199,True,2
0,37,kaist_dataset/Mixed/Digital_Camera/(C.S)C-outdoor3/DSC03187.JPG,char_data/0/DSC03187.JPG_2.jpg,1147,480,640,31,443,474,392,429,True,2
0,42,kaist_dataset/Mixed/Digital_Camera/(C.S)C-outdoor3/DSC03199.JPG,char_data/0/DSC03199.JPG_6.jpg,840,480,640,20,452,472,383,425,True,2
0,57,kaist_dataset/Mixed/Digital_Camera/(C.S)C-outdoor3/DSC03199.JPG,char_data/0/DSC03199.JPG_7.jpg,2166,480,640,38,280,318,324,381,True,2
0,56,kaist_dataset/Mixed/Digital_Camera/(C.S)C-outdoor3/DSC03199.JPG,char_data/0/DSC03199.JPG_8.jpg,2184,480,640,39,549,588,320,376,True,2
0,45,kaist_dataset/Mixed/Digital_Camera/(C.S)C-outdoor3/DSC03212.JPG,char_data/0/DSC03212.JPG_2.jpg,1170,480,640,26,432,458,252,297,True,2
0,41,kaist_dataset/Mixed/Digital_Camera/(C.S)C-outdoor3/DSC03236.JPG,char_data/0/DSC03236.JPG_4.jpg,1271,480,640,31,329,360,422,463,True,2
0,40,kaist_dataset/Mixed/Digital_Camera/(C.S)C-outdoor3/DSC03236.JPG,char_data/0/DSC03236.JPG_5.jpg,1240,480,640,31,386,417,422,462,True,2
0,64,kaist_dataset/Mixed/Digital_Camera/(C.S)C-outdoor3/DSC03267.JPG,char_data/0/DSC03267.JPG_4.jpg,2688,480,640,42,288,330,57,121,True,2
0,59,kaist_dataset/Mixed/Digital_Camera/(C.S)C-outdoor3/DSC03267.JPG,char_data/0/DSC03267.JPG_5.jpg,2891,480,640,49,328,377,57,116,True,2
0,25,kaist_dataset/Mixed/Digital_Camera/(C.S)C-outdoor3/DSC03292.JPG,char_data/0/DSC03292.JPG_4.jpg,325,480,640,13,553,566,120,145,True,2
0,18,kaist_dataset/Mixed/Digital_Camera/(C.S)C-outdoor3/DSC03292.JPG,char_data/0/DSC03292.JPG_5.jpg,234,480,640,13,566,579,124,142,True,2
0,27,kaist_dataset/Mixed/Digital_Camera/(C.S)C-outdoor3/DSC03303.JPG,char_data/0/DSC03303.JPG_4.jpg,729,480,640,27,373,400,277,304,True,2
0,25,kaist_dataset/Mixed/Digital_Camera/(C.S)C-outdoor3/DSC03303.JPG,char_data/0/DSC03303.JPG_5.jpg,650,480,640,26,424,450,277,302,True,2
0,30,kaist_dataset/Mixed/Digital_Camera/(C.S)C-outdoor3/DSC03308.JPG,char_data/0/DSC03308.JPG_2.jpg,630,480,640,21,294,315,248,278,True,2
0,40,kaist_dataset/Mixed/Digital_Camera/(C.S)C-outdoor3/DSC03309.JPG,char_data/0/DSC03309.JPG_4.jpg,760,480,640,19,329,348,257,297,True,2
0,36,kaist_dataset/Mixed/Digital_Camera/(C.S)C-outdoor3/DSC03309.JPG,char_data/0/DSC03309.JPG_5.jpg,720,480,640,20,372,392,259,295,True,2
0,34,kaist_dataset/Mixed/Digital_Camera/(C.S)C-outdoor3/DSC03311.JPG,char_data/0/DSC03311.JPG_4.jpg,646,480,640,19,285,304,372,406,True,2
0,28,kaist_dataset/Mixed/Digital_Camera/(C.S)C-outdoor3/DSC03311.JPG,char_data/0/DSC03311.JPG_5.jpg,476,480,640,17,407,424,371,399,True,2
0,59,kaist_dataset/Mixed/Digital_Camera/(C.S)C-outdoor3/DSC03314.JPG,char_data/0/DSC03314.JPG_2.jpg,1534,480,640,26,433,459,362,421,True,2
0,32,kaist_dataset/Mixed/Digital_Camera/(C.S)C-outdoor3/DSC03315.JPG,char_data/0/DSC03315.JPG_2.jpg,576,480,640,18,449,467,120,152,True,2
0,33,kaist_dataset/Mixed/Digital_Camera/(C.S)C-outdoor3/DSC03316.JPG,char_data/0/DSC03316.JPG_4.jpg,726,480,640,22,468,490,81,114,True,2
0,36,kaist_dataset/Mixed/Digital_Camera/(C.S)C-outdoor3/DSC03316.JPG,char_data/0/DSC03316.JPG_5.jpg,540,480,640,15,565,580,79,115,True,2
0,31,kaist_dataset/Mixed/Digital_Camera/(C.S)C-outdoor3/DSC03328.JPG,char_data/0/DSC03328.JPG_2.jpg,775,480,640,25,250,275,404,435,True,2
0,94,kaist_dataset/Mixed/Digital_Camera/(C.S)C-outdoor3/DSC03340.JPG,char_data/0/DSC03340.JPG_2.jpg,9494,480,640,101,372,473,245,339,True,2
0,42,kaist_dataset/Mixed/Digital_Camera/(C.S)C-outdoor4/DSC03435.JPG,char_data/0/DSC03435.JPG_8.jpg,924,480,640,22,168,190,410,452,True,2
0,35,kaist_dataset/Mixed/Digital_Camera/(C.S)C-outdoor4/DSC03435.JPG,char_data/0/DSC03435.JPG_9.jpg,490,480,640,14,512,526,416,451,True,2
0,39,kaist_dataset/Mixed/Digital_Camera/(C.S)C-outdoor4/DSC03435.JPG,char_data/0/DSC03435.JPG_10.jpg,429,480,640,11,527,538,413,452,True,2
0,38,kaist_dataset/Mixed/Digital_Camera/(C.S)C-outdoor4/DSC03435.JPG,char_data/0/DSC03435.JPG_11.jpg,722,480,640,19,99,118,233,271,True,2
0,29,kaist_dataset/Mixed/Digital_Camera/(C.S)C-outdoor4/DSC03446.JPG,char_data/0/DSC03446.JPG_2.jpg,754,480,640,26,323,349,292,321,True,2
0,46,kaist_dataset/Mixed/Digital_Camera/(C.S)C-outdoor4/DSC03534.JPG,char_data/0/DSC03534.JPG_2.jpg,1380,480,640,30,319,349,286,332,True,2
0,89,kaist_dataset/Mixed/Digital_Camera/(C.S)C-outdoor4/DSC03544.JPG,char_data/0/DSC03544.JPG_2.jpg,4094,480,640,46,384,430,169,258,True,2
0,44,kaist_dataset/Mixed/Digital_Camera/(C.S)C-outdoor4/DSC03548.JPG,char_data/0/DSC03548.JPG_4.jpg,2156,480,640,49,375,424,397,441,True,2
0,49,kaist_dataset/Mixed/Digital_Camera/(C.S)C-outdoor4/DSC03548.JPG,char_data/0/DSC03548.JPG_5.jpg,2401,480,640,49,422,471,394,443,True,2
0,32,kaist_dataset/Mixed/Digital_Camera/(C.S)C-outdoor4/DSC03549.JPG,char_data/0/DSC03549.JPG_4.jpg,352,480,640,11,372,383,423,455,True,2
0,33,kaist_dataset/Mixed/Digital_Camera/(C.S)C-outdoor4/DSC03549.JPG,char_data/0/DSC03549.JPG_5.jpg,528,480,640,16,385,401,422,455,True,2
0,43,kaist_dataset/Mixed/Digital_Camera/(C.S)C-outdoor4/DSC03556.JPG,char_data/0/DSC03556.JPG_10.jpg,860,480,640,20,550,570,256,299,True,2
0,36,kaist_dataset/Mixed/Digital_Camera/(C.S)C-outdoor4/DSC03556.JPG,char_data/0/DSC03556.JPG_11.jpg,468,480,640,13,41,54,314,350,True,2
0,33,kaist_dataset/Mixed/Digital_Camera/(C.S)C-outdoor4/DSC03556.JPG,char_data/0/DSC03556.JPG_12.jpg,396,480,640,12,81,93,318,351,True,2
0,36,kaist_dataset/Mixed/Digital_Camera/(C.S)C-outdoor4/DSC03556.JPG,char_data/0/DSC03556.JPG_13.jpg,504,480,640,14,94,108,314,350,True,2
0,33,kaist_dataset/Mixed/Digital_Camera/(C.S)C-outdoor4/DSC03556.JPG,char_data/0/DSC03556.JPG_14.jpg,561,480,640,17,108,125,314,347,True,2
0,51,kaist_dataset/Mixed/Digital_Camera/(C.S)C-outdoor4/DSC03569.JPG,char_data/0/DSC03569.JPG_2.jpg,1836,480,640,36,513,549,162,213,True,2
0,29,kaist_dataset/Mixed/Digital_Camera/(C.S)C-outdoor4/DSC03570.JPG,char_data/0/DSC03570.JPG_2.jpg,493,480,640,17,324,341,425,454,True,2
0,50,kaist_dataset/Mixed/Digital_Camera/(C.S)C-outdoor4/DSC03571.JPG,char_data/0/DSC03571.JPG_2.jpg,1250,480,640,25,384,409,299,349,True,2
0,41,kaist_dataset/Mixed/Digital_Camera/(C.S)C-outdoor4/DSC03604.JPG,char_data/0/DSC03604.JPG_4.jpg,1148,480,640,28,301,329,86,127,True,2
0,40,kaist_dataset/Mixed/Digital_Camera/(C.S)C-outdoor4/DSC03604.JPG,char_data/0/DSC03604.JPG_5.jpg,1120,480,640,28,329,357,85,125,True,2
0,48,kaist_dataset/Mixed/Digital_Camera/(C.S)C-outdoor4/DSC03613.JPG,char_data/0/DSC03613.JPG_2.jpg,1008,480,640,21,377,398,26,74,True,2
0,35,kaist_dataset/Mixed/Digital_Camera/(C.S)C-outdoor4/DSC03618.JPG,char_data/0/DSC03618.JPG_2.jpg,1085,480,640,31,331,362,411,446,True,2
0,37,kaist_dataset/Mixed/Digital_Camera/(C.S)C-outdoor4/DSC03634.JPG,char_data/0/DSC03634.JPG_8.jpg,1073,480,640,29,571,600,429,466,True,2
0,31,kaist_dataset/Mixed/Digital_Camera/(C.S)C-outdoor4/DSC03634.JPG,char_data/0/DSC03634.JPG_9.jpg,775,480,640,25,292,317,245,276,True,2
0,78,kaist_dataset/Mixed/Digital_Camera/(C.S)C-outdoor4/DSC03634.JPG,char_data/0/DSC03634.JPG_10.jpg,5070,480,640,65,328,393,279,357,True,2
0,91,kaist_dataset/Mixed/Digital_Camera/(C.S)C-outdoor4/DSC03634.JPG,char_data/0/DSC03634.JPG_11.jpg,6006,480,640,66,394,460,273,364,True,2
0,29,kaist_dataset/Mixed/Digital_Camera/(C.S)C-outdoor4/DSC03637.JPG,char_data/0/DSC03637.JPG_2.jpg,435,480,640,15,328,343,297,326,True,2
0,32,kaist_dataset/Mixed/Digital_Camera/(C.S)C-outdoor4/DSC03640.JPG,char_data/0/DSC03640.JPG_2.jpg,544,480,640,17,233,250,398,430,True,2
0,52,kaist_dataset/Mixed/Digital_Camera/(C.S)C-outdoor4/DSC03655.JPG,char_data/0/DSC03655.JPG_4.jpg,1404,480,640,27,294,321,388,440,True,2
0,49,kaist_dataset/Mixed/Digital_Camera/(C.S)C-outdoor4/DSC03655.JPG,char_data/0/DSC03655.JPG_5.jpg,1029,480,640,21,322,343,388,437,True,2
0,35,kaist_dataset/Mixed/Digital_Camera/(C.S)C-outdoor4/DSC03657.JPG,char_data/0/DSC03657.JPG_2.jpg,665,480,640,19,352,371,421,456,True,2
0,35,kaist_dataset/Mixed/Digital_Camera/(C.S)C-outdoor4/DSC03658.JPG,char_data/0/DSC03658.JPG_4.jpg,805,480,640,23,376,399,414,449,True,2
0,40,kaist_dataset/Mixed/Digital_Camera/(C.S)C-outdoor4/DSC03658.JPG,char_data/0/DSC03658.JPG_5.jpg,760,480,640,19,399,418,411,451,True,2
0,38,kaist_dataset/Mixed/Digital_Camera/(C.S)C-outdoor4/DSC03660.JPG,char_data/0/DSC03660.JPG_2.jpg,1064,480,640,28,377,405,97,135,True,2
0,30,kaist_dataset/Mixed/Digital_Camera/(C.S)C-outdoor4/DSC03661.JPG,char_data/0/DSC03661.JPG_4.jpg,570,480,640,19,376,395,336,366,True,2
0,33,kaist_dataset/Mixed/Digital_Camera/(C.S)C-outdoor4/DSC03661.JPG,char_data/0/DSC03661.JPG_5.jpg,627,480,640,19,408,427,334,367,True,2
0,36,kaist_dataset/Mixed/Digital_Camera/(C.S)C-outdoor4/DSC03667.JPG,char_data/0/DSC03667.JPG_2.jpg,792,480,640,22,364,386,376,412,True,2
0,28,kaist_dataset/Mixed/Digital_Camera/(C.S)C-outdoor4/DSC03670.JPG,char_data/0/DSC03670.JPG_2.jpg,336,480,640,12,468,480,448,476,True,2
0,44,kaist_dataset/Mixed/Digital_Camera/(C.S)C-outdoor4/DSC03673.JPG,char_data/0/DSC03673.JPG_2.jpg,1408,480,640,32,87,119,304,348,True,2
0,40,kaist_dataset/Mixed/Digital_Camera/(C.S)C-outdoor4/DSC03674.JPG,char_data/0/DSC03674.JPG_6.jpg,960,480,640,24,524,548,354,394,True,2
0,37,kaist_dataset/Mixed/Digital_Camera/(C.S)C-outdoor4/DSC03674.JPG,char_data/0/DSC03674.JPG_7.jpg,666,480,640,18,547,565,354,391,True,2
0,42,kaist_dataset/Mixed/Digital_Camera/(C.S)C-outdoor4/DSC03674.JPG,char_data/0/DSC03674.JPG_8.jpg,966,480,640,23,564,587,344,386,True,2
0,30,kaist_dataset/Mixed/Digital_Camera/(C.S)C-outdoor4/DSC03677.JPG,char_data/0/DSC03677.JPG_10.jpg,330,480,640,11,508,519,314,344,True,2
0,30,kaist_dataset/Mixed/Digital_Camera/(C.S)C-outdoor4/DSC03677.JPG,char_data/0/DSC03677.JPG_11.jpg,300,480,640,10,530,540,314,344,True,2
0,28,kaist_dataset/Mixed/Digital_Camera/(C.S)C-outdoor4/DSC03677.JPG,char_data/0/DSC03677.JPG_12.jpg,308,480,640,11,568,579,311,339,True,2
0,33,kaist_dataset/Mixed/Digital_Camera/(C.S)C-outdoor4/DSC03677.JPG,char_data/0/DSC03677.JPG_13.jpg,429,480,640,13,597,610,310,343,True,2
0,39,kaist_dataset/Mixed/Digital_Camera/(C.S)C-outdoor4/DSC03677.JPG,char_data/0/DSC03677.JPG_14.jpg,429,480,640,11,620,631,307,346,True,2
0,37,kaist_dataset/Mixed/Digital_Camera/(C.S)C-outdoor4/DSC03679.JPG,char_data/0/DSC03679.JPG_2.jpg,814,480,640,22,383,405,282,319,True,2
0,37,kaist_dataset/Mixed/Digital_Camera/(C.S)C-outdoor4/DSC03691.JPG,char_data/0/DSC03691.JPG_2.jpg,444,480,640,12,628,639,216,253,True,2
0,44,kaist_dataset/Mixed/Digital_Camera/(C.S)C-outdoor4/DSC03693.JPG,char_data/0/DSC03693.JPG_2.jpg,1100,480,640,25,485,510,354,398,True,2
0,63,kaist_dataset/Mixed/Digital_Camera/(C.S)C-outdoor4/DSC03702.JPG,char_data/0/DSC03702.JPG_4.jpg,3024,480,640,48,310,358,340,403,True,2
0,63,kaist_dataset/Mixed/Digital_Camera/(C.S)C-outdoor4/DSC03702.JPG,char_data/0/DSC03702.JPG_5.jpg,2709,480,640,43,359,402,339,402,True,2
0,44,kaist_dataset/Mixed/Digital_Camera/(C.S)C-outdoor4/DSC03724.JPG,char_data/0/DSC03724.JPG_2.jpg,1364,480,640,31,529,560,275,319,True,2
0,70,kaist_dataset/Mixed/Digital_Camera/(C.S)C-outdoor4/DSC03730.JPG,char_data/0/DSC03730.JPG_4.jpg,3990,480,640,57,365,422,323,393,True,2
0,68,kaist_dataset/Mixed/Digital_Camera/(C.S)C-outdoor4/DSC03730.JPG,char_data/0/DSC03730.JPG_5.jpg,4828,480,640,71,416,487,322,390,True,2
0,31,kaist_dataset/Mixed/Digital_Camera/(C.S)C-outdoor4/DSC03733.JPG,char_data/0/DSC03733.JPG_4.jpg,558,480,640,18,535,553,176,207,True,2
0,31,kaist_dataset/Mixed/Digital_Camera/(C.S)C-outdoor4/DSC03733.JPG,char_data/0/DSC03733.JPG_5.jpg,496,480,640,16,566,582,175,206,True,2
0,36,kaist_dataset/Mixed/Digital_Camera/(C.S)C-outdoor4/DSC03745.JPG,char_data/0/DSC03745.JPG_2.jpg,756,480,640,21,540,561,270,306,True,2
0,28,kaist_dataset/Mixed/Digital_Camera/(C.S)C-outdoor4/DSC03757.JPG,char_data/0/DSC03757.JPG_8.jpg,420,480,640,15,189,204,340,368,True,2
0,28,kaist_dataset/Mixed/Digital_Camera/(C.S)C-outdoor4/DSC03757.JPG,char_data/0/DSC03757.JPG_9.jpg,336,480,640,12,216,228,339,367,True,2
0,30,kaist_dataset/Mixed/Digital_Camera/(C.S)C-outdoor4/DSC03757.JPG,char_data/0/DSC03757.JPG_10.jpg,420,480,640,14,364,378,338,368,True,2
0,28,kaist_dataset/Mixed/Digital_Camera/(C.S)C-outdoor4/DSC03757.JPG,char_data/0/DSC03757.JPG_11.jpg,336,480,640,12,390,402,338,366,True,2
0,39,kaist_dataset/Mixed/Digital_Camera/(C.S)C-outdoor5/DSC03821.JPG,char_data/0/DSC03821.JPG_6.jpg,897,480,640,23,381,404,85,124,True,2
0,37,kaist_dataset/Mixed/Digital_Camera/(C.S)C-outdoor5/DSC03821.JPG,char_data/0/DSC03821.JPG_7.jpg,851,480,640,23,425,448,86,123,True,2
0,44,kaist_dataset/Mixed/Digital_Camera/(C.S)C-outdoor5/DSC03821.JPG,char_data/0/DSC03821.JPG_8.jpg,968,480,640,22,212,234,72,116,True,2
0,63,kaist_dataset/Mixed/Digital_Camera/(C.S)C-outdoor5/DSC03837.JPG,char_data/0/DSC03837.JPG_8.jpg,2394,480,640,38,85,123,297,360,True,2
0,59,kaist_dataset/Mixed/Digital_Camera/(C.S)C-outdoor5/DSC03837.JPG,char_data/0/DSC03837.JPG_9.jpg,2242,480,640,38,360,398,307,366,True,2
0,60,kaist_dataset/Mixed/Digital_Camera/(C.S)C-outdoor5/DSC03837.JPG,char_data/0/DSC03837.JPG_10.jpg,2160,480,640,36,397,433,307,367,True,2
0,56,kaist_dataset/Mixed/Digital_Camera/(C.S)C-outdoor5/DSC03837.JPG,char_data/0/DSC03837.JPG_11.jpg,2072,480,640,37,466,503,311,367,True,2
0,41,kaist_dataset/Mixed/Digital_Camera/(C.S)C-outdoor5/DSC03842.JPG,char_data/0/DSC03842.JPG_6.jpg,902,480,640,22,299,321,228,269,True,2
0,38,kaist_dataset/Mixed/Digital_Camera/(C.S)C-outdoor5/DSC03842.JPG,char_data/0/DSC03842.JPG_7.jpg,874,480,640,23,322,345,228,266,True,2
0,42,kaist_dataset/Mixed/Digital_Camera/(C.S)C-outdoor5/DSC03842.JPG,char_data/0/DSC03842.JPG_8.jpg,966,480,640,23,367,390,228,270,True,2
0,60,kaist_dataset/Mixed/Digital_Camera/(C.S)C-outdoor5/DSC03847.JPG,char_data/0/DSC03847.JPG_2.jpg,1800,480,640,30,333,363,14,74,True,2
0,41,kaist_dataset/Mixed/Digital_Camera/(C.S)C-outdoor5/DSC04014.JPG,char_data/0/DSC04014.JPG_6.jpg,779,480,640,19,205,224,300,341,True,2
0,41,kaist_dataset/Mixed/Digital_Camera/(C.S)C-outdoor5/DSC04014.JPG,char_data/0/DSC04014.JPG_7.jpg,820,480,640,20,341,361,300,341,True,2
0,36,kaist_dataset/Mixed/Digital_Camera/(C.S)C-outdoor5/DSC04014.JPG,char_data/0/DSC04014.JPG_8.jpg,900,480,640,25,376,401,302,338,True,2
0,72,kaist_dataset/Mixed/Digital_Camera/(C.S)C-outdoor5/DSC04016.JPG,char_data/0/DSC04016.JPG_2.jpg,3024,480,640,42,362,404,321,393,True,2
0,59,kaist_dataset/Mixed/Digital_Camera/(C.S)C-outdoor5/DSC04033.JPG,char_data/0/DSC04033.JPG_2.jpg,2065,480,640,35,423,458,267,326,True,2
0,34,kaist_dataset/Mixed/Digital_Camera/(C.S)C-outdoor5/DSC04048.JPG,char_data/0/DSC04048.JPG_2.jpg,442,480,640,13,366,379,170,204,True,2
0,88,kaist_dataset/Mixed/Digital_Camera/(C.S)C-outdoor5/DSC04054.JPG,char_data/0/DSC04054.JPG_4.jpg,7128,480,640,81,343,424,68,156,True,2
0,93,kaist_dataset/Mixed/Digital_Camera/(C.S)C-outdoor5/DSC04054.JPG,char_data/0/DSC04054.JPG_5.jpg,7905,480,640,85,515,600,67,160,True,2
0,44,kaist_dataset/Mixed/Digital_Camera/(C.S)C-outdoor5/DSC04055.JPG,char_data/0/DSC04055.JPG_4.jpg,1408,480,640,32,108,140,369,413,True,2
0,38,kaist_dataset/Mixed/Digital_Camera/(C.S)C-outdoor5/DSC04055.JPG,char_data/0/DSC04055.JPG_5.jpg,1368,480,640,36,171,207,371,409,True,2
0,30,kaist_dataset/Mixed/Digital_Camera/(C.S)C-outdoor5/DSC04056.JPG,char_data/0/DSC04056.JPG_2.jpg,630,480,640,21,562,583,301,331,True,2
0,35,kaist_dataset/Mixed/Digital_Camera/(C.S)C-outdoor5/DSC04061.JPG,char_data/0/DSC04061.JPG_4.jpg,630,480,640,18,547,565,144,179,True,2
0,35,kaist_dataset/Mixed/Digital_Camera/(C.S)C-outdoor5/DSC04061.JPG,char_data/0/DSC04061.JPG_5.jpg,525,480,640,15,580,595,139,174,True,2
0,40,kaist_dataset/Mixed/Digital_Camera/(C.S)C-outdoor5/DSC04070.JPG,char_data/0/DSC04070.JPG_2.jpg,720,480,640,18,452,470,103,143,True,2
0,28,kaist_dataset/Mixed/Digital_Camera/(C.S)C-outdoor5/DSC04072.JPG,char_data/0/DSC04072.JPG_6.jpg,420,480,640,15,445,460,353,381,True,2
0,30,kaist_dataset/Mixed/Digital_Camera/(C.S)C-outdoor5/DSC04072.JPG,char_data/0/DSC04072.JPG_7.jpg,330,480,640,11,472,483,349,379,True,2
0,35,kaist_dataset/Mixed/Digital_Camera/(C.S)C-outdoor5/DSC04072.JPG,char_data/0/DSC04072.JPG_8.jpg,455,480,640,13,540,553,347,382,True,2
0,27,kaist_dataset/Mixed/Digital_Camera/(C.S)C-outdoor5/DSC04086.JPG,char_data/0/DSC04086.JPG_4.jpg,459,480,640,17,420,437,373,400,True,2
0,29,kaist_dataset/Mixed/Digital_Camera/(C.S)C-outdoor5/DSC04086.JPG,char_data/0/DSC04086.JPG_5.jpg,348,480,640,12,438,450,371,400,True,2
0,39,kaist_dataset/Mixed/Digital_Camera/(C.S)C-outdoor5/DSC04115.JPG,char_data/0/DSC04115.JPG_2.jpg,936,480,640,24,435,459,354,393,True,2
0,41,kaist_dataset/Mixed/Digital_Camera/(C.S)C-outdoor5/DSC04122.JPG,char_data/0/DSC04122.JPG_2.jpg,615,480,640,15,425,440,411,452,True,2
0,43,kaist_dataset/Mixed/Digital_Camera/(C.S)C-outdoor5/DSC04125.JPG,char_data/0/DSC04125.JPG_2.jpg,1118,480,640,26,140,166,181,224,True,2
0,42,kaist_dataset/Mixed/Digital_Camera/(C.S)C-outdoor5/DSC04135.JPG,char_data/0/DSC04135.JPG_4.jpg,924,480,640,22,513,535,393,435,True,2
0,44,kaist_dataset/Mixed/Digital_Camera/(C.S)C-outdoor5/DSC04135.JPG,char_data/0/DSC04135.JPG_5.jpg,1232,480,640,28,562,590,394,438,True,2
0,39,kaist_dataset/Mixed/Digital_Camera/(C.S)C-outdoor5/DSC04144.JPG,char_data/0/DSC04144.JPG_4.jpg,858,480,640,22,345,367,416,455,True,2
0,39,kaist_dataset/Mixed/Digital_Camera/(C.S)C-outdoor5/DSC04144.JPG,char_data/0/DSC04144.JPG_5.jpg,897,480,640,23,385,408,418,457,True,2
0,29,kaist_dataset/Mixed/Digital_Camera/(C.S)C-outdoor5/DSC04155.JPG,char_data/0/DSC04155.JPG_2.jpg,493,480,640,17,538,555,265,294,True,2
0,29,kaist_dataset/Mixed/Digital_Camera/(C.S)C-outdoor5/DSC04357.JPG,char_data/0/DSC04357.JPG_8.jpg,493,480,640,17,202,219,380,409,True,2
0,33,kaist_dataset/Mixed/Digital_Camera/(C.S)C-outdoor5/DSC04357.JPG,char_data/0/DSC04357.JPG_9.jpg,495,480,640,15,241,256,377,410,True,2
0,31,kaist_dataset/Mixed/Digital_Camera/(C.S)C-outdoor5/DSC04357.JPG,char_data/0/DSC04357.JPG_10.jpg,434,480,640,14,256,270,377,408,True,2
0,28,kaist_dataset/Mixed/Digital_Camera/(C.S)C-outdoor5/DSC04357.JPG,char_data/0/DSC04357.JPG_11.jpg,560,480,640,20,223,243,382,410,True,2
0,40,kaist_dataset/Mixed/Digital_Camera/(C.S)C-outdoor5/DSC04395.JPG,char_data/0/DSC04395.JPG_6.jpg,920,480,640,23,185,208,290,330,True,2
0,46,kaist_dataset/Mixed/Digital_Camera/(C.S)C-outdoor5/DSC04395.JPG,char_data/0/DSC04395.JPG_7.jpg,828,480,640,18,209,227,287,333,True,2
0,44,kaist_dataset/Mixed/Digital_Camera/(C.S)C-outdoor5/DSC04395.JPG,char_data/0/DSC04395.JPG_8.jpg,880,480,640,20,227,247,286,330,True,2
0,58,kaist_dataset/Mixed/Digital_Camera/(C.S)C-outdoor5/DSC04401.JPG,char_data/0/DSC04401.JPG_2.jpg,2204,480,640,38,561,599,247,305,True,2
0,66,kaist_dataset/Mixed/Digital_Camera/(C.S)C-outdoor5/DSC04450.JPG,char_data/0/DSC04450.JPG_2.jpg,2178,480,640,33,351,384,133,199,True,2
0,160,kaist_dataset/Mixed/Digital_Camera/(C.S)C-outdoor5/DSC04451.JPG,char_data/0/DSC04451.JPG_2.jpg,13600,480,640,85,122,207,283,443,True,2
0,103,kaist_dataset/Mixed/Digital_Camera/(C.S)C-outdoor5/P1010006.JPG,char_data/0/P1010006.JPG_4.jpg,6695,480,640,65,212,277,202,305,True,2
0,108,kaist_dataset/Mixed/Digital_Camera/(C.S)C-outdoor5/P1010006.JPG,char_data/0/P1010006.JPG_5.jpg,7020,480,640,65,279,344,192,300,True,2
0,42,kaist_dataset/Mixed/Digital_Camera/(C.S)C-outdoor6/P1010018.JPG,char_data/0/P1010018.JPG_4.jpg,1176,480,640,28,296,324,237,279,True,2
0,39,kaist_dataset/Mixed/Digital_Camera/(C.S)C-outdoor6/P1010018.JPG,char_data/0/P1010018.JPG_5.jpg,1092,480,640,28,547,575,240,279,True,2
0,35,kaist_dataset/Mixed/Digital_Camera/(C.S)C-outdoor6/P1010020.JPG,char_data/0/P1010020.JPG_2.jpg,700,480,640,20,206,226,336,371,True,2
0,39,kaist_dataset/Mixed/Digital_Camera/(C.S)C-outdoor6/P1010021.JPG,char_data/0/P1010021.JPG_4.jpg,1053,480,640,27,285,312,208,247,True,2
0,41,kaist_dataset/Mixed/Digital_Camera/(C.S)C-outdoor6/P1010021.JPG,char_data/0/P1010021.JPG_5.jpg,1189,480,640,29,314,343,206,247,True,2
0,131,kaist_dataset/Mixed/Digital_Camera/(C.S)C-outdoor6/P1010045.JPG,char_data/0/P1010045.JPG_2.jpg,14148,480,640,108,286,394,147,278,True,2
0,38,kaist_dataset/Mixed/Digital_Camera/(C.S)C-outdoor6/P1010056.JPG,char_data/0/P1010056.JPG_2.jpg,608,480,640,16,402,418,227,265,True,2
0,82,kaist_dataset/Mixed/Digital_Camera/(C.S)C-outdoor6/P1010063.JPG,char_data/0/P1010063.JPG_10.jpg,5576,480,640,68,264,332,140,222,False,2
0,90,kaist_dataset/Mixed/Digital_Camera/(C.S)C-outdoor6/P1010063.JPG,char_data/0/P1010063.JPG_11.jpg,5850,480,640,65,334,399,138,228,False,2
0,92,kaist_dataset/Mixed/Digital_Camera/(C.S)C-outdoor6/P1010063.JPG,char_data/0/P1010063.JPG_12.jpg,6532,480,640,71,399,470,139,231,False,2
0,23,kaist_dataset/Mixed/Digital_Camera/(C.S)C-outdoor6/P1010063.JPG,char_data/0/P1010063.JPG_13.jpg,276,480,640,12,185,197,452,475,False,2
0,23,kaist_dataset/Mixed/Digital_Camera/(C.S)C-outdoor6/P1010063.JPG,char_data/0/P1010063.JPG_14.jpg,184,480,640,8,197,205,450,473,False,2
0,58,kaist_dataset/Mixed/Digital_Camera/(C.S)C-outdoor6/P1010067.JPG,char_data/0/P1010067.JPG_2.jpg,2726,480,640,47,586,633,306,364,False,2
0,31,kaist_dataset/Mixed/Digital_Camera/(C.S)C-outdoor6/P1010069.JPG,char_data/0/P1010069.JPG_5.jpg,837,480,640,27,586,613,315,346,False,2
0,31,kaist_dataset/Mixed/Digital_Camera/(C.S)C-outdoor6/P1010073.JPG,char_data/0/P1010073.JPG_2.jpg,465,480,640,15,383,398,241,272,False,2
0,32,kaist_dataset/Mixed/Digital_Camera/(C.S)C-outdoor6/P1010074.JPG,char_data/0/P1010074.JPG_2.jpg,1152,480,640,36,350,386,304,336,False,2
0,24,kaist_dataset/Mixed/Digital_Camera/(C.S)C-outdoor6/P1010075.JPG,char_data/0/P1010075.JPG_2.jpg,552,480,640,23,548,571,311,335,False,2
0,33,kaist_dataset/Mixed/Digital_Camera/(C.S)C-outdoor6/P1010080.JPG,char_data/0/P1010080.JPG_5.jpg,924,480,640,28,478,506,247,280,False,2
0,26,kaist_dataset/Mixed/Digital_Camera/(C.S)C-outdoor6/P1010082.JPG,char_data/0/P1010082.JPG_2.jpg,468,480,640,18,484,502,231,257,False,2
0,37,kaist_dataset/Mixed/Digital_Camera/(C.S)C-outdoor6/P1010084.JPG,char_data/0/P1010084.JPG_4.jpg,851,480,640,23,28,51,186,223,False,2
0,43,kaist_dataset/Mixed/Digital_Camera/(C.S)C-outdoor6/P1010084.JPG,char_data/0/P1010084.JPG_5.jpg,1462,480,640,34,492,526,188,231,False,2
0,24,kaist_dataset/Mixed/Digital_Camera/(C.S)C-outdoor6/P1010088.JPG,char_data/0/P1010088.JPG_2.jpg,288,480,640,12,374,386,220,244,False,2
0,29,kaist_dataset/Mixed/Digital_Camera/(C.S)C-outdoor6/P1010093.JPG,char_data/0/P1010093.JPG_4.jpg,522,480,640,18,568,586,246,275,False,2
0,28,kaist_dataset/Mixed/Digital_Camera/(C.S)C-outdoor6/P1010093.JPG,char_data/0/P1010093.JPG_5.jpg,588,480,640,21,600,621,248,276,False,2
0,21,kaist_dataset/Mixed/Digital_Camera/(C.S)C-outdoor6/P1010094.JPG,char_data/0/P1010094.JPG_4.jpg,483,480,640,23,558,581,220,241,False,2
0,22,kaist_dataset/Mixed/Digital_Camera/(C.S)C-outdoor6/P1010094.JPG,char_data/0/P1010094.JPG_5.jpg,374,480,640,17,581,598,218,240,False,2
0,41,kaist_dataset/Mixed/Digital_Camera/(C.S)C-outdoor6/P1010103.JPG,char_data/0/P1010103.JPG_2.jpg,779,480,640,19,535,554,194,235,False,2
0,42,kaist_dataset/Mixed/Digital_Camera/(C.S)C-outdoor6/P1010111.JPG,char_data/0/P1010111.JPG_10.jpg,1554,480,640,37,353,390,200,242,False,2
0,36,kaist_dataset/Mixed/Digital_Camera/(C.S)C-outdoor6/P1010111.JPG,char_data/0/P1010111.JPG_11.jpg,1296,480,640,36,420,456,204,240,False,2
0,26,kaist_dataset/Mixed/Digital_Camera/(C.S)C-outdoor6/P1010114.JPG,char_data/0/P1010114.JPG_2.jpg,494,480,640,19,516,535,216,242,False,2
0,20,kaist_dataset/Mixed/Digital_Camera/(C.S)C-outdoor6/P1010129.JPG,char_data/0/P1010129.JPG_2.jpg,400,480,640,20,463,483,237,257,False,2
0,37,kaist_dataset/Mixed/Digital_Camera/(C.S)C-outdoor6/P1010137.JPG,char_data/0/P1010137.JPG_4.jpg,851,480,640,23,20,43,70,107,False,2
0,36,kaist_dataset/Mixed/Digital_Camera/(C.S)C-outdoor6/P1010137.JPG,char_data/0/P1010137.JPG_5.jpg,1188,480,640,33,89,122,69,105,False,2
0,29,kaist_dataset/Mixed/Digital_Camera/(C.S)C-outdoor6/크기변환_fadscf0009_creawell.jpg,char_data/0/크기변환_fadscf0009_creawell.jpg_4.jpg,522,480,640,18,288,306,157,186,False,2
0,33,kaist_dataset/Mixed/Digital_Camera/(C.S)C-outdoor6/크기변환_fadscf0009_creawell.jpg,char_data/0/크기변환_fadscf0009_creawell.jpg_5.jpg,561,480,640,17,406,423,165,198,False,2
0,40,kaist_dataset/Mixed/Digital_Camera/(C.S)C-outdoor6/크기변환_P1010029.JPG,char_data/0/크기변환_P1010029.JPG_10.jpg,600,480,640,15,32,47,7,47,False,2
0,36,kaist_dataset/Mixed/Digital_Camera/(C.S)C-outdoor6/크기변환_P1010029.JPG,char_data/0/크기변환_P1010029.JPG_11.jpg,792,480,640,22,57,79,11,47,False,2
0,53,kaist_dataset/Mixed/Digital_Camera/(C.S)C-outdoor6/크기변환_P1010029.JPG,char_data/0/크기변환_P1010029.JPG_12.jpg,1908,480,640,36,110,146,259,312,False,2
0,59,kaist_dataset/Mixed/Digital_Camera/(C.S)C-outdoor6/크기변환_P1010029.JPG,char_data/0/크기변환_P1010029.JPG_13.jpg,2301,480,640,39,232,271,260,319,False,2
0,66,kaist_dataset/Mixed/Digital_Camera/(C.S)C-outdoor6/크기변환_P1010029.JPG,char_data/0/크기변환_P1010029.JPG_14.jpg,2640,480,640,40,423,463,258,324,False,2
0,39,kaist_dataset/Mixed/Digital_Camera/(C.S)D-indoor1/DSC02746.JPG,char_data/0/DSC02746.JPG_6.jpg,1131,480,640,29,95,124,295,334,False,2
0,36,kaist_dataset/Mixed/Digital_Camera/(C.S)D-indoor1/DSC02746.JPG,char_data/0/DSC02746.JPG_7.jpg,864,480,640,24,123,147,296,332,False,2
0,38,kaist_dataset/Mixed/Digital_Camera/(C.S)D-indoor1/DSC02746.JPG,char_data/0/DSC02746.JPG_8.jpg,1178,480,640,31,149,180,293,331,False,2
0,47,kaist_dataset/Mixed/Digital_Camera/(C.S)D-indoor1/DSC02747.JPG,char_data/0/DSC02747.JPG_6.jpg,1692,480,640,36,43,79,333,380,False,2
0,43,kaist_dataset/Mixed/Digital_Camera/(C.S)D-indoor1/DSC02747.JPG,char_data/0/DSC02747.JPG_7.jpg,1462,480,640,34,78,112,333,376,False,2
0,44,kaist_dataset/Mixed/Digital_Camera/(C.S)D-indoor1/DSC02747.JPG,char_data/0/DSC02747.JPG_8.jpg,1672,480,640,38,112,150,335,379,False,2
0,42,kaist_dataset/Mixed/Digital_Camera/(C.S)D-indoor1/DSC02748.JPG,char_data/0/DSC02748.JPG_6.jpg,1260,480,640,30,67,97,340,382,False,2
0,43,kaist_dataset/Mixed/Digital_Camera/(C.S)D-indoor1/DSC02748.JPG,char_data/0/DSC02748.JPG_7.jpg,1462,480,640,34,97,131,339,382,False,2
0,42,kaist_dataset/Mixed/Digital_Camera/(C.S)D-indoor1/DSC02748.JPG,char_data/0/DSC02748.JPG_8.jpg,1386,480,640,33,132,165,342,384,False,2
0,39,kaist_dataset/Mixed/Digital_Camera/(C.S)D-indoor1/DSC02749.JPG,char_data/0/DSC02749.JPG_6.jpg,1014,480,640,26,93,119,367,406,False,2
0,39,kaist_dataset/Mixed/Digital_Camera/(C.S)D-indoor1/DSC02749.JPG,char_data/0/DSC02749.JPG_7.jpg,1092,480,640,28,117,145,367,406,False,2
0,36,kaist_dataset/Mixed/Digital_Camera/(C.S)D-indoor1/DSC02749.JPG,char_data/0/DSC02749.JPG_8.jpg,1152,480,640,32,146,178,368,404,False,2
0,34,kaist_dataset/Mixed/Digital_Camera/(C.S)D-indoor1/DSC02750.JPG,char_data/0/DSC02750.JPG_6.jpg,918,480,640,27,80,107,273,307,False,2
0,30,kaist_dataset/Mixed/Digital_Camera/(C.S)D-indoor1/DSC02750.JPG,char_data/0/DSC02750.JPG_7.jpg,780,480,640,26,108,134,274,304,False,2
0,33,kaist_dataset/Mixed/Digital_Camera/(C.S)D-indoor1/DSC02750.JPG,char_data/0/DSC02750.JPG_8.jpg,924,480,640,28,137,165,269,302,False,2
0,42,kaist_dataset/Mixed/Digital_Camera/(C.S)D-indoor1/DSC02751.JPG,char_data/0/DSC02751.JPG_6.jpg,1092,480,640,26,86,112,254,296,False,2
0,42,kaist_dataset/Mixed/Digital_Camera/(C.S)D-indoor1/DSC02751.JPG,char_data/0/DSC02751.JPG_7.jpg,1386,480,640,33,107,140,253,295,False,2
0,41,kaist_dataset/Mixed/Digital_Camera/(C.S)D-indoor1/DSC02751.JPG,char_data/0/DSC02751.JPG_8.jpg,1517,480,640,37,140,177,256,297,False,2
0,40,kaist_dataset/Mixed/Digital_Camera/(C.S)D-indoor1/DSC02752.JPG,char_data/0/DSC02752.JPG_6.jpg,1240,480,640,31,57,88,260,300,False,2
0,44,kaist_dataset/Mixed/Digital_Camera/(C.S)D-indoor1/DSC02752.JPG,char_data/0/DSC02752.JPG_7.jpg,1188,480,640,27,92,119,254,298,False,2
0,39,kaist_dataset/Mixed/Digital_Camera/(C.S)D-indoor1/DSC02752.JPG,char_data/0/DSC02752.JPG_8.jpg,1443,480,640,37,119,156,258,297,False,2
0,42,kaist_dataset/Mixed/Digital_Camera/(C.S)D-indoor1/DSC02755.JPG,char_data/0/DSC02755.JPG_6.jpg,1134,480,640,27,65,92,255,297,False,2
0,38,kaist_dataset/Mixed/Digital_Camera/(C.S)D-indoor1/DSC02755.JPG,char_data/0/DSC02755.JPG_7.jpg,1140,480,640,30,92,122,257,295,False,2
0,38,kaist_dataset/Mixed/Digital_Camera/(C.S)D-indoor1/DSC02755.JPG,char_data/0/DSC02755.JPG_8.jpg,1368,480,640,36,122,158,255,293,False,2
0,54,kaist_dataset/Mixed/Digital_Camera/(C.S)D-indoor1/DSC02771.JPG,char_data/0/DSC02771.JPG_6.jpg,1728,480,640,32,69,101,251,305,False,2
0,52,kaist_dataset/Mixed/Digital_Camera/(C.S)D-indoor1/DSC02771.JPG,char_data/0/DSC02771.JPG_7.jpg,1352,480,640,26,102,128,252,304,False,2
0,53,kaist_dataset/Mixed/Digital_Camera/(C.S)D-indoor1/DSC02771.JPG,char_data/0/DSC02771.JPG_8.jpg,1696,480,640,32,131,163,258,311,False,2
0,46,kaist_dataset/Mixed/Digital_Camera/(C.S)D-indoor1/DSC02772.JPG,char_data/0/DSC02772.JPG_6.jpg,1426,480,640,31,133,164,328,374,False,2
0,44,kaist_dataset/Mixed/Digital_Camera/(C.S)D-indoor1/DSC02772.JPG,char_data/0/DSC02772.JPG_7.jpg,1408,480,640,32,163,195,329,373,False,2
0,48,kaist_dataset/Mixed/Digital_Camera/(C.S)D-indoor1/DSC02772.JPG,char_data/0/DSC02772.JPG_8.jpg,1584,480,640,33,197,230,328,376,False,2
0,55,kaist_dataset/Mixed/Digital_Camera/(C.S)D-indoor1/DSC02775.JPG,char_data/0/DSC02775.JPG_6.jpg,2145,480,640,39,48,87,229,284,False,2
0,57,kaist_dataset/Mixed/Digital_Camera/(C.S)D-indoor1/DSC02775.JPG,char_data/0/DSC02775.JPG_7.jpg,1710,480,640,30,90,120,229,286,False,2
0,56,kaist_dataset/Mixed/Digital_Camera/(C.S)D-indoor1/DSC02775.JPG,char_data/0/DSC02775.JPG_8.jpg,2072,480,640,37,122,159,229,285,False,2
0,49,kaist_dataset/Mixed/Digital_Camera/(C.S)D-indoor1/DSC02776.JPG,char_data/0/DSC02776.JPG_6.jpg,1715,480,640,35,71,106,268,317,False,2
0,50,kaist_dataset/Mixed/Digital_Camera/(C.S)D-indoor1/DSC02776.JPG,char_data/0/DSC02776.JPG_7.jpg,1800,480,640,36,107,143,266,316,False,2
0,45,kaist_dataset/Mixed/Digital_Camera/(C.S)D-indoor1/DSC02776.JPG,char_data/0/DSC02776.JPG_8.jpg,1800,480,640,40,141,181,263,308,False,2
0,47,kaist_dataset/Mixed/Digital_Camera/(C.S)D-indoor1/DSC02780.JPG,char_data/0/DSC02780.JPG_6.jpg,1269,480,640,27,106,133,268,315,False,2
0,47,kaist_dataset/Mixed/Digital_Camera/(C.S)D-indoor1/DSC02780.JPG,char_data/0/DSC02780.JPG_7.jpg,1269,480,640,27,133,160,265,312,False,2
0,43,kaist_dataset/Mixed/Digital_Camera/(C.S)D-indoor1/DSC02780.JPG,char_data/0/DSC02780.JPG_8.jpg,1032,480,640,24,162,186,265,308,False,2
0,43,kaist_dataset/Mixed/Digital_Camera/(C.S)D-indoor1/DSC02782.JPG,char_data/0/DSC02782.JPG_6.jpg,1505,480,640,35,80,115,230,273,False,2
0,44,kaist_dataset/Mixed/Digital_Camera/(C.S)D-indoor1/DSC02782.JPG,char_data/0/DSC02782.JPG_7.jpg,1496,480,640,34,111,145,226,270,False,2
0,47,kaist_dataset/Mixed/Digital_Camera/(C.S)D-indoor1/DSC02782.JPG,char_data/0/DSC02782.JPG_8.jpg,2021,480,640,43,144,187,225,272,False,2
0,44,kaist_dataset/Mixed/Digital_Camera/(C.S)D-indoor1/DSC02785.JPG,char_data/0/DSC02785.JPG_6.jpg,1188,480,640,27,71,98,291,335,False,2
0,40,kaist_dataset/Mixed/Digital_Camera/(C.S)D-indoor1/DSC02785.JPG,char_data/0/DSC02785.JPG_7.jpg,1160,480,640,29,98,127,290,330,False,2
0,39,kaist_dataset/Mixed/Digital_Camera/(C.S)D-indoor1/DSC02785.JPG,char_data/0/DSC02785.JPG_8.jpg,1248,480,640,32,126,158,292,331,False,2
0,47,kaist_dataset/Mixed/Digital_Camera/(C.S)D-indoor1/DSC02789.JPG,char_data/0/DSC02789.JPG_6.jpg,1598,480,640,34,67,101,224,271,False,2
0,43,kaist_dataset/Mixed/Digital_Camera/(C.S)D-indoor1/DSC02789.JPG,char_data/0/DSC02789.JPG_7.jpg,1247,480,640,29,103,132,224,267,False,2
0,46,kaist_dataset/Mixed/Digital_Camera/(C.S)D-indoor1/DSC02789.JPG,char_data/0/DSC02789.JPG_8.jpg,1794,480,640,39,131,170,222,268,False,2
0,53,kaist_dataset/Mixed/Digital_Camera/(C.S)D-indoor1/DSC02791.JPG,char_data/0/DSC02791.JPG_6.jpg,1431,480,640,27,82,109,323,376,False,2
0,60,kaist_dataset/Mixed/Digital_Camera/(C.S)D-indoor1/DSC02791.JPG,char_data/0/DSC02791.JPG_7.jpg,1500,480,640,25,112,137,319,379,False,2
0,61,kaist_dataset/Mixed/Digital_Camera/(C.S)D-indoor1/DSC02791.JPG,char_data/0/DSC02791.JPG_8.jpg,1647,480,640,27,141,168,313,374,False,2
0,45,kaist_dataset/Mixed/Digital_Camera/(C.S)D-indoor1/DSC02794.JPG,char_data/0/DSC02794.JPG_6.jpg,1035,480,640,23,80,103,320,365,False,2
0,45,kaist_dataset/Mixed/Digital_Camera/(C.S)D-indoor1/DSC02794.JPG,char_data/0/DSC02794.JPG_7.jpg,990,480,640,22,104,126,318,363,False,2
0,50,kaist_dataset/Mixed/Digital_Camera/(C.S)D-indoor1/DSC02794.JPG,char_data/0/DSC02794.JPG_8.jpg,1200,480,640,24,128,152,317,367,False,2
0,47,kaist_dataset/Mixed/Digital_Camera/(C.S)D-indoor1/DSC02796.JPG,char_data/0/DSC02796.JPG_6.jpg,1269,480,640,27,65,92,247,294,False,2
0,45,kaist_dataset/Mixed/Digital_Camera/(C.S)D-indoor1/DSC02796.JPG,char_data/0/DSC02796.JPG_7.jpg,1260,480,640,28,92,120,248,293,False,2
0,45,kaist_dataset/Mixed/Digital_Camera/(C.S)D-indoor1/DSC02796.JPG,char_data/0/DSC02796.JPG_8.jpg,1395,480,640,31,118,149,248,293,False,2
0,50,kaist_dataset/Mixed/Digital_Camera/(C.S)D-indoor1/DSC02797.JPG,char_data/0/DSC02797.JPG_6.jpg,1350,480,640,27,109,136,277,327,False,2
0,48,kaist_dataset/Mixed/Digital_Camera/(C.S)D-indoor1/DSC02797.JPG,char_data/0/DSC02797.JPG_7.jpg,1344,480,640,28,136,164,275,323,False,2
0,51,kaist_dataset/Mixed/Digital_Camera/(C.S)D-indoor1/DSC02797.JPG,char_data/0/DSC02797.JPG_8.jpg,1428,480,640,28,166,194,271,322,False,2
0,53,kaist_dataset/Mixed/Digital_Camera/(C.S)D-indoor1/DSC02801.JPG,char_data/0/DSC02801.JPG_6.jpg,1590,480,640,30,60,90,270,323,False,2
0,42,kaist_dataset/Mixed/Digital_Camera/(C.S)D-indoor1/DSC02801.JPG,char_data/0/DSC02801.JPG_7.jpg,1218,480,640,29,90,119,272,314,False,2
0,40,kaist_dataset/Mixed/Digital_Camera/(C.S)D-indoor1/DSC02801.JPG,char_data/0/DSC02801.JPG_8.jpg,1480,480,640,37,118,155,270,310,False,2
0,49,kaist_dataset/Mixed/Digital_Camera/(C.S)D-indoor1/DSC02802.JPG,char_data/0/DSC02802.JPG_6.jpg,1519,480,640,31,60,91,268,317,False,2
0,52,kaist_dataset/Mixed/Digital_Camera/(C.S)D-indoor1/DSC02802.JPG,char_data/0/DSC02802.JPG_7.jpg,1716,480,640,33,92,125,267,319,False,2
0,50,kaist_dataset/Mixed/Digital_Camera/(C.S)D-indoor1/DSC02802.JPG,char_data/0/DSC02802.JPG_8.jpg,1750,480,640,35,126,161,268,318,False,2
0,78,kaist_dataset/Mixed/Digital_Camera/(C.S)D-indoor1/DSC03909.JPG,char_data/0/DSC03909.JPG_4.jpg,3432,480,640,44,36,80,99,177,False,2
0,48,kaist_dataset/Mixed/Digital_Camera/(C.S)D-indoor1/DSC03909.JPG,char_data/0/DSC03909.JPG_5.jpg,864,480,640,18,436,454,297,345,False,2
0,46,kaist_dataset/Mixed/Digital_Camera/(C.S)D-indoor1/DSC03986.JPG,char_data/0/DSC03986.JPG_6.jpg,874,480,640,19,260,279,163,209,False,2
0,50,kaist_dataset/Mixed/Digital_Camera/(C.S)D-indoor1/DSC03986.JPG,char_data/0/DSC03986.JPG_7.jpg,1050,480,640,21,290,311,163,213,False,2
0,45,kaist_dataset/Mixed/Digital_Camera/(C.S)D-indoor1/DSC03986.JPG,char_data/0/DSC03986.JPG_8.jpg,540,480,640,12,410,422,163,208,False,2
0,73,kaist_dataset/Mixed/Digital_Camera/(C.S)D-indoor1/DSC03998.JPG,char_data/0/DSC03998.JPG_2.jpg,2628,480,640,36,480,516,411,479,False,2
0,100,kaist_dataset/Mixed/Digital_Camera/(C.S)D-indoor1/DSC04002.JPG,char_data/0/DSC04002.JPG_2.jpg,7000,480,640,70,319,389,347,447,False,2
0,24,kaist_dataset/Mixed/Digital_Camera/(C.S)D-indoor1/DSC04005.JPG,char_data/0/DSC04005.JPG_2.jpg,432,480,640,18,345,363,441,465,False,2
0,41,kaist_dataset/Mixed/Digital_Camera/(C.S)D-indoor2/DSC04256.JPG,char_data/0/DSC04256.JPG_2.jpg,1025,480,640,25,489,514,106,147,False,2
0,36,kaist_dataset/Mixed/Digital_Camera/(C.S)E-night/DSC02569.JPG,char_data/0/DSC02569.JPG_4.jpg,792,480,640,22,250,272,412,448,False,2
0,45,kaist_dataset/Mixed/Digital_Camera/(C.S)E-night/DSC02569.JPG,char_data/0/DSC02569.JPG_5.jpg,900,480,640,20,458,478,407,452,False,2
0,52,kaist_dataset/Mixed/Digital_Camera/(C.S)E-night/DSC02575.JPG,char_data/0/DSC02575.JPG_2.jpg,1560,480,640,30,412,442,355,407,False,2
0,35,kaist_dataset/Mixed/Digital_Camera/(C.S)E-night/DSC02585.JPG,char_data/0/DSC02585.JPG_8.jpg,595,480,640,17,313,330,413,448,False,2
0,34,kaist_dataset/Mixed/Digital_Camera/(C.S)E-night/DSC02585.JPG,char_data/0/DSC02585.JPG_9.jpg,544,480,640,16,345,361,412,446,False,2
0,37,kaist_dataset/Mixed/Digital_Camera/(C.S)E-night/DSC02585.JPG,char_data/0/DSC02585.JPG_10.jpg,740,480,640,20,432,452,417,454,False,2
0,36,kaist_dataset/Mixed/Digital_Camera/(C.S)E-night/DSC02585.JPG,char_data/0/DSC02585.JPG_11.jpg,432,480,640,12,453,465,418,454,False,2
0,68,kaist_dataset/Mixed/Digital_Camera/(C.S)E-night/DSC02600.JPG,char_data/0/DSC02600.JPG_8.jpg,4488,480,640,66,312,378,194,262,False,2
0,66,kaist_dataset/Mixed/Digital_Camera/(C.S)E-night/DSC02600.JPG,char_data/0/DSC02600.JPG_9.jpg,4554,480,640,69,379,448,196,262,False,2
0,80,kaist_dataset/Mixed/Digital_Camera/(C.S)E-night/DSC02600.JPG,char_data/0/DSC02600.JPG_10.jpg,5120,480,640,64,310,374,392,472,False,2
0,77,kaist_dataset/Mixed/Digital_Camera/(C.S)E-night/DSC02600.JPG,char_data/0/DSC02600.JPG_11.jpg,5236,480,640,68,378,446,398,475,False,2
0,32,kaist_dataset/Mixed/Digital_Camera/(C.S)E-night/DSC02660.JPG,char_data/0/DSC02660.JPG_4.jpg,736,480,640,23,314,337,416,448,False,2
0,34,kaist_dataset/Mixed/Digital_Camera/(C.S)E-night/DSC02660.JPG,char_data/0/DSC02660.JPG_5.jpg,918,480,640,27,369,396,416,450,False,2
0,46,kaist_dataset/Mixed/Digital_Camera/(C.S)E-night/DSC03561.JPG,char_data/0/DSC03561.JPG_2.jpg,1794,480,640,39,472,511,249,295,False,2
0,31,kaist_dataset/Mixed/Digital_Camera/(C.S)E-night/P1010156.JPG,char_data/0/P1010156.JPG_2.jpg,961,480,640,31,447,478,240,271,False,2
0,52,kaist_dataset/Mixed/Digital_Camera/(C.S)F-others/2007-12-08-day-044.jpg,char_data/0/2007-12-08-day-044.jpg_4.jpg,1144,1200,1600,22,99,121,729,781,False,2
0,49,kaist_dataset/Mixed/Digital_Camera/(C.S)F-others/2007-12-08-day-044.jpg,char_data/0/2007-12-08-day-044.jpg_5.jpg,1617,1200,1600,33,122,155,735,784,False,2
0,51,kaist_dataset/Mixed/Digital_Camera/(C.S)F-others/2007-12-09-day-exterior-023.jpg,char_data/0/2007-12-09-day-exterior-023.jpg_2.jpg,2652,1200,1600,52,1121,1173,605,656,False,2
0,39,kaist_dataset/Mixed/Digital_Camera/(C.S)F-others/DSC02504.JPG,char_data/0/DSC02504.JPG_4.jpg,1209,480,640,31,355,386,358,397,False,2
0,33,kaist_dataset/Mixed/Digital_Camera/(C.S)F-others/DSC02504.JPG,char_data/0/DSC02504.JPG_5.jpg,1155,480,640,35,418,453,374,407,False,2
0,57,kaist_dataset/Mixed/Digital_Camera/(C.S)F-others/DSC02777.JPG,char_data/0/DSC02777.JPG_6.jpg,1824,480,640,32,84,116,312,369,False,2
0,57,kaist_dataset/Mixed/Digital_Camera/(C.S)F-others/DSC02777.JPG,char_data/0/DSC02777.JPG_7.jpg,1938,480,640,34,114,148,308,365,False,2
0,58,kaist_dataset/Mixed/Digital_Camera/(C.S)F-others/DSC02777.JPG,char_data/0/DSC02777.JPG_8.jpg,2494,480,640,43,144,187,306,364,False,2
0,51,kaist_dataset/Mixed/Digital_Camera/(C.S)F-others/DSC02793.JPG,char_data/0/DSC02793.JPG_6.jpg,1326,480,640,26,87,113,350,401,False,2
0,50,kaist_dataset/Mixed/Digital_Camera/(C.S)F-others/DSC02793.JPG,char_data/0/DSC02793.JPG_7.jpg,1250,480,640,25,112,137,348,398,False,2
0,41,kaist_dataset/Mixed/Digital_Camera/(C.S)F-others/DSC02793.JPG,char_data/0/DSC02793.JPG_8.jpg,1189,480,640,29,137,166,348,389,False,2
0,44,kaist_dataset/Mixed/Digital_Camera/(C.S)F-others/DSC02799.JPG,char_data/0/DSC02799.JPG_6.jpg,792,480,640,18,84,102,393,437,False,2
0,43,kaist_dataset/Mixed/Digital_Camera/(C.S)F-others/DSC02799.JPG,char_data/0/DSC02799.JPG_7.jpg,903,480,640,21,100,121,390,433,False,2
0,41,kaist_dataset/Mixed/Digital_Camera/(C.S)F-others/DSC02799.JPG,char_data/0/DSC02799.JPG_8.jpg,943,480,640,23,120,143,387,428,False,2
0,45,kaist_dataset/Mixed/Digital_Camera/(C.S)F-others/DSC02800.JPG,char_data/0/DSC02800.JPG_6.jpg,1305,480,640,29,73,102,269,314,False,2
0,46,kaist_dataset/Mixed/Digital_Camera/(C.S)F-others/DSC02800.JPG,char_data/0/DSC02800.JPG_7.jpg,1196,480,640,26,103,129,266,312,False,2
0,50,kaist_dataset/Mixed/Digital_Camera/(C.S)F-others/DSC02800.JPG,char_data/0/DSC02800.JPG_8.jpg,1400,480,640,28,131,159,259,309,False,2
0,37,kaist_dataset/Mixed/Digital_Camera/(C.S)F-others/DSC02803.JPG,char_data/0/DSC02803.JPG_6.jpg,888,480,640,24,169,193,355,392,False,2
0,38,kaist_dataset/Mixed/Digital_Camera/(C.S)F-others/DSC02803.JPG,char_data/0/DSC02803.JPG_7.jpg,950,480,640,25,195,220,353,391,False,2
0,48,kaist_dataset/Mixed/Digital_Camera/(C.S)F-others/DSC02803.JPG,char_data/0/DSC02803.JPG_8.jpg,3120,480,640,65,151,216,298,346,False,2
0,112,kaist_dataset/Mixed/Mobile_Phone/(C.M)A-outdoor/P090911087.jpg,char_data/0/P090911087.jpg_4.jpg,7616,480,640,68,223,291,38,150,False,2
0,111,kaist_dataset/Mixed/Mobile_Phone/(C.M)A-outdoor/P090911087.jpg,char_data/0/P090911087.jpg_5.jpg,8325,480,640,75,289,364,37,148,False,2
0,31,kaist_dataset/Mixed/Mobile_Phone/(C.M)A-outdoor/P090912036.jpg,char_data/0/P090912036.jpg_4.jpg,558,480,640,18,303,321,191,222,False,2
0,31,kaist_dataset/Mixed/Mobile_Phone/(C.M)A-outdoor/P090912036.jpg,char_data/0/P090912036.jpg_5.jpg,434,480,640,14,373,387,191,222,False,2
0,37,kaist_dataset/Mixed/Mobile_Phone/(C.M)A-outdoor/P090912038.jpg,char_data/0/P090912038.jpg_6.jpg,814,480,640,22,276,298,159,196,False,2
0,36,kaist_dataset/Mixed/Mobile_Phone/(C.M)A-outdoor/P090912038.jpg,char_data/0/P090912038.jpg_7.jpg,828,480,640,23,312,335,160,196,False,2
0,42,kaist_dataset/Mixed/Mobile_Phone/(C.M)A-outdoor/P090912038.jpg,char_data/0/P090912038.jpg_8.jpg,798,480,640,19,450,469,153,195,False,2
0,25,kaist_dataset/Mixed/Mobile_Phone/(C.M)A-outdoor/P090912040.jpg,char_data/0/P090912040.jpg_2.jpg,550,480,640,22,285,307,194,219,False,2
0,43,kaist_dataset/Mixed/Mobile_Phone/(C.M)A-outdoor/P090912047.jpg,char_data/0/P090912047.jpg_2.jpg,903,480,640,21,353,374,271,314,False,2
0,58,kaist_dataset/Mixed/Mobile_Phone/(C.M)B-indoor/P090831007.jpg,char_data/0/P090831007.jpg_6.jpg,2668,480,640,46,205,251,129,187,False,2
0,58,kaist_dataset/Mixed/Mobile_Phone/(C.M)B-indoor/P090831007.jpg,char_data/0/P090831007.jpg_7.jpg,2610,480,640,45,211,256,200,258,False,2
0,57,kaist_dataset/Mixed/Mobile_Phone/(C.M)B-indoor/P090831007.jpg,char_data/0/P090831007.jpg_8.jpg,2565,480,640,45,205,250,270,327,False,2
0,96,kaist_dataset/Mixed/Mobile_Phone/(C.M)C-bookCover/P090902019.jpg,char_data/0/P090902019.jpg_4.jpg,3936,480,640,41,169,210,74,170,False,2
0,65,kaist_dataset/Mixed/Mobile_Phone/(C.M)C-bookCover/P090902019.jpg,char_data/0/P090902019.jpg_5.jpg,2730,480,640,42,109,151,280,345,False,2
4,23,kaist_dataset/English/Digital_Camera/(E.S)C-outdoor1/042.JPG,char_data/4/042.JPG_6.jpg,345,480,640,15,555,570,324,347,True,6
4,27,kaist_dataset/English/Digital_Camera/(E.S)C-outdoor1/042.JPG,char_data/4/042.JPG_7.jpg,324,480,640,12,571,583,322,349,True,6
4,31,kaist_dataset/English/Digital_Camera/(E.S)C-outdoor1/042.JPG,char_data/4/042.JPG_8.jpg,589,480,640,19,583,602,318,349,True,6
4,27,kaist_dataset/English/Digital_Camera/(E.S)C-outdoor1/077.JPG,char_data/4/077.JPG_2.jpg,432,480,640,16,240,256,252,279,True,6
4,50,kaist_dataset/English/Digital_Camera/(E.S)C-outdoor1/080116-0065.jpg,char_data/4/080116-0065.jpg_4.jpg,1150,600,800,23,256,279,367,417,True,6
4,42,kaist_dataset/English/Digital_Camera/(E.S)C-outdoor1/080116-0065.jpg,char_data/4/080116-0065.jpg_5.jpg,882,600,800,21,375,396,383,425,True,6
4,38,kaist_dataset/English/Digital_Camera/(E.S)C-outdoor1/DSC02364.JPG,char_data/4/DSC02364.JPG_8.jpg,646,480,640,17,256,273,347,385,True,6
4,41,kaist_dataset/English/Digital_Camera/(E.S)C-outdoor1/DSC02364.JPG,char_data/4/DSC02364.JPG_9.jpg,738,480,640,18,395,413,346,387,True,6
4,37,kaist_dataset/English/Digital_Camera/(E.S)C-outdoor1/DSC02364.JPG,char_data/4/DSC02364.JPG_10.jpg,555,480,640,15,565,580,351,388,True,6
4,36,kaist_dataset/English/Digital_Camera/(E.S)C-outdoor1/DSC02364.JPG,char_data/4/DSC02364.JPG_11.jpg,540,480,640,15,598,613,354,390,True,6
4,41,kaist_dataset/English/Digital_Camera/(E.S)C-outdoor2/DSC03053.JPG,char_data/4/DSC03053.JPG_2.jpg,1230,480,640,30,457,487,129,170,True,6
4,36,kaist_dataset/English/Digital_Camera/(E.S)C-outdoor2/DSC03162.JPG,char_data/4/DSC03162.JPG_2.jpg,720,480,640,20,404,424,147,183,True,6
4,36,kaist_dataset/English/Digital_Camera/(E.S)C-outdoor2/DSC03294.JPG,char_data/4/DSC03294.JPG_8.jpg,756,480,640,21,226,247,396,432,True,6
4,30,kaist_dataset/English/Digital_Camera/(E.S)C-outdoor2/DSC03294.JPG,char_data/4/DSC03294.JPG_9.jpg,720,480,640,24,310,334,399,429,True,6
4,34,kaist_dataset/English/Digital_Camera/(E.S)C-outdoor2/DSC03294.JPG,char_data/4/DSC03294.JPG_10.jpg,714,480,640,21,354,375,400,434,True,6
4,31,kaist_dataset/English/Digital_Camera/(E.S)C-outdoor2/DSC03294.JPG,char_data/4/DSC03294.JPG_11.jpg,682,480,640,22,376,398,400,431,True,6
4,33,kaist_dataset/English/Digital_Camera/(E.S)C-outdoor2/DSC03436.JPG,char_data/4/DSC03436.JPG_4.jpg,891,480,640,27,194,221,128,161,True,6
4,41,kaist_dataset/English/Digital_Camera/(E.S)C-outdoor2/DSC03436.JPG,char_data/4/DSC03436.JPG_5.jpg,984,480,640,24,247,271,121,162,True,6
4,62,kaist_dataset/English/Digital_Camera/(E.S)C-outdoor2/DSC03650.JPG,char_data/4/DSC03650.JPG_2.jpg,1922,480,640,31,148,179,285,347,True,6
4,31,kaist_dataset/English/Digital_Camera/(E.S)C-outdoor2/DSC03731.JPG,char_data/4/DSC03731.JPG_2.jpg,465,480,640,15,523,538,117,148,True,6
4,71,kaist_dataset/English/Digital_Camera/(E.S)C-outdoor2/DSC04163.JPG,char_data/4/DSC04163.JPG_4.jpg,3621,480,640,51,143,194,313,384,True,6
4,63,kaist_dataset/English/Digital_Camera/(E.S)C-outdoor2/DSC04163.JPG,char_data/4/DSC04163.JPG_5.jpg,2583,480,640,41,380,421,316,379,True,6
4,43,kaist_dataset/English/Digital_Camera/(E.S)C-outdoor3/P1010086.JPG,char_data/4/P1010086.JPG_6.jpg,1032,480,640,24,402,426,96,139,True,6
4,30,kaist_dataset/English/Digital_Camera/(E.S)C-outdoor3/크기변환_P1010076.JPG,char_data/4/크기변환_P1010076.JPG_4.jpg,360,480,640,12,531,543,179,209,True,6
4,21,kaist_dataset/English/Digital_Camera/(E.S)C-outdoor3/크기변환_P1010076.JPG,char_data/4/크기변환_P1010076.JPG_5.jpg,315,480,640,15,564,579,182,203,True,6
4,33,kaist_dataset/English/Digital_Camera/(E.S)F-others/DSC02923.JPG,char_data/4/DSC02923.JPG_4.jpg,726,480,640,22,272,294,402,435,True,6
4,33,kaist_dataset/English/Digital_Camera/(E.S)F-others/DSC02923.JPG,char_data/4/DSC02923.JPG_5.jpg,462,480,640,14,372,386,390,423,True,6
4,63,kaist_dataset/English/Mobile_Phone/(E.M)B-indoor/P090902018.jpg,char_data/4/P090902018.jpg_2.jpg,2772,480,640,44,112,156,173,236,True,6
4,151,kaist_dataset/Korean/Digital_Camera/A-shadow/DSC02670.JPG,char_data/4/DSC02670.JPG_6.jpg,11476,480,640,76,198,274,20,171,True,6
4,134,kaist_dataset/Korean/Digital_Camera/A-shadow/DSC02670.JPG,char_data/4/DSC02670.JPG_7.jpg,6700,480,640,50,491,541,25,159,True,6
4,135,kaist_dataset/Korean/Digital_Camera/A-shadow/DSC02670.JPG,char_data/4/DSC02670.JPG_8.jpg,6750,480,640,50,556,606,25,160,True,6
4,70,kaist_dataset/Korean/Digital_Camera/A-shadow/DSC03536.JPG,char_data/4/DSC03536.JPG_2.jpg,2870,480,640,41,268,309,244,314,True,6
4,71,kaist_dataset/Korean/Digital_Camera/A-shadow/DSC03755.JPG,char_data/4/DSC03755.JPG_4.jpg,2059,480,640,29,353,382,206,277,True,6
4,75,kaist_dataset/Korean/Digital_Camera/A-shadow/DSC03755.JPG,char_data/4/DSC03755.JPG_5.jpg,2475,480,640,33,515,548,208,283,True,6
4,35,kaist_dataset/Korean/Digital_Camera/A-shadow/DSC04297.JPG,char_data/4/DSC04297.JPG_6.jpg,525,480,640,15,391,406,205,240,True,6
4,36,kaist_dataset/Korean/Digital_Camera/A-shadow/DSC04297.JPG,char_data/4/DSC04297.JPG_7.jpg,540,480,640,15,421,436,204,240,True,6
4,33,kaist_dataset/Korean/Digital_Camera/A-shadow/DSC04297.JPG,char_data/4/DSC04297.JPG_8.jpg,462,480,640,14,464,478,206,239,True,6
4,84,kaist_dataset/Korean/Digital_Camera/A-shadow/DSC04311.JPG,char_data/4/DSC04311.JPG_2.jpg,4368,480,640,52,173,225,263,347,True,6
4,49,kaist_dataset/Korean/Digital_Camera/A-shadow/DSC04315.JPG,char_data/4/DSC04315.JPG_2.jpg,1323,480,640,27,169,196,415,464,True,6
4,27,kaist_dataset/Korean/Digital_Camera/B-light/DSC02987.JPG,char_data/4/DSC02987.JPG_4.jpg,378,480,640,14,391,405,279,306,True,6
4,25,kaist_dataset/Korean/Digital_Camera/B-light/DSC02987.JPG,char_data/4/DSC02987.JPG_5.jpg,300,480,640,12,499,511,284,309,True,6
4,31,kaist_dataset/Korean/Digital_Camera/E-night/DSC02626.JPG,char_data/4/DSC02626.JPG_2.jpg,434,480,640,14,49,63,380,411,True,6
4,42,kaist_dataset/Korean/Digital_Camera/E-night/DSC02658.JPG,char_data/4/DSC02658.JPG_4.jpg,1260,480,640,30,342,372,352,394,True,6
4,38,kaist_dataset/Korean/Digital_Camera/E-night/DSC02658.JPG,char_data/4/DSC02658.JPG_5.jpg,988,480,640,26,425,451,355,393,True,6
4,56,kaist_dataset/Korean/Digital_Camera/E-night/DSC03019.JPG,char_data/4/DSC03019.JPG_2.jpg,2296,480,640,41,392,433,178,234,True,6
4,39,kaist_dataset/Korean/Digital_Camera/E-night/DSC03850.JPG,char_data/4/DSC03850.JPG_2.jpg,780,480,640,20,319,339,430,469,True,6
4,25,kaist_dataset/Korean/Digital_Camera/E-night/DSC03870.JPG,char_data/4/DSC03870.JPG_2.jpg,400,480,640,16,329,345,225,250,True,6
4,30,kaist_dataset/Korean/Digital_Camera/E-night/P1010149.JPG,char_data/4/P1010149.JPG_2.jpg,480,480,640,16,533,549,241,271,True,6
4,166,kaist_dataset/Korean/Digital_Camera/F-bookCover/DSC02824.JPG,char_data/4/DSC02824.JPG_2.jpg,16102,480,640,97,28,125,140,306,True,6
4,82,kaist_dataset/Korean/Digital_Camera/F-bookCover/DSC02832.JPG,char_data/4/DSC02832.JPG_2.jpg,5576,480,640,68,130,198,352,434,True,6
4,93,kaist_dataset/Korean/Digital_Camera/F-bookCover/DSC02833.JPG,char_data/4/DSC02833.JPG_2.jpg,6696,480,640,72,130,202,365,458,True,6
4,85,kaist_dataset/Korean/Digital_Camera/F-bookCover/DSC02835.JPG,char_data/4/DSC02835.JPG_2.jpg,4760,480,640,56,206,262,336,421,True,6
4,45,kaist_dataset/Korean/Digital_Camera/G-others/2007-12-08-day-045.jpg,char_data/4/2007-12-08-day-045.jpg_4.jpg,720,1200,1600,16,10,26,803,848,True,6
4,47,kaist_dataset/Korean/Digital_Camera/G-others/2007-12-08-day-045.jpg,char_data/4/2007-12-08-day-045.jpg_5.jpg,752,1200,1600,16,44,60,800,847,True,6
4,93,kaist_dataset/Korean/Digital_Camera/G-others/2007-12-08-day-108.jpg,char_data/4/2007-12-08-day-108.jpg_6.jpg,3720,1200,1600,40,611,651,589,682,True,6
4,97,kaist_dataset/Korean/Digital_Camera/G-others/2007-12-08-day-108.jpg,char_data/4/2007-12-08-day-108.jpg_7.jpg,4171,1200,1600,43,725,768,716,813,True,6
4,91,kaist_dataset/Korean/Digital_Camera/G-others/2007-12-08-day-108.jpg,char_data/4/2007-12-08-day-108.jpg_8.jpg,3458,1200,1600,38,769,807,733,824,True,6
4,72,kaist_dataset/Korean/Digital_Camera/G-others/2007-12-09-day-exterior-005.jpg,char_data/4/2007-12-09-day-exterior-005.jpg_2.jpg,4248,1600,1200,59,6,65,1337,1409,True,6
4,56,kaist_dataset/Korean/Digital_Camera/G-others/DSC03434.JPG,char_data/4/DSC03434.JPG_2.jpg,1624,480,640,29,238,267,25,81,True,6
4,42,kaist_dataset/Korean/Digital_Camera/G-others/DSC03862.JPG,char_data/4/DSC03862.JPG_4.jpg,714,480,640,17,259,276,352,394,True,6
4,36,kaist_dataset/Korean/Digital_Camera/G-others/DSC03862.JPG,char_data/4/DSC03862.JPG_5.jpg,648,480,640,18,319,337,355,391,True,6
4,25,kaist_dataset/Korean/Digital_Camera/G-others/DSC03863.JPG,char_data/4/DSC03863.JPG_2.jpg,475,480,640,19,160,179,411,436,True,6
4,75,kaist_dataset/Korean/Digital_Camera/indoor1/080119-0018.jpg,char_data/4/080119-0018.jpg_4.jpg,3450,1200,1600,46,312,358,423,498,True,6
4,47,kaist_dataset/Korean/Digital_Camera/indoor1/080119-0018.jpg,char_data/4/080119-0018.jpg_5.jpg,1175,1200,1600,25,1118,1143,698,745,True,6
4,121,kaist_dataset/Korean/Digital_Camera/indoor1/DSC03375.JPG,char_data/4/DSC03375.JPG_2.jpg,10890,480,640,90,277,367,159,280,True,6
4,57,kaist_dataset/Korean/Digital_Camera/indoor2/DSC03474.JPG,char_data/4/DSC03474.JPG_4.jpg,2223,480,640,39,133,172,155,212,True,6
4,54,kaist_dataset/Korean/Digital_Camera/indoor2/DSC03474.JPG,char_data/4/DSC03474.JPG_5.jpg,1998,480,640,37,235,272,153,207,True,6
4,57,kaist_dataset/Korean/Digital_Camera/indoor2/DSC03475.JPG,char_data/4/DSC03475.JPG_4.jpg,2280,480,640,40,114,154,94,151,True,6
4,54,kaist_dataset/Korean/Digital_Camera/indoor2/DSC03475.JPG,char_data/4/DSC03475.JPG_5.jpg,2592,480,640,48,242,290,93,147,True,6
4,33,kaist_dataset/Korean/Digital_Camera/indoor2/DSC03564.JPG,char_data/4/DSC03564.JPG_2.jpg,693,480,640,21,321,342,404,437,True,6
4,88,kaist_dataset/Korean/Digital_Camera/indoor2/DSC03565.JPG,char_data/4/DSC03565.JPG_4.jpg,5456,480,640,62,168,230,279,367,True,6
4,90,kaist_dataset/Korean/Digital_Camera/indoor2/DSC03565.JPG,char_data/4/DSC03565.JPG_5.jpg,4860,480,640,54,580,634,261,351,True,6
4,37,kaist_dataset/Korean/Digital_Camera/indoor2/DSC03983.JPG,char_data/4/DSC03983.JPG_2.jpg,888,480,640,24,371,395,322,359,True,6
4,49,kaist_dataset/Korean/Digital_Camera/indoor2/DSC03994.JPG,char_data/4/DSC03994.JPG_2.jpg,1470,480,640,30,313,343,286,335,True,6
4,43,kaist_dataset/Korean/Digital_Camera/indoor2/DSC03995.JPG,char_data/4/DSC03995.JPG_2.jpg,1419,480,640,33,394,427,266,309,True,6
4,71,kaist_dataset/Korean/Digital_Camera/indoor2/DSC04006.JPG,char_data/4/DSC04006.JPG_2.jpg,2911,480,640,41,139,180,151,222,True,6
4,56,kaist_dataset/Korean/Digital_Camera/indoor2/DSC04204.JPG,char_data/4/DSC04204.JPG_2.jpg,1624,480,640,29,417,446,205,261,True,6
4,58,kaist_dataset/Korean/Digital_Camera/indoor2/DSC04423.JPG,char_data/4/DSC04423.JPG_2.jpg,1856,480,640,32,517,549,239,297,True,6
4,86,kaist_dataset/Korean/Digital_Camera/indoor2/크기변환_%BD%C7%B3%BB%B0%A3%C6%C7_moon8481.jpg,char_data/4/크기변환_%BD%C7%B3%BB%B0%A3%C6%C7_moon8481.jpg_4.jpg,4300,480,640,50,208,258,335,421,True,6
4,84,kaist_dataset/Korean/Digital_Camera/indoor2/크기변환_%BD%C7%B3%BB%B0%A3%C6%C7_moon8481.jpg,char_data/4/크기변환_%BD%C7%B3%BB%B0%A3%C6%C7_moon8481.jpg_5.jpg,3528,480,640,42,433,475,339,423,True,6
4,19,kaist_dataset/Korean/Digital_Camera/outdoor1/006.JPG,char_data/4/006.JPG_2.jpg,323,480,640,17,320,337,254,273,True,6
4,35,kaist_dataset/Korean/Digital_Camera/outdoor1/023.JPG,char_data/4/023.JPG_2.jpg,805,480,640,23,231,254,265,300,True,6
4,24,kaist_dataset/Korean/Digital_Camera/outdoor1/028.JPG,char_data/4/028.JPG_4.jpg,384,480,640,16,342,358,265,289,True,6
4,25,kaist_dataset/Korean/Digital_Camera/outdoor1/028.JPG,char_data/4/028.JPG_5.jpg,400,480,640,16,384,400,262,287,True,6
4,30,kaist_dataset/Korean/Digital_Camera/outdoor1/029.JPG,char_data/4/029.JPG_2.jpg,720,480,640,24,356,380,290,320,True,6
4,28,kaist_dataset/Korean/Digital_Camera/outdoor1/032.JPG,char_data/4/032.JPG_2.jpg,588,480,640,21,521,542,254,282,True,6
4,31,kaist_dataset/Korean/Digital_Camera/outdoor1/035.JPG,char_data/4/035.JPG_2.jpg,527,480,640,17,377,394,288,319,True,6
4,33,kaist_dataset/Korean/Digital_Camera/outdoor1/040.JPG,char_data/4/040.JPG_2.jpg,759,480,640,23,272,295,297,330,True,6
4,30,kaist_dataset/Korean/Digital_Camera/outdoor1/071.JPG,char_data/4/071.JPG_4.jpg,570,480,640,19,282,301,257,287,True,6
4,29,kaist_dataset/Korean/Digital_Camera/outdoor1/071.JPG,char_data/4/071.JPG_5.jpg,638,480,640,22,374,396,259,288,True,6
4,36,kaist_dataset/Korean/Digital_Camera/outdoor1/091.JPG,char_data/4/091.JPG_2.jpg,900,480,640,25,313,338,286,322,True,6
4,22,kaist_dataset/Korean/Digital_Camera/outdoor1/126.JPG,char_data/4/126.JPG_4.jpg,506,480,640,23,325,348,264,286,True,6
4,27,kaist_dataset/Korean/Digital_Camera/outdoor1/126.JPG,char_data/4/126.JPG_5.jpg,243,480,640,9,460,469,255,282,True,6
4,67,kaist_dataset/Korean/Digital_Camera/outdoor2/2007-12-08-day-101.jpg,char_data/4/2007-12-08-day-101.jpg_2.jpg,2211,1200,1600,33,951,984,640,707,True,6
4,78,kaist_dataset/Korean/Digital_Camera/outdoor2/2007-12-09-day-exterior-012.jpg,char_data/4/2007-12-09-day-exterior-012.jpg_2.jpg,4446,1200,1600,57,1334,1391,619,697,True,6
4,65,kaist_dataset/Korean/Digital_Camera/outdoor2/2007-12-09-day-exterior-016.jpg,char_data/4/2007-12-09-day-exterior-016.jpg_6.jpg,1625,1200,1600,25,1,25,355,420,True,6
4,60,kaist_dataset/Korean/Digital_Camera/outdoor2/2007-12-09-day-exterior-016.jpg,char_data/4/2007-12-09-day-exterior-016.jpg_7.jpg,2160,1200,1600,36,589,625,746,806,True,6
4,64,kaist_dataset/Korean/Digital_Camera/outdoor2/2007-12-09-day-exterior-016.jpg,char_data/4/2007-12-09-day-exterior-016.jpg_8.jpg,2944,1200,1600,46,773,819,746,810,True,6
4,58,kaist_dataset/Korean/Digital_Camera/outdoor2/2007-12-09-day-exterior-035.jpg,char_data/4/2007-12-09-day-exterior-035.jpg_2.jpg,1856,1200,1600,32,568,600,711,769,True,6
4,31,kaist_dataset/Korean/Digital_Camera/outdoor2/DSC02321.JPG,char_data/4/DSC02321.JPG_2.jpg,713,480,640,23,273,296,378,409,True,6
4,36,kaist_dataset/Korean/Digital_Camera/outdoor2/DSC02371.JPG,char_data/4/DSC02371.JPG_2.jpg,1044,480,640,29,258,287,239,275,True,6
4,30,kaist_dataset/Korean/Digital_Camera/outdoor2/DSC02383.JPG,char_data/4/DSC02383.JPG_4.jpg,480,480,640,16,191,207,290,320,True,6
4,37,kaist_dataset/Korean/Digital_Camera/outdoor2/DSC02383.JPG,char_data/4/DSC02383.JPG_5.jpg,444,480,640,12,250,262,286,323,True,6
4,40,kaist_dataset/Korean/Digital_Camera/outdoor2/DSC02386.JPG,char_data/4/DSC02386.JPG_2.jpg,880,480,640,22,497,519,252,292,True,6
4,34,kaist_dataset/Korean/Digital_Camera/outdoor2/DSC02426.JPG,char_data/4/DSC02426.JPG_2.jpg,782,480,640,23,363,386,220,254,True,6
4,29,kaist_dataset/Korean/Digital_Camera/outdoor2/DSC02435.JPG,char_data/4/DSC02435.JPG_2.jpg,464,480,640,16,514,530,247,276,True,6
4,26,kaist_dataset/Korean/Digital_Camera/outdoor2/DSC02441.JPG,char_data/4/DSC02441.JPG_2.jpg,390,480,640,15,484,499,203,229,True,6
4,67,kaist_dataset/Korean/Digital_Camera/outdoor2/DSC02470.JPG,char_data/4/DSC02470.JPG_2.jpg,2881,480,640,43,494,537,369,436,True,6
4,117,kaist_dataset/Korean/Digital_Camera/outdoor2/DSC02520.JPG,char_data/4/DSC02520.JPG_6.jpg,3627,480,640,31,402,433,299,416,True,6
4,115,kaist_dataset/Korean/Digital_Camera/outdoor2/DSC02520.JPG,char_data/4/DSC02520.JPG_7.jpg,4025,480,640,35,543,578,301,416,True,6
4,113,kaist_dataset/Korean/Digital_Camera/outdoor2/DSC02520.JPG,char_data/4/DSC02520.JPG_8.jpg,3503,480,640,31,603,634,301,414,True,6
4,38,kaist_dataset/Korean/Digital_Camera/outdoor2/DSC02521.JPG,char_data/4/DSC02521.JPG_2.jpg,950,480,640,25,395,420,324,362,True,6
4,37,kaist_dataset/Korean/Digital_Camera/outdoor2/DSC02523.JPG,char_data/4/DSC02523.JPG_4.jpg,740,480,640,20,406,426,338,375,True,6
4,36,kaist_dataset/Korean/Digital_Camera/outdoor2/DSC02523.JPG,char_data/4/DSC02523.JPG_5.jpg,828,480,640,23,597,620,339,375,True,6
4,27,kaist_dataset/Korean/Digital_Camera/outdoor3/DSC02529.JPG,char_data/4/DSC02529.JPG_6.jpg,324,480,640,12,530,542,373,400,True,6
4,27,kaist_dataset/Korean/Digital_Camera/outdoor3/DSC02529.JPG,char_data/4/DSC02529.JPG_7.jpg,297,480,640,11,579,590,371,398,True,6
4,27,kaist_dataset/Korean/Digital_Camera/outdoor3/DSC02529.JPG,char_data/4/DSC02529.JPG_8.jpg,405,480,640,15,597,612,372,399,True,6
4,32,kaist_dataset/Korean/Digital_Camera/outdoor3/DSC02531.JPG,char_data/4/DSC02531.JPG_2.jpg,576,480,640,18,289,307,347,379,True,6
4,41,kaist_dataset/Korean/Digital_Camera/outdoor3/DSC02686.JPG,char_data/4/DSC02686.JPG_4.jpg,1066,480,640,26,223,249,224,265,True,6
4,40,kaist_dataset/Korean/Digital_Camera/outdoor3/DSC02686.JPG,char_data/4/DSC02686.JPG_5.jpg,1000,480,640,25,466,491,227,267,True,6
4,33,kaist_dataset/Korean/Digital_Camera/outdoor3/DSC02888.JPG,char_data/4/DSC02888.JPG_2.jpg,957,480,640,29,132,161,427,460,True,6
4,20,kaist_dataset/Korean/Digital_Camera/outdoor3/DSC02891.JPG,char_data/4/DSC02891.JPG_2.jpg,300,480,640,15,506,521,306,326,True,6
4,50,kaist_dataset/Korean/Digital_Camera/outdoor3/DSC02899.JPG,char_data/4/DSC02899.JPG_4.jpg,1700,480,640,34,346,380,229,279,True,6
4,38,kaist_dataset/Korean/Digital_Camera/outdoor3/DSC02899.JPG,char_data/4/DSC02899.JPG_5.jpg,1520,480,640,40,477,517,228,266,True,6
4,77,kaist_dataset/Korean/Digital_Camera/outdoor3/DSC02900.JPG,char_data/4/DSC02900.JPG_6.jpg,3619,480,640,47,468,515,241,318,True,6
4,73,kaist_dataset/Korean/Digital_Camera/outdoor3/DSC02900.JPG,char_data/4/DSC02900.JPG_7.jpg,3650,480,640,50,563,613,238,311,True,6
4,69,kaist_dataset/Korean/Digital_Camera/outdoor3/DSC02900.JPG,char_data/4/DSC02900.JPG_8.jpg,3450,480,640,50,244,294,260,329,True,6
4,35,kaist_dataset/Korean/Digital_Camera/outdoor3/DSC02939.JPG,char_data/4/DSC02939.JPG_4.jpg,840,480,640,24,263,287,367,402,True,6
4,34,kaist_dataset/Korean/Digital_Camera/outdoor3/DSC02939.JPG,char_data/4/DSC02939.JPG_5.jpg,782,480,640,23,333,356,371,405,True,6
4,40,kaist_dataset/Korean/Digital_Camera/outdoor3/DSC02941.JPG,char_data/4/DSC02941.JPG_4.jpg,1160,480,640,29,326,355,254,294,True,6
4,45,kaist_dataset/Korean/Digital_Camera/outdoor3/DSC02941.JPG,char_data/4/DSC02941.JPG_5.jpg,900,480,640,20,377,397,251,296,True,6
4,30,kaist_dataset/Korean/Digital_Camera/outdoor3/DSC02943.JPG,char_data/4/DSC02943.JPG_2.jpg,630,480,640,21,301,322,429,459,True,6
4,35,kaist_dataset/Korean/Digital_Camera/outdoor3/DSC02944.JPG,char_data/4/DSC02944.JPG_2.jpg,945,480,640,27,215,242,238,273,True,6
4,63,kaist_dataset/Korean/Digital_Camera/outdoor3/DSC02951.JPG,char_data/4/DSC02951.JPG_2.jpg,3654,480,640,58,65,123,390,453,True,6
4,53,kaist_dataset/Korean/Digital_Camera/outdoor3/DSC02953.JPG,char_data/4/DSC02953.JPG_2.jpg,2703,480,640,51,306,357,388,441,True,6
4,46,kaist_dataset/Korean/Digital_Camera/outdoor3/DSC02957.JPG,char_data/4/DSC02957.JPG_4.jpg,1656,480,640,36,215,251,398,444,True,6
4,41,kaist_dataset/Korean/Digital_Camera/outdoor3/DSC02957.JPG,char_data/4/DSC02957.JPG_5.jpg,1189,480,640,29,349,378,406,447,True,6
4,32,kaist_dataset/Korean/Digital_Camera/outdoor3/DSC02971.JPG,char_data/4/DSC02971.JPG_2.jpg,768,480,640,24,252,276,297,329,True,6
4,35,kaist_dataset/Korean/Digital_Camera/outdoor3/DSC02975.JPG,char_data/4/DSC02975.JPG_2.jpg,1050,480,640,30,296,326,240,275,True,6
4,112,kaist_dataset/Korean/Digital_Camera/outdoor3/DSC02983.JPG,char_data/4/DSC02983.JPG_6.jpg,7840,480,640,70,77,147,294,406,True,6
4,98,kaist_dataset/Korean/Digital_Camera/outdoor3/DSC02983.JPG,char_data/4/DSC02983.JPG_7.jpg,5586,480,640,57,308,365,309,407,True,6
4,100,kaist_dataset/Korean/Digital_Camera/outdoor3/DSC02983.JPG,char_data/4/DSC02983.JPG_8.jpg,5100,480,640,51,413,464,314,414,True,6
4,46,kaist_dataset/Korean/Digital_Camera/outdoor3/DSC02994.JPG,char_data/4/DSC02994.JPG_4.jpg,966,480,640,21,98,119,63,109,True,6
4,46,kaist_dataset/Korean/Digital_Camera/outdoor3/DSC02994.JPG,char_data/4/DSC02994.JPG_5.jpg,1748,480,640,38,185,223,284,330,True,6
4,41,kaist_dataset/Korean/Digital_Camera/outdoor3/DSC02999.JPG,char_data/4/DSC02999.JPG_4.jpg,902,480,640,22,203,225,427,468,True,6
4,30,kaist_dataset/Korean/Digital_Camera/outdoor3/DSC02999.JPG,char_data/4/DSC02999.JPG_5.jpg,540,480,640,18,260,278,435,465,True,6
4,123,kaist_dataset/Korean/Digital_Camera/outdoor3/DSC03159.JPG,char_data/4/DSC03159.JPG_2.jpg,7626,480,640,62,3,65,213,336,True,6
4,67,kaist_dataset/Korean/Digital_Camera/outdoor3/DSC03198.JPG,char_data/4/DSC03198.JPG_2.jpg,3752,480,640,56,21,77,198,265,True,6
4,34,kaist_dataset/Korean/Digital_Camera/outdoor3/DSC03219.JPG,char_data/4/DSC03219.JPG_2.jpg,884,480,640,26,324,350,410,444,True,6
4,37,kaist_dataset/Korean/Digital_Camera/outdoor3/DSC03232.JPG,char_data/4/DSC03232.JPG_2.jpg,1184,480,640,32,188,220,285,322,True,6
4,45,kaist_dataset/Korean/Digital_Camera/outdoor3/DSC03237.JPG,char_data/4/DSC03237.JPG_6.jpg,1305,480,640,29,201,230,399,444,True,6
4,40,kaist_dataset/Korean/Digital_Camera/outdoor3/DSC03237.JPG,char_data/4/DSC03237.JPG_7.jpg,1000,480,640,25,257,282,400,440,True,6
4,47,kaist_dataset/Korean/Digital_Camera/outdoor3/DSC03237.JPG,char_data/4/DSC03237.JPG_8.jpg,1222,480,640,26,325,351,395,442,True,6
4,56,kaist_dataset/Korean/Digital_Camera/outdoor4/DSC03261.JPG,char_data/4/DSC03261.JPG_2.jpg,2296,480,640,41,198,239,393,449,True,6
4,35,kaist_dataset/Korean/Digital_Camera/outdoor4/DSC03293.JPG,char_data/4/DSC03293.JPG_4.jpg,770,480,640,22,220,242,286,321,True,6
4,38,kaist_dataset/Korean/Digital_Camera/outdoor4/DSC03293.JPG,char_data/4/DSC03293.JPG_5.jpg,836,480,640,22,285,307,285,323,True,6
4,30,kaist_dataset/Korean/Digital_Camera/outdoor4/DSC03295.JPG,char_data/4/DSC03295.JPG_4.jpg,660,480,640,22,219,241,403,433,True,6
4,32,kaist_dataset/Korean/Digital_Camera/outdoor4/DSC03295.JPG,char_data/4/DSC03295.JPG_5.jpg,672,480,640,21,335,356,400,432,True,6
4,54,kaist_dataset/Korean/Digital_Camera/outdoor4/DSC03313.JPG,char_data/4/DSC03313.JPG_2.jpg,2106,480,640,39,264,303,315,369,True,6
4,53,kaist_dataset/Korean/Digital_Camera/outdoor4/DSC03319.JPG,char_data/4/DSC03319.JPG_4.jpg,2226,480,640,42,172,214,386,439,True,6
4,45,kaist_dataset/Korean/Digital_Camera/outdoor4/DSC03319.JPG,char_data/4/DSC03319.JPG_5.jpg,1485,480,640,33,90,123,82,127,True,6
4,43,kaist_dataset/Korean/Digital_Camera/outdoor4/DSC03416.JPG,char_data/4/DSC03416.JPG_2.jpg,774,480,640,18,71,89,295,338,True,6
4,87,kaist_dataset/Korean/Digital_Camera/outdoor4/DSC03452.JPG,char_data/4/DSC03452.JPG_4.jpg,3132,480,640,36,169,205,275,362,True,6
4,79,kaist_dataset/Korean/Digital_Camera/outdoor4/DSC03452.JPG,char_data/4/DSC03452.JPG_5.jpg,2923,480,640,37,462,499,284,363,True,6
4,67,kaist_dataset/Korean/Digital_Camera/outdoor4/DSC03537.JPG,char_data/4/DSC03537.JPG_2.jpg,2747,480,640,41,162,203,132,199,True,6
4,49,kaist_dataset/Korean/Digital_Camera/outdoor4/DSC03538.JPG,char_data/4/DSC03538.JPG_2.jpg,784,480,640,16,110,126,113,162,True,6
4,77,kaist_dataset/Korean/Digital_Camera/outdoor4/DSC03542.JPG,char_data/4/DSC03542.JPG_2.jpg,2849,480,640,37,81,118,256,333,True,6
4,43,kaist_dataset/Korean/Digital_Camera/outdoor4/DSC03545.JPG,char_data/4/DSC03545.JPG_2.jpg,903,480,640,21,95,116,36,79,True,6
4,62,kaist_dataset/Korean/Digital_Camera/outdoor4/DSC03550.JPG,char_data/4/DSC03550.JPG_2.jpg,3224,480,640,52,154,206,305,367,True,6
4,72,kaist_dataset/Korean/Digital_Camera/outdoor4/DSC03553.JPG,char_data/4/DSC03553.JPG_2.jpg,5256,480,640,73,91,164,183,255,True,6
4,29,kaist_dataset/Korean/Digital_Camera/outdoor4/DSC03555.JPG,char_data/4/DSC03555.JPG_2.jpg,725,480,640,25,294,319,427,456,True,6
4,90,kaist_dataset/Korean/Digital_Camera/outdoor4/DSC03566.JPG,char_data/4/DSC03566.JPG_4.jpg,6030,480,640,67,83,150,154,244,True,6
4,32,kaist_dataset/Korean/Digital_Camera/outdoor4/DSC03566.JPG,char_data/4/DSC03566.JPG_5.jpg,2080,480,640,65,43,108,95,127,True,6
4,45,kaist_dataset/Korean/Digital_Camera/outdoor4/DSC03580.JPG,char_data/4/DSC03580.JPG_4.jpg,1395,480,640,31,218,249,209,254,True,6
4,54,kaist_dataset/Korean/Digital_Camera/outdoor4/DSC03580.JPG,char_data/4/DSC03580.JPG_5.jpg,1458,480,640,27,366,393,203,257,True,6
4,56,kaist_dataset/Korean/Digital_Camera/outdoor4/DSC03592.JPG,char_data/4/DSC03592.JPG_10.jpg,1736,480,640,31,541,572,62,118,True,6
4,46,kaist_dataset/Korean/Digital_Camera/outdoor4/DSC03592.JPG,char_data/4/DSC03592.JPG_11.jpg,1288,480,640,28,56,84,112,158,True,6
4,35,kaist_dataset/Korean/Digital_Camera/outdoor4/DSC03592.JPG,char_data/4/DSC03592.JPG_12.jpg,980,480,640,28,169,197,117,152,True,6
4,35,kaist_dataset/Korean/Digital_Camera/outdoor4/DSC03592.JPG,char_data/4/DSC03592.JPG_13.jpg,770,480,640,22,276,298,120,155,True,6
4,31,kaist_dataset/Korean/Digital_Camera/outdoor4/DSC03592.JPG,char_data/4/DSC03592.JPG_14.jpg,899,480,640,29,385,414,123,154,True,6
4,62,kaist_dataset/Korean/Digital_Camera/outdoor4/DSC03599.JPG,char_data/4/DSC03599.JPG_2.jpg,1922,480,640,31,302,333,232,294,True,6
4,26,kaist_dataset/Korean/Digital_Camera/outdoor4/DSC03600.JPG,char_data/4/DSC03600.JPG_2.jpg,442,480,640,17,326,343,328,354,True,6
4,45,kaist_dataset/Korean/Digital_Camera/outdoor4/DSC03603.JPG,char_data/4/DSC03603.JPG_2.jpg,945,480,640,21,301,322,281,326,True,6
4,57,kaist_dataset/Korean/Digital_Camera/outdoor4/DSC03605.JPG,char_data/4/DSC03605.JPG_4.jpg,2280,480,640,40,80,120,228,285,True,6
4,53,kaist_dataset/Korean/Digital_Camera/outdoor4/DSC03605.JPG,char_data/4/DSC03605.JPG_5.jpg,1749,480,640,33,128,161,147,200,True,6
4,77,kaist_dataset/Korean/Digital_Camera/outdoor4/DSC03608.JPG,char_data/4/DSC03608.JPG_2.jpg,3927,480,640,51,554,605,294,371,True,6
4,42,kaist_dataset/Korean/Digital_Camera/outdoor4/DSC03614.JPG,char_data/4/DSC03614.JPG_2.jpg,1050,480,640,25,314,339,396,438,True,6
4,45,kaist_dataset/Korean/Digital_Camera/outdoor5/DSC03626.JPG,char_data/4/DSC03626.JPG_4.jpg,1395,480,640,31,127,158,293,338,True,6
4,41,kaist_dataset/Korean/Digital_Camera/outdoor5/DSC03626.JPG,char_data/4/DSC03626.JPG_5.jpg,1640,480,640,40,363,403,295,336,True,6
4,33,kaist_dataset/Korean/Digital_Camera/outdoor5/DSC03627.JPG,char_data/4/DSC03627.JPG_2.jpg,1023,480,640,31,206,237,224,257,True,6
4,30,kaist_dataset/Korean/Digital_Camera/outdoor5/DSC03636.JPG,char_data/4/DSC03636.JPG_4.jpg,420,480,640,14,357,371,159,189,True,6
4,30,kaist_dataset/Korean/Digital_Camera/outdoor5/DSC03636.JPG,char_data/4/DSC03636.JPG_5.jpg,720,480,640,24,228,252,400,430,True,6
4,31,kaist_dataset/Korean/Digital_Camera/outdoor5/DSC03641.JPG,char_data/4/DSC03641.JPG_2.jpg,589,480,640,19,362,381,424,455,True,6
4,44,kaist_dataset/Korean/Digital_Camera/outdoor5/DSC03645.JPG,char_data/4/DSC03645.JPG_2.jpg,1540,480,640,35,318,353,348,392,True,6
4,37,kaist_dataset/Korean/Digital_Camera/outdoor5/DSC03669.JPG,char_data/4/DSC03669.JPG_4.jpg,1036,480,640,28,212,240,317,354,True,6
4,43,kaist_dataset/Korean/Digital_Camera/outdoor5/DSC03669.JPG,char_data/4/DSC03669.JPG_5.jpg,1075,480,640,25,270,295,310,353,True,6
4,41,kaist_dataset/Korean/Digital_Camera/outdoor5/DSC03671.JPG,char_data/4/DSC03671.JPG_6.jpg,779,480,640,19,193,212,408,449,True,6
4,34,kaist_dataset/Korean/Digital_Camera/outdoor5/DSC03671.JPG,char_data/4/DSC03671.JPG_7.jpg,578,480,640,17,242,259,410,444,True,6
4,31,kaist_dataset/Korean/Digital_Camera/outdoor5/DSC03671.JPG,char_data/4/DSC03671.JPG_8.jpg,589,480,640,19,456,475,409,440,True,6
4,34,kaist_dataset/Korean/Digital_Camera/outdoor5/DSC03685.JPG,char_data/4/DSC03685.JPG_4.jpg,1190,480,640,35,75,110,189,223,True,6
4,34,kaist_dataset/Korean/Digital_Camera/outdoor5/DSC03685.JPG,char_data/4/DSC03685.JPG_5.jpg,782,480,640,23,338,361,187,221,True,6
4,24,kaist_dataset/Korean/Digital_Camera/outdoor5/DSC03688.JPG,char_data/4/DSC03688.JPG_2.jpg,408,480,640,17,537,554,233,257,True,6
4,38,kaist_dataset/Korean/Digital_Camera/outdoor5/DSC03692.JPG,char_data/4/DSC03692.JPG_2.jpg,532,480,640,14,442,456,184,222,True,6
4,58,kaist_dataset/Korean/Digital_Camera/outdoor5/DSC03694.JPG,char_data/4/DSC03694.JPG_2.jpg,2030,480,640,35,405,440,117,175,True,6
4,52,kaist_dataset/Korean/Digital_Camera/outdoor5/DSC03708.JPG,char_data/4/DSC03708.JPG_4.jpg,1768,480,640,34,322,356,264,316,True,6
4,49,kaist_dataset/Korean/Digital_Camera/outdoor5/DSC03708.JPG,char_data/4/DSC03708.JPG_5.jpg,1470,480,640,30,382,412,263,312,True,6
4,39,kaist_dataset/Korean/Digital_Camera/outdoor5/DSC03709.JPG,char_data/4/DSC03709.JPG_6.jpg,780,480,640,20,429,449,363,402,True,6
4,39,kaist_dataset/Korean/Digital_Camera/outdoor5/DSC03709.JPG,char_data/4/DSC03709.JPG_7.jpg,741,480,640,19,462,481,363,402,True,6
4,47,kaist_dataset/Korean/Digital_Camera/outdoor5/DSC03709.JPG,char_data/4/DSC03709.JPG_8.jpg,1081,480,640,23,546,569,360,407,True,6
4,32,kaist_dataset/Korean/Digital_Camera/outdoor5/DSC03710.JPG,char_data/4/DSC03710.JPG_6.jpg,1216,480,640,38,245,283,411,443,True,6
4,32,kaist_dataset/Korean/Digital_Camera/outdoor5/DSC03710.JPG,char_data/4/DSC03710.JPG_7.jpg,960,480,640,30,396,426,411,443,True,6
4,34,kaist_dataset/Korean/Digital_Camera/outdoor5/DSC03710.JPG,char_data/4/DSC03710.JPG_8.jpg,1054,480,640,31,459,490,408,442,True,6
4,91,kaist_dataset/Korean/Digital_Camera/outdoor5/DSC03715.JPG,char_data/4/DSC03715.JPG_2.jpg,4914,480,640,54,218,272,77,168,True,6
4,42,kaist_dataset/Korean/Digital_Camera/outdoor5/DSC03717.JPG,char_data/4/DSC03717.JPG_6.jpg,1512,480,640,36,164,200,349,391,True,6
4,40,kaist_dataset/Korean/Digital_Camera/outdoor5/DSC03717.JPG,char_data/4/DSC03717.JPG_7.jpg,1520,480,640,38,326,364,349,389,True,6
4,44,kaist_dataset/Korean/Digital_Camera/outdoor5/DSC03717.JPG,char_data/4/DSC03717.JPG_8.jpg,1760,480,640,40,397,437,348,392,True,6
4,28,kaist_dataset/Korean/Digital_Camera/outdoor5/DSC03736.JPG,char_data/4/DSC03736.JPG_2.jpg,420,480,640,15,296,311,407,435,True,6
4,38,kaist_dataset/Korean/Digital_Camera/outdoor5/DSC03740.JPG,char_data/4/DSC03740.JPG_4.jpg,874,480,640,23,297,320,287,325,True,6
4,39,kaist_dataset/Korean/Digital_Camera/outdoor5/DSC03740.JPG,char_data/4/DSC03740.JPG_5.jpg,819,480,640,21,355,376,286,325,True,6
4,23,kaist_dataset/Korean/Digital_Camera/outdoor5/DSC03744.JPG,char_data/4/DSC03744.JPG_2.jpg,713,480,640,31,253,284,308,331,True,6
4,67,kaist_dataset/Korean/Digital_Camera/outdoor5/DSC03749.JPG,char_data/4/DSC03749.JPG_2.jpg,2412,480,640,36,333,369,402,469,True,6
4,28,kaist_dataset/Korean/Digital_Camera/outdoor5/DSC03751.JPG,char_data/4/DSC03751.JPG_4.jpg,728,480,640,26,216,242,413,441,True,6
4,28,kaist_dataset/Korean/Digital_Camera/outdoor5/DSC03751.JPG,char_data/4/DSC03751.JPG_5.jpg,728,480,640,26,263,289,411,439,True,6
4,26,kaist_dataset/Korean/Digital_Camera/outdoor5/DSC03752.JPG,char_data/4/DSC03752.JPG_4.jpg,390,480,640,15,92,107,411,437,True,6
4,28,kaist_dataset/Korean/Digital_Camera/outdoor5/DSC03752.JPG,char_data/4/DSC03752.JPG_5.jpg,420,480,640,15,137,152,411,439,True,6
4,37,kaist_dataset/Korean/Digital_Camera/outdoor5/DSC03768.JPG,char_data/4/DSC03768.JPG_2.jpg,1073,480,640,29,413,442,240,277,True,6
4,33,kaist_dataset/Korean/Digital_Camera/outdoor5/DSC03770.JPG,char_data/4/DSC03770.JPG_2.jpg,990,480,640,30,430,460,424,457,True,6
4,23,kaist_dataset/Korean/Digital_Camera/outdoor5/DSC03776.JPG,char_data/4/DSC03776.JPG_6.jpg,368,480,640,16,483,499,437,460,True,6
4,19,kaist_dataset/Korean/Digital_Camera/outdoor5/DSC03776.JPG,char_data/4/DSC03776.JPG_7.jpg,209,480,640,11,485,496,421,440,True,6
4,21,kaist_dataset/Korean/Digital_Camera/outdoor5/DSC03776.JPG,char_data/4/DSC03776.JPG_8.jpg,273,480,640,13,507,520,420,441,True,6
4,31,kaist_dataset/Korean/Digital_Camera/outdoor5/DSC03777.JPG,char_data/4/DSC03777.JPG_2.jpg,465,480,640,15,125,140,344,375,True,6
4,30,kaist_dataset/Korean/Digital_Camera/outdoor5/DSC03778.JPG,char_data/4/DSC03778.JPG_2.jpg,540,480,640,18,303,321,343,373,True,6
4,34,kaist_dataset/Korean/Digital_Camera/outdoor5/DSC03779.JPG,char_data/4/DSC03779.JPG_2.jpg,850,480,640,25,460,485,241,275,True,6
4,24,kaist_dataset/Korean/Digital_Camera/outdoor5/DSC03780.JPG,char_data/4/DSC03780.JPG_2.jpg,624,480,640,26,134,160,443,467,True,6
4,50,kaist_dataset/Korean/Digital_Camera/outdoor5/DSC03838.JPG,char_data/4/DSC03838.JPG_2.jpg,1500,480,640,30,243,273,200,250,True,6
4,61,kaist_dataset/Korean/Digital_Camera/outdoor5/DSC03860.JPG,char_data/4/DSC03860.JPG_2.jpg,2745,480,640,45,395,440,279,340,True,6
4,36,kaist_dataset/Korean/Digital_Camera/outdoor5/DSC03996.JPG,char_data/4/DSC03996.JPG_2.jpg,1152,480,640,32,192,224,288,324,True,6
4,34,kaist_dataset/Korean/Digital_Camera/outdoor5/DSC04027.JPG,char_data/4/DSC04027.JPG_4.jpg,476,480,640,14,390,404,382,416,True,6
4,36,kaist_dataset/Korean/Digital_Camera/outdoor5/DSC04027.JPG,char_data/4/DSC04027.JPG_5.jpg,648,480,640,18,404,422,382,418,True,6
4,26,kaist_dataset/Korean/Digital_Camera/outdoor5/DSC04028.JPG,char_data/4/DSC04028.JPG_2.jpg,624,480,640,24,280,304,345,371,True,6
4,39,kaist_dataset/Korean/Digital_Camera/outdoor5/DSC04040.JPG,char_data/4/DSC04040.JPG_4.jpg,1482,480,640,38,272,310,339,378,True,6
4,36,kaist_dataset/Korean/Digital_Camera/outdoor5/DSC04040.JPG,char_data/4/DSC04040.JPG_5.jpg,1404,480,640,39,400,439,341,377,True,6
4,22,kaist_dataset/Korean/Digital_Camera/outdoor6/DSC04041.JPG,char_data/4/DSC04041.JPG_4.jpg,396,480,640,18,410,428,145,167,True,6
4,25,kaist_dataset/Korean/Digital_Camera/outdoor6/DSC04041.JPG,char_data/4/DSC04041.JPG_5.jpg,525,480,640,21,476,497,144,169,True,6
4,26,kaist_dataset/Korean/Digital_Camera/outdoor6/DSC04042.JPG,char_data/4/DSC04042.JPG_2.jpg,468,480,640,18,53,71,333,359,True,6
4,33,kaist_dataset/Korean/Digital_Camera/outdoor6/DSC04046.JPG,char_data/4/DSC04046.JPG_2.jpg,627,480,640,19,265,284,258,291,True,6
4,28,kaist_dataset/Korean/Digital_Camera/outdoor6/DSC04062.JPG,char_data/4/DSC04062.JPG_4.jpg,392,480,640,14,539,553,305,333,True,6
4,33,kaist_dataset/Korean/Digital_Camera/outdoor6/DSC04062.JPG,char_data/4/DSC04062.JPG_5.jpg,396,480,640,12,608,620,305,338,True,6
4,42,kaist_dataset/Korean/Digital_Camera/outdoor6/DSC04081.JPG,char_data/4/DSC04081.JPG_2.jpg,1890,480,640,45,208,253,321,363,True,6
4,51,kaist_dataset/Korean/Digital_Camera/outdoor6/DSC04089.JPG,char_data/4/DSC04089.JPG_4.jpg,1479,480,640,29,299,328,271,322,True,6
4,43,kaist_dataset/Korean/Digital_Camera/outdoor6/DSC04089.JPG,char_data/4/DSC04089.JPG_5.jpg,860,480,640,20,446,466,280,323,True,6
4,94,kaist_dataset/Korean/Digital_Camera/outdoor6/DSC04090.JPG,char_data/4/DSC04090.JPG_6.jpg,7802,480,640,83,122,205,199,293,True,6
4,104,kaist_dataset/Korean/Digital_Camera/outdoor6/DSC04090.JPG,char_data/4/DSC04090.JPG_7.jpg,5824,480,640,56,330,386,188,292,True,6
4,106,kaist_dataset/Korean/Digital_Camera/outdoor6/DSC04090.JPG,char_data/4/DSC04090.JPG_8.jpg,5724,480,640,54,383,437,185,291,True,6
4,77,kaist_dataset/Korean/Digital_Camera/outdoor6/DSC04096.JPG,char_data/4/DSC04096.JPG_4.jpg,3850,480,640,50,125,175,222,299,True,6
4,78,kaist_dataset/Korean/Digital_Camera/outdoor6/DSC04096.JPG,char_data/4/DSC04096.JPG_5.jpg,3822,480,640,49,291,340,224,302,True,6
4,36,kaist_dataset/Korean/Digital_Camera/outdoor6/DSC04099.JPG,char_data/4/DSC04099.JPG_2.jpg,756,480,640,21,393,414,417,453,True,6
4,53,kaist_dataset/Korean/Digital_Camera/outdoor6/DSC04100.JPG,char_data/4/DSC04100.JPG_2.jpg,1590,480,640,30,354,384,50,103,True,6
4,37,kaist_dataset/Korean/Digital_Camera/outdoor6/DSC04112.JPG,char_data/4/DSC04112.JPG_4.jpg,666,480,640,18,288,306,271,308,True,6
4,31,kaist_dataset/Korean/Digital_Camera/outdoor6/DSC04112.JPG,char_data/4/DSC04112.JPG_5.jpg,434,480,640,14,414,428,275,306,True,6
4,33,kaist_dataset/Korean/Digital_Camera/outdoor6/DSC04113.JPG,char_data/4/DSC04113.JPG_2.jpg,1023,480,640,31,144,175,441,474,True,6
4,36,kaist_dataset/Korean/Digital_Camera/outdoor6/DSC04116.JPG,char_data/4/DSC04116.JPG_10.jpg,792,480,640,22,168,190,318,354,True,6
4,37,kaist_dataset/Korean/Digital_Camera/outdoor6/DSC04116.JPG,char_data/4/DSC04116.JPG_11.jpg,592,480,640,16,256,272,320,357,True,6
4,41,kaist_dataset/Korean/Digital_Camera/outdoor6/DSC04116.JPG,char_data/4/DSC04116.JPG_12.jpg,779,480,640,19,288,307,317,358,True,6
4,34,kaist_dataset/Korean/Digital_Camera/outdoor6/DSC04116.JPG,char_data/4/DSC04116.JPG_13.jpg,646,480,640,19,323,342,320,354,True,6
4,40,kaist_dataset/Korean/Digital_Camera/outdoor6/DSC04116.JPG,char_data/4/DSC04116.JPG_14.jpg,1000,480,640,25,438,463,318,358,True,6
4,41,kaist_dataset/Korean/Digital_Camera/outdoor6/DSC04121.JPG,char_data/4/DSC04121.JPG_4.jpg,1271,480,640,31,166,197,179,220,True,6
4,38,kaist_dataset/Korean/Digital_Camera/outdoor6/DSC04121.JPG,char_data/4/DSC04121.JPG_5.jpg,1064,480,640,28,405,433,179,217,True,6
4,27,kaist_dataset/Korean/Digital_Camera/outdoor6/DSC04132.JPG,char_data/4/DSC04132.JPG_4.jpg,567,480,640,21,241,262,159,186,True,6
4,34,kaist_dataset/Korean/Digital_Camera/outdoor6/DSC04132.JPG,char_data/4/DSC04132.JPG_5.jpg,748,480,640,22,369,391,147,181,True,6
4,32,kaist_dataset/Korean/Digital_Camera/outdoor6/DSC04138.JPG,char_data/4/DSC04138.JPG_4.jpg,1056,480,640,33,241,274,153,185,True,6
4,30,kaist_dataset/Korean/Digital_Camera/outdoor6/DSC04138.JPG,char_data/4/DSC04138.JPG_5.jpg,840,480,640,28,381,409,155,185,True,6
4,59,kaist_dataset/Korean/Digital_Camera/outdoor6/DSC04143.JPG,char_data/4/DSC04143.JPG_2.jpg,2714,480,640,46,178,224,353,412,True,6
4,70,kaist_dataset/Korean/Digital_Camera/outdoor6/DSC04147.JPG,char_data/4/DSC04147.JPG_2.jpg,4130,480,640,59,136,195,179,249,True,6
4,51,kaist_dataset/Korean/Digital_Camera/outdoor6/DSC04308.JPG,char_data/4/DSC04308.JPG_2.jpg,1530,480,640,30,190,220,384,435,True,6
4,62,kaist_dataset/Korean/Digital_Camera/outdoor6/DSC04332.JPG,char_data/4/DSC04332.JPG_6.jpg,3162,480,640,51,274,325,345,407,True,6
4,58,kaist_dataset/Korean/Digital_Camera/outdoor6/DSC04332.JPG,char_data/4/DSC04332.JPG_7.jpg,2726,480,640,47,372,419,351,409,True,6
4,55,kaist_dataset/Korean/Digital_Camera/outdoor6/DSC04332.JPG,char_data/4/DSC04332.JPG_8.jpg,2970,480,640,54,417,471,350,405,True,6
4,57,kaist_dataset/Korean/Digital_Camera/outdoor6/DSC04350.JPG,char_data/4/DSC04350.JPG_2.jpg,2280,480,640,40,559,599,325,382,True,6
4,53,kaist_dataset/Korean/Digital_Camera/outdoor6/DSC04352.JPG,char_data/4/DSC04352.JPG_4.jpg,1007,480,640,19,382,401,282,335,True,6
4,52,kaist_dataset/Korean/Digital_Camera/outdoor6/DSC04352.JPG,char_data/4/DSC04352.JPG_5.jpg,1352,480,640,26,438,464,287,339,True,6
4,78,kaist_dataset/Korean/Digital_Camera/outdoor6/DSC04359.JPG,char_data/4/DSC04359.JPG_2.jpg,3900,480,640,50,437,487,106,184,True,6
4,36,kaist_dataset/Korean/Digital_Camera/outdoor6/DSC04400.JPG,char_data/4/DSC04400.JPG_4.jpg,900,480,640,25,505,530,231,267,True,6
4,43,kaist_dataset/Korean/Digital_Camera/outdoor6/DSC04400.JPG,char_data/4/DSC04400.JPG_5.jpg,946,480,640,22,302,324,398,441,True,6
4,166,kaist_dataset/Korean/Digital_Camera/outdoor7/DSC04470.JPG,char_data/4/DSC04470.JPG_2.jpg,12948,480,640,78,175,253,139,305,True,6
4,34,kaist_dataset/Korean/Digital_Camera/outdoor7/P1010003.JPG,char_data/4/P1010003.JPG_2.jpg,952,480,640,28,251,279,277,311,True,6
4,33,kaist_dataset/Korean/Digital_Camera/outdoor7/P1010004.JPG,char_data/4/P1010004.JPG_4.jpg,330,480,640,10,540,550,294,327,True,6
4,26,kaist_dataset/Korean/Digital_Camera/outdoor7/P1010005.JPG,char_data/4/P1010005.JPG_4.jpg,650,480,640,25,394,419,192,218,True,6
4,27,kaist_dataset/Korean/Digital_Camera/outdoor7/P1010005.JPG,char_data/4/P1010005.JPG_5.jpg,729,480,640,27,545,572,191,218,True,6
4,57,kaist_dataset/Korean/Digital_Camera/outdoor7/P1010011.JPG,char_data/4/P1010011.JPG_2.jpg,1881,480,640,33,444,477,227,284,True,6
4,58,kaist_dataset/Korean/Digital_Camera/outdoor7/P1010023.JPG,char_data/4/P1010023.JPG_2.jpg,2030,480,640,35,14,49,289,347,True,6
4,38,kaist_dataset/Korean/Digital_Camera/outdoor7/P1010035.JPG,char_data/4/P1010035.JPG_2.jpg,1140,480,640,30,24,54,200,238,True,6
4,33,kaist_dataset/Korean/Digital_Camera/outdoor7/P1010054.JPG,char_data/4/P1010054.JPG_2.jpg,660,480,640,20,488,508,227,260,True,6
4,29,kaist_dataset/Korean/Digital_Camera/outdoor7/P1010056.JPG,char_data/4/P1010056.JPG_6.jpg,725,480,640,25,390,415,268,297,True,6
4,32,kaist_dataset/Korean/Digital_Camera/outdoor7/P1010056.JPG,char_data/4/P1010056.JPG_7.jpg,608,480,640,19,506,525,268,300,True,6
4,30,kaist_dataset/Korean/Digital_Camera/outdoor7/P1010057.JPG,char_data/4/P1010057.JPG_2.jpg,750,480,640,25,499,524,229,259,True,6
4,37,kaist_dataset/Korean/Digital_Camera/outdoor7/P1010061.JPG,char_data/4/P1010061.JPG_2.jpg,1184,480,640,32,339,371,320,357,True,6
4,38,kaist_dataset/Korean/Digital_Camera/outdoor7/P1010067.JPG,char_data/4/P1010067.JPG_6.jpg,1216,480,640,32,140,172,313,351,True,6
4,43,kaist_dataset/Korean/Digital_Camera/outdoor7/P1010067.JPG,char_data/4/P1010067.JPG_7.jpg,1462,480,640,34,303,337,311,354,True,6
4,63,kaist_dataset/Korean/Digital_Camera/outdoor7/P1010068.JPG,char_data/4/P1010068.JPG_8.jpg,2079,480,640,33,294,327,276,339,True,6
4,58,kaist_dataset/Korean/Digital_Camera/outdoor7/P1010068.JPG,char_data/4/P1010068.JPG_9.jpg,1856,480,640,32,375,407,276,334,True,6
4,66,kaist_dataset/Korean/Digital_Camera/outdoor7/P1010068.JPG,char_data/4/P1010068.JPG_10.jpg,2244,480,640,34,521,555,271,337,True,6
4,57,kaist_dataset/Korean/Digital_Camera/outdoor7/P1010068.JPG,char_data/4/P1010068.JPG_11.jpg,1938,480,640,34,581,615,276,333,True,6
4,42,kaist_dataset/Korean/Digital_Camera/outdoor7/P1010069.JPG,char_data/4/P1010069.JPG_4.jpg,1470,480,640,35,226,261,313,355,True,6
4,55,kaist_dataset/Korean/Digital_Camera/outdoor7/P1010077.JPG,char_data/4/P1010077.JPG_4.jpg,1925,480,640,35,198,233,246,301,True,6
4,52,kaist_dataset/Korean/Digital_Camera/outdoor7/P1010077.JPG,char_data/4/P1010077.JPG_5.jpg,1300,480,640,25,355,380,242,294,True,6
4,35,kaist_dataset/Korean/Digital_Camera/outdoor7/P1010078.JPG,char_data/4/P1010078.JPG_2.jpg,770,480,640,22,168,190,251,286,True,6
4,107,kaist_dataset/Korean/Digital_Camera/outdoor7/P1010079.JPG,char_data/4/P1010079.JPG_2.jpg,6206,480,640,58,90,148,339,446,True,6
4,68,kaist_dataset/Korean/Digital_Camera/outdoor7/P1010081.JPG,char_data/4/P1010081.JPG_8.jpg,3332,480,640,49,110,159,223,291,True,6
4,61,kaist_dataset/Korean/Digital_Camera/outdoor7/P1010081.JPG,char_data/4/P1010081.JPG_9.jpg,2501,480,640,41,213,254,215,276,True,6
4,64,kaist_dataset/Korean/Digital_Camera/outdoor7/P1010081.JPG,char_data/4/P1010081.JPG_10.jpg,2560,480,640,40,387,427,206,270,True,6
4,54,kaist_dataset/Korean/Digital_Camera/outdoor7/P1010081.JPG,char_data/4/P1010081.JPG_11.jpg,2484,480,640,46,341,387,209,263,True,6
4,38,kaist_dataset/Korean/Digital_Camera/outdoor7/P1010082.JPG,char_data/4/P1010082.JPG_4.jpg,1482,480,640,39,117,156,49,87,True,6
4,48,kaist_dataset/Korean/Digital_Camera/outdoor7/P1010085.JPG,char_data/4/P1010085.JPG_6.jpg,1440,480,640,30,215,245,268,316,True,6
4,54,kaist_dataset/Korean/Digital_Camera/outdoor7/P1010085.JPG,char_data/4/P1010085.JPG_7.jpg,1944,480,640,36,449,485,267,321,True,6
4,77,kaist_dataset/Korean/Digital_Camera/outdoor7/P1010086.JPG,char_data/4/P1010086.JPG_7.jpg,4620,480,640,60,55,115,255,332,True,6
4,71,kaist_dataset/Korean/Digital_Camera/outdoor7/P1010086.JPG,char_data/4/P1010086.JPG_8.jpg,4970,480,640,70,467,537,256,327,True,6
4,24,kaist_dataset/Korean/Digital_Camera/outdoor7/P1010100.JPG,char_data/4/P1010100.JPG_16.jpg,648,480,640,27,205,232,225,249,True,6
4,24,kaist_dataset/Korean/Digital_Camera/outdoor7/P1010100.JPG,char_data/4/P1010100.JPG_17.jpg,480,480,640,20,281,301,223,247,True,6
4,26,kaist_dataset/Korean/Digital_Camera/outdoor7/P1010100.JPG,char_data/4/P1010100.JPG_18.jpg,468,480,640,18,375,393,219,245,True,6
4,27,kaist_dataset/Korean/Digital_Camera/outdoor7/P1010100.JPG,char_data/4/P1010100.JPG_19.jpg,432,480,640,16,410,426,219,246,True,6
4,21,kaist_dataset/Korean/Digital_Camera/outdoor7/P1010100.JPG,char_data/4/P1010100.JPG_20.jpg,357,480,640,17,463,480,218,239,True,6
4,24,kaist_dataset/Korean/Digital_Camera/outdoor7/P1010100.JPG,char_data/4/P1010100.JPG_21.jpg,360,480,640,15,481,496,221,245,True,6
4,47,kaist_dataset/Korean/Digital_Camera/outdoor7/P1010100.JPG,char_data/4/P1010100.JPG_22.jpg,1504,480,640,32,164,196,346,393,True,6
4,42,kaist_dataset/Korean/Digital_Camera/outdoor7/P1010100.JPG,char_data/4/P1010100.JPG_23.jpg,1428,480,640,34,289,323,349,391,True,6
4,36,kaist_dataset/Korean/Digital_Camera/outdoor7/P1010101.JPG,char_data/4/P1010101.JPG_4.jpg,864,480,640,24,324,348,230,266,True,6
4,38,kaist_dataset/Korean/Digital_Camera/outdoor7/P1010101.JPG,char_data/4/P1010101.JPG_5.jpg,798,480,640,21,423,444,233,271,True,6
4,33,kaist_dataset/Korean/Digital_Camera/outdoor7/P1010107.JPG,char_data/4/P1010107.JPG_2.jpg,924,480,640,28,258,286,223,256,True,6
4,52,kaist_dataset/Korean/Digital_Camera/outdoor7/P1010111.JPG,char_data/4/P1010111.JPG_4.jpg,1508,480,640,29,349,378,216,268,True,6
4,23,kaist_dataset/Korean/Digital_Camera/outdoor7/P1010112.JPG,char_data/4/P1010112.JPG_2.jpg,414,480,640,18,466,484,359,382,True,6
4,28,kaist_dataset/Korean/Digital_Camera/outdoor7/P1010121.JPG,char_data/4/P1010121.JPG_6.jpg,784,480,640,28,438,466,210,238,True,6
4,27,kaist_dataset/Korean/Digital_Camera/outdoor7/P1010121.JPG,char_data/4/P1010121.JPG_7.jpg,702,480,640,26,531,557,212,239,True,6
4,28,kaist_dataset/Korean/Digital_Camera/outdoor7/P1010121.JPG,char_data/4/P1010121.JPG_8.jpg,588,480,640,21,558,579,211,239,True,6
4,23,kaist_dataset/Korean/Digital_Camera/outdoor7/P1010124.JPG,char_data/4/P1010124.JPG_2.jpg,460,480,640,20,283,303,156,179,True,6
4,38,kaist_dataset/Korean/Digital_Camera/outdoor7/P1010138.JPG,char_data/4/P1010138.JPG_6.jpg,646,480,640,17,209,226,285,323,True,6
4,39,kaist_dataset/Korean/Digital_Camera/outdoor7/P1010138.JPG,char_data/4/P1010138.JPG_7.jpg,741,480,640,19,255,274,284,323,True,6
4,66,kaist_dataset/Korean/Digital_Camera/outdoor8/DSC02950.JPG,char_data/4/DSC02950.JPG_4.jpg,3630,480,640,55,137,192,265,331,True,6
4,57,kaist_dataset/Korean/Digital_Camera/outdoor8/DSC02950.JPG,char_data/4/DSC02950.JPG_5.jpg,2736,480,640,48,239,287,282,339,True,6
4,29,kaist_dataset/Korean/Digital_Camera/outdoor8/P090912069.jpg,char_data/4/P090912069.jpg_2.jpg,986,480,640,34,485,519,214,243,True,6
4,37,kaist_dataset/Korean/Digital_Camera/outdoor8/P1010142.JPG,char_data/4/P1010142.JPG_4.jpg,888,480,640,24,199,223,281,318,True,6
4,39,kaist_dataset/Korean/Digital_Camera/outdoor8/P1010142.JPG,char_data/4/P1010142.JPG_5.jpg,975,480,640,25,260,285,281,320,True,6
4,37,kaist_dataset/Korean/Digital_Camera/outdoor8/P1010143.JPG,char_data/4/P1010143.JPG_2.jpg,1073,480,640,29,304,333,263,300,True,6
4,48,kaist_dataset/Korean/Digital_Camera/outdoor8/P1010147.JPG,char_data/4/P1010147.JPG_4.jpg,2112,480,640,44,341,385,313,361,True,6
4,60,kaist_dataset/Korean/Digital_Camera/outdoor8/P1010160.JPG,char_data/4/P1010160.JPG_4.jpg,3600,480,640,60,131,191,230,290,True,6
4,73,kaist_dataset/Korean/Digital_Camera/outdoor8/P1010160.JPG,char_data/4/P1010160.JPG_5.jpg,5110,480,640,70,490,560,220,293,True,6
4,44,kaist_dataset/Korean/Digital_Camera/outdoor8/P1010170.JPG,char_data/4/P1010170.JPG_2.jpg,1232,480,640,28,326,354,268,312,True,6
4,51,kaist_dataset/Korean/Digital_Camera/outdoor8/P1010171.JPG,char_data/4/P1010171.JPG_2.jpg,1989,480,640,39,361,400,232,283,True,6
4,82,kaist_dataset/Korean/Digital_Camera/outdoor8/P1010172.JPG,char_data/4/P1010172.JPG_6.jpg,4592,480,640,56,134,190,220,302,True,6
4,74,kaist_dataset/Korean/Digital_Camera/outdoor8/P1010172.JPG,char_data/4/P1010172.JPG_7.jpg,3552,480,640,48,359,407,224,298,True,6
4,76,kaist_dataset/Korean/Digital_Camera/outdoor8/P1010172.JPG,char_data/4/P1010172.JPG_8.jpg,3268,480,640,43,407,450,224,300,True,6
4,31,kaist_dataset/Korean/Digital_Camera/outdoor8/P1010178.JPG,char_data/4/P1010178.JPG_6.jpg,806,480,640,26,269,295,391,422,True,6
4,38,kaist_dataset/Korean/Digital_Camera/outdoor8/P1010178.JPG,char_data/4/P1010178.JPG_7.jpg,608,480,640,16,390,406,389,427,True,6
4,35,kaist_dataset/Korean/Digital_Camera/outdoor8/P1010178.JPG,char_data/4/P1010178.JPG_8.jpg,630,480,640,18,388,406,306,341,True,6
4,38,kaist_dataset/Korean/Digital_Camera/outdoor8/P1010189.JPG,char_data/4/P1010189.JPG_4.jpg,1444,480,640,38,175,213,229,267,True,6
4,40,kaist_dataset/Korean/Digital_Camera/outdoor8/P1010189.JPG,char_data/4/P1010189.JPG_5.jpg,1320,480,640,33,308,341,232,272,True,6
4,31,kaist_dataset/Korean/Digital_Camera/outdoor8/P1011112.JPG,char_data/4/P1011112.JPG_4.jpg,589,480,640,19,510,529,226,257,True,6
4,38,kaist_dataset/Korean/Digital_Camera/outdoor8/P1011112.JPG,char_data/4/P1011112.JPG_5.jpg,760,480,640,20,279,299,206,244,True,6
4,23,kaist_dataset/Korean/Digital_Camera/outdoor8/크기변환_P1010033.JPG,char_data/4/크기변환_P1010033.JPG_4.jpg,322,480,640,14,415,429,178,201,True,6
4,41,kaist_dataset/Korean/Digital_Camera/outdoor8/크기변환_P1010033.JPG,char_data/4/크기변환_P1010033.JPG_5.jpg,1066,480,640,26,574,600,171,212,True,6
4,40,"kaist_dataset/Korean/Mobile_Phone/(M,K)C-outdoor/P090912033.jpg",char_data/4/P090912033.jpg_4.jpg,1160,480,640,29,441,470,305,345,True,6
4,56,"kaist_dataset/Korean/Mobile_Phone/(M,K)C-outdoor/P090912033.jpg",char_data/4/P090912033.jpg_5.jpg,2744,480,640,49,440,489,356,412,True,6
4,114,"kaist_dataset/Korean/Mobile_Phone/(M,K)D-indoor/P090911066.jpg",char_data/4/P090911066.jpg_2.jpg,12540,480,640,110,240,350,317,431,True,6
4,75,"kaist_dataset/Korean/Mobile_Phone/(M,K)E-bookCover/P090831154.jpg",char_data/4/P090831154.jpg_2.jpg,4275,480,640,57,460,517,137,212,True,6
4,33,kaist_dataset/Mixed/Digital_Camera/(C.S)A-shadow/DSC03257.JPG,char_data/4/DSC03257.JPG_2.jpg,858,480,640,26,249,275,384,417,True,6
4,53,kaist_dataset/Mixed/Digital_Camera/(C.S)A-shadow/DSC04304.JPG,char_data/4/DSC04304.JPG_4.jpg,1855,480,640,35,408,443,281,334,True,6
4,54,kaist_dataset/Mixed/Digital_Camera/(C.S)A-shadow/DSC04304.JPG,char_data/4/DSC04304.JPG_5.jpg,2052,480,640,38,504,542,281,335,True,6
4,34,kaist_dataset/Mixed/Digital_Camera/(C.S)A-shadow/DSC04306.JPG,char_data/4/DSC04306.JPG_2.jpg,714,480,640,21,280,301,410,444,True,6
4,40,kaist_dataset/Mixed/Digital_Camera/(C.S)A-shadow/P1010019.JPG,char_data/4/P1010019.JPG_2.jpg,1000,480,640,25,292,317,199,239,True,6
4,32,kaist_dataset/Mixed/Digital_Camera/(C.S)B-light/DSC03298.JPG,char_data/4/DSC03298.JPG_2.jpg,576,480,640,18,355,373,287,319,True,6
4,20,kaist_dataset/Mixed/Digital_Camera/(C.S)C-outdoor1/014.JPG,char_data/4/014.JPG_6.jpg,340,480,640,17,181,198,279,299,True,6
4,14,kaist_dataset/Mixed/Digital_Camera/(C.S)C-outdoor1/014.JPG,char_data/4/014.JPG_7.jpg,224,480,640,16,225,241,283,297,True,6
4,19,kaist_dataset/Mixed/Digital_Camera/(C.S)C-outdoor1/014.JPG,char_data/4/014.JPG_8.jpg,342,480,640,18,241,259,280,299,True,6
4,22,kaist_dataset/Mixed/Digital_Camera/(C.S)C-outdoor1/047.JPG,char_data/4/047.JPG_2.jpg,198,480,640,9,554,563,240,262,True,6
4,57,kaist_dataset/Mixed/Digital_Camera/(C.S)C-outdoor1/066.JPG,char_data/4/066.JPG_2.jpg,2166,480,640,38,471,509,176,233,True,6
4,50,kaist_dataset/Mixed/Digital_Camera/(C.S)C-outdoor1/080116-0084.jpg,char_data/4/080116-0084.jpg_2.jpg,1350,600,800,27,569,596,305,355,True,6
4,51,kaist_dataset/Mixed/Digital_Camera/(C.S)C-outdoor1/1.JPG,char_data/4/1.JPG_2.jpg,1275,576,768,25,262,287,458,509,True,6
4,26,kaist_dataset/Mixed/Digital_Camera/(C.S)C-outdoor1/121.JPG,char_data/4/121.JPG_2.jpg,468,480,640,18,470,488,277,303,True,6
4,46,kaist_dataset/Mixed/Digital_Camera/(C.S)C-outdoor1/133.JPG,char_data/4/133.JPG_2.jpg,1196,480,640,26,40,66,218,264,True,6
4,32,kaist_dataset/Mixed/Digital_Camera/(C.S)C-outdoor1/2.JPG,char_data/4/2.JPG_4.jpg,576,576,768,18,286,304,70,102,True,6
4,36,kaist_dataset/Mixed/Digital_Camera/(C.S)C-outdoor1/2.JPG,char_data/4/2.JPG_5.jpg,648,576,768,18,306,324,67,103,True,6
4,51,kaist_dataset/Mixed/Digital_Camera/(C.S)C-outdoor1/2007-12-09-day-exterior-078.jpg,char_data/4/2007-12-09-day-exterior-078.jpg_8.jpg,1377,1200,1600,27,584,611,591,642,True,6
4,54,kaist_dataset/Mixed/Digital_Camera/(C.S)C-outdoor1/2007-12-09-day-exterior-078.jpg,char_data/4/2007-12-09-day-exterior-078.jpg_9.jpg,1080,1200,1600,20,739,759,581,635,True,6
4,51,kaist_dataset/Mixed/Digital_Camera/(C.S)C-outdoor1/2007-12-09-day-exterior-078.jpg,char_data/4/2007-12-09-day-exterior-078.jpg_10.jpg,918,1200,1600,18,782,800,583,634,True,6
4,55,kaist_dataset/Mixed/Digital_Camera/(C.S)C-outdoor1/2007-12-09-day-exterior-078.jpg,char_data/4/2007-12-09-day-exterior-078.jpg_11.jpg,1375,1200,1600,25,866,891,578,633,True,6
4,71,kaist_dataset/Mixed/Digital_Camera/(C.S)C-outdoor1/2007-12-09-day-exterior-086.jpg,char_data/4/2007-12-09-day-exterior-086.jpg_2.jpg,5396,1200,1600,76,832,908,721,792,True,6
4,21,kaist_dataset/Mixed/Digital_Camera/(C.S)C-outdoor1/48.JPG,char_data/4/48.JPG_6.jpg,336,576,768,16,266,282,344,365,True,6
4,22,kaist_dataset/Mixed/Digital_Camera/(C.S)C-outdoor1/48.JPG,char_data/4/48.JPG_7.jpg,330,576,768,15,296,311,343,365,True,6
4,24,kaist_dataset/Mixed/Digital_Camera/(C.S)C-outdoor1/48.JPG,char_data/4/48.JPG_8.jpg,312,576,768,13,374,387,342,366,True,6
4,40,kaist_dataset/Mixed/Digital_Camera/(C.S)C-outdoor1/51.JPG,char_data/4/51.JPG_2.jpg,1080,576,768,27,636,663,376,416,True,6
4,39,kaist_dataset/Mixed/Digital_Camera/(C.S)C-outdoor1/56.JPG,char_data/4/56.JPG_2.jpg,1716,576,768,44,543,587,299,338,True,6
4,26,kaist_dataset/Mixed/Digital_Camera/(C.S)C-outdoor1/57.JPG,char_data/4/57.JPG_10.jpg,364,500,766,14,419,433,296,322,True,6
4,31,kaist_dataset/Mixed/Digital_Camera/(C.S)C-outdoor1/57.JPG,char_data/4/57.JPG_11.jpg,434,500,766,14,544,558,296,327,True,6
4,27,kaist_dataset/Mixed/Digital_Camera/(C.S)C-outdoor1/57.JPG,char_data/4/57.JPG_12.jpg,459,500,766,17,623,640,298,325,True,6
4,26,kaist_dataset/Mixed/Digital_Camera/(C.S)C-outdoor1/57.JPG,char_data/4/57.JPG_13.jpg,364,500,766,14,378,392,454,480,True,6
4,23,kaist_dataset/Mixed/Digital_Camera/(C.S)C-outdoor1/57.JPG,char_data/4/57.JPG_14.jpg,276,500,766,12,451,463,457,480,True,6
4,31,kaist_dataset/Mixed/Digital_Camera/(C.S)C-outdoor1/DSC02242.JPG,char_data/4/DSC02242.JPG_2.jpg,403,480,640,13,573,586,260,291,True,6
4,85,kaist_dataset/Mixed/Digital_Camera/(C.S)C-outdoor1/DSC02244.JPG,char_data/4/DSC02244.JPG_4.jpg,4165,480,640,49,273,322,347,432,True,6
4,89,kaist_dataset/Mixed/Digital_Camera/(C.S)C-outdoor1/DSC02244.JPG,char_data/4/DSC02244.JPG_5.jpg,4984,480,640,56,506,562,349,438,True,6
4,39,kaist_dataset/Mixed/Digital_Camera/(C.S)C-outdoor1/DSC02312.JPG,char_data/4/DSC02312.JPG_2.jpg,1248,480,640,32,300,332,219,258,True,6
4,36,kaist_dataset/Mixed/Digital_Camera/(C.S)C-outdoor1/DSC02344.JPG,char_data/4/DSC02344.JPG_4.jpg,828,480,640,23,471,494,255,291,True,6
4,34,kaist_dataset/Mixed/Digital_Camera/(C.S)C-outdoor1/DSC02344.JPG,char_data/4/DSC02344.JPG_5.jpg,646,480,640,19,546,565,258,292,True,6
4,41,kaist_dataset/Mixed/Digital_Camera/(C.S)C-outdoor1/DSC02349.JPG,char_data/4/DSC02349.JPG_4.jpg,1066,480,640,26,362,388,195,236,True,6
4,36,kaist_dataset/Mixed/Digital_Camera/(C.S)C-outdoor1/DSC02349.JPG,char_data/4/DSC02349.JPG_5.jpg,792,480,640,22,419,441,427,463,True,6
4,43,kaist_dataset/Mixed/Digital_Camera/(C.S)C-outdoor1/DSC02350.JPG,char_data/4/DSC02350.JPG_2.jpg,1333,480,640,31,423,454,397,440,True,6
4,47,kaist_dataset/Mixed/Digital_Camera/(C.S)C-outdoor1/P1010009.JPG,char_data/4/P1010009.JPG_4.jpg,1222,480,640,26,91,117,233,280,True,6
4,41,kaist_dataset/Mixed/Digital_Camera/(C.S)C-outdoor1/P1010009.JPG,char_data/4/P1010009.JPG_5.jpg,1107,480,640,27,155,182,238,279,True,6
4,38,kaist_dataset/Mixed/Digital_Camera/(C.S)C-outdoor1/P1010010.JPG,char_data/4/P1010010.JPG_4.jpg,1140,480,640,30,222,252,218,256,True,6
4,45,kaist_dataset/Mixed/Digital_Camera/(C.S)C-outdoor1/P1010010.JPG,char_data/4/P1010010.JPG_5.jpg,1035,480,640,23,315,338,362,407,True,6
4,47,kaist_dataset/Mixed/Digital_Camera/(C.S)C-outdoor1/P1010012.JPG,char_data/4/P1010012.JPG_4.jpg,1927,480,640,41,286,327,236,283,True,6
4,52,kaist_dataset/Mixed/Digital_Camera/(C.S)C-outdoor1/P1010012.JPG,char_data/4/P1010012.JPG_5.jpg,1716,480,640,33,456,489,235,287,True,6
4,37,kaist_dataset/Mixed/Digital_Camera/(C.S)C-outdoor2/DSC02368.JPG,char_data/4/DSC02368.JPG_2.jpg,592,480,640,16,457,473,380,417,True,6
4,40,kaist_dataset/Mixed/Digital_Camera/(C.S)C-outdoor2/DSC02374.JPG,char_data/4/DSC02374.JPG_2.jpg,880,480,640,22,337,359,296,336,True,6
4,44,kaist_dataset/Mixed/Digital_Camera/(C.S)C-outdoor2/DSC02389.JPG,char_data/4/DSC02389.JPG_6.jpg,1760,480,640,40,276,316,38,82,True,6
4,46,kaist_dataset/Mixed/Digital_Camera/(C.S)C-outdoor2/DSC02389.JPG,char_data/4/DSC02389.JPG_7.jpg,1610,480,640,35,310,345,249,295,True,6
4,41,kaist_dataset/Mixed/Digital_Camera/(C.S)C-outdoor2/DSC02389.JPG,char_data/4/DSC02389.JPG_8.jpg,1394,480,640,34,344,378,248,289,True,6
4,37,kaist_dataset/Mixed/Digital_Camera/(C.S)C-outdoor2/DSC02391.JPG,char_data/4/DSC02391.JPG_2.jpg,777,480,640,21,134,155,334,371,True,6
4,75,kaist_dataset/Mixed/Digital_Camera/(C.S)C-outdoor2/DSC02407.JPG,char_data/4/DSC02407.JPG_2.jpg,3450,480,640,46,110,156,77,152,True,6
4,39,kaist_dataset/Mixed/Digital_Camera/(C.S)C-outdoor2/DSC02411.JPG,char_data/4/DSC02411.JPG_4.jpg,1131,480,640,29,426,455,349,388,True,6
4,38,kaist_dataset/Mixed/Digital_Camera/(C.S)C-outdoor2/DSC02411.JPG,char_data/4/DSC02411.JPG_5.jpg,1216,480,640,32,556,588,348,386,True,6
4,33,kaist_dataset/Mixed/Digital_Camera/(C.S)C-outdoor2/DSC02422.JPG,char_data/4/DSC02422.JPG_4.jpg,825,480,640,25,435,460,221,254,True,6
4,26,kaist_dataset/Mixed/Digital_Camera/(C.S)C-outdoor2/DSC02422.JPG,char_data/4/DSC02422.JPG_5.jpg,624,480,640,24,481,505,225,251,True,6
4,31,kaist_dataset/Mixed/Digital_Camera/(C.S)C-outdoor2/DSC02460.JPG,char_data/4/DSC02460.JPG_8.jpg,527,480,640,17,472,489,305,336,True,6
4,31,kaist_dataset/Mixed/Digital_Camera/(C.S)C-outdoor2/DSC02460.JPG,char_data/4/DSC02460.JPG_9.jpg,620,480,640,20,487,507,306,337,True,6
4,30,kaist_dataset/Mixed/Digital_Camera/(C.S)C-outdoor2/DSC02460.JPG,char_data/4/DSC02460.JPG_10.jpg,540,480,640,18,508,526,305,335,True,6
4,31,kaist_dataset/Mixed/Digital_Camera/(C.S)C-outdoor2/DSC02460.JPG,char_data/4/DSC02460.JPG_11.jpg,775,480,640,25,526,551,304,335,True,6
4,34,kaist_dataset/Mixed/Digital_Camera/(C.S)C-outdoor2/DSC02477.JPG,char_data/4/DSC02477.JPG_2.jpg,816,480,640,24,348,372,244,278,True,6
4,38,kaist_dataset/Mixed/Digital_Camera/(C.S)C-outdoor2/DSC02490.JPG,char_data/4/DSC02490.JPG_6.jpg,836,480,640,22,320,342,342,380,True,6
4,41,kaist_dataset/Mixed/Digital_Camera/(C.S)C-outdoor2/DSC02490.JPG,char_data/4/DSC02490.JPG_7.jpg,943,480,640,23,401,424,341,382,True,6
4,50,kaist_dataset/Mixed/Digital_Camera/(C.S)C-outdoor2/DSC02490.JPG,char_data/4/DSC02490.JPG_8.jpg,1400,480,640,28,389,417,400,450,True,6
4,46,kaist_dataset/Mixed/Digital_Camera/(C.S)C-outdoor2/DSC02511.JPG,char_data/4/DSC02511.JPG_2.jpg,1242,480,640,27,577,604,403,449,True,6
4,34,kaist_dataset/Mixed/Digital_Camera/(C.S)C-outdoor2/DSC02545.JPG,char_data/4/DSC02545.JPG_2.jpg,1224,480,640,36,97,133,406,440,True,6
4,28,kaist_dataset/Mixed/Digital_Camera/(C.S)C-outdoor2/DSC02555.JPG,char_data/4/DSC02555.JPG_2.jpg,672,480,640,24,392,416,251,279,True,6
4,25,kaist_dataset/Mixed/Digital_Camera/(C.S)C-outdoor2/DSC02877.JPG,char_data/4/DSC02877.JPG_2.jpg,425,480,640,17,500,517,219,244,True,6
4,24,kaist_dataset/Mixed/Digital_Camera/(C.S)C-outdoor2/DSC02879.JPG,char_data/4/DSC02879.JPG_4.jpg,432,480,640,18,266,284,284,308,True,6
4,26,kaist_dataset/Mixed/Digital_Camera/(C.S)C-outdoor2/DSC02879.JPG,char_data/4/DSC02879.JPG_5.jpg,364,480,640,14,297,311,279,305,True,6
4,34,kaist_dataset/Mixed/Digital_Camera/(C.S)C-outdoor2/DSC02887.JPG,char_data/4/DSC02887.JPG_2.jpg,782,480,640,23,239,262,122,156,True,6
4,28,kaist_dataset/Mixed/Digital_Camera/(C.S)C-outdoor2/DSC02894.JPG,char_data/4/DSC02894.JPG_2.jpg,784,480,640,28,255,283,265,293,True,6
4,36,kaist_dataset/Mixed/Digital_Camera/(C.S)C-outdoor2/DSC02895.JPG,char_data/4/DSC02895.JPG_2.jpg,828,480,640,23,196,219,361,397,True,6
4,39,kaist_dataset/Mixed/Digital_Camera/(C.S)C-outdoor2/DSC02912.JPG,char_data/4/DSC02912.JPG_4.jpg,1833,480,640,47,154,201,438,477,True,6
4,41,kaist_dataset/Mixed/Digital_Camera/(C.S)C-outdoor2/DSC02912.JPG,char_data/4/DSC02912.JPG_5.jpg,1271,480,640,31,377,408,437,478,True,6
4,25,kaist_dataset/Mixed/Digital_Camera/(C.S)C-outdoor2/DSC02917.JPG,char_data/4/DSC02917.JPG_2.jpg,450,480,640,18,559,577,230,255,True,6
4,35,kaist_dataset/Mixed/Digital_Camera/(C.S)C-outdoor2/DSC02926.JPG,char_data/4/DSC02926.JPG_2.jpg,945,480,640,27,373,400,155,190,True,6
4,34,kaist_dataset/Mixed/Digital_Camera/(C.S)C-outdoor2/DSC02930.JPG,char_data/4/DSC02930.JPG_2.jpg,850,480,640,25,275,300,194,228,True,6
4,36,kaist_dataset/Mixed/Digital_Camera/(C.S)C-outdoor2/DSC02933.JPG,char_data/4/DSC02933.JPG_2.jpg,684,480,640,19,476,495,241,277,True,6
4,25,kaist_dataset/Mixed/Digital_Camera/(C.S)C-outdoor2/DSC02936.JPG,char_data/4/DSC02936.JPG_2.jpg,450,480,640,18,487,505,230,255,True,6
4,40,kaist_dataset/Mixed/Digital_Camera/(C.S)C-outdoor2/DSC02937.JPG,char_data/4/DSC02937.JPG_2.jpg,960,480,640,24,103,127,202,242,True,6
4,44,kaist_dataset/Mixed/Digital_Camera/(C.S)C-outdoor2/DSC02938.JPG,char_data/4/DSC02938.JPG_2.jpg,1232,480,640,28,413,441,242,286,True,6
4,27,kaist_dataset/Mixed/Digital_Camera/(C.S)C-outdoor2/DSC02947.JPG,char_data/4/DSC02947.JPG_2.jpg,648,480,640,24,396,420,231,258,True,6
4,39,kaist_dataset/Mixed/Digital_Camera/(C.S)C-outdoor2/DSC02954.JPG,char_data/4/DSC02954.JPG_6.jpg,1092,480,640,28,65,93,88,127,True,6
4,39,kaist_dataset/Mixed/Digital_Camera/(C.S)C-outdoor2/DSC02954.JPG,char_data/4/DSC02954.JPG_7.jpg,1170,480,640,30,88,118,252,291,True,6
4,37,kaist_dataset/Mixed/Digital_Camera/(C.S)C-outdoor2/DSC02954.JPG,char_data/4/DSC02954.JPG_8.jpg,666,480,640,18,509,527,269,306,True,6
4,56,kaist_dataset/Mixed/Digital_Camera/(C.S)C-outdoor2/P1010013.JPG,char_data/4/P1010013.JPG_4.jpg,1960,480,640,35,216,251,363,419,True,6
4,56,kaist_dataset/Mixed/Digital_Camera/(C.S)C-outdoor2/P1010013.JPG,char_data/4/P1010013.JPG_5.jpg,1848,480,640,33,371,404,363,419,True,6
4,22,kaist_dataset/Mixed/Digital_Camera/(C.S)C-outdoor2/P1010015.JPG,char_data/4/P1010015.JPG_4.jpg,308,480,640,14,427,441,190,212,True,6
4,17,kaist_dataset/Mixed/Digital_Camera/(C.S)C-outdoor2/P1010015.JPG,char_data/4/P1010015.JPG_5.jpg,187,480,640,11,345,356,189,206,True,6
4,34,kaist_dataset/Mixed/Digital_Camera/(C.S)C-outdoor3/DSC02956.JPG,char_data/4/DSC02956.JPG_2.jpg,850,480,640,25,89,114,390,424,True,6
4,40,kaist_dataset/Mixed/Digital_Camera/(C.S)C-outdoor3/DSC02958.JPG,char_data/4/DSC02958.JPG_2.jpg,1040,480,640,26,234,260,402,442,True,6
4,33,kaist_dataset/Mixed/Digital_Camera/(C.S)C-outdoor3/DSC02969.JPG,char_data/4/DSC02969.JPG_6.jpg,792,480,640,24,251,275,233,266,True,6
4,39,kaist_dataset/Mixed/Digital_Camera/(C.S)C-outdoor3/DSC02969.JPG,char_data/4/DSC02969.JPG_7.jpg,702,480,640,18,381,399,226,265,True,6
4,31,kaist_dataset/Mixed/Digital_Camera/(C.S)C-outdoor3/DSC02969.JPG,char_data/4/DSC02969.JPG_8.jpg,713,480,640,23,408,431,234,265,True,6
4,40,kaist_dataset/Mixed/Digital_Camera/(C.S)C-outdoor3/DSC02970.JPG,char_data/4/DSC02970.JPG_2.jpg,1360,480,640,34,107,141,362,402,True,6
4,45,kaist_dataset/Mixed/Digital_Camera/(C.S)C-outdoor3/DSC02989.JPG,char_data/4/DSC02989.JPG_4.jpg,900,480,640,20,490,510,347,392,True,6
4,53,kaist_dataset/Mixed/Digital_Camera/(C.S)C-outdoor3/DSC02989.JPG,char_data/4/DSC02989.JPG_5.jpg,901,480,640,17,620,637,347,400,True,6
4,28,kaist_dataset/Mixed/Digital_Camera/(C.S)C-outdoor3/DSC03017.JPG,char_data/4/DSC03017.JPG_2.jpg,616,480,640,22,367,389,245,273,True,6
4,37,kaist_dataset/Mixed/Digital_Camera/(C.S)C-outdoor3/DSC03051.JPG,char_data/4/DSC03051.JPG_2.jpg,703,480,640,19,338,357,317,354,True,6
4,56,kaist_dataset/Mixed/Digital_Camera/(C.S)C-outdoor3/DSC03067.JPG,char_data/4/DSC03067.JPG_2.jpg,1960,480,640,35,344,379,193,249,True,6
4,41,kaist_dataset/Mixed/Digital_Camera/(C.S)C-outdoor3/DSC03185.JPG,char_data/4/DSC03185.JPG_2.jpg,2091,480,640,51,192,243,148,189,True,6
4,35,kaist_dataset/Mixed/Digital_Camera/(C.S)C-outdoor3/DSC03187.JPG,char_data/4/DSC03187.JPG_6.jpg,910,480,640,26,261,287,390,425,True,6
4,39,kaist_dataset/Mixed/Digital_Camera/(C.S)C-outdoor3/DSC03187.JPG,char_data/4/DSC03187.JPG_7.jpg,936,480,640,24,370,394,391,430,True,6
4,36,kaist_dataset/Mixed/Digital_Camera/(C.S)C-outdoor3/DSC03187.JPG,char_data/4/DSC03187.JPG_8.jpg,720,480,640,20,423,443,392,428,True,6
4,49,kaist_dataset/Mixed/Digital_Camera/(C.S)C-outdoor3/DSC03189.JPG,char_data/4/DSC03189.JPG_2.jpg,1421,480,640,29,360,389,304,353,True,6
4,40,kaist_dataset/Mixed/Digital_Camera/(C.S)C-outdoor3/DSC03236.JPG,char_data/4/DSC03236.JPG_4.jpg,880,480,640,22,82,104,187,227,True,6
4,43,kaist_dataset/Mixed/Digital_Camera/(C.S)C-outdoor3/DSC03236.JPG,char_data/4/DSC03236.JPG_5.jpg,1032,480,640,24,219,243,420,463,True,6
4,29,kaist_dataset/Mixed/Digital_Camera/(C.S)C-outdoor3/DSC03250.JPG,char_data/4/DSC03250.JPG_2.jpg,580,480,640,20,443,463,405,434,True,6
4,26,kaist_dataset/Mixed/Digital_Camera/(C.S)C-outdoor3/DSC03255.JPG,char_data/4/DSC03255.JPG_2.jpg,546,480,640,21,190,211,186,212,True,6
4,35,kaist_dataset/Mixed/Digital_Camera/(C.S)C-outdoor3/DSC03259.JPG,char_data/4/DSC03259.JPG_4.jpg,630,480,640,18,345,363,358,393,True,6
4,43,kaist_dataset/Mixed/Digital_Camera/(C.S)C-outdoor3/DSC03259.JPG,char_data/4/DSC03259.JPG_5.jpg,774,480,640,18,412,430,354,397,True,6
4,26,kaist_dataset/Mixed/Digital_Camera/(C.S)C-outdoor3/DSC03292.JPG,char_data/4/DSC03292.JPG_2.jpg,416,480,640,16,497,513,121,147,True,6
4,33,kaist_dataset/Mixed/Digital_Camera/(C.S)C-outdoor3/DSC03301.JPG,char_data/4/DSC03301.JPG_2.jpg,792,480,640,24,349,373,143,176,True,6
4,29,kaist_dataset/Mixed/Digital_Camera/(C.S)C-outdoor3/DSC03303.JPG,char_data/4/DSC03303.JPG_2.jpg,986,480,640,34,241,275,278,307,True,6
4,33,kaist_dataset/Mixed/Digital_Camera/(C.S)C-outdoor3/DSC03308.JPG,char_data/4/DSC03308.JPG_6.jpg,957,480,640,29,199,228,249,282,True,6
4,29,kaist_dataset/Mixed/Digital_Camera/(C.S)C-outdoor3/DSC03308.JPG,char_data/4/DSC03308.JPG_7.jpg,638,480,640,22,343,365,250,279,True,6
4,33,kaist_dataset/Mixed/Digital_Camera/(C.S)C-outdoor3/DSC03308.JPG,char_data/4/DSC03308.JPG_8.jpg,990,480,640,30,363,393,250,283,True,6
4,41,kaist_dataset/Mixed/Digital_Camera/(C.S)C-outdoor3/DSC03309.JPG,char_data/4/DSC03309.JPG_2.jpg,943,480,640,23,220,243,259,300,True,6
4,34,kaist_dataset/Mixed/Digital_Camera/(C.S)C-outdoor3/DSC03311.JPG,char_data/4/DSC03311.JPG_4.jpg,544,480,640,16,305,321,371,405,True,6
4,25,kaist_dataset/Mixed/Digital_Camera/(C.S)C-outdoor3/DSC03311.JPG,char_data/4/DSC03311.JPG_5.jpg,400,480,640,16,343,359,373,398,True,6
4,36,kaist_dataset/Mixed/Digital_Camera/(C.S)C-outdoor3/DSC03312.JPG,char_data/4/DSC03312.JPG_2.jpg,1152,480,640,32,120,152,285,321,True,6
4,29,kaist_dataset/Mixed/Digital_Camera/(C.S)C-outdoor3/DSC03315.JPG,char_data/4/DSC03315.JPG_2.jpg,725,480,640,25,336,361,124,153,True,6
4,30,kaist_dataset/Mixed/Digital_Camera/(C.S)C-outdoor3/DSC03316.JPG,char_data/4/DSC03316.JPG_4.jpg,510,480,640,17,214,231,91,121,True,6
4,29,kaist_dataset/Mixed/Digital_Camera/(C.S)C-outdoor3/DSC03316.JPG,char_data/4/DSC03316.JPG_5.jpg,464,480,640,16,369,385,85,114,True,6
4,46,kaist_dataset/Mixed/Digital_Camera/(C.S)C-outdoor3/DSC03323.JPG,char_data/4/DSC03323.JPG_4.jpg,1794,480,640,39,182,221,300,346,True,6
4,45,kaist_dataset/Mixed/Digital_Camera/(C.S)C-outdoor3/DSC03323.JPG,char_data/4/DSC03323.JPG_5.jpg,1215,480,640,27,345,372,288,333,True,6
4,33,kaist_dataset/Mixed/Digital_Camera/(C.S)C-outdoor3/DSC03328.JPG,char_data/4/DSC03328.JPG_8.jpg,693,480,640,21,139,160,404,437,True,6
4,33,kaist_dataset/Mixed/Digital_Camera/(C.S)C-outdoor3/DSC03328.JPG,char_data/4/DSC03328.JPG_9.jpg,561,480,640,17,216,233,403,436,True,6
4,40,kaist_dataset/Mixed/Digital_Camera/(C.S)C-outdoor3/DSC03328.JPG,char_data/4/DSC03328.JPG_10.jpg,920,480,640,23,315,338,398,438,True,6
4,36,kaist_dataset/Mixed/Digital_Camera/(C.S)C-outdoor3/DSC03328.JPG,char_data/4/DSC03328.JPG_11.jpg,648,480,640,18,404,422,399,435,True,6
4,70,kaist_dataset/Mixed/Digital_Camera/(C.S)C-outdoor3/DSC03332.JPG,char_data/4/DSC03332.JPG_2.jpg,3710,480,640,53,25,78,339,409,True,6
4,41,kaist_dataset/Mixed/Digital_Camera/(C.S)C-outdoor4/DSC03435.JPG,char_data/4/DSC03435.JPG_2.jpg,943,480,640,23,144,167,410,451,True,6
4,32,kaist_dataset/Mixed/Digital_Camera/(C.S)C-outdoor4/DSC03446.JPG,char_data/4/DSC03446.JPG_4.jpg,960,480,640,30,66,96,288,320,True,6
4,31,kaist_dataset/Mixed/Digital_Camera/(C.S)C-outdoor4/DSC03446.JPG,char_data/4/DSC03446.JPG_5.jpg,837,480,640,27,222,249,292,323,True,6
4,85,kaist_dataset/Mixed/Digital_Camera/(C.S)C-outdoor4/DSC03544.JPG,char_data/4/DSC03544.JPG_2.jpg,4505,480,640,53,200,253,168,253,True,6
4,43,kaist_dataset/Mixed/Digital_Camera/(C.S)C-outdoor4/DSC03548.JPG,char_data/4/DSC03548.JPG_4.jpg,1978,480,640,46,99,145,395,438,True,6
4,43,kaist_dataset/Mixed/Digital_Camera/(C.S)C-outdoor4/DSC03548.JPG,char_data/4/DSC03548.JPG_5.jpg,2064,480,640,48,327,375,396,439,True,6
4,45,kaist_dataset/Mixed/Digital_Camera/(C.S)C-outdoor4/DSC03549.JPG,char_data/4/DSC03549.JPG_4.jpg,990,480,640,22,540,562,177,222,True,6
4,29,kaist_dataset/Mixed/Digital_Camera/(C.S)C-outdoor4/DSC03549.JPG,char_data/4/DSC03549.JPG_5.jpg,435,480,640,15,290,305,426,455,True,6
4,29,kaist_dataset/Mixed/Digital_Camera/(C.S)C-outdoor4/DSC03552.JPG,char_data/4/DSC03552.JPG_2.jpg,580,480,640,20,350,370,319,348,True,6
4,48,kaist_dataset/Mixed/Digital_Camera/(C.S)C-outdoor4/DSC03569.JPG,char_data/4/DSC03569.JPG_2.jpg,1488,480,640,31,367,398,165,213,True,6
4,27,kaist_dataset/Mixed/Digital_Camera/(C.S)C-outdoor4/DSC03570.JPG,char_data/4/DSC03570.JPG_4.jpg,567,480,640,21,248,269,426,453,True,6
4,27,kaist_dataset/Mixed/Digital_Camera/(C.S)C-outdoor4/DSC03570.JPG,char_data/4/DSC03570.JPG_5.jpg,432,480,640,16,289,305,424,451,True,6
4,46,kaist_dataset/Mixed/Digital_Camera/(C.S)C-outdoor4/DSC03571.JPG,char_data/4/DSC03571.JPG_2.jpg,1380,480,640,30,290,320,305,351,True,6
4,35,kaist_dataset/Mixed/Digital_Camera/(C.S)C-outdoor4/DSC03604.JPG,char_data/4/DSC03604.JPG_2.jpg,665,480,640,19,314,333,142,177,True,6
4,52,kaist_dataset/Mixed/Digital_Camera/(C.S)C-outdoor4/DSC03613.JPG,char_data/4/DSC03613.JPG_8.jpg,988,480,640,19,399,418,25,77,True,6
4,55,kaist_dataset/Mixed/Digital_Camera/(C.S)C-outdoor4/DSC03613.JPG,char_data/4/DSC03613.JPG_9.jpg,1540,480,640,28,445,473,21,76,True,6
4,55,kaist_dataset/Mixed/Digital_Camera/(C.S)C-outdoor4/DSC03613.JPG,char_data/4/DSC03613.JPG_10.jpg,1375,480,640,25,528,553,23,78,True,6
4,49,kaist_dataset/Mixed/Digital_Camera/(C.S)C-outdoor4/DSC03613.JPG,char_data/4/DSC03613.JPG_11.jpg,1225,480,640,25,596,621,31,80,True,6
4,31,kaist_dataset/Mixed/Digital_Camera/(C.S)C-outdoor4/DSC03616.JPG,char_data/4/DSC03616.JPG_2.jpg,620,480,640,20,549,569,153,184,True,6
4,51,kaist_dataset/Mixed/Digital_Camera/(C.S)C-outdoor4/DSC03617.JPG,char_data/4/DSC03617.JPG_2.jpg,2091,480,640,41,202,243,377,428,True,6
4,30,kaist_dataset/Mixed/Digital_Camera/(C.S)C-outdoor4/DSC03618.JPG,char_data/4/DSC03618.JPG_2.jpg,780,480,640,26,236,262,410,440,True,6
4,47,kaist_dataset/Mixed/Digital_Camera/(C.S)C-outdoor4/DSC03621.JPG,char_data/4/DSC03621.JPG_4.jpg,1269,480,640,27,355,382,331,378,True,6
4,48,kaist_dataset/Mixed/Digital_Camera/(C.S)C-outdoor4/DSC03621.JPG,char_data/4/DSC03621.JPG_5.jpg,1104,480,640,23,515,538,332,380,True,6
4,47,kaist_dataset/Mixed/Digital_Camera/(C.S)C-outdoor4/DSC03631.JPG,char_data/4/DSC03631.JPG_4.jpg,1269,480,640,27,205,232,356,403,True,6
4,46,kaist_dataset/Mixed/Digital_Camera/(C.S)C-outdoor4/DSC03631.JPG,char_data/4/DSC03631.JPG_5.jpg,1104,480,640,24,323,347,355,401,True,6
4,42,kaist_dataset/Mixed/Digital_Camera/(C.S)C-outdoor4/DSC03633.JPG,char_data/4/DSC03633.JPG_6.jpg,1260,480,640,30,120,150,269,311,True,6
4,47,kaist_dataset/Mixed/Digital_Camera/(C.S)C-outdoor4/DSC03633.JPG,char_data/4/DSC03633.JPG_7.jpg,1316,480,640,28,181,209,264,311,True,6
4,40,kaist_dataset/Mixed/Digital_Camera/(C.S)C-outdoor4/DSC03633.JPG,char_data/4/DSC03633.JPG_8.jpg,1040,480,640,26,232,258,269,309,True,6
4,29,kaist_dataset/Mixed/Digital_Camera/(C.S)C-outdoor4/DSC03637.JPG,char_data/4/DSC03637.JPG_4.jpg,493,480,640,17,244,261,300,329,True,6
4,35,kaist_dataset/Mixed/Digital_Camera/(C.S)C-outdoor4/DSC03637.JPG,char_data/4/DSC03637.JPG_5.jpg,525,480,640,15,274,289,292,327,True,6
4,36,kaist_dataset/Mixed/Digital_Camera/(C.S)C-outdoor4/DSC03640.JPG,char_data/4/DSC03640.JPG_8.jpg,792,480,640,22,148,170,399,435,True,6
4,23,kaist_dataset/Mixed/Digital_Camera/(C.S)C-outdoor4/DSC03640.JPG,char_data/4/DSC03640.JPG_9.jpg,437,480,640,19,442,461,401,424,True,6
4,30,kaist_dataset/Mixed/Digital_Camera/(C.S)C-outdoor4/DSC03640.JPG,char_data/4/DSC03640.JPG_10.jpg,420,480,640,14,485,499,399,429,True,6
4,30,kaist_dataset/Mixed/Digital_Camera/(C.S)C-outdoor4/DSC03640.JPG,char_data/4/DSC03640.JPG_11.jpg,630,480,640,21,500,521,398,428,True,6
4,33,kaist_dataset/Mixed/Digital_Camera/(C.S)C-outdoor4/DSC03642.JPG,char_data/4/DSC03642.JPG_2.jpg,693,480,640,21,425,446,397,430,True,6
4,22,kaist_dataset/Mixed/Digital_Camera/(C.S)C-outdoor4/DSC03643.JPG,char_data/4/DSC03643.JPG_2.jpg,418,480,640,19,470,489,329,351,True,6
4,50,kaist_dataset/Mixed/Digital_Camera/(C.S)C-outdoor4/DSC03651.JPG,char_data/4/DSC03651.JPG_2.jpg,1900,480,640,38,200,238,358,408,True,6
4,78,kaist_dataset/Mixed/Digital_Camera/(C.S)C-outdoor4/DSC03654.JPG,char_data/4/DSC03654.JPG_6.jpg,2808,480,640,36,345,381,156,234,True,6
4,93,kaist_dataset/Mixed/Digital_Camera/(C.S)C-outdoor4/DSC03654.JPG,char_data/4/DSC03654.JPG_7.jpg,3069,480,640,33,467,500,150,243,True,6
4,87,kaist_dataset/Mixed/Digital_Camera/(C.S)C-outdoor4/DSC03654.JPG,char_data/4/DSC03654.JPG_8.jpg,3741,480,640,43,563,606,153,240,True,6
4,60,kaist_dataset/Mixed/Digital_Camera/(C.S)C-outdoor4/DSC03655.JPG,char_data/4/DSC03655.JPG_4.jpg,1440,480,640,24,221,245,382,442,True,6
4,55,kaist_dataset/Mixed/Digital_Camera/(C.S)C-outdoor4/DSC03655.JPG,char_data/4/DSC03655.JPG_5.jpg,1320,480,640,24,363,387,387,442,True,6
4,32,kaist_dataset/Mixed/Digital_Camera/(C.S)C-outdoor4/DSC03656.JPG,char_data/4/DSC03656.JPG_6.jpg,864,480,640,27,388,415,417,449,True,6
4,36,kaist_dataset/Mixed/Digital_Camera/(C.S)C-outdoor4/DSC03656.JPG,char_data/4/DSC03656.JPG_7.jpg,1008,480,640,28,496,524,417,453,True,6
4,34,kaist_dataset/Mixed/Digital_Camera/(C.S)C-outdoor4/DSC03656.JPG,char_data/4/DSC03656.JPG_8.jpg,1122,480,640,33,582,615,414,448,True,6
4,25,kaist_dataset/Mixed/Digital_Camera/(C.S)C-outdoor4/DSC03657.JPG,char_data/4/DSC03657.JPG_6.jpg,500,480,640,20,272,292,422,447,True,6
4,30,kaist_dataset/Mixed/Digital_Camera/(C.S)C-outdoor4/DSC03657.JPG,char_data/4/DSC03657.JPG_7.jpg,510,480,640,17,369,386,422,452,True,6
4,31,kaist_dataset/Mixed/Digital_Camera/(C.S)C-outdoor4/DSC03657.JPG,char_data/4/DSC03657.JPG_8.jpg,713,480,640,23,385,408,419,450,True,6
4,33,kaist_dataset/Mixed/Digital_Camera/(C.S)C-outdoor4/DSC03658.JPG,char_data/4/DSC03658.JPG_2.jpg,726,480,640,22,299,321,418,451,True,6
4,30,kaist_dataset/Mixed/Digital_Camera/(C.S)C-outdoor4/DSC03660.JPG,char_data/4/DSC03660.JPG_2.jpg,990,480,640,33,277,310,99,129,True,6
4,29,kaist_dataset/Mixed/Digital_Camera/(C.S)C-outdoor4/DSC03661.JPG,char_data/4/DSC03661.JPG_4.jpg,493,480,640,17,477,494,331,360,True,6
4,36,kaist_dataset/Mixed/Digital_Camera/(C.S)C-outdoor4/DSC03661.JPG,char_data/4/DSC03661.JPG_5.jpg,684,480,640,19,540,559,326,362,True,6
4,44,kaist_dataset/Mixed/Digital_Camera/(C.S)C-outdoor4/DSC03662.JPG,char_data/4/DSC03662.JPG_2.jpg,1232,480,640,28,431,459,420,464,True,6
4,37,kaist_dataset/Mixed/Digital_Camera/(C.S)C-outdoor4/DSC03665.JPG,char_data/4/DSC03665.JPG_2.jpg,1369,480,640,37,247,284,156,193,True,6
4,33,kaist_dataset/Mixed/Digital_Camera/(C.S)C-outdoor4/DSC03667.JPG,char_data/4/DSC03667.JPG_4.jpg,594,480,640,18,422,440,376,409,True,6
4,33,kaist_dataset/Mixed/Digital_Camera/(C.S)C-outdoor4/DSC03667.JPG,char_data/4/DSC03667.JPG_5.jpg,660,480,640,20,485,505,376,409,True,6
4,22,kaist_dataset/Mixed/Digital_Camera/(C.S)C-outdoor4/DSC03670.JPG,char_data/4/DSC03670.JPG_2.jpg,308,480,640,14,428,442,450,472,True,6
4,35,kaist_dataset/Mixed/Digital_Camera/(C.S)C-outdoor4/DSC03673.JPG,char_data/4/DSC03673.JPG_2.jpg,770,480,640,22,176,198,308,343,True,6
4,29,kaist_dataset/Mixed/Digital_Camera/(C.S)C-outdoor4/DSC03674.JPG,char_data/4/DSC03674.JPG_2.jpg,435,480,640,15,506,521,420,449,True,6
4,40,kaist_dataset/Mixed/Digital_Camera/(C.S)C-outdoor4/DSC03675.JPG,char_data/4/DSC03675.JPG_2.jpg,1080,480,640,27,417,444,340,380,True,6
4,29,kaist_dataset/Mixed/Digital_Camera/(C.S)C-outdoor4/DSC03676.JPG,char_data/4/DSC03676.JPG_2.jpg,580,480,640,20,76,96,271,300,True,6
4,47,kaist_dataset/Mixed/Digital_Camera/(C.S)C-outdoor4/DSC03679.JPG,char_data/4/DSC03679.JPG_4.jpg,1504,480,640,32,206,238,276,323,True,6
4,37,kaist_dataset/Mixed/Digital_Camera/(C.S)C-outdoor4/DSC03679.JPG,char_data/4/DSC03679.JPG_5.jpg,740,480,640,20,317,337,281,318,True,6
4,30,kaist_dataset/Mixed/Digital_Camera/(C.S)C-outdoor4/DSC03687.JPG,char_data/4/DSC03687.JPG_2.jpg,510,480,640,17,415,432,399,429,True,6
4,25,kaist_dataset/Mixed/Digital_Camera/(C.S)C-outdoor4/DSC03689.JPG,char_data/4/DSC03689.JPG_4.jpg,350,480,640,14,526,540,132,157,True,6
4,28,kaist_dataset/Mixed/Digital_Camera/(C.S)C-outdoor4/DSC03689.JPG,char_data/4/DSC03689.JPG_5.jpg,336,480,640,12,592,604,133,161,True,6
4,31,kaist_dataset/Mixed/Digital_Camera/(C.S)C-outdoor4/DSC03691.JPG,char_data/4/DSC03691.JPG_4.jpg,496,480,640,16,379,395,224,255,True,6
4,30,kaist_dataset/Mixed/Digital_Camera/(C.S)C-outdoor4/DSC03691.JPG,char_data/4/DSC03691.JPG_5.jpg,510,480,640,17,530,547,222,252,True,6
4,47,kaist_dataset/Mixed/Digital_Camera/(C.S)C-outdoor4/DSC03693.JPG,char_data/4/DSC03693.JPG_4.jpg,1128,480,640,24,403,427,354,401,True,6
4,51,kaist_dataset/Mixed/Digital_Camera/(C.S)C-outdoor4/DSC03693.JPG,char_data/4/DSC03693.JPG_5.jpg,918,480,640,18,451,469,353,404,True,6
4,65,kaist_dataset/Mixed/Digital_Camera/(C.S)C-outdoor4/DSC03702.JPG,char_data/4/DSC03702.JPG_4.jpg,3315,480,640,51,71,122,335,400,True,6
4,61,kaist_dataset/Mixed/Digital_Camera/(C.S)C-outdoor4/DSC03702.JPG,char_data/4/DSC03702.JPG_5.jpg,2867,480,640,47,403,450,338,399,True,6
4,34,kaist_dataset/Mixed/Digital_Camera/(C.S)C-outdoor4/DSC03716.JPG,char_data/4/DSC03716.JPG_4.jpg,782,480,640,23,528,551,253,287,True,6
4,35,kaist_dataset/Mixed/Digital_Camera/(C.S)C-outdoor4/DSC03716.JPG,char_data/4/DSC03716.JPG_5.jpg,665,480,640,19,562,581,251,286,True,6
4,27,kaist_dataset/Mixed/Digital_Camera/(C.S)C-outdoor4/DSC03718.JPG,char_data/4/DSC03718.JPG_4.jpg,486,480,640,18,457,475,406,433,True,6
4,31,kaist_dataset/Mixed/Digital_Camera/(C.S)C-outdoor4/DSC03718.JPG,char_data/4/DSC03718.JPG_5.jpg,403,480,640,13,496,509,401,432,True,6
4,28,kaist_dataset/Mixed/Digital_Camera/(C.S)C-outdoor4/DSC03719.JPG,char_data/4/DSC03719.JPG_4.jpg,476,480,640,17,464,481,185,213,True,6
4,28,kaist_dataset/Mixed/Digital_Camera/(C.S)C-outdoor4/DSC03719.JPG,char_data/4/DSC03719.JPG_5.jpg,420,480,640,15,500,515,186,214,True,6
4,28,kaist_dataset/Mixed/Digital_Camera/(C.S)C-outdoor4/DSC03722.JPG,char_data/4/DSC03722.JPG_4.jpg,812,480,640,29,219,248,206,234,True,6
4,35,kaist_dataset/Mixed/Digital_Camera/(C.S)C-outdoor4/DSC03722.JPG,char_data/4/DSC03722.JPG_5.jpg,1015,480,640,29,375,404,202,237,True,6
4,28,kaist_dataset/Mixed/Digital_Camera/(C.S)C-outdoor4/DSC03723.JPG,char_data/4/DSC03723.JPG_4.jpg,700,480,640,25,392,417,198,226,True,6
4,24,kaist_dataset/Mixed/Digital_Camera/(C.S)C-outdoor4/DSC03723.JPG,char_data/4/DSC03723.JPG_5.jpg,504,480,640,21,477,498,200,224,True,6
4,41,kaist_dataset/Mixed/Digital_Camera/(C.S)C-outdoor4/DSC03724.JPG,char_data/4/DSC03724.JPG_2.jpg,1271,480,640,31,348,379,278,319,True,6
4,34,kaist_dataset/Mixed/Digital_Camera/(C.S)C-outdoor4/DSC03730.JPG,char_data/4/DSC03730.JPG_2.jpg,918,480,640,27,325,352,256,290,True,6
4,37,kaist_dataset/Mixed/Digital_Camera/(C.S)C-outdoor4/DSC03732.JPG,char_data/4/DSC03732.JPG_2.jpg,1147,480,640,31,315,346,394,431,True,6
4,31,kaist_dataset/Mixed/Digital_Camera/(C.S)C-outdoor4/DSC03733.JPG,char_data/4/DSC03733.JPG_2.jpg,589,480,640,19,486,505,179,210,True,6
4,26,kaist_dataset/Mixed/Digital_Camera/(C.S)C-outdoor4/DSC03734.JPG,char_data/4/DSC03734.JPG_2.jpg,364,480,640,14,500,514,350,376,True,6
4,34,kaist_dataset/Mixed/Digital_Camera/(C.S)C-outdoor4/DSC03735.JPG,char_data/4/DSC03735.JPG_4.jpg,646,480,640,19,454,473,147,181,True,6
4,40,kaist_dataset/Mixed/Digital_Camera/(C.S)C-outdoor4/DSC03735.JPG,char_data/4/DSC03735.JPG_5.jpg,760,480,640,19,571,590,152,192,True,6
4,29,kaist_dataset/Mixed/Digital_Camera/(C.S)C-outdoor4/DSC03737.JPG,char_data/4/DSC03737.JPG_6.jpg,522,480,640,18,152,170,161,190,True,6
4,27,kaist_dataset/Mixed/Digital_Camera/(C.S)C-outdoor4/DSC03737.JPG,char_data/4/DSC03737.JPG_7.jpg,459,480,640,17,290,307,165,192,True,6
4,27,kaist_dataset/Mixed/Digital_Camera/(C.S)C-outdoor4/DSC03737.JPG,char_data/4/DSC03737.JPG_8.jpg,594,480,640,22,320,342,168,195,True,6
4,45,kaist_dataset/Mixed/Digital_Camera/(C.S)C-outdoor4/DSC03738.JPG,char_data/4/DSC03738.JPG_2.jpg,1530,480,640,34,307,341,235,280,True,6
4,44,kaist_dataset/Mixed/Digital_Camera/(C.S)C-outdoor4/DSC03741.JPG,char_data/4/DSC03741.JPG_2.jpg,1584,480,640,36,333,369,357,401,True,6
4,29,kaist_dataset/Mixed/Digital_Camera/(C.S)C-outdoor4/DSC03745.JPG,char_data/4/DSC03745.JPG_4.jpg,638,480,640,22,115,137,273,302,True,6
4,35,kaist_dataset/Mixed/Digital_Camera/(C.S)C-outdoor4/DSC03745.JPG,char_data/4/DSC03745.JPG_5.jpg,735,480,640,21,473,494,270,305,True,6
4,30,kaist_dataset/Mixed/Digital_Camera/(C.S)C-outdoor4/DSC03757.JPG,char_data/4/DSC03757.JPG_4.jpg,360,480,640,12,317,329,338,368,True,6
4,30,kaist_dataset/Mixed/Digital_Camera/(C.S)C-outdoor4/DSC03757.JPG,char_data/4/DSC03757.JPG_5.jpg,330,480,640,11,490,501,340,370,True,6
4,26,kaist_dataset/Mixed/Digital_Camera/(C.S)C-outdoor4/DSC03758.JPG,char_data/4/DSC03758.JPG_6.jpg,442,480,640,17,255,272,305,331,True,6
4,27,kaist_dataset/Mixed/Digital_Camera/(C.S)C-outdoor4/DSC03758.JPG,char_data/4/DSC03758.JPG_7.jpg,513,480,640,19,344,363,309,336,True,6
4,26,kaist_dataset/Mixed/Digital_Camera/(C.S)C-outdoor4/DSC03758.JPG,char_data/4/DSC03758.JPG_8.jpg,390,480,640,15,370,385,313,339,True,6
4,29,kaist_dataset/Mixed/Digital_Camera/(C.S)C-outdoor4/DSC03764.JPG,char_data/4/DSC03764.JPG_6.jpg,609,480,640,21,216,237,273,302,True,6
4,30,kaist_dataset/Mixed/Digital_Camera/(C.S)C-outdoor4/DSC03764.JPG,char_data/4/DSC03764.JPG_7.jpg,540,480,640,18,318,336,272,302,True,6
4,29,kaist_dataset/Mixed/Digital_Camera/(C.S)C-outdoor4/DSC03764.JPG,char_data/4/DSC03764.JPG_8.jpg,551,480,640,19,344,363,271,300,True,6
4,30,kaist_dataset/Mixed/Digital_Camera/(C.S)C-outdoor4/DSC03769.JPG,char_data/4/DSC03769.JPG_2.jpg,300,480,640,10,170,180,419,449,True,6
4,37,kaist_dataset/Mixed/Digital_Camera/(C.S)C-outdoor4/DSC03781.JPG,char_data/4/DSC03781.JPG_6.jpg,1665,480,640,45,186,231,379,416,True,6
4,37,kaist_dataset/Mixed/Digital_Camera/(C.S)C-outdoor4/DSC03781.JPG,char_data/4/DSC03781.JPG_7.jpg,1184,480,640,32,386,418,379,416,True,6
4,43,kaist_dataset/Mixed/Digital_Camera/(C.S)C-outdoor4/DSC03781.JPG,char_data/4/DSC03781.JPG_8.jpg,1806,480,640,42,419,461,379,422,True,6
4,88,kaist_dataset/Mixed/Digital_Camera/(C.S)C-outdoor4/DSC03787.JPG,char_data/4/DSC03787.JPG_6.jpg,3168,480,640,36,360,396,140,228,True,6
4,84,kaist_dataset/Mixed/Digital_Camera/(C.S)C-outdoor4/DSC03787.JPG,char_data/4/DSC03787.JPG_7.jpg,2856,480,640,34,473,507,138,222,True,6
4,91,kaist_dataset/Mixed/Digital_Camera/(C.S)C-outdoor4/DSC03787.JPG,char_data/4/DSC03787.JPG_8.jpg,2912,480,640,32,567,599,139,230,True,6
4,41,kaist_dataset/Mixed/Digital_Camera/(C.S)C-outdoor5/DSC03821.JPG,char_data/4/DSC03821.JPG_4.jpg,861,480,640,21,233,254,78,119,True,6
4,40,kaist_dataset/Mixed/Digital_Camera/(C.S)C-outdoor5/DSC03821.JPG,char_data/4/DSC03821.JPG_5.jpg,880,480,640,22,285,307,80,120,True,6
4,37,kaist_dataset/Mixed/Digital_Camera/(C.S)C-outdoor5/DSC03837.JPG,char_data/4/DSC03837.JPG_8.jpg,925,480,640,25,317,342,379,416,True,6
4,64,kaist_dataset/Mixed/Digital_Camera/(C.S)C-outdoor5/DSC03837.JPG,char_data/4/DSC03837.JPG_9.jpg,2432,480,640,38,123,161,299,363,True,6
4,60,kaist_dataset/Mixed/Digital_Camera/(C.S)C-outdoor5/DSC03837.JPG,char_data/4/DSC03837.JPG_10.jpg,2280,480,640,38,221,259,304,364,True,6
4,64,kaist_dataset/Mixed/Digital_Camera/(C.S)C-outdoor5/DSC03837.JPG,char_data/4/DSC03837.JPG_11.jpg,2112,480,640,33,434,467,308,372,True,6
4,41,kaist_dataset/Mixed/Digital_Camera/(C.S)C-outdoor5/DSC03842.JPG,char_data/4/DSC03842.JPG_4.jpg,1107,480,640,27,220,247,226,267,True,6
4,44,kaist_dataset/Mixed/Digital_Camera/(C.S)C-outdoor5/DSC03842.JPG,char_data/4/DSC03842.JPG_5.jpg,968,480,640,22,345,367,227,271,True,6
4,61,kaist_dataset/Mixed/Digital_Camera/(C.S)C-outdoor5/DSC03847.JPG,char_data/4/DSC03847.JPG_8.jpg,1403,480,640,23,359,382,12,73,True,6
4,53,kaist_dataset/Mixed/Digital_Camera/(C.S)C-outdoor5/DSC03847.JPG,char_data/4/DSC03847.JPG_9.jpg,1484,480,640,28,422,450,16,69,True,6
4,54,kaist_dataset/Mixed/Digital_Camera/(C.S)C-outdoor5/DSC03847.JPG,char_data/4/DSC03847.JPG_10.jpg,1512,480,640,28,543,571,10,64,True,6
4,60,kaist_dataset/Mixed/Digital_Camera/(C.S)C-outdoor5/DSC03847.JPG,char_data/4/DSC03847.JPG_11.jpg,1500,480,640,25,595,620,12,72,True,6
4,38,kaist_dataset/Mixed/Digital_Camera/(C.S)C-outdoor5/DSC04014.JPG,char_data/4/DSC04014.JPG_4.jpg,760,480,640,20,224,244,299,337,True,6
4,39,kaist_dataset/Mixed/Digital_Camera/(C.S)C-outdoor5/DSC04014.JPG,char_data/4/DSC04014.JPG_5.jpg,702,480,640,18,402,420,301,340,False,6
4,67,kaist_dataset/Mixed/Digital_Camera/(C.S)C-outdoor5/DSC04016.JPG,char_data/4/DSC04016.JPG_2.jpg,2948,480,640,44,173,217,113,180,False,6
4,50,kaist_dataset/Mixed/Digital_Camera/(C.S)C-outdoor5/DSC04017.JPG,char_data/4/DSC04017.JPG_2.jpg,1950,480,640,39,205,244,427,477,False,6
4,25,kaist_dataset/Mixed/Digital_Camera/(C.S)C-outdoor5/DSC04031.JPG,char_data/4/DSC04031.JPG_4.jpg,375,480,640,15,460,475,382,407,False,6
4,22,kaist_dataset/Mixed/Digital_Camera/(C.S)C-outdoor5/DSC04031.JPG,char_data/4/DSC04031.JPG_5.jpg,330,480,640,15,153,168,380,402,False,6
4,58,kaist_dataset/Mixed/Digital_Camera/(C.S)C-outdoor5/DSC04033.JPG,char_data/4/DSC04033.JPG_6.jpg,2494,480,640,43,101,144,283,341,False,6
4,58,kaist_dataset/Mixed/Digital_Camera/(C.S)C-outdoor5/DSC04033.JPG,char_data/4/DSC04033.JPG_7.jpg,1972,480,640,34,373,407,271,329,False,6
4,53,kaist_dataset/Mixed/Digital_Camera/(C.S)C-outdoor5/DSC04033.JPG,char_data/4/DSC04033.JPG_8.jpg,1961,480,640,37,492,529,264,317,False,6
4,28,kaist_dataset/Mixed/Digital_Camera/(C.S)C-outdoor5/DSC04048.JPG,char_data/4/DSC04048.JPG_4.jpg,476,480,640,17,288,305,172,200,False,6
4,29,kaist_dataset/Mixed/Digital_Camera/(C.S)C-outdoor5/DSC04048.JPG,char_data/4/DSC04048.JPG_5.jpg,696,480,640,24,439,463,172,201,False,6
4,32,kaist_dataset/Mixed/Digital_Camera/(C.S)C-outdoor5/DSC04056.JPG,char_data/4/DSC04056.JPG_4.jpg,960,480,640,30,400,430,261,293,False,6
4,26,kaist_dataset/Mixed/Digital_Camera/(C.S)C-outdoor5/DSC04056.JPG,char_data/4/DSC04056.JPG_5.jpg,624,480,640,24,413,437,301,327,False,6
4,32,kaist_dataset/Mixed/Digital_Camera/(C.S)C-outdoor5/DSC04061.JPG,char_data/4/DSC04061.JPG_4.jpg,608,480,640,19,490,509,145,177,False,6
4,33,kaist_dataset/Mixed/Digital_Camera/(C.S)C-outdoor5/DSC04061.JPG,char_data/4/DSC04061.JPG_5.jpg,726,480,640,22,593,615,147,180,False,6
4,39,kaist_dataset/Mixed/Digital_Camera/(C.S)C-outdoor5/DSC04070.JPG,char_data/4/DSC04070.JPG_4.jpg,819,480,640,21,349,370,105,144,False,6
4,38,kaist_dataset/Mixed/Digital_Camera/(C.S)C-outdoor5/DSC04070.JPG,char_data/4/DSC04070.JPG_5.jpg,950,480,640,25,556,581,105,143,False,6
4,36,kaist_dataset/Mixed/Digital_Camera/(C.S)C-outdoor5/DSC04071.JPG,char_data/4/DSC04071.JPG_4.jpg,972,480,640,27,98,125,364,400,False,6
4,32,kaist_dataset/Mixed/Digital_Camera/(C.S)C-outdoor5/DSC04071.JPG,char_data/4/DSC04071.JPG_5.jpg,736,480,640,23,408,431,369,401,False,6
4,30,kaist_dataset/Mixed/Digital_Camera/(C.S)C-outdoor5/DSC04072.JPG,char_data/4/DSC04072.JPG_4.jpg,300,480,640,10,584,594,350,380,False,6
4,36,kaist_dataset/Mixed/Digital_Camera/(C.S)C-outdoor5/DSC04072.JPG,char_data/4/DSC04072.JPG_5.jpg,576,480,640,16,606,622,348,384,False,6
4,23,kaist_dataset/Mixed/Digital_Camera/(C.S)C-outdoor5/DSC04086.JPG,char_data/4/DSC04086.JPG_2.jpg,345,480,640,15,362,377,373,396,False,6
4,37,kaist_dataset/Mixed/Digital_Camera/(C.S)C-outdoor5/DSC04098.JPG,char_data/4/DSC04098.JPG_2.jpg,629,480,640,17,431,448,313,350,False,6
4,64,kaist_dataset/Mixed/Digital_Camera/(C.S)C-outdoor5/DSC04108.JPG,char_data/4/DSC04108.JPG_6.jpg,2240,480,640,35,322,357,239,303,False,6
4,69,kaist_dataset/Mixed/Digital_Camera/(C.S)C-outdoor5/DSC04108.JPG,char_data/4/DSC04108.JPG_7.jpg,2346,480,640,34,523,557,234,303,False,6
4,68,kaist_dataset/Mixed/Digital_Camera/(C.S)C-outdoor5/DSC04108.JPG,char_data/4/DSC04108.JPG_8.jpg,2380,480,640,35,557,592,231,299,False,6
4,38,kaist_dataset/Mixed/Digital_Camera/(C.S)C-outdoor5/DSC04115.JPG,char_data/4/DSC04115.JPG_2.jpg,1140,480,640,30,341,371,356,394,False,6
4,29,kaist_dataset/Mixed/Digital_Camera/(C.S)C-outdoor5/DSC04124.JPG,char_data/4/DSC04124.JPG_2.jpg,377,480,640,13,405,418,309,338,False,6
4,42,kaist_dataset/Mixed/Digital_Camera/(C.S)C-outdoor5/DSC04125.JPG,char_data/4/DSC04125.JPG_4.jpg,1218,480,640,29,41,70,178,220,False,6
4,39,kaist_dataset/Mixed/Digital_Camera/(C.S)C-outdoor5/DSC04125.JPG,char_data/4/DSC04125.JPG_5.jpg,936,480,640,24,425,449,415,454,False,6
4,39,kaist_dataset/Mixed/Digital_Camera/(C.S)C-outdoor5/DSC04135.JPG,char_data/4/DSC04135.JPG_2.jpg,1092,480,640,28,397,425,387,426,False,6
4,46,kaist_dataset/Mixed/Digital_Camera/(C.S)C-outdoor5/DSC04139.JPG,char_data/4/DSC04139.JPG_2.jpg,920,480,640,20,278,298,395,441,False,6
4,33,kaist_dataset/Mixed/Digital_Camera/(C.S)C-outdoor5/DSC04140.JPG,char_data/4/DSC04140.JPG_2.jpg,495,480,640,15,504,519,348,381,False,6
4,38,kaist_dataset/Mixed/Digital_Camera/(C.S)C-outdoor5/DSC04144.JPG,char_data/4/DSC04144.JPG_2.jpg,988,480,640,26,240,266,417,455,False,6
4,27,kaist_dataset/Mixed/Digital_Camera/(C.S)C-outdoor5/DSC04146.JPG,char_data/4/DSC04146.JPG_2.jpg,621,480,640,23,263,286,408,435,False,6
4,25,kaist_dataset/Mixed/Digital_Camera/(C.S)C-outdoor5/DSC04150.JPG,char_data/4/DSC04150.JPG_6.jpg,375,480,640,15,490,505,365,390,False,6
4,28,kaist_dataset/Mixed/Digital_Camera/(C.S)C-outdoor5/DSC04150.JPG,char_data/4/DSC04150.JPG_7.jpg,420,480,640,15,542,557,366,394,False,6
4,29,kaist_dataset/Mixed/Digital_Camera/(C.S)C-outdoor5/DSC04150.JPG,char_data/4/DSC04150.JPG_8.jpg,319,480,640,11,557,568,365,394,False,6
4,30,kaist_dataset/Mixed/Digital_Camera/(C.S)C-outdoor5/DSC04151.JPG,char_data/4/DSC04151.JPG_4.jpg,690,480,640,23,420,443,344,374,False,6
4,26,kaist_dataset/Mixed/Digital_Camera/(C.S)C-outdoor5/DSC04151.JPG,char_data/4/DSC04151.JPG_5.jpg,312,480,640,12,537,549,350,376,False,6
4,32,kaist_dataset/Mixed/Digital_Camera/(C.S)C-outdoor5/DSC04155.JPG,char_data/4/DSC04155.JPG_2.jpg,672,480,640,21,478,499,264,296,False,6
4,128,kaist_dataset/Mixed/Digital_Camera/(C.S)C-outdoor5/DSC04330.JPG,char_data/4/DSC04330.JPG_6.jpg,6912,480,640,54,122,176,245,373,False,6
4,37,kaist_dataset/Mixed/Digital_Camera/(C.S)C-outdoor5/DSC04330.JPG,char_data/4/DSC04330.JPG_7.jpg,1036,480,640,28,449,477,166,203,False,6
4,61,kaist_dataset/Mixed/Digital_Camera/(C.S)C-outdoor5/DSC04330.JPG,char_data/4/DSC04330.JPG_8.jpg,1891,480,640,31,485,516,356,417,False,6
4,59,kaist_dataset/Mixed/Digital_Camera/(C.S)C-outdoor5/DSC04401.JPG,char_data/4/DSC04401.JPG_4.jpg,1652,480,640,28,238,266,248,307,False,6
4,61,kaist_dataset/Mixed/Digital_Camera/(C.S)C-outdoor5/DSC04401.JPG,char_data/4/DSC04401.JPG_5.jpg,2013,480,640,33,430,463,244,305,False,6
4,36,kaist_dataset/Mixed/Digital_Camera/(C.S)C-outdoor5/P1010002.JPG,char_data/4/P1010002.JPG_4.jpg,1152,480,640,32,403,435,282,318,False,6
4,40,kaist_dataset/Mixed/Digital_Camera/(C.S)C-outdoor5/P1010002.JPG,char_data/4/P1010002.JPG_5.jpg,1080,480,640,27,465,492,283,323,False,6
4,28,kaist_dataset/Mixed/Digital_Camera/(C.S)C-outdoor5/P1010004.JPG,char_data/4/P1010004.JPG_5.jpg,644,480,640,23,237,260,306,334,False,6
4,39,kaist_dataset/Mixed/Digital_Camera/(C.S)C-outdoor5/P1010007.JPG,char_data/4/P1010007.JPG_6.jpg,1287,480,640,33,315,348,270,309,False,6
4,41,kaist_dataset/Mixed/Digital_Camera/(C.S)C-outdoor5/P1010007.JPG,char_data/4/P1010007.JPG_7.jpg,1476,480,640,36,374,410,270,311,False,6
4,42,kaist_dataset/Mixed/Digital_Camera/(C.S)C-outdoor5/P1010007.JPG,char_data/4/P1010007.JPG_8.jpg,1302,480,640,31,409,440,269,311,False,6
4,63,kaist_dataset/Mixed/Digital_Camera/(C.S)C-outdoor6/080116-0057.jpg,char_data/4/080116-0057.jpg_2.jpg,2079,1200,1600,33,688,721,818,881,False,6
4,28,kaist_dataset/Mixed/Digital_Camera/(C.S)C-outdoor6/DSC03324.JPG,char_data/4/DSC03324.JPG_2.jpg,448,480,640,16,391,407,154,182,False,6
4,63,kaist_dataset/Mixed/Digital_Camera/(C.S)C-outdoor6/P1010017.JPG,char_data/4/P1010017.JPG_4.jpg,1827,480,640,29,253,282,179,242,False,6
4,63,kaist_dataset/Mixed/Digital_Camera/(C.S)C-outdoor6/P1010017.JPG,char_data/4/P1010017.JPG_5.jpg,1827,480,640,29,308,337,177,240,False,6
4,35,kaist_dataset/Mixed/Digital_Camera/(C.S)C-outdoor6/P1010018.JPG,char_data/4/P1010018.JPG_4.jpg,840,480,640,24,408,432,245,280,False,6
4,33,kaist_dataset/Mixed/Digital_Camera/(C.S)C-outdoor6/P1010018.JPG,char_data/4/P1010018.JPG_5.jpg,726,480,640,22,453,475,243,276,False,6
4,30,kaist_dataset/Mixed/Digital_Camera/(C.S)C-outdoor6/P1010020.JPG,char_data/4/P1010020.JPG_6.jpg,480,480,640,16,138,154,336,366,False,6
4,33,kaist_dataset/Mixed/Digital_Camera/(C.S)C-outdoor6/P1010020.JPG,char_data/4/P1010020.JPG_7.jpg,594,480,640,18,227,245,337,370,False,6
4,32,kaist_dataset/Mixed/Digital_Camera/(C.S)C-outdoor6/P1010020.JPG,char_data/4/P1010020.JPG_8.jpg,832,480,640,26,95,121,230,262,False,6
4,33,kaist_dataset/Mixed/Digital_Camera/(C.S)C-outdoor6/P1010056.JPG,char_data/4/P1010056.JPG_8.jpg,693,480,640,21,299,320,230,263,False,6
4,26,kaist_dataset/Mixed/Digital_Camera/(C.S)C-outdoor6/P1010065.JPG,char_data/4/P1010065.JPG_2.jpg,572,480,640,22,323,345,233,259,False,6
4,59,kaist_dataset/Mixed/Digital_Camera/(C.S)C-outdoor6/P1010067.JPG,char_data/4/P1010067.JPG_8.jpg,1711,480,640,29,351,380,308,367,False,6
4,29,kaist_dataset/Mixed/Digital_Camera/(C.S)C-outdoor6/P1010069.JPG,char_data/4/P1010069.JPG_5.jpg,725,480,640,25,393,418,306,335,False,6
4,30,kaist_dataset/Mixed/Digital_Camera/(C.S)C-outdoor6/P1010073.JPG,char_data/4/P1010073.JPG_6.jpg,420,480,640,14,361,375,242,272,False,6
4,34,kaist_dataset/Mixed/Digital_Camera/(C.S)C-outdoor6/P1010073.JPG,char_data/4/P1010073.JPG_7.jpg,578,480,640,17,424,441,240,274,False,6
4,32,kaist_dataset/Mixed/Digital_Camera/(C.S)C-outdoor6/P1010073.JPG,char_data/4/P1010073.JPG_8.jpg,608,480,640,19,326,345,239,271,False,6
4,37,kaist_dataset/Mixed/Digital_Camera/(C.S)C-outdoor6/P1010074.JPG,char_data/4/P1010074.JPG_2.jpg,1184,480,640,32,165,197,308,345,False,6
4,39,kaist_dataset/Mixed/Digital_Camera/(C.S)C-outdoor6/P1010075.JPG,char_data/4/P1010075.JPG_4.jpg,585,480,640,15,435,450,308,347,False,6
4,28,kaist_dataset/Mixed/Digital_Camera/(C.S)C-outdoor6/P1010075.JPG,char_data/4/P1010075.JPG_5.jpg,448,480,640,16,533,549,312,340,False,6
4,34,kaist_dataset/Mixed/Digital_Camera/(C.S)C-outdoor6/P1010080.JPG,char_data/4/P1010080.JPG_2.jpg,1020,480,640,30,355,385,247,281,False,6
4,30,kaist_dataset/Mixed/Digital_Camera/(C.S)C-outdoor6/P1010082.JPG,char_data/4/P1010082.JPG_5.jpg,690,480,640,23,176,199,228,258,False,6
4,43,kaist_dataset/Mixed/Digital_Camera/(C.S)C-outdoor6/P1010084.JPG,char_data/4/P1010084.JPG_6.jpg,860,480,640,20,52,72,183,226,False,6
4,47,kaist_dataset/Mixed/Digital_Camera/(C.S)C-outdoor6/P1010084.JPG,char_data/4/P1010084.JPG_7.jpg,1551,480,640,33,305,338,190,237,False,6
4,43,kaist_dataset/Mixed/Digital_Camera/(C.S)C-outdoor6/P1010084.JPG,char_data/4/P1010084.JPG_8.jpg,1591,480,640,37,529,566,192,235,False,6
4,26,kaist_dataset/Mixed/Digital_Camera/(C.S)C-outdoor6/P1010085.JPG,char_data/4/P1010085.JPG_8.jpg,624,480,640,24,307,331,158,184,False,6
4,58,kaist_dataset/Mixed/Digital_Camera/(C.S)C-outdoor6/P1010087.JPG,char_data/4/P1010087.JPG_2.jpg,2378,480,640,41,224,265,176,234,False,6
4,26,kaist_dataset/Mixed/Digital_Camera/(C.S)C-outdoor6/P1010088.JPG,char_data/4/P1010088.JPG_4.jpg,416,480,640,16,307,323,222,248,False,6
4,31,kaist_dataset/Mixed/Digital_Camera/(C.S)C-outdoor6/P1010088.JPG,char_data/4/P1010088.JPG_5.jpg,465,480,640,15,336,351,217,248,False,6
4,32,kaist_dataset/Mixed/Digital_Camera/(C.S)C-outdoor6/P1010093.JPG,char_data/4/P1010093.JPG_2.jpg,448,480,640,14,497,511,242,274,False,6
4,21,kaist_dataset/Mixed/Digital_Camera/(C.S)C-outdoor6/P1010094.JPG,char_data/4/P1010094.JPG_2.jpg,483,480,640,23,459,482,219,240,False,6
4,33,kaist_dataset/Mixed/Digital_Camera/(C.S)C-outdoor6/P1010097.JPG,char_data/4/P1010097.JPG_4.jpg,957,480,640,29,34,63,172,205,False,6
4,20,kaist_dataset/Mixed/Digital_Camera/(C.S)C-outdoor6/P1010097.JPG,char_data/4/P1010097.JPG_5.jpg,460,480,640,23,409,432,191,211,False,6
4,43,kaist_dataset/Mixed/Digital_Camera/(C.S)C-outdoor6/P1010098.JPG,char_data/4/P1010098.JPG_2.jpg,860,480,640,20,385,405,55,98,False,6
4,22,kaist_dataset/Mixed/Digital_Camera/(C.S)C-outdoor6/P1010099.JPG,char_data/4/P1010099.JPG_4.jpg,374,480,640,17,455,472,208,230,False,6
4,21,kaist_dataset/Mixed/Digital_Camera/(C.S)C-outdoor6/P1010099.JPG,char_data/4/P1010099.JPG_5.jpg,315,480,640,15,489,504,210,231,False,6
4,32,kaist_dataset/Mixed/Digital_Camera/(C.S)C-outdoor6/P1010103.JPG,char_data/4/P1010103.JPG_2.jpg,544,480,640,17,465,482,202,234,False,6
4,31,kaist_dataset/Mixed/Digital_Camera/(C.S)C-outdoor6/P1010111.JPG,char_data/4/P1010111.JPG_5.jpg,1054,480,640,34,224,258,208,239,False,6
4,28,kaist_dataset/Mixed/Digital_Camera/(C.S)C-outdoor6/P1010114.JPG,char_data/4/P1010114.JPG_4.jpg,504,480,640,18,427,445,218,246,False,6
4,33,kaist_dataset/Mixed/Digital_Camera/(C.S)C-outdoor6/P1010114.JPG,char_data/4/P1010114.JPG_5.jpg,726,480,640,22,559,581,213,246,False,6
4,42,kaist_dataset/Mixed/Digital_Camera/(C.S)C-outdoor6/P1010120.JPG,char_data/4/P1010120.JPG_4.jpg,1176,480,640,28,303,331,193,235,False,6
4,41,kaist_dataset/Mixed/Digital_Camera/(C.S)C-outdoor6/P1010120.JPG,char_data/4/P1010120.JPG_5.jpg,1025,480,640,25,448,473,192,233,False,6
4,20,kaist_dataset/Mixed/Digital_Camera/(C.S)C-outdoor6/P1010129.JPG,char_data/4/P1010129.JPG_2.jpg,480,480,640,24,375,399,238,258,False,6
4,27,kaist_dataset/Mixed/Digital_Camera/(C.S)C-outdoor6/P1010138.JPG,char_data/4/P1010138.JPG_8.jpg,621,480,640,23,332,355,184,211,False,6
4,55,kaist_dataset/Mixed/Digital_Camera/(C.S)D-indoor1/DSC02733.JPG,char_data/4/DSC02733.JPG_4.jpg,1705,480,640,31,376,407,388,443,False,6
4,54,kaist_dataset/Mixed/Digital_Camera/(C.S)D-indoor1/DSC02733.JPG,char_data/4/DSC02733.JPG_5.jpg,1674,480,640,31,407,438,388,442,False,6
4,48,kaist_dataset/Mixed/Digital_Camera/(C.S)D-indoor1/DSC02789.JPG,char_data/4/DSC02789.JPG_2.jpg,1680,480,640,35,33,68,226,274,False,6
4,59,kaist_dataset/Mixed/Digital_Camera/(C.S)D-indoor1/DSC02791.JPG,char_data/4/DSC02791.JPG_2.jpg,2124,480,640,36,45,81,323,382,False,6
4,46,kaist_dataset/Mixed/Digital_Camera/(C.S)D-indoor1/DSC02794.JPG,char_data/4/DSC02794.JPG_2.jpg,1104,480,640,24,55,79,322,368,False,6
4,49,kaist_dataset/Mixed/Digital_Camera/(C.S)D-indoor1/DSC02796.JPG,char_data/4/DSC02796.JPG_2.jpg,1568,480,640,32,33,65,243,292,False,6
4,82,kaist_dataset/Mixed/Digital_Camera/(C.S)D-indoor1/DSC03466.JPG,char_data/4/DSC03466.JPG_2.jpg,5084,480,640,62,132,194,128,210,False,6
4,47,kaist_dataset/Mixed/Digital_Camera/(C.S)D-indoor1/DSC03986.JPG,char_data/4/DSC03986.JPG_2.jpg,846,480,640,18,128,146,162,209,False,6
4,65,kaist_dataset/Mixed/Digital_Camera/(C.S)D-indoor1/DSC03998.JPG,char_data/4/DSC03998.JPG_2.jpg,2860,480,640,44,334,378,410,475,False,6
4,109,kaist_dataset/Mixed/Digital_Camera/(C.S)D-indoor1/DSC04002.JPG,char_data/4/DSC04002.JPG_2.jpg,8393,480,640,77,51,128,346,455,False,6
4,25,kaist_dataset/Mixed/Digital_Camera/(C.S)D-indoor1/DSC04005.JPG,char_data/4/DSC04005.JPG_4.jpg,475,480,640,19,243,262,443,468,False,6
4,24,kaist_dataset/Mixed/Digital_Camera/(C.S)D-indoor1/DSC04005.JPG,char_data/4/DSC04005.JPG_5.jpg,456,480,640,19,406,425,440,464,False,6
4,41,kaist_dataset/Mixed/Digital_Camera/(C.S)E-night/DSC02569.JPG,char_data/4/DSC02569.JPG_4.jpg,779,480,640,19,273,292,410,451,False,6
4,43,kaist_dataset/Mixed/Digital_Camera/(C.S)E-night/DSC02569.JPG,char_data/4/DSC02569.JPG_5.jpg,774,480,640,18,422,440,405,448,False,6
4,58,kaist_dataset/Mixed/Digital_Camera/(C.S)E-night/DSC02574.JPG,char_data/4/DSC02574.JPG_2.jpg,2088,480,640,36,566,602,410,468,False,6
4,35,kaist_dataset/Mixed/Digital_Camera/(C.S)E-night/DSC02585.JPG,char_data/4/DSC02585.JPG_2.jpg,525,480,640,15,392,407,415,450,False,6
4,67,kaist_dataset/Mixed/Digital_Camera/(C.S)E-night/DSC02600.JPG,char_data/4/DSC02600.JPG_2.jpg,5025,480,640,75,235,310,193,260,False,6
4,36,kaist_dataset/Mixed/Digital_Camera/(C.S)E-night/DSC02647.JPG,char_data/4/DSC02647.JPG_4.jpg,972,480,640,27,329,356,272,308,False,6
4,39,kaist_dataset/Mixed/Digital_Camera/(C.S)E-night/DSC02647.JPG,char_data/4/DSC02647.JPG_5.jpg,975,480,640,25,378,403,268,307,False,6
4,36,kaist_dataset/Mixed/Digital_Camera/(C.S)E-night/DSC02673.JPG,char_data/4/DSC02673.JPG_2.jpg,684,480,640,19,348,367,301,337,False,6
4,29,kaist_dataset/Mixed/Digital_Camera/(C.S)E-night/DSC02678.JPG,char_data/4/DSC02678.JPG_8.jpg,406,480,640,14,400,414,397,426,False,6
4,33,kaist_dataset/Mixed/Digital_Camera/(C.S)E-night/DSC02678.JPG,char_data/4/DSC02678.JPG_9.jpg,429,480,640,13,420,433,392,425,False,6
4,37,kaist_dataset/Mixed/Digital_Camera/(C.S)E-night/DSC02678.JPG,char_data/4/DSC02678.JPG_10.jpg,592,480,640,16,432,448,392,429,False,6
4,35,kaist_dataset/Mixed/Digital_Camera/(C.S)E-night/DSC02678.JPG,char_data/4/DSC02678.JPG_11.jpg,420,480,640,12,449,461,392,427,False,6
4,49,kaist_dataset/Mixed/Digital_Camera/(C.S)E-night/DSC03561.JPG,char_data/4/DSC03561.JPG_2.jpg,1715,480,640,35,220,255,255,304,False,6
4,26,kaist_dataset/Mixed/Digital_Camera/(C.S)E-night/DSC03840.JPG,char_data/4/DSC03840.JPG_2.jpg,468,480,640,18,431,449,207,233,False,6
4,60,kaist_dataset/Mixed/Digital_Camera/(C.S)E-night/P1010147.JPG,char_data/4/P1010147.JPG_5.jpg,2520,480,640,42,191,233,254,314,False,6
4,80,kaist_dataset/Mixed/Digital_Camera/(C.S)E-night/P1010151.JPG,char_data/4/P1010151.JPG_8.jpg,5360,480,640,67,155,222,349,429,False,6
4,83,kaist_dataset/Mixed/Digital_Camera/(C.S)E-night/P1010151.JPG,char_data/4/P1010151.JPG_9.jpg,4980,480,640,60,432,492,347,430,False,6
4,75,kaist_dataset/Mixed/Digital_Camera/(C.S)E-night/P1010151.JPG,char_data/4/P1010151.JPG_10.jpg,4200,480,640,56,490,546,356,431,False,6
4,71,kaist_dataset/Mixed/Digital_Camera/(C.S)E-night/P1010151.JPG,char_data/4/P1010151.JPG_11.jpg,4331,480,640,61,543,604,358,429,False,6
4,75,kaist_dataset/Mixed/Digital_Camera/(C.S)E-night/P1010152.JPG,char_data/4/P1010152.JPG_4.jpg,5775,480,640,77,509,586,217,292,False,6
4,66,kaist_dataset/Mixed/Digital_Camera/(C.S)E-night/P1010152.JPG,char_data/4/P1010152.JPG_5.jpg,3432,480,640,52,194,246,228,294,False,6
4,22,kaist_dataset/Mixed/Digital_Camera/(C.S)E-night/P1010155.JPG,char_data/4/P1010155.JPG_2.jpg,264,480,640,12,439,451,287,309,False,6
4,36,kaist_dataset/Mixed/Digital_Camera/(C.S)E-night/P1010156.JPG,char_data/4/P1010156.JPG_2.jpg,756,480,640,21,299,320,242,278,False,6
4,43,kaist_dataset/Mixed/Digital_Camera/(C.S)F-others/2007-12-08-day-044.jpg,char_data/4/2007-12-08-day-044.jpg_2.jpg,1075,1200,1600,25,71,96,736,779,False,6
4,50,kaist_dataset/Mixed/Digital_Camera/(C.S)F-others/2007-12-08-day-113.jpg,char_data/4/2007-12-08-day-113.jpg_2.jpg,1150,1200,1600,23,874,897,411,461,False,6
4,49,kaist_dataset/Mixed/Digital_Camera/(C.S)F-others/2007-12-09-day-exterior-023.jpg,char_data/4/2007-12-09-day-exterior-023.jpg_2.jpg,2205,1200,1600,45,937,982,591,640,False,6
4,56,kaist_dataset/Mixed/Digital_Camera/(C.S)F-others/DSC02793.JPG,char_data/4/DSC02793.JPG_2.jpg,1568,480,640,28,59,87,350,406,False,6
4,44,kaist_dataset/Mixed/Digital_Camera/(C.S)F-others/DSC02893.JPG,char_data/4/DSC02893.JPG_2.jpg,1496,480,640,34,262,296,345,389,False,6
4,88,kaist_dataset/Mixed/Digital_Camera/(C.S)F-others/DSC03224.JPG,char_data/4/DSC03224.JPG_6.jpg,4840,480,640,55,83,138,257,345,False,6
4,80,kaist_dataset/Mixed/Digital_Camera/(C.S)F-others/DSC03224.JPG,char_data/4/DSC03224.JPG_7.jpg,4080,480,640,51,179,230,248,328,False,6
4,79,kaist_dataset/Mixed/Digital_Camera/(C.S)F-others/DSC03224.JPG,char_data/4/DSC03224.JPG_8.jpg,4187,480,640,53,324,377,217,296,False,6
4,32,kaist_dataset/Mixed/Mobile_Phone/(C.M)A-outdoor/P090908006.jpg,char_data/4/P090908006.jpg_2.jpg,480,480,640,15,373,388,368,400,False,6
4,30,kaist_dataset/Mixed/Mobile_Phone/(C.M)A-outdoor/P090912036.jpg,char_data/4/P090912036.jpg_10.jpg,420,480,640,14,212,226,192,222,False,6
4,32,kaist_dataset/Mixed/Mobile_Phone/(C.M)A-outdoor/P090912036.jpg,char_data/4/P090912036.jpg_11.jpg,448,480,640,14,239,253,190,222,False,6
4,32,kaist_dataset/Mixed/Mobile_Phone/(C.M)A-outdoor/P090912036.jpg,char_data/4/P090912036.jpg_12.jpg,576,480,640,18,355,373,192,224,False,6
4,32,kaist_dataset/Mixed/Mobile_Phone/(C.M)A-outdoor/P090912036.jpg,char_data/4/P090912036.jpg_13.jpg,512,480,640,16,411,427,191,223,False,6
4,32,kaist_dataset/Mixed/Mobile_Phone/(C.M)A-outdoor/P090912036.jpg,char_data/4/P090912036.jpg_14.jpg,448,480,640,14,442,456,190,222,False,6
4,38,kaist_dataset/Mixed/Mobile_Phone/(C.M)A-outdoor/P090912047.jpg,char_data/4/P090912047.jpg_2.jpg,836,480,640,22,376,398,277,315,False,6
4,40,kaist_dataset/Mixed/Mobile_Phone/(C.M)A-outdoor/P090912066.jpg,char_data/4/P090912066.jpg_2.jpg,920,480,640,23,431,454,217,257,False,6
4,58,kaist_dataset/Mixed/Mobile_Phone/(C.M)B-indoor/P090831007.jpg,char_data/4/P090831007.jpg_16.jpg,2726,480,640,47,160,207,129,187,False,6
4,64,kaist_dataset/Mixed/Mobile_Phone/(C.M)B-indoor/P090831007.jpg,char_data/4/P090831007.jpg_17.jpg,2944,480,640,46,349,395,132,196,False,6
4,61,kaist_dataset/Mixed/Mobile_Phone/(C.M)B-indoor/P090831007.jpg,char_data/4/P090831007.jpg_18.jpg,2623,480,640,43,396,439,130,191,False,6
4,63,kaist_dataset/Mixed/Mobile_Phone/(C.M)B-indoor/P090831007.jpg,char_data/4/P090831007.jpg_19.jpg,2772,480,640,44,166,210,199,262,False,6
4,65,kaist_dataset/Mixed/Mobile_Phone/(C.M)B-indoor/P090831007.jpg,char_data/4/P090831007.jpg_20.jpg,2925,480,640,45,355,400,205,270,False,6
4,61,kaist_dataset/Mixed/Mobile_Phone/(C.M)B-indoor/P090831007.jpg,char_data/4/P090831007.jpg_21.jpg,2501,480,640,41,165,206,272,333,False,6
4,64,kaist_dataset/Mixed/Mobile_Phone/(C.M)B-indoor/P090831007.jpg,char_data/4/P090831007.jpg_22.jpg,2816,480,640,44,351,395,273,337,False,6
4,66,kaist_dataset/Mixed/Mobile_Phone/(C.M)B-indoor/P090831007.jpg,char_data/4/P090831007.jpg_23.jpg,2772,480,640,42,394,436,273,339,False,6
4,44,kaist_dataset/Mixed/Mobile_Phone/(C.M)C-bookCover/P090902016.jpg,char_data/4/P090902016.jpg_2.jpg,1100,480,640,25,58,83,200,244,False,6
4,95,kaist_dataset/Mixed/Mobile_Phone/(C.M)C-bookCover/P090902019.jpg,char_data/4/P090902019.jpg_4.jpg,3705,480,640,39,86,125,72,167,False,6
4,62,kaist_dataset/Mixed/Mobile_Phone/(C.M)C-bookCover/P090902019.jpg,char_data/4/P090902019.jpg_5.jpg,1984,480,640,32,41,73,277,339,False,6
e,68,kaist_dataset/English/Digital_Camera/(E.S)A-shadow/DSC02857.JPG,char_data/e/DSC02857.JPG_2.jpg,3128,480,640,46,539,585,209,277,True,34
e,81,kaist_dataset/English/Digital_Camera/(E.S)A-shadow/DSC02858.JPG,char_data/e/DSC02858.JPG_2.jpg,4131,480,640,51,519,570,318,399,True,34
e,35,kaist_dataset/English/Digital_Camera/(E.S)A-shadow/DSC03075.JPG,char_data/e/DSC03075.JPG_4.jpg,1050,480,640,30,363,393,362,397,True,34
e,39,kaist_dataset/English/Digital_Camera/(E.S)A-shadow/DSC03075.JPG,char_data/e/DSC03075.JPG_5.jpg,1326,480,640,34,494,528,356,395,True,34
e,85,kaist_dataset/English/Digital_Camera/(E.S)A-shadow/DSC03077.JPG,char_data/e/DSC03077.JPG_4.jpg,6885,480,640,81,271,352,351,436,True,34
e,83,kaist_dataset/English/Digital_Camera/(E.S)A-shadow/DSC03077.JPG,char_data/e/DSC03077.JPG_5.jpg,6640,480,640,80,498,578,353,436,True,34
e,54,kaist_dataset/English/Digital_Camera/(E.S)A-shadow/DSC03079.JPG,char_data/e/DSC03079.JPG_2.jpg,1350,480,640,25,231,256,338,392,True,34
e,42,kaist_dataset/English/Digital_Camera/(E.S)A-shadow/DSC03082.JPG,char_data/e/DSC03082.JPG_2.jpg,756,480,640,18,169,187,387,429,True,34
e,61,kaist_dataset/English/Digital_Camera/(E.S)A-shadow/DSC03084.JPG,char_data/e/DSC03084.JPG_7.jpg,1647,480,640,27,422,449,369,430,True,34
e,62,kaist_dataset/English/Digital_Camera/(E.S)A-shadow/DSC03084.JPG,char_data/e/DSC03084.JPG_8.jpg,1860,480,640,30,549,579,369,431,True,34
e,51,kaist_dataset/English/Digital_Camera/(E.S)A-shadow/IMG_2647.JPG,char_data/e/IMG_2647.JPG_6.jpg,2346,480,640,46,292,338,261,312,True,34
e,55,kaist_dataset/English/Digital_Camera/(E.S)A-shadow/IMG_2647.JPG,char_data/e/IMG_2647.JPG_7.jpg,2530,480,640,46,231,277,335,390,True,34
e,50,kaist_dataset/English/Digital_Camera/(E.S)A-shadow/IMG_2647.JPG,char_data/e/IMG_2647.JPG_8.jpg,2150,480,640,43,242,285,111,161,True,34
e,46,kaist_dataset/English/Digital_Camera/(E.S)A-shadow/P090912074.jpg,char_data/e/P090912074.jpg_4.jpg,1518,480,640,33,459,492,85,131,True,34
e,48,kaist_dataset/English/Digital_Camera/(E.S)A-shadow/P090912074.jpg,char_data/e/P090912074.jpg_5.jpg,1392,480,640,29,521,550,85,133,True,34
e,81,kaist_dataset/English/Digital_Camera/(E.S)B-light/DSC02587.JPG,char_data/e/DSC02587.JPG_4.jpg,4860,480,640,60,200,260,198,279,True,34
e,85,kaist_dataset/English/Digital_Camera/(E.S)B-light/DSC02587.JPG,char_data/e/DSC02587.JPG_5.jpg,5950,480,640,70,467,537,338,423,True,34
e,85,kaist_dataset/English/Digital_Camera/(E.S)B-light/DSC02980.JPG,char_data/e/DSC02980.JPG_2.jpg,5865,480,640,69,513,582,182,267,True,34
e,28,kaist_dataset/English/Digital_Camera/(E.S)B-light/크기변환_%B0%A3%C6%C74_fabdent.jpg,char_data/e/크기변환_%B0%A3%C6%C74_fabdent.jpg_2.jpg,392,480,640,14,242,256,261,289,True,34
e,43,kaist_dataset/English/Digital_Camera/(E.S)C-outdoor1/001.jpg,char_data/e/001.jpg_11.jpg,1763,257,470,41,88,129,113,156,True,34
e,63,kaist_dataset/English/Digital_Camera/(E.S)C-outdoor1/001.jpg,char_data/e/001.jpg_12.jpg,2835,257,470,45,310,355,91,154,True,34
e,57,kaist_dataset/English/Digital_Camera/(E.S)C-outdoor1/027.jpg,char_data/e/027.jpg_6.jpg,2907,300,472,51,146,197,123,180,True,34
e,56,kaist_dataset/English/Digital_Camera/(E.S)C-outdoor1/027.jpg,char_data/e/027.jpg_7.jpg,3360,300,472,60,400,460,109,165,True,34
e,31,kaist_dataset/English/Digital_Camera/(E.S)C-outdoor1/031.JPG,char_data/e/031.JPG_11.jpg,1364,480,640,44,302,346,435,466,True,34
e,60,kaist_dataset/English/Digital_Camera/(E.S)C-outdoor1/033.jpg,char_data/e/033.jpg_4.jpg,2820,232,354,47,69,116,58,118,True,34
e,54,kaist_dataset/English/Digital_Camera/(E.S)C-outdoor1/033.jpg,char_data/e/033.jpg_5.jpg,2538,232,354,47,181,228,62,116,True,34
e,27,kaist_dataset/English/Digital_Camera/(E.S)C-outdoor1/036.jpg,char_data/e/036.jpg_4.jpg,864,197,354,32,150,182,80,107,True,34
e,33,kaist_dataset/English/Digital_Camera/(E.S)C-outdoor1/036.jpg,char_data/e/036.jpg_5.jpg,1122,197,354,34,241,275,79,112,True,34
e,40,kaist_dataset/English/Digital_Camera/(E.S)C-outdoor1/055.JPG,char_data/e/055.JPG_2.jpg,1600,480,640,40,103,143,207,247,True,34
e,23,kaist_dataset/English/Digital_Camera/(E.S)C-outdoor1/056.JPG,char_data/e/056.JPG_2.jpg,184,480,640,8,292,300,241,264,True,34
e,53,kaist_dataset/English/Digital_Camera/(E.S)C-outdoor1/076.JPG,char_data/e/076.JPG_4.jpg,2279,480,640,43,423,466,212,265,True,34
e,21,kaist_dataset/English/Digital_Camera/(E.S)C-outdoor1/076.JPG,char_data/e/076.JPG_5.jpg,210,480,640,10,599,609,318,339,True,34
e,33,kaist_dataset/English/Digital_Camera/(E.S)C-outdoor1/077.JPG,char_data/e/077.JPG_10.jpg,1155,480,640,35,290,325,209,242,True,34
e,34,kaist_dataset/English/Digital_Camera/(E.S)C-outdoor1/077.JPG,char_data/e/077.JPG_11.jpg,1224,480,640,36,440,476,207,241,True,34
e,35,kaist_dataset/English/Digital_Camera/(E.S)C-outdoor1/077.JPG,char_data/e/077.JPG_12.jpg,1365,480,640,39,475,514,206,241,True,34
e,58,kaist_dataset/English/Digital_Camera/(E.S)C-outdoor1/080116-0064.jpg,char_data/e/080116-0064.jpg_2.jpg,1914,600,800,33,356,389,252,310,True,34
e,38,kaist_dataset/English/Digital_Camera/(E.S)C-outdoor1/080116-0066.jpg,char_data/e/080116-0066.jpg_2.jpg,1368,600,800,36,442,478,360,398,True,34
e,42,kaist_dataset/English/Digital_Camera/(E.S)C-outdoor1/080119-0012.jpg,char_data/e/080119-0012.jpg_2.jpg,2184,1200,1600,52,893,945,572,614,True,34
e,197,kaist_dataset/English/Digital_Camera/(E.S)C-outdoor1/080119-0035.jpg,char_data/e/080119-0035.jpg_5.jpg,24034,1200,1600,122,1143,1265,770,967,True,34
e,194,kaist_dataset/English/Digital_Camera/(E.S)C-outdoor1/080119-0036.jpg,char_data/e/080119-0036.jpg_5.jpg,19400,1200,1600,100,1363,1463,367,561,True,34
e,58,kaist_dataset/English/Digital_Camera/(E.S)C-outdoor1/107.jpg,char_data/e/107.jpg_2.jpg,3306,480,640,57,369,426,258,316,True,34
e,44,kaist_dataset/English/Digital_Camera/(E.S)C-outdoor1/109.jpg,char_data/e/109.jpg_2.jpg,1672,480,640,38,265,303,189,233,True,34
e,69,kaist_dataset/English/Digital_Camera/(E.S)C-outdoor1/129.JPG,char_data/e/129.JPG_4.jpg,3036,480,640,44,347,391,224,293,True,34
e,80,kaist_dataset/English/Digital_Camera/(E.S)C-outdoor1/129.JPG,char_data/e/129.JPG_5.jpg,4000,480,640,50,410,460,213,293,True,34
e,38,kaist_dataset/English/Digital_Camera/(E.S)C-outdoor1/137.JPG,char_data/e/137.JPG_2.jpg,684,480,640,18,254,272,262,300,True,34
e,53,kaist_dataset/English/Digital_Camera/(E.S)C-outdoor1/138.JPG,char_data/e/138.JPG_2.jpg,1643,480,640,31,279,310,255,308,True,34
e,72,kaist_dataset/English/Digital_Camera/(E.S)C-outdoor1/2007-12-08-day-111.jpg,char_data/e/2007-12-08-day-111.jpg_4.jpg,6408,1200,1600,89,593,682,518,590,True,34
e,61,kaist_dataset/English/Digital_Camera/(E.S)C-outdoor1/2007-12-08-day-111.jpg,char_data/e/2007-12-08-day-111.jpg_5.jpg,4575,1200,1600,75,727,802,522,583,True,34
e,31,kaist_dataset/English/Digital_Camera/(E.S)C-outdoor1/2007-12-09-day-exterior-063.jpg,char_data/e/2007-12-09-day-exterior-063.jpg_6.jpg,651,1200,1600,21,223,244,552,583,True,34
e,30,kaist_dataset/English/Digital_Camera/(E.S)C-outdoor1/2007-12-09-day-exterior-063.jpg,char_data/e/2007-12-09-day-exterior-063.jpg_7.jpg,840,1200,1600,28,245,273,555,585,True,34
e,39,kaist_dataset/English/Digital_Camera/(E.S)C-outdoor1/DSC02355.JPG,char_data/e/DSC02355.JPG_4.jpg,819,480,640,21,216,237,306,345,True,34
e,34,kaist_dataset/English/Digital_Camera/(E.S)C-outdoor1/DSC02355.JPG,char_data/e/DSC02355.JPG_5.jpg,578,480,640,17,277,294,308,342,True,34
e,36,kaist_dataset/English/Digital_Camera/(E.S)C-outdoor1/DSC02356.JPG,char_data/e/DSC02356.JPG_19.jpg,828,480,640,23,111,134,310,346,True,34
e,31,kaist_dataset/English/Digital_Camera/(E.S)C-outdoor1/DSC02356.JPG,char_data/e/DSC02356.JPG_20.jpg,558,480,640,18,216,234,312,343,True,34
e,34,kaist_dataset/English/Digital_Camera/(E.S)C-outdoor1/DSC02356.JPG,char_data/e/DSC02356.JPG_21.jpg,476,480,640,14,453,467,314,348,True,34
e,34,kaist_dataset/English/Digital_Camera/(E.S)C-outdoor1/DSC02356.JPG,char_data/e/DSC02356.JPG_22.jpg,782,480,640,23,467,490,312,346,True,34
e,34,kaist_dataset/English/Digital_Camera/(E.S)C-outdoor1/DSC02356.JPG,char_data/e/DSC02356.JPG_23.jpg,612,480,640,18,537,555,313,347,True,34
e,82,kaist_dataset/English/Digital_Camera/(E.S)C-outdoor1/DSC02387.JPG,char_data/e/DSC02387.JPG_4.jpg,5658,480,640,69,308,377,210,292,True,34
e,23,kaist_dataset/English/Digital_Camera/(E.S)C-outdoor1/DSC02387.JPG,char_data/e/DSC02387.JPG_5.jpg,460,480,640,20,374,394,303,326,True,34
e,23,kaist_dataset/English/Digital_Camera/(E.S)C-outdoor1/DSC02417.JPG,char_data/e/DSC02417.JPG_2.jpg,460,480,640,20,501,521,186,209,True,34
e,27,kaist_dataset/English/Digital_Camera/(E.S)C-outdoor1/DSC02427.JPG,char_data/e/DSC02427.JPG_21.jpg,567,480,640,21,406,427,374,401,True,34
e,25,kaist_dataset/English/Digital_Camera/(E.S)C-outdoor1/DSC02427.JPG,char_data/e/DSC02427.JPG_22.jpg,525,480,640,21,589,610,371,396,True,34
e,29,kaist_dataset/English/Digital_Camera/(E.S)C-outdoor1/DSC02427.JPG,char_data/e/DSC02427.JPG_23.jpg,667,480,640,23,610,633,371,400,True,34
e,45,kaist_dataset/English/Digital_Camera/(E.S)C-outdoor1/DSC02442.JPG,char_data/e/DSC02442.JPG_4.jpg,1485,480,640,33,220,253,176,221,True,34
e,42,kaist_dataset/English/Digital_Camera/(E.S)C-outdoor1/DSC02442.JPG,char_data/e/DSC02442.JPG_5.jpg,1470,480,640,35,276,311,178,220,True,34
e,39,kaist_dataset/English/Digital_Camera/(E.S)C-outdoor1/DSC02480.JPG,char_data/e/DSC02480.JPG_4.jpg,1365,480,640,35,301,336,127,166,True,34
e,42,kaist_dataset/English/Digital_Camera/(E.S)C-outdoor1/DSC02480.JPG,char_data/e/DSC02480.JPG_5.jpg,1050,480,640,25,129,154,415,457,True,34
e,62,kaist_dataset/English/Digital_Camera/(E.S)C-outdoor1/DSC02491.JPG,char_data/e/DSC02491.JPG_4.jpg,2666,480,640,43,140,183,338,400,True,34
e,67,kaist_dataset/English/Digital_Camera/(E.S)C-outdoor1/DSC02491.JPG,char_data/e/DSC02491.JPG_5.jpg,3417,480,640,51,208,259,144,211,True,34
e,66,kaist_dataset/English/Digital_Camera/(E.S)C-outdoor1/DSC02524.JPG,char_data/e/DSC02524.JPG_4.jpg,3432,480,640,52,530,582,335,401,True,34
e,76,kaist_dataset/English/Digital_Camera/(E.S)C-outdoor1/DSC02524.JPG,char_data/e/DSC02524.JPG_5.jpg,4104,480,640,54,579,633,330,406,True,34
e,38,kaist_dataset/English/Digital_Camera/(E.S)C-outdoor1/DSC02559.JPG,char_data/e/DSC02559.JPG_4.jpg,836,480,640,22,217,239,127,165,True,34
e,84,kaist_dataset/English/Digital_Camera/(E.S)C-outdoor1/DSC02914.JPG,char_data/e/DSC02914.JPG_2.jpg,7980,480,640,95,521,616,196,280,True,34
e,36,kaist_dataset/English/Digital_Camera/(E.S)C-outdoor1/DSC02918.JPG,char_data/e/DSC02918.JPG_4.jpg,972,480,640,27,130,157,236,272,True,34
e,32,kaist_dataset/English/Digital_Camera/(E.S)C-outdoor1/DSC02918.JPG,char_data/e/DSC02918.JPG_5.jpg,832,480,640,26,430,456,231,263,True,34
e,78,kaist_dataset/English/Digital_Camera/(E.S)C-outdoor2/DSC02990.JPG,char_data/e/DSC02990.JPG_4.jpg,4758,480,640,61,266,327,170,248,True,34
e,73,kaist_dataset/English/Digital_Camera/(E.S)C-outdoor2/DSC02990.JPG,char_data/e/DSC02990.JPG_5.jpg,4599,480,640,63,561,624,196,269,True,34
e,50,kaist_dataset/English/Digital_Camera/(E.S)C-outdoor2/DSC03000.JPG,char_data/e/DSC03000.JPG_4.jpg,1500,480,640,30,381,411,288,338,True,34
e,49,kaist_dataset/English/Digital_Camera/(E.S)C-outdoor2/DSC03000.JPG,char_data/e/DSC03000.JPG_5.jpg,1862,480,640,38,412,450,292,341,True,34
e,59,kaist_dataset/English/Digital_Camera/(E.S)C-outdoor2/DSC03001.JPG,char_data/e/DSC03001.JPG_4.jpg,2419,480,640,41,565,606,178,237,True,34
e,53,kaist_dataset/English/Digital_Camera/(E.S)C-outdoor2/DSC03001.JPG,char_data/e/DSC03001.JPG_5.jpg,1643,480,640,31,607,638,180,233,True,34
e,33,kaist_dataset/English/Digital_Camera/(E.S)C-outdoor2/DSC03053.JPG,char_data/e/DSC03053.JPG_2.jpg,792,480,640,24,264,288,139,172,True,34
e,38,kaist_dataset/English/Digital_Camera/(E.S)C-outdoor2/DSC03160.JPG,char_data/e/DSC03160.JPG_6.jpg,874,480,640,23,170,193,155,193,True,34
e,30,kaist_dataset/English/Digital_Camera/(E.S)C-outdoor2/DSC03160.JPG,char_data/e/DSC03160.JPG_7.jpg,660,480,640,22,194,216,155,185,True,34
e,31,kaist_dataset/English/Digital_Camera/(E.S)C-outdoor2/DSC03160.JPG,char_data/e/DSC03160.JPG_8.jpg,651,480,640,21,342,363,156,187,True,34
e,42,kaist_dataset/English/Digital_Camera/(E.S)C-outdoor2/DSC03167.JPG,char_data/e/DSC03167.JPG_2.jpg,1554,480,640,37,264,301,306,348,True,34
e,42,kaist_dataset/English/Digital_Camera/(E.S)C-outdoor2/DSC03169.JPG,char_data/e/DSC03169.JPG_2.jpg,1554,480,640,37,212,249,295,337,True,34
e,55,kaist_dataset/English/Digital_Camera/(E.S)C-outdoor2/DSC03192.JPG,char_data/e/DSC03192.JPG_2.jpg,2420,480,640,44,383,427,163,218,True,34
e,66,kaist_dataset/English/Digital_Camera/(E.S)C-outdoor2/DSC03200.JPG,char_data/e/DSC03200.JPG_2.jpg,3300,480,640,50,363,413,246,312,True,34
e,44,kaist_dataset/English/Digital_Camera/(E.S)C-outdoor2/DSC03201.JPG,char_data/e/DSC03201.JPG_4.jpg,1408,480,640,32,218,250,83,127,True,34
e,44,kaist_dataset/English/Digital_Camera/(E.S)C-outdoor2/DSC03201.JPG,char_data/e/DSC03201.JPG_5.jpg,1276,480,640,29,334,363,147,191,True,34
e,38,kaist_dataset/English/Digital_Camera/(E.S)C-outdoor2/DSC03203.JPG,char_data/e/DSC03203.JPG_10.jpg,1216,480,640,32,180,212,379,417,True,34
e,39,kaist_dataset/English/Digital_Camera/(E.S)C-outdoor2/DSC03203.JPG,char_data/e/DSC03203.JPG_12.jpg,1248,480,640,32,167,199,431,470,True,34
e,42,kaist_dataset/English/Digital_Camera/(E.S)C-outdoor2/DSC03203.JPG,char_data/e/DSC03203.JPG_13.jpg,1470,480,640,35,197,232,429,471,True,34
e,37,kaist_dataset/English/Digital_Camera/(E.S)C-outdoor2/DSC03203.JPG,char_data/e/DSC03203.JPG_14.jpg,1332,480,640,36,257,293,431,468,True,34
e,39,kaist_dataset/English/Digital_Camera/(E.S)C-outdoor2/DSC03225.JPG,char_data/e/DSC03225.JPG_5.jpg,975,480,640,25,528,553,87,126,True,34
e,46,kaist_dataset/English/Digital_Camera/(E.S)C-outdoor2/DSC03262.JPG,char_data/e/DSC03262.JPG_5.jpg,1702,480,640,37,345,382,148,194,True,34
e,53,kaist_dataset/English/Digital_Camera/(E.S)C-outdoor2/DSC03277.JPG,char_data/e/DSC03277.JPG_6.jpg,2438,480,640,46,170,216,189,242,True,34
e,53,kaist_dataset/English/Digital_Camera/(E.S)C-outdoor2/DSC03277.JPG,char_data/e/DSC03277.JPG_7.jpg,2385,480,640,45,216,261,194,247,True,34
e,47,kaist_dataset/English/Digital_Camera/(E.S)C-outdoor2/DSC03277.JPG,char_data/e/DSC03277.JPG_8.jpg,2115,480,640,45,558,603,205,252,True,34
e,76,kaist_dataset/English/Digital_Camera/(E.S)C-outdoor2/DSC03281.JPG,char_data/e/DSC03281.JPG_5.jpg,3724,480,640,49,414,463,215,291,True,34
e,48,kaist_dataset/English/Digital_Camera/(E.S)C-outdoor2/DSC03290.JPG,char_data/e/DSC03290.JPG_2.jpg,1392,480,640,29,335,364,203,251,True,34
e,37,kaist_dataset/English/Digital_Camera/(E.S)C-outdoor2/DSC03294.JPG,char_data/e/DSC03294.JPG_8.jpg,925,480,640,25,441,466,313,350,True,34
e,48,kaist_dataset/English/Digital_Camera/(E.S)C-outdoor2/DSC03297.JPG,char_data/e/DSC03297.JPG_8.jpg,1632,480,640,34,495,529,259,307,True,34
e,100,kaist_dataset/English/Digital_Camera/(E.S)C-outdoor2/DSC03300.JPG,char_data/e/DSC03300.JPG_2.jpg,8500,480,640,85,397,482,147,247,True,34
e,36,kaist_dataset/English/Digital_Camera/(E.S)C-outdoor2/DSC03307.JPG,char_data/e/DSC03307.JPG_2.jpg,648,480,640,18,282,300,172,208,True,34
e,125,kaist_dataset/English/Digital_Camera/(E.S)C-outdoor2/DSC03406.JPG,char_data/e/DSC03406.JPG_2.jpg,13625,480,640,109,334,443,46,171,True,34
e,78,kaist_dataset/English/Digital_Camera/(E.S)C-outdoor2/DSC03408.JPG,char_data/e/DSC03408.JPG_4.jpg,4134,480,640,53,286,339,342,420,True,34
e,73,kaist_dataset/English/Digital_Camera/(E.S)C-outdoor2/DSC03408.JPG,char_data/e/DSC03408.JPG_5.jpg,4015,480,640,55,369,424,346,419,True,34
e,63,kaist_dataset/English/Digital_Camera/(E.S)C-outdoor2/DSC03436.JPG,char_data/e/DSC03436.JPG_2.jpg,3339,480,640,53,275,328,44,107,True,34
e,50,kaist_dataset/English/Digital_Camera/(E.S)C-outdoor2/DSC03440.JPG,char_data/e/DSC03440.JPG_2.jpg,1950,480,640,39,462,501,34,84,True,34
e,103,kaist_dataset/English/Digital_Camera/(E.S)C-outdoor2/DSC03663.JPG,char_data/e/DSC03663.JPG_4.jpg,7519,480,640,73,321,394,177,280,True,34
e,104,kaist_dataset/English/Digital_Camera/(E.S)C-outdoor2/DSC03663.JPG,char_data/e/DSC03663.JPG_5.jpg,8216,480,640,79,453,532,179,283,True,34
e,32,kaist_dataset/English/Digital_Camera/(E.S)C-outdoor2/DSC03664.JPG,char_data/e/DSC03664.JPG_6.jpg,896,480,640,28,244,272,35,67,True,34
e,36,kaist_dataset/English/Digital_Camera/(E.S)C-outdoor2/DSC03664.JPG,char_data/e/DSC03664.JPG_7.jpg,972,480,640,27,404,431,30,66,True,34
e,40,kaist_dataset/English/Digital_Camera/(E.S)C-outdoor2/DSC03664.JPG,char_data/e/DSC03664.JPG_8.jpg,1120,480,640,28,432,460,29,69,True,34
e,47,kaist_dataset/English/Digital_Camera/(E.S)C-outdoor2/DSC03765.JPG,char_data/e/DSC03765.JPG_2.jpg,1504,480,640,32,382,414,93,140,True,34
e,100,kaist_dataset/English/Digital_Camera/(E.S)C-outdoor2/DSC03786.JPG,char_data/e/DSC03786.JPG_6.jpg,9700,480,640,97,471,568,334,434,True,34
e,90,kaist_dataset/English/Digital_Camera/(E.S)C-outdoor2/DSC03786.JPG,char_data/e/DSC03786.JPG_7.jpg,7560,480,640,84,428,512,63,153,True,34
e,33,kaist_dataset/English/Digital_Camera/(E.S)C-outdoor2/DSC03865.JPG,char_data/e/DSC03865.JPG_4.jpg,858,480,640,26,50,76,102,135,True,34
e,40,kaist_dataset/English/Digital_Camera/(E.S)C-outdoor2/DSC03865.JPG,char_data/e/DSC03865.JPG_5.jpg,960,480,640,24,98,122,55,95,True,34
e,46,kaist_dataset/English/Digital_Camera/(E.S)C-outdoor2/DSC04035.JPG,char_data/e/DSC04035.JPG_2.jpg,1840,480,640,40,579,619,204,250,True,34
e,53,kaist_dataset/English/Digital_Camera/(E.S)C-outdoor2/DSC04047.JPG,char_data/e/DSC04047.JPG_6.jpg,2756,480,640,52,140,192,233,286,True,34
e,50,kaist_dataset/English/Digital_Camera/(E.S)C-outdoor2/DSC04047.JPG,char_data/e/DSC04047.JPG_7.jpg,2450,480,640,49,193,242,234,284,True,34
e,59,kaist_dataset/English/Digital_Camera/(E.S)C-outdoor2/DSC04047.JPG,char_data/e/DSC04047.JPG_8.jpg,3245,480,640,55,534,589,236,295,True,34
e,52,kaist_dataset/English/Digital_Camera/(E.S)C-outdoor2/DSC04066.JPG,char_data/e/DSC04066.JPG_4.jpg,1612,480,640,31,290,321,347,399,True,34
e,53,kaist_dataset/English/Digital_Camera/(E.S)C-outdoor2/DSC04066.JPG,char_data/e/DSC04066.JPG_5.jpg,1696,480,640,32,352,384,343,396,True,34
e,35,kaist_dataset/English/Digital_Camera/(E.S)C-outdoor2/DSC04079.JPG,char_data/e/DSC04079.JPG_16.jpg,875,480,640,25,190,215,159,194,True,34
e,33,kaist_dataset/English/Digital_Camera/(E.S)C-outdoor2/DSC04079.JPG,char_data/e/DSC04079.JPG_17.jpg,924,480,640,28,66,94,202,235,True,34
e,41,kaist_dataset/English/Digital_Camera/(E.S)C-outdoor2/DSC04079.JPG,char_data/e/DSC04079.JPG_18.jpg,1025,480,640,25,118,143,198,239,True,34
e,36,kaist_dataset/English/Digital_Camera/(E.S)C-outdoor2/DSC04079.JPG,char_data/e/DSC04079.JPG_19.jpg,936,480,640,26,212,238,199,235,True,34
e,36,kaist_dataset/English/Digital_Camera/(E.S)C-outdoor2/DSC04079.JPG,char_data/e/DSC04079.JPG_20.jpg,864,480,640,24,267,291,200,236,True,34
e,61,kaist_dataset/English/Digital_Camera/(E.S)C-outdoor2/DSC04160.JPG,char_data/e/DSC04160.JPG_2.jpg,2989,480,640,49,157,206,276,337,True,34
e,55,kaist_dataset/English/Digital_Camera/(E.S)C-outdoor2/DSC04251.JPG,char_data/e/DSC04251.JPG_2.jpg,2255,480,640,41,198,239,80,135,True,34
e,93,kaist_dataset/English/Digital_Camera/(E.S)C-outdoor2/DSC04430.JPG,char_data/e/DSC04430.JPG_4.jpg,8742,480,640,94,167,261,300,393,True,34
e,98,kaist_dataset/English/Digital_Camera/(E.S)C-outdoor2/DSC04430.JPG,char_data/e/DSC04430.JPG_5.jpg,9310,480,640,95,456,551,305,403,True,34
e,125,kaist_dataset/English/Digital_Camera/(E.S)C-outdoor2/DSC04431.JPG,char_data/e/DSC04431.JPG_8.jpg,12125,480,640,97,278,375,115,240,True,34
e,122,kaist_dataset/English/Digital_Camera/(E.S)C-outdoor2/DSC04431.JPG,char_data/e/DSC04431.JPG_9.jpg,11468,480,640,94,371,465,115,237,True,34
e,105,kaist_dataset/English/Digital_Camera/(E.S)C-outdoor2/DSC04431.JPG,char_data/e/DSC04431.JPG_10.jpg,10920,480,640,104,184,288,288,393,True,34
e,116,kaist_dataset/English/Digital_Camera/(E.S)C-outdoor2/DSC04431.JPG,char_data/e/DSC04431.JPG_11.jpg,12296,480,640,106,466,572,281,397,True,34
e,126,kaist_dataset/English/Digital_Camera/(E.S)C-outdoor2/DSC04433.JPG,char_data/e/DSC04433.JPG_2.jpg,13482,480,640,107,448,555,143,269,True,34
e,24,kaist_dataset/English/Digital_Camera/(E.S)C-outdoor2/DSC04437.JPG,char_data/e/DSC04437.JPG_10.jpg,312,480,640,13,268,281,80,104,True,34
e,21,kaist_dataset/English/Digital_Camera/(E.S)C-outdoor2/DSC04437.JPG,char_data/e/DSC04437.JPG_11.jpg,252,480,640,12,328,340,82,103,True,34
e,21,kaist_dataset/English/Digital_Camera/(E.S)C-outdoor2/DSC04437.JPG,char_data/e/DSC04437.JPG_12.jpg,231,480,640,11,354,365,82,103,True,34
e,26,kaist_dataset/English/Digital_Camera/(E.S)C-outdoor2/DSC04437.JPG,char_data/e/DSC04437.JPG_13.jpg,364,480,640,14,394,408,80,106,True,34
e,21,kaist_dataset/English/Digital_Camera/(E.S)C-outdoor2/DSC04437.JPG,char_data/e/DSC04437.JPG_14.jpg,210,480,640,10,424,434,83,104,True,34
e,119,kaist_dataset/English/Digital_Camera/(E.S)C-outdoor2/DSC04458.JPG,char_data/e/DSC04458.JPG_4.jpg,10948,480,640,92,314,406,299,418,True,34
e,120,kaist_dataset/English/Digital_Camera/(E.S)C-outdoor2/DSC04458.JPG,char_data/e/DSC04458.JPG_5.jpg,10800,480,640,90,182,272,142,262,True,34
e,77,kaist_dataset/English/Digital_Camera/(E.S)C-outdoor2/IMG_2618.JPG,char_data/e/IMG_2618.JPG_4.jpg,3542,279,640,46,49,95,183,260,True,34
e,81,kaist_dataset/English/Digital_Camera/(E.S)C-outdoor2/IMG_2618.JPG,char_data/e/IMG_2618.JPG_5.jpg,2187,279,640,27,560,587,183,264,True,34
e,43,kaist_dataset/English/Digital_Camera/(E.S)C-outdoor3/DSC03038.JPG,char_data/e/DSC03038.JPG_4.jpg,989,480,640,23,193,216,327,370,True,34
e,33,kaist_dataset/English/Digital_Camera/(E.S)C-outdoor3/DSC03038.JPG,char_data/e/DSC03038.JPG_5.jpg,990,480,640,30,326,356,318,351,True,34
e,62,kaist_dataset/English/Digital_Camera/(E.S)C-outdoor3/P1010064.JPG,char_data/e/P1010064.JPG_8.jpg,2666,480,640,43,436,479,331,393,True,34
e,23,kaist_dataset/English/Digital_Camera/(E.S)C-outdoor3/P1010123.JPG,char_data/e/P1010123.JPG_8.jpg,207,480,640,9,532,541,72,95,True,34
e,24,kaist_dataset/English/Digital_Camera/(E.S)C-outdoor3/P1010123.JPG,char_data/e/P1010123.JPG_9.jpg,312,480,640,13,541,554,104,128,True,34
e,19,kaist_dataset/English/Digital_Camera/(E.S)C-outdoor3/P1010123.JPG,char_data/e/P1010123.JPG_10.jpg,266,480,640,14,35,49,80,99,True,34
e,23,kaist_dataset/English/Digital_Camera/(E.S)C-outdoor3/P1010123.JPG,char_data/e/P1010123.JPG_11.jpg,322,480,640,14,40,54,112,135,True,34
e,29,kaist_dataset/English/Digital_Camera/(E.S)D-indoor/080119-0009.jpg,char_data/e/080119-0009.jpg_16.jpg,1073,1200,1600,37,791,828,688,717,True,34
e,29,kaist_dataset/English/Digital_Camera/(E.S)D-indoor/080119-0009.jpg,char_data/e/080119-0009.jpg_17.jpg,1015,1200,1600,35,970,1005,699,728,True,34
e,29,kaist_dataset/English/Digital_Camera/(E.S)D-indoor/080119-0009.jpg,char_data/e/080119-0009.jpg_18.jpg,406,1200,1600,14,678,692,1050,1079,True,34
e,36,kaist_dataset/English/Digital_Camera/(E.S)D-indoor/080119-0009.jpg,char_data/e/080119-0009.jpg_19.jpg,648,1200,1600,18,647,665,1082,1118,True,34
e,33,kaist_dataset/English/Digital_Camera/(E.S)D-indoor/080119-0009.jpg,char_data/e/080119-0009.jpg_20.jpg,660,1200,1600,20,770,790,1117,1150,True,34
e,34,kaist_dataset/English/Digital_Camera/(E.S)D-indoor/080119-0009.jpg,char_data/e/080119-0009.jpg_21.jpg,510,1200,1600,15,746,761,997,1031,True,34
e,40,kaist_dataset/English/Digital_Camera/(E.S)D-indoor/080119-0009.jpg,char_data/e/080119-0009.jpg_22.jpg,680,1200,1600,17,802,819,1004,1044,True,34
e,39,kaist_dataset/English/Digital_Camera/(E.S)D-indoor/080119-0009.jpg,char_data/e/080119-0009.jpg_23.jpg,780,1200,1600,20,851,871,1012,1051,True,34
e,55,kaist_dataset/English/Digital_Camera/(E.S)D-indoor/DSC02719.JPG,char_data/e/DSC02719.JPG_4.jpg,1925,480,640,35,424,459,287,342,True,34
e,52,kaist_dataset/English/Digital_Camera/(E.S)D-indoor/DSC02719.JPG,char_data/e/DSC02719.JPG_5.jpg,1872,480,640,36,518,554,290,342,True,34
e,46,kaist_dataset/English/Digital_Camera/(E.S)D-indoor/DSC02854.JPG,char_data/e/DSC02854.JPG_4.jpg,1840,480,640,40,211,251,155,201,True,34
e,57,kaist_dataset/English/Digital_Camera/(E.S)D-indoor/DSC02854.JPG,char_data/e/DSC02854.JPG_5.jpg,1938,480,640,34,422,456,150,207,True,34
e,39,kaist_dataset/English/Digital_Camera/(E.S)D-indoor/DSC02859.JPG,char_data/e/DSC02859.JPG_4.jpg,1482,480,640,38,145,183,344,383,True,34
e,49,kaist_dataset/English/Digital_Camera/(E.S)D-indoor/DSC02859.JPG,char_data/e/DSC02859.JPG_5.jpg,1813,480,640,37,513,550,349,398,True,34
e,58,kaist_dataset/English/Digital_Camera/(E.S)D-indoor/DSC02860.JPG,char_data/e/DSC02860.JPG_2.jpg,3306,480,640,57,477,534,89,147,True,34
e,54,kaist_dataset/English/Digital_Camera/(E.S)D-indoor/DSC02862.JPG,char_data/e/DSC02862.JPG_4.jpg,3240,480,640,60,133,193,249,303,True,34
e,69,kaist_dataset/English/Digital_Camera/(E.S)D-indoor/DSC02862.JPG,char_data/e/DSC02862.JPG_5.jpg,3381,480,640,49,242,291,243,312,True,34
e,62,kaist_dataset/English/Digital_Camera/(E.S)D-indoor/DSC03074.JPG,char_data/e/DSC03074.JPG_7.jpg,1364,480,640,22,397,419,260,322,True,34
e,62,kaist_dataset/English/Digital_Camera/(E.S)D-indoor/DSC03074.JPG,char_data/e/DSC03074.JPG_8.jpg,1364,480,640,22,453,475,260,322,True,34
e,63,kaist_dataset/English/Digital_Camera/(E.S)D-indoor/DSC03076.JPG,char_data/e/DSC03076.JPG_4.jpg,1953,480,640,31,255,286,300,363,True,34
e,64,kaist_dataset/English/Digital_Camera/(E.S)D-indoor/DSC03076.JPG,char_data/e/DSC03076.JPG_5.jpg,2688,480,640,42,361,403,295,359,True,34
e,49,kaist_dataset/English/Digital_Camera/(E.S)D-indoor/DSC03085.JPG,char_data/e/DSC03085.JPG_4.jpg,1470,480,640,30,293,323,384,433,True,34
e,55,kaist_dataset/English/Digital_Camera/(E.S)D-indoor/DSC03085.JPG,char_data/e/DSC03085.JPG_5.jpg,1430,480,640,26,374,400,379,434,True,34
e,54,kaist_dataset/English/Digital_Camera/(E.S)D-indoor/DSC03087.JPG,char_data/e/DSC03087.JPG_2.jpg,2214,480,640,41,180,221,376,430,True,34
e,36,kaist_dataset/English/Digital_Camera/(E.S)D-indoor/DSC03090.JPG,char_data/e/DSC03090.JPG_6.jpg,900,480,640,25,247,272,243,279,True,34
e,36,kaist_dataset/English/Digital_Camera/(E.S)D-indoor/DSC03090.JPG,char_data/e/DSC03090.JPG_7.jpg,756,480,640,21,307,328,245,281,True,34
e,36,kaist_dataset/English/Digital_Camera/(E.S)D-indoor/DSC03090.JPG,char_data/e/DSC03090.JPG_8.jpg,648,480,640,18,358,376,296,332,True,34
e,58,kaist_dataset/English/Digital_Camera/(E.S)D-indoor/DSC03091.JPG,char_data/e/DSC03091.JPG_6.jpg,2436,480,640,42,181,223,132,190,True,34
e,57,kaist_dataset/English/Digital_Camera/(E.S)D-indoor/DSC03091.JPG,char_data/e/DSC03091.JPG_7.jpg,2280,480,640,40,283,323,128,185,True,34
e,51,kaist_dataset/English/Digital_Camera/(E.S)D-indoor/DSC03093.JPG,char_data/e/DSC03093.JPG_4.jpg,1785,480,640,35,279,314,142,193,True,34
e,39,kaist_dataset/English/Digital_Camera/(E.S)D-indoor/DSC03093.JPG,char_data/e/DSC03093.JPG_5.jpg,1209,480,640,31,520,551,216,255,True,34
e,37,kaist_dataset/English/Digital_Camera/(E.S)D-indoor/DSC03112.JPG,char_data/e/DSC03112.JPG_2.jpg,962,480,640,26,447,473,213,250,True,34
e,59,kaist_dataset/English/Digital_Camera/(E.S)D-indoor/DSC03136.JPG,char_data/e/DSC03136.JPG_2.jpg,1888,480,640,32,473,505,264,323,True,34
e,64,kaist_dataset/English/Digital_Camera/(E.S)D-indoor/DSC03141.JPG,char_data/e/DSC03141.JPG_2.jpg,3456,480,640,54,287,341,212,276,True,34
e,33,kaist_dataset/English/Digital_Camera/(E.S)D-indoor/DSC03142.JPG,char_data/e/DSC03142.JPG_6.jpg,825,480,640,25,290,315,428,461,True,34
e,38,kaist_dataset/English/Digital_Camera/(E.S)D-indoor/DSC03142.JPG,char_data/e/DSC03142.JPG_7.jpg,836,480,640,22,328,350,427,465,True,34
e,36,kaist_dataset/English/Digital_Camera/(E.S)D-indoor/DSC03142.JPG,char_data/e/DSC03142.JPG_8.jpg,900,480,640,25,209,234,367,403,True,34
e,34,kaist_dataset/English/Digital_Camera/(E.S)D-indoor/DSC03144.JPG,char_data/e/DSC03144.JPG_4.jpg,612,480,640,18,286,304,238,272,True,34
e,34,kaist_dataset/English/Digital_Camera/(E.S)D-indoor/DSC03144.JPG,char_data/e/DSC03144.JPG_5.jpg,680,480,640,20,280,300,291,325,True,34
e,37,kaist_dataset/English/Digital_Camera/(E.S)D-indoor/DSC03145.JPG,char_data/e/DSC03145.JPG_4.jpg,814,480,640,22,175,197,179,216,True,34
e,29,kaist_dataset/English/Digital_Camera/(E.S)D-indoor/DSC03145.JPG,char_data/e/DSC03145.JPG_5.jpg,638,480,640,22,179,201,127,156,True,34
e,35,kaist_dataset/English/Digital_Camera/(E.S)D-indoor/DSC03146.JPG,char_data/e/DSC03146.JPG_2.jpg,665,480,640,19,355,374,234,269,True,34
e,30,kaist_dataset/English/Digital_Camera/(E.S)D-indoor/DSC03147.JPG,char_data/e/DSC03147.JPG_4.jpg,720,480,640,24,184,208,302,332,True,34
e,32,kaist_dataset/English/Digital_Camera/(E.S)D-indoor/DSC03147.JPG,char_data/e/DSC03147.JPG_5.jpg,864,480,640,27,187,214,241,273,True,34
e,42,kaist_dataset/English/Digital_Camera/(E.S)D-indoor/DSC03149.JPG,char_data/e/DSC03149.JPG_2.jpg,1218,480,640,29,535,564,398,440,True,34
e,42,kaist_dataset/English/Digital_Camera/(E.S)D-indoor/DSC03150.JPG,char_data/e/DSC03150.JPG_4.jpg,1470,480,640,35,153,188,40,82,True,34
e,51,kaist_dataset/English/Digital_Camera/(E.S)D-indoor/DSC03150.JPG,char_data/e/DSC03150.JPG_5.jpg,2040,480,640,40,520,560,25,76,True,34
e,47,kaist_dataset/English/Digital_Camera/(E.S)D-indoor/DSC03151.JPG,char_data/e/DSC03151.JPG_4.jpg,1551,480,640,33,175,208,108,155,True,34
e,43,kaist_dataset/English/Digital_Camera/(E.S)D-indoor/DSC03151.JPG,char_data/e/DSC03151.JPG_5.jpg,1376,480,640,32,589,621,111,154,True,34
e,44,kaist_dataset/English/Digital_Camera/(E.S)D-indoor/DSC03345.JPG,char_data/e/DSC03345.JPG_4.jpg,1584,480,640,36,208,244,108,152,True,34
e,46,kaist_dataset/English/Digital_Camera/(E.S)D-indoor/DSC03345.JPG,char_data/e/DSC03345.JPG_5.jpg,1564,480,640,34,380,414,102,148,True,34
e,43,kaist_dataset/English/Digital_Camera/(E.S)D-indoor/DSC03376.JPG,char_data/e/DSC03376.JPG_2.jpg,1075,480,640,25,331,356,407,450,True,34
e,50,kaist_dataset/English/Digital_Camera/(E.S)D-indoor/DSC03395.JPG,char_data/e/DSC03395.JPG_2.jpg,1950,480,640,39,274,313,418,468,True,34
e,37,kaist_dataset/English/Digital_Camera/(E.S)D-indoor/DSC03396.JPG,char_data/e/DSC03396.JPG_9.jpg,851,480,640,23,292,315,341,378,True,34
e,59,kaist_dataset/English/Digital_Camera/(E.S)D-indoor/DSC03441.JPG,char_data/e/DSC03441.JPG_2.jpg,2537,480,640,43,282,325,390,449,True,34
e,43,kaist_dataset/English/Digital_Camera/(E.S)D-indoor/DSC03532.JPG,char_data/e/DSC03532.JPG_8.jpg,1720,480,640,40,357,397,433,476,True,34
e,27,kaist_dataset/English/Digital_Camera/(E.S)D-indoor/DSC03532.JPG,char_data/e/DSC03532.JPG_9.jpg,432,480,640,16,229,245,386,413,True,34
e,24,kaist_dataset/English/Digital_Camera/(E.S)D-indoor/DSC03532.JPG,char_data/e/DSC03532.JPG_10.jpg,360,480,640,15,402,417,387,411,True,34
e,27,kaist_dataset/English/Digital_Camera/(E.S)D-indoor/DSC03532.JPG,char_data/e/DSC03532.JPG_11.jpg,405,480,640,15,484,499,381,408,True,34
e,45,kaist_dataset/English/Digital_Camera/(E.S)D-indoor/DSC03936.JPG,char_data/e/DSC03936.JPG_4.jpg,1485,480,640,33,390,423,175,220,True,34
e,47,kaist_dataset/English/Digital_Camera/(E.S)D-indoor/DSC03936.JPG,char_data/e/DSC03936.JPG_5.jpg,1645,480,640,35,449,484,167,214,True,34
e,31,kaist_dataset/English/Digital_Camera/(E.S)D-indoor/DSC04023.JPG,char_data/e/DSC04023.JPG_8.jpg,961,480,640,31,94,125,308,339,True,34
e,30,kaist_dataset/English/Digital_Camera/(E.S)D-indoor/DSC04023.JPG,char_data/e/DSC04023.JPG_9.jpg,720,480,640,24,294,318,320,350,True,34
e,34,kaist_dataset/English/Digital_Camera/(E.S)D-indoor/DSC04023.JPG,char_data/e/DSC04023.JPG_10.jpg,850,480,640,25,458,483,325,359,True,34
e,30,kaist_dataset/English/Digital_Camera/(E.S)D-indoor/DSC04023.JPG,char_data/e/DSC04023.JPG_11.jpg,750,480,640,25,532,557,332,362,True,34
e,48,kaist_dataset/English/Digital_Camera/(E.S)D-indoor/크기변환_%B0%A3%C6%C76_fabdent.jpg,char_data/e/크기변환_%B0%A3%C6%C76_fabdent.jpg_2.jpg,1008,480,640,21,198,219,191,239,True,34
e,122,kaist_dataset/English/Digital_Camera/(E.S)E-night/068.jpg,char_data/e/068.jpg_7.jpg,6466,519,742,53,329,382,285,407,True,34
e,126,kaist_dataset/English/Digital_Camera/(E.S)E-night/068.jpg,char_data/e/068.jpg_8.jpg,7434,519,742,59,381,440,282,408,True,34
e,101,kaist_dataset/English/Digital_Camera/(E.S)E-night/080116-0056.jpg,char_data/e/080116-0056.jpg_2.jpg,9393,1200,1600,93,936,1029,527,628,True,34
e,98,kaist_dataset/English/Digital_Camera/(E.S)E-night/DSC02604.JPG,char_data/e/DSC02604.JPG_4.jpg,10094,480,640,103,268,371,240,338,True,34
e,99,kaist_dataset/English/Digital_Camera/(E.S)E-night/DSC02604.JPG,char_data/e/DSC02604.JPG_5.jpg,8910,480,640,90,369,459,239,338,True,34
e,61,kaist_dataset/English/Digital_Camera/(E.S)E-night/DSC02676.JPG,char_data/e/DSC02676.JPG_2.jpg,2379,480,640,39,139,178,231,292,True,34
e,74,kaist_dataset/English/Digital_Camera/(E.S)E-night/DSC02981.JPG,char_data/e/DSC02981.JPG_6.jpg,2146,480,640,29,353,382,379,453,True,34
e,71,kaist_dataset/English/Digital_Camera/(E.S)E-night/DSC02981.JPG,char_data/e/DSC02981.JPG_7.jpg,2698,480,640,38,383,421,379,450,True,34
e,95,kaist_dataset/English/Digital_Camera/(E.S)E-night/DSC02981.JPG,char_data/e/DSC02981.JPG_8.jpg,4370,480,640,46,385,431,194,289,True,34
e,69,kaist_dataset/English/Digital_Camera/(E.S)E-night/크기변환_P1010163.JPG,char_data/e/크기변환_P1010163.JPG_2.jpg,3726,480,640,54,237,291,104,173,True,34
e,41,kaist_dataset/English/Digital_Camera/(E.S)F-others/080116-0058.jpg,char_data/e/080116-0058.jpg_8.jpg,1312,1200,1600,32,105,137,640,681,True,34
e,46,kaist_dataset/English/Digital_Camera/(E.S)F-others/080119-0007.jpg,char_data/e/080119-0007.jpg_23.jpg,1564,1200,1600,34,861,895,825,871,True,34
e,55,kaist_dataset/English/Digital_Camera/(E.S)F-others/080119-0007.jpg,char_data/e/080119-0007.jpg_27.jpg,1705,1200,1600,31,144,175,740,795,True,34
e,38,kaist_dataset/English/Digital_Camera/(E.S)F-others/080119-0007.jpg,char_data/e/080119-0007.jpg_30.jpg,646,1200,1600,17,860,877,897,935,True,34
e,35,kaist_dataset/English/Digital_Camera/(E.S)F-others/080119-0007.jpg,char_data/e/080119-0007.jpg_31.jpg,735,1200,1600,21,965,986,876,911,True,34
e,45,kaist_dataset/English/Digital_Camera/(E.S)F-others/080119-0007.jpg,char_data/e/080119-0007.jpg_32.jpg,1710,1200,1600,38,983,1021,733,778,True,34
e,125,kaist_dataset/English/Digital_Camera/(E.S)F-others/080119-0014.jpg,char_data/e/080119-0014.jpg_7.jpg,8000,1200,1600,64,862,926,594,719,True,34
e,87,kaist_dataset/English/Digital_Camera/(E.S)F-others/DSC02923.JPG,char_data/e/DSC02923.JPG_4.jpg,7134,480,640,82,488,570,266,353,True,34
e,74,kaist_dataset/English/Digital_Camera/(E.S)F-others/DSC02925.JPG,char_data/e/DSC02925.JPG_2.jpg,5254,480,640,71,108,179,289,363,True,34
e,82,kaist_dataset/English/Digital_Camera/(E.S)F-others/크기변환_%B0%A3%C6%C72_ktimt007.jpg,char_data/e/크기변환_%B0%A3%C6%C72_ktimt007.jpg_2.jpg,4100,480,640,50,242,292,229,311,True,34
e,75,kaist_dataset/English/Mobile_Phone/(E.M)A-outdoor/P090912059.jpg,char_data/e/P090912059.jpg_4.jpg,6975,480,640,93,34,127,154,229,True,34
e,79,kaist_dataset/English/Mobile_Phone/(E.M)A-outdoor/P090912059.jpg,char_data/e/P090912059.jpg_5.jpg,5925,480,640,75,212,287,156,235,True,34
e,45,kaist_dataset/English/Mobile_Phone/(E.M)A-outdoor/P090912072.jpg,char_data/e/P090912072.jpg_8.jpg,1620,480,640,36,173,209,127,172,True,34
e,45,kaist_dataset/English/Mobile_Phone/(E.M)A-outdoor/P090912072.jpg,char_data/e/P090912072.jpg_9.jpg,2025,480,640,45,209,254,127,172,True,34
e,48,kaist_dataset/English/Mobile_Phone/(E.M)A-outdoor/P090912072.jpg,char_data/e/P090912072.jpg_10.jpg,1776,480,640,37,87,124,187,235,True,34
e,48,kaist_dataset/English/Mobile_Phone/(E.M)A-outdoor/P090912072.jpg,char_data/e/P090912072.jpg_11.jpg,1632,480,640,34,126,160,195,243,True,34
e,69,kaist_dataset/English/Mobile_Phone/(E.M)B-indoor/P090831011.jpg,char_data/e/P090831011.jpg_6.jpg,3174,480,640,46,72,118,137,206,True,34
e,66,kaist_dataset/English/Mobile_Phone/(E.M)B-indoor/P090831011.jpg,char_data/e/P090831011.jpg_7.jpg,2904,480,640,44,237,281,139,205,True,34
e,65,kaist_dataset/English/Mobile_Phone/(E.M)B-indoor/P090831011.jpg,char_data/e/P090831011.jpg_8.jpg,3120,480,640,48,566,614,139,204,True,34
e,53,kaist_dataset/English/Mobile_Phone/(E.M)B-indoor/P090902018.jpg,char_data/e/P090902018.jpg_2.jpg,2173,480,640,41,151,192,311,364,True,34
e,119,kaist_dataset/English/Mobile_Phone/(E.M)B-indoor/P090903001.jpg,char_data/e/P090903001.jpg_2.jpg,11900,480,640,100,404,504,140,259,True,34
e,101,kaist_dataset/English/Mobile_Phone/(E.M)B-indoor/P090903003.jpg,char_data/e/P090903003.jpg_2.jpg,7777,480,640,77,384,461,260,361,True,34
e,78,kaist_dataset/English/Mobile_Phone/(E.M)B-indoor/P090903004.jpg,char_data/e/P090903004.jpg_4.jpg,5148,480,640,66,207,273,258,336,True,34
e,78,kaist_dataset/English/Mobile_Phone/(E.M)B-indoor/P090903004.jpg,char_data/e/P090903004.jpg_5.jpg,5538,480,640,71,527,598,256,334,True,34
e,57,kaist_dataset/English/Mobile_Phone/(E.M)B-indoor/P090903007.jpg,char_data/e/P090903007.jpg_4.jpg,2850,480,640,50,299,349,267,324,True,34
e,59,kaist_dataset/English/Mobile_Phone/(E.M)B-indoor/P090903007.jpg,char_data/e/P090903007.jpg_5.jpg,2596,480,640,44,493,537,261,320,True,34
e,56,kaist_dataset/English/Mobile_Phone/(E.M)B-indoor/P090903008.jpg,char_data/e/P090903008.jpg_6.jpg,2464,480,640,44,198,242,37,93,True,34
e,58,kaist_dataset/English/Mobile_Phone/(E.M)B-indoor/P090903008.jpg,char_data/e/P090903008.jpg_7.jpg,2378,480,640,41,378,419,39,97,True,34
e,51,kaist_dataset/English/Mobile_Phone/(E.M)B-indoor/P090903008.jpg,char_data/e/P090903008.jpg_8.jpg,1938,480,640,38,578,616,44,95,True,34
e,108,kaist_dataset/English/Mobile_Phone/(E.M)B-indoor/P090911075.jpg,char_data/e/P090911075.jpg_2.jpg,12960,480,640,120,355,475,115,223,True,34
e,45,kaist_dataset/English/Mobile_Phone/(E.M)B-indoor/P090911084.jpg,char_data/e/P090911084.jpg_8.jpg,1215,480,640,27,257,284,163,208,True,34
e,47,kaist_dataset/English/Mobile_Phone/(E.M)B-indoor/P090911084.jpg,char_data/e/P090911084.jpg_9.jpg,1128,480,640,24,348,372,159,206,True,34
e,49,kaist_dataset/English/Mobile_Phone/(E.M)B-indoor/P090911084.jpg,char_data/e/P090911084.jpg_10.jpg,1176,480,640,24,472,496,158,207,True,34
e,41,kaist_dataset/English/Mobile_Phone/(E.M)B-indoor/P090911084.jpg,char_data/e/P090911084.jpg_11.jpg,1107,480,640,27,542,569,160,201,True,34
e,87,kaist_dataset/English/Mobile_Phone/(E.M)B-indoor/P090911086.jpg,char_data/e/P090911086.jpg_4.jpg,4698,480,640,54,582,636,369,456,True,34
e,84,kaist_dataset/English/Mobile_Phone/(E.M)B-indoor/P090911086.jpg,char_data/e/P090911086.jpg_5.jpg,4032,480,640,48,256,304,244,328,True,34
e,68,kaist_dataset/English/Mobile_Phone/(E.M)C-bookCover/P090831039.jpg,char_data/e/P090831039.jpg_4.jpg,4012,480,640,59,207,266,42,110,True,34
e,69,kaist_dataset/English/Mobile_Phone/(E.M)C-bookCover/P090831039.jpg,char_data/e/P090831039.jpg_5.jpg,4140,480,640,60,166,226,131,200,True,34
e,106,kaist_dataset/English/Mobile_Phone/(E.M)C-bookCover/P090831077.jpg,char_data/e/P090831077.jpg_4.jpg,7738,480,640,73,159,232,91,197,True,34
e,108,kaist_dataset/English/Mobile_Phone/(E.M)C-bookCover/P090831077.jpg,char_data/e/P090831077.jpg_5.jpg,7344,480,640,68,546,614,88,196,True,34
e,37,kaist_dataset/English/Mobile_Phone/(E.M)C-bookCover/P090903030.jpg,char_data/e/P090903030.jpg_6.jpg,851,480,640,23,134,157,79,116,True,34
e,42,kaist_dataset/English/Mobile_Phone/(E.M)C-bookCover/P090903030.jpg,char_data/e/P090903030.jpg_7.jpg,1176,480,640,28,224,252,74,116,True,34
e,33,kaist_dataset/English/Mobile_Phone/(E.M)C-bookCover/P090903030.jpg,char_data/e/P090903030.jpg_8.jpg,627,480,640,19,593,612,75,108,True,34
e,80,kaist_dataset/English/Mobile_Phone/(E.M)C-bookCover/P090903054.jpg,char_data/e/P090903054.jpg_10.jpg,6320,480,640,79,239,318,229,309,True,34
e,88,kaist_dataset/English/Mobile_Phone/(E.M)C-bookCover/P090903054.jpg,char_data/e/P090903054.jpg_12.jpg,6952,480,640,79,539,618,227,315,True,34
e,26,kaist_dataset/Korean/Digital_Camera/A-shadow/2007-12-09-day-exterior-031.jpg,char_data/e/2007-12-09-day-exterior-031.jpg_4.jpg,390,1200,1600,15,369,384,622,648,True,34
e,23,kaist_dataset/Korean/Digital_Camera/A-shadow/2007-12-09-day-exterior-031.jpg,char_data/e/2007-12-09-day-exterior-031.jpg_5.jpg,253,1200,1600,11,455,466,620,643,True,34
e,24,kaist_dataset/Korean/Digital_Camera/B-light/DSC02987.JPG,char_data/e/DSC02987.JPG_2.jpg,216,480,640,9,369,378,279,303,True,34
e,45,kaist_dataset/Korean/Digital_Camera/G-others/2007-12-08-day-112.jpg,char_data/e/2007-12-08-day-112.jpg_5.jpg,720,1200,1600,16,663,679,590,635,True,34
e,18,kaist_dataset/Korean/Digital_Camera/indoor1/080119-0029.jpg,char_data/e/080119-0029.jpg_8.jpg,270,1200,1600,15,321,336,588,606,True,34
e,19,kaist_dataset/Korean/Digital_Camera/indoor1/080119-0029.jpg,char_data/e/080119-0029.jpg_9.jpg,228,1200,1600,12,679,691,657,676,True,34
e,20,kaist_dataset/Korean/Digital_Camera/indoor1/080119-0029.jpg,char_data/e/080119-0029.jpg_10.jpg,240,1200,1600,12,753,765,659,679,True,34
e,21,kaist_dataset/Korean/Digital_Camera/indoor1/080119-0029.jpg,char_data/e/080119-0029.jpg_11.jpg,294,1200,1600,14,940,954,666,687,True,34
e,20,kaist_dataset/Korean/Digital_Camera/indoor1/145.JPG,char_data/e/145.JPG_2.jpg,200,480,640,10,292,302,307,327,True,34
e,18,kaist_dataset/Korean/Digital_Camera/outdoor1/001.JPG,char_data/e/001.JPG_14.jpg,216,480,640,12,473,485,240,258,True,34
e,34,kaist_dataset/Korean/Digital_Camera/outdoor1/023.JPG,char_data/e/023.JPG_4.jpg,850,480,640,25,535,560,37,71,True,34
e,35,kaist_dataset/Korean/Digital_Camera/outdoor1/023.JPG,char_data/e/023.JPG_5.jpg,1260,480,640,36,560,596,36,71,True,34
e,31,kaist_dataset/Korean/Digital_Camera/outdoor1/2007-12-08-day-056.jpg,char_data/e/2007-12-08-day-056.jpg_4.jpg,930,1200,1600,30,874,904,408,439,True,34
e,29,kaist_dataset/Korean/Digital_Camera/outdoor1/2007-12-08-day-056.jpg,char_data/e/2007-12-08-day-056.jpg_5.jpg,841,1200,1600,29,903,932,407,436,True,34
e,29,kaist_dataset/Korean/Digital_Camera/outdoor1/2007-12-08-day-087.jpg,char_data/e/2007-12-08-day-087.jpg_2.jpg,464,1200,1600,16,28,44,516,545,True,34
e,38,kaist_dataset/Korean/Digital_Camera/outdoor2/080118-0018.jpg,char_data/e/080118-0018.jpg_6.jpg,1330,1200,1600,35,684,719,689,727,True,34
e,35,kaist_dataset/Korean/Digital_Camera/outdoor2/080118-0018.jpg,char_data/e/080118-0018.jpg_7.jpg,1505,1200,1600,43,964,1007,694,729,True,34
e,35,kaist_dataset/Korean/Digital_Camera/outdoor2/080118-0018.jpg,char_data/e/080118-0018.jpg_8.jpg,1050,1200,1600,30,1059,1089,697,732,True,34
e,60,kaist_dataset/Korean/Digital_Camera/outdoor2/2007-12-08-day-101.jpg,char_data/e/2007-12-08-day-101.jpg_4.jpg,2820,1200,1600,47,622,669,385,445,True,34
e,36,kaist_dataset/Mixed/Digital_Camera/(C.S)A-shadow/DSC02609.JPG,char_data/e/DSC02609.JPG_4.jpg,648,480,640,18,250,268,316,352,True,34
e,57,kaist_dataset/Mixed/Digital_Camera/(C.S)A-shadow/DSC03207.JPG,char_data/e/DSC03207.JPG_2.jpg,2052,480,640,36,239,275,204,261,True,34
e,23,kaist_dataset/Mixed/Digital_Camera/(C.S)C-outdoor1/003.JPG,char_data/e/003.JPG_10.jpg,230,480,640,10,268,278,262,285,True,34
e,18,kaist_dataset/Mixed/Digital_Camera/(C.S)C-outdoor1/003.JPG,char_data/e/003.JPG_11.jpg,252,480,640,14,300,314,262,280,True,34
e,20,kaist_dataset/Mixed/Digital_Camera/(C.S)C-outdoor1/003.JPG,char_data/e/003.JPG_12.jpg,260,480,640,13,363,376,258,278,True,34
e,17,kaist_dataset/Mixed/Digital_Camera/(C.S)C-outdoor1/003.JPG,char_data/e/003.JPG_13.jpg,221,480,640,13,102,115,269,286,True,34
e,19,kaist_dataset/Mixed/Digital_Camera/(C.S)C-outdoor1/003.JPG,char_data/e/003.JPG_14.jpg,190,480,640,10,200,210,265,284,True,34
e,59,kaist_dataset/Mixed/Digital_Camera/(C.S)C-outdoor1/014.JPG,char_data/e/014.JPG_6.jpg,1475,480,640,25,31,56,197,256,True,34
e,58,kaist_dataset/Mixed/Digital_Camera/(C.S)C-outdoor1/014.JPG,char_data/e/014.JPG_7.jpg,1508,480,640,26,81,107,203,261,True,34
e,34,kaist_dataset/Mixed/Digital_Camera/(C.S)C-outdoor1/062.JPG,char_data/e/062.JPG_6.jpg,510,480,640,15,295,310,168,202,True,34
e,33,kaist_dataset/Mixed/Digital_Camera/(C.S)C-outdoor1/062.JPG,char_data/e/062.JPG_7.jpg,297,480,640,9,353,362,167,200,True,34
e,32,kaist_dataset/Mixed/Digital_Camera/(C.S)C-outdoor1/062.JPG,char_data/e/062.JPG_8.jpg,320,480,640,10,363,373,167,199,True,34
e,55,kaist_dataset/Mixed/Digital_Camera/(C.S)C-outdoor1/080116-0084.jpg,char_data/e/080116-0084.jpg_4.jpg,2695,600,800,49,407,456,211,266,True,34
e,59,kaist_dataset/Mixed/Digital_Camera/(C.S)C-outdoor1/080116-0084.jpg,char_data/e/080116-0084.jpg_5.jpg,2891,600,800,49,492,541,212,271,True,34
e,130,kaist_dataset/Mixed/Digital_Camera/(C.S)C-outdoor1/080118-0014.jpg,char_data/e/080118-0014.jpg_2.jpg,12090,1200,1600,93,767,860,755,885,True,34
e,212,kaist_dataset/Mixed/Digital_Camera/(C.S)C-outdoor1/080119-0008.jpg,char_data/e/080119-0008.jpg_2.jpg,44096,1200,1600,208,748,956,593,805,True,34
e,30,kaist_dataset/Mixed/Digital_Camera/(C.S)C-outdoor1/086.JPG,char_data/e/086.JPG_13.jpg,390,480,640,13,202,215,335,365,True,34
e,26,kaist_dataset/Mixed/Digital_Camera/(C.S)C-outdoor1/086.JPG,char_data/e/086.JPG_14.jpg,468,480,640,18,284,302,337,363,True,34
e,28,kaist_dataset/Mixed/Digital_Camera/(C.S)C-outdoor1/1.JPG,char_data/e/1.JPG_16.jpg,616,576,768,22,326,348,15,43,True,34
e,35,kaist_dataset/Mixed/Digital_Camera/(C.S)C-outdoor1/1.JPG,char_data/e/1.JPG_17.jpg,875,576,768,25,349,374,12,47,True,34
e,31,kaist_dataset/Mixed/Digital_Camera/(C.S)C-outdoor1/1.JPG,char_data/e/1.JPG_18.jpg,713,576,768,23,613,636,15,46,True,34
e,31,kaist_dataset/Mixed/Digital_Camera/(C.S)C-outdoor1/1.JPG,char_data/e/1.JPG_19.jpg,806,576,768,26,637,663,16,47,True,34
e,42,kaist_dataset/Mixed/Digital_Camera/(C.S)C-outdoor1/101.JPG,char_data/e/101.JPG_2.jpg,1638,480,640,39,326,365,251,293,True,34
e,26,kaist_dataset/Mixed/Digital_Camera/(C.S)C-outdoor1/115.JPG,char_data/e/115.JPG_4.jpg,520,480,640,20,341,361,279,305,True,34
e,26,kaist_dataset/Mixed/Digital_Camera/(C.S)C-outdoor1/115.JPG,char_data/e/115.JPG_5.jpg,494,480,640,19,420,439,277,303,True,34
e,43,kaist_dataset/Mixed/Digital_Camera/(C.S)C-outdoor1/133.JPG,char_data/e/133.JPG_2.jpg,817,480,640,19,607,626,338,381,True,34
e,15,kaist_dataset/Mixed/Digital_Camera/(C.S)C-outdoor1/2.JPG,char_data/e/2.JPG_2.jpg,135,576,768,9,535,544,402,417,True,34
e,52,kaist_dataset/Mixed/Digital_Camera/(C.S)C-outdoor1/2007-12-08-day-106.jpg,char_data/e/2007-12-08-day-106.jpg_2.jpg,2184,1200,1600,42,1209,1251,757,809,True,34
e,57,kaist_dataset/Mixed/Digital_Camera/(C.S)C-outdoor1/2007-12-08-day-118.jpg,char_data/e/2007-12-08-day-118.jpg_2.jpg,3990,1200,1600,70,1406,1476,423,480,True,34
e,25,kaist_dataset/Mixed/Digital_Camera/(C.S)C-outdoor1/47.JPG,char_data/e/47.JPG_2.jpg,600,576,768,24,389,413,187,212,True,34
e,28,kaist_dataset/Mixed/Digital_Camera/(C.S)C-outdoor1/DSC02318.JPG,char_data/e/DSC02318.JPG_4.jpg,672,480,640,24,199,223,324,352,True,34
e,23,kaist_dataset/Mixed/Digital_Camera/(C.S)C-outdoor1/DSC02318.JPG,char_data/e/DSC02318.JPG_5.jpg,575,480,640,25,290,315,330,353,True,34
e,16,kaist_dataset/Mixed/Digital_Camera/(C.S)C-outdoor1/DSC02320.JPG,char_data/e/DSC02320.JPG_4.jpg,144,480,640,9,549,558,258,274,True,34
e,18,kaist_dataset/Mixed/Digital_Camera/(C.S)C-outdoor1/DSC02320.JPG,char_data/e/DSC02320.JPG_5.jpg,180,480,640,10,564,574,256,274,True,34
e,28,kaist_dataset/Mixed/Digital_Camera/(C.S)C-outdoor1/DSC02325.JPG,char_data/e/DSC02325.JPG_2.jpg,644,480,640,23,299,322,319,347,True,34
e,66,kaist_dataset/Mixed/Digital_Camera/(C.S)C-outdoor1/DSC02344.JPG,char_data/e/DSC02344.JPG_4.jpg,3564,480,640,54,128,182,154,220,True,34
e,63,kaist_dataset/Mixed/Digital_Camera/(C.S)C-outdoor1/DSC02344.JPG,char_data/e/DSC02344.JPG_5.jpg,3717,480,640,59,552,611,167,230,True,34
e,87,kaist_dataset/Mixed/Digital_Camera/(C.S)C-outdoor1/P1010008.JPG,char_data/e/P1010008.JPG_2.jpg,4176,480,640,48,221,269,113,200,True,34
e,49,kaist_dataset/Mixed/Digital_Camera/(C.S)C-outdoor2/DSC02382.JPG,char_data/e/DSC02382.JPG_2.jpg,2303,480,640,47,117,164,262,311,True,34
e,32,kaist_dataset/Mixed/Digital_Camera/(C.S)C-outdoor2/DSC02385.JPG,char_data/e/DSC02385.JPG_5.jpg,416,480,640,13,532,545,133,165,True,34
e,40,kaist_dataset/Mixed/Digital_Camera/(C.S)C-outdoor2/DSC02400.JPG,char_data/e/DSC02400.JPG_8.jpg,1400,480,640,35,153,188,329,369,True,34
e,38,kaist_dataset/Mixed/Digital_Camera/(C.S)C-outdoor2/DSC02400.JPG,char_data/e/DSC02400.JPG_9.jpg,1330,480,640,35,189,224,327,365,True,34
e,38,kaist_dataset/Mixed/Digital_Camera/(C.S)C-outdoor2/DSC02400.JPG,char_data/e/DSC02400.JPG_10.jpg,1102,480,640,29,319,348,326,364,True,34
e,40,kaist_dataset/Mixed/Digital_Camera/(C.S)C-outdoor2/DSC02400.JPG,char_data/e/DSC02400.JPG_11.jpg,1440,480,640,36,569,605,330,370,True,34
e,55,kaist_dataset/Mixed/Digital_Camera/(C.S)C-outdoor2/DSC02416.JPG,char_data/e/DSC02416.JPG_2.jpg,3410,480,640,62,179,241,215,270,True,34
e,52,kaist_dataset/Mixed/Digital_Camera/(C.S)C-outdoor2/DSC02418.JPG,char_data/e/DSC02418.JPG_2.jpg,2964,480,640,57,404,461,174,226,True,34
e,25,kaist_dataset/Mixed/Digital_Camera/(C.S)C-outdoor2/DSC02421.JPG,char_data/e/DSC02421.JPG_6.jpg,525,480,640,21,84,105,213,238,True,34
e,21,kaist_dataset/Mixed/Digital_Camera/(C.S)C-outdoor2/DSC02421.JPG,char_data/e/DSC02421.JPG_7.jpg,441,480,640,21,365,386,213,234,True,34
e,16,kaist_dataset/Mixed/Digital_Camera/(C.S)C-outdoor2/DSC02421.JPG,char_data/e/DSC02421.JPG_8.jpg,320,480,640,20,504,524,214,230,True,34
e,22,kaist_dataset/Mixed/Digital_Camera/(C.S)C-outdoor2/DSC02430.JPG,char_data/e/DSC02430.JPG_2.jpg,374,480,640,17,150,167,188,210,True,34
e,73,kaist_dataset/Mixed/Digital_Camera/(C.S)C-outdoor2/DSC02434.JPG,char_data/e/DSC02434.JPG_4.jpg,4088,480,640,56,454,510,200,273,True,34
e,77,kaist_dataset/Mixed/Digital_Camera/(C.S)C-outdoor2/DSC02434.JPG,char_data/e/DSC02434.JPG_5.jpg,4697,480,640,61,508,569,202,279,True,34
e,19,kaist_dataset/Mixed/Digital_Camera/(C.S)C-outdoor2/DSC02439.JPG,char_data/e/DSC02439.JPG_5.jpg,304,480,640,16,469,485,112,131,True,34
e,28,kaist_dataset/Mixed/Digital_Camera/(C.S)C-outdoor2/DSC02479.JPG,char_data/e/DSC02479.JPG_2.jpg,728,480,640,26,400,426,224,252,True,34
e,79,kaist_dataset/Mixed/Digital_Camera/(C.S)C-outdoor2/DSC02493.JPG,char_data/e/DSC02493.JPG_4.jpg,5609,480,640,71,90,161,286,365,True,34
e,71,kaist_dataset/Mixed/Digital_Camera/(C.S)C-outdoor2/DSC02493.JPG,char_data/e/DSC02493.JPG_5.jpg,4615,480,640,65,398,463,299,370,True,34
e,30,kaist_dataset/Mixed/Digital_Camera/(C.S)C-outdoor2/DSC02511.JPG,char_data/e/DSC02511.JPG_8.jpg,540,480,640,18,106,124,208,238,True,34
e,24,kaist_dataset/Mixed/Digital_Camera/(C.S)C-outdoor2/DSC02511.JPG,char_data/e/DSC02511.JPG_9.jpg,432,480,640,18,141,159,212,236,True,34
e,27,kaist_dataset/Mixed/Digital_Camera/(C.S)C-outdoor2/DSC02511.JPG,char_data/e/DSC02511.JPG_10.jpg,702,480,640,26,253,279,215,242,True,34
e,49,kaist_dataset/Mixed/Digital_Camera/(C.S)C-outdoor2/DSC02519.JPG,char_data/e/DSC02519.JPG_2.jpg,2107,480,640,43,430,473,206,255,True,34
e,30,kaist_dataset/Mixed/Digital_Camera/(C.S)C-outdoor2/DSC02545.JPG,char_data/e/DSC02545.JPG_5.jpg,900,480,640,30,349,379,368,398,True,34
e,31,kaist_dataset/Mixed/Digital_Camera/(C.S)C-outdoor2/DSC02560.JPG,char_data/e/DSC02560.JPG_8.jpg,682,480,640,22,296,318,304,335,True,34
e,27,kaist_dataset/Mixed/Digital_Camera/(C.S)C-outdoor2/DSC02560.JPG,char_data/e/DSC02560.JPG_9.jpg,594,480,640,22,318,340,304,331,True,34
e,25,kaist_dataset/Mixed/Digital_Camera/(C.S)C-outdoor2/DSC02560.JPG,char_data/e/DSC02560.JPG_10.jpg,625,480,640,25,381,406,306,331,True,34
e,25,kaist_dataset/Mixed/Digital_Camera/(C.S)C-outdoor2/DSC02560.JPG,char_data/e/DSC02560.JPG_11.jpg,425,480,640,17,408,425,307,332,True,34
e,71,kaist_dataset/Mixed/Digital_Camera/(C.S)C-outdoor2/DSC02701.JPG,char_data/e/DSC02701.JPG_2.jpg,4189,480,640,59,282,341,98,169,True,34
e,33,kaist_dataset/Mixed/Digital_Camera/(C.S)C-outdoor2/DSC02864.JPG,char_data/e/DSC02864.JPG_2.jpg,891,480,640,27,439,466,267,300,True,34
e,37,kaist_dataset/Mixed/Digital_Camera/(C.S)C-outdoor2/DSC02867.JPG,char_data/e/DSC02867.JPG_2.jpg,888,480,640,24,226,250,402,439,True,34
e,41,kaist_dataset/Mixed/Digital_Camera/(C.S)C-outdoor2/DSC02869.JPG,char_data/e/DSC02869.JPG_2.jpg,656,480,640,16,187,203,142,183,True,34
e,28,kaist_dataset/Mixed/Digital_Camera/(C.S)C-outdoor2/DSC02886.JPG,char_data/e/DSC02886.JPG_2.jpg,728,480,640,26,573,599,128,156,True,34
e,27,kaist_dataset/Mixed/Digital_Camera/(C.S)C-outdoor2/DSC02894.JPG,char_data/e/DSC02894.JPG_2.jpg,540,480,640,20,199,219,275,302,True,34
e,27,kaist_dataset/Mixed/Digital_Camera/(C.S)C-outdoor2/DSC02912.JPG,char_data/e/DSC02912.JPG_2.jpg,540,480,640,20,291,311,16,43,True,34
e,114,kaist_dataset/Mixed/Digital_Camera/(C.S)C-outdoor2/DSC02919.JPG,char_data/e/DSC02919.JPG_2.jpg,16188,480,640,142,354,496,353,467,True,34
e,43,kaist_dataset/Mixed/Digital_Camera/(C.S)C-outdoor2/DSC02926.JPG,char_data/e/DSC02926.JPG_2.jpg,1376,480,640,32,44,76,148,191,True,34
e,34,kaist_dataset/Mixed/Digital_Camera/(C.S)C-outdoor2/DSC02927.JPG,char_data/e/DSC02927.JPG_2.jpg,646,480,640,19,198,217,370,404,True,34
e,41,kaist_dataset/Mixed/Digital_Camera/(C.S)C-outdoor2/DSC02928.JPG,char_data/e/DSC02928.JPG_2.jpg,1148,480,640,28,334,362,390,431,True,34
e,51,kaist_dataset/Mixed/Digital_Camera/(C.S)C-outdoor2/DSC02936.JPG,char_data/e/DSC02936.JPG_6.jpg,1938,480,640,38,404,442,139,190,True,34
e,35,kaist_dataset/Mixed/Digital_Camera/(C.S)C-outdoor2/DSC02936.JPG,char_data/e/DSC02936.JPG_7.jpg,630,480,640,18,230,248,81,116,True,34
e,31,kaist_dataset/Mixed/Digital_Camera/(C.S)C-outdoor2/DSC02936.JPG,char_data/e/DSC02936.JPG_8.jpg,341,480,640,11,344,355,90,121,True,34
e,62,kaist_dataset/Mixed/Digital_Camera/(C.S)C-outdoor2/DSC02940.JPG,char_data/e/DSC02940.JPG_6.jpg,3782,480,640,61,117,178,245,307,True,34
e,73,kaist_dataset/Mixed/Digital_Camera/(C.S)C-outdoor2/DSC02940.JPG,char_data/e/DSC02940.JPG_7.jpg,4526,480,640,62,251,313,241,314,True,34
e,66,kaist_dataset/Mixed/Digital_Camera/(C.S)C-outdoor2/DSC02940.JPG,char_data/e/DSC02940.JPG_8.jpg,4092,480,640,62,478,540,259,325,True,34
e,44,kaist_dataset/Mixed/Digital_Camera/(C.S)C-outdoor3/DSC02962.JPG,char_data/e/DSC02962.JPG_8.jpg,1804,480,640,41,319,360,256,300,True,34
e,59,kaist_dataset/Mixed/Digital_Camera/(C.S)C-outdoor3/DSC02962.JPG,char_data/e/DSC02962.JPG_9.jpg,2891,480,640,49,521,570,215,274,True,34
e,45,kaist_dataset/Mixed/Digital_Camera/(C.S)C-outdoor3/DSC02962.JPG,char_data/e/DSC02962.JPG_10.jpg,1620,480,640,36,355,391,179,224,True,34
e,43,kaist_dataset/Mixed/Digital_Camera/(C.S)C-outdoor3/DSC02962.JPG,char_data/e/DSC02962.JPG_11.jpg,1419,480,640,33,101,134,228,271,True,34
e,25,kaist_dataset/Mixed/Digital_Camera/(C.S)C-outdoor3/DSC02970.JPG,char_data/e/DSC02970.JPG_2.jpg,325,480,640,13,264,277,310,335,True,34
e,43,kaist_dataset/Mixed/Digital_Camera/(C.S)C-outdoor3/DSC02978.JPG,char_data/e/DSC02978.JPG_2.jpg,1161,480,640,27,125,152,166,209,True,34
e,35,kaist_dataset/Mixed/Digital_Camera/(C.S)C-outdoor3/DSC02989.JPG,char_data/e/DSC02989.JPG_2.jpg,595,480,640,17,430,447,355,390,True,34
e,76,kaist_dataset/Mixed/Digital_Camera/(C.S)C-outdoor3/DSC03017.JPG,char_data/e/DSC03017.JPG_2.jpg,6232,480,640,82,401,483,161,237,True,34
e,29,kaist_dataset/Mixed/Digital_Camera/(C.S)C-outdoor3/DSC03020.JPG,char_data/e/DSC03020.JPG_8.jpg,348,480,640,12,466,478,304,333,True,34
e,46,kaist_dataset/Mixed/Digital_Camera/(C.S)C-outdoor3/DSC03063.JPG,char_data/e/DSC03063.JPG_2.jpg,1196,480,640,26,179,205,279,325,True,34
e,41,kaist_dataset/Mixed/Digital_Camera/(C.S)C-outdoor3/DSC03177.JPG,char_data/e/DSC03177.JPG_2.jpg,1189,480,640,29,332,361,146,187,True,34
e,26,kaist_dataset/Mixed/Digital_Camera/(C.S)C-outdoor3/DSC03186.JPG,char_data/e/DSC03186.JPG_2.jpg,598,480,640,23,189,212,111,137,True,34
e,30,kaist_dataset/Mixed/Digital_Camera/(C.S)C-outdoor3/DSC03187.JPG,char_data/e/DSC03187.JPG_2.jpg,720,480,640,24,203,227,396,426,True,34
e,26,kaist_dataset/Mixed/Digital_Camera/(C.S)C-outdoor3/DSC03209.JPG,char_data/e/DSC03209.JPG_2.jpg,676,480,640,26,301,327,426,452,True,34
e,102,kaist_dataset/Mixed/Digital_Camera/(C.S)C-outdoor3/DSC03210.JPG,char_data/e/DSC03210.JPG_2.jpg,5202,480,640,51,412,463,237,339,True,34
e,50,kaist_dataset/Mixed/Digital_Camera/(C.S)C-outdoor3/DSC03242.JPG,char_data/e/DSC03242.JPG_2.jpg,2650,480,640,53,323,376,177,227,True,34
e,69,kaist_dataset/Mixed/Digital_Camera/(C.S)C-outdoor3/DSC03260.JPG,char_data/e/DSC03260.JPG_2.jpg,3519,480,640,51,188,239,83,152,True,34
e,28,kaist_dataset/Mixed/Digital_Camera/(C.S)C-outdoor3/DSC03271.JPG,char_data/e/DSC03271.JPG_2.jpg,784,480,640,28,358,386,82,110,True,34
e,73,kaist_dataset/Mixed/Digital_Camera/(C.S)C-outdoor3/DSC03299.JPG,char_data/e/DSC03299.JPG_4.jpg,4088,480,640,56,399,455,386,459,True,34
e,74,kaist_dataset/Mixed/Digital_Camera/(C.S)C-outdoor3/DSC03299.JPG,char_data/e/DSC03299.JPG_5.jpg,3774,480,640,51,456,507,387,461,True,34
e,43,kaist_dataset/Mixed/Digital_Camera/(C.S)C-outdoor3/DSC03310.JPG,char_data/e/DSC03310.JPG_8.jpg,731,480,640,17,461,478,125,168,True,34
e,42,kaist_dataset/Mixed/Digital_Camera/(C.S)C-outdoor3/DSC03310.JPG,char_data/e/DSC03310.JPG_9.jpg,840,480,640,20,479,499,126,168,True,34
e,40,kaist_dataset/Mixed/Digital_Camera/(C.S)C-outdoor3/DSC03310.JPG,char_data/e/DSC03310.JPG_10.jpg,600,480,640,15,540,555,125,165,True,34
e,39,kaist_dataset/Mixed/Digital_Camera/(C.S)C-outdoor3/DSC03310.JPG,char_data/e/DSC03310.JPG_11.jpg,780,480,640,20,555,575,128,167,True,34
e,29,kaist_dataset/Mixed/Digital_Camera/(C.S)C-outdoor3/DSC03328.JPG,char_data/e/DSC03328.JPG_2.jpg,406,480,640,14,359,373,242,271,True,34
e,37,kaist_dataset/Mixed/Digital_Camera/(C.S)C-outdoor3/DSC03332.JPG,char_data/e/DSC03332.JPG_2.jpg,1258,480,640,34,333,367,231,268,True,34
e,58,kaist_dataset/Mixed/Digital_Camera/(C.S)C-outdoor3/DSC03409.JPG,char_data/e/DSC03409.JPG_4.jpg,2610,480,640,45,303,348,139,197,True,34
e,61,kaist_dataset/Mixed/Digital_Camera/(C.S)C-outdoor3/DSC03409.JPG,char_data/e/DSC03409.JPG_5.jpg,2867,480,640,47,369,416,137,198,True,34
e,77,kaist_dataset/Mixed/Digital_Camera/(C.S)C-outdoor3/DSC03421.JPG,char_data/e/DSC03421.JPG_6.jpg,2695,480,640,35,98,133,231,308,True,34
e,71,kaist_dataset/Mixed/Digital_Camera/(C.S)C-outdoor3/DSC03421.JPG,char_data/e/DSC03421.JPG_7.jpg,2556,480,640,36,393,429,248,319,True,34
e,92,kaist_dataset/Mixed/Digital_Camera/(C.S)C-outdoor3/DSC03421.JPG,char_data/e/DSC03421.JPG_8.jpg,6072,480,640,66,182,248,90,182,True,34
e,67,kaist_dataset/Mixed/Digital_Camera/(C.S)C-outdoor3/DSC03422.JPG,char_data/e/DSC03422.JPG_4.jpg,2345,480,640,35,203,238,253,320,True,34
e,56,kaist_dataset/Mixed/Digital_Camera/(C.S)C-outdoor3/DSC03422.JPG,char_data/e/DSC03422.JPG_5.jpg,1400,480,640,25,399,424,264,320,True,34
e,70,kaist_dataset/Mixed/Digital_Camera/(C.S)C-outdoor3/P1010016.JPG,char_data/e/P1010016.JPG_2.jpg,2660,480,640,38,396,434,183,253,True,34
e,69,kaist_dataset/Mixed/Digital_Camera/(C.S)C-outdoor4/DSC03544.JPG,char_data/e/DSC03544.JPG_2.jpg,2553,480,640,37,118,155,185,254,True,34
e,24,kaist_dataset/Mixed/Digital_Camera/(C.S)C-outdoor4/DSC03552.JPG,char_data/e/DSC03552.JPG_2.jpg,312,480,640,13,322,335,324,348,True,34
e,30,kaist_dataset/Mixed/Digital_Camera/(C.S)C-outdoor4/DSC03556.JPG,char_data/e/DSC03556.JPG_10.jpg,330,480,640,11,205,216,322,352,True,34
e,24,kaist_dataset/Mixed/Digital_Camera/(C.S)C-outdoor4/DSC03556.JPG,char_data/e/DSC03556.JPG_11.jpg,288,480,640,12,400,412,325,349,True,34
e,21,kaist_dataset/Mixed/Digital_Camera/(C.S)C-outdoor4/DSC03556.JPG,char_data/e/DSC03556.JPG_12.jpg,168,480,640,8,502,510,328,349,True,34
e,25,kaist_dataset/Mixed/Digital_Camera/(C.S)C-outdoor4/DSC03556.JPG,char_data/e/DSC03556.JPG_13.jpg,300,480,640,12,518,530,324,349,True,34
e,24,kaist_dataset/Mixed/Digital_Camera/(C.S)C-outdoor4/DSC03556.JPG,char_data/e/DSC03556.JPG_14.jpg,240,480,640,10,602,612,324,348,True,34
e,39,kaist_dataset/Mixed/Digital_Camera/(C.S)C-outdoor4/DSC03569.JPG,char_data/e/DSC03569.JPG_2.jpg,1053,480,640,27,294,321,180,219,True,34
e,66,kaist_dataset/Mixed/Digital_Camera/(C.S)C-outdoor4/DSC03572.JPG,char_data/e/DSC03572.JPG_2.jpg,3498,480,640,53,525,578,132,198,True,34
e,34,kaist_dataset/Mixed/Digital_Camera/(C.S)C-outdoor4/DSC03586.JPG,char_data/e/DSC03586.JPG_2.jpg,782,480,640,23,235,258,158,192,True,34
e,49,kaist_dataset/Mixed/Digital_Camera/(C.S)C-outdoor4/DSC03642.JPG,char_data/e/DSC03642.JPG_8.jpg,1225,480,640,25,176,201,251,300,True,34
e,41,kaist_dataset/Mixed/Digital_Camera/(C.S)C-outdoor4/DSC03642.JPG,char_data/e/DSC03642.JPG_9.jpg,1148,480,640,28,460,488,245,286,True,34
e,44,kaist_dataset/Mixed/Digital_Camera/(C.S)C-outdoor4/DSC03642.JPG,char_data/e/DSC03642.JPG_10.jpg,1232,480,640,28,529,557,243,287,True,34
e,56,kaist_dataset/Mixed/Digital_Camera/(C.S)C-outdoor4/DSC03643.JPG,char_data/e/DSC03643.JPG_6.jpg,2576,480,640,46,34,80,248,304,True,34
e,45,kaist_dataset/Mixed/Digital_Camera/(C.S)C-outdoor4/DSC03643.JPG,char_data/e/DSC03643.JPG_7.jpg,1575,480,640,35,434,469,278,323,True,34
e,44,kaist_dataset/Mixed/Digital_Camera/(C.S)C-outdoor4/DSC03643.JPG,char_data/e/DSC03643.JPG_8.jpg,1452,480,640,33,529,562,282,326,True,34
e,73,kaist_dataset/Mixed/Digital_Camera/(C.S)C-outdoor4/DSC03651.JPG,char_data/e/DSC03651.JPG_2.jpg,5402,480,640,74,473,547,180,253,True,34
e,28,kaist_dataset/Mixed/Digital_Camera/(C.S)C-outdoor4/DSC03661.JPG,char_data/e/DSC03661.JPG_7.jpg,420,480,640,15,120,135,276,304,True,34
e,21,kaist_dataset/Mixed/Digital_Camera/(C.S)C-outdoor4/DSC03670.JPG,char_data/e/DSC03670.JPG_2.jpg,252,480,640,12,425,437,325,346,True,34
e,32,kaist_dataset/Mixed/Digital_Camera/(C.S)C-outdoor4/DSC03672.JPG,char_data/e/DSC03672.JPG_2.jpg,832,480,640,26,275,301,413,445,True,34
e,26,kaist_dataset/Mixed/Digital_Camera/(C.S)C-outdoor4/DSC03677.JPG,char_data/e/DSC03677.JPG_2.jpg,234,480,640,9,486,495,318,344,True,34
e,29,kaist_dataset/Mixed/Digital_Camera/(C.S)C-outdoor4/DSC03682.JPG,char_data/e/DSC03682.JPG_4.jpg,493,480,640,17,419,436,328,357,True,34
e,24,kaist_dataset/Mixed/Digital_Camera/(C.S)C-outdoor4/DSC03682.JPG,char_data/e/DSC03682.JPG_5.jpg,504,480,640,21,549,570,334,358,True,34
e,30,kaist_dataset/Mixed/Digital_Camera/(C.S)C-outdoor4/DSC03758.JPG,char_data/e/DSC03758.JPG_8.jpg,420,480,640,14,220,234,233,263,True,34
e,24,kaist_dataset/Mixed/Digital_Camera/(C.S)C-outdoor4/DSC03758.JPG,char_data/e/DSC03758.JPG_9.jpg,360,480,640,15,234,249,237,261,True,34
e,23,kaist_dataset/Mixed/Digital_Camera/(C.S)C-outdoor4/DSC03758.JPG,char_data/e/DSC03758.JPG_10.jpg,299,480,640,13,204,217,280,303,True,34
e,21,kaist_dataset/Mixed/Digital_Camera/(C.S)C-outdoor4/DSC03758.JPG,char_data/e/DSC03758.JPG_11.jpg,231,480,640,11,218,229,279,300,True,34
e,45,kaist_dataset/Mixed/Digital_Camera/(C.S)C-outdoor4/DSC03781.JPG,char_data/e/DSC03781.JPG_6.jpg,2250,480,640,50,385,435,315,360,True,34
e,36,kaist_dataset/Mixed/Digital_Camera/(C.S)C-outdoor4/DSC03781.JPG,char_data/e/DSC03781.JPG_8.jpg,1440,480,640,40,359,399,228,264,True,34
e,60,kaist_dataset/Mixed/Digital_Camera/(C.S)C-outdoor4/DSC03784.JPG,char_data/e/DSC03784.JPG_6.jpg,1860,480,640,31,184,215,321,381,True,34
e,58,kaist_dataset/Mixed/Digital_Camera/(C.S)C-outdoor4/DSC03784.JPG,char_data/e/DSC03784.JPG_7.jpg,2030,480,640,35,242,277,319,377,True,34
e,56,kaist_dataset/Mixed/Digital_Camera/(C.S)C-outdoor4/DSC03784.JPG,char_data/e/DSC03784.JPG_8.jpg,1848,480,640,33,344,377,324,380,True,34
e,58,kaist_dataset/Mixed/Digital_Camera/(C.S)C-outdoor5/DSC03820.JPG,char_data/e/DSC03820.JPG_2.jpg,2146,480,640,37,141,178,377,435,True,34
e,35,kaist_dataset/Mixed/Digital_Camera/(C.S)C-outdoor5/DSC03821.JPG,char_data/e/DSC03821.JPG_6.jpg,700,480,640,20,85,105,34,69,True,34
e,32,kaist_dataset/Mixed/Digital_Camera/(C.S)C-outdoor5/DSC03821.JPG,char_data/e/DSC03821.JPG_7.jpg,672,480,640,21,247,268,39,71,True,34
e,38,kaist_dataset/Mixed/Digital_Camera/(C.S)C-outdoor5/DSC03821.JPG,char_data/e/DSC03821.JPG_8.jpg,912,480,640,24,469,493,44,82,True,34
e,38,kaist_dataset/Mixed/Digital_Camera/(C.S)C-outdoor5/DSC03839.JPG,char_data/e/DSC03839.JPG_6.jpg,684,480,640,18,193,211,37,75,True,34
e,32,kaist_dataset/Mixed/Digital_Camera/(C.S)C-outdoor5/DSC03839.JPG,char_data/e/DSC03839.JPG_7.jpg,544,480,640,17,394,411,41,73,True,34
e,27,kaist_dataset/Mixed/Digital_Camera/(C.S)C-outdoor5/DSC03839.JPG,char_data/e/DSC03839.JPG_8.jpg,378,480,640,14,223,237,372,399,True,34
e,39,kaist_dataset/Mixed/Digital_Camera/(C.S)C-outdoor5/DSC04015.JPG,char_data/e/DSC04015.JPG_2.jpg,1014,480,640,26,307,333,128,167,True,34
e,55,kaist_dataset/Mixed/Digital_Camera/(C.S)C-outdoor5/DSC04029.JPG,char_data/e/DSC04029.JPG_4.jpg,1925,480,640,35,268,303,176,231,True,34
e,50,kaist_dataset/Mixed/Digital_Camera/(C.S)C-outdoor5/DSC04029.JPG,char_data/e/DSC04029.JPG_5.jpg,1500,480,640,30,419,449,180,230,True,34
e,27,kaist_dataset/Mixed/Digital_Camera/(C.S)C-outdoor5/DSC04057.JPG,char_data/e/DSC04057.JPG_6.jpg,459,480,640,17,114,131,125,152,True,34
e,28,kaist_dataset/Mixed/Digital_Camera/(C.S)C-outdoor5/DSC04057.JPG,char_data/e/DSC04057.JPG_7.jpg,532,480,640,19,131,150,125,153,True,34
e,27,kaist_dataset/Mixed/Digital_Camera/(C.S)C-outdoor5/DSC04057.JPG,char_data/e/DSC04057.JPG_8.jpg,459,480,640,17,221,238,122,149,True,34
e,32,kaist_dataset/Mixed/Digital_Camera/(C.S)C-outdoor5/DSC04069.JPG,char_data/e/DSC04069.JPG_6.jpg,864,480,640,27,83,110,391,423,True,34
e,35,kaist_dataset/Mixed/Digital_Camera/(C.S)C-outdoor5/DSC04069.JPG,char_data/e/DSC04069.JPG_7.jpg,700,480,640,20,132,152,387,422,True,34
e,28,kaist_dataset/Mixed/Digital_Camera/(C.S)C-outdoor5/DSC04069.JPG,char_data/e/DSC04069.JPG_8.jpg,504,480,640,18,232,250,387,415,True,34
e,33,kaist_dataset/Mixed/Digital_Camera/(C.S)C-outdoor5/DSC04070.JPG,char_data/e/DSC04070.JPG_4.jpg,429,480,640,13,234,247,111,144,True,34
e,35,kaist_dataset/Mixed/Digital_Camera/(C.S)C-outdoor5/DSC04076.JPG,char_data/e/DSC04076.JPG_4.jpg,1190,480,640,34,365,399,106,141,True,34
e,36,kaist_dataset/Mixed/Digital_Camera/(C.S)C-outdoor5/DSC04076.JPG,char_data/e/DSC04076.JPG_5.jpg,1260,480,640,35,463,498,100,136,True,34
e,42,kaist_dataset/Mixed/Digital_Camera/(C.S)C-outdoor5/DSC04097.JPG,char_data/e/DSC04097.JPG_6.jpg,1428,480,640,34,330,364,202,244,True,34
e,45,kaist_dataset/Mixed/Digital_Camera/(C.S)C-outdoor5/DSC04097.JPG,char_data/e/DSC04097.JPG_7.jpg,1485,480,640,33,518,551,202,247,True,34
e,45,kaist_dataset/Mixed/Digital_Camera/(C.S)C-outdoor5/DSC04097.JPG,char_data/e/DSC04097.JPG_8.jpg,1440,480,640,32,554,586,203,248,True,34
e,36,kaist_dataset/Mixed/Digital_Camera/(C.S)C-outdoor5/DSC04104.JPG,char_data/e/DSC04104.JPG_4.jpg,900,480,640,25,234,259,47,83,True,34
e,38,kaist_dataset/Mixed/Digital_Camera/(C.S)C-outdoor5/DSC04104.JPG,char_data/e/DSC04104.JPG_5.jpg,912,480,640,24,292,316,47,85,True,34
e,75,kaist_dataset/Mixed/Digital_Camera/(C.S)C-outdoor5/DSC04115.JPG,char_data/e/DSC04115.JPG_4.jpg,5250,480,640,70,419,489,199,274,True,34
e,76,kaist_dataset/Mixed/Digital_Camera/(C.S)C-outdoor5/DSC04115.JPG,char_data/e/DSC04115.JPG_5.jpg,5472,480,640,72,487,559,199,275,True,34
e,28,kaist_dataset/Mixed/Digital_Camera/(C.S)C-outdoor5/DSC04125.JPG,char_data/e/DSC04125.JPG_6.jpg,448,480,640,16,95,111,431,459,True,34
e,28,kaist_dataset/Mixed/Digital_Camera/(C.S)C-outdoor5/DSC04125.JPG,char_data/e/DSC04125.JPG_7.jpg,448,480,640,16,124,140,430,458,True,34
e,29,kaist_dataset/Mixed/Digital_Camera/(C.S)C-outdoor5/DSC04125.JPG,char_data/e/DSC04125.JPG_8.jpg,435,480,640,15,205,220,428,457,True,34
e,78,kaist_dataset/Mixed/Digital_Camera/(C.S)C-outdoor5/DSC04128.JPG,char_data/e/DSC04128.JPG_6.jpg,5070,480,640,65,283,348,211,289,True,34
e,73,kaist_dataset/Mixed/Digital_Camera/(C.S)C-outdoor5/DSC04128.JPG,char_data/e/DSC04128.JPG_7.jpg,4818,480,640,66,347,413,210,283,True,34
e,84,kaist_dataset/Mixed/Digital_Camera/(C.S)C-outdoor5/DSC04128.JPG,char_data/e/DSC04128.JPG_8.jpg,5880,480,640,70,473,543,206,290,True,34
e,36,kaist_dataset/Mixed/Digital_Camera/(C.S)C-outdoor5/DSC04129.JPG,char_data/e/DSC04129.JPG_6.jpg,864,480,640,24,87,111,411,447,True,34
e,34,kaist_dataset/Mixed/Digital_Camera/(C.S)C-outdoor5/DSC04151.JPG,char_data/e/DSC04151.JPG_4.jpg,782,480,640,23,130,153,337,371,True,34
e,28,kaist_dataset/Mixed/Digital_Camera/(C.S)C-outdoor5/DSC04154.JPG,char_data/e/DSC04154.JPG_2.jpg,672,480,640,24,517,541,246,274,True,34
e,38,kaist_dataset/Mixed/Digital_Camera/(C.S)C-outdoor5/DSC04162.JPG,char_data/e/DSC04162.JPG_2.jpg,1406,480,640,37,272,309,332,370,True,34
e,32,kaist_dataset/Mixed/Digital_Camera/(C.S)C-outdoor5/DSC04321.JPG,char_data/e/DSC04321.JPG_2.jpg,672,480,640,21,482,503,207,239,True,34
e,43,kaist_dataset/Mixed/Digital_Camera/(C.S)C-outdoor5/DSC04322.JPG,char_data/e/DSC04322.JPG_8.jpg,1075,480,640,25,179,204,218,261,True,34
e,35,kaist_dataset/Mixed/Digital_Camera/(C.S)C-outdoor5/DSC04322.JPG,char_data/e/DSC04322.JPG_10.jpg,805,480,640,23,252,275,226,261,True,34
e,37,kaist_dataset/Mixed/Digital_Camera/(C.S)C-outdoor5/DSC04322.JPG,char_data/e/DSC04322.JPG_11.jpg,999,480,640,27,302,329,222,259,True,34
e,32,kaist_dataset/Mixed/Digital_Camera/(C.S)C-outdoor5/DSC04323.JPG,char_data/e/DSC04323.JPG_10.jpg,672,480,640,21,230,251,206,238,True,34
e,37,kaist_dataset/Mixed/Digital_Camera/(C.S)C-outdoor5/DSC04323.JPG,char_data/e/DSC04323.JPG_11.jpg,777,480,640,21,284,305,203,240,True,34
e,36,kaist_dataset/Mixed/Digital_Camera/(C.S)C-outdoor5/DSC04323.JPG,char_data/e/DSC04323.JPG_12.jpg,648,480,640,18,327,345,204,240,True,34
e,36,kaist_dataset/Mixed/Digital_Camera/(C.S)C-outdoor5/DSC04323.JPG,char_data/e/DSC04323.JPG_13.jpg,612,480,640,17,442,459,207,243,True,34
e,39,kaist_dataset/Mixed/Digital_Camera/(C.S)C-outdoor5/DSC04323.JPG,char_data/e/DSC04323.JPG_14.jpg,702,480,640,18,494,512,207,246,True,34
e,41,kaist_dataset/Mixed/Digital_Camera/(C.S)C-outdoor5/DSC04338.JPG,char_data/e/DSC04338.JPG_5.jpg,902,480,640,22,383,405,197,238,True,34
e,26,kaist_dataset/Mixed/Digital_Camera/(C.S)C-outdoor5/DSC04357.JPG,char_data/e/DSC04357.JPG_4.jpg,442,480,640,17,429,446,353,379,True,34
e,24,kaist_dataset/Mixed/Digital_Camera/(C.S)C-outdoor5/DSC04357.JPG,char_data/e/DSC04357.JPG_5.jpg,456,480,640,19,512,531,355,379,True,34
e,50,kaist_dataset/Mixed/Digital_Camera/(C.S)C-outdoor5/DSC04399.JPG,char_data/e/DSC04399.JPG_2.jpg,1850,480,640,37,547,584,281,331,True,34
e,76,kaist_dataset/Mixed/Digital_Camera/(C.S)C-outdoor5/P1010006.JPG,char_data/e/P1010006.JPG_4.jpg,3420,480,640,45,402,447,222,298,True,34
e,73,kaist_dataset/Mixed/Digital_Camera/(C.S)C-outdoor5/P1010006.JPG,char_data/e/P1010006.JPG_5.jpg,3212,480,640,44,448,492,227,300,True,34
e,67,kaist_dataset/Mixed/Digital_Camera/(C.S)C-outdoor6/025.jpg,char_data/e/025.jpg_4.jpg,4757,293,472,71,203,274,61,128,True,34
e,65,kaist_dataset/Mixed/Digital_Camera/(C.S)C-outdoor6/025.jpg,char_data/e/025.jpg_5.jpg,3770,293,472,58,328,386,73,138,True,34
e,150,kaist_dataset/Mixed/Digital_Camera/(C.S)C-outdoor6/080116-0057.jpg,char_data/e/080116-0057.jpg_8.jpg,18450,1200,1600,123,532,655,355,505,True,34
e,151,kaist_dataset/Mixed/Digital_Camera/(C.S)C-outdoor6/080116-0057.jpg,char_data/e/080116-0057.jpg_9.jpg,18271,1200,1600,121,1280,1401,351,502,True,34
e,51,kaist_dataset/Mixed/Digital_Camera/(C.S)C-outdoor6/080116-0057.jpg,char_data/e/080116-0057.jpg_10.jpg,1632,1200,1600,32,1171,1203,826,877,True,34
e,43,kaist_dataset/Mixed/Digital_Camera/(C.S)C-outdoor6/080116-0057.jpg,char_data/e/080116-0057.jpg_11.jpg,1376,1200,1600,32,328,360,925,968,True,34
e,29,kaist_dataset/Mixed/Digital_Camera/(C.S)C-outdoor6/090.jpg,char_data/e/090.jpg_8.jpg,667,480,640,23,277,300,161,190,True,34
e,28,kaist_dataset/Mixed/Digital_Camera/(C.S)C-outdoor6/090.jpg,char_data/e/090.jpg_9.jpg,560,480,640,20,326,346,161,189,True,34
e,25,kaist_dataset/Mixed/Digital_Camera/(C.S)C-outdoor6/090.jpg,char_data/e/090.jpg_10.jpg,550,480,640,22,417,439,165,190,True,34
e,38,kaist_dataset/Mixed/Digital_Camera/(C.S)C-outdoor6/090.jpg,char_data/e/090.jpg_11.jpg,1178,480,640,31,439,470,157,195,True,34
e,46,kaist_dataset/Mixed/Digital_Camera/(C.S)C-outdoor6/117.JPG,char_data/e/117.JPG_2.jpg,2116,480,640,46,575,621,202,248,True,34
e,24,kaist_dataset/Mixed/Digital_Camera/(C.S)C-outdoor6/P1010020.JPG,char_data/e/P1010020.JPG_2.jpg,312,480,640,13,103,116,341,365,True,34
e,31,kaist_dataset/Mixed/Digital_Camera/(C.S)C-outdoor6/P1010021.JPG,char_data/e/P1010021.JPG_2.jpg,775,480,640,25,50,75,223,254,True,34
e,23,kaist_dataset/Mixed/Digital_Camera/(C.S)C-outdoor6/P1010065.JPG,char_data/e/P1010065.JPG_10.jpg,322,480,640,14,209,223,236,259,True,34
e,16,kaist_dataset/Mixed/Digital_Camera/(C.S)C-outdoor6/P1010065.JPG,char_data/e/P1010065.JPG_11.jpg,144,480,640,9,233,242,239,255,True,34
e,17,kaist_dataset/Mixed/Digital_Camera/(C.S)C-outdoor6/P1010065.JPG,char_data/e/P1010065.JPG_12.jpg,221,480,640,13,296,309,237,254,True,34
e,28,kaist_dataset/Mixed/Digital_Camera/(C.S)C-outdoor6/P1010075.JPG,char_data/e/P1010075.JPG_2.jpg,336,480,640,12,405,417,311,339,True,34
e,37,kaist_dataset/Mixed/Digital_Camera/(C.S)C-outdoor6/P1010085.JPG,char_data/e/P1010085.JPG_2.jpg,851,480,640,23,146,169,129,166,True,34
e,63,kaist_dataset/Mixed/Digital_Camera/(C.S)C-outdoor6/P1010116.JPG,char_data/e/P1010116.JPG_2.jpg,1134,480,640,18,284,302,197,260,True,34
e,23,kaist_dataset/Mixed/Digital_Camera/(C.S)C-outdoor6/P1010132.JPG,char_data/e/P1010132.JPG_2.jpg,368,480,640,16,168,184,108,131,True,34
e,22,kaist_dataset/Mixed/Digital_Camera/(C.S)C-outdoor6/P1010138.JPG,char_data/e/P1010138.JPG_5.jpg,352,480,640,16,113,129,183,205,True,34
e,27,kaist_dataset/Mixed/Digital_Camera/(C.S)C-outdoor6/크기변환_P1010029.JPG,char_data/e/크기변환_P1010029.JPG_8.jpg,459,480,640,17,111,128,19,46,True,34
e,24,kaist_dataset/Mixed/Digital_Camera/(C.S)C-outdoor6/크기변환_P1010029.JPG,char_data/e/크기변환_P1010029.JPG_9.jpg,360,480,640,15,193,208,21,45,True,34
e,29,kaist_dataset/Mixed/Digital_Camera/(C.S)C-outdoor6/크기변환_P1010029.JPG,char_data/e/크기변환_P1010029.JPG_10.jpg,522,480,640,18,233,251,15,44,True,34
e,21,kaist_dataset/Mixed/Digital_Camera/(C.S)C-outdoor6/크기변환_P1010029.JPG,char_data/e/크기변환_P1010029.JPG_11.jpg,273,480,640,13,272,285,23,44,True,34
e,38,kaist_dataset/Mixed/Digital_Camera/(C.S)D-indoor1/DSC02711.JPG,char_data/e/DSC02711.JPG_2.jpg,1330,480,640,35,155,190,244,282,False,34
e,32,kaist_dataset/Mixed/Digital_Camera/(C.S)D-indoor1/DSC02718.JPG,char_data/e/DSC02718.JPG_4.jpg,384,480,640,12,169,181,241,273,False,34
e,26,kaist_dataset/Mixed/Digital_Camera/(C.S)D-indoor1/DSC02718.JPG,char_data/e/DSC02718.JPG_5.jpg,364,480,640,14,203,217,249,275,False,34
e,52,kaist_dataset/Mixed/Digital_Camera/(C.S)D-indoor1/DSC02770.JPG,char_data/e/DSC02770.JPG_4.jpg,2184,480,640,42,304,346,358,410,False,34
e,55,kaist_dataset/Mixed/Digital_Camera/(C.S)D-indoor1/DSC02770.JPG,char_data/e/DSC02770.JPG_5.jpg,2530,480,640,46,497,543,360,415,False,34
e,33,kaist_dataset/Mixed/Digital_Camera/(C.S)D-indoor1/DSC02787.JPG,char_data/e/DSC02787.JPG_6.jpg,429,480,640,13,71,84,394,427,False,34
e,36,kaist_dataset/Mixed/Digital_Camera/(C.S)D-indoor1/DSC02787.JPG,char_data/e/DSC02787.JPG_8.jpg,648,480,640,18,545,563,361,397,False,34
e,32,kaist_dataset/Mixed/Digital_Camera/(C.S)D-indoor1/DSC02804.JPG,char_data/e/DSC02804.JPG_2.jpg,704,480,640,22,414,436,353,385,False,34
e,35,kaist_dataset/Mixed/Digital_Camera/(C.S)D-indoor1/DSC03073.JPG,char_data/e/DSC03073.JPG_2.jpg,665,480,640,19,339,358,340,375,False,34
e,41,kaist_dataset/Mixed/Digital_Camera/(C.S)D-indoor1/DSC03094.JPG,char_data/e/DSC03094.JPG_2.jpg,1148,480,640,28,270,298,146,187,False,34
e,27,kaist_dataset/Mixed/Digital_Camera/(C.S)D-indoor1/DSC03096.JPG,char_data/e/DSC03096.JPG_4.jpg,513,480,640,19,276,295,427,454,False,34
e,32,kaist_dataset/Mixed/Digital_Camera/(C.S)D-indoor1/DSC03096.JPG,char_data/e/DSC03096.JPG_5.jpg,512,480,640,16,521,537,425,457,False,34
e,38,kaist_dataset/Mixed/Digital_Camera/(C.S)D-indoor1/DSC03118.JPG,char_data/e/DSC03118.JPG_6.jpg,836,480,640,22,202,224,158,196,False,34
e,42,kaist_dataset/Mixed/Digital_Camera/(C.S)D-indoor1/DSC03118.JPG,char_data/e/DSC03118.JPG_7.jpg,924,480,640,22,230,252,231,273,False,34
e,39,kaist_dataset/Mixed/Digital_Camera/(C.S)D-indoor1/DSC03118.JPG,char_data/e/DSC03118.JPG_8.jpg,1014,480,640,26,457,483,229,268,False,34
e,41,kaist_dataset/Mixed/Digital_Camera/(C.S)D-indoor1/DSC03119.JPG,char_data/e/DSC03119.JPG_2.jpg,1230,480,640,30,332,362,168,209,False,34
e,50,kaist_dataset/Mixed/Digital_Camera/(C.S)D-indoor1/DSC03121.JPG,char_data/e/DSC03121.JPG_2.jpg,1750,480,640,35,359,394,203,253,False,34
e,35,kaist_dataset/Mixed/Digital_Camera/(C.S)D-indoor1/DSC03122.JPG,char_data/e/DSC03122.JPG_2.jpg,700,480,640,20,303,323,152,187,False,34
e,40,kaist_dataset/Mixed/Digital_Camera/(C.S)D-indoor1/DSC03123.JPG,char_data/e/DSC03123.JPG_2.jpg,1240,480,640,31,346,377,185,225,False,34
e,31,kaist_dataset/Mixed/Digital_Camera/(C.S)D-indoor1/DSC03124.JPG,char_data/e/DSC03124.JPG_2.jpg,961,480,640,31,373,404,204,235,False,34
e,39,kaist_dataset/Mixed/Digital_Camera/(C.S)D-indoor1/DSC03126.JPG,char_data/e/DSC03126.JPG_2.jpg,1131,480,640,29,370,399,224,263,False,34
e,46,kaist_dataset/Mixed/Digital_Camera/(C.S)D-indoor1/DSC03130.JPG,char_data/e/DSC03130.JPG_2.jpg,1380,480,640,30,315,345,180,226,False,34
e,46,kaist_dataset/Mixed/Digital_Camera/(C.S)D-indoor1/DSC03131.JPG,char_data/e/DSC03131.JPG_2.jpg,1380,480,640,30,283,313,133,179,False,34
e,33,kaist_dataset/Mixed/Digital_Camera/(C.S)D-indoor1/DSC03132.JPG,char_data/e/DSC03132.JPG_6.jpg,924,480,640,28,242,270,184,217,False,34
e,40,kaist_dataset/Mixed/Digital_Camera/(C.S)D-indoor1/DSC03132.JPG,char_data/e/DSC03132.JPG_7.jpg,1120,480,640,28,143,171,248,288,False,34
e,37,kaist_dataset/Mixed/Digital_Camera/(C.S)D-indoor1/DSC03132.JPG,char_data/e/DSC03132.JPG_8.jpg,1110,480,640,30,341,371,253,290,False,34
e,41,kaist_dataset/Mixed/Digital_Camera/(C.S)D-indoor1/DSC03133.JPG,char_data/e/DSC03133.JPG_2.jpg,1148,480,640,28,232,260,155,196,False,34
e,39,kaist_dataset/Mixed/Digital_Camera/(C.S)D-indoor1/DSC03134.JPG,char_data/e/DSC03134.JPG_2.jpg,897,480,640,23,282,305,172,211,False,34
e,45,kaist_dataset/Mixed/Digital_Camera/(C.S)D-indoor1/DSC03135.JPG,char_data/e/DSC03135.JPG_2.jpg,1440,480,640,32,246,278,183,228,False,34
e,63,kaist_dataset/Mixed/Digital_Camera/(C.S)D-indoor1/DSC03455.JPG,char_data/e/DSC03455.JPG_2.jpg,2457,480,640,39,205,244,396,459,False,34
e,58,kaist_dataset/Mixed/Digital_Camera/(C.S)D-indoor1/DSC03460.JPG,char_data/e/DSC03460.JPG_2.jpg,1856,480,640,32,210,242,387,445,False,34
e,35,kaist_dataset/Mixed/Digital_Camera/(C.S)D-indoor1/DSC03466.JPG,char_data/e/DSC03466.JPG_2.jpg,840,480,640,24,279,303,233,268,False,34
e,85,kaist_dataset/Mixed/Digital_Camera/(C.S)D-indoor1/DSC03472.JPG,char_data/e/DSC03472.JPG_2.jpg,3315,480,640,39,280,319,19,104,False,34
e,79,kaist_dataset/Mixed/Digital_Camera/(C.S)D-indoor1/DSC03501.JPG,char_data/e/DSC03501.JPG_4.jpg,5925,480,640,75,143,218,219,298,False,34
e,73,kaist_dataset/Mixed/Digital_Camera/(C.S)D-indoor1/DSC03501.JPG,char_data/e/DSC03501.JPG_5.jpg,4672,480,640,64,357,421,226,299,False,34
e,80,kaist_dataset/Mixed/Digital_Camera/(C.S)D-indoor1/DSC03909.JPG,char_data/e/DSC03909.JPG_6.jpg,4080,480,640,51,248,299,104,184,False,34
e,81,kaist_dataset/Mixed/Digital_Camera/(C.S)D-indoor1/DSC03909.JPG,char_data/e/DSC03909.JPG_7.jpg,4536,480,640,56,401,457,102,183,False,34
e,78,kaist_dataset/Mixed/Digital_Camera/(C.S)D-indoor1/DSC03909.JPG,char_data/e/DSC03909.JPG_8.jpg,4212,480,640,54,324,378,201,279,False,34
e,46,kaist_dataset/Mixed/Digital_Camera/(C.S)D-indoor1/DSC03912.JPG,char_data/e/DSC03912.JPG_2.jpg,1104,480,640,24,344,368,45,91,False,34
e,49,kaist_dataset/Mixed/Digital_Camera/(C.S)D-indoor1/DSC03913.JPG,char_data/e/DSC03913.JPG_2.jpg,1715,480,640,35,397,432,117,166,False,34
e,53,kaist_dataset/Mixed/Digital_Camera/(C.S)D-indoor1/DSC03925.JPG,char_data/e/DSC03925.JPG_2.jpg,2173,480,640,41,497,538,382,435,False,34
e,40,kaist_dataset/Mixed/Digital_Camera/(C.S)D-indoor1/DSC03953.JPG,char_data/e/DSC03953.JPG_2.jpg,720,480,640,18,249,267,386,426,False,34
e,26,kaist_dataset/Mixed/Digital_Camera/(C.S)D-indoor1/DSC04022.JPG,char_data/e/DSC04022.JPG_2.jpg,546,480,640,21,316,337,175,201,False,34
e,45,kaist_dataset/Mixed/Digital_Camera/(C.S)D-indoor1/DSC04183.JPG,char_data/e/DSC04183.JPG_2.jpg,1035,480,640,23,200,223,246,291,False,34
e,31,kaist_dataset/Mixed/Digital_Camera/(C.S)D-indoor1/DSC04206.JPG,char_data/e/DSC04206.JPG_4.jpg,434,480,640,14,157,171,287,318,False,34
e,35,kaist_dataset/Mixed/Digital_Camera/(C.S)D-indoor1/DSC04206.JPG,char_data/e/DSC04206.JPG_5.jpg,560,480,640,16,355,371,293,328,False,34
e,36,kaist_dataset/Mixed/Digital_Camera/(C.S)D-indoor1/DSC04244.JPG,char_data/e/DSC04244.JPG_6.jpg,792,480,640,22,205,227,233,269,False,34
e,36,kaist_dataset/Mixed/Digital_Camera/(C.S)D-indoor1/DSC04244.JPG,char_data/e/DSC04244.JPG_7.jpg,792,480,640,22,342,364,238,274,False,34
e,35,kaist_dataset/Mixed/Digital_Camera/(C.S)D-indoor1/DSC04244.JPG,char_data/e/DSC04244.JPG_8.jpg,840,480,640,24,388,412,240,275,False,34
e,32,kaist_dataset/Mixed/Digital_Camera/(C.S)D-indoor1/DSC04246.JPG,char_data/e/DSC04246.JPG_4.jpg,544,480,640,17,255,272,254,286,False,34
e,37,kaist_dataset/Mixed/Digital_Camera/(C.S)D-indoor1/DSC04246.JPG,char_data/e/DSC04246.JPG_5.jpg,703,480,640,19,403,422,250,287,False,34
e,29,kaist_dataset/Mixed/Digital_Camera/(C.S)D-indoor2/DSC04248.JPG,char_data/e/DSC04248.JPG_6.jpg,667,480,640,23,236,259,228,257,False,34
e,36,kaist_dataset/Mixed/Digital_Camera/(C.S)D-indoor2/DSC04248.JPG,char_data/e/DSC04248.JPG_7.jpg,684,480,640,19,279,298,223,259,False,34
e,36,kaist_dataset/Mixed/Digital_Camera/(C.S)D-indoor2/DSC04248.JPG,char_data/e/DSC04248.JPG_8.jpg,972,480,640,27,341,368,223,259,False,34
e,38,kaist_dataset/Mixed/Digital_Camera/(C.S)D-indoor2/DSC04249.JPG,char_data/e/DSC04249.JPG_2.jpg,988,480,640,26,180,206,219,257,False,34
e,27,kaist_dataset/Mixed/Digital_Camera/(C.S)D-indoor2/DSC04254.JPG,char_data/e/DSC04254.JPG_8.jpg,594,480,640,22,300,322,349,376,False,34
e,28,kaist_dataset/Mixed/Digital_Camera/(C.S)D-indoor2/DSC04254.JPG,char_data/e/DSC04254.JPG_10.jpg,476,480,640,17,502,519,343,371,False,34
e,28,kaist_dataset/Mixed/Digital_Camera/(C.S)D-indoor2/DSC04254.JPG,char_data/e/DSC04254.JPG_11.jpg,448,480,640,16,549,565,341,369,False,34
e,50,kaist_dataset/Mixed/Digital_Camera/(C.S)D-indoor2/DSC04421.JPG,char_data/e/DSC04421.JPG_5.jpg,1150,480,640,23,267,290,212,262,False,34
e,28,kaist_dataset/Mixed/Digital_Camera/(C.S)E-night/DSC02569.JPG,char_data/e/DSC02569.JPG_10.jpg,616,480,640,22,233,255,277,305,False,34
e,28,kaist_dataset/Mixed/Digital_Camera/(C.S)E-night/DSC02569.JPG,char_data/e/DSC02569.JPG_11.jpg,448,480,640,16,301,317,276,304,False,34
e,28,kaist_dataset/Mixed/Digital_Camera/(C.S)E-night/DSC02569.JPG,char_data/e/DSC02569.JPG_13.jpg,476,480,640,17,412,429,273,301,False,34
e,40,kaist_dataset/Mixed/Digital_Camera/(C.S)E-night/DSC02569.JPG,char_data/e/DSC02569.JPG_14.jpg,400,480,640,10,211,221,410,450,False,34
e,35,kaist_dataset/Mixed/Digital_Camera/(C.S)E-night/DSC02574.JPG,char_data/e/DSC02574.JPG_2.jpg,805,480,640,23,381,404,155,190,False,34
e,112,kaist_dataset/Mixed/Digital_Camera/(C.S)E-night/DSC02585.JPG,char_data/e/DSC02585.JPG_2.jpg,11984,480,640,107,339,446,264,376,False,34
e,106,kaist_dataset/Mixed/Digital_Camera/(C.S)E-night/DSC02586.JPG,char_data/e/DSC02586.JPG_2.jpg,10600,480,640,100,415,515,246,352,False,34
e,34,kaist_dataset/Mixed/Digital_Camera/(C.S)E-night/DSC02623.JPG,char_data/e/DSC02623.JPG_4.jpg,1020,480,640,30,457,487,401,435,False,34
e,34,kaist_dataset/Mixed/Digital_Camera/(C.S)E-night/DSC02623.JPG,char_data/e/DSC02623.JPG_5.jpg,952,480,640,28,488,516,399,433,False,34
e,26,kaist_dataset/Mixed/Digital_Camera/(C.S)E-night/DSC02647.JPG,char_data/e/DSC02647.JPG_2.jpg,702,480,640,27,134,161,301,327,False,34
e,30,kaist_dataset/Mixed/Digital_Camera/(C.S)E-night/DSC03031.JPG,char_data/e/DSC03031.JPG_10.jpg,450,480,640,15,172,187,26,56,False,34
e,27,kaist_dataset/Mixed/Digital_Camera/(C.S)E-night/DSC03031.JPG,char_data/e/DSC03031.JPG_11.jpg,459,480,640,17,292,309,27,54,False,34
e,28,kaist_dataset/Mixed/Digital_Camera/(C.S)E-night/DSC03031.JPG,char_data/e/DSC03031.JPG_12.jpg,392,480,640,14,310,324,28,56,False,34
e,19,kaist_dataset/Mixed/Digital_Camera/(C.S)E-night/P1010151.JPG,char_data/e/P1010151.JPG_2.jpg,342,480,640,18,516,534,208,227,False,34
e,16,kaist_dataset/Mixed/Digital_Camera/(C.S)E-night/P1010155.JPG,char_data/e/P1010155.JPG_2.jpg,208,480,640,13,415,428,293,309,False,34
e,80,kaist_dataset/Mixed/Digital_Camera/(C.S)F-others/2007-12-08-day-044.jpg,char_data/e/2007-12-08-day-044.jpg_10.jpg,4240,1200,1600,53,434,487,456,536,False,34
e,35,kaist_dataset/Mixed/Digital_Camera/(C.S)F-others/2007-12-08-day-044.jpg,char_data/e/2007-12-08-day-044.jpg_11.jpg,595,1200,1600,17,887,904,817,852,False,34
e,32,kaist_dataset/Mixed/Digital_Camera/(C.S)F-others/2007-12-08-day-044.jpg,char_data/e/2007-12-08-day-044.jpg_12.jpg,544,1200,1600,17,904,921,815,847,False,34
e,28,kaist_dataset/Mixed/Digital_Camera/(C.S)F-others/2007-12-08-day-044.jpg,char_data/e/2007-12-08-day-044.jpg_13.jpg,364,1200,1600,13,980,993,825,853,False,34
e,30,kaist_dataset/Mixed/Digital_Camera/(C.S)F-others/2007-12-08-day-044.jpg,char_data/e/2007-12-08-day-044.jpg_14.jpg,480,1200,1600,16,993,1009,823,853,False,34
e,37,kaist_dataset/Mixed/Digital_Camera/(C.S)F-others/2007-12-08-day-067.jpg,char_data/e/2007-12-08-day-067.jpg_6.jpg,1739,1600,1200,47,440,487,957,994,False,34
e,34,kaist_dataset/Mixed/Digital_Camera/(C.S)F-others/2007-12-08-day-067.jpg,char_data/e/2007-12-08-day-067.jpg_7.jpg,1802,1600,1200,53,430,483,1189,1223,False,34
e,36,kaist_dataset/Mixed/Digital_Camera/(C.S)F-others/2007-12-08-day-067.jpg,char_data/e/2007-12-08-day-067.jpg_8.jpg,1980,1600,1200,55,430,485,1080,1116,False,34
e,24,kaist_dataset/Mixed/Digital_Camera/(C.S)F-others/2007-12-09-day-exterior-032.jpg,char_data/e/2007-12-09-day-exterior-032.jpg_4.jpg,504,1600,1200,21,668,689,355,379,False,34
e,27,kaist_dataset/Mixed/Digital_Camera/(C.S)F-others/2007-12-09-day-exterior-032.jpg,char_data/e/2007-12-09-day-exterior-032.jpg_5.jpg,513,1600,1200,19,692,711,354,381,False,34
e,36,kaist_dataset/Mixed/Digital_Camera/(C.S)F-others/DSC02609.JPG,char_data/e/DSC02609.JPG_5.jpg,648,480,640,18,250,268,316,352,False,34
e,64,kaist_dataset/Mixed/Digital_Camera/(C.S)F-others/DSC02696.JPG,char_data/e/DSC02696.JPG_2.jpg,3392,480,640,53,260,313,314,378,False,34
e,66,kaist_dataset/Mixed/Digital_Camera/(C.S)F-others/DSC03489.JPG,char_data/e/DSC03489.JPG_2.jpg,3630,480,640,55,533,588,375,441,False,34
e,26,kaist_dataset/Mixed/Mobile_Phone/(C.M)A-outdoor/P090912062.jpg,char_data/e/P090912062.jpg_2.jpg,442,480,640,17,535,552,129,155,False,34
e,30,kaist_dataset/Mixed/Mobile_Phone/(C.M)A-outdoor/P090912078.jpg,char_data/e/P090912078.jpg_5.jpg,840,480,640,28,107,135,315,345,False,34
e,33,kaist_dataset/Mixed/Mobile_Phone/(C.M)B-indoor/P090831005.jpg,char_data/e/P090831005.jpg_4.jpg,561,480,640,17,198,215,239,272,False,34
e,29,kaist_dataset/Mixed/Mobile_Phone/(C.M)B-indoor/P090831005.jpg,char_data/e/P090831005.jpg_5.jpg,522,480,640,18,336,354,243,272,False,34
e,44,kaist_dataset/Mixed/Mobile_Phone/(C.M)B-indoor/P090831010.jpg,char_data/e/P090831010.jpg_8.jpg,1540,480,640,35,105,140,293,337,False,34
e,50,kaist_dataset/Mixed/Mobile_Phone/(C.M)B-indoor/P090831010.jpg,char_data/e/P090831010.jpg_9.jpg,1950,480,640,39,159,198,290,340,False,34
e,45,kaist_dataset/Mixed/Mobile_Phone/(C.M)B-indoor/P090831010.jpg,char_data/e/P090831010.jpg_10.jpg,1440,480,640,32,223,255,295,340,False,34
e,47,kaist_dataset/Mixed/Mobile_Phone/(C.M)B-indoor/P090831010.jpg,char_data/e/P090831010.jpg_11.jpg,1739,480,640,37,329,366,291,338,False,34
e,34,kaist_dataset/Mixed/Mobile_Phone/(C.M)B-indoor/P090831012.jpg,char_data/e/P090831012.jpg_2.jpg,1292,480,640,38,409,447,185,219,False,34
e,58,kaist_dataset/Mixed/Mobile_Phone/(C.M)B-indoor/P090831013.jpg,char_data/e/P090831013.jpg_4.jpg,2552,480,640,44,214,258,195,253,False,34
e,52,kaist_dataset/Mixed/Mobile_Phone/(C.M)B-indoor/P090831013.jpg,char_data/e/P090831013.jpg_5.jpg,2288,480,640,44,513,557,199,251,False,34
e,40,kaist_dataset/Mixed/Mobile_Phone/(C.M)B-indoor/P090831014.jpg,char_data/e/P090831014.jpg_2.jpg,1400,480,640,35,378,413,172,212,False,34
e,46,kaist_dataset/Mixed/Mobile_Phone/(C.M)B-indoor/P090831015.jpg,char_data/e/P090831015.jpg_2.jpg,2070,480,640,45,432,477,215,261,False,34
e,39,kaist_dataset/Mixed/Mobile_Phone/(C.M)B-indoor/P090831016.jpg,char_data/e/P090831016.jpg_2.jpg,1482,480,640,38,323,361,197,236,False,34
e,47,kaist_dataset/Mixed/Mobile_Phone/(C.M)B-indoor/P090831017.jpg,char_data/e/P090831017.jpg_2.jpg,2021,480,640,43,207,250,244,291,False,34
e,56,kaist_dataset/Mixed/Mobile_Phone/(C.M)B-indoor/P090831018.jpg,char_data/e/P090831018.jpg_7.jpg,2464,480,640,44,201,245,233,289,False,34
e,49,kaist_dataset/Mixed/Mobile_Phone/(C.M)B-indoor/P090831018.jpg,char_data/e/P090831018.jpg_8.jpg,2695,480,640,55,353,408,235,284,False,34
e,61,kaist_dataset/Mixed/Mobile_Phone/(C.M)B-indoor/P090831019.jpg,char_data/e/P090831019.jpg_2.jpg,3904,480,640,64,317,381,163,224,False,34
e,53,kaist_dataset/Mixed/Mobile_Phone/(C.M)B-indoor/P090831023.jpg,char_data/e/P090831023.jpg_2.jpg,2173,480,640,41,57,98,279,332,False,34
e,34,kaist_dataset/Mixed/Mobile_Phone/(C.M)C-bookCover/P090831080.jpg,char_data/e/P090831080.jpg_4.jpg,918,480,640,27,343,370,340,374,False,34
e,37,kaist_dataset/Mixed/Mobile_Phone/(C.M)C-bookCover/P090831080.jpg,char_data/e/P090831080.jpg_5.jpg,999,480,640,27,414,441,409,446,False,34
e,39,kaist_dataset/Mixed/Mobile_Phone/(C.M)C-bookCover/P090831113.jpg,char_data/e/P090831113.jpg_2.jpg,1443,480,640,37,287,324,253,292,False,34
e,63,kaist_dataset/Mixed/Mobile_Phone/(C.M)C-bookCover/P090831114.jpg,char_data/e/P090831114.jpg_4.jpg,2142,480,640,34,273,307,258,321,False,34
e,45,kaist_dataset/Mixed/Mobile_Phone/(C.M)C-bookCover/P090831114.jpg,char_data/e/P090831114.jpg_5.jpg,1665,480,640,37,414,451,276,321,False,34
e,31,kaist_dataset/Mixed/Mobile_Phone/(C.M)C-bookCover/P090831115.jpg,char_data/e/P090831115.jpg_4.jpg,496,480,640,16,267,283,177,208,False,34
e,31,kaist_dataset/Mixed/Mobile_Phone/(C.M)C-bookCover/P090831115.jpg,char_data/e/P090831115.jpg_5.jpg,589,480,640,19,393,412,173,204,False,34
e,39,kaist_dataset/Mixed/Mobile_Phone/(C.M)C-bookCover/P090831118.jpg,char_data/e/P090831118.jpg_2.jpg,897,480,640,23,451,474,218,257,False,34
e,51,kaist_dataset/Mixed/Mobile_Phone/(C.M)C-bookCover/P090831121.jpg,char_data/e/P090831121.jpg_2.jpg,1887,480,640,37,361,398,327,378,False,34
e,44,kaist_dataset/Mixed/Mobile_Phone/(C.M)C-bookCover/P090831122.jpg,char_data/e/P090831122.jpg_2.jpg,1540,480,640,35,425,460,269,313,False,34
e,39,kaist_dataset/Mixed/Mobile_Phone/(C.M)C-bookCover/P090831124.jpg,char_data/e/P090831124.jpg_2.jpg,780,480,640,20,334,354,405,444,False,34
e,46,kaist_dataset/Mixed/Mobile_Phone/(C.M)C-bookCover/P090831125.jpg,char_data/e/P090831125.jpg_2.jpg,1334,480,640,29,415,444,276,322,False,34
e,30,kaist_dataset/Mixed/Mobile_Phone/(C.M)C-bookCover/P090902016.jpg,char_data/e/P090902016.jpg_2.jpg,660,480,640,22,463,485,278,308,False,34
e,59,kaist_dataset/Mixed/Mobile_Phone/(C.M)C-bookCover/P090902019.jpg,char_data/e/P090902019.jpg_2.jpg,2124,480,640,36,209,245,289,348,False,34
e,45,kaist_dataset/Mixed/Mobile_Phone/(C.M)C-bookCover/P090903024.jpg,char_data/e/P090903024.jpg_16.jpg,1710,480,640,38,543,581,48,93,False,34
e,31,kaist_dataset/Mixed/Mobile_Phone/(C.M)C-bookCover/P090903024.jpg,char_data/e/P090903024.jpg_17.jpg,744,480,640,24,386,410,117,148,False,34
e,40,kaist_dataset/Mixed/Mobile_Phone/(C.M)C-bookCover/P090903024.jpg,char_data/e/P090903024.jpg_18.jpg,760,480,640,19,460,479,111,151,False,34
e,27,kaist_dataset/Mixed/Mobile_Phone/(C.M)C-bookCover/P090903024.jpg,char_data/e/P090903024.jpg_19.jpg,891,480,640,33,544,577,117,144,False,34
e,25,kaist_dataset/Mixed/Mobile_Phone/(C.M)C-bookCover/P090903024.jpg,char_data/e/P090903024.jpg_20.jpg,450,480,640,18,495,513,175,200,False,34
e,28,kaist_dataset/Mixed/Mobile_Phone/(C.M)C-bookCover/P090903024.jpg,char_data/e/P090903024.jpg_21.jpg,672,480,640,24,518,542,173,201,False,34
e,32,kaist_dataset/Mixed/Mobile_Phone/(C.M)C-bookCover/P090903024.jpg,char_data/e/P090903024.jpg_22.jpg,736,480,640,23,438,461,223,255,False,34
e,30,kaist_dataset/Mixed/Mobile_Phone/(C.M)C-bookCover/P090903024.jpg,char_data/e/P090903024.jpg_23.jpg,750,480,640,25,503,528,225,255,False,34
e,51,kaist_dataset/Mixed/Mobile_Phone/(C.M)C-bookCover/P090903083.jpg,char_data/e/P090903083.jpg_4.jpg,1734,480,640,34,427,461,177,228,False,34
e,44,kaist_dataset/Mixed/Mobile_Phone/(C.M)C-bookCover/P090903083.jpg,char_data/e/P090903083.jpg_5.jpg,1804,480,640,41,204,245,176,220,False,34
e,32,kaist_dataset/Mixed/Mobile_Phone/(C.M)C-bookCover/P090904005.jpg,char_data/e/P090904005.jpg_2.jpg,704,480,640,22,476,498,128,160,False,34
1,21,kaist_dataset/English/Digital_Camera/(E.S)C-outdoor1/056.JPG,char_data/1/056.JPG_4.jpg,252,480,640,12,537,549,252,273,True,3
1,29,kaist_dataset/English/Digital_Camera/(E.S)C-outdoor1/056.JPG,char_data/1/056.JPG_5.jpg,319,480,640,11,590,601,246,275,True,3
1,33,kaist_dataset/English/Digital_Camera/(E.S)C-outdoor1/077.JPG,char_data/1/077.JPG_4.jpg,297,480,640,9,268,277,250,283,True,3
1,23,kaist_dataset/English/Digital_Camera/(E.S)C-outdoor1/077.JPG,char_data/1/077.JPG_5.jpg,322,480,640,14,227,241,253,276,True,3
1,49,kaist_dataset/English/Digital_Camera/(E.S)C-outdoor1/080116-0065.jpg,char_data/1/080116-0065.jpg_2.jpg,882,600,800,18,236,254,369,418,True,3
1,127,kaist_dataset/English/Digital_Camera/(E.S)C-outdoor1/108.JPG,char_data/1/108.JPG_2.jpg,8509,480,640,67,466,533,195,322,True,3
1,29,kaist_dataset/English/Digital_Camera/(E.S)C-outdoor1/113.jpg,char_data/1/113.jpg_2.jpg,493,480,640,17,513,530,304,333,True,3
1,38,kaist_dataset/English/Digital_Camera/(E.S)C-outdoor1/DSC02364.JPG,char_data/1/DSC02364.JPG_4.jpg,570,480,640,15,240,255,348,386,True,3
1,39,kaist_dataset/English/Digital_Camera/(E.S)C-outdoor1/DSC02364.JPG,char_data/1/DSC02364.JPG_5.jpg,585,480,640,15,310,325,349,388,True,3
1,45,kaist_dataset/English/Digital_Camera/(E.S)C-outdoor1/DSC02450.JPG,char_data/1/DSC02450.JPG_2.jpg,1350,480,640,30,309,339,220,265,True,3
1,84,kaist_dataset/English/Digital_Camera/(E.S)C-outdoor1/DSC02491.JPG,char_data/1/DSC02491.JPG_6.jpg,3276,480,640,39,436,475,307,391,True,3
1,75,kaist_dataset/English/Digital_Camera/(E.S)C-outdoor1/DSC02491.JPG,char_data/1/DSC02491.JPG_7.jpg,2475,480,640,33,525,558,313,388,True,3
1,80,kaist_dataset/English/Digital_Camera/(E.S)C-outdoor1/DSC02491.JPG,char_data/1/DSC02491.JPG_8.jpg,2960,480,640,37,559,596,313,393,True,3
1,47,kaist_dataset/English/Digital_Camera/(E.S)C-outdoor2/DSC03053.JPG,char_data/1/DSC03053.JPG_4.jpg,1034,480,640,22,391,413,127,174,True,3
1,42,kaist_dataset/English/Digital_Camera/(E.S)C-outdoor2/DSC03053.JPG,char_data/1/DSC03053.JPG_5.jpg,840,480,640,20,436,456,131,173,True,3
1,56,kaist_dataset/English/Digital_Camera/(E.S)C-outdoor2/DSC03161.JPG,char_data/1/DSC03161.JPG_2.jpg,896,480,640,16,1,17,225,281,True,3
1,33,kaist_dataset/English/Digital_Camera/(E.S)C-outdoor2/DSC03162.JPG,char_data/1/DSC03162.JPG_2.jpg,429,480,640,13,488,501,148,181,True,3
1,30,kaist_dataset/English/Digital_Camera/(E.S)C-outdoor2/DSC03317.JPG,char_data/1/DSC03317.JPG_2.jpg,600,480,640,20,459,479,323,353,True,3
1,56,kaist_dataset/English/Digital_Camera/(E.S)C-outdoor2/DSC03650.JPG,char_data/1/DSC03650.JPG_4.jpg,1512,480,640,27,304,331,288,344,True,3
1,54,kaist_dataset/English/Digital_Camera/(E.S)C-outdoor2/DSC03650.JPG,char_data/1/DSC03650.JPG_5.jpg,1566,480,640,29,466,495,294,348,True,3
1,85,kaist_dataset/English/Digital_Camera/(E.S)C-outdoor2/DSC03731.JPG,char_data/1/DSC03731.JPG_6.jpg,3825,480,640,45,522,567,28,113,True,3
1,28,kaist_dataset/English/Digital_Camera/(E.S)C-outdoor2/DSC03731.JPG,char_data/1/DSC03731.JPG_7.jpg,252,480,640,9,550,559,113,141,True,3
1,24,kaist_dataset/English/Digital_Camera/(E.S)C-outdoor2/DSC03731.JPG,char_data/1/DSC03731.JPG_8.jpg,336,480,640,14,600,614,119,143,True,3
1,201,kaist_dataset/English/Digital_Camera/(E.S)C-outdoor2/DSC04080.JPG,char_data/1/DSC04080.JPG_2.jpg,22512,480,640,112,489,601,214,415,True,3
1,37,kaist_dataset/English/Digital_Camera/(E.S)D-indoor/080119-0009.jpg,char_data/1/080119-0009.jpg_2.jpg,888,1200,1600,24,322,346,1165,1199,True,3
1,204,kaist_dataset/English/Digital_Camera/(E.S)D-indoor/DSC02725.JPG,char_data/1/DSC02725.JPG_2.jpg,23664,480,640,116,167,283,170,374,True,3
1,56,kaist_dataset/English/Digital_Camera/(E.S)D-indoor/DSC03532.JPG,char_data/1/DSC03532.JPG_4.jpg,1512,480,640,27,84,111,416,472,True,3
1,58,kaist_dataset/English/Digital_Camera/(E.S)D-indoor/DSC03532.JPG,char_data/1/DSC03532.JPG_5.jpg,1566,480,640,27,166,193,419,477,True,3
1,33,kaist_dataset/English/Digital_Camera/(E.S)D-indoor/DSC03943.JPG,char_data/1/DSC03943.JPG_2.jpg,264,480,640,8,406,414,310,343,True,3
1,51,kaist_dataset/English/Digital_Camera/(E.S)E-night/DSC02610.JPG,char_data/1/DSC02610.JPG_2.jpg,1326,480,640,26,143,169,385,436,True,3
1,24,kaist_dataset/English/Digital_Camera/(E.S)E-night/크기변환_%BA%F7%BD%BA%BD%C5%B8%DE%B4%BA_01_tjtjdska2008.jpg,char_data/1/크기변환_%BA%F7%BD%BA%BD%C5%B8%DE%B4%BA_01_tjtjdska2008.jpg_2.jpg,432,480,640,18,335,353,277,301,True,3
1,42,kaist_dataset/English/Digital_Camera/(E.S)F-others/2007-12-09-day-exterior-047.jpg,char_data/1/2007-12-09-day-exterior-047.jpg_2.jpg,462,1200,1600,11,18,29,572,614,True,3
1,112,kaist_dataset/Korean/Digital_Camera/A-shadow/104.JPG,char_data/1/104.JPG_2.jpg,4928,480,640,44,458,502,347,459,True,3
1,45,kaist_dataset/Korean/Digital_Camera/A-shadow/2007-12-09-day-exterior-025.jpg,char_data/1/2007-12-09-day-exterior-025.jpg_2.jpg,945,1200,1600,21,982,1003,735,780,True,3
1,73,kaist_dataset/Korean/Digital_Camera/A-shadow/DSC03535.JPG,char_data/1/DSC03535.JPG_2.jpg,1971,480,640,27,352,379,246,319,True,3
1,68,kaist_dataset/Korean/Digital_Camera/A-shadow/DSC03536.JPG,char_data/1/DSC03536.JPG_4.jpg,2516,480,640,37,393,430,245,313,True,3
1,71,kaist_dataset/Korean/Digital_Camera/A-shadow/DSC03536.JPG,char_data/1/DSC03536.JPG_5.jpg,2840,480,640,40,431,471,238,309,True,3
1,79,kaist_dataset/Korean/Digital_Camera/A-shadow/DSC03755.JPG,char_data/1/DSC03755.JPG_2.jpg,1975,480,640,25,217,242,206,285,True,3
1,74,kaist_dataset/Korean/Digital_Camera/A-shadow/DSC03793.JPG,char_data/1/DSC03793.JPG_2.jpg,3182,480,640,43,104,147,166,240,True,3
1,32,kaist_dataset/Korean/Digital_Camera/A-shadow/DSC04297.JPG,char_data/1/DSC04297.JPG_2.jpg,416,480,640,13,347,360,206,238,True,3
1,137,kaist_dataset/Korean/Digital_Camera/A-shadow/DSC04300.JPG,char_data/1/DSC04300.JPG_2.jpg,7946,480,640,58,451,509,237,374,True,3
1,28,kaist_dataset/Korean/Digital_Camera/B-light/DSC02987.JPG,char_data/1/DSC02987.JPG_2.jpg,364,480,640,13,435,448,278,306,True,3
1,30,kaist_dataset/Korean/Digital_Camera/E-night/DSC02626.JPG,char_data/1/DSC02626.JPG_10.jpg,390,480,640,13,231,244,369,399,True,3
1,37,kaist_dataset/Korean/Digital_Camera/E-night/DSC02626.JPG,char_data/1/DSC02626.JPG_11.jpg,481,480,640,13,286,299,364,401,True,3
1,37,kaist_dataset/Korean/Digital_Camera/E-night/DSC02626.JPG,char_data/1/DSC02626.JPG_12.jpg,740,480,640,20,297,317,364,401,True,3
1,34,kaist_dataset/Korean/Digital_Camera/E-night/DSC02626.JPG,char_data/1/DSC02626.JPG_13.jpg,442,480,640,13,362,375,363,397,True,3
1,34,kaist_dataset/Korean/Digital_Camera/E-night/DSC02626.JPG,char_data/1/DSC02626.JPG_14.jpg,1054,480,640,31,373,404,362,396,True,3
1,95,kaist_dataset/Korean/Digital_Camera/E-night/DSC02631.JPG,char_data/1/DSC02631.JPG_2.jpg,3705,480,640,39,33,72,197,292,True,3
1,44,kaist_dataset/Korean/Digital_Camera/E-night/DSC02658.JPG,char_data/1/DSC02658.JPG_4.jpg,792,480,640,18,388,406,350,394,True,3
1,41,kaist_dataset/Korean/Digital_Camera/E-night/DSC02658.JPG,char_data/1/DSC02658.JPG_5.jpg,820,480,640,20,470,490,354,395,True,3
1,42,kaist_dataset/Korean/Digital_Camera/E-night/DSC02662.JPG,char_data/1/DSC02662.JPG_2.jpg,840,480,640,20,508,528,370,412,True,3
1,60,kaist_dataset/Korean/Digital_Camera/E-night/DSC03019.JPG,char_data/1/DSC03019.JPG_2.jpg,1560,480,640,26,432,458,177,237,True,3
1,42,kaist_dataset/Korean/Digital_Camera/E-night/DSC03515.JPG,char_data/1/DSC03515.JPG_6.jpg,714,480,640,17,403,420,272,314,True,3
1,45,kaist_dataset/Korean/Digital_Camera/E-night/DSC03515.JPG,char_data/1/DSC03515.JPG_7.jpg,810,480,640,18,420,438,269,314,True,3
1,38,kaist_dataset/Korean/Digital_Camera/E-night/DSC03515.JPG,char_data/1/DSC03515.JPG_8.jpg,608,480,640,16,491,507,274,312,True,3
1,44,kaist_dataset/Korean/Digital_Camera/E-night/DSC03523.JPG,char_data/1/DSC03523.JPG_2.jpg,880,480,640,20,550,570,333,377,True,3
1,46,kaist_dataset/Korean/Digital_Camera/E-night/DSC03861.JPG,char_data/1/DSC03861.JPG_2.jpg,1196,480,640,26,270,296,417,463,True,3
1,71,kaist_dataset/Korean/Digital_Camera/E-night/DSC03870.JPG,char_data/1/DSC03870.JPG_8.jpg,1349,480,640,19,254,273,126,197,True,3
1,45,kaist_dataset/Korean/Digital_Camera/E-night/DSC03870.JPG,char_data/1/DSC03870.JPG_9.jpg,810,480,640,18,324,342,149,194,True,3
1,20,kaist_dataset/Korean/Digital_Camera/E-night/DSC03870.JPG,char_data/1/DSC03870.JPG_10.jpg,260,480,640,13,359,372,226,246,True,3
1,24,kaist_dataset/Korean/Digital_Camera/E-night/DSC03870.JPG,char_data/1/DSC03870.JPG_11.jpg,264,480,640,11,383,394,225,249,True,3
1,27,kaist_dataset/Korean/Digital_Camera/E-night/P1010146.JPG,char_data/1/P1010146.JPG_4.jpg,324,480,640,12,205,217,251,278,True,3
1,35,kaist_dataset/Korean/Digital_Camera/E-night/P1010146.JPG,char_data/1/P1010146.JPG_5.jpg,770,480,640,22,359,381,248,283,True,3
1,126,kaist_dataset/Korean/Digital_Camera/F-bookCover/DSC04229.JPG,char_data/1/DSC04229.JPG_2.jpg,9450,480,640,75,52,127,169,295,True,3
1,152,kaist_dataset/Korean/Digital_Camera/F-bookCover/P090911043.jpg,char_data/1/P090911043.jpg_4.jpg,11248,480,640,74,12,86,147,299,True,3
1,92,kaist_dataset/Korean/Digital_Camera/F-bookCover/P090911043.jpg,char_data/1/P090911043.jpg_5.jpg,4600,480,640,50,226,276,141,233,True,3
1,57,kaist_dataset/Korean/Digital_Camera/G-others/005.JPG,char_data/1/005.JPG_2.jpg,2451,768,576,43,219,262,315,372,True,3
1,44,kaist_dataset/Korean/Digital_Camera/G-others/2007-12-08-day-045.jpg,char_data/1/2007-12-08-day-045.jpg_2.jpg,616,1200,1600,14,56,70,801,845,True,3
1,91,kaist_dataset/Korean/Digital_Camera/G-others/2007-12-08-day-108.jpg,char_data/1/2007-12-08-day-108.jpg_2.jpg,2730,1200,1600,30,623,653,687,778,True,3
1,21,kaist_dataset/Korean/Digital_Camera/G-others/2007-12-08-day-112.jpg,char_data/1/2007-12-08-day-112.jpg_2.jpg,294,1200,1600,14,371,385,1168,1189,True,3
1,54,kaist_dataset/Korean/Digital_Camera/G-others/2007-12-09-day-exterior-083.jpg,char_data/1/2007-12-09-day-exterior-083.jpg_2.jpg,1944,1600,1200,36,564,600,118,172,True,3
1,48,kaist_dataset/Korean/Digital_Camera/G-others/DSC03862.JPG,char_data/1/DSC03862.JPG_2.jpg,528,480,640,11,292,303,349,397,True,3
1,31,kaist_dataset/Korean/Digital_Camera/G-others/DSC03863.JPG,char_data/1/DSC03863.JPG_2.jpg,527,480,640,17,254,271,408,439,True,3
1,63,kaist_dataset/Korean/Digital_Camera/indoor1/080119-0018.jpg,char_data/1/080119-0018.jpg_8.jpg,1575,1200,1600,25,887,912,438,501,True,3
1,50,kaist_dataset/Korean/Digital_Camera/indoor1/080119-0018.jpg,char_data/1/080119-0018.jpg_9.jpg,1100,1200,1600,22,1035,1057,934,984,True,3
1,43,kaist_dataset/Korean/Digital_Camera/indoor1/080119-0018.jpg,char_data/1/080119-0018.jpg_10.jpg,860,1200,1600,20,1159,1179,940,983,True,3
1,45,kaist_dataset/Korean/Digital_Camera/indoor1/080119-0018.jpg,char_data/1/080119-0018.jpg_11.jpg,1080,1200,1600,24,1181,1205,936,981,True,3
1,94,kaist_dataset/Korean/Digital_Camera/indoor1/080119-0030.jpg,char_data/1/080119-0030.jpg_2.jpg,3572,1200,1600,38,848,886,429,523,True,3
1,35,kaist_dataset/Korean/Digital_Camera/indoor1/DSC02700.JPG,char_data/1/DSC02700.JPG_2.jpg,525,480,640,15,158,173,423,458,True,3
1,34,kaist_dataset/Korean/Digital_Camera/indoor1/DSC03362.JPG,char_data/1/DSC03362.JPG_2.jpg,340,480,640,10,97,107,278,312,True,3
1,40,kaist_dataset/Korean/Digital_Camera/indoor1/DSC03375.JPG,char_data/1/DSC03375.JPG_2.jpg,840,480,640,21,154,175,38,78,True,3
1,51,kaist_dataset/Korean/Digital_Camera/indoor2/DSC03560.JPG,char_data/1/DSC03560.JPG_2.jpg,1224,480,640,24,344,368,66,117,True,3
1,53,kaist_dataset/Korean/Digital_Camera/indoor2/DSC03563.JPG,char_data/1/DSC03563.JPG_2.jpg,1325,480,640,25,482,507,257,310,True,3
1,34,kaist_dataset/Korean/Digital_Camera/indoor2/DSC03564.JPG,char_data/1/DSC03564.JPG_2.jpg,408,480,640,12,275,287,405,439,True,3
1,78,kaist_dataset/Korean/Digital_Camera/indoor2/DSC03902.JPG,char_data/1/DSC03902.JPG_2.jpg,2106,480,640,27,90,117,128,206,True,3
1,32,kaist_dataset/Korean/Digital_Camera/indoor2/DSC03975.JPG,char_data/1/DSC03975.JPG_2.jpg,384,480,640,12,258,270,287,319,True,3
1,37,kaist_dataset/Korean/Digital_Camera/indoor2/DSC03983.JPG,char_data/1/DSC03983.JPG_4.jpg,629,480,640,17,326,343,323,360,True,3
1,34,kaist_dataset/Korean/Digital_Camera/indoor2/DSC03983.JPG,char_data/1/DSC03983.JPG_5.jpg,714,480,640,21,351,372,324,358,True,3
1,49,kaist_dataset/Korean/Digital_Camera/indoor2/DSC03994.JPG,char_data/1/DSC03994.JPG_2.jpg,1274,480,640,26,372,398,285,334,True,3
1,45,kaist_dataset/Korean/Digital_Camera/indoor2/DSC03995.JPG,char_data/1/DSC03995.JPG_2.jpg,855,480,640,19,456,475,266,311,True,3
1,50,kaist_dataset/Korean/Digital_Camera/indoor2/DSC04204.JPG,char_data/1/DSC04204.JPG_2.jpg,1400,480,640,28,223,251,203,253,True,3
1,69,kaist_dataset/Korean/Digital_Camera/indoor2/P071209063.jpg,char_data/1/P071209063.jpg_6.jpg,3381,1200,1600,49,1075,1124,1069,1138,True,3
1,73,kaist_dataset/Korean/Digital_Camera/indoor2/P071209063.jpg,char_data/1/P071209063.jpg_7.jpg,3504,1200,1600,48,1181,1229,1062,1135,True,3
1,77,kaist_dataset/Korean/Digital_Camera/indoor2/P071209063.jpg,char_data/1/P071209063.jpg_8.jpg,3696,1200,1600,48,1339,1387,1055,1132,True,3
1,89,kaist_dataset/Korean/Digital_Camera/indoor2/크기변환_%BD%C7%B3%BB%B0%A3%C6%C7_moon8481.jpg,char_data/1/크기변환_%BD%C7%B3%BB%B0%A3%C6%C7_moon8481.jpg_4.jpg,2225,480,640,25,131,156,340,429,True,3
1,89,kaist_dataset/Korean/Digital_Camera/indoor2/크기변환_%BD%C7%B3%BB%B0%A3%C6%C7_moon8481.jpg,char_data/1/크기변환_%BD%C7%B3%BB%B0%A3%C6%C7_moon8481.jpg_5.jpg,4806,480,640,54,515,569,341,430,True,3
1,25,kaist_dataset/Korean/Digital_Camera/outdoor1/002.JPG,char_data/1/002.JPG_2.jpg,225,480,640,9,324,333,374,399,True,3
1,25,kaist_dataset/Korean/Digital_Camera/outdoor1/011.JPG,char_data/1/011.JPG_4.jpg,350,480,640,14,451,465,258,283,True,3
1,21,kaist_dataset/Korean/Digital_Camera/outdoor1/011.JPG,char_data/1/011.JPG_5.jpg,336,480,640,16,491,507,259,280,True,3
1,25,kaist_dataset/Korean/Digital_Camera/outdoor1/017.JPG,char_data/1/017.JPG_2.jpg,250,480,640,10,475,485,269,294,True,3
1,33,kaist_dataset/Korean/Digital_Camera/outdoor1/023.JPG,char_data/1/023.JPG_2.jpg,462,480,640,14,190,204,270,303,True,3
1,28,kaist_dataset/Korean/Digital_Camera/outdoor1/028.JPG,char_data/1/028.JPG_2.jpg,392,480,640,14,311,325,263,291,True,3
1,28,kaist_dataset/Korean/Digital_Camera/outdoor1/029.JPG,char_data/1/029.JPG_4.jpg,392,480,640,14,286,300,295,323,True,3
1,30,kaist_dataset/Korean/Digital_Camera/outdoor1/029.JPG,char_data/1/029.JPG_5.jpg,480,480,640,16,339,355,290,320,True,3
1,29,kaist_dataset/Korean/Digital_Camera/outdoor1/032.JPG,char_data/1/032.JPG_6.jpg,551,480,640,19,194,213,258,287,True,3
1,30,kaist_dataset/Korean/Digital_Camera/outdoor1/032.JPG,char_data/1/032.JPG_7.jpg,480,480,640,16,286,302,257,287,True,3
1,28,kaist_dataset/Korean/Digital_Camera/outdoor1/032.JPG,char_data/1/032.JPG_8.jpg,392,480,640,14,492,506,256,284,True,3
1,24,kaist_dataset/Korean/Digital_Camera/outdoor1/035.JPG,char_data/1/035.JPG_2.jpg,240,480,640,10,550,560,293,317,True,3
1,28,kaist_dataset/Korean/Digital_Camera/outdoor1/069.JPG,char_data/1/069.JPG_4.jpg,252,480,640,9,338,347,272,300,True,3
1,33,kaist_dataset/Korean/Digital_Camera/outdoor1/069.JPG,char_data/1/069.JPG_5.jpg,462,480,640,14,371,385,269,302,True,3
1,28,kaist_dataset/Korean/Digital_Camera/outdoor1/071.JPG,char_data/1/071.JPG_2.jpg,532,480,640,19,316,335,259,287,True,3
1,43,kaist_dataset/Korean/Digital_Camera/outdoor1/091.JPG,char_data/1/091.JPG_2.jpg,817,480,640,19,386,405,284,327,True,3
1,42,kaist_dataset/Korean/Digital_Camera/outdoor1/109.JPG,char_data/1/109.JPG_4.jpg,924,480,640,22,530,552,4,46,True,3
1,41,kaist_dataset/Korean/Digital_Camera/outdoor1/109.JPG,char_data/1/109.JPG_5.jpg,861,480,640,21,552,573,4,45,True,3
1,29,kaist_dataset/Korean/Digital_Camera/outdoor1/120.JPG,char_data/1/120.JPG_2.jpg,609,480,640,21,412,433,301,330,True,3
1,29,kaist_dataset/Korean/Digital_Camera/outdoor1/123.JPG,char_data/1/123.JPG_4.jpg,348,480,640,12,70,82,280,309,True,3
1,38,kaist_dataset/Korean/Digital_Camera/outdoor1/123.JPG,char_data/1/123.JPG_5.jpg,608,480,640,16,416,432,271,309,True,3
1,27,kaist_dataset/Korean/Digital_Camera/outdoor1/126.JPG,char_data/1/126.JPG_2.jpg,486,480,640,18,378,396,262,289,True,3
1,41,kaist_dataset/Korean/Digital_Camera/outdoor1/127.JPG,char_data/1/127.JPG_2.jpg,820,480,640,20,320,340,270,311,True,3
1,31,kaist_dataset/Korean/Digital_Camera/outdoor1/128.JPG,char_data/1/128.JPG_2.jpg,248,480,640,8,413,421,114,145,True,3
1,44,kaist_dataset/Korean/Digital_Camera/outdoor1/2007-12-08-day-047.jpg,char_data/1/2007-12-08-day-047.jpg_4.jpg,1144,1200,1600,26,953,979,713,757,True,3
1,44,kaist_dataset/Korean/Digital_Camera/outdoor1/2007-12-08-day-047.jpg,char_data/1/2007-12-08-day-047.jpg_5.jpg,1100,1200,1600,25,1013,1038,717,761,True,3
1,68,kaist_dataset/Korean/Digital_Camera/outdoor1/46.JPG,char_data/1/46.JPG_4.jpg,1904,576,768,28,237,265,370,438,True,3
1,69,kaist_dataset/Korean/Digital_Camera/outdoor1/46.JPG,char_data/1/46.JPG_5.jpg,1725,576,768,25,366,391,368,437,True,3
1,30,kaist_dataset/Korean/Digital_Camera/outdoor1/50.JPG,char_data/1/50.JPG_2.jpg,420,576,768,14,341,355,338,368,True,3
1,62,kaist_dataset/Korean/Digital_Camera/outdoor1/54.JPG,char_data/1/54.JPG_4.jpg,1178,523,767,19,371,390,83,145,True,3
1,46,kaist_dataset/Korean/Digital_Camera/outdoor1/54.JPG,char_data/1/54.JPG_5.jpg,828,523,767,18,441,459,363,409,True,3
1,71,kaist_dataset/Korean/Digital_Camera/outdoor2/2007-12-09-day-exterior-009.jpg,char_data/1/2007-12-09-day-exterior-009.jpg_4.jpg,2272,1200,1600,32,865,897,661,732,True,3
1,83,kaist_dataset/Korean/Digital_Camera/outdoor2/2007-12-09-day-exterior-009.jpg,char_data/1/2007-12-09-day-exterior-009.jpg_5.jpg,1992,1200,1600,24,937,961,652,735,True,3
1,61,kaist_dataset/Korean/Digital_Camera/outdoor2/2007-12-09-day-exterior-016.jpg,char_data/1/2007-12-09-day-exterior-016.jpg_4.jpg,1769,1200,1600,29,92,121,352,413,True,3
1,62,kaist_dataset/Korean/Digital_Camera/outdoor2/2007-12-09-day-exterior-016.jpg,char_data/1/2007-12-09-day-exterior-016.jpg_5.jpg,1860,1200,1600,30,659,689,743,805,True,3
1,65,kaist_dataset/Korean/Digital_Camera/outdoor2/2007-12-09-day-exterior-035.jpg,char_data/1/2007-12-09-day-exterior-035.jpg_2.jpg,1885,1200,1600,29,633,662,705,770,True,3
1,46,kaist_dataset/Korean/Digital_Camera/outdoor2/2007-12-09-day-exterior-084.jpg,char_data/1/2007-12-09-day-exterior-084.jpg_2.jpg,1610,1200,1600,35,981,1016,791,837,True,3
1,34,kaist_dataset/Korean/Digital_Camera/outdoor2/DSC02311.JPG,char_data/1/DSC02311.JPG_2.jpg,884,480,640,26,598,624,252,286,True,3
1,21,kaist_dataset/Korean/Digital_Camera/outdoor2/DSC02314.JPG,char_data/1/DSC02314.JPG_2.jpg,252,480,640,12,413,425,205,226,True,3
1,29,kaist_dataset/Korean/Digital_Camera/outdoor2/DSC02373.JPG,char_data/1/DSC02373.JPG_2.jpg,319,480,640,11,393,404,334,363,True,3
1,36,kaist_dataset/Korean/Digital_Camera/outdoor2/DSC02381.JPG,char_data/1/DSC02381.JPG_2.jpg,936,480,640,26,357,383,321,357,True,3
1,34,kaist_dataset/Korean/Digital_Camera/outdoor2/DSC02383.JPG,char_data/1/DSC02383.JPG_8.jpg,408,480,640,12,81,93,294,328,True,3
1,33,kaist_dataset/Korean/Digital_Camera/outdoor2/DSC02383.JPG,char_data/1/DSC02383.JPG_9.jpg,264,480,640,8,93,101,295,328,True,3
1,26,kaist_dataset/Korean/Digital_Camera/outdoor2/DSC02383.JPG,char_data/1/DSC02383.JPG_10.jpg,234,480,640,9,163,172,294,320,True,3
1,29,kaist_dataset/Korean/Digital_Camera/outdoor2/DSC02383.JPG,char_data/1/DSC02383.JPG_11.jpg,261,480,640,9,174,183,293,322,True,3
1,39,kaist_dataset/Korean/Digital_Camera/outdoor2/DSC02396.JPG,char_data/1/DSC02396.JPG_2.jpg,624,480,640,16,175,191,182,221,True,3
1,48,kaist_dataset/Korean/Digital_Camera/outdoor2/DSC02414.JPG,char_data/1/DSC02414.JPG_6.jpg,1536,480,640,32,142,174,239,287,True,3
1,47,kaist_dataset/Korean/Digital_Camera/outdoor2/DSC02414.JPG,char_data/1/DSC02414.JPG_7.jpg,1316,480,640,28,174,202,241,288,True,3
1,43,kaist_dataset/Korean/Digital_Camera/outdoor2/DSC02414.JPG,char_data/1/DSC02414.JPG_8.jpg,1634,480,640,38,516,554,242,285,True,3
1,28,kaist_dataset/Korean/Digital_Camera/outdoor2/DSC02424.JPG,char_data/1/DSC02424.JPG_2.jpg,336,480,640,12,545,557,244,272,True,3
1,29,kaist_dataset/Korean/Digital_Camera/outdoor2/DSC02470.JPG,char_data/1/DSC02470.JPG_2.jpg,406,480,640,14,520,534,164,193,True,3
1,105,kaist_dataset/Korean/Digital_Camera/outdoor2/DSC02486.JPG,char_data/1/DSC02486.JPG_6.jpg,3465,480,640,33,38,71,240,345,True,3
1,104,kaist_dataset/Korean/Digital_Camera/outdoor2/DSC02486.JPG,char_data/1/DSC02486.JPG_7.jpg,3016,480,640,29,69,98,239,343,True,3
1,109,kaist_dataset/Korean/Digital_Camera/outdoor2/DSC02486.JPG,char_data/1/DSC02486.JPG_8.jpg,3052,480,640,28,219,247,238,347,True,3
1,44,kaist_dataset/Korean/Digital_Camera/outdoor2/DSC02488.JPG,char_data/1/DSC02488.JPG_4.jpg,484,480,640,11,596,607,368,412,True,3
1,35,kaist_dataset/Korean/Digital_Camera/outdoor2/DSC02488.JPG,char_data/1/DSC02488.JPG_5.jpg,560,480,640,16,607,623,371,406,True,3
1,28,kaist_dataset/Korean/Digital_Camera/outdoor2/DSC02506.JPG,char_data/1/DSC02506.JPG_2.jpg,504,480,640,18,300,318,437,465,True,3
1,59,kaist_dataset/Korean/Digital_Camera/outdoor2/DSC02512.JPG,char_data/1/DSC02512.JPG_2.jpg,1475,480,640,25,606,631,290,349,True,3
1,127,kaist_dataset/Korean/Digital_Camera/outdoor2/DSC02520.JPG,char_data/1/DSC02520.JPG_2.jpg,3429,480,640,27,288,315,302,429,True,3
1,37,kaist_dataset/Korean/Digital_Camera/outdoor2/DSC02521.JPG,char_data/1/DSC02521.JPG_2.jpg,592,480,640,16,420,436,324,361,True,3
1,48,kaist_dataset/Korean/Digital_Camera/outdoor2/DSC02523.JPG,char_data/1/DSC02523.JPG_2.jpg,960,480,640,20,496,516,334,382,True,3
1,28,kaist_dataset/Korean/Digital_Camera/outdoor3/DSC02529.JPG,char_data/1/DSC02529.JPG_2.jpg,196,480,640,7,506,513,372,400,True,3
1,30,kaist_dataset/Korean/Digital_Camera/outdoor3/DSC02546.JPG,char_data/1/DSC02546.JPG_2.jpg,360,480,640,12,182,194,425,455,True,3
1,44,kaist_dataset/Korean/Digital_Camera/outdoor3/DSC02561.JPG,char_data/1/DSC02561.JPG_4.jpg,792,480,640,18,263,281,351,395,True,3
1,35,kaist_dataset/Korean/Digital_Camera/outdoor3/DSC02561.JPG,char_data/1/DSC02561.JPG_5.jpg,840,480,640,24,418,442,354,389,True,3
1,76,kaist_dataset/Korean/Digital_Camera/outdoor3/DSC02562.JPG,char_data/1/DSC02562.JPG_2.jpg,2204,480,640,29,268,297,358,434,True,3
1,50,kaist_dataset/Korean/Digital_Camera/outdoor3/DSC02697.JPG,char_data/1/DSC02697.JPG_6.jpg,1100,480,640,22,156,178,377,427,True,3
1,50,kaist_dataset/Korean/Digital_Camera/outdoor3/DSC02697.JPG,char_data/1/DSC02697.JPG_7.jpg,1150,480,640,23,340,363,378,428,True,3
1,56,kaist_dataset/Korean/Digital_Camera/outdoor3/DSC02697.JPG,char_data/1/DSC02697.JPG_8.jpg,1176,480,640,21,365,386,376,432,True,3
1,45,kaist_dataset/Korean/Digital_Camera/outdoor3/DSC02698.JPG,char_data/1/DSC02698.JPG_2.jpg,765,480,640,17,223,240,399,444,True,3
1,30,kaist_dataset/Korean/Digital_Camera/outdoor3/DSC02888.JPG,char_data/1/DSC02888.JPG_2.jpg,570,480,640,19,259,278,422,452,True,3
1,37,kaist_dataset/Korean/Digital_Camera/outdoor3/DSC02939.JPG,char_data/1/DSC02939.JPG_2.jpg,518,480,640,14,479,493,369,406,True,3
1,35,kaist_dataset/Korean/Digital_Camera/outdoor3/DSC02943.JPG,char_data/1/DSC02943.JPG_4.jpg,595,480,640,17,418,435,434,469,True,3
1,30,kaist_dataset/Korean/Digital_Camera/outdoor3/DSC02943.JPG,char_data/1/DSC02943.JPG_5.jpg,780,480,640,26,436,462,440,470,True,3
1,31,kaist_dataset/Korean/Digital_Camera/outdoor3/DSC02944.JPG,char_data/1/DSC02944.JPG_2.jpg,527,480,640,17,323,340,231,262,True,3
1,64,kaist_dataset/Korean/Digital_Camera/outdoor3/DSC02953.JPG,char_data/1/DSC02953.JPG_2.jpg,1728,480,640,27,465,492,384,448,True,3
1,45,kaist_dataset/Korean/Digital_Camera/outdoor3/DSC02957.JPG,char_data/1/DSC02957.JPG_6.jpg,1080,480,640,24,381,405,408,453,True,3
1,47,kaist_dataset/Korean/Digital_Camera/outdoor3/DSC02957.JPG,char_data/1/DSC02957.JPG_7.jpg,940,480,640,20,407,427,406,453,True,3
1,50,kaist_dataset/Korean/Digital_Camera/outdoor3/DSC02957.JPG,char_data/1/DSC02957.JPG_8.jpg,1400,480,640,28,427,455,404,454,True,3
1,53,kaist_dataset/Korean/Digital_Camera/outdoor3/DSC02972.JPG,char_data/1/DSC02972.JPG_2.jpg,1643,480,640,31,318,349,42,95,True,3
1,45,kaist_dataset/Korean/Digital_Camera/outdoor3/DSC02994.JPG,char_data/1/DSC02994.JPG_2.jpg,855,480,640,19,322,341,288,333,True,3
1,51,kaist_dataset/Korean/Digital_Camera/outdoor3/DSC03064.JPG,char_data/1/DSC03064.JPG_2.jpg,1020,480,640,20,279,299,344,395,True,3
1,63,kaist_dataset/Korean/Digital_Camera/outdoor3/DSC03195.JPG,char_data/1/DSC03195.JPG_2.jpg,2016,480,640,32,228,260,249,312,True,3
1,48,kaist_dataset/Korean/Digital_Camera/outdoor3/DSC03237.JPG,char_data/1/DSC03237.JPG_2.jpg,912,480,640,19,306,325,395,443,True,3
1,50,kaist_dataset/Korean/Digital_Camera/outdoor4/DSC03319.JPG,char_data/1/DSC03319.JPG_4.jpg,1600,480,640,32,307,339,386,436,True,3
1,54,kaist_dataset/Korean/Digital_Camera/outdoor4/DSC03319.JPG,char_data/1/DSC03319.JPG_5.jpg,1350,480,640,25,485,510,381,435,True,3
1,81,kaist_dataset/Korean/Digital_Camera/outdoor4/DSC03320.JPG,char_data/1/DSC03320.JPG_2.jpg,2754,480,640,34,381,415,383,464,True,3
1,45,kaist_dataset/Korean/Digital_Camera/outdoor4/DSC03545.JPG,char_data/1/DSC03545.JPG_2.jpg,450,480,640,10,204,214,38,83,True,3
1,74,kaist_dataset/Korean/Digital_Camera/outdoor4/DSC03553.JPG,char_data/1/DSC03553.JPG_4.jpg,3552,480,640,48,343,391,175,249,True,3
1,75,kaist_dataset/Korean/Digital_Camera/outdoor4/DSC03553.JPG,char_data/1/DSC03553.JPG_5.jpg,3600,480,640,48,467,515,175,250,True,3
1,76,kaist_dataset/Korean/Digital_Camera/outdoor4/DSC03555.JPG,char_data/1/DSC03555.JPG_2.jpg,2888,480,640,38,154,192,348,424,True,3
1,52,kaist_dataset/Korean/Digital_Camera/outdoor4/DSC03580.JPG,char_data/1/DSC03580.JPG_2.jpg,780,480,640,15,351,366,202,254,True,3
1,58,kaist_dataset/Korean/Digital_Camera/outdoor4/DSC03592.JPG,char_data/1/DSC03592.JPG_4.jpg,1566,480,640,27,215,242,53,111,True,3
1,36,kaist_dataset/Korean/Digital_Camera/outdoor4/DSC03592.JPG,char_data/1/DSC03592.JPG_5.jpg,612,480,640,17,414,431,122,158,True,3
1,30,kaist_dataset/Korean/Digital_Camera/outdoor4/DSC03598.JPG,char_data/1/DSC03598.JPG_2.jpg,660,480,640,22,261,283,270,300,True,3
1,48,kaist_dataset/Korean/Digital_Camera/outdoor4/DSC03602.JPG,char_data/1/DSC03602.JPG_4.jpg,1488,480,640,31,214,245,248,296,True,3
1,55,kaist_dataset/Korean/Digital_Camera/outdoor4/DSC03602.JPG,char_data/1/DSC03602.JPG_5.jpg,2035,480,640,37,274,311,249,304,True,3
1,51,kaist_dataset/Korean/Digital_Camera/outdoor4/DSC03603.JPG,char_data/1/DSC03603.JPG_6.jpg,867,480,640,17,202,219,50,101,True,3
1,41,kaist_dataset/Korean/Digital_Camera/outdoor4/DSC03603.JPG,char_data/1/DSC03603.JPG_7.jpg,1558,480,640,38,319,357,237,278,True,3
1,48,kaist_dataset/Korean/Digital_Camera/outdoor4/DSC03603.JPG,char_data/1/DSC03603.JPG_8.jpg,1728,480,640,36,188,224,384,432,True,3
1,65,kaist_dataset/Korean/Digital_Camera/outdoor4/DSC03607.JPG,char_data/1/DSC03607.JPG_2.jpg,1755,480,640,27,561,588,98,163,True,3
1,48,kaist_dataset/Korean/Digital_Camera/outdoor4/DSC03614.JPG,char_data/1/DSC03614.JPG_2.jpg,960,480,640,20,475,495,382,430,True,3
1,29,kaist_dataset/Korean/Digital_Camera/outdoor5/DSC03636.JPG,char_data/1/DSC03636.JPG_4.jpg,290,480,640,10,303,313,158,187,True,3
1,41,kaist_dataset/Korean/Digital_Camera/outdoor5/DSC03636.JPG,char_data/1/DSC03636.JPG_5.jpg,820,480,640,20,49,69,333,374,True,3
1,35,kaist_dataset/Korean/Digital_Camera/outdoor5/DSC03641.JPG,char_data/1/DSC03641.JPG_2.jpg,490,480,640,14,496,510,421,456,True,3
1,35,kaist_dataset/Korean/Digital_Camera/outdoor5/DSC03669.JPG,char_data/1/DSC03669.JPG_2.jpg,560,480,640,16,353,369,312,347,True,3
1,36,kaist_dataset/Korean/Digital_Camera/outdoor5/DSC03671.JPG,char_data/1/DSC03671.JPG_6.jpg,540,480,640,15,322,337,410,446,True,3
1,33,kaist_dataset/Korean/Digital_Camera/outdoor5/DSC03671.JPG,char_data/1/DSC03671.JPG_7.jpg,429,480,640,13,413,426,411,444,True,3
1,38,kaist_dataset/Korean/Digital_Camera/outdoor5/DSC03671.JPG,char_data/1/DSC03671.JPG_8.jpg,570,480,640,15,543,558,408,446,True,3
1,27,kaist_dataset/Korean/Digital_Camera/outdoor5/DSC03688.JPG,char_data/1/DSC03688.JPG_2.jpg,189,480,640,7,611,618,227,254,True,3
1,35,kaist_dataset/Korean/Digital_Camera/outdoor5/DSC03692.JPG,char_data/1/DSC03692.JPG_4.jpg,315,480,640,9,409,418,186,221,True,3
1,36,kaist_dataset/Korean/Digital_Camera/outdoor5/DSC03692.JPG,char_data/1/DSC03692.JPG_5.jpg,432,480,640,12,420,432,186,222,True,3
1,68,kaist_dataset/Korean/Digital_Camera/outdoor5/DSC03694.JPG,char_data/1/DSC03694.JPG_4.jpg,2244,480,640,33,65,98,255,323,True,3
1,65,kaist_dataset/Korean/Digital_Camera/outdoor5/DSC03694.JPG,char_data/1/DSC03694.JPG_5.jpg,1690,480,640,26,287,313,248,313,True,3
1,47,kaist_dataset/Korean/Digital_Camera/outdoor5/DSC03708.JPG,char_data/1/DSC03708.JPG_4.jpg,1175,480,640,25,457,482,263,310,True,3
1,49,kaist_dataset/Korean/Digital_Camera/outdoor5/DSC03708.JPG,char_data/1/DSC03708.JPG_5.jpg,1568,480,640,32,508,540,261,310,True,3
1,38,kaist_dataset/Korean/Digital_Camera/outdoor5/DSC03710.JPG,char_data/1/DSC03710.JPG_2.jpg,912,480,640,24,316,340,405,443,True,3
1,40,kaist_dataset/Korean/Digital_Camera/outdoor5/DSC03717.JPG,char_data/1/DSC03717.JPG_2.jpg,1040,480,640,26,233,259,350,390,True,3
1,62,kaist_dataset/Korean/Digital_Camera/outdoor5/DSC03749.JPG,char_data/1/DSC03749.JPG_2.jpg,1240,480,640,20,462,482,409,471,True,3
1,29,kaist_dataset/Korean/Digital_Camera/outdoor5/DSC03752.JPG,char_data/1/DSC03752.JPG_2.jpg,232,480,640,8,204,212,411,440,True,3
1,110,kaist_dataset/Korean/Digital_Camera/outdoor5/DSC03760.JPG,char_data/1/DSC03760.JPG_2.jpg,4180,480,640,38,343,381,65,175,True,3
1,16,kaist_dataset/Korean/Digital_Camera/outdoor5/DSC03776.JPG,char_data/1/DSC03776.JPG_4.jpg,144,480,640,9,534,543,443,459,True,3
1,17,kaist_dataset/Korean/Digital_Camera/outdoor5/DSC03776.JPG,char_data/1/DSC03776.JPG_5.jpg,153,480,640,9,557,566,442,459,True,3
1,39,kaist_dataset/Korean/Digital_Camera/outdoor5/DSC03777.JPG,char_data/1/DSC03777.JPG_10.jpg,429,480,640,11,90,101,338,377,True,3
1,34,kaist_dataset/Korean/Digital_Camera/outdoor5/DSC03777.JPG,char_data/1/DSC03777.JPG_11.jpg,340,480,640,10,101,111,341,375,True,3
1,33,kaist_dataset/Korean/Digital_Camera/outdoor5/DSC03777.JPG,char_data/1/DSC03777.JPG_12.jpg,429,480,640,13,183,196,343,376,True,3
1,29,kaist_dataset/Korean/Digital_Camera/outdoor5/DSC03777.JPG,char_data/1/DSC03777.JPG_13.jpg,261,480,640,9,196,205,342,371,True,3
1,29,kaist_dataset/Korean/Digital_Camera/outdoor5/DSC03777.JPG,char_data/1/DSC03777.JPG_14.jpg,232,480,640,8,206,214,341,370,True,3
1,35,kaist_dataset/Korean/Digital_Camera/outdoor5/DSC03778.JPG,char_data/1/DSC03778.JPG_4.jpg,490,480,640,14,374,388,342,377,True,3
1,36,kaist_dataset/Korean/Digital_Camera/outdoor5/DSC03778.JPG,char_data/1/DSC03778.JPG_5.jpg,540,480,640,15,387,402,339,375,True,3
1,34,kaist_dataset/Korean/Digital_Camera/outdoor5/DSC03779.JPG,char_data/1/DSC03779.JPG_4.jpg,306,480,640,9,569,578,242,276,True,3
1,32,kaist_dataset/Korean/Digital_Camera/outdoor5/DSC03779.JPG,char_data/1/DSC03779.JPG_5.jpg,608,480,640,19,601,620,246,278,True,3
1,28,kaist_dataset/Korean/Digital_Camera/outdoor5/DSC03780.JPG,char_data/1/DSC03780.JPG_2.jpg,448,480,640,16,264,280,435,463,True,3
1,39,kaist_dataset/Korean/Digital_Camera/outdoor5/DSC03789.JPG,char_data/1/DSC03789.JPG_6.jpg,858,480,640,22,229,251,165,204,True,3
1,37,kaist_dataset/Korean/Digital_Camera/outdoor5/DSC03789.JPG,char_data/1/DSC03789.JPG_7.jpg,592,480,640,16,251,267,167,204,True,3
1,37,kaist_dataset/Korean/Digital_Camera/outdoor5/DSC03789.JPG,char_data/1/DSC03789.JPG_8.jpg,740,480,640,20,229,249,212,249,True,3
1,79,kaist_dataset/Korean/Digital_Camera/outdoor5/DSC03790.JPG,char_data/1/DSC03790.JPG_2.jpg,3160,480,640,40,400,440,144,223,True,3
1,33,kaist_dataset/Korean/Digital_Camera/outdoor5/DSC03794.JPG,char_data/1/DSC03794.JPG_2.jpg,462,480,640,14,270,284,367,400,True,3
1,59,kaist_dataset/Korean/Digital_Camera/outdoor5/DSC03848.JPG,char_data/1/DSC03848.JPG_2.jpg,1003,480,640,17,433,450,196,255,True,3
1,43,kaist_dataset/Korean/Digital_Camera/outdoor5/DSC03979.JPG,char_data/1/DSC03979.JPG_2.jpg,1032,480,640,24,584,608,357,400,True,3
1,37,kaist_dataset/Korean/Digital_Camera/outdoor5/DSC03996.JPG,char_data/1/DSC03996.JPG_2.jpg,888,480,640,24,404,428,277,314,True,3
1,33,kaist_dataset/Korean/Digital_Camera/outdoor5/DSC04027.JPG,char_data/1/DSC04027.JPG_6.jpg,363,480,640,11,210,221,386,419,True,3
1,32,kaist_dataset/Korean/Digital_Camera/outdoor5/DSC04027.JPG,char_data/1/DSC04027.JPG_7.jpg,320,480,640,10,335,345,386,418,True,3
1,35,kaist_dataset/Korean/Digital_Camera/outdoor5/DSC04027.JPG,char_data/1/DSC04027.JPG_8.jpg,315,480,640,9,422,431,382,417,True,3
1,21,kaist_dataset/Korean/Digital_Camera/outdoor6/DSC04042.JPG,char_data/1/DSC04042.JPG_2.jpg,315,480,640,15,110,125,333,354,True,3
1,30,kaist_dataset/Korean/Digital_Camera/outdoor6/DSC04062.JPG,char_data/1/DSC04062.JPG_2.jpg,210,480,640,7,565,572,305,335,True,3
1,80,kaist_dataset/Korean/Digital_Camera/outdoor6/DSC04096.JPG,char_data/1/DSC04096.JPG_2.jpg,2720,480,640,34,341,375,226,306,True,3
1,55,kaist_dataset/Korean/Digital_Camera/outdoor6/DSC04100.JPG,char_data/1/DSC04100.JPG_2.jpg,715,480,640,13,290,303,50,105,True,3
1,33,kaist_dataset/Korean/Digital_Camera/outdoor6/DSC04112.JPG,char_data/1/DSC04112.JPG_6.jpg,396,480,640,12,348,360,273,306,True,3
1,37,kaist_dataset/Korean/Digital_Camera/outdoor6/DSC04112.JPG,char_data/1/DSC04112.JPG_7.jpg,481,480,640,13,484,497,271,308,True,3
1,37,kaist_dataset/Korean/Digital_Camera/outdoor6/DSC04112.JPG,char_data/1/DSC04112.JPG_8.jpg,407,480,640,11,497,508,271,308,True,3
1,52,kaist_dataset/Korean/Digital_Camera/outdoor6/DSC04118.JPG,char_data/1/DSC04118.JPG_6.jpg,1300,480,640,25,256,281,253,305,True,3
1,52,kaist_dataset/Korean/Digital_Camera/outdoor6/DSC04118.JPG,char_data/1/DSC04118.JPG_7.jpg,1560,480,640,30,426,456,258,310,True,3
1,49,kaist_dataset/Korean/Digital_Camera/outdoor6/DSC04118.JPG,char_data/1/DSC04118.JPG_8.jpg,1323,480,640,27,485,512,257,306,True,3
1,49,kaist_dataset/Korean/Digital_Camera/outdoor6/DSC04136.JPG,char_data/1/DSC04136.JPG_2.jpg,1029,480,640,21,331,352,327,376,True,3
1,57,kaist_dataset/Korean/Digital_Camera/outdoor6/DSC04143.JPG,char_data/1/DSC04143.JPG_2.jpg,1710,480,640,30,414,444,358,415,True,3
1,45,kaist_dataset/Korean/Digital_Camera/outdoor6/DSC04148.JPG,char_data/1/DSC04148.JPG_4.jpg,855,480,640,19,395,414,201,246,True,3
1,42,kaist_dataset/Korean/Digital_Camera/outdoor6/DSC04148.JPG,char_data/1/DSC04148.JPG_5.jpg,840,480,640,20,414,434,202,244,True,3
1,58,kaist_dataset/Korean/Digital_Camera/outdoor6/DSC04296.JPG,char_data/1/DSC04296.JPG_2.jpg,928,480,640,16,212,228,315,373,True,3
1,36,kaist_dataset/Korean/Digital_Camera/outdoor6/DSC04339.JPG,char_data/1/DSC04339.JPG_2.jpg,756,480,640,21,354,375,211,247,True,3
1,25,kaist_dataset/Korean/Digital_Camera/outdoor6/DSC04343.JPG,char_data/1/DSC04343.JPG_4.jpg,425,480,640,17,368,385,208,233,True,3
1,33,kaist_dataset/Korean/Digital_Camera/outdoor6/DSC04343.JPG,char_data/1/DSC04343.JPG_5.jpg,759,480,640,23,426,449,202,235,True,3
1,48,kaist_dataset/Korean/Digital_Camera/outdoor6/DSC04400.JPG,char_data/1/DSC04400.JPG_4.jpg,1152,480,640,24,422,446,218,266,True,3
1,45,kaist_dataset/Korean/Digital_Camera/outdoor6/DSC04400.JPG,char_data/1/DSC04400.JPG_5.jpg,1035,480,640,23,374,397,396,441,True,3
1,34,kaist_dataset/Korean/Digital_Camera/outdoor7/P1010003.JPG,char_data/1/P1010003.JPG_2.jpg,714,480,640,21,375,396,278,312,True,3
1,34,kaist_dataset/Korean/Digital_Camera/outdoor7/P1010004.JPG,char_data/1/P1010004.JPG_6.jpg,408,480,640,12,468,480,295,329,True,3
1,33,kaist_dataset/Korean/Digital_Camera/outdoor7/P1010004.JPG,char_data/1/P1010004.JPG_7.jpg,495,480,640,15,556,571,296,329,True,3
1,33,kaist_dataset/Korean/Digital_Camera/outdoor7/P1010004.JPG,char_data/1/P1010004.JPG_8.jpg,297,480,640,9,582,591,293,326,True,3
1,52,kaist_dataset/Korean/Digital_Camera/outdoor7/P1010023.JPG,char_data/1/P1010023.JPG_6.jpg,1404,480,640,27,79,106,292,344,True,3
1,57,kaist_dataset/Korean/Digital_Camera/outdoor7/P1010023.JPG,char_data/1/P1010023.JPG_7.jpg,1539,480,640,27,343,370,285,342,True,3
1,56,kaist_dataset/Korean/Digital_Camera/outdoor7/P1010023.JPG,char_data/1/P1010023.JPG_8.jpg,1232,480,640,22,370,392,283,339,True,3
1,39,kaist_dataset/Korean/Digital_Camera/outdoor7/P1010061.JPG,char_data/1/P1010061.JPG_2.jpg,858,480,640,22,443,465,319,358,True,3
1,64,kaist_dataset/Korean/Digital_Camera/outdoor7/P1010068.JPG,char_data/1/P1010068.JPG_2.jpg,1856,480,640,29,141,170,272,336,True,3
1,39,kaist_dataset/Korean/Digital_Camera/outdoor7/P1010069.JPG,char_data/1/P1010069.JPG_2.jpg,585,480,640,15,542,557,315,354,True,3
1,66,kaist_dataset/Korean/Digital_Camera/outdoor7/P1010080.JPG,char_data/1/P1010080.JPG_2.jpg,1848,480,640,28,390,418,191,257,True,3
1,40,kaist_dataset/Korean/Digital_Camera/outdoor7/P1010091.JPG,char_data/1/P1010091.JPG_2.jpg,680,480,640,17,399,416,227,267,True,3
1,25,kaist_dataset/Korean/Digital_Camera/outdoor7/P1010107.JPG,char_data/1/P1010107.JPG_4.jpg,425,480,640,17,331,348,229,254,True,3
1,25,kaist_dataset/Korean/Digital_Camera/outdoor7/P1010107.JPG,char_data/1/P1010107.JPG_5.jpg,400,480,640,16,363,379,229,254,True,3
1,49,kaist_dataset/Korean/Digital_Camera/outdoor8/P1010147.JPG,char_data/1/P1010147.JPG_2.jpg,1078,480,640,22,467,489,314,363,True,3
1,71,kaist_dataset/Korean/Digital_Camera/outdoor8/P1010160.JPG,char_data/1/P1010160.JPG_2.jpg,2485,480,640,35,339,374,224,295,True,3
1,52,kaist_dataset/Korean/Digital_Camera/outdoor8/P1010171.JPG,char_data/1/P1010171.JPG_4.jpg,1196,480,640,23,517,540,227,279,True,3
1,54,kaist_dataset/Korean/Digital_Camera/outdoor8/P1010171.JPG,char_data/1/P1010171.JPG_5.jpg,1296,480,640,24,569,593,228,282,True,3
1,64,kaist_dataset/Korean/Digital_Camera/outdoor8/P1010172.JPG,char_data/1/P1010172.JPG_2.jpg,1728,480,640,27,331,358,226,290,True,3
1,70,kaist_dataset/Korean/Digital_Camera/outdoor8/P1010181.JPG,char_data/1/P1010181.JPG_4.jpg,1610,480,640,23,440,463,195,265,True,3
1,88,kaist_dataset/Korean/Digital_Camera/outdoor8/P1010181.JPG,char_data/1/P1010181.JPG_5.jpg,2992,480,640,34,445,479,293,381,True,3
1,35,kaist_dataset/Korean/Digital_Camera/outdoor8/P1010189.JPG,char_data/1/P1010189.JPG_2.jpg,770,480,640,22,120,142,232,267,True,3
1,34,kaist_dataset/Korean/Digital_Camera/outdoor8/P1011112.JPG,char_data/1/P1011112.JPG_4.jpg,442,480,640,13,473,486,222,256,True,3
1,39,kaist_dataset/Korean/Digital_Camera/outdoor8/P1011112.JPG,char_data/1/P1011112.JPG_5.jpg,468,480,640,12,486,498,221,260,True,3
1,23,kaist_dataset/Korean/Digital_Camera/outdoor8/크기변환_P1010033.JPG,char_data/1/크기변환_P1010033.JPG_2.jpg,345,480,640,15,443,458,177,200,True,3
1,49,"kaist_dataset/Korean/Mobile_Phone/(M,K)C-outdoor/P090912033.jpg",char_data/1/P090912033.jpg_4.jpg,833,480,640,17,357,374,303,352,True,3
1,57,"kaist_dataset/Korean/Mobile_Phone/(M,K)C-outdoor/P090912033.jpg",char_data/1/P090912033.jpg_5.jpg,1254,480,640,22,376,398,353,410,True,3
1,41,"kaist_dataset/Korean/Mobile_Phone/(M,K)E-bookCover/P090831033.jpg",char_data/1/P090831033.jpg_2.jpg,656,480,640,16,267,283,408,449,True,3
1,86,"kaist_dataset/Korean/Mobile_Phone/(M,K)E-bookCover/P090831047.jpg",char_data/1/P090831047.jpg_2.jpg,1548,480,640,18,59,77,145,231,True,3
1,102,"kaist_dataset/Korean/Mobile_Phone/(M,K)E-bookCover/P090831056.jpg",char_data/1/P090831056.jpg_2.jpg,3060,480,640,30,599,629,168,270,True,3
1,74,"kaist_dataset/Korean/Mobile_Phone/(M,K)E-bookCover/P090831082.jpg",char_data/1/P090831082.jpg_2.jpg,2442,480,640,33,342,375,34,108,True,3
1,66,"kaist_dataset/Korean/Mobile_Phone/(M,K)E-bookCover/P090831084.jpg",char_data/1/P090831084.jpg_2.jpg,1914,480,640,29,312,341,42,108,True,3
1,72,"kaist_dataset/Korean/Mobile_Phone/(M,K)E-bookCover/P090831086.jpg",char_data/1/P090831086.jpg_2.jpg,2376,480,640,33,341,374,35,107,True,3
1,70,"kaist_dataset/Korean/Mobile_Phone/(M,K)E-bookCover/P090831087.jpg",char_data/1/P090831087.jpg_2.jpg,2310,480,640,33,352,385,24,94,True,3
1,66,"kaist_dataset/Korean/Mobile_Phone/(M,K)E-bookCover/P090831088.jpg",char_data/1/P090831088.jpg_2.jpg,2112,480,640,32,346,378,14,80,True,3
1,76,"kaist_dataset/Korean/Mobile_Phone/(M,K)E-bookCover/P090831089.jpg",char_data/1/P090831089.jpg_2.jpg,3116,480,640,41,378,419,25,101,True,3
1,82,"kaist_dataset/Korean/Mobile_Phone/(M,K)E-bookCover/P090831090.jpg",char_data/1/P090831090.jpg_2.jpg,2952,480,640,36,422,458,30,112,True,3
1,87,"kaist_dataset/Korean/Mobile_Phone/(M,K)E-bookCover/P090831091.jpg",char_data/1/P090831091.jpg_2.jpg,3480,480,640,40,410,450,25,112,True,3
1,86,"kaist_dataset/Korean/Mobile_Phone/(M,K)E-bookCover/P090831094.jpg",char_data/1/P090831094.jpg_2.jpg,3096,480,640,36,397,433,33,119,True,3
1,90,"kaist_dataset/Korean/Mobile_Phone/(M,K)E-bookCover/P090831095.jpg",char_data/1/P090831095.jpg_2.jpg,3240,480,640,36,425,461,34,124,True,3
1,83,"kaist_dataset/Korean/Mobile_Phone/(M,K)E-bookCover/P090831096.jpg",char_data/1/P090831096.jpg_2.jpg,3154,480,640,38,399,437,41,124,True,3
1,88,"kaist_dataset/Korean/Mobile_Phone/(M,K)E-bookCover/P090831097.jpg",char_data/1/P090831097.jpg_2.jpg,3080,480,640,35,411,446,35,123,True,3
1,79,"kaist_dataset/Korean/Mobile_Phone/(M,K)E-bookCover/P090831098.jpg",char_data/1/P090831098.jpg_2.jpg,2449,480,640,31,424,455,31,110,True,3
1,81,"kaist_dataset/Korean/Mobile_Phone/(M,K)E-bookCover/P090831099.jpg",char_data/1/P090831099.jpg_2.jpg,2916,480,640,36,421,457,23,104,True,3
1,82,"kaist_dataset/Korean/Mobile_Phone/(M,K)E-bookCover/P090831100.jpg",char_data/1/P090831100.jpg_2.jpg,3444,480,640,42,405,447,44,126,True,3
1,104,"kaist_dataset/Korean/Mobile_Phone/(M,K)E-bookCover/P090831105.jpg",char_data/1/P090831105.jpg_2.jpg,4056,480,640,39,521,560,97,201,True,3
1,81,"kaist_dataset/Korean/Mobile_Phone/(M,K)E-bookCover/P090831154.jpg",char_data/1/P090831154.jpg_2.jpg,3078,480,640,38,419,457,137,218,True,3
1,77,"kaist_dataset/Korean/Mobile_Phone/(M,K)E-bookCover/P090903084.jpg",char_data/1/P090903084.jpg_2.jpg,3234,480,640,42,512,554,331,408,True,3
1,130,"kaist_dataset/Korean/Mobile_Phone/(M,K)E-bookCover/P090911010.jpg",char_data/1/P090911010.jpg_2.jpg,8710,480,640,67,199,266,124,254,True,3
1,44,kaist_dataset/Mixed/Digital_Camera/(C.S)A-shadow/DSC02567.JPG,char_data/1/DSC02567.JPG_8.jpg,1100,480,640,25,317,342,142,186,True,3
1,44,kaist_dataset/Mixed/Digital_Camera/(C.S)A-shadow/DSC02567.JPG,char_data/1/DSC02567.JPG_9.jpg,1012,480,640,23,379,402,142,186,True,3
1,70,kaist_dataset/Mixed/Digital_Camera/(C.S)A-shadow/DSC02568.JPG,char_data/1/DSC02568.JPG_4.jpg,2170,480,640,31,469,500,213,283,True,3
1,26,kaist_dataset/Mixed/Digital_Camera/(C.S)A-shadow/DSC02624.JPG,char_data/1/DSC02624.JPG_4.jpg,312,480,640,12,516,528,401,427,True,3
1,59,kaist_dataset/Mixed/Digital_Camera/(C.S)A-shadow/DSC04304.JPG,char_data/1/DSC04304.JPG_2.jpg,1888,480,640,32,474,506,283,342,True,3
1,25,kaist_dataset/Mixed/Digital_Camera/(C.S)A-shadow/P1010017.JPG,char_data/1/P1010017.JPG_2.jpg,400,480,640,16,77,93,130,155,True,3
1,35,kaist_dataset/Mixed/Digital_Camera/(C.S)B-light/DSC03298.JPG,char_data/1/DSC03298.JPG_2.jpg,525,480,640,15,407,422,288,323,True,3
1,31,kaist_dataset/Mixed/Digital_Camera/(C.S)C-outdoor1/008.JPG,char_data/1/008.JPG_2.jpg,403,480,640,13,475,488,265,296,True,3
1,29,kaist_dataset/Mixed/Digital_Camera/(C.S)C-outdoor1/014.JPG,char_data/1/014.JPG_2.jpg,261,480,640,9,214,223,275,304,True,3
1,58,kaist_dataset/Mixed/Digital_Camera/(C.S)C-outdoor1/025.JPG,char_data/1/025.JPG_2.jpg,1392,480,640,24,181,205,332,390,True,3
1,28,kaist_dataset/Mixed/Digital_Camera/(C.S)C-outdoor1/027.JPG,char_data/1/027.JPG_4.jpg,476,480,640,17,423,440,277,305,True,3
1,32,kaist_dataset/Mixed/Digital_Camera/(C.S)C-outdoor1/027.JPG,char_data/1/027.JPG_5.jpg,608,480,640,19,496,515,275,307,True,3
1,22,kaist_dataset/Mixed/Digital_Camera/(C.S)C-outdoor1/047.JPG,char_data/1/047.JPG_4.jpg,220,480,640,10,527,537,240,262,True,3
1,21,kaist_dataset/Mixed/Digital_Camera/(C.S)C-outdoor1/047.JPG,char_data/1/047.JPG_5.jpg,168,480,640,8,537,545,240,261,True,3
1,30,kaist_dataset/Mixed/Digital_Camera/(C.S)C-outdoor1/054.JPG,char_data/1/054.JPG_2.jpg,450,480,640,15,491,506,301,331,True,3
1,53,kaist_dataset/Mixed/Digital_Camera/(C.S)C-outdoor1/080116-0084.jpg,char_data/1/080116-0084.jpg_4.jpg,1113,600,800,21,686,707,304,357,True,3
1,55,kaist_dataset/Mixed/Digital_Camera/(C.S)C-outdoor1/080116-0084.jpg,char_data/1/080116-0084.jpg_5.jpg,1650,600,800,30,706,736,305,360,True,3
1,114,kaist_dataset/Mixed/Digital_Camera/(C.S)C-outdoor1/080118-0014.jpg,char_data/1/080118-0014.jpg_2.jpg,5586,1200,1600,49,1121,1170,1026,1140,True,3
1,43,kaist_dataset/Mixed/Digital_Camera/(C.S)C-outdoor1/081.JPG,char_data/1/081.JPG_6.jpg,1333,480,640,31,240,271,254,297,True,3
1,40,kaist_dataset/Mixed/Digital_Camera/(C.S)C-outdoor1/081.JPG,char_data/1/081.JPG_7.jpg,1520,480,640,38,340,378,257,297,True,3
1,39,kaist_dataset/Mixed/Digital_Camera/(C.S)C-outdoor1/081.JPG,char_data/1/081.JPG_8.jpg,1170,480,640,30,381,411,257,296,True,3
1,49,kaist_dataset/Mixed/Digital_Camera/(C.S)C-outdoor1/1.JPG,char_data/1/1.JPG_4.jpg,1127,576,768,23,144,167,460,509,True,3
1,53,kaist_dataset/Mixed/Digital_Camera/(C.S)C-outdoor1/1.JPG,char_data/1/1.JPG_5.jpg,954,576,768,18,238,256,458,511,True,3
1,40,kaist_dataset/Mixed/Digital_Camera/(C.S)C-outdoor1/105.jpg,char_data/1/105.jpg_2.jpg,560,480,640,14,254,268,384,424,True,3
1,31,kaist_dataset/Mixed/Digital_Camera/(C.S)C-outdoor1/135.JPG,char_data/1/135.JPG_2.jpg,465,480,640,15,261,276,256,287,True,3
1,41,kaist_dataset/Mixed/Digital_Camera/(C.S)C-outdoor1/2.JPG,char_data/1/2.JPG_2.jpg,533,576,768,13,210,223,64,105,True,3
1,153,kaist_dataset/Mixed/Digital_Camera/(C.S)C-outdoor1/2007-12-08-day-118.jpg,char_data/1/2007-12-08-day-118.jpg_2.jpg,14688,1200,1600,96,635,731,565,718,True,3
1,37,kaist_dataset/Mixed/Digital_Camera/(C.S)C-outdoor1/2007-12-08-day-130.jpg,char_data/1/2007-12-08-day-130.jpg_2.jpg,666,1200,1600,18,1010,1028,758,795,True,3
1,311,kaist_dataset/Mixed/Digital_Camera/(C.S)C-outdoor1/2007-12-08-day-137.jpg,char_data/1/2007-12-08-day-137.jpg_2.jpg,48516,1200,1600,156,428,584,366,677,True,3
1,47,kaist_dataset/Mixed/Digital_Camera/(C.S)C-outdoor1/2007-12-09-day-exterior-078.jpg,char_data/1/2007-12-09-day-exterior-078.jpg_6.jpg,752,1200,1600,16,540,556,593,640,True,3
1,44,kaist_dataset/Mixed/Digital_Camera/(C.S)C-outdoor1/2007-12-09-day-exterior-078.jpg,char_data/1/2007-12-09-day-exterior-078.jpg_7.jpg,528,1200,1600,12,696,708,590,634,True,3
1,57,kaist_dataset/Mixed/Digital_Camera/(C.S)C-outdoor1/2007-12-09-day-exterior-078.jpg,char_data/1/2007-12-09-day-exterior-078.jpg_8.jpg,798,1200,1600,14,832,846,577,634,True,3
1,75,kaist_dataset/Mixed/Digital_Camera/(C.S)C-outdoor1/2007-12-09-day-exterior-086.jpg,char_data/1/2007-12-09-day-exterior-086.jpg_2.jpg,3750,1200,1600,50,980,1030,721,796,True,3
1,43,kaist_dataset/Mixed/Digital_Camera/(C.S)C-outdoor1/3.JPG,char_data/1/3.JPG_2.jpg,688,576,768,16,543,559,419,462,True,3
1,40,kaist_dataset/Mixed/Digital_Camera/(C.S)C-outdoor1/45.JPG,char_data/1/45.JPG_4.jpg,960,576,768,24,343,367,366,406,True,3
1,43,kaist_dataset/Mixed/Digital_Camera/(C.S)C-outdoor1/45.JPG,char_data/1/45.JPG_5.jpg,1032,576,768,24,484,508,364,407,True,3
1,21,kaist_dataset/Mixed/Digital_Camera/(C.S)C-outdoor1/47.JPG,char_data/1/47.JPG_4.jpg,273,576,768,13,374,387,480,501,True,3
1,24,kaist_dataset/Mixed/Digital_Camera/(C.S)C-outdoor1/47.JPG,char_data/1/47.JPG_5.jpg,288,576,768,12,387,399,476,500,True,3
1,25,kaist_dataset/Mixed/Digital_Camera/(C.S)C-outdoor1/48.JPG,char_data/1/48.JPG_6.jpg,300,576,768,12,337,349,341,366,True,3
1,23,kaist_dataset/Mixed/Digital_Camera/(C.S)C-outdoor1/48.JPG,char_data/1/48.JPG_7.jpg,322,576,768,14,349,363,343,366,True,3
1,19,kaist_dataset/Mixed/Digital_Camera/(C.S)C-outdoor1/48.JPG,char_data/1/48.JPG_8.jpg,247,576,768,13,461,474,344,363,True,3
1,39,kaist_dataset/Mixed/Digital_Camera/(C.S)C-outdoor1/51.JPG,char_data/1/51.JPG_2.jpg,819,576,768,21,555,576,376,415,True,3
1,49,kaist_dataset/Mixed/Digital_Camera/(C.S)C-outdoor1/55.JPG,char_data/1/55.JPG_2.jpg,931,576,768,19,360,379,145,194,True,3
1,42,kaist_dataset/Mixed/Digital_Camera/(C.S)C-outdoor1/56.JPG,char_data/1/56.JPG_2.jpg,1176,576,768,28,389,417,301,343,True,3
1,29,kaist_dataset/Mixed/Digital_Camera/(C.S)C-outdoor1/57.JPG,char_data/1/57.JPG_8.jpg,377,500,766,13,499,512,295,324,True,3
1,24,kaist_dataset/Mixed/Digital_Camera/(C.S)C-outdoor1/57.JPG,char_data/1/57.JPG_9.jpg,312,500,766,13,575,588,299,323,True,3
1,26,kaist_dataset/Mixed/Digital_Camera/(C.S)C-outdoor1/57.JPG,char_data/1/57.JPG_10.jpg,260,500,766,10,335,345,455,481,True,3
1,28,kaist_dataset/Mixed/Digital_Camera/(C.S)C-outdoor1/57.JPG,char_data/1/57.JPG_11.jpg,364,500,766,13,405,418,454,482,True,3
1,85,kaist_dataset/Mixed/Digital_Camera/(C.S)C-outdoor1/DSC02244.JPG,char_data/1/DSC02244.JPG_2.jpg,3995,480,640,47,366,413,347,432,True,3
1,46,kaist_dataset/Mixed/Digital_Camera/(C.S)C-outdoor1/DSC02309.JPG,char_data/1/DSC02309.JPG_4.jpg,1380,480,640,30,530,560,241,287,True,3
1,42,kaist_dataset/Mixed/Digital_Camera/(C.S)C-outdoor1/DSC02309.JPG,char_data/1/DSC02309.JPG_5.jpg,840,480,640,20,466,486,391,433,True,3
1,48,kaist_dataset/Mixed/Digital_Camera/(C.S)C-outdoor1/DSC02312.JPG,char_data/1/DSC02312.JPG_2.jpg,912,480,640,19,281,300,217,265,True,3
1,43,kaist_dataset/Mixed/Digital_Camera/(C.S)C-outdoor1/DSC02322.JPG,char_data/1/DSC02322.JPG_2.jpg,1032,480,640,24,273,297,362,405,True,3
1,24,kaist_dataset/Mixed/Digital_Camera/(C.S)C-outdoor1/DSC02323.JPG,char_data/1/DSC02323.JPG_2.jpg,360,480,640,15,71,86,291,315,True,3
1,43,kaist_dataset/Mixed/Digital_Camera/(C.S)C-outdoor1/DSC02325.JPG,char_data/1/DSC02325.JPG_2.jpg,903,480,640,21,325,346,306,349,True,3
1,47,kaist_dataset/Mixed/Digital_Camera/(C.S)C-outdoor1/P1010010.JPG,char_data/1/P1010010.JPG_8.jpg,1222,480,640,26,421,447,210,257,True,3
1,46,kaist_dataset/Mixed/Digital_Camera/(C.S)C-outdoor1/P1010010.JPG,char_data/1/P1010010.JPG_9.jpg,1334,480,640,29,457,486,211,257,True,3
1,45,kaist_dataset/Mixed/Digital_Camera/(C.S)C-outdoor1/P1010010.JPG,char_data/1/P1010010.JPG_10.jpg,720,480,640,16,413,429,359,404,True,3
1,41,kaist_dataset/Mixed/Digital_Camera/(C.S)C-outdoor1/P1010010.JPG,char_data/1/P1010010.JPG_11.jpg,861,480,640,21,429,450,360,401,True,3
1,46,kaist_dataset/Mixed/Digital_Camera/(C.S)C-outdoor2/DSC02359.JPG,char_data/1/DSC02359.JPG_2.jpg,966,480,640,21,384,405,417,463,True,3
1,40,kaist_dataset/Mixed/Digital_Camera/(C.S)C-outdoor2/DSC02368.JPG,char_data/1/DSC02368.JPG_2.jpg,440,480,640,11,415,426,380,420,True,3
1,39,kaist_dataset/Mixed/Digital_Camera/(C.S)C-outdoor2/DSC02389.JPG,char_data/1/DSC02389.JPG_4.jpg,624,480,640,16,370,386,34,73,True,3
1,35,kaist_dataset/Mixed/Digital_Camera/(C.S)C-outdoor2/DSC02389.JPG,char_data/1/DSC02389.JPG_5.jpg,1015,480,640,29,416,445,33,68,True,3
1,36,kaist_dataset/Mixed/Digital_Camera/(C.S)C-outdoor2/DSC02391.JPG,char_data/1/DSC02391.JPG_4.jpg,1008,480,640,28,103,131,333,369,True,3
1,34,kaist_dataset/Mixed/Digital_Camera/(C.S)C-outdoor2/DSC02391.JPG,char_data/1/DSC02391.JPG_5.jpg,646,480,640,19,173,192,334,368,True,3
1,54,kaist_dataset/Mixed/Digital_Camera/(C.S)C-outdoor2/DSC02397.JPG,char_data/1/DSC02397.JPG_2.jpg,1566,480,640,29,609,638,422,476,True,3
1,41,kaist_dataset/Mixed/Digital_Camera/(C.S)C-outdoor2/DSC02413.JPG,char_data/1/DSC02413.JPG_2.jpg,861,480,640,21,426,447,207,248,True,3
1,36,kaist_dataset/Mixed/Digital_Camera/(C.S)C-outdoor2/DSC02422.JPG,char_data/1/DSC02422.JPG_2.jpg,540,480,640,15,159,174,222,258,True,3
1,53,kaist_dataset/Mixed/Digital_Camera/(C.S)C-outdoor2/DSC02461.JPG,char_data/1/DSC02461.JPG_4.jpg,2067,480,640,39,355,394,275,328,True,3
1,56,kaist_dataset/Mixed/Digital_Camera/(C.S)C-outdoor2/DSC02461.JPG,char_data/1/DSC02461.JPG_5.jpg,2352,480,640,42,471,513,272,328,True,3
1,39,kaist_dataset/Mixed/Digital_Camera/(C.S)C-outdoor2/DSC02466.JPG,char_data/1/DSC02466.JPG_2.jpg,741,480,640,19,347,366,251,290,True,3
1,35,kaist_dataset/Mixed/Digital_Camera/(C.S)C-outdoor2/DSC02489.JPG,char_data/1/DSC02489.JPG_2.jpg,630,480,640,18,378,396,260,295,True,3
1,33,kaist_dataset/Mixed/Digital_Camera/(C.S)C-outdoor2/DSC02492.JPG,char_data/1/DSC02492.JPG_2.jpg,396,480,640,12,435,447,326,359,True,3
1,70,kaist_dataset/Mixed/Digital_Camera/(C.S)C-outdoor2/DSC02502.JPG,char_data/1/DSC02502.JPG_6.jpg,2170,480,640,31,166,197,348,418,True,3
1,60,kaist_dataset/Mixed/Digital_Camera/(C.S)C-outdoor2/DSC02502.JPG,char_data/1/DSC02502.JPG_7.jpg,1800,480,640,30,307,337,345,405,True,3
1,65,kaist_dataset/Mixed/Digital_Camera/(C.S)C-outdoor2/DSC02502.JPG,char_data/1/DSC02502.JPG_8.jpg,2080,480,640,32,336,368,345,410,True,3
1,66,kaist_dataset/Mixed/Digital_Camera/(C.S)C-outdoor2/DSC02503.JPG,char_data/1/DSC02503.JPG_4.jpg,2046,480,640,31,545,576,344,410,True,3
1,66,kaist_dataset/Mixed/Digital_Camera/(C.S)C-outdoor2/DSC02503.JPG,char_data/1/DSC02503.JPG_5.jpg,2244,480,640,34,577,611,345,411,True,3
1,81,kaist_dataset/Mixed/Digital_Camera/(C.S)C-outdoor2/DSC02513.JPG,char_data/1/DSC02513.JPG_2.jpg,2754,480,640,34,240,274,142,223,True,3
1,37,kaist_dataset/Mixed/Digital_Camera/(C.S)C-outdoor2/DSC02543.JPG,char_data/1/DSC02543.JPG_2.jpg,666,480,640,18,415,433,347,384,True,3
1,40,kaist_dataset/Mixed/Digital_Camera/(C.S)C-outdoor2/DSC02545.JPG,char_data/1/DSC02545.JPG_2.jpg,560,480,640,14,286,300,399,439,True,3
1,33,kaist_dataset/Mixed/Digital_Camera/(C.S)C-outdoor2/DSC02553.JPG,char_data/1/DSC02553.JPG_2.jpg,561,480,640,17,393,410,300,333,True,3
1,34,kaist_dataset/Mixed/Digital_Camera/(C.S)C-outdoor2/DSC02557.JPG,char_data/1/DSC02557.JPG_2.jpg,544,480,640,16,453,469,212,246,True,3
1,44,kaist_dataset/Mixed/Digital_Camera/(C.S)C-outdoor2/DSC02567.JPG,char_data/1/DSC02567.JPG_10.jpg,1100,480,640,25,317,342,142,186,True,3
1,44,kaist_dataset/Mixed/Digital_Camera/(C.S)C-outdoor2/DSC02567.JPG,char_data/1/DSC02567.JPG_11.jpg,1012,480,640,23,379,402,142,186,True,3
1,70,kaist_dataset/Mixed/Digital_Camera/(C.S)C-outdoor2/DSC02568.JPG,char_data/1/DSC02568.JPG_5.jpg,2170,480,640,31,469,500,213,283,True,3
1,26,kaist_dataset/Mixed/Digital_Camera/(C.S)C-outdoor2/DSC02624.JPG,char_data/1/DSC02624.JPG_5.jpg,312,480,640,12,516,528,401,427,True,3
1,95,kaist_dataset/Mixed/Digital_Camera/(C.S)C-outdoor2/DSC02865.JPG,char_data/1/DSC02865.JPG_4.jpg,5510,480,640,58,47,105,303,398,True,3
1,91,kaist_dataset/Mixed/Digital_Camera/(C.S)C-outdoor2/DSC02865.JPG,char_data/1/DSC02865.JPG_5.jpg,4641,480,640,51,303,354,312,403,True,3
1,26,kaist_dataset/Mixed/Digital_Camera/(C.S)C-outdoor2/DSC02879.JPG,char_data/1/DSC02879.JPG_6.jpg,468,480,640,18,315,333,278,304,True,3
1,21,kaist_dataset/Mixed/Digital_Camera/(C.S)C-outdoor2/DSC02879.JPG,char_data/1/DSC02879.JPG_7.jpg,315,480,640,15,332,347,279,300,True,3
1,37,kaist_dataset/Mixed/Digital_Camera/(C.S)C-outdoor2/DSC02879.JPG,char_data/1/DSC02879.JPG_8.jpg,370,480,640,10,358,368,265,302,True,3
1,35,kaist_dataset/Mixed/Digital_Camera/(C.S)C-outdoor2/DSC02887.JPG,char_data/1/DSC02887.JPG_2.jpg,630,480,640,18,338,356,119,154,True,3
1,37,kaist_dataset/Mixed/Digital_Camera/(C.S)C-outdoor2/DSC02895.JPG,char_data/1/DSC02895.JPG_2.jpg,666,480,640,18,300,318,352,389,True,3
1,33,kaist_dataset/Mixed/Digital_Camera/(C.S)C-outdoor2/DSC02926.JPG,char_data/1/DSC02926.JPG_2.jpg,495,480,640,15,423,438,151,184,True,3
1,37,kaist_dataset/Mixed/Digital_Camera/(C.S)C-outdoor2/DSC02933.JPG,char_data/1/DSC02933.JPG_2.jpg,407,480,640,11,559,570,245,282,True,3
1,46,kaist_dataset/Mixed/Digital_Camera/(C.S)C-outdoor2/DSC02938.JPG,char_data/1/DSC02938.JPG_2.jpg,874,480,640,19,543,562,239,285,True,3
1,39,kaist_dataset/Mixed/Digital_Camera/(C.S)C-outdoor2/DSC02954.JPG,char_data/1/DSC02954.JPG_4.jpg,507,480,640,13,396,409,263,302,True,3
1,35,kaist_dataset/Mixed/Digital_Camera/(C.S)C-outdoor2/DSC02954.JPG,char_data/1/DSC02954.JPG_5.jpg,700,480,640,20,408,428,263,298,True,3
1,49,kaist_dataset/Mixed/Digital_Camera/(C.S)C-outdoor2/P1010013.JPG,char_data/1/P1010013.JPG_2.jpg,1274,480,640,26,345,371,366,415,True,3
1,24,kaist_dataset/Mixed/Digital_Camera/(C.S)C-outdoor2/P1010015.JPG,char_data/1/P1010015.JPG_2.jpg,168,480,640,7,255,262,184,208,True,3
1,43,kaist_dataset/Mixed/Digital_Camera/(C.S)C-outdoor3/DSC02956.JPG,char_data/1/DSC02956.JPG_4.jpg,688,480,640,16,217,233,388,431,True,3
1,39,kaist_dataset/Mixed/Digital_Camera/(C.S)C-outdoor3/DSC02956.JPG,char_data/1/DSC02956.JPG_5.jpg,546,480,640,14,233,247,399,438,True,3
1,36,kaist_dataset/Mixed/Digital_Camera/(C.S)C-outdoor3/DSC02970.JPG,char_data/1/DSC02970.JPG_2.jpg,1152,480,640,32,227,259,365,401,True,3
1,34,kaist_dataset/Mixed/Digital_Camera/(C.S)C-outdoor3/DSC03017.JPG,char_data/1/DSC03017.JPG_4.jpg,408,480,640,12,406,418,242,276,True,3
1,34,kaist_dataset/Mixed/Digital_Camera/(C.S)C-outdoor3/DSC03017.JPG,char_data/1/DSC03017.JPG_5.jpg,612,480,640,18,449,467,242,276,True,3
1,32,kaist_dataset/Mixed/Digital_Camera/(C.S)C-outdoor3/DSC03051.JPG,char_data/1/DSC03051.JPG_4.jpg,608,480,640,19,283,302,320,352,True,3
1,29,kaist_dataset/Mixed/Digital_Camera/(C.S)C-outdoor3/DSC03051.JPG,char_data/1/DSC03051.JPG_5.jpg,522,480,640,18,320,338,320,349,True,3
1,29,kaist_dataset/Mixed/Digital_Camera/(C.S)C-outdoor3/DSC03062.JPG,char_data/1/DSC03062.JPG_4.jpg,319,480,640,11,341,352,246,275,True,3
1,28,kaist_dataset/Mixed/Digital_Camera/(C.S)C-outdoor3/DSC03062.JPG,char_data/1/DSC03062.JPG_5.jpg,280,480,640,10,354,364,245,273,True,3
1,65,kaist_dataset/Mixed/Digital_Camera/(C.S)C-outdoor3/DSC03067.JPG,char_data/1/DSC03067.JPG_2.jpg,2275,480,640,35,134,169,194,259,True,3
1,51,kaist_dataset/Mixed/Digital_Camera/(C.S)C-outdoor3/DSC03164.JPG,char_data/1/DSC03164.JPG_2.jpg,1581,480,640,31,419,450,211,262,True,3
1,46,kaist_dataset/Mixed/Digital_Camera/(C.S)C-outdoor3/DSC03177.JPG,char_data/1/DSC03177.JPG_2.jpg,1472,480,640,32,110,142,194,240,True,3
1,47,kaist_dataset/Mixed/Digital_Camera/(C.S)C-outdoor3/DSC03185.JPG,char_data/1/DSC03185.JPG_2.jpg,1410,480,640,30,516,546,158,205,True,3
1,47,kaist_dataset/Mixed/Digital_Camera/(C.S)C-outdoor3/DSC03199.JPG,char_data/1/DSC03199.JPG_6.jpg,1034,480,640,22,430,452,383,430,True,3
1,61,kaist_dataset/Mixed/Digital_Camera/(C.S)C-outdoor3/DSC03199.JPG,char_data/1/DSC03199.JPG_7.jpg,2074,480,640,34,163,197,321,382,True,3
1,67,kaist_dataset/Mixed/Digital_Camera/(C.S)C-outdoor3/DSC03199.JPG,char_data/1/DSC03199.JPG_8.jpg,2479,480,640,37,196,233,319,386,True,3
1,30,kaist_dataset/Mixed/Digital_Camera/(C.S)C-outdoor3/DSC03250.JPG,char_data/1/DSC03250.JPG_2.jpg,420,480,640,14,519,533,405,435,True,3
1,36,kaist_dataset/Mixed/Digital_Camera/(C.S)C-outdoor3/DSC03301.JPG,char_data/1/DSC03301.JPG_2.jpg,468,480,640,13,390,403,142,178,True,3
1,39,kaist_dataset/Mixed/Digital_Camera/(C.S)C-outdoor3/DSC03308.JPG,char_data/1/DSC03308.JPG_2.jpg,741,480,640,19,451,470,246,285,True,3
1,35,kaist_dataset/Mixed/Digital_Camera/(C.S)C-outdoor3/DSC03311.JPG,char_data/1/DSC03311.JPG_6.jpg,385,480,640,11,372,383,367,402,True,3
1,30,kaist_dataset/Mixed/Digital_Camera/(C.S)C-outdoor3/DSC03311.JPG,char_data/1/DSC03311.JPG_7.jpg,360,480,640,12,425,437,370,400,True,3
1,29,kaist_dataset/Mixed/Digital_Camera/(C.S)C-outdoor3/DSC03311.JPG,char_data/1/DSC03311.JPG_8.jpg,464,480,640,16,437,453,369,398,True,3
1,26,kaist_dataset/Mixed/Digital_Camera/(C.S)C-outdoor3/DSC03315.JPG,char_data/1/DSC03315.JPG_2.jpg,364,480,640,14,467,481,120,146,True,3
1,34,kaist_dataset/Mixed/Digital_Camera/(C.S)C-outdoor3/DSC03316.JPG,char_data/1/DSC03316.JPG_2.jpg,408,480,640,12,602,614,81,115,True,3
1,36,kaist_dataset/Mixed/Digital_Camera/(C.S)C-outdoor3/DSC03328.JPG,char_data/1/DSC03328.JPG_6.jpg,468,480,640,13,204,217,402,438,True,3
1,45,kaist_dataset/Mixed/Digital_Camera/(C.S)C-outdoor3/DSC03328.JPG,char_data/1/DSC03328.JPG_7.jpg,540,480,640,12,391,403,397,442,True,3
1,41,kaist_dataset/Mixed/Digital_Camera/(C.S)C-outdoor3/DSC03328.JPG,char_data/1/DSC03328.JPG_8.jpg,574,480,640,14,439,453,396,437,True,3
1,55,kaist_dataset/Mixed/Digital_Camera/(C.S)C-outdoor3/DSC03431.JPG,char_data/1/DSC03431.JPG_2.jpg,1375,480,640,25,65,90,47,102,True,3
1,38,kaist_dataset/Mixed/Digital_Camera/(C.S)C-outdoor4/DSC03435.JPG,char_data/1/DSC03435.JPG_2.jpg,646,480,640,17,83,100,233,271,True,3
1,29,kaist_dataset/Mixed/Digital_Camera/(C.S)C-outdoor4/DSC03446.JPG,char_data/1/DSC03446.JPG_2.jpg,464,480,640,16,307,323,293,322,True,3
1,48,kaist_dataset/Mixed/Digital_Camera/(C.S)C-outdoor4/DSC03531.JPG,char_data/1/DSC03531.JPG_4.jpg,1008,480,640,21,537,558,348,396,True,3
1,56,kaist_dataset/Mixed/Digital_Camera/(C.S)C-outdoor4/DSC03531.JPG,char_data/1/DSC03531.JPG_5.jpg,1008,480,640,18,602,620,340,396,True,3
1,61,kaist_dataset/Mixed/Digital_Camera/(C.S)C-outdoor4/DSC03533.JPG,char_data/1/DSC03533.JPG_2.jpg,2257,480,640,37,49,86,298,359,True,3
1,51,kaist_dataset/Mixed/Digital_Camera/(C.S)C-outdoor4/DSC03544.JPG,char_data/1/DSC03544.JPG_2.jpg,1071,480,640,21,429,450,270,321,True,3
1,38,kaist_dataset/Mixed/Digital_Camera/(C.S)C-outdoor4/DSC03549.JPG,char_data/1/DSC03549.JPG_4.jpg,570,480,640,15,580,595,218,256,True,3
1,39,kaist_dataset/Mixed/Digital_Camera/(C.S)C-outdoor4/DSC03549.JPG,char_data/1/DSC03549.JPG_5.jpg,429,480,640,11,614,625,219,258,True,3
1,43,kaist_dataset/Mixed/Digital_Camera/(C.S)C-outdoor4/DSC03556.JPG,char_data/1/DSC03556.JPG_4.jpg,774,480,640,18,530,548,257,300,True,3
1,39,kaist_dataset/Mixed/Digital_Camera/(C.S)C-outdoor4/DSC03556.JPG,char_data/1/DSC03556.JPG_5.jpg,585,480,640,15,26,41,317,356,True,3
1,49,kaist_dataset/Mixed/Digital_Camera/(C.S)C-outdoor4/DSC03571.JPG,char_data/1/DSC03571.JPG_4.jpg,882,480,640,18,341,359,300,349,True,3
1,45,kaist_dataset/Mixed/Digital_Camera/(C.S)C-outdoor4/DSC03571.JPG,char_data/1/DSC03571.JPG_5.jpg,810,480,640,18,432,450,300,345,True,3
1,46,kaist_dataset/Mixed/Digital_Camera/(C.S)C-outdoor4/DSC03617.JPG,char_data/1/DSC03617.JPG_4.jpg,1150,480,640,25,351,376,380,426,True,3
1,47,kaist_dataset/Mixed/Digital_Camera/(C.S)C-outdoor4/DSC03617.JPG,char_data/1/DSC03617.JPG_5.jpg,1175,480,640,25,377,402,378,425,True,3
1,30,kaist_dataset/Mixed/Digital_Camera/(C.S)C-outdoor4/DSC03618.JPG,char_data/1/DSC03618.JPG_2.jpg,450,480,640,15,363,378,413,443,True,3
1,27,kaist_dataset/Mixed/Digital_Camera/(C.S)C-outdoor4/DSC03640.JPG,char_data/1/DSC03640.JPG_2.jpg,297,480,640,11,256,267,400,427,True,3
1,31,kaist_dataset/Mixed/Digital_Camera/(C.S)C-outdoor4/DSC03642.JPG,char_data/1/DSC03642.JPG_4.jpg,434,480,640,14,498,512,396,427,True,3
1,29,kaist_dataset/Mixed/Digital_Camera/(C.S)C-outdoor4/DSC03642.JPG,char_data/1/DSC03642.JPG_5.jpg,377,480,640,13,514,527,399,428,True,3
1,24,kaist_dataset/Mixed/Digital_Camera/(C.S)C-outdoor4/DSC03643.JPG,char_data/1/DSC03643.JPG_4.jpg,288,480,640,12,538,550,329,353,True,3
1,25,kaist_dataset/Mixed/Digital_Camera/(C.S)C-outdoor4/DSC03643.JPG,char_data/1/DSC03643.JPG_5.jpg,275,480,640,11,550,561,328,353,True,3
1,49,kaist_dataset/Mixed/Digital_Camera/(C.S)C-outdoor4/DSC03651.JPG,char_data/1/DSC03651.JPG_2.jpg,1176,480,640,24,365,389,356,405,True,3
1,40,kaist_dataset/Mixed/Digital_Camera/(C.S)C-outdoor4/DSC03658.JPG,char_data/1/DSC03658.JPG_2.jpg,560,480,640,14,418,432,410,450,True,3
1,31,kaist_dataset/Mixed/Digital_Camera/(C.S)C-outdoor4/DSC03661.JPG,char_data/1/DSC03661.JPG_4.jpg,403,480,640,13,396,409,333,364,True,3
1,31,kaist_dataset/Mixed/Digital_Camera/(C.S)C-outdoor4/DSC03661.JPG,char_data/1/DSC03661.JPG_5.jpg,434,480,640,14,446,460,331,362,True,3
1,38,kaist_dataset/Mixed/Digital_Camera/(C.S)C-outdoor4/DSC03665.JPG,char_data/1/DSC03665.JPG_2.jpg,798,480,640,21,387,408,155,193,True,3
1,39,kaist_dataset/Mixed/Digital_Camera/(C.S)C-outdoor4/DSC03667.JPG,char_data/1/DSC03667.JPG_6.jpg,429,480,640,11,385,396,374,413,True,3
1,39,kaist_dataset/Mixed/Digital_Camera/(C.S)C-outdoor4/DSC03667.JPG,char_data/1/DSC03667.JPG_7.jpg,507,480,640,13,395,408,370,409,True,3
1,35,kaist_dataset/Mixed/Digital_Camera/(C.S)C-outdoor4/DSC03667.JPG,char_data/1/DSC03667.JPG_8.jpg,455,480,640,13,521,534,372,407,True,3
1,36,kaist_dataset/Mixed/Digital_Camera/(C.S)C-outdoor4/DSC03673.JPG,char_data/1/DSC03673.JPG_4.jpg,612,480,640,17,119,136,308,344,True,3
1,33,kaist_dataset/Mixed/Digital_Camera/(C.S)C-outdoor4/DSC03673.JPG,char_data/1/DSC03673.JPG_5.jpg,561,480,640,17,136,153,308,341,True,3
1,28,kaist_dataset/Mixed/Digital_Camera/(C.S)C-outdoor4/DSC03677.JPG,char_data/1/DSC03677.JPG_2.jpg,252,480,640,9,548,557,281,309,True,3
1,32,kaist_dataset/Mixed/Digital_Camera/(C.S)C-outdoor4/DSC03691.JPG,char_data/1/DSC03691.JPG_6.jpg,352,480,640,11,449,460,223,255,False,3
1,35,kaist_dataset/Mixed/Digital_Camera/(C.S)C-outdoor4/DSC03691.JPG,char_data/1/DSC03691.JPG_7.jpg,385,480,640,11,460,471,224,259,False,3
1,31,kaist_dataset/Mixed/Digital_Camera/(C.S)C-outdoor4/DSC03691.JPG,char_data/1/DSC03691.JPG_8.jpg,341,480,640,11,590,601,221,252,False,3
1,33,kaist_dataset/Mixed/Digital_Camera/(C.S)C-outdoor4/DSC03716.JPG,char_data/1/DSC03716.JPG_4.jpg,330,480,640,10,605,615,251,284,False,3
1,33,kaist_dataset/Mixed/Digital_Camera/(C.S)C-outdoor4/DSC03716.JPG,char_data/1/DSC03716.JPG_5.jpg,330,480,640,10,628,638,249,282,False,3
1,28,kaist_dataset/Mixed/Digital_Camera/(C.S)C-outdoor4/DSC03718.JPG,char_data/1/DSC03718.JPG_2.jpg,336,480,640,12,523,535,405,433,False,3
1,31,kaist_dataset/Mixed/Digital_Camera/(C.S)C-outdoor4/DSC03719.JPG,char_data/1/DSC03719.JPG_2.jpg,465,480,640,15,527,542,184,215,False,3
1,32,kaist_dataset/Mixed/Digital_Camera/(C.S)C-outdoor4/DSC03722.JPG,char_data/1/DSC03722.JPG_2.jpg,544,480,640,17,329,346,203,235,False,3
1,73,kaist_dataset/Mixed/Digital_Camera/(C.S)C-outdoor4/DSC03730.JPG,char_data/1/DSC03730.JPG_2.jpg,2920,480,640,40,484,524,320,393,False,3
1,33,kaist_dataset/Mixed/Digital_Camera/(C.S)C-outdoor4/DSC03741.JPG,char_data/1/DSC03741.JPG_4.jpg,990,480,640,30,538,568,369,402,False,3
1,37,kaist_dataset/Mixed/Digital_Camera/(C.S)C-outdoor4/DSC03741.JPG,char_data/1/DSC03741.JPG_5.jpg,1073,480,640,29,401,430,362,399,False,3
1,32,kaist_dataset/Mixed/Digital_Camera/(C.S)C-outdoor4/DSC03757.JPG,char_data/1/DSC03757.JPG_2.jpg,320,480,640,10,205,215,337,369,False,3
1,41,kaist_dataset/Mixed/Digital_Camera/(C.S)C-outdoor4/DSC03781.JPG,char_data/1/DSC03781.JPG_2.jpg,697,480,640,17,262,279,376,417,False,3
1,67,kaist_dataset/Mixed/Digital_Camera/(C.S)C-outdoor5/DSC03837.JPG,char_data/1/DSC03837.JPG_2.jpg,1742,480,640,26,295,321,301,368,False,3
1,34,kaist_dataset/Mixed/Digital_Camera/(C.S)C-outdoor5/DSC03839.JPG,char_data/1/DSC03839.JPG_6.jpg,510,480,640,15,258,273,363,397,False,3
1,36,kaist_dataset/Mixed/Digital_Camera/(C.S)C-outdoor5/DSC03839.JPG,char_data/1/DSC03839.JPG_7.jpg,576,480,640,16,351,367,368,404,False,3
1,39,kaist_dataset/Mixed/Digital_Camera/(C.S)C-outdoor5/DSC03839.JPG,char_data/1/DSC03839.JPG_8.jpg,624,480,640,16,366,382,364,403,False,3
1,36,kaist_dataset/Mixed/Digital_Camera/(C.S)C-outdoor5/DSC03842.JPG,char_data/1/DSC03842.JPG_2.jpg,576,480,640,16,269,285,228,264,False,3
1,51,kaist_dataset/Mixed/Digital_Camera/(C.S)C-outdoor5/DSC03847.JPG,char_data/1/DSC03847.JPG_2.jpg,918,480,640,18,525,543,10,61,False,3
1,80,kaist_dataset/Mixed/Digital_Camera/(C.S)C-outdoor5/DSC04016.JPG,char_data/1/DSC04016.JPG_8.jpg,2880,480,640,36,396,432,105,185,False,3
1,74,kaist_dataset/Mixed/Digital_Camera/(C.S)C-outdoor5/DSC04016.JPG,char_data/1/DSC04016.JPG_9.jpg,3108,480,640,42,436,478,107,181,False,3
1,69,kaist_dataset/Mixed/Digital_Camera/(C.S)C-outdoor5/DSC04016.JPG,char_data/1/DSC04016.JPG_10.jpg,2622,480,640,38,168,206,321,390,False,3
1,73,kaist_dataset/Mixed/Digital_Camera/(C.S)C-outdoor5/DSC04016.JPG,char_data/1/DSC04016.JPG_11.jpg,2555,480,640,35,440,475,323,396,False,3
1,52,kaist_dataset/Mixed/Digital_Camera/(C.S)C-outdoor5/DSC04017.JPG,char_data/1/DSC04017.JPG_8.jpg,2392,480,640,46,15,61,5,57,False,3
1,51,kaist_dataset/Mixed/Digital_Camera/(C.S)C-outdoor5/DSC04017.JPG,char_data/1/DSC04017.JPG_9.jpg,2346,480,640,46,63,109,3,54,False,3
1,52,kaist_dataset/Mixed/Digital_Camera/(C.S)C-outdoor5/DSC04017.JPG,char_data/1/DSC04017.JPG_10.jpg,1196,480,640,23,378,401,423,475,False,3
1,52,kaist_dataset/Mixed/Digital_Camera/(C.S)C-outdoor5/DSC04017.JPG,char_data/1/DSC04017.JPG_11.jpg,1716,480,640,33,402,435,426,478,False,3
1,30,kaist_dataset/Mixed/Digital_Camera/(C.S)C-outdoor5/DSC04056.JPG,char_data/1/DSC04056.JPG_2.jpg,390,480,640,13,548,561,300,330,False,3
1,40,kaist_dataset/Mixed/Digital_Camera/(C.S)C-outdoor5/DSC04061.JPG,char_data/1/DSC04061.JPG_2.jpg,520,480,640,13,522,535,143,183,False,3
1,26,kaist_dataset/Mixed/Digital_Camera/(C.S)C-outdoor5/DSC04086.JPG,char_data/1/DSC04086.JPG_2.jpg,234,480,640,9,466,475,374,400,False,3
1,30,kaist_dataset/Mixed/Digital_Camera/(C.S)C-outdoor5/DSC04092.JPG,char_data/1/DSC04092.JPG_2.jpg,330,480,640,11,182,193,328,358,False,3
1,49,kaist_dataset/Mixed/Digital_Camera/(C.S)C-outdoor5/DSC04094.JPG,char_data/1/DSC04094.JPG_4.jpg,1568,480,640,32,374,406,386,435,False,3
1,51,kaist_dataset/Mixed/Digital_Camera/(C.S)C-outdoor5/DSC04094.JPG,char_data/1/DSC04094.JPG_5.jpg,1530,480,640,30,495,525,387,438,False,3
1,30,kaist_dataset/Mixed/Digital_Camera/(C.S)C-outdoor5/DSC04115.JPG,char_data/1/DSC04115.JPG_2.jpg,450,480,640,15,280,295,364,394,False,3
1,36,kaist_dataset/Mixed/Digital_Camera/(C.S)C-outdoor5/DSC04122.JPG,char_data/1/DSC04122.JPG_2.jpg,396,480,640,11,372,383,412,448,False,3
1,41,kaist_dataset/Mixed/Digital_Camera/(C.S)C-outdoor5/DSC04139.JPG,char_data/1/DSC04139.JPG_6.jpg,820,480,640,20,340,360,398,439,False,3
1,44,kaist_dataset/Mixed/Digital_Camera/(C.S)C-outdoor5/DSC04139.JPG,char_data/1/DSC04139.JPG_7.jpg,572,480,640,13,360,373,396,440,False,3
1,49,kaist_dataset/Mixed/Digital_Camera/(C.S)C-outdoor5/DSC04139.JPG,char_data/1/DSC04139.JPG_8.jpg,637,480,640,13,374,387,395,444,False,3
1,42,kaist_dataset/Mixed/Digital_Camera/(C.S)C-outdoor5/DSC04140.JPG,char_data/1/DSC04140.JPG_2.jpg,420,480,640,10,589,599,342,384,False,3
1,35,kaist_dataset/Mixed/Digital_Camera/(C.S)C-outdoor5/DSC04144.JPG,char_data/1/DSC04144.JPG_2.jpg,595,480,640,17,368,385,419,454,False,3
1,30,kaist_dataset/Mixed/Digital_Camera/(C.S)C-outdoor5/DSC04151.JPG,char_data/1/DSC04151.JPG_2.jpg,450,480,640,15,557,572,349,379,False,3
1,32,kaist_dataset/Mixed/Digital_Camera/(C.S)C-outdoor5/DSC04330.JPG,char_data/1/DSC04330.JPG_6.jpg,736,480,640,23,301,324,192,224,False,3
1,35,kaist_dataset/Mixed/Digital_Camera/(C.S)C-outdoor5/DSC04330.JPG,char_data/1/DSC04330.JPG_7.jpg,735,480,640,21,477,498,163,198,False,3
1,61,kaist_dataset/Mixed/Digital_Camera/(C.S)C-outdoor5/DSC04330.JPG,char_data/1/DSC04330.JPG_8.jpg,976,480,640,16,517,533,357,418,False,3
1,40,kaist_dataset/Mixed/Digital_Camera/(C.S)C-outdoor5/DSC04337.JPG,char_data/1/DSC04337.JPG_2.jpg,1040,480,640,26,493,519,322,362,False,3
1,43,kaist_dataset/Mixed/Digital_Camera/(C.S)C-outdoor5/DSC04395.JPG,char_data/1/DSC04395.JPG_2.jpg,989,480,640,23,130,153,289,332,False,3
1,57,kaist_dataset/Mixed/Digital_Camera/(C.S)C-outdoor5/DSC04401.JPG,char_data/1/DSC04401.JPG_2.jpg,1482,480,640,26,535,561,248,305,False,3
1,196,kaist_dataset/Mixed/Digital_Camera/(C.S)C-outdoor5/DSC04447.JPG,char_data/1/DSC04447.JPG_2.jpg,10192,480,640,52,585,637,81,277,False,3
1,62,kaist_dataset/Mixed/Digital_Camera/(C.S)C-outdoor5/DSC04450.JPG,char_data/1/DSC04450.JPG_2.jpg,2046,480,640,33,275,308,56,118,False,3
1,59,kaist_dataset/Mixed/Digital_Camera/(C.S)C-outdoor6/080116-0057.jpg,char_data/1/080116-0057.jpg_2.jpg,1652,1200,1600,28,587,615,821,880,False,3
1,26,kaist_dataset/Mixed/Digital_Camera/(C.S)C-outdoor6/117.JPG,char_data/1/117.JPG_4.jpg,234,480,640,9,367,376,265,291,False,3
1,22,kaist_dataset/Mixed/Digital_Camera/(C.S)C-outdoor6/117.JPG,char_data/1/117.JPG_5.jpg,154,480,640,7,507,514,264,286,False,3
1,34,kaist_dataset/Mixed/Digital_Camera/(C.S)C-outdoor6/P1010018.JPG,char_data/1/P1010018.JPG_2.jpg,442,480,640,13,535,548,242,276,False,3
1,28,kaist_dataset/Mixed/Digital_Camera/(C.S)C-outdoor6/P1010020.JPG,char_data/1/P1010020.JPG_2.jpg,700,480,640,25,144,169,232,260,False,3
1,42,kaist_dataset/Mixed/Digital_Camera/(C.S)C-outdoor6/P1010021.JPG,char_data/1/P1010021.JPG_2.jpg,1134,480,640,27,381,408,205,247,False,3
1,127,kaist_dataset/Mixed/Digital_Camera/(C.S)C-outdoor6/P1010045.JPG,char_data/1/P1010045.JPG_2.jpg,12827,480,640,101,188,289,149,276,False,3
1,35,kaist_dataset/Mixed/Digital_Camera/(C.S)C-outdoor6/P1010056.JPG,char_data/1/P1010056.JPG_2.jpg,525,480,640,15,365,380,230,265,False,3
1,116,kaist_dataset/Mixed/Digital_Camera/(C.S)C-outdoor6/P1010063.JPG,char_data/1/P1010063.JPG_2.jpg,4988,480,640,43,191,234,129,245,False,3
1,55,kaist_dataset/Mixed/Digital_Camera/(C.S)C-outdoor6/P1010067.JPG,char_data/1/P1010067.JPG_4.jpg,1210,480,640,22,160,182,317,372,False,3
1,55,kaist_dataset/Mixed/Digital_Camera/(C.S)C-outdoor6/P1010067.JPG,char_data/1/P1010067.JPG_5.jpg,1485,480,640,27,529,556,310,365,False,3
1,35,kaist_dataset/Mixed/Digital_Camera/(C.S)C-outdoor6/P1010074.JPG,char_data/1/P1010074.JPG_4.jpg,1575,480,640,45,427,472,300,335,False,3
1,37,kaist_dataset/Mixed/Digital_Camera/(C.S)C-outdoor6/P1010074.JPG,char_data/1/P1010074.JPG_5.jpg,925,480,640,25,609,634,297,334,False,3
1,26,kaist_dataset/Mixed/Digital_Camera/(C.S)C-outdoor6/P1010082.JPG,char_data/1/P1010082.JPG_4.jpg,390,480,640,15,405,420,233,259,False,3
1,25,kaist_dataset/Mixed/Digital_Camera/(C.S)C-outdoor6/P1010082.JPG,char_data/1/P1010082.JPG_5.jpg,300,480,640,12,471,483,233,258,False,3
1,37,kaist_dataset/Mixed/Digital_Camera/(C.S)C-outdoor6/P1010084.JPG,char_data/1/P1010084.JPG_4.jpg,740,480,640,20,11,31,187,224,False,3
1,46,kaist_dataset/Mixed/Digital_Camera/(C.S)C-outdoor6/P1010084.JPG,char_data/1/P1010084.JPG_5.jpg,1380,480,640,30,567,597,192,238,False,3
1,27,kaist_dataset/Mixed/Digital_Camera/(C.S)C-outdoor6/P1010096.JPG,char_data/1/P1010096.JPG_2.jpg,378,480,640,14,283,297,202,229,False,3
1,22,kaist_dataset/Mixed/Digital_Camera/(C.S)C-outdoor6/P1010099.JPG,char_data/1/P1010099.JPG_4.jpg,308,480,640,14,529,543,207,229,False,3
1,24,kaist_dataset/Mixed/Digital_Camera/(C.S)C-outdoor6/P1010099.JPG,char_data/1/P1010099.JPG_5.jpg,360,480,640,15,557,572,207,231,False,3
1,23,kaist_dataset/Mixed/Digital_Camera/(C.S)C-outdoor6/P1010138.JPG,char_data/1/P1010138.JPG_4.jpg,506,480,640,22,503,525,191,214,False,3
1,24,kaist_dataset/Mixed/Digital_Camera/(C.S)C-outdoor6/P1010138.JPG,char_data/1/P1010138.JPG_5.jpg,504,480,640,21,529,550,190,214,False,3
1,32,kaist_dataset/Mixed/Digital_Camera/(C.S)C-outdoor6/크기변환_P1010029.JPG,char_data/1/크기변환_P1010029.JPG_8.jpg,320,480,640,10,48,58,14,46,False,3
1,60,kaist_dataset/Mixed/Digital_Camera/(C.S)C-outdoor6/크기변환_P1010029.JPG,char_data/1/크기변환_P1010029.JPG_9.jpg,1380,480,640,23,209,232,258,318,False,3
1,68,kaist_dataset/Mixed/Digital_Camera/(C.S)C-outdoor6/크기변환_P1010029.JPG,char_data/1/크기변환_P1010029.JPG_10.jpg,2244,480,640,33,391,424,261,329,False,3
1,61,kaist_dataset/Mixed/Digital_Camera/(C.S)C-outdoor6/크기변환_P1010029.JPG,char_data/1/크기변환_P1010029.JPG_11.jpg,1708,480,640,28,485,513,264,325,False,3
1,164,kaist_dataset/Mixed/Digital_Camera/(C.S)D-indoor1/DSC02726.JPG,char_data/1/DSC02726.JPG_2.jpg,16892,480,640,103,200,303,34,198,False,3
1,156,kaist_dataset/Mixed/Digital_Camera/(C.S)D-indoor1/DSC02739.JPG,char_data/1/DSC02739.JPG_2.jpg,11232,480,640,72,360,432,319,475,False,3
1,54,kaist_dataset/Mixed/Digital_Camera/(C.S)D-indoor1/DSC02771.JPG,char_data/1/DSC02771.JPG_2.jpg,1404,480,640,26,44,70,251,305,False,3
1,47,kaist_dataset/Mixed/Digital_Camera/(C.S)D-indoor1/DSC02772.JPG,char_data/1/DSC02772.JPG_2.jpg,1034,480,640,22,112,134,328,375,False,3
1,56,kaist_dataset/Mixed/Digital_Camera/(C.S)D-indoor1/DSC02775.JPG,char_data/1/DSC02775.JPG_2.jpg,1848,480,640,33,17,50,226,282,False,3
1,52,kaist_dataset/Mixed/Digital_Camera/(C.S)D-indoor1/DSC02776.JPG,char_data/1/DSC02776.JPG_2.jpg,1144,480,640,22,50,72,267,319,False,3
1,44,kaist_dataset/Mixed/Digital_Camera/(C.S)D-indoor1/DSC02780.JPG,char_data/1/DSC02780.JPG_2.jpg,1012,480,640,23,82,105,273,317,False,3
1,47,kaist_dataset/Mixed/Digital_Camera/(C.S)D-indoor1/DSC03980.JPG,char_data/1/DSC03980.JPG_2.jpg,1598,480,640,34,318,352,306,353,False,3
1,47,kaist_dataset/Mixed/Digital_Camera/(C.S)D-indoor1/DSC03986.JPG,char_data/1/DSC03986.JPG_8.jpg,423,480,640,9,281,290,163,210,False,3
1,50,kaist_dataset/Mixed/Digital_Camera/(C.S)D-indoor1/DSC03986.JPG,char_data/1/DSC03986.JPG_9.jpg,800,480,640,16,343,359,159,209,False,3
1,49,kaist_dataset/Mixed/Digital_Camera/(C.S)D-indoor1/DSC03986.JPG,char_data/1/DSC03986.JPG_10.jpg,637,480,640,13,377,390,157,206,False,3
1,43,kaist_dataset/Mixed/Digital_Camera/(C.S)D-indoor1/DSC03986.JPG,char_data/1/DSC03986.JPG_11.jpg,602,480,640,14,423,437,161,204,False,3
1,26,kaist_dataset/Mixed/Digital_Camera/(C.S)D-indoor1/DSC04005.JPG,char_data/1/DSC04005.JPG_6.jpg,338,480,640,13,316,329,441,467,False,3
1,24,kaist_dataset/Mixed/Digital_Camera/(C.S)D-indoor1/DSC04005.JPG,char_data/1/DSC04005.JPG_7.jpg,384,480,640,16,329,345,441,465,False,3
1,24,kaist_dataset/Mixed/Digital_Camera/(C.S)D-indoor1/DSC04005.JPG,char_data/1/DSC04005.JPG_8.jpg,384,480,640,16,490,506,440,464,False,3
1,42,kaist_dataset/Mixed/Digital_Camera/(C.S)D-indoor2/DSC04421.JPG,char_data/1/DSC04421.JPG_2.jpg,672,480,640,16,577,593,218,260,False,3
1,35,kaist_dataset/Mixed/Digital_Camera/(C.S)E-night/DSC02569.JPG,char_data/1/DSC02569.JPG_4.jpg,595,480,640,17,367,384,413,448,False,3
1,39,kaist_dataset/Mixed/Digital_Camera/(C.S)E-night/DSC02569.JPG,char_data/1/DSC02569.JPG_5.jpg,624,480,640,16,405,421,406,445,False,3
1,49,kaist_dataset/Mixed/Digital_Camera/(C.S)E-night/DSC02575.JPG,char_data/1/DSC02575.JPG_4.jpg,1421,480,640,29,364,393,360,409,False,3
1,52,kaist_dataset/Mixed/Digital_Camera/(C.S)E-night/DSC02575.JPG,char_data/1/DSC02575.JPG_5.jpg,1040,480,640,20,393,413,358,410,False,3
1,36,kaist_dataset/Mixed/Digital_Camera/(C.S)E-night/DSC02585.JPG,char_data/1/DSC02585.JPG_2.jpg,468,480,640,13,468,481,419,455,False,3
1,52,kaist_dataset/Mixed/Digital_Camera/(C.S)E-night/DSC02595.JPG,char_data/1/DSC02595.JPG_2.jpg,1924,480,640,37,374,411,347,399,False,3
1,33,kaist_dataset/Mixed/Digital_Camera/(C.S)E-night/DSC02903.JPG,char_data/1/DSC02903.JPG_2.jpg,330,480,640,10,412,422,268,301,False,3
1,29,kaist_dataset/Mixed/Digital_Camera/(C.S)E-night/P1010151.JPG,char_data/1/P1010151.JPG_2.jpg,290,480,640,10,532,542,202,231,False,3
1,71,kaist_dataset/Mixed/Digital_Camera/(C.S)E-night/P1010152.JPG,char_data/1/P1010152.JPG_6.jpg,3124,480,640,44,292,336,220,291,False,3
1,76,kaist_dataset/Mixed/Digital_Camera/(C.S)E-night/P1010152.JPG,char_data/1/P1010152.JPG_7.jpg,2584,480,640,34,436,470,217,293,False,3
1,68,kaist_dataset/Mixed/Digital_Camera/(C.S)E-night/P1010152.JPG,char_data/1/P1010152.JPG_8.jpg,2856,480,640,42,467,509,222,290,False,3
1,77,kaist_dataset/Mixed/Digital_Camera/(C.S)F-others/097.jpg,char_data/1/097.jpg_2.jpg,3542,480,640,46,403,449,196,273,False,3
1,33,kaist_dataset/Mixed/Digital_Camera/(C.S)F-others/2007-12-08-day-044.jpg,char_data/1/2007-12-08-day-044.jpg_4.jpg,396,1200,1600,12,1088,1100,835,868,False,3
1,33,kaist_dataset/Mixed/Digital_Camera/(C.S)F-others/2007-12-08-day-044.jpg,char_data/1/2007-12-08-day-044.jpg_5.jpg,429,1200,1600,13,1096,1109,832,865,False,3
1,45,kaist_dataset/Mixed/Digital_Camera/(C.S)F-others/2007-12-08-day-113.jpg,char_data/1/2007-12-08-day-113.jpg_2.jpg,810,1200,1600,18,984,1002,442,487,False,3
1,42,kaist_dataset/Mixed/Digital_Camera/(C.S)F-others/DSC02504.JPG,char_data/1/DSC02504.JPG_2.jpg,1050,480,640,25,277,302,338,380,False,3
1,58,kaist_dataset/Mixed/Digital_Camera/(C.S)F-others/DSC02777.JPG,char_data/1/DSC02777.JPG_2.jpg,1856,480,640,32,51,83,315,373,False,3
1,30,kaist_dataset/Mixed/Mobile_Phone/(C.M)A-outdoor/P090912036.jpg,char_data/1/P090912036.jpg_4.jpg,330,480,640,11,322,333,190,220,False,3
1,33,kaist_dataset/Mixed/Mobile_Phone/(C.M)A-outdoor/P090912036.jpg,char_data/1/P090912036.jpg_5.jpg,495,480,640,15,333,348,189,222,False,3
1,34,kaist_dataset/Mixed/Mobile_Phone/(C.M)A-outdoor/P090912038.jpg,char_data/1/P090912038.jpg_2.jpg,408,480,640,12,299,311,159,193,False,3
1,75,kaist_dataset/Mixed/Mobile_Phone/(C.M)A-outdoor/P090912062.jpg,char_data/1/P090912062.jpg_4.jpg,3150,480,640,42,11,53,3,78,False,3
1,74,kaist_dataset/Mixed/Mobile_Phone/(C.M)A-outdoor/P090912062.jpg,char_data/1/P090912062.jpg_5.jpg,3256,480,640,44,69,113,94,168,False,3
1,59,kaist_dataset/Mixed/Mobile_Phone/(C.M)B-indoor/P090831007.jpg,char_data/1/P090831007.jpg_10.jpg,2301,480,640,39,122,161,132,191,False,3
1,65,kaist_dataset/Mixed/Mobile_Phone/(C.M)B-indoor/P090831007.jpg,char_data/1/P090831007.jpg_11.jpg,2145,480,640,33,249,282,128,193,False,3
1,60,kaist_dataset/Mixed/Mobile_Phone/(C.M)B-indoor/P090831007.jpg,char_data/1/P090831007.jpg_12.jpg,1680,480,640,28,321,349,135,195,False,3
1,65,kaist_dataset/Mixed/Mobile_Phone/(C.M)B-indoor/P090831007.jpg,char_data/1/P090831007.jpg_13.jpg,1690,480,640,26,253,279,198,263,False,3
1,66,kaist_dataset/Mixed/Mobile_Phone/(C.M)B-indoor/P090831007.jpg,char_data/1/P090831007.jpg_14.jpg,2178,480,640,33,249,282,267,333,False,3
T,105,kaist_dataset/English/Digital_Camera/(E.S)A-shadow/DSC02317.JPG,char_data/T/DSC02317.JPG_2.jpg,6615,480,640,63,101,164,225,330,True,29
T,71,kaist_dataset/English/Digital_Camera/(E.S)A-shadow/DSC02423.JPG,char_data/T/DSC02423.JPG_4.jpg,3905,480,640,55,572,627,170,241,True,29
T,44,kaist_dataset/English/Digital_Camera/(E.S)A-shadow/DSC02423.JPG,char_data/T/DSC02423.JPG_5.jpg,1936,480,640,44,470,514,244,288,True,29
T,72,kaist_dataset/English/Digital_Camera/(E.S)A-shadow/DSC03079.JPG,char_data/T/DSC03079.JPG_2.jpg,2736,480,640,38,194,232,317,389,True,29
T,41,kaist_dataset/English/Digital_Camera/(E.S)A-shadow/P1010044.JPG,char_data/T/P1010044.JPG_6.jpg,1066,480,640,26,219,245,357,398,True,29
T,34,kaist_dataset/English/Digital_Camera/(E.S)A-shadow/P1010044.JPG,char_data/T/P1010044.JPG_7.jpg,918,480,640,27,250,277,120,154,True,29
T,35,kaist_dataset/English/Digital_Camera/(E.S)A-shadow/P1010044.JPG,char_data/T/P1010044.JPG_8.jpg,910,480,640,26,277,303,153,188,True,29
T,172,kaist_dataset/English/Digital_Camera/(E.S)B-light/080116-0059.jpg,char_data/T/080116-0059.jpg_28.jpg,13416,1200,1600,78,1059,1137,332,504,True,29
T,39,kaist_dataset/English/Digital_Camera/(E.S)B-light/080116-0059.jpg,char_data/T/080116-0059.jpg_29.jpg,819,1200,1600,21,452,473,825,864,True,29
T,37,kaist_dataset/English/Digital_Camera/(E.S)B-light/080116-0059.jpg,char_data/T/080116-0059.jpg_30.jpg,370,1200,1600,10,506,516,826,863,True,29
T,25,kaist_dataset/English/Digital_Camera/(E.S)B-light/080116-0059.jpg,char_data/T/080116-0059.jpg_31.jpg,300,1200,1600,12,991,1003,825,850,True,29
T,28,kaist_dataset/English/Digital_Camera/(E.S)B-light/080116-0059.jpg,char_data/T/080116-0059.jpg_32.jpg,504,1200,1600,18,1156,1174,822,850,True,29
T,34,kaist_dataset/English/Digital_Camera/(E.S)B-light/080116-0059.jpg,char_data/T/080116-0059.jpg_33.jpg,476,1200,1600,14,815,829,825,859,True,29
T,31,kaist_dataset/English/Digital_Camera/(E.S)B-light/080116-0059.jpg,char_data/T/080116-0059.jpg_34.jpg,589,1200,1600,19,623,642,826,857,True,29
T,30,kaist_dataset/English/Digital_Camera/(E.S)B-light/080116-0059.jpg,char_data/T/080116-0059.jpg_35.jpg,360,1200,1600,12,734,746,800,830,True,29
T,33,kaist_dataset/English/Digital_Camera/(E.S)B-light/080116-0059.jpg,char_data/T/080116-0059.jpg_36.jpg,660,1200,1600,20,557,577,772,805,True,29
T,33,kaist_dataset/English/Digital_Camera/(E.S)B-light/080116-0059.jpg,char_data/T/080116-0059.jpg_37.jpg,627,1200,1600,19,726,745,770,803,True,29
T,32,kaist_dataset/English/Digital_Camera/(E.S)B-light/080116-0059.jpg,char_data/T/080116-0059.jpg_38.jpg,416,1200,1600,13,821,834,771,803,True,29
T,37,kaist_dataset/English/Digital_Camera/(E.S)B-light/080116-0059.jpg,char_data/T/080116-0059.jpg_39.jpg,481,1200,1600,13,871,884,766,803,True,29
T,32,kaist_dataset/English/Digital_Camera/(E.S)B-light/080116-0059.jpg,char_data/T/080116-0059.jpg_40.jpg,416,1200,1600,13,1135,1148,769,801,True,29
T,31,kaist_dataset/English/Digital_Camera/(E.S)B-light/080116-0059.jpg,char_data/T/080116-0059.jpg_41.jpg,558,1200,1600,18,1174,1192,771,802,True,29
T,78,kaist_dataset/English/Digital_Camera/(E.S)B-light/080119-0038.jpg,char_data/T/080119-0038.jpg_2.jpg,5304,1200,1600,68,977,1045,683,761,True,29
T,51,kaist_dataset/English/Digital_Camera/(E.S)B-light/DSC02712.JPG,char_data/T/DSC02712.JPG_2.jpg,1734,480,640,34,150,184,213,264,True,29
T,32,kaist_dataset/English/Digital_Camera/(E.S)B-light/v.jpg,char_data/T/v.jpg_2.jpg,864,240,320,27,24,51,50,82,True,29
T,25,kaist_dataset/English/Digital_Camera/(E.S)B-light/x.jpg,char_data/T/x.jpg_2.jpg,400,240,320,16,123,139,108,133,True,29
T,60,kaist_dataset/English/Digital_Camera/(E.S)C-outdoor1/031.JPG,char_data/T/031.JPG_8.jpg,2640,480,640,44,134,178,188,248,True,29
T,24,kaist_dataset/English/Digital_Camera/(E.S)C-outdoor1/031.JPG,char_data/T/031.JPG_9.jpg,408,480,640,17,103,120,318,342,True,29
T,22,kaist_dataset/English/Digital_Camera/(E.S)C-outdoor1/031.JPG,char_data/T/031.JPG_10.jpg,352,480,640,16,495,511,320,342,True,29
T,45,kaist_dataset/English/Digital_Camera/(E.S)C-outdoor1/031.JPG,char_data/T/031.JPG_11.jpg,1665,480,640,37,303,340,351,396,True,29
T,42,kaist_dataset/English/Digital_Camera/(E.S)C-outdoor1/041.JPG,char_data/T/041.JPG_2.jpg,1008,480,640,24,421,445,247,289,True,29
T,72,kaist_dataset/English/Digital_Camera/(E.S)C-outdoor1/055.JPG,char_data/T/055.JPG_2.jpg,3600,480,640,50,332,382,184,256,True,29
T,26,kaist_dataset/English/Digital_Camera/(E.S)C-outdoor1/056.JPG,char_data/T/056.JPG_8.jpg,312,480,640,12,497,509,251,277,True,29
T,45,kaist_dataset/English/Digital_Camera/(E.S)C-outdoor1/064.JPG,char_data/T/064.JPG_4.jpg,1080,480,640,24,472,496,189,234,True,29
T,42,kaist_dataset/English/Digital_Camera/(E.S)C-outdoor1/064.JPG,char_data/T/064.JPG_5.jpg,1092,480,640,26,496,522,188,230,True,29
T,43,kaist_dataset/English/Digital_Camera/(E.S)C-outdoor1/080116-0065.jpg,char_data/T/080116-0065.jpg_2.jpg,1204,600,800,28,460,488,338,381,True,29
T,66,kaist_dataset/English/Digital_Camera/(E.S)C-outdoor1/080118-0011.jpg,char_data/T/080118-0011.jpg_6.jpg,2574,1200,1600,39,709,748,936,1002,True,29
T,72,kaist_dataset/English/Digital_Camera/(E.S)C-outdoor1/080118-0011.jpg,char_data/T/080118-0011.jpg_7.jpg,4320,1200,1600,60,746,806,458,530,True,29
T,65,kaist_dataset/English/Digital_Camera/(E.S)C-outdoor1/080118-0011.jpg,char_data/T/080118-0011.jpg_8.jpg,3445,1200,1600,53,805,858,529,594,True,29
T,67,kaist_dataset/English/Digital_Camera/(E.S)C-outdoor1/080119-0012.jpg,char_data/T/080119-0012.jpg_2.jpg,4087,1200,1600,61,847,908,553,620,True,29
T,41,kaist_dataset/English/Digital_Camera/(E.S)C-outdoor1/089.jpg,char_data/T/089.jpg_4.jpg,779,480,640,19,369,388,289,330,True,29
T,57,kaist_dataset/English/Digital_Camera/(E.S)C-outdoor1/089.jpg,char_data/T/089.jpg_5.jpg,1539,480,640,27,507,534,268,325,True,29
T,77,kaist_dataset/English/Digital_Camera/(E.S)C-outdoor1/110.jpg,char_data/T/110.jpg_2.jpg,4389,480,640,57,320,377,195,272,True,29
T,102,kaist_dataset/English/Digital_Camera/(E.S)C-outdoor1/129.JPG,char_data/T/129.JPG_2.jpg,4692,480,640,46,300,346,193,295,True,29
T,134,kaist_dataset/English/Digital_Camera/(E.S)C-outdoor1/2007-12-09-day-exterior-063.jpg,char_data/T/2007-12-09-day-exterior-063.jpg_5.jpg,12998,1200,1600,97,966,1063,441,575,True,29
T,46,kaist_dataset/English/Digital_Camera/(E.S)C-outdoor1/6.jpg,char_data/T/6.jpg_4.jpg,1610,255,731,35,475,510,95,141,True,29
T,46,kaist_dataset/English/Digital_Camera/(E.S)C-outdoor1/6.jpg,char_data/T/6.jpg_5.jpg,1610,255,731,35,512,547,95,141,True,29
T,96,kaist_dataset/English/Digital_Camera/(E.S)C-outdoor1/DSC02306.JPG,char_data/T/DSC02306.JPG_2.jpg,7296,480,640,76,464,540,147,243,True,29
T,88,kaist_dataset/English/Digital_Camera/(E.S)C-outdoor1/DSC02345.JPG,char_data/T/DSC02345.JPG_8.jpg,8096,480,640,92,203,295,139,227,True,29
T,31,kaist_dataset/English/Digital_Camera/(E.S)C-outdoor1/DSC02345.JPG,char_data/T/DSC02345.JPG_9.jpg,434,480,640,14,161,175,239,270,True,29
T,28,kaist_dataset/English/Digital_Camera/(E.S)C-outdoor1/DSC02345.JPG,char_data/T/DSC02345.JPG_10.jpg,756,480,640,27,222,249,240,268,True,29
T,30,kaist_dataset/English/Digital_Camera/(E.S)C-outdoor1/DSC02345.JPG,char_data/T/DSC02345.JPG_11.jpg,510,480,640,17,442,459,237,267,True,29
T,171,kaist_dataset/English/Digital_Camera/(E.S)C-outdoor1/DSC02354.JPG,char_data/T/DSC02354.JPG_2.jpg,24111,480,640,141,33,174,156,327,True,29
T,48,kaist_dataset/English/Digital_Camera/(E.S)C-outdoor1/DSC02356.JPG,char_data/T/DSC02356.JPG_4.jpg,1920,480,640,40,28,68,298,346,True,29
T,75,kaist_dataset/English/Digital_Camera/(E.S)C-outdoor1/DSC02398.JPG,char_data/T/DSC02398.JPG_2.jpg,3750,480,640,50,289,339,236,311,True,29
T,140,kaist_dataset/English/Digital_Camera/(E.S)C-outdoor1/DSC02406.JPG,char_data/T/DSC02406.JPG_2.jpg,12740,480,640,91,165,256,269,409,True,29
T,81,kaist_dataset/English/Digital_Camera/(E.S)C-outdoor1/DSC02408.JPG,char_data/T/DSC02408.JPG_2.jpg,4536,480,640,56,370,426,265,346,True,29
T,87,kaist_dataset/English/Digital_Camera/(E.S)C-outdoor1/DSC02410.JPG,char_data/T/DSC02410.JPG_2.jpg,6438,480,640,74,239,313,120,207,True,29
T,81,kaist_dataset/English/Digital_Camera/(E.S)C-outdoor1/DSC02417.JPG,char_data/T/DSC02417.JPG_2.jpg,5265,480,640,65,51,116,129,210,True,29
T,38,kaist_dataset/English/Digital_Camera/(E.S)C-outdoor1/DSC02427.JPG,char_data/T/DSC02427.JPG_4.jpg,1292,480,640,34,328,362,366,404,True,29
T,134,kaist_dataset/English/Digital_Camera/(E.S)C-outdoor1/DSC02448.JPG,char_data/T/DSC02448.JPG_2.jpg,8576,480,640,64,196,260,192,326,True,29
T,128,kaist_dataset/English/Digital_Camera/(E.S)C-outdoor1/DSC02450.JPG,char_data/T/DSC02450.JPG_4.jpg,7936,480,640,62,47,109,60,188,True,29
T,49,kaist_dataset/English/Digital_Camera/(E.S)C-outdoor1/DSC02450.JPG,char_data/T/DSC02450.JPG_5.jpg,1911,480,640,39,54,93,218,267,True,29
T,161,kaist_dataset/English/Digital_Camera/(E.S)C-outdoor1/DSC02475.JPG,char_data/T/DSC02475.JPG_2.jpg,19803,480,640,123,487,610,77,238,True,29
T,57,kaist_dataset/English/Digital_Camera/(E.S)C-outdoor1/DSC02480.JPG,char_data/T/DSC02480.JPG_2.jpg,2223,480,640,39,92,131,403,460,True,29
T,88,kaist_dataset/English/Digital_Camera/(E.S)C-outdoor1/DSC02491.JPG,char_data/T/DSC02491.JPG_4.jpg,5016,480,640,57,81,138,315,403,True,29
T,29,kaist_dataset/English/Digital_Camera/(E.S)C-outdoor1/DSC02500.JPG,char_data/T/DSC02500.JPG_6.jpg,435,480,640,15,22,37,103,132,True,29
T,24,kaist_dataset/English/Digital_Camera/(E.S)C-outdoor1/DSC02500.JPG,char_data/T/DSC02500.JPG_7.jpg,240,480,640,10,21,31,81,105,True,29
T,99,kaist_dataset/English/Digital_Camera/(E.S)C-outdoor1/DSC02500.JPG,char_data/T/DSC02500.JPG_8.jpg,7821,480,640,79,523,602,173,272,True,29
T,134,kaist_dataset/English/Digital_Camera/(E.S)C-outdoor1/DSC02501.JPG,char_data/T/DSC02501.JPG_4.jpg,18090,480,640,135,443,578,92,226,True,29
T,59,kaist_dataset/English/Digital_Camera/(E.S)C-outdoor1/DSC02501.JPG,char_data/T/DSC02501.JPG_5.jpg,3127,480,640,53,349,402,297,356,True,29
T,103,kaist_dataset/English/Digital_Camera/(E.S)C-outdoor1/DSC02590.JPG,char_data/T/DSC02590.JPG_2.jpg,8034,480,640,78,177,255,126,229,True,29
T,86,kaist_dataset/English/Digital_Camera/(E.S)C-outdoor1/DSC02897.JPG,char_data/T/DSC02897.JPG_2.jpg,6622,480,640,77,547,624,265,351,True,29
T,49,kaist_dataset/English/Digital_Camera/(E.S)C-outdoor1/DSC02918.JPG,char_data/T/DSC02918.JPG_6.jpg,2156,480,640,44,55,99,227,276,True,29
T,97,kaist_dataset/English/Digital_Camera/(E.S)C-outdoor2/DSC02984.JPG,char_data/T/DSC02984.JPG_2.jpg,5917,480,640,61,286,347,98,195,True,29
T,78,kaist_dataset/English/Digital_Camera/(E.S)C-outdoor2/DSC02993.JPG,char_data/T/DSC02993.JPG_2.jpg,4758,480,640,61,268,329,126,204,True,29
T,67,kaist_dataset/English/Digital_Camera/(E.S)C-outdoor2/DSC03012.JPG,char_data/T/DSC03012.JPG_2.jpg,2144,480,640,32,491,523,215,282,True,29
T,52,kaist_dataset/English/Digital_Camera/(E.S)C-outdoor2/DSC03023.JPG,char_data/T/DSC03023.JPG_2.jpg,1248,480,640,24,129,153,300,352,True,29
T,64,kaist_dataset/English/Digital_Camera/(E.S)C-outdoor2/DSC03050.JPG,char_data/T/DSC03050.JPG_2.jpg,4992,480,640,78,320,398,210,274,True,29
T,45,kaist_dataset/English/Digital_Camera/(E.S)C-outdoor2/DSC03053.JPG,char_data/T/DSC03053.JPG_5.jpg,1215,480,640,27,236,263,126,171,True,29
T,43,kaist_dataset/English/Digital_Camera/(E.S)C-outdoor2/DSC03160.JPG,char_data/T/DSC03160.JPG_5.jpg,1075,480,640,25,267,292,396,439,True,29
T,35,kaist_dataset/English/Digital_Camera/(E.S)C-outdoor2/DSC03162.JPG,char_data/T/DSC03162.JPG_2.jpg,770,480,640,22,371,393,146,181,True,29
T,51,kaist_dataset/English/Digital_Camera/(E.S)C-outdoor2/DSC03168.JPG,char_data/T/DSC03168.JPG_2.jpg,2499,480,640,49,218,267,291,342,True,29
T,76,kaist_dataset/English/Digital_Camera/(E.S)C-outdoor2/DSC03225.JPG,char_data/T/DSC03225.JPG_2.jpg,4484,480,640,59,51,110,39,115,True,29
T,64,kaist_dataset/English/Digital_Camera/(E.S)C-outdoor2/DSC03264.JPG,char_data/T/DSC03264.JPG_4.jpg,3264,480,640,51,294,345,162,226,True,29
T,67,kaist_dataset/English/Digital_Camera/(E.S)C-outdoor2/DSC03264.JPG,char_data/T/DSC03264.JPG_5.jpg,3685,480,640,55,236,291,92,159,True,29
T,31,kaist_dataset/English/Digital_Camera/(E.S)C-outdoor2/DSC03294.JPG,char_data/T/DSC03294.JPG_2.jpg,713,480,640,23,190,213,398,429,True,29
T,43,kaist_dataset/English/Digital_Camera/(E.S)C-outdoor2/DSC03317.JPG,char_data/T/DSC03317.JPG_4.jpg,817,480,640,19,414,433,195,238,True,29
T,40,kaist_dataset/English/Digital_Camera/(E.S)C-outdoor2/DSC03317.JPG,char_data/T/DSC03317.JPG_5.jpg,880,480,640,22,536,558,193,233,True,29
T,57,kaist_dataset/English/Digital_Camera/(E.S)C-outdoor2/DSC03412.JPG,char_data/T/DSC03412.JPG_2.jpg,2850,480,640,50,208,258,398,455,True,29
T,62,kaist_dataset/English/Digital_Camera/(E.S)C-outdoor2/DSC03413.JPG,char_data/T/DSC03413.JPG_4.jpg,2480,480,640,40,191,231,195,257,True,29
T,83,kaist_dataset/English/Digital_Camera/(E.S)C-outdoor2/DSC03432.JPG,char_data/T/DSC03432.JPG_2.jpg,3735,480,640,45,415,460,357,440,True,29
T,40,kaist_dataset/English/Digital_Camera/(E.S)C-outdoor2/DSC03436.JPG,char_data/T/DSC03436.JPG_5.jpg,1080,480,640,27,155,182,121,161,True,29
T,47,kaist_dataset/English/Digital_Camera/(E.S)C-outdoor2/DSC03575.JPG,char_data/T/DSC03575.JPG_2.jpg,1645,480,640,35,290,325,177,224,True,29
T,54,kaist_dataset/English/Digital_Camera/(E.S)C-outdoor2/DSC03650.JPG,char_data/T/DSC03650.JPG_2.jpg,1836,480,640,34,359,393,212,266,True,29
T,47,kaist_dataset/English/Digital_Camera/(E.S)C-outdoor2/DSC03705.JPG,char_data/T/DSC03705.JPG_2.jpg,1316,480,640,28,296,324,315,362,True,29
T,31,kaist_dataset/English/Digital_Camera/(E.S)C-outdoor2/DSC03731.JPG,char_data/T/DSC03731.JPG_2.jpg,403,480,640,13,507,520,114,145,True,29
T,67,kaist_dataset/English/Digital_Camera/(E.S)C-outdoor2/DSC03865.JPG,char_data/T/DSC03865.JPG_8.jpg,3283,480,640,49,582,631,96,163,True,29
T,62,kaist_dataset/English/Digital_Camera/(E.S)C-outdoor2/DSC04080.JPG,char_data/T/DSC04080.JPG_2.jpg,3658,480,640,59,219,278,294,356,True,29
T,70,kaist_dataset/English/Digital_Camera/(E.S)C-outdoor2/DSC04131.JPG,char_data/T/DSC04131.JPG_2.jpg,5460,480,640,78,487,565,133,203,True,29
T,135,kaist_dataset/English/Digital_Camera/(E.S)C-outdoor2/DSC04163.JPG,char_data/T/DSC04163.JPG_2.jpg,15660,480,640,116,117,233,117,252,True,29
T,68,kaist_dataset/English/Digital_Camera/(E.S)C-outdoor2/DSC04313.JPG,char_data/T/DSC04313.JPG_2.jpg,3060,480,640,45,381,426,114,182,True,29
T,58,kaist_dataset/English/Digital_Camera/(E.S)C-outdoor2/DSC04464.JPG,char_data/T/DSC04464.JPG_2.jpg,2726,480,640,47,436,483,328,386,True,29
T,54,kaist_dataset/English/Digital_Camera/(E.S)C-outdoor2/IMG_2481.JPG,char_data/T/IMG_2481.JPG_2.jpg,2970,480,640,55,388,443,194,248,True,29
T,92,kaist_dataset/English/Digital_Camera/(E.S)C-outdoor2/ktx.jpg,char_data/T/ktx.jpg_2.jpg,6808,240,320,74,120,194,52,144,True,29
T,62,kaist_dataset/English/Digital_Camera/(E.S)C-outdoor3/DSC02788.JPG,char_data/T/DSC02788.JPG_2.jpg,2046,480,640,33,420,453,296,358,True,29
T,84,kaist_dataset/English/Digital_Camera/(E.S)C-outdoor3/DSC03046.JPG,char_data/T/DSC03046.JPG_2.jpg,4116,480,640,49,420,469,119,203,True,29
T,52,kaist_dataset/English/Digital_Camera/(E.S)C-outdoor3/P1010086.JPG,char_data/T/P1010086.JPG_2.jpg,2080,480,640,40,355,395,90,142,True,29
T,85,kaist_dataset/English/Digital_Camera/(E.S)C-outdoor3/P1010138.JPG,char_data/T/P1010138.JPG_6.jpg,4930,480,640,58,245,303,74,159,True,29
T,89,kaist_dataset/English/Digital_Camera/(E.S)C-outdoor3/P1010138.JPG,char_data/T/P1010138.JPG_7.jpg,5162,480,640,58,296,354,71,160,True,29
T,71,kaist_dataset/English/Digital_Camera/(E.S)C-outdoor3/크기변환_%B0%A3%C6%C718_m_starfirm.jpg,char_data/T/크기변환_%B0%A3%C6%C718_m_starfirm.jpg_2.jpg,4828,480,640,68,161,229,207,278,True,29
T,59,kaist_dataset/English/Digital_Camera/(E.S)C-outdoor3/크기변환_%C8%AD%C0%CC%C6%AE%C4%FE%C6%AE%B0%A3%C6%C7_%BA%B9%BB%E7_1-bona0007.jpg,char_data/T/크기변환_%C8%AD%C0%CC%C6%AE%C4%FE%C6%AE%B0%A3%C6%C7_%BA%B9%BB%E7_1-bona0007.jpg_4.jpg,2950,480,640,50,416,466,201,260,True,29
T,65,kaist_dataset/English/Digital_Camera/(E.S)C-outdoor3/크기변환_%C8%AD%C0%CC%C6%AE%C4%FE%C6%AE%B0%A3%C6%C7_%BA%B9%BB%E7_1-bona0007.jpg,char_data/T/크기변환_%C8%AD%C0%CC%C6%AE%C4%FE%C6%AE%B0%A3%C6%C7_%BA%B9%BB%E7_1-bona0007.jpg_5.jpg,3705,480,640,57,512,569,276,341,True,29
T,69,kaist_dataset/English/Digital_Camera/(E.S)C-outdoor3/크기변환_P1010028.JPG,char_data/T/크기변환_P1010028.JPG_2.jpg,2760,480,640,40,392,432,168,237,True,29
T,46,kaist_dataset/English/Digital_Camera/(E.S)C-outdoor3/크기변환_P1010076.JPG,char_data/T/크기변환_P1010076.JPG_4.jpg,2024,480,640,44,345,389,120,166,True,29
T,105,kaist_dataset/English/Digital_Camera/(E.S)D-indoor/080119-0009.jpg,char_data/T/080119-0009.jpg_10.jpg,7245,1200,1600,69,682,751,547,652,True,29
T,103,kaist_dataset/English/Digital_Camera/(E.S)D-indoor/080119-0009.jpg,char_data/T/080119-0009.jpg_11.jpg,7622,1200,1600,74,783,857,565,668,True,29
T,32,kaist_dataset/English/Digital_Camera/(E.S)D-indoor/080119-0009.jpg,char_data/T/080119-0009.jpg_14.jpg,576,1200,1600,18,112,130,1050,1082,True,29
T,64,kaist_dataset/English/Digital_Camera/(E.S)D-indoor/DSC02769.JPG,char_data/T/DSC02769.JPG_2.jpg,2624,480,640,41,426,467,215,279,True,29
T,137,kaist_dataset/English/Digital_Camera/(E.S)D-indoor/DSC02842.JPG,char_data/T/DSC02842.JPG_5.jpg,18632,480,640,136,141,277,143,280,True,29
T,123,kaist_dataset/English/Digital_Camera/(E.S)D-indoor/DSC02852.JPG,char_data/T/DSC02852.JPG_2.jpg,8118,480,640,66,78,144,301,424,True,29
T,82,kaist_dataset/English/Digital_Camera/(E.S)D-indoor/DSC03087.JPG,char_data/T/DSC03087.JPG_4.jpg,4920,480,640,60,129,189,346,428,True,29
T,88,kaist_dataset/English/Digital_Camera/(E.S)D-indoor/DSC03087.JPG,char_data/T/DSC03087.JPG_5.jpg,8008,480,640,91,235,326,138,226,True,29
T,68,kaist_dataset/English/Digital_Camera/(E.S)D-indoor/DSC03091.JPG,char_data/T/DSC03091.JPG_4.jpg,3536,480,640,52,87,139,114,182,True,29
T,82,kaist_dataset/English/Digital_Camera/(E.S)D-indoor/DSC03367.JPG,char_data/T/DSC03367.JPG_2.jpg,5084,480,640,62,245,307,34,116,True,29
T,66,kaist_dataset/English/Digital_Camera/(E.S)D-indoor/DSC03467.JPG,char_data/T/DSC03467.JPG_2.jpg,2310,480,640,35,412,447,148,214,True,29
T,67,kaist_dataset/English/Digital_Camera/(E.S)D-indoor/DSC03883.JPG,char_data/T/DSC03883.JPG_4.jpg,2144,480,640,32,127,159,319,386,True,29
T,69,kaist_dataset/English/Digital_Camera/(E.S)D-indoor/DSC03883.JPG,char_data/T/DSC03883.JPG_5.jpg,2553,480,640,37,158,195,315,384,True,29
T,80,kaist_dataset/English/Digital_Camera/(E.S)D-indoor/DSC03896.JPG,char_data/T/DSC03896.JPG_2.jpg,4480,480,640,56,308,364,274,354,True,29
T,31,kaist_dataset/English/Digital_Camera/(E.S)D-indoor/DSC03901.JPG,char_data/T/DSC03901.JPG_12.jpg,682,480,640,22,240,262,264,295,True,29
T,35,kaist_dataset/English/Digital_Camera/(E.S)D-indoor/DSC03901.JPG,char_data/T/DSC03901.JPG_13.jpg,700,480,640,20,373,393,261,296,True,29
T,37,kaist_dataset/English/Digital_Camera/(E.S)D-indoor/DSC03901.JPG,char_data/T/DSC03901.JPG_14.jpg,777,480,640,21,393,414,257,294,True,29
T,58,kaist_dataset/English/Digital_Camera/(E.S)D-indoor/DSC03901.JPG,char_data/T/DSC03901.JPG_15.jpg,2610,480,640,45,164,209,176,234,True,29
T,65,kaist_dataset/English/Digital_Camera/(E.S)D-indoor/DSC03901.JPG,char_data/T/DSC03901.JPG_16.jpg,3055,480,640,47,506,553,164,229,True,29
T,47,kaist_dataset/English/Digital_Camera/(E.S)D-indoor/DSC03901.JPG,char_data/T/DSC03901.JPG_17.jpg,1645,480,640,35,158,193,114,161,True,29
T,36,kaist_dataset/English/Digital_Camera/(E.S)D-indoor/DSC03935.JPG,char_data/T/DSC03935.JPG_2.jpg,828,480,640,23,215,238,38,74,True,29
T,39,kaist_dataset/English/Digital_Camera/(E.S)D-indoor/DSC03942.JPG,char_data/T/DSC03942.JPG_2.jpg,975,480,640,25,492,517,371,410,True,29
T,37,kaist_dataset/English/Digital_Camera/(E.S)D-indoor/DSC03943.JPG,char_data/T/DSC03943.JPG_2.jpg,555,480,640,15,259,274,312,349,True,29
T,67,kaist_dataset/English/Digital_Camera/(E.S)D-indoor/DSC04023.JPG,char_data/T/DSC04023.JPG_10.jpg,3216,480,640,48,391,439,230,297,True,29
T,18,kaist_dataset/English/Digital_Camera/(E.S)E-night/111.jpg,char_data/T/111.jpg_6.jpg,198,480,640,11,241,252,286,304,True,29
T,17,kaist_dataset/English/Digital_Camera/(E.S)E-night/111.jpg,char_data/T/111.jpg_7.jpg,238,480,640,14,292,306,270,287,True,29
T,16,kaist_dataset/English/Digital_Camera/(E.S)E-night/111.jpg,char_data/T/111.jpg_8.jpg,128,480,640,8,329,337,271,287,True,29
T,106,kaist_dataset/English/Digital_Camera/(E.S)E-night/DSC02606.JPG,char_data/T/DSC02606.JPG_2.jpg,9964,480,640,94,505,599,187,293,True,29
T,106,kaist_dataset/English/Digital_Camera/(E.S)E-night/DSC02613.JPG,char_data/T/DSC02613.JPG_2.jpg,12508,480,640,118,514,632,164,270,True,29
T,82,kaist_dataset/English/Digital_Camera/(E.S)E-night/DSC02675.JPG,char_data/T/DSC02675.JPG_4.jpg,4428,480,640,54,420,474,190,272,True,29
T,87,kaist_dataset/English/Digital_Camera/(E.S)E-night/DSC02675.JPG,char_data/T/DSC02675.JPG_5.jpg,5133,480,640,59,474,533,186,273,True,29
T,227,kaist_dataset/English/Digital_Camera/(E.S)F-others/080116-0058.jpg,char_data/T/080116-0058.jpg_4.jpg,26559,1200,1600,117,307,424,170,397,True,29
T,103,kaist_dataset/English/Digital_Camera/(E.S)F-others/080116-0058.jpg,char_data/T/080116-0058.jpg_5.jpg,2266,1200,1600,22,982,1004,636,739,True,29
T,159,kaist_dataset/English/Digital_Camera/(E.S)F-others/080116-0060.jpg,char_data/T/080116-0060.jpg_4.jpg,21147,1200,1600,133,410,543,441,600,True,29
T,120,kaist_dataset/English/Digital_Camera/(E.S)F-others/080116-0060.jpg,char_data/T/080116-0060.jpg_5.jpg,11160,1200,1600,93,1478,1571,372,492,True,29
T,137,kaist_dataset/English/Digital_Camera/(E.S)F-others/080119-0014.jpg,char_data/T/080119-0014.jpg_2.jpg,10275,1200,1600,75,1294,1369,739,876,True,29
T,49,kaist_dataset/English/Digital_Camera/(E.S)F-others/086.jpg,char_data/T/086.jpg_2.jpg,980,480,640,20,283,303,306,355,True,29
T,35,kaist_dataset/English/Digital_Camera/(E.S)F-others/DSC02923.JPG,char_data/T/DSC02923.JPG_8.jpg,980,480,640,28,203,231,407,442,True,29
T,86,kaist_dataset/English/Digital_Camera/(E.S)F-others/DSC03291.JPG,char_data/T/DSC03291.JPG_2.jpg,4300,480,640,50,396,446,215,301,True,29
T,48,kaist_dataset/English/Digital_Camera/(E.S)F-others/크기변환_%B0%A3%C6%C716_m_starfirm.jpg,char_data/T/크기변환_%B0%A3%C6%C716_m_starfirm.jpg_2.jpg,1344,480,640,28,423,451,227,275,True,29
T,63,kaist_dataset/English/Digital_Camera/(E.S)F-others/크기변환_%B0%A3%C6%C77_m_starfirm.jpg,char_data/T/크기변환_%B0%A3%C6%C77_m_starfirm.jpg_2.jpg,3024,480,640,48,455,503,213,276,True,29
T,121,kaist_dataset/English/Mobile_Phone/(E.M)A-outdoor/P090911064.jpg,char_data/T/P090911064.jpg_2.jpg,18392,480,640,152,436,588,114,235,True,29
T,62,kaist_dataset/English/Mobile_Phone/(E.M)B-indoor/P090902018.jpg,char_data/T/P090902018.jpg_8.jpg,2542,480,640,41,368,409,299,361,True,29
T,51,kaist_dataset/English/Mobile_Phone/(E.M)B-indoor/P090911060.jpg,char_data/T/P090911060.jpg_2.jpg,2346,480,640,46,284,330,17,68,True,29
T,108,kaist_dataset/English/Mobile_Phone/(E.M)B-indoor/P090911086.jpg,char_data/T/P090911086.jpg_2.jpg,9288,480,640,86,7,93,347,455,True,29
T,126,kaist_dataset/English/Mobile_Phone/(E.M)C-bookCover/P090831037.jpg,char_data/T/P090831037.jpg_4.jpg,13986,480,640,111,275,386,60,186,True,29
T,135,kaist_dataset/English/Mobile_Phone/(E.M)C-bookCover/P090831037.jpg,char_data/T/P090831037.jpg_5.jpg,13770,480,640,102,295,397,190,325,True,29
T,95,kaist_dataset/English/Mobile_Phone/(E.M)C-bookCover/P090831039.jpg,char_data/T/P090831039.jpg_6.jpg,5890,480,640,62,80,142,18,113,True,29
T,62,kaist_dataset/English/Mobile_Phone/(E.M)C-bookCover/P090831075.jpg,char_data/T/P090831075.jpg_4.jpg,2356,480,640,38,398,436,279,341,True,29
T,53,kaist_dataset/English/Mobile_Phone/(E.M)C-bookCover/P090831075.jpg,char_data/T/P090831075.jpg_5.jpg,2067,480,640,39,527,566,285,338,True,29
T,138,kaist_dataset/English/Mobile_Phone/(E.M)C-bookCover/P090831077.jpg,char_data/T/P090831077.jpg_5.jpg,12834,480,640,93,15,108,238,376,True,29
T,62,kaist_dataset/English/Mobile_Phone/(E.M)C-bookCover/P090903041.jpg,char_data/T/P090903041.jpg_4.jpg,2604,480,640,42,226,268,21,83,True,29
T,52,kaist_dataset/English/Mobile_Phone/(E.M)C-bookCover/P090903041.jpg,char_data/T/P090903041.jpg_5.jpg,2288,480,640,44,506,550,29,81,True,29
T,77,kaist_dataset/English/Mobile_Phone/(E.M)C-bookCover/P090903050.jpg,char_data/T/P090903050.jpg_2.jpg,6006,480,640,78,172,250,9,86,True,29
T,61,kaist_dataset/English/Mobile_Phone/(E.M)C-bookCover/P090903054.jpg,char_data/T/P090903054.jpg_6.jpg,1769,480,640,29,278,307,346,407,True,29
T,56,kaist_dataset/English/Mobile_Phone/(E.M)C-bookCover/P090903054.jpg,char_data/T/P090903054.jpg_7.jpg,1568,480,640,28,306,334,348,404,True,29
T,53,kaist_dataset/English/Mobile_Phone/(E.M)C-bookCover/P090903054.jpg,char_data/T/P090903054.jpg_8.jpg,1537,480,640,29,525,554,350,403,True,29
T,89,kaist_dataset/English/Mobile_Phone/(E.M)C-bookCover/P090903055.jpg,char_data/T/P090903055.jpg_4.jpg,7743,480,640,87,22,109,152,241,True,29
T,38,kaist_dataset/English/Mobile_Phone/(E.M)C-bookCover/P090903055.jpg,char_data/T/P090903055.jpg_5.jpg,1330,480,640,35,139,174,408,446,True,29
T,112,kaist_dataset/English/Mobile_Phone/(E.M)C-bookCover/P090903056.jpg,char_data/T/P090903056.jpg_2.jpg,8624,480,640,77,11,88,291,403,True,29
T,70,kaist_dataset/English/Mobile_Phone/(E.M)C-bookCover/P090903071.jpg,char_data/T/P090903071.jpg_2.jpg,4200,480,640,60,229,289,147,217,True,29
T,87,kaist_dataset/English/Mobile_Phone/(E.M)C-bookCover/P090905007.jpg,char_data/T/P090905007.jpg_10.jpg,6699,480,640,77,353,430,41,128,True,29
T,90,kaist_dataset/English/Mobile_Phone/(E.M)C-bookCover/P090905007.jpg,char_data/T/P090905007.jpg_11.jpg,5580,480,640,62,106,168,169,259,True,29
T,89,kaist_dataset/English/Mobile_Phone/(E.M)C-bookCover/P090905007.jpg,char_data/T/P090905007.jpg_12.jpg,6141,480,640,69,165,234,170,259,True,29
T,80,kaist_dataset/English/Mobile_Phone/(E.M)C-bookCover/P090905007.jpg,char_data/T/P090905007.jpg_13.jpg,4880,480,640,61,560,621,174,254,True,29
T,76,kaist_dataset/English/Mobile_Phone/(E.M)C-bookCover/P090905007.jpg,char_data/T/P090905007.jpg_14.jpg,5776,480,640,76,148,224,294,370,True,29
T,14,kaist_dataset/Korean/Digital_Camera/E-night/103.jpg,char_data/T/103.jpg_4.jpg,112,480,640,8,389,397,155,169,True,29
T,20,kaist_dataset/Korean/Digital_Camera/E-night/103.jpg,char_data/T/103.jpg_5.jpg,260,480,640,13,139,152,315,335,True,29
T,42,kaist_dataset/Korean/Digital_Camera/G-others/DSC03862.JPG,char_data/T/DSC03862.JPG_2.jpg,1050,480,640,25,226,251,351,393,True,29
T,19,kaist_dataset/Korean/Digital_Camera/indoor1/136.JPG,char_data/T/136.JPG_2.jpg,285,480,640,15,324,339,288,307,True,29
T,19,kaist_dataset/Korean/Digital_Camera/indoor1/145.JPG,char_data/T/145.JPG_2.jpg,304,480,640,16,214,230,307,326,True,29
T,41,kaist_dataset/Korean/Digital_Camera/outdoor1/127.JPG,char_data/T/127.JPG_2.jpg,1107,480,640,27,172,199,271,312,True,29
T,47,kaist_dataset/Korean/Digital_Camera/outdoor1/2007-12-08-day-047.jpg,char_data/T/2007-12-08-day-047.jpg_2.jpg,1786,1200,1600,38,760,798,706,753,True,29
T,29,kaist_dataset/Korean/Digital_Camera/outdoor2/2007-12-08-day-094.jpg,char_data/T/2007-12-08-day-094.jpg_2.jpg,551,1600,1200,19,710,729,1420,1449,True,29
T,60,kaist_dataset/Korean/Digital_Camera/outdoor2/2007-12-08-day-109.jpg,char_data/T/2007-12-08-day-109.jpg_2.jpg,2280,1200,1600,38,69,107,800,860,True,29
T,50,kaist_dataset/Korean/Digital_Camera/outdoor2/2007-12-09-day-exterior-006.jpg,char_data/T/2007-12-09-day-exterior-006.jpg_2.jpg,1800,1200,1600,36,1495,1531,576,626,True,29
T,58,kaist_dataset/Korean/Digital_Camera/outdoor2/2007-12-09-day-exterior-035.jpg,char_data/T/2007-12-09-day-exterior-035.jpg_2.jpg,2958,1200,1600,51,343,394,702,760,True,29
T,40,kaist_dataset/Korean/Digital_Camera/outdoor2/2007-12-09-day-exterior-036.jpg,char_data/T/2007-12-09-day-exterior-036.jpg_2.jpg,960,1200,1600,24,1406,1430,628,668,True,29
T,30,kaist_dataset/Korean/Digital_Camera/outdoor2/DSC02372.JPG,char_data/T/DSC02372.JPG_2.jpg,660,480,640,22,440,462,293,323,True,29
T,32,kaist_dataset/Korean/Digital_Camera/outdoor3/DSC02971.JPG,char_data/T/DSC02971.JPG_2.jpg,800,480,640,25,211,236,295,327,True,29
T,36,kaist_dataset/Korean/Digital_Camera/outdoor3/DSC03237.JPG,char_data/T/DSC03237.JPG_2.jpg,1512,480,640,42,158,200,411,447,True,29
T,24,kaist_dataset/Korean/Digital_Camera/outdoor6/DSC04341.JPG,char_data/T/DSC04341.JPG_2.jpg,504,480,640,21,453,474,225,249,True,29
T,49,kaist_dataset/Mixed/Digital_Camera/(C.S)A-shadow/DSC02567.JPG,char_data/T/DSC02567.JPG_4.jpg,2156,480,640,44,116,160,143,192,True,29
T,31,kaist_dataset/Mixed/Digital_Camera/(C.S)A-shadow/DSC02579.JPG,char_data/T/DSC02579.JPG_2.jpg,961,480,640,31,172,203,403,434,True,29
T,36,kaist_dataset/Mixed/Digital_Camera/(C.S)A-shadow/DSC02581.JPG,char_data/T/DSC02581.JPG_2.jpg,900,480,640,25,187,212,388,424,True,29
T,31,kaist_dataset/Mixed/Digital_Camera/(C.S)A-shadow/DSC02609.JPG,char_data/T/DSC02609.JPG_8.jpg,713,480,640,23,228,251,312,343,True,29
T,35,kaist_dataset/Mixed/Digital_Camera/(C.S)A-shadow/DSC03257.JPG,char_data/T/DSC03257.JPG_2.jpg,945,480,640,27,214,241,381,416,True,29
T,63,kaist_dataset/Mixed/Digital_Camera/(C.S)A-shadow/DSC03520.JPG,char_data/T/DSC03520.JPG_2.jpg,2394,480,640,38,351,389,45,108,True,29
T,50,kaist_dataset/Mixed/Digital_Camera/(C.S)A-shadow/DSC04304.JPG,char_data/T/DSC04304.JPG_2.jpg,1800,480,640,36,285,321,283,333,True,29
T,33,kaist_dataset/Mixed/Digital_Camera/(C.S)A-shadow/DSC04306.JPG,char_data/T/DSC04306.JPG_2.jpg,726,480,640,22,195,217,408,441,True,29
T,67,kaist_dataset/Mixed/Digital_Camera/(C.S)A-shadow/DSC04326.JPG,char_data/T/DSC04326.JPG_2.jpg,2211,480,640,33,275,308,11,78,True,29
T,45,kaist_dataset/Mixed/Digital_Camera/(C.S)A-shadow/P1010019.JPG,char_data/T/P1010019.JPG_2.jpg,1215,480,640,27,255,282,198,243,True,29
T,35,kaist_dataset/Mixed/Digital_Camera/(C.S)B-light/DSC03298.JPG,char_data/T/DSC03298.JPG_2.jpg,945,480,640,27,300,327,289,324,True,29
T,53,kaist_dataset/Mixed/Digital_Camera/(C.S)C-outdoor1/003.JPG,char_data/T/003.JPG_12.jpg,1696,480,640,32,344,376,94,147,True,29
T,120,kaist_dataset/Mixed/Digital_Camera/(C.S)C-outdoor1/008.JPG,char_data/T/008.JPG_6.jpg,6360,480,640,53,58,111,133,253,True,29
T,117,kaist_dataset/Mixed/Digital_Camera/(C.S)C-outdoor1/008.JPG,char_data/T/008.JPG_7.jpg,7137,480,640,61,339,400,132,249,True,29
T,26,kaist_dataset/Mixed/Digital_Camera/(C.S)C-outdoor1/008.JPG,char_data/T/008.JPG_8.jpg,520,480,640,20,410,430,267,293,True,29
T,32,kaist_dataset/Mixed/Digital_Camera/(C.S)C-outdoor1/009.JPG,char_data/T/009.JPG_2.jpg,864,480,640,27,217,244,321,353,True,29
T,17,kaist_dataset/Mixed/Digital_Camera/(C.S)C-outdoor1/014.JPG,char_data/T/014.JPG_2.jpg,340,480,640,20,121,141,280,297,True,29
T,26,kaist_dataset/Mixed/Digital_Camera/(C.S)C-outdoor1/021.JPG,char_data/T/021.JPG_2.jpg,286,480,640,11,481,492,207,233,True,29
T,53,kaist_dataset/Mixed/Digital_Camera/(C.S)C-outdoor1/025.JPG,char_data/T/025.JPG_2.jpg,1908,480,640,36,74,110,332,385,True,29
T,30,kaist_dataset/Mixed/Digital_Camera/(C.S)C-outdoor1/048.JPG,char_data/T/048.JPG_2.jpg,600,480,640,20,189,209,257,287,True,29
T,51,kaist_dataset/Mixed/Digital_Camera/(C.S)C-outdoor1/080119-0006.jpg,char_data/T/080119-0006.jpg_2.jpg,2040,1200,1600,40,826,866,738,789,True,29
T,71,kaist_dataset/Mixed/Digital_Camera/(C.S)C-outdoor1/080119-0008.jpg,char_data/T/080119-0008.jpg_2.jpg,2343,1200,1600,33,1243,1276,654,725,True,29
T,154,kaist_dataset/Mixed/Digital_Camera/(C.S)C-outdoor1/080119-0017.jpg,char_data/T/080119-0017.jpg_2.jpg,17248,1200,1600,112,976,1088,561,715,True,29
T,123,kaist_dataset/Mixed/Digital_Camera/(C.S)C-outdoor1/080119-0037.jpg,char_data/T/080119-0037.jpg_10.jpg,7995,1200,1600,65,182,247,882,1005,True,29
T,125,kaist_dataset/Mixed/Digital_Camera/(C.S)C-outdoor1/080119-0037.jpg,char_data/T/080119-0037.jpg_11.jpg,8500,1200,1600,68,248,316,877,1002,True,29
T,134,kaist_dataset/Mixed/Digital_Camera/(C.S)C-outdoor1/080119-0037.jpg,char_data/T/080119-0037.jpg_12.jpg,8174,1200,1600,61,798,859,851,985,True,29
T,118,kaist_dataset/Mixed/Digital_Camera/(C.S)C-outdoor1/080119-0037.jpg,char_data/T/080119-0037.jpg_13.jpg,7552,1200,1600,64,1106,1170,843,961,True,29
T,129,kaist_dataset/Mixed/Digital_Camera/(C.S)C-outdoor1/080119-0037.jpg,char_data/T/080119-0037.jpg_14.jpg,7482,1200,1600,58,1250,1308,829,958,True,29
T,43,kaist_dataset/Mixed/Digital_Camera/(C.S)C-outdoor1/081.JPG,char_data/T/081.JPG_2.jpg,1247,480,640,29,101,130,252,295,True,29
T,26,kaist_dataset/Mixed/Digital_Camera/(C.S)C-outdoor1/090.JPG,char_data/T/090.JPG_4.jpg,520,480,640,20,463,483,362,388,True,29
T,33,kaist_dataset/Mixed/Digital_Camera/(C.S)C-outdoor1/090.JPG,char_data/T/090.JPG_5.jpg,825,480,640,25,304,329,388,421,True,29
T,52,kaist_dataset/Mixed/Digital_Camera/(C.S)C-outdoor1/1.JPG,char_data/T/1.JPG_5.jpg,1508,576,768,29,566,595,281,333,True,29
T,28,kaist_dataset/Mixed/Digital_Camera/(C.S)C-outdoor1/121.JPG,char_data/T/121.JPG_2.jpg,616,480,640,22,245,267,275,303,True,29
T,63,kaist_dataset/Mixed/Digital_Camera/(C.S)C-outdoor1/2.JPG,char_data/T/2.JPG_8.jpg,2079,576,768,33,431,464,209,272,True,29
T,22,kaist_dataset/Mixed/Digital_Camera/(C.S)C-outdoor1/2.JPG,char_data/T/2.JPG_10.jpg,374,576,768,17,517,534,398,420,True,29
T,22,kaist_dataset/Mixed/Digital_Camera/(C.S)C-outdoor1/2.JPG,char_data/T/2.JPG_11.jpg,308,576,768,14,587,601,371,393,True,29
T,53,kaist_dataset/Mixed/Digital_Camera/(C.S)C-outdoor1/2007-12-08-day-091.jpg,char_data/T/2007-12-08-day-091.jpg_2.jpg,2438,1200,1600,46,1006,1052,635,688,True,29
T,91,kaist_dataset/Mixed/Digital_Camera/(C.S)C-outdoor1/2007-12-08-day-092.jpg,char_data/T/2007-12-08-day-092.jpg_2.jpg,6188,1200,1600,68,408,476,663,754,True,29
T,60,kaist_dataset/Mixed/Digital_Camera/(C.S)C-outdoor1/2007-12-08-day-106.jpg,char_data/T/2007-12-08-day-106.jpg_2.jpg,3660,1200,1600,61,1149,1210,746,806,True,29
T,39,kaist_dataset/Mixed/Digital_Camera/(C.S)C-outdoor1/2007-12-08-day-130.jpg,char_data/T/2007-12-08-day-130.jpg_2.jpg,1404,1200,1600,36,835,871,749,788,True,29
T,61,kaist_dataset/Mixed/Digital_Camera/(C.S)C-outdoor1/2007-12-09-day-exterior-004.jpg,char_data/T/2007-12-09-day-exterior-004.jpg_2.jpg,3660,1200,1600,60,898,958,662,723,True,29
T,40,kaist_dataset/Mixed/Digital_Camera/(C.S)C-outdoor1/2007-12-09-day-exterior-037.jpg,char_data/T/2007-12-09-day-exterior-037.jpg_2.jpg,1720,1200,1600,43,613,656,716,756,True,29
T,82,kaist_dataset/Mixed/Digital_Camera/(C.S)C-outdoor1/2007-12-09-day-exterior-044.jpg,char_data/T/2007-12-09-day-exterior-044.jpg_4.jpg,7954,1200,1600,97,502,599,327,409,True,29
T,76,kaist_dataset/Mixed/Digital_Camera/(C.S)C-outdoor1/2007-12-09-day-exterior-044.jpg,char_data/T/2007-12-09-day-exterior-044.jpg_5.jpg,4028,1200,1600,53,1343,1396,970,1046,True,29
T,104,kaist_dataset/Mixed/Digital_Camera/(C.S)C-outdoor1/2007-12-09-day-exterior-051.jpg,char_data/T/2007-12-09-day-exterior-051.jpg_6.jpg,11128,1200,1600,107,435,542,355,459,True,29
T,49,kaist_dataset/Mixed/Digital_Camera/(C.S)C-outdoor1/2007-12-09-day-exterior-051.jpg,char_data/T/2007-12-09-day-exterior-051.jpg_7.jpg,1421,1200,1600,29,213,242,924,973,True,29
T,60,kaist_dataset/Mixed/Digital_Camera/(C.S)C-outdoor1/2007-12-09-day-exterior-051.jpg,char_data/T/2007-12-09-day-exterior-051.jpg_8.jpg,2820,1200,1600,47,1329,1376,924,984,True,29
T,57,kaist_dataset/Mixed/Digital_Camera/(C.S)C-outdoor1/2007-12-09-day-exterior-078.jpg,char_data/T/2007-12-09-day-exterior-078.jpg_2.jpg,2052,1200,1600,36,374,410,591,648,True,29
T,63,kaist_dataset/Mixed/Digital_Camera/(C.S)C-outdoor1/2007-12-09-day-exterior-086.jpg,char_data/T/2007-12-09-day-exterior-086.jpg_2.jpg,5481,1200,1600,87,574,661,726,789,True,29
T,41,kaist_dataset/Mixed/Digital_Camera/(C.S)C-outdoor1/45.JPG,char_data/T/45.JPG_2.jpg,1681,576,768,41,213,254,361,402,True,29
T,38,kaist_dataset/Mixed/Digital_Camera/(C.S)C-outdoor1/51.JPG,char_data/T/51.JPG_2.jpg,1406,576,768,37,444,481,379,417,True,29
T,31,kaist_dataset/Mixed/Digital_Camera/(C.S)C-outdoor1/55.JPG,char_data/T/55.JPG_2.jpg,1147,576,768,37,226,263,371,402,True,29
T,41,kaist_dataset/Mixed/Digital_Camera/(C.S)C-outdoor1/56.JPG,char_data/T/56.JPG_2.jpg,1312,576,768,32,267,299,302,343,True,29
T,26,kaist_dataset/Mixed/Digital_Camera/(C.S)C-outdoor1/57.JPG,char_data/T/57.JPG_2.jpg,546,500,766,21,294,315,292,318,True,29
T,84,kaist_dataset/Mixed/Digital_Camera/(C.S)C-outdoor1/DSC02244.JPG,char_data/T/DSC02244.JPG_2.jpg,4620,480,640,55,82,137,348,432,True,29
T,115,kaist_dataset/Mixed/Digital_Camera/(C.S)C-outdoor1/DSC02320.JPG,char_data/T/DSC02320.JPG_4.jpg,14260,480,640,124,171,295,181,296,True,29
T,37,kaist_dataset/Mixed/Digital_Camera/(C.S)C-outdoor1/DSC02349.JPG,char_data/T/DSC02349.JPG_2.jpg,1073,480,640,29,224,253,195,232,True,29
T,50,kaist_dataset/Mixed/Digital_Camera/(C.S)C-outdoor1/DSC02350.JPG,char_data/T/DSC02350.JPG_2.jpg,1900,480,640,38,193,231,398,448,True,29
T,53,kaist_dataset/Mixed/Digital_Camera/(C.S)C-outdoor1/P1010009.JPG,char_data/T/P1010009.JPG_4.jpg,1484,480,640,28,195,223,183,236,True,29
T,55,kaist_dataset/Mixed/Digital_Camera/(C.S)C-outdoor1/P1010009.JPG,char_data/T/P1010009.JPG_5.jpg,1705,480,640,31,402,433,188,243,True,29
T,39,kaist_dataset/Mixed/Digital_Camera/(C.S)C-outdoor1/P1010010.JPG,char_data/T/P1010010.JPG_4.jpg,1638,480,640,42,151,193,217,256,True,29
T,46,kaist_dataset/Mixed/Digital_Camera/(C.S)C-outdoor1/P1010010.JPG,char_data/T/P1010010.JPG_5.jpg,1196,480,640,26,279,305,363,409,True,29
T,37,kaist_dataset/Mixed/Digital_Camera/(C.S)C-outdoor1/P1010011.JPG,char_data/T/P1010011.JPG_2.jpg,851,480,640,23,414,437,311,348,True,29
T,51,kaist_dataset/Mixed/Digital_Camera/(C.S)C-outdoor1/P1010012.JPG,char_data/T/P1010012.JPG_2.jpg,1887,480,640,37,223,260,235,286,True,29
T,54,kaist_dataset/Mixed/Digital_Camera/(C.S)C-outdoor2/DSC02359.JPG,char_data/T/DSC02359.JPG_2.jpg,1512,480,640,28,149,177,411,465,True,29
T,42,kaist_dataset/Mixed/Digital_Camera/(C.S)C-outdoor2/DSC02361.JPG,char_data/T/DSC02361.JPG_2.jpg,1092,480,640,26,467,493,372,414,True,29
T,55,kaist_dataset/Mixed/Digital_Camera/(C.S)C-outdoor2/DSC02365.JPG,char_data/T/DSC02365.JPG_4.jpg,1155,480,640,21,258,279,90,145,True,29
T,52,kaist_dataset/Mixed/Digital_Camera/(C.S)C-outdoor2/DSC02365.JPG,char_data/T/DSC02365.JPG_5.jpg,1872,480,640,36,305,341,82,134,True,29
T,36,kaist_dataset/Mixed/Digital_Camera/(C.S)C-outdoor2/DSC02368.JPG,char_data/T/DSC02368.JPG_2.jpg,612,480,640,17,71,88,383,419,True,29
T,39,kaist_dataset/Mixed/Digital_Camera/(C.S)C-outdoor2/DSC02374.JPG,char_data/T/DSC02374.JPG_2.jpg,780,480,640,20,206,226,305,344,True,29
T,38,kaist_dataset/Mixed/Digital_Camera/(C.S)C-outdoor2/DSC02376.JPG,char_data/T/DSC02376.JPG_2.jpg,1140,480,640,30,383,413,341,379,True,29
T,33,kaist_dataset/Mixed/Digital_Camera/(C.S)C-outdoor2/DSC02377.JPG,char_data/T/DSC02377.JPG_2.jpg,594,480,640,18,362,380,356,389,True,29
T,31,kaist_dataset/Mixed/Digital_Camera/(C.S)C-outdoor2/DSC02379.JPG,char_data/T/DSC02379.JPG_2.jpg,837,480,640,27,352,379,291,322,True,29
T,72,kaist_dataset/Mixed/Digital_Camera/(C.S)C-outdoor2/DSC02385.JPG,char_data/T/DSC02385.JPG_2.jpg,3672,480,640,51,396,447,178,250,True,29
T,41,kaist_dataset/Mixed/Digital_Camera/(C.S)C-outdoor2/DSC02389.JPG,char_data/T/DSC02389.JPG_2.jpg,1681,480,640,41,172,213,50,91,True,29
T,62,kaist_dataset/Mixed/Digital_Camera/(C.S)C-outdoor2/DSC02400.JPG,char_data/T/DSC02400.JPG_2.jpg,2604,480,640,42,127,169,391,453,True,29
T,40,kaist_dataset/Mixed/Digital_Camera/(C.S)C-outdoor2/DSC02422.JPG,char_data/T/DSC02422.JPG_2.jpg,840,480,640,21,310,331,217,257,True,29
T,28,kaist_dataset/Mixed/Digital_Camera/(C.S)C-outdoor2/DSC02430.JPG,char_data/T/DSC02430.JPG_4.jpg,560,480,640,20,94,114,187,215,True,29
T,55,kaist_dataset/Mixed/Digital_Camera/(C.S)C-outdoor2/DSC02439.JPG,char_data/T/DSC02439.JPG_2.jpg,2640,480,640,48,330,378,139,194,True,29
T,36,kaist_dataset/Mixed/Digital_Camera/(C.S)C-outdoor2/DSC02447.JPG,char_data/T/DSC02447.JPG_2.jpg,828,480,640,23,444,467,223,259,True,29
T,30,kaist_dataset/Mixed/Digital_Camera/(C.S)C-outdoor2/DSC02460.JPG,char_data/T/DSC02460.JPG_2.jpg,720,480,640,24,276,300,306,336,True,29
T,55,kaist_dataset/Mixed/Digital_Camera/(C.S)C-outdoor2/DSC02461.JPG,char_data/T/DSC02461.JPG_2.jpg,3905,480,640,71,5,76,288,343,True,29
T,23,kaist_dataset/Mixed/Digital_Camera/(C.S)C-outdoor2/DSC02477.JPG,char_data/T/DSC02477.JPG_4.jpg,276,480,640,12,115,127,158,181,True,29
T,25,kaist_dataset/Mixed/Digital_Camera/(C.S)C-outdoor2/DSC02477.JPG,char_data/T/DSC02477.JPG_5.jpg,625,480,640,25,25,50,255,280,True,29
T,33,kaist_dataset/Mixed/Digital_Camera/(C.S)C-outdoor2/DSC02479.JPG,char_data/T/DSC02479.JPG_2.jpg,660,480,640,20,384,404,222,255,True,29
T,36,kaist_dataset/Mixed/Digital_Camera/(C.S)C-outdoor2/DSC02489.JPG,char_data/T/DSC02489.JPG_2.jpg,936,480,640,26,221,247,262,298,True,29
T,44,kaist_dataset/Mixed/Digital_Camera/(C.S)C-outdoor2/DSC02490.JPG,char_data/T/DSC02490.JPG_2.jpg,1100,480,640,25,238,263,339,383,True,29
T,36,kaist_dataset/Mixed/Digital_Camera/(C.S)C-outdoor2/DSC02492.JPG,char_data/T/DSC02492.JPG_2.jpg,1008,480,640,28,314,342,325,361,True,29
T,49,kaist_dataset/Mixed/Digital_Camera/(C.S)C-outdoor2/DSC02511.JPG,char_data/T/DSC02511.JPG_4.jpg,1225,480,640,25,79,104,196,245,True,29
T,36,kaist_dataset/Mixed/Digital_Camera/(C.S)C-outdoor2/DSC02511.JPG,char_data/T/DSC02511.JPG_5.jpg,936,480,640,26,165,191,397,433,True,29
T,70,kaist_dataset/Mixed/Digital_Camera/(C.S)C-outdoor2/DSC02527.JPG,char_data/T/DSC02527.JPG_2.jpg,2520,480,640,36,194,230,288,358,True,29
T,38,kaist_dataset/Mixed/Digital_Camera/(C.S)C-outdoor2/DSC02543.JPG,char_data/T/DSC02543.JPG_2.jpg,1254,480,640,33,267,300,351,389,True,29
T,119,kaist_dataset/Mixed/Digital_Camera/(C.S)C-outdoor2/DSC02551.JPG,char_data/T/DSC02551.JPG_2.jpg,11781,480,640,99,446,545,269,388,True,29
T,37,kaist_dataset/Mixed/Digital_Camera/(C.S)C-outdoor2/DSC02553.JPG,char_data/T/DSC02553.JPG_2.jpg,962,480,640,26,262,288,297,334,True,29
T,24,kaist_dataset/Mixed/Digital_Camera/(C.S)C-outdoor2/DSC02555.JPG,char_data/T/DSC02555.JPG_4.jpg,336,480,640,14,128,142,152,176,True,29
T,24,kaist_dataset/Mixed/Digital_Camera/(C.S)C-outdoor2/DSC02555.JPG,char_data/T/DSC02555.JPG_5.jpg,600,480,640,25,26,51,253,277,True,29
T,31,kaist_dataset/Mixed/Digital_Camera/(C.S)C-outdoor2/DSC02556.JPG,char_data/T/DSC02556.JPG_2.jpg,1147,480,640,37,234,271,341,372,True,29
T,49,kaist_dataset/Mixed/Digital_Camera/(C.S)C-outdoor2/DSC02567.JPG,char_data/T/DSC02567.JPG_5.jpg,2156,480,640,44,116,160,143,192,True,29
T,39,kaist_dataset/Mixed/Digital_Camera/(C.S)C-outdoor2/DSC02864.JPG,char_data/T/DSC02864.JPG_2.jpg,819,480,640,21,557,578,256,295,True,29
T,43,kaist_dataset/Mixed/Digital_Camera/(C.S)C-outdoor2/DSC02867.JPG,char_data/T/DSC02867.JPG_2.jpg,1204,480,640,28,341,369,399,442,True,29
T,69,kaist_dataset/Mixed/Digital_Camera/(C.S)C-outdoor2/DSC02870.JPG,char_data/T/DSC02870.JPG_2.jpg,3105,480,640,45,224,269,277,346,True,29
T,28,kaist_dataset/Mixed/Digital_Camera/(C.S)C-outdoor2/DSC02877.JPG,char_data/T/DSC02877.JPG_2.jpg,672,480,640,24,471,495,220,248,True,29
T,27,kaist_dataset/Mixed/Digital_Camera/(C.S)C-outdoor2/DSC02879.JPG,char_data/T/DSC02879.JPG_2.jpg,513,480,640,19,223,242,291,318,True,29
T,43,kaist_dataset/Mixed/Digital_Camera/(C.S)C-outdoor2/DSC02895.JPG,char_data/T/DSC02895.JPG_2.jpg,1032,480,640,24,161,185,361,404,True,29
T,42,kaist_dataset/Mixed/Digital_Camera/(C.S)C-outdoor2/DSC02910.JPG,char_data/T/DSC02910.JPG_4.jpg,798,480,640,19,333,352,54,96,True,29
T,39,kaist_dataset/Mixed/Digital_Camera/(C.S)C-outdoor2/DSC02910.JPG,char_data/T/DSC02910.JPG_5.jpg,585,480,640,15,445,460,52,91,True,29
T,35,kaist_dataset/Mixed/Digital_Camera/(C.S)C-outdoor2/DSC02930.JPG,char_data/T/DSC02930.JPG_2.jpg,875,480,640,25,236,261,194,229,True,29
T,43,kaist_dataset/Mixed/Digital_Camera/(C.S)C-outdoor2/DSC02933.JPG,char_data/T/DSC02933.JPG_2.jpg,1075,480,640,25,442,467,238,281,True,29
T,42,kaist_dataset/Mixed/Digital_Camera/(C.S)C-outdoor2/DSC02937.JPG,char_data/T/DSC02937.JPG_2.jpg,1092,480,640,26,67,93,204,246,True,29
T,40,kaist_dataset/Mixed/Digital_Camera/(C.S)C-outdoor2/DSC02938.JPG,char_data/T/DSC02938.JPG_2.jpg,1240,480,640,31,381,412,240,280,True,29
T,39,kaist_dataset/Mixed/Digital_Camera/(C.S)C-outdoor2/DSC02954.JPG,char_data/T/DSC02954.JPG_2.jpg,1131,480,640,29,47,76,251,290,True,29
T,57,kaist_dataset/Mixed/Digital_Camera/(C.S)C-outdoor2/P1010013.JPG,char_data/T/P1010013.JPG_2.jpg,2337,480,640,41,151,192,359,416,True,29
T,23,kaist_dataset/Mixed/Digital_Camera/(C.S)C-outdoor2/P1010015.JPG,char_data/T/P1010015.JPG_2.jpg,368,480,640,16,322,338,186,209,True,29
T,37,kaist_dataset/Mixed/Digital_Camera/(C.S)C-outdoor3/DSC02956.JPG,char_data/T/DSC02956.JPG_2.jpg,925,480,640,25,58,83,388,425,True,29
T,42,kaist_dataset/Mixed/Digital_Camera/(C.S)C-outdoor3/DSC02958.JPG,char_data/T/DSC02958.JPG_2.jpg,1218,480,640,29,192,221,398,440,True,29
T,42,kaist_dataset/Mixed/Digital_Camera/(C.S)C-outdoor3/DSC02969.JPG,char_data/T/DSC02969.JPG_2.jpg,1722,480,640,41,204,245,228,270,True,29
T,39,kaist_dataset/Mixed/Digital_Camera/(C.S)C-outdoor3/DSC02986.JPG,char_data/T/DSC02986.JPG_2.jpg,975,480,640,25,360,385,278,317,True,29
T,45,kaist_dataset/Mixed/Digital_Camera/(C.S)C-outdoor3/DSC02989.JPG,char_data/T/DSC02989.JPG_12.jpg,1485,480,640,33,240,273,261,306,True,29
T,45,kaist_dataset/Mixed/Digital_Camera/(C.S)C-outdoor3/DSC02989.JPG,char_data/T/DSC02989.JPG_13.jpg,1440,480,640,32,430,462,265,310,True,29
T,51,kaist_dataset/Mixed/Digital_Camera/(C.S)C-outdoor3/DSC02989.JPG,char_data/T/DSC02989.JPG_14.jpg,1224,480,640,24,406,430,343,394,True,29
T,34,kaist_dataset/Mixed/Digital_Camera/(C.S)C-outdoor3/DSC03020.JPG,char_data/T/DSC03020.JPG_2.jpg,850,480,640,25,499,524,268,302,True,29
T,31,kaist_dataset/Mixed/Digital_Camera/(C.S)C-outdoor3/DSC03035.JPG,char_data/T/DSC03035.JPG_6.jpg,527,480,640,17,284,301,369,400,True,29
T,37,kaist_dataset/Mixed/Digital_Camera/(C.S)C-outdoor3/DSC03035.JPG,char_data/T/DSC03035.JPG_7.jpg,851,480,640,23,399,422,368,405,True,29
T,27,kaist_dataset/Mixed/Digital_Camera/(C.S)C-outdoor3/DSC03035.JPG,char_data/T/DSC03035.JPG_8.jpg,594,480,640,22,284,306,403,430,True,29
T,31,kaist_dataset/Mixed/Digital_Camera/(C.S)C-outdoor3/DSC03051.JPG,char_data/T/DSC03051.JPG_2.jpg,620,480,640,20,215,235,323,354,True,29
T,79,kaist_dataset/Mixed/Digital_Camera/(C.S)C-outdoor3/DSC03055.JPG,char_data/T/DSC03055.JPG_2.jpg,5609,480,640,71,57,128,256,335,True,29
T,75,kaist_dataset/Mixed/Digital_Camera/(C.S)C-outdoor3/DSC03060.JPG,char_data/T/DSC03060.JPG_2.jpg,3450,480,640,46,174,220,71,146,True,29
T,37,kaist_dataset/Mixed/Digital_Camera/(C.S)C-outdoor3/DSC03061.JPG,char_data/T/DSC03061.JPG_2.jpg,851,480,640,23,261,284,253,290,True,29
T,37,kaist_dataset/Mixed/Digital_Camera/(C.S)C-outdoor3/DSC03062.JPG,char_data/T/DSC03062.JPG_2.jpg,703,480,640,19,241,260,246,283,True,29
T,78,kaist_dataset/Mixed/Digital_Camera/(C.S)C-outdoor3/DSC03067.JPG,char_data/T/DSC03067.JPG_2.jpg,4446,480,640,57,179,236,100,178,True,29
T,51,kaist_dataset/Mixed/Digital_Camera/(C.S)C-outdoor3/DSC03185.JPG,char_data/T/DSC03185.JPG_2.jpg,2397,480,640,47,122,169,143,194,True,29
T,35,kaist_dataset/Mixed/Digital_Camera/(C.S)C-outdoor3/DSC03187.JPG,char_data/T/DSC03187.JPG_2.jpg,840,480,640,24,179,203,389,424,True,29
T,40,kaist_dataset/Mixed/Digital_Camera/(C.S)C-outdoor3/DSC03212.JPG,char_data/T/DSC03212.JPG_2.jpg,1040,480,640,26,311,337,253,293,True,29
T,42,kaist_dataset/Mixed/Digital_Camera/(C.S)C-outdoor3/DSC03233.JPG,char_data/T/DSC03233.JPG_2.jpg,714,480,640,17,65,82,284,326,True,29
T,41,kaist_dataset/Mixed/Digital_Camera/(C.S)C-outdoor3/DSC03236.JPG,char_data/T/DSC03236.JPG_2.jpg,1804,480,640,44,156,200,423,464,True,29
T,96,kaist_dataset/Mixed/Digital_Camera/(C.S)C-outdoor3/DSC03247.JPG,char_data/T/DSC03247.JPG_2.jpg,5280,480,640,55,274,329,144,240,True,29
T,37,kaist_dataset/Mixed/Digital_Camera/(C.S)C-outdoor3/DSC03250.JPG,char_data/T/DSC03250.JPG_2.jpg,1036,480,640,28,407,435,400,437,True,29
T,29,kaist_dataset/Mixed/Digital_Camera/(C.S)C-outdoor3/DSC03254.JPG,char_data/T/DSC03254.JPG_2.jpg,1102,480,640,38,188,226,228,257,True,29
T,27,kaist_dataset/Mixed/Digital_Camera/(C.S)C-outdoor3/DSC03255.JPG,char_data/T/DSC03255.JPG_2.jpg,729,480,640,27,155,182,188,215,True,29
T,124,kaist_dataset/Mixed/Digital_Camera/(C.S)C-outdoor3/DSC03259.JPG,char_data/T/DSC03259.JPG_2.jpg,11780,480,640,95,88,183,60,184,True,29
T,104,kaist_dataset/Mixed/Digital_Camera/(C.S)C-outdoor3/DSC03260.JPG,char_data/T/DSC03260.JPG_4.jpg,6032,480,640,58,41,99,42,146,True,29
T,24,kaist_dataset/Mixed/Digital_Camera/(C.S)C-outdoor3/DSC03292.JPG,char_data/T/DSC03292.JPG_2.jpg,432,480,640,18,472,490,120,144,True,29
T,34,kaist_dataset/Mixed/Digital_Camera/(C.S)C-outdoor3/DSC03301.JPG,char_data/T/DSC03301.JPG_2.jpg,748,480,640,22,320,342,144,178,True,29
T,59,kaist_dataset/Mixed/Digital_Camera/(C.S)C-outdoor3/DSC03306.JPG,char_data/T/DSC03306.JPG_2.jpg,1829,480,640,31,460,491,392,451,True,29
T,37,kaist_dataset/Mixed/Digital_Camera/(C.S)C-outdoor3/DSC03309.JPG,char_data/T/DSC03309.JPG_2.jpg,999,480,640,27,184,211,263,300,True,29
T,38,kaist_dataset/Mixed/Digital_Camera/(C.S)C-outdoor3/DSC03312.JPG,char_data/T/DSC03312.JPG_2.jpg,1140,480,640,30,75,105,286,324,True,29
T,36,kaist_dataset/Mixed/Digital_Camera/(C.S)C-outdoor3/DSC03316.JPG,char_data/T/DSC03316.JPG_2.jpg,684,480,640,19,182,201,86,122,True,29
T,36,kaist_dataset/Mixed/Digital_Camera/(C.S)C-outdoor3/DSC03328.JPG,char_data/T/DSC03328.JPG_5.jpg,900,480,640,25,114,139,401,437,True,29
T,37,kaist_dataset/Mixed/Digital_Camera/(C.S)C-outdoor3/DSC03329.JPG,char_data/T/DSC03329.JPG_2.jpg,1110,480,640,30,499,529,440,477,True,29
T,36,kaist_dataset/Mixed/Digital_Camera/(C.S)C-outdoor3/DSC03330.JPG,char_data/T/DSC03330.JPG_2.jpg,720,480,640,20,182,202,395,431,True,29
T,37,kaist_dataset/Mixed/Digital_Camera/(C.S)C-outdoor3/DSC03331.JPG,char_data/T/DSC03331.JPG_2.jpg,740,480,640,20,174,194,380,417,True,29
T,74,kaist_dataset/Mixed/Digital_Camera/(C.S)C-outdoor3/DSC03409.JPG,char_data/T/DSC03409.JPG_2.jpg,4070,480,640,55,255,310,120,194,True,29
T,76,kaist_dataset/Mixed/Digital_Camera/(C.S)C-outdoor3/DSC03415.JPG,char_data/T/DSC03415.JPG_2.jpg,2584,480,640,34,438,472,162,238,True,29
T,43,kaist_dataset/Mixed/Digital_Camera/(C.S)C-outdoor4/DSC03435.JPG,char_data/T/DSC03435.JPG_2.jpg,1247,480,640,29,108,137,409,452,True,29
T,27,kaist_dataset/Mixed/Digital_Camera/(C.S)C-outdoor4/DSC03446.JPG,char_data/T/DSC03446.JPG_2.jpg,945,480,640,35,186,221,296,323,True,29
T,91,kaist_dataset/Mixed/Digital_Camera/(C.S)C-outdoor4/DSC03544.JPG,char_data/T/DSC03544.JPG_2.jpg,4914,480,640,54,62,116,165,256,True,29
T,44,kaist_dataset/Mixed/Digital_Camera/(C.S)C-outdoor4/DSC03548.JPG,char_data/T/DSC03548.JPG_2.jpg,2420,480,640,55,31,86,394,438,True,29
T,30,kaist_dataset/Mixed/Digital_Camera/(C.S)C-outdoor4/DSC03549.JPG,char_data/T/DSC03549.JPG_2.jpg,450,480,640,15,271,286,424,454,True,29
T,25,kaist_dataset/Mixed/Digital_Camera/(C.S)C-outdoor4/DSC03552.JPG,char_data/T/DSC03552.JPG_2.jpg,500,480,640,20,302,322,322,347,True,29
T,48,kaist_dataset/Mixed/Digital_Camera/(C.S)C-outdoor4/DSC03569.JPG,char_data/T/DSC03569.JPG_2.jpg,1392,480,640,29,265,294,169,217,True,29
T,28,kaist_dataset/Mixed/Digital_Camera/(C.S)C-outdoor4/DSC03570.JPG,char_data/T/DSC03570.JPG_2.jpg,700,480,640,25,215,240,421,449,True,29
T,91,kaist_dataset/Mixed/Digital_Camera/(C.S)C-outdoor4/DSC03571.JPG,char_data/T/DSC03571.JPG_2.jpg,4277,480,640,47,522,569,188,279,True,29
T,44,kaist_dataset/Mixed/Digital_Camera/(C.S)C-outdoor4/DSC03581.JPG,char_data/T/DSC03581.JPG_4.jpg,1056,480,640,24,123,147,193,237,True,29
T,49,kaist_dataset/Mixed/Digital_Camera/(C.S)C-outdoor4/DSC03581.JPG,char_data/T/DSC03581.JPG_5.jpg,1029,480,640,21,317,338,126,175,True,29
T,71,kaist_dataset/Mixed/Digital_Camera/(C.S)C-outdoor4/DSC03582.JPG,char_data/T/DSC03582.JPG_2.jpg,2911,480,640,41,349,390,154,225,True,29
T,80,kaist_dataset/Mixed/Digital_Camera/(C.S)C-outdoor4/DSC03609.JPG,char_data/T/DSC03609.JPG_2.jpg,3040,480,640,38,129,167,372,452,True,29
T,55,kaist_dataset/Mixed/Digital_Camera/(C.S)C-outdoor4/DSC03613.JPG,char_data/T/DSC03613.JPG_2.jpg,1595,480,640,29,340,369,20,75,True,29
T,35,kaist_dataset/Mixed/Digital_Camera/(C.S)C-outdoor4/DSC03616.JPG,char_data/T/DSC03616.JPG_2.jpg,945,480,640,27,518,545,149,184,True,29
T,41,kaist_dataset/Mixed/Digital_Camera/(C.S)C-outdoor4/DSC03617.JPG,char_data/T/DSC03617.JPG_2.jpg,984,480,640,24,115,139,387,428,True,29
T,26,kaist_dataset/Mixed/Digital_Camera/(C.S)C-outdoor4/DSC03618.JPG,char_data/T/DSC03618.JPG_2.jpg,858,480,640,33,196,229,410,436,True,29
T,43,kaist_dataset/Mixed/Digital_Camera/(C.S)C-outdoor4/DSC03620.JPG,char_data/T/DSC03620.JPG_2.jpg,2365,480,640,55,412,467,96,139,True,29
T,51,kaist_dataset/Mixed/Digital_Camera/(C.S)C-outdoor4/DSC03621.JPG,char_data/T/DSC03621.JPG_2.jpg,1377,480,640,27,319,346,327,378,True,29
T,47,kaist_dataset/Mixed/Digital_Camera/(C.S)C-outdoor4/DSC03631.JPG,char_data/T/DSC03631.JPG_2.jpg,752,480,640,16,115,131,355,402,True,29
T,49,kaist_dataset/Mixed/Digital_Camera/(C.S)C-outdoor4/DSC03633.JPG,char_data/T/DSC03633.JPG_2.jpg,1323,480,640,27,80,107,262,311,True,29
T,28,kaist_dataset/Mixed/Digital_Camera/(C.S)C-outdoor4/DSC03637.JPG,char_data/T/DSC03637.JPG_2.jpg,644,480,640,23,216,239,303,331,True,29
T,31,kaist_dataset/Mixed/Digital_Camera/(C.S)C-outdoor4/DSC03640.JPG,char_data/T/DSC03640.JPG_2.jpg,868,480,640,28,84,112,402,433,True,29
T,28,kaist_dataset/Mixed/Digital_Camera/(C.S)C-outdoor4/DSC03642.JPG,char_data/T/DSC03642.JPG_8.jpg,504,480,640,18,375,393,399,427,True,29
T,51,kaist_dataset/Mixed/Digital_Camera/(C.S)C-outdoor4/DSC03651.JPG,char_data/T/DSC03651.JPG_5.jpg,2244,480,640,44,148,192,358,409,True,29
T,86,kaist_dataset/Mixed/Digital_Camera/(C.S)C-outdoor4/DSC03654.JPG,char_data/T/DSC03654.JPG_2.jpg,3526,480,640,41,289,330,154,240,True,29
T,56,kaist_dataset/Mixed/Digital_Camera/(C.S)C-outdoor4/DSC03655.JPG,char_data/T/DSC03655.JPG_2.jpg,1456,480,640,26,155,181,386,442,True,29
T,35,kaist_dataset/Mixed/Digital_Camera/(C.S)C-outdoor4/DSC03656.JPG,char_data/T/DSC03656.JPG_2.jpg,1190,480,640,34,341,375,417,452,True,29
T,29,kaist_dataset/Mixed/Digital_Camera/(C.S)C-outdoor4/DSC03657.JPG,char_data/T/DSC03657.JPG_2.jpg,725,480,640,25,246,271,421,450,True,29
T,34,kaist_dataset/Mixed/Digital_Camera/(C.S)C-outdoor4/DSC03658.JPG,char_data/T/DSC03658.JPG_2.jpg,782,480,640,23,272,295,417,451,True,29
T,32,kaist_dataset/Mixed/Digital_Camera/(C.S)C-outdoor4/DSC03660.JPG,char_data/T/DSC03660.JPG_2.jpg,1120,480,640,35,223,258,102,134,True,29
T,26,kaist_dataset/Mixed/Digital_Camera/(C.S)C-outdoor4/DSC03661.JPG,char_data/T/DSC03661.JPG_2.jpg,416,480,640,16,339,355,340,366,True,29
T,40,kaist_dataset/Mixed/Digital_Camera/(C.S)C-outdoor4/DSC03662.JPG,char_data/T/DSC03662.JPG_2.jpg,1320,480,640,33,392,425,419,459,True,29
T,39,kaist_dataset/Mixed/Digital_Camera/(C.S)C-outdoor4/DSC03665.JPG,char_data/T/DSC03665.JPG_2.jpg,1365,480,640,35,202,237,155,194,True,29
T,83,kaist_dataset/Mixed/Digital_Camera/(C.S)C-outdoor4/DSC03666.JPG,char_data/T/DSC03666.JPG_2.jpg,5312,480,640,64,351,415,159,242,True,29
T,25,kaist_dataset/Mixed/Digital_Camera/(C.S)C-outdoor4/DSC03670.JPG,char_data/T/DSC03670.JPG_8.jpg,425,480,640,17,406,423,450,475,True,29
T,27,kaist_dataset/Mixed/Digital_Camera/(C.S)C-outdoor4/DSC03674.JPG,char_data/T/DSC03674.JPG_2.jpg,405,480,640,15,488,503,421,448,True,29
T,34,kaist_dataset/Mixed/Digital_Camera/(C.S)C-outdoor4/DSC03676.JPG,char_data/T/DSC03676.JPG_2.jpg,510,480,640,15,26,41,269,303,True,29
T,30,kaist_dataset/Mixed/Digital_Camera/(C.S)C-outdoor4/DSC03677.JPG,char_data/T/DSC03677.JPG_2.jpg,510,480,640,17,469,486,313,343,True,29
T,52,kaist_dataset/Mixed/Digital_Camera/(C.S)C-outdoor4/DSC03678.JPG,char_data/T/DSC03678.JPG_4.jpg,1144,480,640,22,75,97,229,281,True,29
T,46,kaist_dataset/Mixed/Digital_Camera/(C.S)C-outdoor4/DSC03678.JPG,char_data/T/DSC03678.JPG_5.jpg,1150,480,640,25,219,244,235,281,True,29
T,66,kaist_dataset/Mixed/Digital_Camera/(C.S)C-outdoor4/DSC03687.JPG,char_data/T/DSC03687.JPG_6.jpg,3696,480,640,56,334,390,325,391,True,29
T,24,kaist_dataset/Mixed/Digital_Camera/(C.S)C-outdoor4/DSC03687.JPG,char_data/T/DSC03687.JPG_7.jpg,312,480,640,13,161,174,295,319,True,29
T,29,kaist_dataset/Mixed/Digital_Camera/(C.S)C-outdoor4/DSC03687.JPG,char_data/T/DSC03687.JPG_8.jpg,522,480,640,18,254,272,292,321,True,29
T,29,kaist_dataset/Mixed/Digital_Camera/(C.S)C-outdoor4/DSC03689.JPG,char_data/T/DSC03689.JPG_2.jpg,464,480,640,16,510,526,131,160,True,29
T,31,kaist_dataset/Mixed/Digital_Camera/(C.S)C-outdoor4/DSC03691.JPG,char_data/T/DSC03691.JPG_2.jpg,558,480,640,18,353,371,225,256,True,29
T,37,kaist_dataset/Mixed/Digital_Camera/(C.S)C-outdoor4/DSC03718.JPG,char_data/T/DSC03718.JPG_6.jpg,518,480,640,14,29,43,252,289,True,29
T,33,kaist_dataset/Mixed/Digital_Camera/(C.S)C-outdoor4/DSC03718.JPG,char_data/T/DSC03718.JPG_8.jpg,759,480,640,23,429,452,403,436,True,29
T,35,kaist_dataset/Mixed/Digital_Camera/(C.S)C-outdoor4/DSC03719.JPG,char_data/T/DSC03719.JPG_6.jpg,630,480,640,18,29,47,24,59,True,29
T,27,kaist_dataset/Mixed/Digital_Camera/(C.S)C-outdoor4/DSC03719.JPG,char_data/T/DSC03719.JPG_8.jpg,567,480,640,21,436,457,184,211,True,29
T,32,kaist_dataset/Mixed/Digital_Camera/(C.S)C-outdoor4/DSC03722.JPG,char_data/T/DSC03722.JPG_2.jpg,832,480,640,26,176,202,202,234,True,29
T,41,kaist_dataset/Mixed/Digital_Camera/(C.S)C-outdoor4/DSC03724.JPG,char_data/T/DSC03724.JPG_2.jpg,1189,480,640,29,311,340,276,317,True,29
T,30,kaist_dataset/Mixed/Digital_Camera/(C.S)C-outdoor4/DSC03734.JPG,char_data/T/DSC03734.JPG_2.jpg,600,480,640,20,475,495,350,380,True,29
T,32,kaist_dataset/Mixed/Digital_Camera/(C.S)C-outdoor4/DSC03735.JPG,char_data/T/DSC03735.JPG_2.jpg,608,480,640,19,429,448,150,182,True,29
T,30,kaist_dataset/Mixed/Digital_Camera/(C.S)C-outdoor4/DSC03737.JPG,char_data/T/DSC03737.JPG_2.jpg,690,480,640,23,118,141,160,190,True,29
T,46,kaist_dataset/Mixed/Digital_Camera/(C.S)C-outdoor4/DSC03738.JPG,char_data/T/DSC03738.JPG_2.jpg,1794,480,640,39,249,288,233,279,True,29
T,34,kaist_dataset/Mixed/Digital_Camera/(C.S)C-outdoor4/DSC03741.JPG,char_data/T/DSC03741.JPG_2.jpg,1224,480,640,36,287,323,363,397,True,29
T,34,kaist_dataset/Mixed/Digital_Camera/(C.S)C-outdoor4/DSC03757.JPG,char_data/T/DSC03757.JPG_2.jpg,612,480,640,18,162,180,336,370,True,29
T,34,kaist_dataset/Mixed/Digital_Camera/(C.S)C-outdoor4/DSC03769.JPG,char_data/T/DSC03769.JPG_2.jpg,510,480,640,15,148,163,416,450,True,29
T,95,kaist_dataset/Mixed/Digital_Camera/(C.S)C-outdoor4/DSC03787.JPG,char_data/T/DSC03787.JPG_2.jpg,3230,480,640,34,314,348,134,229,True,29
T,33,kaist_dataset/Mixed/Digital_Camera/(C.S)C-outdoor5/DSC03829.JPG,char_data/T/DSC03829.JPG_4.jpg,330,480,640,10,364,374,179,212,True,29
T,32,kaist_dataset/Mixed/Digital_Camera/(C.S)C-outdoor5/DSC03829.JPG,char_data/T/DSC03829.JPG_5.jpg,544,480,640,17,372,389,177,209,True,29
T,45,kaist_dataset/Mixed/Digital_Camera/(C.S)C-outdoor5/DSC03839.JPG,char_data/T/DSC03839.JPG_8.jpg,945,480,640,21,202,223,358,403,True,29
T,69,kaist_dataset/Mixed/Digital_Camera/(C.S)C-outdoor5/DSC03867.JPG,char_data/T/DSC03867.JPG_2.jpg,2553,480,640,37,342,379,299,368,True,29
T,72,kaist_dataset/Mixed/Digital_Camera/(C.S)C-outdoor5/DSC04016.JPG,char_data/T/DSC04016.JPG_4.jpg,4104,480,640,57,98,155,110,182,True,29
T,70,kaist_dataset/Mixed/Digital_Camera/(C.S)C-outdoor5/DSC04016.JPG,char_data/T/DSC04016.JPG_5.jpg,3780,480,640,54,98,152,317,387,True,29
T,50,kaist_dataset/Mixed/Digital_Camera/(C.S)C-outdoor5/DSC04017.JPG,char_data/T/DSC04017.JPG_2.jpg,2100,480,640,42,151,193,428,478,True,29
T,24,kaist_dataset/Mixed/Digital_Camera/(C.S)C-outdoor5/DSC04031.JPG,char_data/T/DSC04031.JPG_2.jpg,384,480,640,16,108,124,382,406,True,29
T,61,kaist_dataset/Mixed/Digital_Camera/(C.S)C-outdoor5/DSC04033.JPG,char_data/T/DSC04033.JPG_2.jpg,3233,480,640,53,32,85,285,346,True,29
T,66,kaist_dataset/Mixed/Digital_Camera/(C.S)C-outdoor5/DSC04059.JPG,char_data/T/DSC04059.JPG_2.jpg,1716,480,640,26,516,542,114,180,True,29
T,56,kaist_dataset/Mixed/Digital_Camera/(C.S)C-outdoor5/DSC04060.JPG,char_data/T/DSC04060.JPG_8.jpg,2016,480,640,36,182,218,179,235,True,29
T,56,kaist_dataset/Mixed/Digital_Camera/(C.S)C-outdoor5/DSC04060.JPG,char_data/T/DSC04060.JPG_9.jpg,1680,480,640,30,283,313,177,233,True,29
T,52,kaist_dataset/Mixed/Digital_Camera/(C.S)C-outdoor5/DSC04060.JPG,char_data/T/DSC04060.JPG_10.jpg,1612,480,640,31,386,417,179,231,True,29
T,62,kaist_dataset/Mixed/Digital_Camera/(C.S)C-outdoor5/DSC04060.JPG,char_data/T/DSC04060.JPG_11.jpg,2232,480,640,36,266,302,97,159,True,29
T,35,kaist_dataset/Mixed/Digital_Camera/(C.S)C-outdoor5/DSC04070.JPG,char_data/T/DSC04070.JPG_5.jpg,700,480,640,20,286,306,106,141,True,29
T,42,kaist_dataset/Mixed/Digital_Camera/(C.S)C-outdoor5/DSC04071.JPG,char_data/T/DSC04071.JPG_2.jpg,1386,480,640,33,56,89,360,402,True,29
T,27,kaist_dataset/Mixed/Digital_Camera/(C.S)C-outdoor5/DSC04086.JPG,char_data/T/DSC04086.JPG_2.jpg,513,480,640,19,340,359,369,396,True,29
T,54,kaist_dataset/Mixed/Digital_Camera/(C.S)C-outdoor5/DSC04094.JPG,char_data/T/DSC04094.JPG_2.jpg,2538,480,640,47,138,185,381,435,True,29
T,34,kaist_dataset/Mixed/Digital_Camera/(C.S)C-outdoor5/DSC04098.JPG,char_data/T/DSC04098.JPG_2.jpg,850,480,640,25,399,424,310,344,True,29
T,44,kaist_dataset/Mixed/Digital_Camera/(C.S)C-outdoor5/DSC04104.JPG,char_data/T/DSC04104.JPG_8.jpg,1672,480,640,38,357,395,37,81,True,29
T,66,kaist_dataset/Mixed/Digital_Camera/(C.S)C-outdoor5/DSC04108.JPG,char_data/T/DSC04108.JPG_2.jpg,2112,480,640,32,278,310,237,303,True,29
T,32,kaist_dataset/Mixed/Digital_Camera/(C.S)C-outdoor5/DSC04124.JPG,char_data/T/DSC04124.JPG_2.jpg,576,480,640,18,380,398,307,339,True,29
T,41,kaist_dataset/Mixed/Digital_Camera/(C.S)C-outdoor5/DSC04135.JPG,char_data/T/DSC04135.JPG_2.jpg,1271,480,640,31,357,388,385,426,True,29
T,43,kaist_dataset/Mixed/Digital_Camera/(C.S)C-outdoor5/DSC04140.JPG,char_data/T/DSC04140.JPG_2.jpg,688,480,640,16,484,500,346,389,True,29
T,38,kaist_dataset/Mixed/Digital_Camera/(C.S)C-outdoor5/DSC04144.JPG,char_data/T/DSC04144.JPG_2.jpg,1102,480,640,29,195,224,416,454,True,29
T,33,kaist_dataset/Mixed/Digital_Camera/(C.S)C-outdoor5/DSC04146.JPG,char_data/T/DSC04146.JPG_2.jpg,792,480,640,24,231,255,404,437,True,29
T,28,kaist_dataset/Mixed/Digital_Camera/(C.S)C-outdoor5/DSC04150.JPG,char_data/T/DSC04150.JPG_2.jpg,644,480,640,23,466,489,366,394,True,29
T,90,kaist_dataset/Mixed/Digital_Camera/(C.S)C-outdoor5/DSC04151.JPG,char_data/T/DSC04151.JPG_2.jpg,8190,480,640,91,488,579,249,339,True,29
T,33,kaist_dataset/Mixed/Digital_Camera/(C.S)C-outdoor5/DSC04155.JPG,char_data/T/DSC04155.JPG_2.jpg,693,480,640,21,455,476,263,296,False,29
T,39,kaist_dataset/Mixed/Digital_Camera/(C.S)C-outdoor5/DSC04314.JPG,char_data/T/DSC04314.JPG_2.jpg,780,480,640,20,450,470,168,207,False,29
T,41,kaist_dataset/Mixed/Digital_Camera/(C.S)C-outdoor5/DSC04337.JPG,char_data/T/DSC04337.JPG_2.jpg,1230,480,640,30,279,309,317,358,False,29
T,25,kaist_dataset/Mixed/Digital_Camera/(C.S)C-outdoor5/DSC04357.JPG,char_data/T/DSC04357.JPG_7.jpg,275,480,640,11,266,277,352,377,False,29
T,70,kaist_dataset/Mixed/Digital_Camera/(C.S)C-outdoor5/DSC04364.JPG,char_data/T/DSC04364.JPG_2.jpg,3080,480,640,44,84,128,387,457,False,29
T,38,kaist_dataset/Mixed/Digital_Camera/(C.S)C-outdoor5/DSC04434.JPG,char_data/T/DSC04434.JPG_2.jpg,836,480,640,22,291,313,386,424,False,29
T,110,kaist_dataset/Mixed/Digital_Camera/(C.S)C-outdoor5/DSC04449.JPG,char_data/T/DSC04449.JPG_2.jpg,6160,480,640,56,6,62,43,153,False,29
T,68,kaist_dataset/Mixed/Digital_Camera/(C.S)C-outdoor5/DSC04450.JPG,char_data/T/DSC04450.JPG_4.jpg,2108,480,640,31,221,252,50,118,False,29
T,68,kaist_dataset/Mixed/Digital_Camera/(C.S)C-outdoor5/DSC04450.JPG,char_data/T/DSC04450.JPG_5.jpg,2380,480,640,35,216,251,260,328,False,29
T,129,kaist_dataset/Mixed/Digital_Camera/(C.S)C-outdoor5/DSC04465.JPG,char_data/T/DSC04465.JPG_4.jpg,10836,480,640,84,192,276,268,397,False,29
T,114,kaist_dataset/Mixed/Digital_Camera/(C.S)C-outdoor5/DSC04465.JPG,char_data/T/DSC04465.JPG_5.jpg,8550,480,640,75,273,348,278,392,False,29
T,38,kaist_dataset/Mixed/Digital_Camera/(C.S)C-outdoor5/P1010002.JPG,char_data/T/P1010002.JPG_2.jpg,1292,480,640,34,356,390,280,318,False,29
T,43,kaist_dataset/Mixed/Digital_Camera/(C.S)C-outdoor5/P1010007.JPG,char_data/T/P1010007.JPG_2.jpg,1290,480,640,30,174,204,270,313,False,29
T,70,kaist_dataset/Mixed/Digital_Camera/(C.S)C-outdoor6/117.JPG,char_data/T/117.JPG_4.jpg,4970,480,640,71,343,414,177,247,False,29
T,20,kaist_dataset/Mixed/Digital_Camera/(C.S)C-outdoor6/117.JPG,char_data/T/117.JPG_5.jpg,300,480,640,15,237,252,267,287,False,29
T,71,kaist_dataset/Mixed/Digital_Camera/(C.S)C-outdoor6/P1010017.JPG,char_data/T/P1010017.JPG_2.jpg,2414,480,640,34,203,237,173,244,False,29
T,40,kaist_dataset/Mixed/Digital_Camera/(C.S)C-outdoor6/P1010018.JPG,char_data/T/P1010018.JPG_2.jpg,1160,480,640,29,92,121,241,281,False,29
T,31,kaist_dataset/Mixed/Digital_Camera/(C.S)C-outdoor6/P1010020.JPG,char_data/T/P1010020.JPG_2.jpg,682,480,640,22,80,102,333,364,False,29
T,43,kaist_dataset/Mixed/Digital_Camera/(C.S)C-outdoor6/P1010021.JPG,char_data/T/P1010021.JPG_2.jpg,1376,480,640,32,23,55,213,256,False,29
T,111,kaist_dataset/Mixed/Digital_Camera/(C.S)C-outdoor6/P1010054.JPG,char_data/T/P1010054.JPG_2.jpg,8547,480,640,77,292,369,99,210,False,29
T,34,kaist_dataset/Mixed/Digital_Camera/(C.S)C-outdoor6/P1010056.JPG,char_data/T/P1010056.JPG_2.jpg,748,480,640,22,269,291,229,263,False,29
T,23,kaist_dataset/Mixed/Digital_Camera/(C.S)C-outdoor6/P1010065.JPG,char_data/T/P1010065.JPG_6.jpg,437,480,640,19,191,210,232,255,False,29
T,23,kaist_dataset/Mixed/Digital_Camera/(C.S)C-outdoor6/P1010065.JPG,char_data/T/P1010065.JPG_7.jpg,276,480,640,12,175,187,106,129,False,29
T,24,kaist_dataset/Mixed/Digital_Camera/(C.S)C-outdoor6/P1010065.JPG,char_data/T/P1010065.JPG_8.jpg,384,480,640,16,249,265,109,133,False,29
T,61,kaist_dataset/Mixed/Digital_Camera/(C.S)C-outdoor6/P1010067.JPG,char_data/T/P1010067.JPG_2.jpg,2684,480,640,44,289,333,306,367,False,29
T,43,kaist_dataset/Mixed/Digital_Camera/(C.S)C-outdoor6/P1010073.JPG,char_data/T/P1010073.JPG_2.jpg,774,480,640,18,302,320,232,275,False,29
T,46,kaist_dataset/Mixed/Digital_Camera/(C.S)C-outdoor6/P1010074.JPG,char_data/T/P1010074.JPG_2.jpg,1978,480,640,43,95,138,303,349,False,29
T,35,kaist_dataset/Mixed/Digital_Camera/(C.S)C-outdoor6/P1010075.JPG,char_data/T/P1010075.JPG_2.jpg,560,480,640,16,388,404,306,341,False,29
T,37,kaist_dataset/Mixed/Digital_Camera/(C.S)C-outdoor6/P1010080.JPG,char_data/T/P1010080.JPG_2.jpg,1258,480,640,34,313,347,245,282,False,29
T,30,kaist_dataset/Mixed/Digital_Camera/(C.S)C-outdoor6/P1010082.JPG,char_data/T/P1010082.JPG_2.jpg,540,480,640,18,117,135,230,260,False,29
T,51,kaist_dataset/Mixed/Digital_Camera/(C.S)C-outdoor6/P1010084.JPG,char_data/T/P1010084.JPG_2.jpg,2244,480,640,44,237,281,188,239,False,29
T,51,kaist_dataset/Mixed/Digital_Camera/(C.S)C-outdoor6/P1010087.JPG,char_data/T/P1010087.JPG_2.jpg,2958,480,640,58,151,209,180,231,False,29
T,33,kaist_dataset/Mixed/Digital_Camera/(C.S)C-outdoor6/P1010088.JPG,char_data/T/P1010088.JPG_2.jpg,693,480,640,21,241,262,219,252,False,29
T,38,kaist_dataset/Mixed/Digital_Camera/(C.S)C-outdoor6/P1010090.JPG,char_data/T/P1010090.JPG_2.jpg,646,480,640,17,378,395,197,235,False,29
T,37,kaist_dataset/Mixed/Digital_Camera/(C.S)C-outdoor6/P1010093.JPG,char_data/T/P1010093.JPG_5.jpg,814,480,640,22,468,490,241,278,False,29
T,24,kaist_dataset/Mixed/Digital_Camera/(C.S)C-outdoor6/P1010094.JPG,char_data/T/P1010094.JPG_2.jpg,624,480,640,26,423,449,217,241,False,29
T,33,kaist_dataset/Mixed/Digital_Camera/(C.S)C-outdoor6/P1010097.JPG,char_data/T/P1010097.JPG_2.jpg,957,480,640,29,371,400,187,220,False,29
T,43,kaist_dataset/Mixed/Digital_Camera/(C.S)C-outdoor6/P1010098.JPG,char_data/T/P1010098.JPG_2.jpg,1161,480,640,27,345,372,53,96,False,29
T,39,kaist_dataset/Mixed/Digital_Camera/(C.S)C-outdoor6/P1010103.JPG,char_data/T/P1010103.JPG_2.jpg,1248,480,640,32,425,457,201,240,False,29
T,46,kaist_dataset/Mixed/Digital_Camera/(C.S)C-outdoor6/P1010120.JPG,char_data/T/P1010120.JPG_2.jpg,1748,480,640,38,252,290,189,235,False,29
T,29,kaist_dataset/Mixed/Digital_Camera/(C.S)C-outdoor6/P1010129.JPG,char_data/T/P1010129.JPG_2.jpg,754,480,640,26,333,359,233,262,False,29
T,37,kaist_dataset/Mixed/Digital_Camera/(C.S)C-outdoor6/P1010132.JPG,char_data/T/P1010132.JPG_2.jpg,1147,480,640,31,500,531,155,192,False,29
T,34,kaist_dataset/Mixed/Digital_Camera/(C.S)C-outdoor6/크기변환_fadscf0009_creawell.jpg,char_data/T/크기변환_fadscf0009_creawell.jpg_2.jpg,816,480,640,24,206,230,151,185,False,29
T,47,kaist_dataset/Mixed/Digital_Camera/(C.S)D-indoor1/DSC02713.JPG,char_data/T/DSC02713.JPG_2.jpg,1692,480,640,36,140,176,149,196,False,29
T,42,kaist_dataset/Mixed/Digital_Camera/(C.S)D-indoor1/DSC02714.JPG,char_data/T/DSC02714.JPG_4.jpg,1428,480,640,34,341,375,74,116,False,29
T,71,kaist_dataset/Mixed/Digital_Camera/(C.S)D-indoor1/DSC02714.JPG,char_data/T/DSC02714.JPG_5.jpg,5751,480,640,81,401,482,118,189,False,29
T,63,kaist_dataset/Mixed/Digital_Camera/(C.S)D-indoor1/DSC02733.JPG,char_data/T/DSC02733.JPG_2.jpg,3402,480,640,54,155,209,396,459,False,29
T,101,kaist_dataset/Mixed/Digital_Camera/(C.S)D-indoor1/DSC02739.JPG,char_data/T/DSC02739.JPG_2.jpg,8282,480,640,82,123,205,43,144,False,29
T,45,kaist_dataset/Mixed/Digital_Camera/(C.S)D-indoor1/DSC02787.JPG,char_data/T/DSC02787.JPG_6.jpg,1035,480,640,23,45,68,382,427,False,29
T,109,kaist_dataset/Mixed/Digital_Camera/(C.S)D-indoor1/DSC02840.JPG,char_data/T/DSC02840.JPG_2.jpg,12971,480,640,119,63,182,118,227,False,29
T,47,kaist_dataset/Mixed/Digital_Camera/(C.S)D-indoor1/DSC03118.JPG,char_data/T/DSC03118.JPG_6.jpg,1222,480,640,26,291,317,146,193,False,29
T,47,kaist_dataset/Mixed/Digital_Camera/(C.S)D-indoor1/DSC03132.JPG,char_data/T/DSC03132.JPG_4.jpg,1457,480,640,31,137,168,168,215,False,29
T,49,kaist_dataset/Mixed/Digital_Camera/(C.S)D-indoor1/DSC03372.JPG,char_data/T/DSC03372.JPG_2.jpg,1960,480,640,40,599,639,392,441,False,29
T,85,kaist_dataset/Mixed/Digital_Camera/(C.S)D-indoor1/DSC03472.JPG,char_data/T/DSC03472.JPG_4.jpg,3910,480,640,46,197,243,22,107,False,29
T,84,kaist_dataset/Mixed/Digital_Camera/(C.S)D-indoor1/DSC03472.JPG,char_data/T/DSC03472.JPG_5.jpg,3948,480,640,47,408,455,21,105,False,29
T,53,kaist_dataset/Mixed/Digital_Camera/(C.S)D-indoor1/DSC03479.JPG,char_data/T/DSC03479.JPG_2.jpg,2279,480,640,43,229,272,259,312,False,29
T,39,kaist_dataset/Mixed/Digital_Camera/(C.S)D-indoor1/DSC03483.JPG,char_data/T/DSC03483.JPG_2.jpg,975,480,640,25,377,402,372,411,False,29
T,106,kaist_dataset/Mixed/Digital_Camera/(C.S)D-indoor1/DSC03890.JPG,char_data/T/DSC03890.JPG_4.jpg,7208,480,640,68,368,436,237,343,False,29
T,101,kaist_dataset/Mixed/Digital_Camera/(C.S)D-indoor1/DSC03890.JPG,char_data/T/DSC03890.JPG_5.jpg,7373,480,640,73,438,511,238,339,False,29
T,45,kaist_dataset/Mixed/Digital_Camera/(C.S)D-indoor1/DSC03980.JPG,char_data/T/DSC03980.JPG_4.jpg,810,480,640,18,536,554,143,188,False,29
T,48,kaist_dataset/Mixed/Digital_Camera/(C.S)D-indoor1/DSC03980.JPG,char_data/T/DSC03980.JPG_5.jpg,1968,480,640,41,191,232,301,349,False,29
T,26,kaist_dataset/Mixed/Digital_Camera/(C.S)D-indoor1/DSC04005.JPG,char_data/T/DSC04005.JPG_2.jpg,572,480,640,22,214,236,442,468,False,29
T,56,kaist_dataset/Mixed/Digital_Camera/(C.S)D-indoor1/DSC04198.JPG,char_data/T/DSC04198.JPG_2.jpg,2240,480,640,40,302,342,82,138,False,29
T,42,kaist_dataset/Mixed/Digital_Camera/(C.S)D-indoor1/DSC04203.JPG,char_data/T/DSC04203.JPG_2.jpg,756,480,640,18,94,112,287,329,False,29
T,50,kaist_dataset/Mixed/Digital_Camera/(C.S)D-indoor1/DSC04206.JPG,char_data/T/DSC04206.JPG_4.jpg,1250,480,640,25,131,156,276,326,False,29
T,45,kaist_dataset/Mixed/Digital_Camera/(C.S)D-indoor2/DSC04256.JPG,char_data/T/DSC04256.JPG_2.jpg,1170,480,640,26,455,481,100,145,False,29
T,73,kaist_dataset/Mixed/Digital_Camera/(C.S)D-indoor2/크기변환_P1010030.JPG,char_data/T/크기변환_P1010030.JPG_2.jpg,4015,480,640,55,514,569,129,202,False,29
T,42,kaist_dataset/Mixed/Digital_Camera/(C.S)E-night/DSC02569.JPG,char_data/T/DSC02569.JPG_8.jpg,798,480,640,19,190,209,412,454,False,29
T,53,kaist_dataset/Mixed/Digital_Camera/(C.S)E-night/DSC02573.JPG,char_data/T/DSC02573.JPG_2.jpg,1855,480,640,35,257,292,187,240,False,29
T,52,kaist_dataset/Mixed/Digital_Camera/(C.S)E-night/DSC02575.JPG,char_data/T/DSC02575.JPG_2.jpg,2444,480,640,47,210,257,352,404,False,29
T,34,kaist_dataset/Mixed/Digital_Camera/(C.S)E-night/DSC02644.JPG,char_data/T/DSC02644.JPG_2.jpg,748,480,640,22,267,289,402,436,False,29
T,35,kaist_dataset/Mixed/Digital_Camera/(C.S)E-night/DSC02647.JPG,char_data/T/DSC02647.JPG_2.jpg,945,480,640,27,109,136,296,331,False,29
T,40,kaist_dataset/Mixed/Digital_Camera/(C.S)E-night/DSC02673.JPG,char_data/T/DSC02673.JPG_2.jpg,480,480,640,12,245,257,306,346,False,29
T,36,kaist_dataset/Mixed/Digital_Camera/(C.S)E-night/DSC02678.JPG,char_data/T/DSC02678.JPG_2.jpg,720,480,640,20,345,365,395,431,False,29
T,38,kaist_dataset/Mixed/Digital_Camera/(C.S)E-night/DSC02903.JPG,char_data/T/DSC02903.JPG_2.jpg,1064,480,640,28,234,262,262,300,False,29
T,73,kaist_dataset/Mixed/Digital_Camera/(C.S)E-night/DSC03031.JPG,char_data/T/DSC03031.JPG_4.jpg,3504,480,640,48,84,132,64,137,False,29
T,71,kaist_dataset/Mixed/Digital_Camera/(C.S)E-night/DSC03031.JPG,char_data/T/DSC03031.JPG_5.jpg,3195,480,640,45,263,308,72,143,False,29
T,63,kaist_dataset/Mixed/Digital_Camera/(C.S)E-night/DSC03517.JPG,char_data/T/DSC03517.JPG_2.jpg,1827,480,640,29,501,530,188,251,False,29
T,53,kaist_dataset/Mixed/Digital_Camera/(C.S)E-night/DSC03561.JPG,char_data/T/DSC03561.JPG_2.jpg,2279,480,640,43,156,199,251,304,False,29
T,27,kaist_dataset/Mixed/Digital_Camera/(C.S)E-night/DSC03840.JPG,char_data/T/DSC03840.JPG_2.jpg,513,480,640,19,408,427,204,231,False,29
T,39,kaist_dataset/Mixed/Digital_Camera/(C.S)E-night/DSC03871.JPG,char_data/T/DSC03871.JPG_4.jpg,1053,480,640,27,378,405,185,224,False,29
T,33,kaist_dataset/Mixed/Digital_Camera/(C.S)E-night/DSC03871.JPG,char_data/T/DSC03871.JPG_5.jpg,759,480,640,23,523,546,194,227,False,29
T,57,kaist_dataset/Mixed/Digital_Camera/(C.S)E-night/P1010147.JPG,char_data/T/P1010147.JPG_2.jpg,2736,480,640,48,123,171,257,314,False,29
T,69,kaist_dataset/Mixed/Digital_Camera/(C.S)E-night/P1010152.JPG,char_data/T/P1010152.JPG_2.jpg,3933,480,640,57,113,170,228,297,False,29
T,31,kaist_dataset/Mixed/Digital_Camera/(C.S)E-night/P1010155.JPG,char_data/T/P1010155.JPG_2.jpg,620,480,640,20,399,419,280,311,False,29
T,32,kaist_dataset/Mixed/Digital_Camera/(C.S)E-night/P1010156.JPG,char_data/T/P1010156.JPG_2.jpg,992,480,640,31,263,294,241,273,False,29
T,44,kaist_dataset/Mixed/Digital_Camera/(C.S)E-night/사진9.jpg수정.jpg,char_data/T/사진9.jpg수정.jpg_2.jpg,1584,480,680,36,307,343,250,294,False,29
T,27,kaist_dataset/Mixed/Digital_Camera/(C.S)F-others/097.jpg,char_data/T/097.jpg_4.jpg,351,480,640,13,252,265,167,194,False,29
T,35,kaist_dataset/Mixed/Digital_Camera/(C.S)F-others/097.jpg,char_data/T/097.jpg_5.jpg,350,480,640,10,266,276,162,197,False,29
T,62,kaist_dataset/Mixed/Digital_Camera/(C.S)F-others/2007-12-08-day-113.jpg,char_data/T/2007-12-08-day-113.jpg_6.jpg,2232,1200,1600,36,335,371,252,314,False,29
T,59,kaist_dataset/Mixed/Digital_Camera/(C.S)F-others/2007-12-08-day-113.jpg,char_data/T/2007-12-08-day-113.jpg_7.jpg,1888,1200,1600,32,514,546,304,363,False,29
T,49,kaist_dataset/Mixed/Digital_Camera/(C.S)F-others/2007-12-08-day-113.jpg,char_data/T/2007-12-08-day-113.jpg_8.jpg,1666,1200,1600,34,735,769,369,418,False,29
T,56,kaist_dataset/Mixed/Digital_Camera/(C.S)F-others/2007-12-09-day-exterior-023.jpg,char_data/T/2007-12-09-day-exterior-023.jpg_2.jpg,2632,1200,1600,47,784,831,571,627,False,29
T,108,kaist_dataset/Mixed/Digital_Camera/(C.S)F-others/DSC02504.JPG,char_data/T/DSC02504.JPG_8.jpg,13392,480,640,124,380,504,220,328,False,29
T,43,kaist_dataset/Mixed/Digital_Camera/(C.S)F-others/DSC02504.JPG,char_data/T/DSC02504.JPG_9.jpg,1505,480,640,35,101,136,305,348,False,29
T,39,kaist_dataset/Mixed/Digital_Camera/(C.S)F-others/DSC02504.JPG,char_data/T/DSC02504.JPG_10.jpg,897,480,640,23,350,373,315,354,False,29
T,38,kaist_dataset/Mixed/Digital_Camera/(C.S)F-others/DSC02504.JPG,char_data/T/DSC02504.JPG_11.jpg,1254,480,640,33,502,535,350,388,False,29
T,31,kaist_dataset/Mixed/Digital_Camera/(C.S)F-others/DSC02609.JPG,char_data/T/DSC02609.JPG_10.jpg,713,480,640,23,228,251,312,343,False,29
T,48,kaist_dataset/Mixed/Digital_Camera/(C.S)F-others/DSC02893.JPG,char_data/T/DSC02893.JPG_2.jpg,1920,480,640,40,213,253,346,394,False,29
T,32,kaist_dataset/Mixed/Mobile_Phone/(C.M)A-outdoor/P090908006.jpg,char_data/T/P090908006.jpg_2.jpg,800,480,640,25,246,271,369,401,False,29
T,33,kaist_dataset/Mixed/Mobile_Phone/(C.M)A-outdoor/P090912036.jpg,char_data/T/P090912036.jpg_2.jpg,792,480,640,24,133,157,190,223,False,29
T,25,kaist_dataset/Mixed/Mobile_Phone/(C.M)A-outdoor/P090912040.jpg,char_data/T/P090912040.jpg_2.jpg,750,480,640,30,93,123,190,215,False,29
T,39,kaist_dataset/Mixed/Mobile_Phone/(C.M)A-outdoor/P090912047.jpg,char_data/T/P090912047.jpg_2.jpg,1053,480,640,27,199,226,281,320,False,29
T,59,kaist_dataset/Mixed/Mobile_Phone/(C.M)B-indoor/P090831015.jpg,char_data/T/P090831015.jpg_4.jpg,2714,480,640,46,109,155,200,259,False,29
T,39,kaist_dataset/Mixed/Mobile_Phone/(C.M)B-indoor/P090831021.jpg,char_data/T/P090831021.jpg_4.jpg,858,480,640,22,315,337,42,81,False,29
T,45,kaist_dataset/Mixed/Mobile_Phone/(C.M)B-indoor/P090831021.jpg,char_data/T/P090831021.jpg_5.jpg,1080,480,640,24,187,211,377,422,False,29
T,79,kaist_dataset/Mixed/Mobile_Phone/(C.M)C-bookCover/P090831114.jpg,char_data/T/P090831114.jpg_2.jpg,4266,480,640,54,320,374,241,320,False,29
T,98,kaist_dataset/Mixed/Mobile_Phone/(C.M)C-bookCover/P090831136.jpg,char_data/T/P090831136.jpg_4.jpg,6958,480,640,71,401,472,225,323,False,29
T,106,kaist_dataset/Mixed/Mobile_Phone/(C.M)C-bookCover/P090831136.jpg,char_data/T/P090831136.jpg_5.jpg,9434,480,640,89,303,392,118,224,False,29
T,98,kaist_dataset/Mixed/Mobile_Phone/(C.M)C-bookCover/P090905002.jpg,char_data/T/P090905002.jpg_2.jpg,4998,480,640,51,284,335,31,129,False,29
E,109,kaist_dataset/English/Digital_Camera/(E.S)A-shadow/DSC02317.JPG,char_data/E/DSC02317.JPG_2.jpg,6322,480,640,58,218,276,228,337,True,16
E,118,kaist_dataset/English/Digital_Camera/(E.S)A-shadow/DSC02629.JPG,char_data/E/DSC02629.JPG_6.jpg,7906,480,640,67,130,197,303,421,True,16
E,93,kaist_dataset/English/Digital_Camera/(E.S)A-shadow/DSC02629.JPG,char_data/E/DSC02629.JPG_7.jpg,5208,480,640,56,478,534,304,397,True,16
E,88,kaist_dataset/English/Digital_Camera/(E.S)A-shadow/DSC02629.JPG,char_data/E/DSC02629.JPG_8.jpg,5368,480,640,61,532,593,306,394,True,16
E,97,kaist_dataset/English/Digital_Camera/(E.S)A-shadow/DSC02633.JPG,char_data/E/DSC02633.JPG_4.jpg,6208,480,640,64,202,266,179,276,True,16
E,94,kaist_dataset/English/Digital_Camera/(E.S)A-shadow/DSC02633.JPG,char_data/E/DSC02633.JPG_5.jpg,4982,480,640,53,555,608,185,279,True,16
E,83,kaist_dataset/English/Digital_Camera/(E.S)A-shadow/DSC03084.JPG,char_data/E/DSC03084.JPG_6.jpg,3735,480,640,45,55,100,342,425,True,16
E,46,kaist_dataset/English/Digital_Camera/(E.S)A-shadow/P1010044.JPG,char_data/E/P1010044.JPG_10.jpg,1426,480,640,31,54,85,353,399,True,16
E,41,kaist_dataset/English/Digital_Camera/(E.S)A-shadow/P1010044.JPG,char_data/E/P1010044.JPG_11.jpg,1230,480,640,30,114,144,353,394,True,16
E,45,kaist_dataset/English/Digital_Camera/(E.S)A-shadow/P1010044.JPG,char_data/E/P1010044.JPG_12.jpg,1170,480,640,26,319,345,352,397,True,16
E,36,kaist_dataset/English/Digital_Camera/(E.S)A-shadow/P1010044.JPG,char_data/E/P1010044.JPG_13.jpg,972,480,640,27,307,334,121,157,True,16
E,35,kaist_dataset/English/Digital_Camera/(E.S)A-shadow/P1010044.JPG,char_data/E/P1010044.JPG_14.jpg,945,480,640,27,307,334,184,219,True,16
E,126,kaist_dataset/English/Digital_Camera/(E.S)B-light/080116-0053.jpg,char_data/E/080116-0053.jpg_4.jpg,9450,600,800,75,114,189,211,337,True,16
E,112,kaist_dataset/English/Digital_Camera/(E.S)B-light/080116-0053.jpg,char_data/E/080116-0053.jpg_5.jpg,7952,600,800,71,670,741,220,332,True,16
E,175,kaist_dataset/English/Digital_Camera/(E.S)B-light/080116-0059.jpg,char_data/E/080116-0059.jpg_24.jpg,16100,1200,1600,92,777,869,317,492,True,16
E,37,kaist_dataset/English/Digital_Camera/(E.S)B-light/080116-0059.jpg,char_data/E/080116-0059.jpg_25.jpg,518,1200,1600,14,474,488,825,862,True,16
E,31,kaist_dataset/English/Digital_Camera/(E.S)B-light/080116-0059.jpg,char_data/E/080116-0059.jpg_26.jpg,372,1200,1600,12,1144,1156,821,852,True,16
E,36,kaist_dataset/English/Digital_Camera/(E.S)B-light/080116-0059.jpg,char_data/E/080116-0059.jpg_27.jpg,504,1200,1600,14,787,801,824,860,True,16
E,32,kaist_dataset/English/Digital_Camera/(E.S)B-light/080116-0059.jpg,char_data/E/080116-0059.jpg_28.jpg,352,1200,1600,11,831,842,826,858,True,16
E,28,kaist_dataset/English/Digital_Camera/(E.S)B-light/080116-0059.jpg,char_data/E/080116-0059.jpg_29.jpg,336,1200,1600,12,842,854,826,854,True,16
E,29,kaist_dataset/English/Digital_Camera/(E.S)B-light/080116-0059.jpg,char_data/E/080116-0059.jpg_30.jpg,580,1200,1600,20,686,706,827,856,True,16
E,29,kaist_dataset/English/Digital_Camera/(E.S)B-light/080116-0059.jpg,char_data/E/080116-0059.jpg_31.jpg,406,1200,1600,14,801,815,798,827,True,16
E,39,kaist_dataset/English/Digital_Camera/(E.S)B-light/080116-0059.jpg,char_data/E/080116-0059.jpg_32.jpg,819,1200,1600,21,882,903,767,806,True,16
E,30,kaist_dataset/English/Digital_Camera/(E.S)B-light/080116-0059.jpg,char_data/E/080116-0059.jpg_33.jpg,390,1200,1600,13,959,972,770,800,True,16
E,29,kaist_dataset/English/Digital_Camera/(E.S)B-light/080116-0059.jpg,char_data/E/080116-0059.jpg_34.jpg,377,1200,1600,13,986,999,772,801,True,16
E,33,kaist_dataset/English/Digital_Camera/(E.S)B-light/080116-0059.jpg,char_data/E/080116-0059.jpg_35.jpg,429,1200,1600,13,1148,1161,768,801,True,16
E,76,kaist_dataset/English/Digital_Camera/(E.S)B-light/DSC04200.JPG,char_data/E/DSC04200.JPG_4.jpg,4408,480,640,58,114,172,266,342,True,16
E,66,kaist_dataset/English/Digital_Camera/(E.S)B-light/DSC04200.JPG,char_data/E/DSC04200.JPG_5.jpg,2640,480,640,40,227,267,272,338,True,16
E,23,kaist_dataset/English/Digital_Camera/(E.S)B-light/x.jpg,char_data/E/x.jpg_2.jpg,253,240,320,11,157,168,109,132,True,16
E,46,kaist_dataset/English/Digital_Camera/(E.S)C-outdoor1/001.jpg,char_data/E/001.jpg_10.jpg,1150,257,470,25,256,281,20,66,True,16
E,45,kaist_dataset/English/Digital_Camera/(E.S)C-outdoor1/004.jpg,char_data/E/004.jpg_2.jpg,1755,269,413,39,169,208,34,79,True,16
E,60,kaist_dataset/English/Digital_Camera/(E.S)C-outdoor1/026.JPG,char_data/E/026.JPG_6.jpg,2340,480,640,39,206,245,205,265,True,16
E,57,kaist_dataset/English/Digital_Camera/(E.S)C-outdoor1/026.JPG,char_data/E/026.JPG_7.jpg,1767,480,640,31,283,314,204,261,True,16
E,59,kaist_dataset/English/Digital_Camera/(E.S)C-outdoor1/026.JPG,char_data/E/026.JPG_8.jpg,2301,480,640,39,362,401,203,262,True,16
E,105,kaist_dataset/English/Digital_Camera/(E.S)C-outdoor1/029.jpg,char_data/E/029.jpg_2.jpg,10080,250,472,96,358,454,54,159,True,16
E,58,kaist_dataset/English/Digital_Camera/(E.S)C-outdoor1/031.JPG,char_data/E/031.JPG_8.jpg,2610,480,640,45,274,319,190,248,True,16
E,25,kaist_dataset/English/Digital_Camera/(E.S)C-outdoor1/031.JPG,char_data/E/031.JPG_9.jpg,325,480,640,13,131,144,317,342,True,16
E,21,kaist_dataset/English/Digital_Camera/(E.S)C-outdoor1/031.JPG,char_data/E/031.JPG_10.jpg,252,480,640,12,524,536,320,341,True,16
E,38,kaist_dataset/English/Digital_Camera/(E.S)C-outdoor1/041.JPG,char_data/E/041.JPG_4.jpg,1026,480,640,27,369,396,248,286,True,16
E,36,kaist_dataset/English/Digital_Camera/(E.S)C-outdoor1/041.JPG,char_data/E/041.JPG_5.jpg,972,480,640,27,443,470,249,285,True,16
E,75,kaist_dataset/English/Digital_Camera/(E.S)C-outdoor1/050.JPG,char_data/E/050.JPG_2.jpg,4950,480,640,66,343,409,187,262,True,16
E,18,kaist_dataset/English/Digital_Camera/(E.S)C-outdoor1/061.jpg,char_data/E/061.jpg_4.jpg,378,219,323,21,132,153,86,104,True,16
E,24,kaist_dataset/English/Digital_Camera/(E.S)C-outdoor1/061.jpg,char_data/E/061.jpg_5.jpg,384,219,323,16,135,151,66,90,True,16
E,53,kaist_dataset/English/Digital_Camera/(E.S)C-outdoor1/064.JPG,char_data/E/064.JPG_4.jpg,1325,480,640,25,448,473,186,239,True,16
E,47,kaist_dataset/English/Digital_Camera/(E.S)C-outdoor1/064.JPG,char_data/E/064.JPG_5.jpg,1175,480,640,25,522,547,188,235,True,16
E,25,kaist_dataset/English/Digital_Camera/(E.S)C-outdoor1/077.JPG,char_data/E/077.JPG_13.jpg,350,480,640,14,339,353,249,274,True,16
E,23,kaist_dataset/English/Digital_Camera/(E.S)C-outdoor1/077.JPG,char_data/E/077.JPG_14.jpg,322,480,640,14,375,389,250,273,True,16
E,44,kaist_dataset/English/Digital_Camera/(E.S)C-outdoor1/080116-0065.jpg,char_data/E/080116-0065.jpg_2.jpg,1364,600,800,31,401,432,333,377,True,16
E,65,kaist_dataset/English/Digital_Camera/(E.S)C-outdoor1/080118-0011.jpg,char_data/E/080118-0011.jpg_10.jpg,2990,1200,1600,46,429,475,941,1006,True,16
E,64,kaist_dataset/English/Digital_Camera/(E.S)C-outdoor1/080118-0011.jpg,char_data/E/080118-0011.jpg_11.jpg,3008,1200,1600,47,529,576,941,1005,True,16
E,74,kaist_dataset/English/Digital_Camera/(E.S)C-outdoor1/080118-0011.jpg,char_data/E/080118-0011.jpg_12.jpg,3552,1200,1600,48,879,927,932,1006,True,16
E,70,kaist_dataset/English/Digital_Camera/(E.S)C-outdoor1/080118-0011.jpg,char_data/E/080118-0011.jpg_13.jpg,3570,1200,1600,51,860,911,457,527,True,16
E,68,kaist_dataset/English/Digital_Camera/(E.S)C-outdoor1/080118-0011.jpg,char_data/E/080118-0011.jpg_14.jpg,3536,1200,1600,52,863,915,595,663,True,16
E,314,kaist_dataset/English/Digital_Camera/(E.S)C-outdoor1/080119-0035.jpg,char_data/E/080119-0035.jpg_4.jpg,79756,1200,1600,254,156,410,753,1067,True,16
E,259,kaist_dataset/English/Digital_Camera/(E.S)C-outdoor1/080119-0036.jpg,char_data/E/080119-0036.jpg_4.jpg,47138,1200,1600,182,612,794,309,568,True,16
E,356,kaist_dataset/English/Digital_Camera/(E.S)C-outdoor1/080120-0001.jpg,char_data/E/080120-0001.jpg_2.jpg,139908,1200,1600,393,1103,1496,491,847,True,16
E,89,kaist_dataset/English/Digital_Camera/(E.S)C-outdoor1/083.JPG,char_data/E/083.JPG_2.jpg,6408,480,640,72,398,470,170,259,True,16
E,43,kaist_dataset/English/Digital_Camera/(E.S)C-outdoor1/089.jpg,char_data/E/089.jpg_4.jpg,1032,480,640,24,127,151,296,339,True,16
E,46,kaist_dataset/English/Digital_Camera/(E.S)C-outdoor1/089.jpg,char_data/E/089.jpg_5.jpg,828,480,640,18,331,349,283,329,True,16
E,52,kaist_dataset/English/Digital_Camera/(E.S)C-outdoor1/113.jpg,char_data/E/113.jpg_4.jpg,2080,480,640,40,370,410,168,220,True,16
E,47,kaist_dataset/English/Digital_Camera/(E.S)C-outdoor1/113.jpg,char_data/E/113.jpg_5.jpg,2021,480,640,43,409,452,173,220,True,16
E,60,kaist_dataset/English/Digital_Camera/(E.S)C-outdoor1/139.JPG,char_data/E/139.JPG_2.jpg,2400,480,640,40,271,311,253,313,True,16
E,212,kaist_dataset/English/Digital_Camera/(E.S)C-outdoor1/2007-12-08-day-099.jpg,char_data/E/2007-12-08-day-099.jpg_2.jpg,27136,1200,1600,128,580,708,446,658,True,16
E,207,kaist_dataset/English/Digital_Camera/(E.S)C-outdoor1/2007-12-08-day-117.jpg,char_data/E/2007-12-08-day-117.jpg_2.jpg,32499,1200,1600,157,772,929,508,715,True,16
E,114,kaist_dataset/English/Digital_Camera/(E.S)C-outdoor1/2007-12-09-day-exterior-056.jpg,char_data/E/2007-12-09-day-exterior-056.jpg_6.jpg,7752,1200,1600,68,604,672,507,621,True,16
E,117,kaist_dataset/English/Digital_Camera/(E.S)C-outdoor1/2007-12-09-day-exterior-056.jpg,char_data/E/2007-12-09-day-exterior-056.jpg_7.jpg,7371,1200,1600,63,735,798,507,624,True,16
E,121,kaist_dataset/English/Digital_Camera/(E.S)C-outdoor1/2007-12-09-day-exterior-056.jpg,char_data/E/2007-12-09-day-exterior-056.jpg_8.jpg,8228,1200,1600,68,886,954,505,626,True,16
E,132,kaist_dataset/English/Digital_Camera/(E.S)C-outdoor1/2007-12-09-day-exterior-063.jpg,char_data/E/2007-12-09-day-exterior-063.jpg_8.jpg,12012,1200,1600,91,523,614,397,529,True,16
E,46,kaist_dataset/English/Digital_Camera/(E.S)C-outdoor1/6.jpg,char_data/E/6.jpg_4.jpg,1886,255,731,41,433,474,94,140,True,16
E,47,kaist_dataset/English/Digital_Camera/(E.S)C-outdoor1/6.jpg,char_data/E/6.jpg_5.jpg,1880,255,731,40,548,588,93,140,True,16
E,33,kaist_dataset/English/Digital_Camera/(E.S)C-outdoor1/DSC02345.JPG,char_data/E/DSC02345.JPG_2.jpg,792,480,640,24,257,281,236,269,True,16
E,76,kaist_dataset/English/Digital_Camera/(E.S)C-outdoor1/DSC02356.JPG,char_data/E/DSC02356.JPG_16.jpg,3496,480,640,46,239,285,169,245,True,16
E,76,kaist_dataset/English/Digital_Camera/(E.S)C-outdoor1/DSC02356.JPG,char_data/E/DSC02356.JPG_17.jpg,3420,480,640,45,283,328,169,245,True,16
E,76,kaist_dataset/English/Digital_Camera/(E.S)C-outdoor1/DSC02356.JPG,char_data/E/DSC02356.JPG_18.jpg,3344,480,640,44,449,493,163,239,True,16
E,83,kaist_dataset/English/Digital_Camera/(E.S)C-outdoor1/DSC02364.JPG,char_data/E/DSC02364.JPG_4.jpg,4897,480,640,59,259,318,239,322,True,16
E,86,kaist_dataset/English/Digital_Camera/(E.S)C-outdoor1/DSC02364.JPG,char_data/E/DSC02364.JPG_5.jpg,5160,480,640,60,391,451,246,332,True,16
E,81,kaist_dataset/English/Digital_Camera/(E.S)C-outdoor1/DSC02384.JPG,char_data/E/DSC02384.JPG_4.jpg,4860,480,640,60,340,400,224,305,True,16
E,80,kaist_dataset/English/Digital_Camera/(E.S)C-outdoor1/DSC02384.JPG,char_data/E/DSC02384.JPG_5.jpg,4880,480,640,61,400,461,222,302,True,16
E,82,kaist_dataset/English/Digital_Camera/(E.S)C-outdoor1/DSC02394.JPG,char_data/E/DSC02394.JPG_2.jpg,3936,480,640,48,375,423,252,334,True,16
E,72,kaist_dataset/English/Digital_Camera/(E.S)C-outdoor1/DSC02395.JPG,char_data/E/DSC02395.JPG_2.jpg,5544,480,640,77,354,431,295,367,True,16
E,68,kaist_dataset/English/Digital_Camera/(E.S)C-outdoor1/DSC02398.JPG,char_data/E/DSC02398.JPG_4.jpg,3468,480,640,51,120,171,245,313,True,16
E,82,kaist_dataset/English/Digital_Camera/(E.S)C-outdoor1/DSC02398.JPG,char_data/E/DSC02398.JPG_5.jpg,4510,480,640,55,521,576,223,305,True,16
E,144,kaist_dataset/English/Digital_Camera/(E.S)C-outdoor1/DSC02415.JPG,char_data/E/DSC02415.JPG_2.jpg,13392,480,640,93,2,95,53,197,True,16
E,117,kaist_dataset/English/Digital_Camera/(E.S)C-outdoor1/DSC02427.JPG,char_data/E/DSC02427.JPG_16.jpg,6435,480,640,55,283,338,107,224,True,16
E,57,kaist_dataset/English/Digital_Camera/(E.S)C-outdoor1/DSC02427.JPG,char_data/E/DSC02427.JPG_17.jpg,1710,480,640,30,248,278,231,288,True,16
E,48,kaist_dataset/English/Digital_Camera/(E.S)C-outdoor1/DSC02427.JPG,char_data/E/DSC02427.JPG_18.jpg,1392,480,640,29,363,392,236,284,True,16
E,46,kaist_dataset/English/Digital_Camera/(E.S)C-outdoor1/DSC02427.JPG,char_data/E/DSC02427.JPG_19.jpg,966,480,640,21,597,618,241,287,True,16
E,50,kaist_dataset/English/Digital_Camera/(E.S)C-outdoor1/DSC02427.JPG,char_data/E/DSC02427.JPG_20.jpg,1000,480,640,20,618,638,241,291,True,16
E,132,kaist_dataset/English/Digital_Camera/(E.S)C-outdoor1/DSC02448.JPG,char_data/E/DSC02448.JPG_2.jpg,9900,480,640,75,488,563,193,325,True,16
E,114,kaist_dataset/English/Digital_Camera/(E.S)C-outdoor1/DSC02450.JPG,char_data/E/DSC02450.JPG_2.jpg,6954,480,640,61,571,632,73,187,True,16
E,18,kaist_dataset/English/Digital_Camera/(E.S)C-outdoor1/DSC02500.JPG,char_data/E/DSC02500.JPG_8.jpg,288,480,640,16,36,52,106,124,True,16
E,24,kaist_dataset/English/Digital_Camera/(E.S)C-outdoor1/DSC02500.JPG,char_data/E/DSC02500.JPG_9.jpg,432,480,640,18,30,48,82,106,True,16
E,24,kaist_dataset/English/Digital_Camera/(E.S)C-outdoor1/DSC02500.JPG,char_data/E/DSC02500.JPG_10.jpg,408,480,640,17,106,123,83,107,True,16
E,54,kaist_dataset/English/Digital_Camera/(E.S)C-outdoor1/DSC02500.JPG,char_data/E/DSC02500.JPG_11.jpg,1944,480,640,36,391,427,286,340,True,16
E,141,kaist_dataset/English/Digital_Camera/(E.S)C-outdoor1/DSC02501.JPG,char_data/E/DSC02501.JPG_6.jpg,17484,480,640,124,192,316,88,229,True,16
E,140,kaist_dataset/English/Digital_Camera/(E.S)C-outdoor1/DSC02501.JPG,char_data/E/DSC02501.JPG_7.jpg,16800,480,640,120,321,441,91,231,True,16
E,61,kaist_dataset/English/Digital_Camera/(E.S)C-outdoor1/DSC02501.JPG,char_data/E/DSC02501.JPG_8.jpg,3416,480,640,56,18,74,293,354,True,16
E,53,kaist_dataset/English/Digital_Camera/(E.S)C-outdoor1/DSC02559.JPG,char_data/E/DSC02559.JPG_5.jpg,3074,480,640,58,480,538,104,157,True,16
E,89,kaist_dataset/English/Digital_Camera/(E.S)C-outdoor1/DSC02590.JPG,char_data/E/DSC02590.JPG_2.jpg,7298,480,640,82,231,313,139,228,True,16
E,38,kaist_dataset/English/Digital_Camera/(E.S)C-outdoor1/DSC02618.JPG,char_data/E/DSC02618.JPG_4.jpg,684,480,640,18,313,331,175,213,True,16
E,36,kaist_dataset/English/Digital_Camera/(E.S)C-outdoor1/DSC02618.JPG,char_data/E/DSC02618.JPG_5.jpg,756,480,640,21,355,376,176,212,True,16
E,61,kaist_dataset/English/Digital_Camera/(E.S)C-outdoor1/DSC02619.JPG,char_data/E/DSC02619.JPG_2.jpg,2257,480,640,37,233,270,219,280,True,16
E,85,kaist_dataset/English/Digital_Camera/(E.S)C-outdoor1/DSC02897.JPG,char_data/E/DSC02897.JPG_2.jpg,4165,480,640,49,309,358,281,366,True,16
E,190,kaist_dataset/English/Digital_Camera/(E.S)C-outdoor2/DSC02949.JPG,char_data/E/DSC02949.JPG_2.jpg,7220,480,640,38,315,353,61,251,True,16
E,90,kaist_dataset/English/Digital_Camera/(E.S)C-outdoor2/DSC02984.JPG,char_data/E/DSC02984.JPG_4.jpg,5130,480,640,57,91,148,104,194,True,16
E,88,kaist_dataset/English/Digital_Camera/(E.S)C-outdoor2/DSC02984.JPG,char_data/E/DSC02984.JPG_5.jpg,5368,480,640,61,503,564,106,194,True,16
E,81,kaist_dataset/English/Digital_Camera/(E.S)C-outdoor2/DSC02993.JPG,char_data/E/DSC02993.JPG_4.jpg,4455,480,640,55,179,234,226,307,True,16
E,80,kaist_dataset/English/Digital_Camera/(E.S)C-outdoor2/DSC02993.JPG,char_data/E/DSC02993.JPG_5.jpg,4320,480,640,54,446,500,122,202,True,16
E,76,kaist_dataset/English/Digital_Camera/(E.S)C-outdoor2/DSC03012.JPG,char_data/E/DSC03012.JPG_4.jpg,2812,480,640,37,165,202,210,286,True,16
E,74,kaist_dataset/English/Digital_Camera/(E.S)C-outdoor2/DSC03012.JPG,char_data/E/DSC03012.JPG_5.jpg,2664,480,640,36,201,237,210,284,True,16
E,52,kaist_dataset/English/Digital_Camera/(E.S)C-outdoor2/DSC03023.JPG,char_data/E/DSC03023.JPG_6.jpg,1144,480,640,22,149,171,299,351,True,16
E,56,kaist_dataset/English/Digital_Camera/(E.S)C-outdoor2/DSC03023.JPG,char_data/E/DSC03023.JPG_7.jpg,1568,480,640,28,442,470,297,353,True,16
E,59,kaist_dataset/English/Digital_Camera/(E.S)C-outdoor2/DSC03023.JPG,char_data/E/DSC03023.JPG_8.jpg,1829,480,640,31,471,502,298,357,True,16
E,73,kaist_dataset/English/Digital_Camera/(E.S)C-outdoor2/DSC03050.JPG,char_data/E/DSC03050.JPG_2.jpg,5256,480,640,72,171,243,211,284,True,16
E,78,kaist_dataset/English/Digital_Camera/(E.S)C-outdoor2/DSC03191.JPG,char_data/E/DSC03191.JPG_4.jpg,3744,480,640,48,314,362,218,296,True,16
E,81,kaist_dataset/English/Digital_Camera/(E.S)C-outdoor2/DSC03191.JPG,char_data/E/DSC03191.JPG_5.jpg,4050,480,640,50,362,412,217,298,True,16
E,52,kaist_dataset/English/Digital_Camera/(E.S)C-outdoor2/DSC03203.JPG,char_data/E/DSC03203.JPG_11.jpg,1820,480,640,35,159,194,309,361,True,16
E,45,kaist_dataset/English/Digital_Camera/(E.S)C-outdoor2/DSC03225.JPG,char_data/E/DSC03225.JPG_4.jpg,1215,480,640,27,306,333,71,116,True,16
E,69,kaist_dataset/English/Digital_Camera/(E.S)C-outdoor2/DSC03262.JPG,char_data/E/DSC03262.JPG_4.jpg,2967,480,640,43,9,52,107,176,True,16
E,68,kaist_dataset/English/Digital_Camera/(E.S)C-outdoor2/DSC03264.JPG,char_data/E/DSC03264.JPG_4.jpg,3536,480,640,52,354,406,230,298,True,16
E,69,kaist_dataset/English/Digital_Camera/(E.S)C-outdoor2/DSC03264.JPG,char_data/E/DSC03264.JPG_5.jpg,3795,480,640,55,348,403,93,162,True,16
E,48,kaist_dataset/English/Digital_Camera/(E.S)C-outdoor2/DSC03279.JPG,char_data/E/DSC03279.JPG_4.jpg,1392,480,640,29,172,201,211,259,True,16
E,42,kaist_dataset/English/Digital_Camera/(E.S)C-outdoor2/DSC03279.JPG,char_data/E/DSC03279.JPG_5.jpg,1176,480,640,28,204,232,214,256,True,16
E,96,kaist_dataset/English/Digital_Camera/(E.S)C-outdoor2/DSC03281.JPG,char_data/E/DSC03281.JPG_4.jpg,5760,480,640,60,209,269,211,307,True,16
E,57,kaist_dataset/English/Digital_Camera/(E.S)C-outdoor2/DSC03294.JPG,char_data/E/DSC03294.JPG_6.jpg,1653,480,640,29,226,255,293,350,True,16
E,59,kaist_dataset/English/Digital_Camera/(E.S)C-outdoor2/DSC03294.JPG,char_data/E/DSC03294.JPG_7.jpg,2242,480,640,38,329,367,290,349,True,16
E,63,kaist_dataset/English/Digital_Camera/(E.S)C-outdoor2/DSC03297.JPG,char_data/E/DSC03297.JPG_6.jpg,2394,480,640,38,108,146,260,323,True,16
E,63,kaist_dataset/English/Digital_Camera/(E.S)C-outdoor2/DSC03297.JPG,char_data/E/DSC03297.JPG_7.jpg,2583,480,640,41,359,400,246,309,True,16
E,41,kaist_dataset/English/Digital_Camera/(E.S)C-outdoor2/DSC03317.JPG,char_data/E/DSC03317.JPG_6.jpg,1025,480,640,25,478,503,260,301,True,16
E,110,kaist_dataset/English/Digital_Camera/(E.S)C-outdoor2/DSC03317.JPG,char_data/E/DSC03317.JPG_7.jpg,7810,480,640,71,414,485,62,172,True,16
E,49,kaist_dataset/English/Digital_Camera/(E.S)C-outdoor2/DSC03317.JPG,char_data/E/DSC03317.JPG_8.jpg,833,480,640,17,377,394,194,243,True,16
E,143,kaist_dataset/English/Digital_Camera/(E.S)C-outdoor2/DSC03410.JPG,char_data/E/DSC03410.JPG_4.jpg,21021,480,640,147,9,156,45,188,True,16
E,127,kaist_dataset/English/Digital_Camera/(E.S)C-outdoor2/DSC03410.JPG,char_data/E/DSC03410.JPG_5.jpg,17272,480,640,136,293,429,59,186,True,16
E,76,kaist_dataset/English/Digital_Camera/(E.S)C-outdoor2/DSC03411.JPG,char_data/E/DSC03411.JPG_4.jpg,5928,480,640,78,195,273,40,116,True,16
E,65,kaist_dataset/English/Digital_Camera/(E.S)C-outdoor2/DSC03411.JPG,char_data/E/DSC03411.JPG_5.jpg,4550,480,640,70,343,413,56,121,True,16
E,40,kaist_dataset/English/Digital_Camera/(E.S)C-outdoor2/DSC03575.JPG,char_data/E/DSC03575.JPG_8.jpg,1080,480,640,27,359,386,182,222,True,16
E,52,kaist_dataset/English/Digital_Camera/(E.S)C-outdoor2/DSC03575.JPG,char_data/E/DSC03575.JPG_9.jpg,1664,480,640,32,199,231,258,310,True,16
E,54,kaist_dataset/English/Digital_Camera/(E.S)C-outdoor2/DSC03575.JPG,char_data/E/DSC03575.JPG_10.jpg,1944,480,640,36,270,306,261,315,True,16
E,55,kaist_dataset/English/Digital_Camera/(E.S)C-outdoor2/DSC03575.JPG,char_data/E/DSC03575.JPG_11.jpg,1540,480,640,28,412,440,261,316,True,16
E,61,kaist_dataset/English/Digital_Camera/(E.S)C-outdoor2/DSC03684.JPG,char_data/E/DSC03684.JPG_4.jpg,2684,480,640,44,171,215,84,145,True,16
E,62,kaist_dataset/English/Digital_Camera/(E.S)C-outdoor2/DSC03684.JPG,char_data/E/DSC03684.JPG_5.jpg,2914,480,640,47,468,515,92,154,True,16
E,66,kaist_dataset/English/Digital_Camera/(E.S)C-outdoor2/DSC03759.JPG,char_data/E/DSC03759.JPG_2.jpg,6930,480,640,105,318,423,118,184,True,16
E,134,kaist_dataset/English/Digital_Camera/(E.S)C-outdoor2/DSC03786.JPG,char_data/E/DSC03786.JPG_8.jpg,10854,480,640,81,89,170,165,299,True,16
E,95,kaist_dataset/English/Digital_Camera/(E.S)C-outdoor2/DSC03831.JPG,char_data/E/DSC03831.JPG_4.jpg,6080,480,640,64,349,413,16,111,True,16
E,100,kaist_dataset/English/Digital_Camera/(E.S)C-outdoor2/DSC03831.JPG,char_data/E/DSC03831.JPG_5.jpg,6000,480,640,60,415,475,13,113,True,16
E,30,kaist_dataset/English/Digital_Camera/(E.S)C-outdoor2/DSC04064.JPG,char_data/E/DSC04064.JPG_2.jpg,600,480,640,20,567,587,151,181,True,16
E,76,kaist_dataset/English/Digital_Camera/(E.S)C-outdoor2/DSC04079.JPG,char_data/E/DSC04079.JPG_14.jpg,3192,480,640,42,564,606,268,344,True,16
E,65,kaist_dataset/English/Digital_Camera/(E.S)C-outdoor2/DSC04079.JPG,char_data/E/DSC04079.JPG_15.jpg,2470,480,640,38,468,506,41,106,True,16
E,38,kaist_dataset/English/Digital_Camera/(E.S)C-outdoor2/DSC04080.JPG,char_data/E/DSC04080.JPG_2.jpg,1292,480,640,34,403,437,353,391,True,16
E,60,kaist_dataset/English/Digital_Camera/(E.S)C-outdoor2/DSC04120.JPG,char_data/E/DSC04120.JPG_2.jpg,2220,480,640,37,155,192,144,204,True,16
E,64,kaist_dataset/English/Digital_Camera/(E.S)C-outdoor2/DSC04313.JPG,char_data/E/DSC04313.JPG_4.jpg,2816,480,640,44,266,310,116,180,True,16
E,78,kaist_dataset/English/Digital_Camera/(E.S)C-outdoor2/DSC04313.JPG,char_data/E/DSC04313.JPG_5.jpg,3432,480,640,44,426,470,111,189,True,16
E,42,kaist_dataset/English/Digital_Camera/(E.S)C-outdoor2/DSC04361.JPG,char_data/E/DSC04361.JPG_4.jpg,1008,480,640,24,337,361,238,280,True,16
E,37,kaist_dataset/English/Digital_Camera/(E.S)C-outdoor2/DSC04361.JPG,char_data/E/DSC04361.JPG_5.jpg,925,480,640,25,408,433,241,278,True,16
E,59,kaist_dataset/English/Digital_Camera/(E.S)C-outdoor2/DSC04464.JPG,char_data/E/DSC04464.JPG_6.jpg,1652,480,640,28,107,135,318,377,True,16
E,65,kaist_dataset/English/Digital_Camera/(E.S)C-outdoor2/DSC04464.JPG,char_data/E/DSC04464.JPG_7.jpg,2210,480,640,34,393,427,328,393,True,16
E,56,kaist_dataset/English/Digital_Camera/(E.S)C-outdoor2/DSC04464.JPG,char_data/E/DSC04464.JPG_8.jpg,1848,480,640,33,553,586,331,387,True,16
E,64,kaist_dataset/English/Digital_Camera/(E.S)C-outdoor2/IMG_2481.JPG,char_data/E/IMG_2481.JPG_2.jpg,3264,480,640,51,424,475,249,313,True,16
E,98,kaist_dataset/English/Digital_Camera/(E.S)C-outdoor2/P1010015.JPG,char_data/E/P1010015.JPG_2.jpg,5586,480,640,57,213,270,129,227,True,16
E,67,kaist_dataset/English/Digital_Camera/(E.S)C-outdoor3/DSC02788.JPG,char_data/E/DSC02788.JPG_6.jpg,2345,480,640,35,346,381,297,364,True,16
E,61,kaist_dataset/English/Digital_Camera/(E.S)C-outdoor3/DSC02788.JPG,char_data/E/DSC02788.JPG_7.jpg,1830,480,640,30,453,483,295,356,True,16
E,58,kaist_dataset/English/Digital_Camera/(E.S)C-outdoor3/DSC02788.JPG,char_data/E/DSC02788.JPG_8.jpg,1798,480,640,31,240,271,226,284,True,16
E,83,kaist_dataset/English/Digital_Camera/(E.S)C-outdoor3/P1010064.JPG,char_data/E/P1010064.JPG_6.jpg,4565,480,640,55,87,142,304,387,True,16
E,78,kaist_dataset/English/Digital_Camera/(E.S)C-outdoor3/P1010064.JPG,char_data/E/P1010064.JPG_7.jpg,4212,480,640,54,263,317,311,389,True,16
E,94,kaist_dataset/English/Digital_Camera/(E.S)C-outdoor3/P1010133.JPG,char_data/E/P1010133.JPG_2.jpg,6110,480,640,65,329,394,63,157,True,16
E,76,kaist_dataset/English/Digital_Camera/(E.S)C-outdoor3/P1010138.JPG,char_data/E/P1010138.JPG_4.jpg,4256,480,640,56,342,398,78,154,True,16
E,38,kaist_dataset/English/Digital_Camera/(E.S)C-outdoor3/r.jpg,char_data/E/r.jpg_4.jpg,1292,240,320,34,208,242,55,93,True,16
E,92,kaist_dataset/English/Digital_Camera/(E.S)C-outdoor3/r.jpg,char_data/E/r.jpg_5.jpg,5152,240,320,56,229,285,97,189,True,16
E,56,kaist_dataset/English/Digital_Camera/(E.S)C-outdoor3/크기변환_%B0%A3%C6%C718_m_starfirm.jpg,char_data/E/크기변환_%B0%A3%C6%C718_m_starfirm.jpg_4.jpg,3136,480,640,56,272,328,216,272,True,16
E,57,kaist_dataset/English/Digital_Camera/(E.S)C-outdoor3/크기변환_%B0%A3%C6%C718_m_starfirm.jpg,char_data/E/크기변환_%B0%A3%C6%C718_m_starfirm.jpg_5.jpg,3363,480,640,59,506,565,204,261,True,16
E,61,kaist_dataset/English/Digital_Camera/(E.S)C-outdoor3/크기변환_%C8%AD%C0%CC%C6%AE%C4%FE%C6%AE%B0%A3%C6%C7_%BA%B9%BB%E7_1-bona0007.jpg,char_data/E/크기변환_%C8%AD%C0%CC%C6%AE%C4%FE%C6%AE%B0%A3%C6%C7_%BA%B9%BB%E7_1-bona0007.jpg_2.jpg,3416,480,640,56,469,525,197,258,True,16
E,52,kaist_dataset/English/Digital_Camera/(E.S)C-outdoor3/크기변환_P1010076.JPG,char_data/E/크기변환_P1010076.JPG_4.jpg,1664,480,640,32,432,464,120,172,True,16
E,51,kaist_dataset/English/Digital_Camera/(E.S)C-outdoor3/크기변환_P1010076.JPG,char_data/E/크기변환_P1010076.JPG_5.jpg,2091,480,640,41,465,506,119,170,True,16
E,31,kaist_dataset/English/Digital_Camera/(E.S)D-indoor/308.jpg,char_data/E/308.jpg_2.jpg,713,212,385,23,122,145,48,79,True,16
E,64,kaist_dataset/English/Digital_Camera/(E.S)D-indoor/DSC02769.JPG,char_data/E/DSC02769.JPG_6.jpg,2752,480,640,43,334,377,217,281,True,16
E,62,kaist_dataset/English/Digital_Camera/(E.S)D-indoor/DSC02769.JPG,char_data/E/DSC02769.JPG_7.jpg,2480,480,640,40,466,506,216,278,True,16
E,66,kaist_dataset/English/Digital_Camera/(E.S)D-indoor/DSC02769.JPG,char_data/E/DSC02769.JPG_8.jpg,2772,480,640,42,184,226,135,201,True,16
E,141,kaist_dataset/English/Digital_Camera/(E.S)D-indoor/DSC02842.JPG,char_data/E/DSC02842.JPG_2.jpg,17202,480,640,122,233,355,191,332,True,16
E,85,kaist_dataset/English/Digital_Camera/(E.S)D-indoor/DSC02850.JPG,char_data/E/DSC02850.JPG_4.jpg,5100,480,640,60,422,482,160,245,True,16
E,67,kaist_dataset/English/Digital_Camera/(E.S)D-indoor/DSC02850.JPG,char_data/E/DSC02850.JPG_5.jpg,3283,480,640,49,342,391,240,307,True,16
E,78,kaist_dataset/English/Digital_Camera/(E.S)D-indoor/DSC03074.JPG,char_data/E/DSC03074.JPG_6.jpg,3042,480,640,39,84,123,244,322,True,16
E,67,kaist_dataset/English/Digital_Camera/(E.S)D-indoor/DSC03078.JPG,char_data/E/DSC03078.JPG_2.jpg,3015,480,640,45,193,238,293,360,True,16
E,67,kaist_dataset/English/Digital_Camera/(E.S)D-indoor/DSC03091.JPG,char_data/E/DSC03091.JPG_8.jpg,2546,480,640,38,480,518,205,272,True,16
E,94,kaist_dataset/English/Digital_Camera/(E.S)D-indoor/DSC03365.JPG,char_data/E/DSC03365.JPG_2.jpg,7050,480,640,75,373,448,362,456,True,16
E,102,kaist_dataset/English/Digital_Camera/(E.S)D-indoor/DSC03366.JPG,char_data/E/DSC03366.JPG_2.jpg,7650,480,640,75,219,294,349,451,True,16
E,89,kaist_dataset/English/Digital_Camera/(E.S)D-indoor/DSC03367.JPG,char_data/E/DSC03367.JPG_2.jpg,6853,480,640,77,455,532,32,121,True,16
E,67,kaist_dataset/English/Digital_Camera/(E.S)D-indoor/DSC03396.JPG,char_data/E/DSC03396.JPG_8.jpg,3283,480,640,49,434,483,215,282,True,16
E,46,kaist_dataset/English/Digital_Camera/(E.S)D-indoor/DSC03396.JPG,char_data/E/DSC03396.JPG_10.jpg,1518,480,640,33,363,396,336,382,True,16
E,67,kaist_dataset/English/Digital_Camera/(E.S)D-indoor/DSC03396.JPG,char_data/E/DSC03396.JPG_11.jpg,3015,480,640,45,483,528,151,218,True,16
E,47,kaist_dataset/English/Digital_Camera/(E.S)D-indoor/DSC03401.JPG,char_data/E/DSC03401.JPG_2.jpg,1833,480,640,39,270,309,231,278,True,16
E,53,kaist_dataset/English/Digital_Camera/(E.S)D-indoor/DSC03467.JPG,char_data/E/DSC03467.JPG_4.jpg,1908,480,640,36,333,369,155,208,True,16
E,57,kaist_dataset/English/Digital_Camera/(E.S)D-indoor/DSC03467.JPG,char_data/E/DSC03467.JPG_5.jpg,1881,480,640,33,449,482,154,211,True,16
E,65,kaist_dataset/English/Digital_Camera/(E.S)D-indoor/DSC03881.JPG,char_data/E/DSC03881.JPG_2.jpg,3185,480,640,49,307,356,315,380,True,16
E,68,kaist_dataset/English/Digital_Camera/(E.S)D-indoor/DSC03883.JPG,char_data/E/DSC03883.JPG_2.jpg,3332,480,640,49,195,244,316,384,True,16
E,68,kaist_dataset/English/Digital_Camera/(E.S)D-indoor/DSC03887.JPG,char_data/E/DSC03887.JPG_2.jpg,3468,480,640,51,106,157,166,234,True,16
E,79,kaist_dataset/English/Digital_Camera/(E.S)D-indoor/DSC03896.JPG,char_data/E/DSC03896.JPG_4.jpg,4503,480,640,57,369,426,274,353,True,16
E,79,kaist_dataset/English/Digital_Camera/(E.S)D-indoor/DSC03896.JPG,char_data/E/DSC03896.JPG_5.jpg,2844,480,640,36,498,534,258,337,True,16
E,39,kaist_dataset/English/Digital_Camera/(E.S)D-indoor/DSC03901.JPG,char_data/E/DSC03901.JPG_10.jpg,897,480,640,23,195,218,262,301,True,16
E,36,kaist_dataset/English/Digital_Camera/(E.S)D-indoor/DSC03901.JPG,char_data/E/DSC03901.JPG_11.jpg,828,480,640,23,411,434,259,295,True,16
E,71,kaist_dataset/English/Digital_Camera/(E.S)D-indoor/DSC03901.JPG,char_data/E/DSC03901.JPG_12.jpg,2911,480,640,41,123,164,165,236,True,16
E,58,kaist_dataset/English/Digital_Camera/(E.S)D-indoor/DSC03901.JPG,char_data/E/DSC03901.JPG_13.jpg,2552,480,640,44,208,252,174,232,True,16
E,38,kaist_dataset/English/Digital_Camera/(E.S)D-indoor/DSC03901.JPG,char_data/E/DSC03901.JPG_14.jpg,912,480,640,24,224,248,122,160,True,16
E,121,kaist_dataset/English/Digital_Camera/(E.S)D-indoor/DSC03911.JPG,char_data/E/DSC03911.JPG_4.jpg,8349,480,640,69,200,269,322,443,True,16
E,120,kaist_dataset/English/Digital_Camera/(E.S)D-indoor/DSC03911.JPG,char_data/E/DSC03911.JPG_5.jpg,8760,480,640,73,272,345,322,442,True,16
E,39,kaist_dataset/English/Digital_Camera/(E.S)D-indoor/DSC03935.JPG,char_data/E/DSC03935.JPG_8.jpg,1014,480,640,26,85,111,38,77,True,16
E,42,kaist_dataset/English/Digital_Camera/(E.S)D-indoor/DSC03935.JPG,char_data/E/DSC03935.JPG_9.jpg,840,480,640,20,137,157,37,79,True,16
E,36,kaist_dataset/English/Digital_Camera/(E.S)D-indoor/DSC03935.JPG,char_data/E/DSC03935.JPG_10.jpg,648,480,640,18,179,197,39,75,True,16
E,39,kaist_dataset/English/Digital_Camera/(E.S)D-indoor/DSC03935.JPG,char_data/E/DSC03935.JPG_11.jpg,1014,480,640,26,533,559,53,92,True,16
E,38,kaist_dataset/English/Digital_Camera/(E.S)D-indoor/DSC03943.JPG,char_data/E/DSC03943.JPG_2.jpg,608,480,640,16,297,313,311,349,True,16
E,58,kaist_dataset/English/Digital_Camera/(E.S)D-indoor/DSC03947.JPG,char_data/E/DSC03947.JPG_2.jpg,2262,480,640,39,424,463,192,250,True,16
E,140,kaist_dataset/English/Digital_Camera/(E.S)E-night/068.jpg,char_data/E/068.jpg_6.jpg,14280,519,742,102,96,198,268,408,True,16
E,30,kaist_dataset/English/Digital_Camera/(E.S)E-night/111.jpg,char_data/E/111.jpg_10.jpg,360,480,640,12,280,292,282,312,True,16
E,22,kaist_dataset/English/Digital_Camera/(E.S)E-night/111.jpg,char_data/E/111.jpg_11.jpg,308,480,640,14,310,324,289,311,True,16
E,26,kaist_dataset/English/Digital_Camera/(E.S)E-night/111.jpg,char_data/E/111.jpg_12.jpg,312,480,640,12,339,351,270,296,True,16
E,21,kaist_dataset/English/Digital_Camera/(E.S)E-night/111.jpg,char_data/E/111.jpg_13.jpg,231,480,640,11,201,212,263,284,True,16
E,18,kaist_dataset/English/Digital_Camera/(E.S)E-night/111.jpg,char_data/E/111.jpg_14.jpg,234,480,640,13,255,268,265,283,True,16
E,110,kaist_dataset/English/Digital_Camera/(E.S)E-night/DSC02606.JPG,char_data/E/DSC02606.JPG_2.jpg,10120,480,640,92,411,503,187,297,True,16
E,88,kaist_dataset/English/Digital_Camera/(E.S)E-night/DSC02613.JPG,char_data/E/DSC02613.JPG_4.jpg,9592,480,640,109,50,159,177,265,True,16
E,103,kaist_dataset/English/Digital_Camera/(E.S)E-night/DSC02613.JPG,char_data/E/DSC02613.JPG_5.jpg,11845,480,640,115,281,396,171,274,True,16
E,92,kaist_dataset/English/Digital_Camera/(E.S)E-night/DSC02641.JPG,char_data/E/DSC02641.JPG_6.jpg,4968,480,640,54,144,198,270,362,True,16
E,97,kaist_dataset/English/Digital_Camera/(E.S)E-night/DSC02641.JPG,char_data/E/DSC02641.JPG_7.jpg,4656,480,640,48,408,456,267,364,True,16
E,97,kaist_dataset/English/Digital_Camera/(E.S)E-night/DSC02641.JPG,char_data/E/DSC02641.JPG_8.jpg,4753,480,640,49,456,505,268,365,True,16
E,93,kaist_dataset/English/Digital_Camera/(E.S)E-night/DSC02675.JPG,char_data/E/DSC02675.JPG_4.jpg,6324,480,640,68,349,417,182,275,True,16
E,97,kaist_dataset/English/Digital_Camera/(E.S)E-night/DSC02675.JPG,char_data/E/DSC02675.JPG_5.jpg,5820,480,640,60,533,593,184,281,True,16
E,39,kaist_dataset/English/Digital_Camera/(E.S)E-night/t.jpg,char_data/E/t.jpg_6.jpg,702,240,320,18,110,128,66,105,True,16
E,36,kaist_dataset/English/Digital_Camera/(E.S)E-night/t.jpg,char_data/E/t.jpg_7.jpg,936,240,320,26,198,224,64,100,True,16
E,42,kaist_dataset/English/Digital_Camera/(E.S)E-night/t.jpg,char_data/E/t.jpg_8.jpg,1386,240,320,33,253,286,58,100,True,16
E,29,kaist_dataset/English/Digital_Camera/(E.S)E-night/크기변환_%BA%F7%BD%BA%BD%C5%B8%DE%B4%BA_01_tjtjdska2008.jpg,char_data/E/크기변환_%BA%F7%BD%BA%BD%C5%B8%DE%B4%BA_01_tjtjdska2008.jpg_2.jpg,493,480,640,17,312,329,274,303,True,16
E,192,kaist_dataset/English/Digital_Camera/(E.S)F-others/080116-0058.jpg,char_data/E/080116-0058.jpg_6.jpg,18816,1200,1600,98,539,637,275,467,True,16
E,118,kaist_dataset/English/Digital_Camera/(E.S)F-others/080116-0058.jpg,char_data/E/080116-0058.jpg_7.jpg,3658,1200,1600,31,895,926,609,727,True,16
E,149,kaist_dataset/English/Digital_Camera/(E.S)F-others/080116-0060.jpg,char_data/E/080116-0060.jpg_2.jpg,13708,1200,1600,92,676,768,425,574,True,16
E,35,kaist_dataset/English/Digital_Camera/(E.S)F-others/080119-0007.jpg,char_data/E/080119-0007.jpg_22.jpg,700,1200,1600,20,1579,1599,433,468,True,16
E,37,kaist_dataset/English/Digital_Camera/(E.S)F-others/080119-0007.jpg,char_data/E/080119-0007.jpg_24.jpg,1924,1200,1600,52,1221,1273,812,849,True,16
E,27,kaist_dataset/English/Digital_Camera/(E.S)F-others/080119-0007.jpg,char_data/E/080119-0007.jpg_25.jpg,513,1200,1600,19,194,213,476,503,True,16
E,43,kaist_dataset/English/Digital_Camera/(E.S)F-others/080119-0007.jpg,char_data/E/080119-0007.jpg_26.jpg,989,1200,1600,23,221,244,602,645,True,16
E,35,kaist_dataset/English/Digital_Camera/(E.S)F-others/080119-0007.jpg,char_data/E/080119-0007.jpg_28.jpg,595,1200,1600,17,1391,1408,495,530,True,16
E,36,kaist_dataset/English/Digital_Camera/(E.S)F-others/080119-0007.jpg,char_data/E/080119-0007.jpg_29.jpg,468,1200,1600,13,1495,1508,488,524,True,16
E,143,kaist_dataset/English/Digital_Camera/(E.S)F-others/080119-0013.jpg,char_data/E/080119-0013.jpg_2.jpg,14729,1200,1600,103,989,1092,707,850,True,16
E,184,kaist_dataset/English/Digital_Camera/(E.S)F-others/080119-0014.jpg,char_data/E/080119-0014.jpg_6.jpg,20424,1200,1600,111,583,694,461,645,True,16
E,148,kaist_dataset/English/Digital_Camera/(E.S)F-others/080119-0014.jpg,char_data/E/080119-0014.jpg_8.jpg,12136,1200,1600,82,1158,1240,677,825,True,16
E,228,kaist_dataset/English/Digital_Camera/(E.S)F-others/080119-0016.jpg,char_data/E/080119-0016.jpg_2.jpg,35568,1200,1600,156,699,855,317,545,True,16
E,53,kaist_dataset/English/Digital_Camera/(E.S)F-others/086.jpg,char_data/E/086.jpg_10.jpg,901,480,640,17,266,283,301,354,True,16
E,49,kaist_dataset/English/Digital_Camera/(E.S)F-others/086.jpg,char_data/E/086.jpg_11.jpg,735,480,640,15,382,397,325,374,True,16
E,50,kaist_dataset/English/Digital_Camera/(E.S)F-others/086.jpg,char_data/E/086.jpg_12.jpg,850,480,640,17,397,414,330,380,True,16
E,77,kaist_dataset/English/Digital_Camera/(E.S)F-others/2007-12-09-day-exterior-047.jpg,char_data/E/2007-12-09-day-exterior-047.jpg_2.jpg,2541,1200,1600,33,84,117,492,569,True,16
E,113,kaist_dataset/English/Digital_Camera/(E.S)F-others/DSC02646.JPG,char_data/E/DSC02646.JPG_4.jpg,4859,480,640,43,360,403,197,310,True,16
E,111,kaist_dataset/English/Digital_Camera/(E.S)F-others/DSC02646.JPG,char_data/E/DSC02646.JPG_5.jpg,5106,480,640,46,404,450,186,297,True,16
E,49,kaist_dataset/English/Digital_Camera/(E.S)F-others/DSC02884.JPG,char_data/E/DSC02884.JPG_2.jpg,2009,480,640,41,540,581,18,67,True,16
E,36,kaist_dataset/English/Digital_Camera/(E.S)F-others/DSC02923.JPG,char_data/E/DSC02923.JPG_5.jpg,504,480,640,14,232,246,408,444,True,16
E,79,kaist_dataset/English/Digital_Camera/(E.S)F-others/DSC03291.JPG,char_data/E/DSC03291.JPG_4.jpg,3555,480,640,45,491,536,237,316,True,16
E,80,kaist_dataset/English/Digital_Camera/(E.S)F-others/DSC03291.JPG,char_data/E/DSC03291.JPG_5.jpg,3760,480,640,47,535,582,247,327,True,16
E,44,kaist_dataset/English/Digital_Camera/(E.S)F-others/m.jpg,char_data/E/m.jpg_4.jpg,1496,240,320,34,134,168,96,140,True,16
E,43,kaist_dataset/English/Digital_Camera/(E.S)F-others/m.jpg,char_data/E/m.jpg_5.jpg,860,240,320,20,1,20,188,231,True,16
E,55,kaist_dataset/English/Digital_Camera/(E.S)F-others/크기변환_%B0%A3%C6%C77_m_starfirm.jpg,char_data/E/크기변환_%B0%A3%C6%C77_m_starfirm.jpg_4.jpg,2640,480,640,48,475,523,153,208,True,16
E,66,kaist_dataset/English/Digital_Camera/(E.S)F-others/크기변환_%B0%A3%C6%C77_m_starfirm.jpg,char_data/E/크기변환_%B0%A3%C6%C77_m_starfirm.jpg_5.jpg,2640,480,640,40,421,461,202,268,True,16
E,84,kaist_dataset/English/Digital_Camera/(E.S)F-others/크기변환_%C4%BF%C7%C7%B5%B9%C3%E2%B0%A3%C6%C7_%281%29_alto99kr.jpg,char_data/E/크기변환_%C4%BF%C7%C7%B5%B9%C3%E2%B0%A3%C6%C7_%281%29_alto99kr.jpg_4.jpg,7056,480,640,84,435,519,242,326,True,16
E,88,kaist_dataset/English/Digital_Camera/(E.S)F-others/크기변환_%C4%BF%C7%C7%B5%B9%C3%E2%B0%A3%C6%C7_%281%29_alto99kr.jpg,char_data/E/크기변환_%C4%BF%C7%C7%B5%B9%C3%E2%B0%A3%C6%C7_%281%29_alto99kr.jpg_5.jpg,9064,480,640,103,518,621,218,306,True,16
E,120,kaist_dataset/English/Mobile_Phone/(E.M)A-outdoor/P090911085.jpg,char_data/E/P090911085.jpg_2.jpg,9480,480,640,79,375,454,117,237,True,16
E,127,kaist_dataset/English/Mobile_Phone/(E.M)C-bookCover/P090831037.jpg,char_data/E/P090831037.jpg_4.jpg,14097,480,640,111,382,493,62,189,True,16
E,148,kaist_dataset/English/Mobile_Phone/(E.M)C-bookCover/P090831037.jpg,char_data/E/P090831037.jpg_5.jpg,16132,480,640,109,512,621,186,334,True,16
E,68,kaist_dataset/English/Mobile_Phone/(E.M)C-bookCover/P090831075.jpg,char_data/E/P090831075.jpg_4.jpg,2652,480,640,39,268,307,159,227,True,16
E,63,kaist_dataset/English/Mobile_Phone/(E.M)C-bookCover/P090831075.jpg,char_data/E/P090831075.jpg_5.jpg,2205,480,640,35,313,348,282,345,True,16
E,48,kaist_dataset/English/Mobile_Phone/(E.M)C-bookCover/P090903015.jpg,char_data/E/P090903015.jpg_4.jpg,1680,480,640,35,420,455,75,123,True,16
E,51,kaist_dataset/English/Mobile_Phone/(E.M)C-bookCover/P090903015.jpg,char_data/E/P090903015.jpg_5.jpg,1938,480,640,38,336,374,142,193,True,16
E,60,kaist_dataset/English/Mobile_Phone/(E.M)C-bookCover/P090903041.jpg,char_data/E/P090903041.jpg_2.jpg,2400,480,640,40,287,327,23,83,True,16
E,78,kaist_dataset/English/Mobile_Phone/(E.M)C-bookCover/P090903050.jpg,char_data/E/P090903050.jpg_2.jpg,4602,480,640,59,317,376,5,83,True,16
E,92,kaist_dataset/English/Mobile_Phone/(E.M)C-bookCover/P090903054.jpg,char_data/E/P090903054.jpg_11.jpg,7268,480,640,79,352,431,220,312,True,16
E,51,kaist_dataset/English/Mobile_Phone/(E.M)C-bookCover/P090903054.jpg,char_data/E/P090903054.jpg_13.jpg,1887,480,640,37,331,368,354,405,True,16
E,56,kaist_dataset/English/Mobile_Phone/(E.M)C-bookCover/P090903054.jpg,char_data/E/P090903054.jpg_14.jpg,1512,480,640,27,557,584,350,406,True,16
E,40,kaist_dataset/English/Mobile_Phone/(E.M)C-bookCover/P090903055.jpg,char_data/E/P090903055.jpg_6.jpg,1640,480,640,41,369,410,71,111,True,16
E,82,kaist_dataset/English/Mobile_Phone/(E.M)C-bookCover/P090903055.jpg,char_data/E/P090903055.jpg_7.jpg,6724,480,640,82,217,299,160,242,True,16
E,31,kaist_dataset/English/Mobile_Phone/(E.M)C-bookCover/P090903055.jpg,char_data/E/P090903055.jpg_8.jpg,1054,480,640,34,223,257,412,443,True,16
E,38,kaist_dataset/English/Mobile_Phone/(E.M)C-bookCover/P090903056.jpg,char_data/E/P090903056.jpg_4.jpg,1064,480,640,28,369,397,205,243,True,16
E,85,kaist_dataset/English/Mobile_Phone/(E.M)C-bookCover/P090903056.jpg,char_data/E/P090903056.jpg_5.jpg,6970,480,640,82,202,284,305,390,True,16
E,75,kaist_dataset/English/Mobile_Phone/(E.M)C-bookCover/P090903071.jpg,char_data/E/P090903071.jpg_6.jpg,4125,480,640,55,286,341,147,222,True,16
E,67,kaist_dataset/English/Mobile_Phone/(E.M)C-bookCover/P090903071.jpg,char_data/E/P090903071.jpg_7.jpg,4020,480,640,60,466,526,233,300,True,16
E,38,kaist_dataset/English/Mobile_Phone/(E.M)C-bookCover/P090903071.jpg,char_data/E/P090903071.jpg_8.jpg,912,480,640,24,364,388,302,340,True,16
E,99,kaist_dataset/English/Mobile_Phone/(E.M)C-bookCover/P090903076.jpg,char_data/E/P090903076.jpg_6.jpg,7524,480,640,76,192,268,179,278,True,16
E,93,kaist_dataset/English/Mobile_Phone/(E.M)C-bookCover/P090903076.jpg,char_data/E/P090903076.jpg_7.jpg,6603,480,640,71,225,296,285,378,True,16
E,53,kaist_dataset/English/Mobile_Phone/(E.M)C-bookCover/P090903076.jpg,char_data/E/P090903076.jpg_8.jpg,1749,480,640,33,362,395,392,445,True,16
E,146,kaist_dataset/English/Mobile_Phone/(E.M)C-bookCover/P090903081.jpg,char_data/E/P090903081.jpg_2.jpg,11096,480,640,76,338,414,104,250,True,16
E,140,kaist_dataset/English/Mobile_Phone/(E.M)C-bookCover/P090903082.jpg,char_data/E/P090903082.jpg_2.jpg,15820,480,640,113,416,529,45,185,True,16
E,88,kaist_dataset/English/Mobile_Phone/(E.M)C-bookCover/P090905007.jpg,char_data/E/P090905007.jpg_6.jpg,4928,480,640,56,235,291,170,258,True,16
E,85,kaist_dataset/English/Mobile_Phone/(E.M)C-bookCover/P090905007.jpg,char_data/E/P090905007.jpg_7.jpg,4845,480,640,57,223,280,294,379,True,16
E,78,kaist_dataset/English/Mobile_Phone/(E.M)C-bookCover/P090905007.jpg,char_data/E/P090905007.jpg_8.jpg,4524,480,640,58,447,505,292,370,True,16
E,18,kaist_dataset/Korean/Digital_Camera/E-night/103.jpg,char_data/E/103.jpg_6.jpg,162,480,640,9,318,327,152,170,True,16
E,15,kaist_dataset/Korean/Digital_Camera/E-night/103.jpg,char_data/E/103.jpg_7.jpg,120,480,640,8,327,335,155,170,True,16
E,17,kaist_dataset/Korean/Digital_Camera/E-night/103.jpg,char_data/E/103.jpg_8.jpg,136,480,640,8,372,380,153,170,True,16
E,53,kaist_dataset/Korean/Digital_Camera/G-others/2007-12-08-day-112.jpg,char_data/E/2007-12-08-day-112.jpg_4.jpg,1325,1200,1600,25,616,641,600,653,True,16
E,17,kaist_dataset/Korean/Digital_Camera/indoor1/136.JPG,char_data/E/136.JPG_2.jpg,221,480,640,13,291,304,290,307,True,16
E,31,kaist_dataset/Korean/Digital_Camera/indoor1/2007-12-08-day-139.jpg,char_data/E/2007-12-08-day-139.jpg_2.jpg,496,1200,1600,16,518,534,356,387,True,16
E,29,kaist_dataset/Korean/Digital_Camera/outdoor1/001.JPG,char_data/E/001.JPG_13.jpg,377,480,640,13,450,463,234,263,True,16
E,32,kaist_dataset/Korean/Digital_Camera/outdoor2/2007-12-08-day-094.jpg,char_data/E/2007-12-08-day-094.jpg_2.jpg,736,1600,1200,23,649,672,1420,1452,True,16
E,25,kaist_dataset/Korean/Digital_Camera/outdoor2/2007-12-08-day-101.jpg,char_data/E/2007-12-08-day-101.jpg_5.jpg,375,1200,1600,15,183,198,1060,1085,True,16
E,44,kaist_dataset/Korean/Digital_Camera/outdoor2/2007-12-08-day-109.jpg,char_data/E/2007-12-08-day-109.jpg_2.jpg,1188,1200,1600,27,110,137,814,858,True,16
E,52,kaist_dataset/Korean/Digital_Camera/outdoor2/2007-12-09-day-exterior-006.jpg,char_data/E/2007-12-09-day-exterior-006.jpg_2.jpg,1300,1200,1600,25,1532,1557,576,628,True,16
E,73,kaist_dataset/Korean/Digital_Camera/outdoor2/2007-12-09-day-exterior-068.jpg,char_data/E/2007-12-09-day-exterior-068.jpg_2.jpg,3577,1200,1600,49,630,679,924,997,True,16
E,36,kaist_dataset/Korean/Digital_Camera/outdoor6/DSC04292.JPG,char_data/E/DSC04292.JPG_2.jpg,828,480,640,23,55,78,51,87,True,16
E,44,kaist_dataset/Mixed/Digital_Camera/(C.S)A-shadow/DSC02902.JPG,char_data/E/DSC02902.JPG_2.jpg,1496,480,640,34,404,438,367,411,True,16
E,32,kaist_dataset/Mixed/Digital_Camera/(C.S)A-shadow/P1010017.JPG,char_data/E/P1010017.JPG_2.jpg,832,480,640,26,47,73,130,162,True,16
E,36,kaist_dataset/Mixed/Digital_Camera/(C.S)B-light/DSC03298.JPG,char_data/E/DSC03298.JPG_2.jpg,432,480,640,12,327,339,286,322,True,16
E,61,kaist_dataset/Mixed/Digital_Camera/(C.S)C-outdoor1/014.JPG,char_data/E/014.JPG_8.jpg,2196,480,640,36,241,277,196,257,True,16
E,108,kaist_dataset/Mixed/Digital_Camera/(C.S)C-outdoor1/027.JPG,char_data/E/027.JPG_8.jpg,6264,480,640,58,376,434,163,271,True,16
E,78,kaist_dataset/Mixed/Digital_Camera/(C.S)C-outdoor1/046.JPG,char_data/E/046.JPG_4.jpg,4368,480,640,56,576,632,192,270,True,16
E,67,kaist_dataset/Mixed/Digital_Camera/(C.S)C-outdoor1/046.JPG,char_data/E/046.JPG_5.jpg,3953,480,640,59,208,267,204,271,True,16
E,33,kaist_dataset/Mixed/Digital_Camera/(C.S)C-outdoor1/048.JPG,char_data/E/048.JPG_2.jpg,825,480,640,25,207,232,254,287,True,16
E,25,kaist_dataset/Mixed/Digital_Camera/(C.S)C-outdoor1/054.JPG,char_data/E/054.JPG_4.jpg,625,480,640,25,544,569,278,303,True,16
E,22,kaist_dataset/Mixed/Digital_Camera/(C.S)C-outdoor1/054.JPG,char_data/E/054.JPG_5.jpg,374,480,640,17,404,421,308,330,True,16
E,58,kaist_dataset/Mixed/Digital_Camera/(C.S)C-outdoor1/080119-0006.jpg,char_data/E/080119-0006.jpg_2.jpg,2900,1200,1600,50,1075,1125,735,793,True,16
E,110,kaist_dataset/Mixed/Digital_Camera/(C.S)C-outdoor1/080119-0027.jpg,char_data/E/080119-0027.jpg_6.jpg,13310,1200,1600,121,338,459,471,581,True,16
E,77,kaist_dataset/Mixed/Digital_Camera/(C.S)C-outdoor1/080119-0027.jpg,char_data/E/080119-0027.jpg_7.jpg,3388,1200,1600,44,1073,1117,718,795,True,16
E,45,kaist_dataset/Mixed/Digital_Camera/(C.S)C-outdoor1/080119-0027.jpg,char_data/E/080119-0027.jpg_8.jpg,1260,1200,1600,28,976,1004,1055,1100,True,16
E,139,kaist_dataset/Mixed/Digital_Camera/(C.S)C-outdoor1/080119-0037.jpg,char_data/E/080119-0037.jpg_8.jpg,10147,1200,1600,73,321,394,873,1012,True,16
E,132,kaist_dataset/Mixed/Digital_Camera/(C.S)C-outdoor1/080119-0037.jpg,char_data/E/080119-0037.jpg_9.jpg,8844,1200,1600,67,516,583,866,998,True,16
E,114,kaist_dataset/Mixed/Digital_Camera/(C.S)C-outdoor1/080119-0037.jpg,char_data/E/080119-0037.jpg_10.jpg,6726,1200,1600,59,968,1027,851,965,True,16
E,117,kaist_dataset/Mixed/Digital_Camera/(C.S)C-outdoor1/080119-0037.jpg,char_data/E/080119-0037.jpg_11.jpg,8073,1200,1600,69,1432,1501,821,938,True,16
E,73,kaist_dataset/Mixed/Digital_Camera/(C.S)C-outdoor1/1.JPG,char_data/E/1.JPG_20.jpg,2847,576,768,39,258,297,195,268,True,16
E,69,kaist_dataset/Mixed/Digital_Camera/(C.S)C-outdoor1/1.JPG,char_data/E/1.JPG_21.jpg,2415,576,768,35,297,332,196,265,True,16
E,66,kaist_dataset/Mixed/Digital_Camera/(C.S)C-outdoor1/1.JPG,char_data/E/1.JPG_22.jpg,2310,576,768,35,437,472,202,268,True,16
E,63,kaist_dataset/Mixed/Digital_Camera/(C.S)C-outdoor1/1.JPG,char_data/E/1.JPG_23.jpg,2394,576,768,38,524,562,204,267,True,16
E,39,kaist_dataset/Mixed/Digital_Camera/(C.S)C-outdoor1/114.jpg,char_data/E/114.jpg_6.jpg,1092,480,640,28,352,380,268,307,True,16
E,39,kaist_dataset/Mixed/Digital_Camera/(C.S)C-outdoor1/114.jpg,char_data/E/114.jpg_7.jpg,1248,480,640,32,392,424,272,311,True,16
E,23,kaist_dataset/Mixed/Digital_Camera/(C.S)C-outdoor1/114.jpg,char_data/E/114.jpg_8.jpg,414,480,640,18,263,281,369,392,True,16
E,19,kaist_dataset/Mixed/Digital_Camera/(C.S)C-outdoor1/135.JPG,char_data/E/135.JPG_2.jpg,247,480,640,13,284,297,177,196,True,16
E,53,kaist_dataset/Mixed/Digital_Camera/(C.S)C-outdoor1/2007-12-08-day-130.jpg,char_data/E/2007-12-08-day-130.jpg_4.jpg,2067,1200,1600,39,1083,1122,708,761,True,16
E,44,kaist_dataset/Mixed/Digital_Camera/(C.S)C-outdoor1/2007-12-08-day-130.jpg,char_data/E/2007-12-08-day-130.jpg_5.jpg,1320,1200,1600,30,872,902,749,793,True,16
E,89,kaist_dataset/Mixed/Digital_Camera/(C.S)C-outdoor1/2007-12-09-day-exterior-044.jpg,char_data/E/2007-12-09-day-exterior-044.jpg_4.jpg,9345,1200,1600,105,287,392,327,416,True,16
E,77,kaist_dataset/Mixed/Digital_Camera/(C.S)C-outdoor1/2007-12-09-day-exterior-044.jpg,char_data/E/2007-12-09-day-exterior-044.jpg_5.jpg,4389,1200,1600,57,1228,1285,971,1048,True,16
E,78,kaist_dataset/Mixed/Digital_Camera/(C.S)C-outdoor1/2007-12-09-day-exterior-051.jpg,char_data/E/2007-12-09-day-exterior-051.jpg_12.jpg,6318,1200,1600,81,522,603,382,460,True,16
E,28,kaist_dataset/Mixed/Digital_Camera/(C.S)C-outdoor1/2007-12-09-day-exterior-051.jpg,char_data/E/2007-12-09-day-exterior-051.jpg_13.jpg,504,1200,1600,18,524,542,643,671,True,16
E,30,kaist_dataset/Mixed/Digital_Camera/(C.S)C-outdoor1/2007-12-09-day-exterior-051.jpg,char_data/E/2007-12-09-day-exterior-051.jpg_14.jpg,540,1200,1600,18,542,560,643,673,True,16
E,26,kaist_dataset/Mixed/Digital_Camera/(C.S)C-outdoor1/2007-12-09-day-exterior-051.jpg,char_data/E/2007-12-09-day-exterior-051.jpg_15.jpg,442,1200,1600,17,583,600,611,637,True,16
E,25,kaist_dataset/Mixed/Digital_Camera/(C.S)C-outdoor1/2007-12-09-day-exterior-051.jpg,char_data/E/2007-12-09-day-exterior-051.jpg_16.jpg,525,1200,1600,21,600,621,611,636,True,16
E,60,kaist_dataset/Mixed/Digital_Camera/(C.S)C-outdoor1/2007-12-09-day-exterior-051.jpg,char_data/E/2007-12-09-day-exterior-051.jpg_17.jpg,2040,1200,1600,34,282,316,918,978,True,16
E,54,kaist_dataset/Mixed/Digital_Camera/(C.S)C-outdoor1/3.JPG,char_data/E/3.JPG_8.jpg,1944,576,768,36,317,353,229,283,True,16
E,44,kaist_dataset/Mixed/Digital_Camera/(C.S)C-outdoor1/3.JPG,char_data/E/3.JPG_9.jpg,1056,576,768,24,681,705,418,462,True,16
E,26,kaist_dataset/Mixed/Digital_Camera/(C.S)C-outdoor1/3.JPG,char_data/E/3.JPG_10.jpg,260,576,768,10,580,590,293,319,True,16
E,14,kaist_dataset/Mixed/Digital_Camera/(C.S)C-outdoor1/3.JPG,char_data/E/3.JPG_11.jpg,98,576,768,7,107,114,293,307,True,16
E,51,kaist_dataset/Mixed/Digital_Camera/(C.S)C-outdoor1/P1010009.JPG,char_data/E/P1010009.JPG_4.jpg,1989,480,640,39,154,193,186,237,True,16
E,46,kaist_dataset/Mixed/Digital_Camera/(C.S)C-outdoor1/P1010009.JPG,char_data/E/P1010009.JPG_5.jpg,1656,480,640,36,484,520,198,244,True,16
E,55,kaist_dataset/Mixed/Digital_Camera/(C.S)C-outdoor2/DSC02359.JPG,char_data/E/DSC02359.JPG_2.jpg,990,480,640,18,177,195,409,464,True,16
E,39,kaist_dataset/Mixed/Digital_Camera/(C.S)C-outdoor2/DSC02368.JPG,char_data/E/DSC02368.JPG_2.jpg,585,480,640,15,90,105,382,421,True,16
E,39,kaist_dataset/Mixed/Digital_Camera/(C.S)C-outdoor2/DSC02377.JPG,char_data/E/DSC02377.JPG_2.jpg,546,480,640,14,380,394,353,392,True,16
E,73,kaist_dataset/Mixed/Digital_Camera/(C.S)C-outdoor2/DSC02385.JPG,char_data/E/DSC02385.JPG_4.jpg,4015,480,640,55,451,506,166,239,True,16
E,40,kaist_dataset/Mixed/Digital_Camera/(C.S)C-outdoor2/DSC02391.JPG,char_data/E/DSC02391.JPG_4.jpg,960,480,640,24,280,304,331,371,True,16
E,32,kaist_dataset/Mixed/Digital_Camera/(C.S)C-outdoor2/DSC02391.JPG,char_data/E/DSC02391.JPG_5.jpg,896,480,640,28,339,367,333,365,True,16
E,32,kaist_dataset/Mixed/Digital_Camera/(C.S)C-outdoor2/DSC02397.JPG,char_data/E/DSC02397.JPG_6.jpg,576,480,640,18,25,43,141,173,True,16
E,21,kaist_dataset/Mixed/Digital_Camera/(C.S)C-outdoor2/DSC02397.JPG,char_data/E/DSC02397.JPG_7.jpg,294,480,640,14,45,59,144,165,True,16
E,140,kaist_dataset/Mixed/Digital_Camera/(C.S)C-outdoor2/DSC02397.JPG,char_data/E/DSC02397.JPG_8.jpg,17220,480,640,123,165,288,295,435,True,16
E,41,kaist_dataset/Mixed/Digital_Camera/(C.S)C-outdoor2/DSC02419.JPG,char_data/E/DSC02419.JPG_2.jpg,1025,480,640,25,31,56,199,240,True,16
E,58,kaist_dataset/Mixed/Digital_Camera/(C.S)C-outdoor2/DSC02439.JPG,char_data/E/DSC02439.JPG_4.jpg,3480,480,640,60,392,452,137,195,True,16
E,25,kaist_dataset/Mixed/Digital_Camera/(C.S)C-outdoor2/DSC02477.JPG,char_data/E/DSC02477.JPG_2.jpg,300,480,640,12,87,99,157,182,True,16
E,27,kaist_dataset/Mixed/Digital_Camera/(C.S)C-outdoor2/DSC02483.JPG,char_data/E/DSC02483.JPG_2.jpg,621,480,640,23,273,296,152,179,True,16
E,46,kaist_dataset/Mixed/Digital_Camera/(C.S)C-outdoor2/DSC02511.JPG,char_data/E/DSC02511.JPG_11.jpg,690,480,640,15,193,208,393,439,True,16
E,29,kaist_dataset/Mixed/Digital_Camera/(C.S)C-outdoor2/DSC02545.JPG,char_data/E/DSC02545.JPG_4.jpg,870,480,640,30,43,73,371,400,True,16
E,23,kaist_dataset/Mixed/Digital_Camera/(C.S)C-outdoor2/DSC02555.JPG,char_data/E/DSC02555.JPG_2.jpg,391,480,640,17,93,110,153,176,True,16
E,64,kaist_dataset/Mixed/Digital_Camera/(C.S)C-outdoor2/DSC02866.JPG,char_data/E/DSC02866.JPG_2.jpg,2816,480,640,44,506,550,111,175,True,16
E,23,kaist_dataset/Mixed/Digital_Camera/(C.S)C-outdoor2/DSC02879.JPG,char_data/E/DSC02879.JPG_2.jpg,253,480,640,11,243,254,288,311,True,16
E,35,kaist_dataset/Mixed/Digital_Camera/(C.S)C-outdoor2/DSC02890.JPG,char_data/E/DSC02890.JPG_2.jpg,735,480,640,21,241,262,404,439,True,16
E,33,kaist_dataset/Mixed/Digital_Camera/(C.S)C-outdoor2/DSC02910.JPG,char_data/E/DSC02910.JPG_2.jpg,627,480,640,19,394,413,59,92,True,16
E,49,kaist_dataset/Mixed/Digital_Camera/(C.S)C-outdoor2/DSC02924.JPG,char_data/E/DSC02924.JPG_6.jpg,1225,480,640,25,189,214,315,364,True,16
E,51,kaist_dataset/Mixed/Digital_Camera/(C.S)C-outdoor2/DSC02924.JPG,char_data/E/DSC02924.JPG_7.jpg,1224,480,640,24,363,387,317,368,True,16
E,39,kaist_dataset/Mixed/Digital_Camera/(C.S)C-outdoor2/DSC02924.JPG,char_data/E/DSC02924.JPG_8.jpg,1053,480,640,27,460,487,331,370,True,16
E,51,kaist_dataset/Mixed/Digital_Camera/(C.S)C-outdoor3/DSC03010.JPG,char_data/E/DSC03010.JPG_4.jpg,1173,480,640,23,358,381,89,140,True,16
E,55,kaist_dataset/Mixed/Digital_Camera/(C.S)C-outdoor3/DSC03010.JPG,char_data/E/DSC03010.JPG_5.jpg,1705,480,640,31,474,505,66,121,True,16
E,37,kaist_dataset/Mixed/Digital_Camera/(C.S)C-outdoor3/DSC03020.JPG,char_data/E/DSC03020.JPG_6.jpg,851,480,640,23,346,369,263,300,True,16
E,45,kaist_dataset/Mixed/Digital_Camera/(C.S)C-outdoor3/DSC03020.JPG,char_data/E/DSC03020.JPG_7.jpg,1035,480,640,23,605,628,261,306,True,16
E,26,kaist_dataset/Mixed/Digital_Camera/(C.S)C-outdoor3/DSC03033.JPG,char_data/E/DSC03033.JPG_6.jpg,312,480,640,12,43,55,130,156,True,16
E,25,kaist_dataset/Mixed/Digital_Camera/(C.S)C-outdoor3/DSC03033.JPG,char_data/E/DSC03033.JPG_7.jpg,300,480,640,12,55,67,131,156,True,16
E,22,kaist_dataset/Mixed/Digital_Camera/(C.S)C-outdoor3/DSC03033.JPG,char_data/E/DSC03033.JPG_8.jpg,264,480,640,12,85,97,154,176,True,16
E,41,kaist_dataset/Mixed/Digital_Camera/(C.S)C-outdoor3/DSC03035.JPG,char_data/E/DSC03035.JPG_2.jpg,861,480,640,21,263,284,398,439,True,16
E,70,kaist_dataset/Mixed/Digital_Camera/(C.S)C-outdoor3/DSC03048.JPG,char_data/E/DSC03048.JPG_2.jpg,2870,480,640,41,218,259,133,203,True,16
E,106,kaist_dataset/Mixed/Digital_Camera/(C.S)C-outdoor3/DSC03176.JPG,char_data/E/DSC03176.JPG_2.jpg,7950,480,640,75,310,385,261,367,True,16
E,88,kaist_dataset/Mixed/Digital_Camera/(C.S)C-outdoor3/DSC03217.JPG,char_data/E/DSC03217.JPG_2.jpg,6336,480,640,72,260,332,239,327,True,16
E,41,kaist_dataset/Mixed/Digital_Camera/(C.S)C-outdoor3/DSC03233.JPG,char_data/E/DSC03233.JPG_2.jpg,1271,480,640,31,83,114,246,287,True,16
E,63,kaist_dataset/Mixed/Digital_Camera/(C.S)C-outdoor3/DSC03283.JPG,char_data/E/DSC03283.JPG_2.jpg,2142,480,640,34,426,460,66,129,True,16
E,75,kaist_dataset/Mixed/Digital_Camera/(C.S)C-outdoor3/DSC03415.JPG,char_data/E/DSC03415.JPG_2.jpg,3450,480,640,46,258,304,157,232,True,16
E,57,kaist_dataset/Mixed/Digital_Camera/(C.S)C-outdoor3/DSC03428.JPG,char_data/E/DSC03428.JPG_2.jpg,1482,480,640,26,155,181,314,371,True,16
E,32,kaist_dataset/Mixed/Digital_Camera/(C.S)C-outdoor3/DSC03430.JPG,char_data/E/DSC03430.JPG_2.jpg,448,480,640,14,211,225,241,273,True,16
E,56,kaist_dataset/Mixed/Digital_Camera/(C.S)C-outdoor4/DSC03433.JPG,char_data/E/DSC03433.JPG_2.jpg,1456,480,640,26,120,146,379,435,True,16
E,43,kaist_dataset/Mixed/Digital_Camera/(C.S)C-outdoor4/DSC03617.JPG,char_data/E/DSC03617.JPG_2.jpg,817,480,640,19,140,159,384,427,True,16
E,34,kaist_dataset/Mixed/Digital_Camera/(C.S)C-outdoor4/DSC03640.JPG,char_data/E/DSC03640.JPG_2.jpg,578,480,640,17,113,130,400,434,True,16
E,25,kaist_dataset/Mixed/Digital_Camera/(C.S)C-outdoor4/DSC03642.JPG,char_data/E/DSC03642.JPG_11.jpg,400,480,640,16,393,409,400,425,True,16
E,76,kaist_dataset/Mixed/Digital_Camera/(C.S)C-outdoor4/DSC03652.JPG,char_data/E/DSC03652.JPG_4.jpg,4408,480,640,58,233,291,184,260,True,16
E,85,kaist_dataset/Mixed/Digital_Camera/(C.S)C-outdoor4/DSC03652.JPG,char_data/E/DSC03652.JPG_5.jpg,4420,480,640,52,345,397,176,261,True,16
E,54,kaist_dataset/Mixed/Digital_Camera/(C.S)C-outdoor4/DSC03655.JPG,char_data/E/DSC03655.JPG_2.jpg,972,480,640,18,181,199,385,439,True,16
E,61,kaist_dataset/Mixed/Digital_Camera/(C.S)C-outdoor4/DSC03661.JPG,char_data/E/DSC03661.JPG_6.jpg,2623,480,640,43,417,460,244,305,True,16
E,27,kaist_dataset/Mixed/Digital_Camera/(C.S)C-outdoor4/DSC03661.JPG,char_data/E/DSC03661.JPG_8.jpg,270,480,640,10,355,365,337,364,True,16
E,70,kaist_dataset/Mixed/Digital_Camera/(C.S)C-outdoor4/DSC03673.JPG,char_data/E/DSC03673.JPG_2.jpg,2940,480,640,42,411,453,171,241,True,16
E,30,kaist_dataset/Mixed/Digital_Camera/(C.S)C-outdoor4/DSC03676.JPG,char_data/E/DSC03676.JPG_2.jpg,420,480,640,14,40,54,268,298,True,16
E,42,kaist_dataset/Mixed/Digital_Camera/(C.S)C-outdoor4/DSC03678.JPG,char_data/E/DSC03678.JPG_2.jpg,882,480,640,21,198,219,238,280,True,16
E,27,kaist_dataset/Mixed/Digital_Camera/(C.S)C-outdoor4/DSC03687.JPG,char_data/E/DSC03687.JPG_2.jpg,351,480,640,13,131,144,296,323,True,16
E,59,kaist_dataset/Mixed/Digital_Camera/(C.S)C-outdoor4/DSC03707.JPG,char_data/E/DSC03707.JPG_6.jpg,2006,480,640,34,210,244,84,143,True,16
E,48,kaist_dataset/Mixed/Digital_Camera/(C.S)C-outdoor4/DSC03707.JPG,char_data/E/DSC03707.JPG_7.jpg,1584,480,640,33,244,277,90,138,True,16
E,59,kaist_dataset/Mixed/Digital_Camera/(C.S)C-outdoor4/DSC03707.JPG,char_data/E/DSC03707.JPG_8.jpg,2183,480,640,37,332,369,142,201,True,16
E,42,kaist_dataset/Mixed/Digital_Camera/(C.S)C-outdoor4/DSC03711.JPG,char_data/E/DSC03711.JPG_6.jpg,924,480,640,22,42,64,388,430,True,16
E,40,kaist_dataset/Mixed/Digital_Camera/(C.S)C-outdoor4/DSC03711.JPG,char_data/E/DSC03711.JPG_7.jpg,800,480,640,20,117,137,390,430,True,16
E,53,kaist_dataset/Mixed/Digital_Camera/(C.S)C-outdoor4/DSC03711.JPG,char_data/E/DSC03711.JPG_8.jpg,1590,480,640,30,194,224,380,433,True,16
E,32,kaist_dataset/Mixed/Digital_Camera/(C.S)C-outdoor4/DSC03716.JPG,char_data/E/DSC03716.JPG_2.jpg,352,480,640,11,363,374,239,271,True,16
E,65,kaist_dataset/Mixed/Digital_Camera/(C.S)C-outdoor4/DSC03756.JPG,char_data/E/DSC03756.JPG_2.jpg,2795,480,640,43,193,236,387,452,True,16
E,31,kaist_dataset/Mixed/Digital_Camera/(C.S)C-outdoor4/DSC03764.JPG,char_data/E/DSC03764.JPG_8.jpg,713,480,640,23,225,248,234,265,True,16
E,36,kaist_dataset/Mixed/Digital_Camera/(C.S)C-outdoor4/DSC03764.JPG,char_data/E/DSC03764.JPG_9.jpg,864,480,640,24,247,271,234,270,True,16
E,43,kaist_dataset/Mixed/Digital_Camera/(C.S)C-outdoor4/DSC03764.JPG,char_data/E/DSC03764.JPG_10.jpg,903,480,640,21,325,346,223,266,True,16
E,35,kaist_dataset/Mixed/Digital_Camera/(C.S)C-outdoor4/DSC03764.JPG,char_data/E/DSC03764.JPG_11.jpg,875,480,640,25,346,371,231,266,True,16
E,39,kaist_dataset/Mixed/Digital_Camera/(C.S)C-outdoor4/DSC03781.JPG,char_data/E/DSC03781.JPG_7.jpg,1989,480,640,51,180,231,267,306,True,16
E,31,kaist_dataset/Mixed/Digital_Camera/(C.S)C-outdoor5/DSC03829.JPG,char_data/E/DSC03829.JPG_4.jpg,558,480,640,18,343,361,179,210,True,16
E,32,kaist_dataset/Mixed/Digital_Camera/(C.S)C-outdoor5/DSC03829.JPG,char_data/E/DSC03829.JPG_5.jpg,576,480,640,18,387,405,177,209,True,16
E,138,kaist_dataset/Mixed/Digital_Camera/(C.S)C-outdoor5/DSC03830.JPG,char_data/E/DSC03830.JPG_4.jpg,16146,480,640,117,289,406,123,261,True,16
E,143,kaist_dataset/Mixed/Digital_Camera/(C.S)C-outdoor5/DSC03830.JPG,char_data/E/DSC03830.JPG_5.jpg,15444,480,640,108,402,510,110,253,True,16
E,26,kaist_dataset/Mixed/Digital_Camera/(C.S)C-outdoor5/DSC04031.JPG,char_data/E/DSC04031.JPG_2.jpg,364,480,640,14,124,138,379,405,False,16
E,48,kaist_dataset/Mixed/Digital_Camera/(C.S)C-outdoor5/DSC04048.JPG,char_data/E/DSC04048.JPG_2.jpg,1920,480,640,40,51,91,138,186,False,16
E,63,kaist_dataset/Mixed/Digital_Camera/(C.S)C-outdoor5/DSC04054.JPG,char_data/E/DSC04054.JPG_2.jpg,2898,480,640,46,204,250,66,129,False,16
E,54,kaist_dataset/Mixed/Digital_Camera/(C.S)C-outdoor5/DSC04055.JPG,char_data/E/DSC04055.JPG_2.jpg,2322,480,640,43,356,399,177,231,False,16
E,61,kaist_dataset/Mixed/Digital_Camera/(C.S)C-outdoor5/DSC04059.JPG,char_data/E/DSC04059.JPG_4.jpg,1769,480,640,29,460,489,117,178,False,16
E,64,kaist_dataset/Mixed/Digital_Camera/(C.S)C-outdoor5/DSC04059.JPG,char_data/E/DSC04059.JPG_5.jpg,2048,480,640,32,540,572,117,181,False,16
E,53,kaist_dataset/Mixed/Digital_Camera/(C.S)C-outdoor5/DSC04060.JPG,char_data/E/DSC04060.JPG_2.jpg,1855,480,640,35,416,451,176,229,False,16
E,40,kaist_dataset/Mixed/Digital_Camera/(C.S)C-outdoor5/DSC04065.JPG,char_data/E/DSC04065.JPG_2.jpg,1040,480,640,26,533,559,143,183,False,16
E,37,kaist_dataset/Mixed/Digital_Camera/(C.S)C-outdoor5/DSC04070.JPG,char_data/E/DSC04070.JPG_5.jpg,592,480,640,16,306,322,107,144,False,16
E,40,kaist_dataset/Mixed/Digital_Camera/(C.S)C-outdoor5/DSC04098.JPG,char_data/E/DSC04098.JPG_2.jpg,1240,480,640,31,286,317,71,111,False,16
E,51,kaist_dataset/Mixed/Digital_Camera/(C.S)C-outdoor5/DSC04129.JPG,char_data/E/DSC04129.JPG_7.jpg,1275,480,640,25,221,246,370,421,False,16
E,45,kaist_dataset/Mixed/Digital_Camera/(C.S)C-outdoor5/DSC04129.JPG,char_data/E/DSC04129.JPG_8.jpg,1485,480,640,33,403,436,375,420,False,16
E,42,kaist_dataset/Mixed/Digital_Camera/(C.S)C-outdoor5/DSC04139.JPG,char_data/E/DSC04139.JPG_2.jpg,1260,480,640,30,364,394,92,134,False,16
E,105,kaist_dataset/Mixed/Digital_Camera/(C.S)C-outdoor5/DSC04151.JPG,char_data/E/DSC04151.JPG_5.jpg,8820,480,640,84,334,418,238,343,False,16
E,36,kaist_dataset/Mixed/Digital_Camera/(C.S)C-outdoor5/DSC04290.JPG,char_data/E/DSC04290.JPG_2.jpg,756,480,640,21,52,73,376,412,False,16
E,44,kaist_dataset/Mixed/Digital_Camera/(C.S)C-outdoor5/DSC04305.JPG,char_data/E/DSC04305.JPG_2.jpg,1276,480,640,29,549,578,84,128,False,16
E,34,kaist_dataset/Mixed/Digital_Camera/(C.S)C-outdoor5/DSC04314.JPG,char_data/E/DSC04314.JPG_4.jpg,850,480,640,25,374,399,172,206,False,16
E,40,kaist_dataset/Mixed/Digital_Camera/(C.S)C-outdoor5/DSC04314.JPG,char_data/E/DSC04314.JPG_5.jpg,1160,480,640,29,470,499,166,206,False,16
E,44,kaist_dataset/Mixed/Digital_Camera/(C.S)C-outdoor5/DSC04322.JPG,char_data/E/DSC04322.JPG_9.jpg,1232,480,640,28,213,241,216,260,False,16
E,44,kaist_dataset/Mixed/Digital_Camera/(C.S)C-outdoor5/DSC04338.JPG,char_data/E/DSC04338.JPG_4.jpg,792,480,640,18,140,158,193,237,False,16
E,62,kaist_dataset/Mixed/Digital_Camera/(C.S)C-outdoor5/DSC04349.JPG,char_data/E/DSC04349.JPG_2.jpg,1550,480,640,25,470,495,304,366,False,16
E,38,kaist_dataset/Mixed/Digital_Camera/(C.S)C-outdoor5/DSC04360.JPG,char_data/E/DSC04360.JPG_2.jpg,1064,480,640,28,49,77,338,376,False,16
E,82,kaist_dataset/Mixed/Digital_Camera/(C.S)C-outdoor5/DSC04368.JPG,char_data/E/DSC04368.JPG_2.jpg,3362,480,640,41,215,256,267,349,False,16
E,67,kaist_dataset/Mixed/Digital_Camera/(C.S)C-outdoor5/DSC04450.JPG,char_data/E/DSC04450.JPG_8.jpg,2010,480,640,30,98,128,51,118,False,16
E,69,kaist_dataset/Mixed/Digital_Camera/(C.S)C-outdoor5/DSC04450.JPG,char_data/E/DSC04450.JPG_9.jpg,1863,480,640,27,164,191,51,120,False,16
E,64,kaist_dataset/Mixed/Digital_Camera/(C.S)C-outdoor5/DSC04450.JPG,char_data/E/DSC04450.JPG_10.jpg,2112,480,640,33,90,123,261,325,False,16
E,69,kaist_dataset/Mixed/Digital_Camera/(C.S)C-outdoor5/DSC04450.JPG,char_data/E/DSC04450.JPG_11.jpg,1932,480,640,28,159,187,261,330,False,16
E,98,kaist_dataset/Mixed/Digital_Camera/(C.S)C-outdoor5/DSC04465.JPG,char_data/E/DSC04465.JPG_2.jpg,5096,480,640,52,417,469,289,387,False,16
E,45,kaist_dataset/Mixed/Digital_Camera/(C.S)C-outdoor5/P1010007.JPG,char_data/E/P1010007.JPG_2.jpg,990,480,640,22,206,228,271,316,False,16
E,25,kaist_dataset/Mixed/Digital_Camera/(C.S)C-outdoor6/P1010063.JPG,char_data/E/P1010063.JPG_16.jpg,250,480,640,10,279,289,414,439,False,16
E,27,kaist_dataset/Mixed/Digital_Camera/(C.S)C-outdoor6/P1010063.JPG,char_data/E/P1010063.JPG_17.jpg,297,480,640,11,329,340,390,417,False,16
E,19,kaist_dataset/Mixed/Digital_Camera/(C.S)C-outdoor6/P1010063.JPG,char_data/E/P1010063.JPG_18.jpg,228,480,640,12,412,424,362,381,False,16
E,19,kaist_dataset/Mixed/Digital_Camera/(C.S)C-outdoor6/P1010063.JPG,char_data/E/P1010063.JPG_19.jpg,171,480,640,9,469,478,338,357,False,16
E,24,kaist_dataset/Mixed/Digital_Camera/(C.S)C-outdoor6/P1010063.JPG,char_data/E/P1010063.JPG_20.jpg,360,480,640,15,478,493,330,354,False,16
E,55,kaist_dataset/Mixed/Digital_Camera/(C.S)C-outdoor6/P1010063.JPG,char_data/E/P1010063.JPG_21.jpg,2145,480,640,39,212,251,372,427,False,16
E,57,kaist_dataset/Mixed/Digital_Camera/(C.S)C-outdoor6/P1010063.JPG,char_data/E/P1010063.JPG_22.jpg,2052,480,640,36,410,446,288,345,False,16
E,54,kaist_dataset/Mixed/Digital_Camera/(C.S)C-outdoor6/P1010063.JPG,char_data/E/P1010063.JPG_23.jpg,1836,480,640,34,445,479,278,332,False,16
E,22,kaist_dataset/Mixed/Digital_Camera/(C.S)C-outdoor6/P1010065.JPG,char_data/E/P1010065.JPG_13.jpg,242,480,640,11,94,105,106,128,False,16
E,21,kaist_dataset/Mixed/Digital_Camera/(C.S)C-outdoor6/P1010065.JPG,char_data/E/P1010065.JPG_14.jpg,231,480,640,11,152,163,108,129,False,16
E,29,kaist_dataset/Mixed/Digital_Camera/(C.S)C-outdoor6/P1010082.JPG,char_data/E/P1010082.JPG_2.jpg,406,480,640,14,138,152,230,259,False,16
E,38,kaist_dataset/Mixed/Digital_Camera/(C.S)C-outdoor6/P1010088.JPG,char_data/E/P1010088.JPG_6.jpg,722,480,640,19,472,491,170,208,False,16
E,32,kaist_dataset/Mixed/Digital_Camera/(C.S)C-outdoor6/P1010088.JPG,char_data/E/P1010088.JPG_7.jpg,576,480,640,18,530,548,175,207,False,16
E,32,kaist_dataset/Mixed/Digital_Camera/(C.S)C-outdoor6/P1010088.JPG,char_data/E/P1010088.JPG_8.jpg,544,480,640,17,261,278,218,250,False,16
E,34,kaist_dataset/Mixed/Digital_Camera/(C.S)C-outdoor6/P1010090.JPG,char_data/E/P1010090.JPG_2.jpg,680,480,640,20,392,412,198,232,False,16
E,22,kaist_dataset/Mixed/Digital_Camera/(C.S)C-outdoor6/P1010114.JPG,char_data/E/P1010114.JPG_4.jpg,330,480,640,15,237,252,219,241,False,16
E,23,kaist_dataset/Mixed/Digital_Camera/(C.S)C-outdoor6/P1010114.JPG,char_data/E/P1010114.JPG_5.jpg,437,480,640,19,369,388,222,245,False,16
E,32,kaist_dataset/Mixed/Digital_Camera/(C.S)C-outdoor6/크기변환_fadscf0009_creawell.jpg,char_data/E/크기변환_fadscf0009_creawell.jpg_2.jpg,576,480,640,18,232,250,153,185,False,16
E,45,kaist_dataset/Mixed/Digital_Camera/(C.S)D-indoor1/DSC02714.JPG,char_data/E/DSC02714.JPG_4.jpg,1800,480,640,40,183,223,71,116,False,16
E,77,kaist_dataset/Mixed/Digital_Camera/(C.S)D-indoor1/DSC02714.JPG,char_data/E/DSC02714.JPG_5.jpg,6160,480,640,80,220,300,114,191,False,16
E,86,kaist_dataset/Mixed/Digital_Camera/(C.S)D-indoor1/DSC02756.JPG,char_data/E/DSC02756.JPG_4.jpg,4558,480,640,53,61,114,182,268,False,16
E,32,kaist_dataset/Mixed/Digital_Camera/(C.S)D-indoor1/DSC02756.JPG,char_data/E/DSC02756.JPG_5.jpg,800,480,640,25,337,362,145,177,False,16
E,41,kaist_dataset/Mixed/Digital_Camera/(C.S)D-indoor1/DSC02787.JPG,char_data/E/DSC02787.JPG_7.jpg,738,480,640,18,231,249,371,412,False,16
E,120,kaist_dataset/Mixed/Digital_Camera/(C.S)D-indoor1/DSC02840.JPG,char_data/E/DSC02840.JPG_2.jpg,9480,480,640,79,296,375,117,237,False,16
E,73,kaist_dataset/Mixed/Digital_Camera/(C.S)D-indoor1/DSC03479.JPG,char_data/E/DSC03479.JPG_2.jpg,2555,480,640,35,40,75,288,361,False,16
E,49,kaist_dataset/Mixed/Digital_Camera/(C.S)D-indoor1/DSC03483.JPG,char_data/E/DSC03483.JPG_2.jpg,1323,480,640,27,241,268,368,417,False,16
E,77,kaist_dataset/Mixed/Digital_Camera/(C.S)D-indoor1/DSC03500.JPG,char_data/E/DSC03500.JPG_4.jpg,5082,480,640,66,107,173,102,179,False,16
E,74,kaist_dataset/Mixed/Digital_Camera/(C.S)D-indoor1/DSC03500.JPG,char_data/E/DSC03500.JPG_5.jpg,3700,480,640,50,334,384,103,177,False,16
E,108,kaist_dataset/Mixed/Digital_Camera/(C.S)D-indoor1/DSC03890.JPG,char_data/E/DSC03890.JPG_2.jpg,7668,480,640,71,513,584,239,347,False,16
E,39,kaist_dataset/Mixed/Digital_Camera/(C.S)D-indoor1/DSC03904.JPG,char_data/E/DSC03904.JPG_4.jpg,624,480,640,16,329,345,212,251,False,16
E,40,kaist_dataset/Mixed/Digital_Camera/(C.S)D-indoor1/DSC03904.JPG,char_data/E/DSC03904.JPG_5.jpg,800,480,640,20,408,428,212,252,False,16
E,35,kaist_dataset/Mixed/Digital_Camera/(C.S)D-indoor1/DSC03959.JPG,char_data/E/DSC03959.JPG_4.jpg,770,480,640,22,348,370,185,220,False,16
E,30,kaist_dataset/Mixed/Digital_Camera/(C.S)D-indoor1/DSC03959.JPG,char_data/E/DSC03959.JPG_5.jpg,720,480,640,24,370,394,187,217,False,16
E,38,kaist_dataset/Mixed/Digital_Camera/(C.S)D-indoor1/DSC03980.JPG,char_data/E/DSC03980.JPG_2.jpg,608,480,640,16,219,235,135,173,False,16
E,61,kaist_dataset/Mixed/Digital_Camera/(C.S)D-indoor1/DSC04009.JPG,char_data/E/DSC04009.JPG_2.jpg,2013,480,640,33,202,235,397,458,False,16
E,179,kaist_dataset/Mixed/Digital_Camera/(C.S)D-indoor1/DSC04223.JPG,char_data/E/DSC04223.JPG_2.jpg,17184,480,640,96,310,406,6,185,False,16
E,142,kaist_dataset/Mixed/Digital_Camera/(C.S)D-indoor1/DSC04233.JPG,char_data/E/DSC04233.JPG_2.jpg,15336,480,640,108,213,321,17,159,False,16
E,36,kaist_dataset/Mixed/Digital_Camera/(C.S)D-indoor2/DSC04254.JPG,char_data/E/DSC04254.JPG_9.jpg,828,480,640,23,322,345,339,375,False,16
E,51,kaist_dataset/Mixed/Digital_Camera/(C.S)D-indoor2/DSC04421.JPG,char_data/E/DSC04421.JPG_4.jpg,1428,480,640,28,172,200,209,260,False,16
E,78,kaist_dataset/Mixed/Digital_Camera/(C.S)D-indoor2/크기변환_P1010030.JPG,char_data/E/크기변환_P1010030.JPG_4.jpg,3978,480,640,51,314,365,123,201,False,16
E,68,kaist_dataset/Mixed/Digital_Camera/(C.S)D-indoor2/크기변환_P1010030.JPG,char_data/E/크기변환_P1010030.JPG_5.jpg,3196,480,640,47,415,462,131,199,False,16
E,33,kaist_dataset/Mixed/Digital_Camera/(C.S)E-night/DSC02569.JPG,char_data/E/DSC02569.JPG_12.jpg,792,480,640,24,330,354,272,305,False,16
E,47,kaist_dataset/Mixed/Digital_Camera/(C.S)E-night/DSC02595.JPG,char_data/E/DSC02595.JPG_2.jpg,2444,480,640,52,302,354,352,399,False,16
E,172,kaist_dataset/Mixed/Digital_Camera/(C.S)E-night/DSC02602.JPG,char_data/E/DSC02602.JPG_2.jpg,18576,480,640,108,470,578,146,318,False,16
E,31,kaist_dataset/Mixed/Digital_Camera/(C.S)E-night/DSC02660.JPG,char_data/E/DSC02660.JPG_2.jpg,496,480,640,16,265,281,384,415,False,16
E,44,kaist_dataset/Mixed/Digital_Camera/(C.S)E-night/DSC02672.JPG,char_data/E/DSC02672.JPG_4.jpg,1056,480,640,24,334,358,171,215,False,16
E,46,kaist_dataset/Mixed/Digital_Camera/(C.S)E-night/DSC02672.JPG,char_data/E/DSC02672.JPG_5.jpg,1104,480,640,24,544,568,174,220,False,16
E,43,kaist_dataset/Mixed/Digital_Camera/(C.S)E-night/DSC02673.JPG,char_data/E/DSC02673.JPG_2.jpg,430,480,640,10,257,267,304,347,False,16
E,36,kaist_dataset/Mixed/Digital_Camera/(C.S)E-night/DSC02903.JPG,char_data/E/DSC02903.JPG_2.jpg,864,480,640,24,266,290,264,300,False,16
E,70,kaist_dataset/Mixed/Digital_Camera/(C.S)E-night/DSC03031.JPG,char_data/E/DSC03031.JPG_13.jpg,3570,480,640,51,179,230,67,137,False,16
E,71,kaist_dataset/Mixed/Digital_Camera/(C.S)E-night/DSC03031.JPG,char_data/E/DSC03031.JPG_14.jpg,2911,480,640,41,310,351,70,141,False,16
E,36,kaist_dataset/Mixed/Digital_Camera/(C.S)E-night/DSC03871.JPG,char_data/E/DSC03871.JPG_4.jpg,792,480,640,22,220,242,183,219,False,16
E,39,kaist_dataset/Mixed/Digital_Camera/(C.S)E-night/DSC03871.JPG,char_data/E/DSC03871.JPG_5.jpg,741,480,640,19,343,362,184,223,False,16
E,76,kaist_dataset/Mixed/Digital_Camera/(C.S)E-night/크기변환_P1010162.JPG,char_data/E/크기변환_P1010162.JPG_2.jpg,4180,480,640,55,96,151,77,153,False,16
E,32,kaist_dataset/Mixed/Digital_Camera/(C.S)F-others/097.jpg,char_data/E/097.jpg_4.jpg,352,480,640,11,240,251,165,197,False,16
E,36,kaist_dataset/Mixed/Digital_Camera/(C.S)F-others/097.jpg,char_data/E/097.jpg_5.jpg,612,480,640,17,353,370,166,202,False,16
E,68,kaist_dataset/Mixed/Digital_Camera/(C.S)F-others/2007-12-08-day-113.jpg,char_data/E/2007-12-08-day-113.jpg_6.jpg,2788,1200,1600,41,371,412,264,332,False,16
E,61,kaist_dataset/Mixed/Digital_Camera/(C.S)F-others/2007-12-08-day-113.jpg,char_data/E/2007-12-08-day-113.jpg_7.jpg,1891,1200,1600,31,482,513,295,356,False,16
E,50,kaist_dataset/Mixed/Digital_Camera/(C.S)F-others/2007-12-08-day-113.jpg,char_data/E/2007-12-08-day-113.jpg_8.jpg,1300,1200,1600,26,770,796,377,427,False,16
E,43,kaist_dataset/Mixed/Digital_Camera/(C.S)F-others/DSC02504.JPG,char_data/E/DSC02504.JPG_4.jpg,1118,480,640,26,134,160,304,347,False,16
E,41,kaist_dataset/Mixed/Digital_Camera/(C.S)F-others/DSC02504.JPG,char_data/E/DSC02504.JPG_5.jpg,1066,480,640,26,293,319,301,342,False,16
E,36,kaist_dataset/Mixed/Mobile_Phone/(C.M)A-outdoor/P090908006.jpg,char_data/E/P090908006.jpg_2.jpg,828,480,640,23,269,292,367,403,False,16
E,43,kaist_dataset/Mixed/Mobile_Phone/(C.M)A-outdoor/P090912078.jpg,char_data/E/P090912078.jpg_4.jpg,1161,480,640,27,488,515,284,327,False,16
E,63,kaist_dataset/Mixed/Mobile_Phone/(C.M)B-indoor/P090831018.jpg,char_data/E/P090831018.jpg_6.jpg,3843,480,640,61,98,159,226,289,False,16
E,49,kaist_dataset/Mixed/Mobile_Phone/(C.M)B-indoor/P090831021.jpg,char_data/E/P090831021.jpg_6.jpg,1764,480,640,36,117,153,376,425,False,16
E,38,kaist_dataset/Mixed/Mobile_Phone/(C.M)B-indoor/P090831021.jpg,char_data/E/P090831021.jpg_7.jpg,1140,480,640,30,408,438,379,417,False,16
E,49,kaist_dataset/Mixed/Mobile_Phone/(C.M)B-indoor/P090831021.jpg,char_data/E/P090831021.jpg_8.jpg,1715,480,640,35,320,355,331,380,False,16
E,40,kaist_dataset/Mixed/Mobile_Phone/(C.M)C-bookCover/P090831062.jpg,char_data/E/P090831062.jpg_6.jpg,1320,480,640,33,267,300,304,344,False,16
E,32,kaist_dataset/Mixed/Mobile_Phone/(C.M)C-bookCover/P090831062.jpg,char_data/E/P090831062.jpg_7.jpg,1280,480,640,40,353,393,304,336,False,16
E,39,kaist_dataset/Mixed/Mobile_Phone/(C.M)C-bookCover/P090831062.jpg,char_data/E/P090831062.jpg_8.jpg,1170,480,640,30,515,545,294,333,False,16
E,103,kaist_dataset/Mixed/Mobile_Phone/(C.M)C-bookCover/P090831136.jpg,char_data/E/P090831136.jpg_2.jpg,7931,480,640,77,514,591,224,327,False,16
E,37,kaist_dataset/Mixed/Mobile_Phone/(C.M)C-bookCover/P090903009.jpg,char_data/E/P090903009.jpg_4.jpg,851,480,640,23,177,200,354,391,False,16
E,42,kaist_dataset/Mixed/Mobile_Phone/(C.M)C-bookCover/P090903009.jpg,char_data/E/P090903009.jpg_5.jpg,924,480,640,22,408,430,355,397,False,16
E,55,kaist_dataset/Mixed/Mobile_Phone/(C.M)C-bookCover/P090903092.jpg,char_data/E/P090903092.jpg_2.jpg,1815,480,640,33,591,624,200,255,False,16
5,101,kaist_dataset/English/Digital_Camera/(E.S)A-shadow/DSC03077.JPG,char_data/5/DSC03077.JPG_2.jpg,13029,480,640,129,338,467,88,189,True,7
5,44,kaist_dataset/English/Digital_Camera/(E.S)C-outdoor1/080116-0065.jpg,char_data/5/080116-0065.jpg_2.jpg,1056,600,800,24,277,301,370,414,True,7
5,46,kaist_dataset/English/Digital_Camera/(E.S)C-outdoor1/DSC02415.JPG,char_data/5/DSC02415.JPG_2.jpg,1518,480,640,33,518,551,247,293,True,7
5,51,kaist_dataset/English/Digital_Camera/(E.S)C-outdoor2/DSC03161.JPG,char_data/5/DSC03161.JPG_2.jpg,1734,480,640,34,17,51,229,280,True,7
5,40,kaist_dataset/English/Digital_Camera/(E.S)C-outdoor2/DSC03436.JPG,char_data/5/DSC03436.JPG_4.jpg,840,480,640,21,314,335,120,160,True,7
5,34,kaist_dataset/English/Digital_Camera/(E.S)C-outdoor2/DSC03436.JPG,char_data/5/DSC03436.JPG_5.jpg,714,480,640,21,360,381,127,161,True,7
5,74,kaist_dataset/English/Digital_Camera/(E.S)C-outdoor2/DSC04163.JPG,char_data/5/DSC04163.JPG_2.jpg,3552,480,640,48,419,467,315,389,True,7
5,124,kaist_dataset/English/Digital_Camera/(E.S)C-outdoor3/P1010123.JPG,char_data/5/P1010123.JPG_2.jpg,11656,480,640,94,357,451,51,175,True,7
5,38,kaist_dataset/English/Digital_Camera/(E.S)F-others/DSC02923.JPG,char_data/5/DSC02923.JPG_2.jpg,798,480,640,21,386,407,387,425,True,7
5,78,kaist_dataset/English/Mobile_Phone/(E.M)B-indoor/P090902018.jpg,char_data/5/P090902018.jpg_2.jpg,3354,480,640,43,153,196,167,245,True,7
5,70,kaist_dataset/Korean/Digital_Camera/A-shadow/DSC03535.JPG,char_data/5/DSC03535.JPG_4.jpg,2800,480,640,40,273,313,252,322,True,7
5,68,kaist_dataset/Korean/Digital_Camera/A-shadow/DSC03535.JPG,char_data/5/DSC03535.JPG_5.jpg,2788,480,640,41,524,565,245,313,True,7
5,76,kaist_dataset/Korean/Digital_Camera/A-shadow/DSC03536.JPG,char_data/5/DSC03536.JPG_2.jpg,3192,480,640,42,185,227,243,319,True,7
5,81,kaist_dataset/Korean/Digital_Camera/A-shadow/DSC04311.JPG,char_data/5/DSC04311.JPG_2.jpg,5103,480,640,63,533,596,264,345,True,7
5,47,kaist_dataset/Korean/Digital_Camera/A-shadow/DSC04315.JPG,char_data/5/DSC04315.JPG_4.jpg,1363,480,640,29,241,270,415,462,True,7
5,47,kaist_dataset/Korean/Digital_Camera/A-shadow/DSC04315.JPG,char_data/5/DSC04315.JPG_5.jpg,1363,480,640,29,292,321,417,464,True,7
5,29,kaist_dataset/Korean/Digital_Camera/B-light/DSC02987.JPG,char_data/5/DSC02987.JPG_4.jpg,377,480,640,13,418,431,276,305,True,7
5,32,kaist_dataset/Korean/Digital_Camera/B-light/DSC02987.JPG,char_data/5/DSC02987.JPG_5.jpg,416,480,640,13,445,458,275,307,True,7
5,23,kaist_dataset/Korean/Digital_Camera/E-night/103.jpg,char_data/5/103.jpg_4.jpg,253,480,640,11,155,166,312,335,True,7
5,21,kaist_dataset/Korean/Digital_Camera/E-night/103.jpg,char_data/5/103.jpg_5.jpg,252,480,640,12,219,231,313,334,True,7
5,45,kaist_dataset/Korean/Digital_Camera/E-night/DSC02649.JPG,char_data/5/DSC02649.JPG_2.jpg,945,480,640,21,546,567,392,437,True,7
5,30,kaist_dataset/Korean/Digital_Camera/E-night/P1010146.JPG,char_data/5/P1010146.JPG_4.jpg,480,480,640,16,273,289,249,279,True,7
5,34,kaist_dataset/Korean/Digital_Camera/E-night/P1010146.JPG,char_data/5/P1010146.JPG_5.jpg,578,480,640,17,312,329,245,279,True,7
5,26,kaist_dataset/Korean/Digital_Camera/E-night/P1010149.JPG,char_data/5/P1010149.JPG_2.jpg,390,480,640,15,588,603,241,267,True,7
5,136,kaist_dataset/Korean/Digital_Camera/F-bookCover/DSC02823.JPG,char_data/5/DSC02823.JPG_2.jpg,11152,480,640,82,35,117,169,305,True,7
5,106,kaist_dataset/Korean/Digital_Camera/F-bookCover/DSC02834.JPG,char_data/5/DSC02834.JPG_2.jpg,6784,480,640,64,158,222,30,136,True,7
5,50,kaist_dataset/Korean/Digital_Camera/G-others/005.JPG,char_data/5/005.JPG_2.jpg,1700,768,576,34,293,327,427,477,True,7
5,20,kaist_dataset/Korean/Digital_Camera/G-others/2007-12-08-day-112.jpg,char_data/5/2007-12-08-day-112.jpg_2.jpg,260,1200,1600,13,403,416,1175,1195,True,7
5,114,kaist_dataset/Korean/Digital_Camera/G-others/2007-12-09-day-exterior-062.jpg,char_data/5/2007-12-09-day-exterior-062.jpg_2.jpg,3876,1600,1200,34,631,665,1396,1510,True,7
5,46,kaist_dataset/Korean/Digital_Camera/G-others/2007-12-09-day-exterior-083.jpg,char_data/5/2007-12-09-day-exterior-083.jpg_8.jpg,1380,1600,1200,30,664,694,979,1025,True,7
5,46,kaist_dataset/Korean/Digital_Camera/G-others/2007-12-09-day-exterior-083.jpg,char_data/5/2007-12-09-day-exterior-083.jpg_9.jpg,1334,1600,1200,29,695,724,983,1029,True,7
5,59,kaist_dataset/Korean/Digital_Camera/G-others/2007-12-09-day-exterior-083.jpg,char_data/5/2007-12-09-day-exterior-083.jpg_10.jpg,2242,1600,1200,38,482,520,118,177,True,7
5,58,kaist_dataset/Korean/Digital_Camera/G-others/2007-12-09-day-exterior-083.jpg,char_data/5/2007-12-09-day-exterior-083.jpg_11.jpg,2494,1600,1200,43,521,564,120,178,True,7
5,43,kaist_dataset/Korean/Digital_Camera/G-others/DSC03065.JPG,char_data/5/DSC03065.JPG_2.jpg,2494,480,640,58,257,315,53,96,True,7
5,50,kaist_dataset/Korean/Digital_Camera/G-others/DSC03434.JPG,char_data/5/DSC03434.JPG_4.jpg,1450,480,640,29,371,400,29,79,True,7
5,54,kaist_dataset/Korean/Digital_Camera/G-others/DSC03434.JPG,char_data/5/DSC03434.JPG_5.jpg,1890,480,640,35,426,461,30,84,True,7
5,25,kaist_dataset/Korean/Digital_Camera/G-others/DSC03863.JPG,char_data/5/DSC03863.JPG_2.jpg,350,480,640,14,191,205,408,433,True,7
5,47,kaist_dataset/Korean/Digital_Camera/indoor1/080119-0018.jpg,char_data/5/080119-0018.jpg_4.jpg,1598,1200,1600,34,1005,1039,699,746,True,7
5,49,kaist_dataset/Korean/Digital_Camera/indoor1/080119-0018.jpg,char_data/5/080119-0018.jpg_5.jpg,1568,1200,1600,32,1143,1175,699,748,True,7
5,48,kaist_dataset/Korean/Digital_Camera/indoor1/080119-0029.jpg,char_data/5/080119-0029.jpg_4.jpg,1200,1200,1600,25,7,32,572,620,True,7
5,87,kaist_dataset/Korean/Digital_Camera/indoor1/080119-0029.jpg,char_data/5/080119-0029.jpg_5.jpg,3654,1200,1600,42,1361,1403,983,1070,True,7
5,102,kaist_dataset/Korean/Digital_Camera/indoor1/080119-0030.jpg,char_data/5/080119-0030.jpg_4.jpg,5406,1200,1600,53,906,959,426,528,True,7
5,159,kaist_dataset/Korean/Digital_Camera/indoor1/080119-0030.jpg,char_data/5/080119-0030.jpg_5.jpg,16854,1200,1600,106,999,1105,561,720,True,7
5,56,kaist_dataset/Korean/Digital_Camera/indoor2/DSC03474.JPG,char_data/5/DSC03474.JPG_4.jpg,2016,480,640,36,436,472,150,206,True,7
5,53,kaist_dataset/Korean/Digital_Camera/indoor2/DSC03474.JPG,char_data/5/DSC03474.JPG_5.jpg,2173,480,640,41,470,511,149,202,True,7
5,55,kaist_dataset/Korean/Digital_Camera/indoor2/DSC03475.JPG,char_data/5/DSC03475.JPG_4.jpg,2200,480,640,40,459,499,93,148,True,7
5,59,kaist_dataset/Korean/Digital_Camera/indoor2/DSC03475.JPG,char_data/5/DSC03475.JPG_5.jpg,2714,480,640,46,530,576,85,144,True,7
5,51,kaist_dataset/Korean/Digital_Camera/indoor2/DSC03560.JPG,char_data/5/DSC03560.JPG_2.jpg,1530,480,640,30,394,424,54,105,True,7
5,95,kaist_dataset/Korean/Digital_Camera/indoor2/DSC03565.JPG,char_data/5/DSC03565.JPG_4.jpg,5795,480,640,61,291,352,269,364,True,7
5,92,kaist_dataset/Korean/Digital_Camera/indoor2/DSC03565.JPG,char_data/5/DSC03565.JPG_5.jpg,5152,480,640,56,457,513,267,359,True,7
5,54,kaist_dataset/Korean/Digital_Camera/indoor2/DSC03994.JPG,char_data/5/DSC03994.JPG_4.jpg,1620,480,640,30,458,488,286,340,True,7
5,56,kaist_dataset/Korean/Digital_Camera/indoor2/DSC03994.JPG,char_data/5/DSC03994.JPG_5.jpg,2240,480,640,40,512,552,286,342,True,7
5,43,kaist_dataset/Korean/Digital_Camera/indoor2/DSC03995.JPG,char_data/5/DSC03995.JPG_4.jpg,1075,480,640,25,521,546,264,307,True,7
5,43,kaist_dataset/Korean/Digital_Camera/indoor2/DSC03995.JPG,char_data/5/DSC03995.JPG_5.jpg,1161,480,640,27,570,597,262,305,True,7
5,50,kaist_dataset/Korean/Digital_Camera/indoor2/DSC04204.JPG,char_data/5/DSC04204.JPG_4.jpg,1850,480,640,37,249,286,204,254,True,7
5,42,kaist_dataset/Korean/Digital_Camera/indoor2/DSC04204.JPG,char_data/5/DSC04204.JPG_5.jpg,882,480,640,21,433,454,279,321,True,7
5,74,kaist_dataset/Korean/Digital_Camera/indoor2/P071209063.jpg,char_data/5/P071209063.jpg_4.jpg,3996,1200,1600,54,1230,1284,1060,1134,True,7
5,76,kaist_dataset/Korean/Digital_Camera/indoor2/P071209063.jpg,char_data/5/P071209063.jpg_5.jpg,4028,1200,1600,53,1283,1336,1057,1133,True,7
5,21,kaist_dataset/Korean/Digital_Camera/outdoor1/006.JPG,char_data/5/006.JPG_2.jpg,357,480,640,17,382,399,251,272,True,7
5,25,kaist_dataset/Korean/Digital_Camera/outdoor1/028.JPG,char_data/5/028.JPG_4.jpg,325,480,640,13,359,372,265,290,True,7
5,24,kaist_dataset/Korean/Digital_Camera/outdoor1/028.JPG,char_data/5/028.JPG_5.jpg,288,480,640,12,373,385,263,287,True,7
5,32,kaist_dataset/Korean/Digital_Camera/outdoor1/032.JPG,char_data/5/032.JPG_2.jpg,544,480,640,17,178,195,257,289,True,7
5,29,kaist_dataset/Korean/Digital_Camera/outdoor1/035.JPG,char_data/5/035.JPG_2.jpg,493,480,640,17,358,375,290,319,True,7
5,40,kaist_dataset/Korean/Digital_Camera/outdoor1/052.JPG,char_data/5/052.JPG_2.jpg,1040,480,640,26,408,434,320,360,True,7
5,33,kaist_dataset/Korean/Digital_Camera/outdoor1/059.JPG,char_data/5/059.JPG_4.jpg,561,480,640,17,515,532,329,362,True,7
5,40,kaist_dataset/Korean/Digital_Camera/outdoor1/059.JPG,char_data/5/059.JPG_5.jpg,720,480,640,18,486,504,322,362,True,7
5,30,kaist_dataset/Korean/Digital_Camera/outdoor1/069.JPG,char_data/5/069.JPG_2.jpg,540,480,640,18,388,406,270,300,True,7
5,21,kaist_dataset/Korean/Digital_Camera/outdoor1/070.JPG,char_data/5/070.JPG_6.jpg,336,480,640,16,412,428,249,270,True,7
5,23,kaist_dataset/Korean/Digital_Camera/outdoor1/070.JPG,char_data/5/070.JPG_7.jpg,414,480,640,18,428,446,247,270,True,7
5,21,kaist_dataset/Korean/Digital_Camera/outdoor1/070.JPG,char_data/5/070.JPG_8.jpg,420,480,640,20,459,479,251,272,True,7
5,39,kaist_dataset/Korean/Digital_Camera/outdoor1/091.JPG,char_data/5/091.JPG_6.jpg,975,480,640,25,404,429,282,321,True,7
5,51,kaist_dataset/Korean/Digital_Camera/outdoor1/091.JPG,char_data/5/091.JPG_7.jpg,1479,480,640,29,429,458,276,327,True,7
5,37,kaist_dataset/Korean/Digital_Camera/outdoor1/091.JPG,char_data/5/091.JPG_8.jpg,1110,480,640,30,283,313,284,321,True,7
5,31,kaist_dataset/Korean/Digital_Camera/outdoor1/102.JPG,char_data/5/102.JPG_4.jpg,651,480,640,21,368,389,308,339,True,7
5,30,kaist_dataset/Korean/Digital_Camera/outdoor1/102.JPG,char_data/5/102.JPG_5.jpg,630,480,640,21,388,409,308,338,True,7
5,34,kaist_dataset/Korean/Digital_Camera/outdoor1/120.JPG,char_data/5/120.JPG_6.jpg,1224,480,640,36,279,315,299,333,True,7
5,48,kaist_dataset/Korean/Digital_Camera/outdoor1/120.JPG,char_data/5/120.JPG_7.jpg,1776,480,640,37,334,371,287,335,True,7
5,43,kaist_dataset/Korean/Digital_Camera/outdoor1/120.JPG,char_data/5/120.JPG_8.jpg,1591,480,640,37,372,409,292,335,True,7
5,35,kaist_dataset/Korean/Digital_Camera/outdoor1/123.JPG,char_data/5/123.JPG_2.jpg,700,480,640,20,383,403,272,307,True,7
5,26,kaist_dataset/Korean/Digital_Camera/outdoor1/126.JPG,char_data/5/126.JPG_4.jpg,702,480,640,27,350,377,260,286,True,7
5,28,kaist_dataset/Korean/Digital_Camera/outdoor1/126.JPG,char_data/5/126.JPG_5.jpg,308,480,640,11,518,529,254,282,True,7
5,41,kaist_dataset/Korean/Digital_Camera/outdoor1/127.JPG,char_data/5/127.JPG_2.jpg,1230,480,640,30,393,423,267,308,True,7
5,68,kaist_dataset/Korean/Digital_Camera/outdoor1/2007-12-08-day-057.jpg,char_data/5/2007-12-08-day-057.jpg_4.jpg,2788,1200,1600,41,949,990,595,663,True,7
5,72,kaist_dataset/Korean/Digital_Camera/outdoor1/2007-12-08-day-057.jpg,char_data/5/2007-12-08-day-057.jpg_5.jpg,3024,1200,1600,42,990,1032,593,665,True,7
5,33,kaist_dataset/Korean/Digital_Camera/outdoor1/50.JPG,char_data/5/50.JPG_4.jpg,561,576,768,17,370,387,338,371,True,7
5,26,kaist_dataset/Korean/Digital_Camera/outdoor1/50.JPG,char_data/5/50.JPG_5.jpg,494,576,768,19,387,406,343,369,True,7
5,40,kaist_dataset/Korean/Digital_Camera/outdoor1/53.JPG,char_data/5/53.JPG_2.jpg,560,401,766,14,707,721,225,265,True,7
5,40,kaist_dataset/Korean/Digital_Camera/outdoor1/54.JPG,char_data/5/54.JPG_2.jpg,1160,523,767,29,494,523,367,407,True,7
5,62,kaist_dataset/Korean/Digital_Camera/outdoor2/2007-12-08-day-101.jpg,char_data/5/2007-12-08-day-101.jpg_4.jpg,2232,1200,1600,36,815,851,639,701,True,7
5,41,kaist_dataset/Korean/Digital_Camera/outdoor2/2007-12-08-day-101.jpg,char_data/5/2007-12-08-day-101.jpg_5.jpg,697,1200,1600,17,827,844,743,784,True,7
5,77,kaist_dataset/Korean/Digital_Camera/outdoor2/2007-12-09-day-exterior-009.jpg,char_data/5/2007-12-09-day-exterior-009.jpg_2.jpg,3234,1200,1600,42,962,1004,652,729,True,7
5,43,kaist_dataset/Korean/Digital_Camera/outdoor2/2007-12-09-day-exterior-016.jpg,char_data/5/2007-12-09-day-exterior-016.jpg_2.jpg,1333,1200,1600,31,7,38,906,949,True,7
5,57,kaist_dataset/Korean/Digital_Camera/outdoor2/2007-12-09-day-exterior-033.jpg,char_data/5/2007-12-09-day-exterior-033.jpg_2.jpg,4104,1200,1600,72,856,928,726,783,True,7
5,58,kaist_dataset/Korean/Digital_Camera/outdoor2/2007-12-09-day-exterior-035.jpg,char_data/5/2007-12-09-day-exterior-035.jpg_2.jpg,2030,1200,1600,35,742,777,712,770,True,7
5,52,kaist_dataset/Korean/Digital_Camera/outdoor2/2007-12-09-day-exterior-084.jpg,char_data/5/2007-12-09-day-exterior-084.jpg_4.jpg,1768,1200,1600,34,906,940,790,842,True,7
5,48,kaist_dataset/Korean/Digital_Camera/outdoor2/2007-12-09-day-exterior-084.jpg,char_data/5/2007-12-09-day-exterior-084.jpg_5.jpg,1824,1200,1600,38,941,979,789,837,True,7
5,31,kaist_dataset/Korean/Digital_Camera/outdoor2/DSC02299.JPG,char_data/5/DSC02299.JPG_2.jpg,372,480,640,12,629,639,210,241,True,7
5,31,kaist_dataset/Korean/Digital_Camera/outdoor2/DSC02304.JPG,char_data/5/DSC02304.JPG_4.jpg,713,480,640,23,378,401,263,294,True,7
5,32,kaist_dataset/Korean/Digital_Camera/outdoor2/DSC02304.JPG,char_data/5/DSC02304.JPG_5.jpg,1088,480,640,34,402,436,264,296,True,7
5,54,kaist_dataset/Korean/Digital_Camera/outdoor2/DSC02305.JPG,char_data/5/DSC02305.JPG_2.jpg,2376,480,640,44,409,453,245,299,True,7
5,39,kaist_dataset/Korean/Digital_Camera/outdoor2/DSC02311.JPG,char_data/5/DSC02311.JPG_2.jpg,741,480,640,19,581,600,250,289,True,7
5,39,kaist_dataset/Korean/Digital_Camera/outdoor2/DSC02327.JPG,char_data/5/DSC02327.JPG_4.jpg,1092,480,640,28,218,246,357,396,True,7
5,40,kaist_dataset/Korean/Digital_Camera/outdoor2/DSC02327.JPG,char_data/5/DSC02327.JPG_5.jpg,1120,480,640,28,422,450,362,402,True,7
5,31,kaist_dataset/Korean/Digital_Camera/outdoor2/DSC02372.JPG,char_data/5/DSC02372.JPG_4.jpg,434,480,640,14,510,524,286,317,True,7
5,35,kaist_dataset/Korean/Digital_Camera/outdoor2/DSC02372.JPG,char_data/5/DSC02372.JPG_5.jpg,490,480,640,14,524,538,284,319,True,7
5,30,kaist_dataset/Korean/Digital_Camera/outdoor2/DSC02373.JPG,char_data/5/DSC02373.JPG_2.jpg,330,480,640,11,437,448,336,366,True,7
5,36,kaist_dataset/Korean/Digital_Camera/outdoor2/DSC02380.JPG,char_data/5/DSC02380.JPG_4.jpg,576,480,640,16,375,391,231,267,True,7
5,34,kaist_dataset/Korean/Digital_Camera/outdoor2/DSC02380.JPG,char_data/5/DSC02380.JPG_5.jpg,408,480,640,12,420,432,233,267,True,7
5,31,kaist_dataset/Korean/Digital_Camera/outdoor2/DSC02386.JPG,char_data/5/DSC02386.JPG_2.jpg,868,480,640,28,562,590,252,283,True,7
5,46,kaist_dataset/Korean/Digital_Camera/outdoor2/DSC02414.JPG,char_data/5/DSC02414.JPG_4.jpg,1656,480,640,36,286,322,238,284,True,7
5,44,kaist_dataset/Korean/Digital_Camera/outdoor2/DSC02414.JPG,char_data/5/DSC02414.JPG_5.jpg,1408,480,640,32,486,518,243,287,True,7
5,39,kaist_dataset/Korean/Digital_Camera/outdoor2/DSC02426.JPG,char_data/5/DSC02426.JPG_4.jpg,1053,480,640,27,437,464,217,256,True,7
5,31,kaist_dataset/Korean/Digital_Camera/outdoor2/DSC02426.JPG,char_data/5/DSC02426.JPG_5.jpg,837,480,640,27,562,589,215,246,True,7
5,27,kaist_dataset/Korean/Digital_Camera/outdoor2/DSC02435.JPG,char_data/5/DSC02435.JPG_6.jpg,405,480,640,15,501,516,247,274,True,7
5,25,kaist_dataset/Korean/Digital_Camera/outdoor2/DSC02435.JPG,char_data/5/DSC02435.JPG_7.jpg,350,480,640,14,562,576,248,273,True,7
5,25,kaist_dataset/Korean/Digital_Camera/outdoor2/DSC02435.JPG,char_data/5/DSC02435.JPG_8.jpg,500,480,640,20,590,610,250,275,True,7
5,26,kaist_dataset/Korean/Digital_Camera/outdoor2/DSC02441.JPG,char_data/5/DSC02441.JPG_2.jpg,494,480,640,19,531,550,202,228,True,7
5,104,kaist_dataset/Korean/Digital_Camera/outdoor2/DSC02486.JPG,char_data/5/DSC02486.JPG_2.jpg,3952,480,640,38,248,286,236,340,True,7
5,37,kaist_dataset/Korean/Digital_Camera/outdoor2/DSC02523.JPG,char_data/5/DSC02523.JPG_2.jpg,888,480,640,24,535,559,338,375,True,7
5,112,kaist_dataset/Korean/Digital_Camera/outdoor3/DSC02525.JPG,char_data/5/DSC02525.JPG_2.jpg,8960,480,640,80,270,350,27,139,True,7
5,26,kaist_dataset/Korean/Digital_Camera/outdoor3/DSC02529.JPG,char_data/5/DSC02529.JPG_2.jpg,234,480,640,9,542,551,372,398,True,7
5,33,kaist_dataset/Korean/Digital_Camera/outdoor3/DSC02531.JPG,char_data/5/DSC02531.JPG_4.jpg,627,480,640,19,311,330,347,380,True,7
5,34,kaist_dataset/Korean/Digital_Camera/outdoor3/DSC02531.JPG,char_data/5/DSC02531.JPG_5.jpg,646,480,640,19,332,351,347,381,True,7
5,48,kaist_dataset/Korean/Digital_Camera/outdoor3/DSC02546.JPG,char_data/5/DSC02546.JPG_4.jpg,1440,480,640,30,388,418,229,277,True,7
5,33,kaist_dataset/Korean/Digital_Camera/outdoor3/DSC02546.JPG,char_data/5/DSC02546.JPG_5.jpg,330,480,640,10,210,220,426,459,True,7
5,47,kaist_dataset/Korean/Digital_Camera/outdoor3/DSC02697.JPG,char_data/5/DSC02697.JPG_2.jpg,1692,480,640,36,177,213,376,423,True,7
5,27,kaist_dataset/Korean/Digital_Camera/outdoor3/DSC02891.JPG,char_data/5/DSC02891.JPG_2.jpg,378,480,640,14,548,562,302,329,True,7
5,39,kaist_dataset/Korean/Digital_Camera/outdoor3/DSC02899.JPG,char_data/5/DSC02899.JPG_2.jpg,1677,480,640,43,583,626,224,263,True,7
5,81,kaist_dataset/Korean/Digital_Camera/outdoor3/DSC02900.JPG,char_data/5/DSC02900.JPG_2.jpg,3645,480,640,45,516,561,238,319,True,7
5,36,kaist_dataset/Korean/Digital_Camera/outdoor3/DSC02944.JPG,char_data/5/DSC02944.JPG_2.jpg,792,480,640,22,303,325,235,271,True,7
5,68,kaist_dataset/Korean/Digital_Camera/outdoor3/DSC02951.JPG,char_data/5/DSC02951.JPG_4.jpg,3672,480,640,54,334,388,391,459,True,7
5,73,kaist_dataset/Korean/Digital_Camera/outdoor3/DSC02951.JPG,char_data/5/DSC02951.JPG_5.jpg,4307,480,640,59,439,498,386,459,True,7
5,56,kaist_dataset/Korean/Digital_Camera/outdoor3/DSC02953.JPG,char_data/5/DSC02953.JPG_2.jpg,1848,480,640,33,522,555,388,444,True,7
5,98,kaist_dataset/Korean/Digital_Camera/outdoor3/DSC02983.JPG,char_data/5/DSC02983.JPG_4.jpg,4802,480,640,49,364,413,312,410,True,7
5,104,kaist_dataset/Korean/Digital_Camera/outdoor3/DSC02983.JPG,char_data/5/DSC02983.JPG_5.jpg,5616,480,640,54,462,516,314,418,True,7
5,50,kaist_dataset/Korean/Digital_Camera/outdoor3/DSC02994.JPG,char_data/5/DSC02994.JPG_2.jpg,1450,480,640,29,254,283,284,334,True,7
5,117,kaist_dataset/Korean/Digital_Camera/outdoor3/DSC03159.JPG,char_data/5/DSC03159.JPG_2.jpg,5967,480,640,51,290,341,222,339,True,7
5,67,kaist_dataset/Korean/Digital_Camera/outdoor3/DSC03198.JPG,char_data/5/DSC03198.JPG_2.jpg,3149,480,640,47,121,168,195,262,True,7
5,51,kaist_dataset/Korean/Digital_Camera/outdoor3/DSC03221.JPG,char_data/5/DSC03221.JPG_2.jpg,1122,480,640,22,128,150,90,141,True,7
5,69,kaist_dataset/Korean/Digital_Camera/outdoor3/DSC03222.JPG,char_data/5/DSC03222.JPG_2.jpg,3933,480,640,57,280,337,378,447,True,7
5,30,kaist_dataset/Korean/Digital_Camera/outdoor3/DSC03232.JPG,char_data/5/DSC03232.JPG_4.jpg,660,480,640,22,299,321,284,314,True,7
5,33,kaist_dataset/Korean/Digital_Camera/outdoor3/DSC03232.JPG,char_data/5/DSC03232.JPG_5.jpg,792,480,640,24,564,588,272,305,True,7
5,48,kaist_dataset/Korean/Digital_Camera/outdoor4/DSC03272.JPG,char_data/5/DSC03272.JPG_2.jpg,2352,480,640,49,284,333,423,471,True,7
5,46,kaist_dataset/Korean/Digital_Camera/outdoor4/DSC03319.JPG,char_data/5/DSC03319.JPG_2.jpg,1104,480,640,24,219,243,84,130,True,7
5,84,kaist_dataset/Korean/Digital_Camera/outdoor4/DSC03452.JPG,char_data/5/DSC03452.JPG_4.jpg,3528,480,640,42,284,326,278,362,True,7
5,80,kaist_dataset/Korean/Digital_Camera/outdoor4/DSC03452.JPG,char_data/5/DSC03452.JPG_5.jpg,2720,480,640,34,362,396,277,357,True,7
5,39,kaist_dataset/Korean/Digital_Camera/outdoor4/DSC03545.JPG,char_data/5/DSC03545.JPG_2.jpg,663,480,640,17,186,203,40,79,True,7
5,35,kaist_dataset/Korean/Digital_Camera/outdoor4/DSC03555.JPG,char_data/5/DSC03555.JPG_2.jpg,805,480,640,23,416,439,422,457,True,7
5,36,kaist_dataset/Korean/Digital_Camera/outdoor4/DSC03592.JPG,char_data/5/DSC03592.JPG_4.jpg,900,480,640,25,197,222,118,154,True,7
5,38,kaist_dataset/Korean/Digital_Camera/outdoor4/DSC03592.JPG,char_data/5/DSC03592.JPG_5.jpg,608,480,640,16,626,639,124,162,True,7
5,56,kaist_dataset/Korean/Digital_Camera/outdoor4/DSC03598.JPG,char_data/5/DSC03598.JPG_2.jpg,1456,480,640,26,272,298,199,255,True,7
5,47,kaist_dataset/Korean/Digital_Camera/outdoor4/DSC03601.JPG,char_data/5/DSC03601.JPG_2.jpg,1175,480,640,25,270,295,293,340,True,7
5,44,kaist_dataset/Korean/Digital_Camera/outdoor4/DSC03603.JPG,char_data/5/DSC03603.JPG_2.jpg,1188,480,640,27,342,369,287,331,True,7
5,25,kaist_dataset/Korean/Digital_Camera/outdoor5/DSC03636.JPG,char_data/5/DSC03636.JPG_4.jpg,300,480,640,12,330,342,162,187,True,7
5,32,kaist_dataset/Korean/Digital_Camera/outdoor5/DSC03636.JPG,char_data/5/DSC03636.JPG_5.jpg,736,480,640,23,304,327,398,430,True,7
5,39,kaist_dataset/Korean/Digital_Camera/outdoor5/DSC03692.JPG,char_data/5/DSC03692.JPG_6.jpg,702,480,640,18,457,475,182,221,True,7
5,40,kaist_dataset/Korean/Digital_Camera/outdoor5/DSC03692.JPG,char_data/5/DSC03692.JPG_7.jpg,680,480,640,17,536,553,188,228,True,7
5,40,kaist_dataset/Korean/Digital_Camera/outdoor5/DSC03692.JPG,char_data/5/DSC03692.JPG_8.jpg,760,480,640,19,551,570,187,227,True,7
5,63,kaist_dataset/Korean/Digital_Camera/outdoor5/DSC03694.JPG,char_data/5/DSC03694.JPG_4.jpg,1953,480,640,31,517,548,118,181,True,7
5,65,kaist_dataset/Korean/Digital_Camera/outdoor5/DSC03694.JPG,char_data/5/DSC03694.JPG_5.jpg,2080,480,640,32,344,376,245,310,True,7
5,86,kaist_dataset/Korean/Digital_Camera/outdoor5/DSC03715.JPG,char_data/5/DSC03715.JPG_2.jpg,4386,480,640,51,408,459,84,170,True,7
5,39,kaist_dataset/Korean/Digital_Camera/outdoor5/DSC03740.JPG,char_data/5/DSC03740.JPG_6.jpg,975,480,640,25,397,422,285,324,True,7
5,39,kaist_dataset/Korean/Digital_Camera/outdoor5/DSC03740.JPG,char_data/5/DSC03740.JPG_7.jpg,897,480,640,23,449,472,285,324,True,7
5,39,kaist_dataset/Korean/Digital_Camera/outdoor5/DSC03740.JPG,char_data/5/DSC03740.JPG_8.jpg,975,480,640,25,514,539,284,323,True,7
5,29,kaist_dataset/Korean/Digital_Camera/outdoor5/DSC03744.JPG,char_data/5/DSC03744.JPG_2.jpg,696,480,640,24,313,337,303,332,True,7
5,32,kaist_dataset/Korean/Digital_Camera/outdoor5/DSC03751.JPG,char_data/5/DSC03751.JPG_2.jpg,896,480,640,28,307,335,410,442,True,7
5,27,kaist_dataset/Korean/Digital_Camera/outdoor5/DSC03752.JPG,char_data/5/DSC03752.JPG_2.jpg,324,480,640,12,165,177,411,438,True,7
5,32,kaist_dataset/Korean/Digital_Camera/outdoor5/DSC03777.JPG,char_data/5/DSC03777.JPG_2.jpg,576,480,640,18,154,172,341,373,True,7
5,40,kaist_dataset/Korean/Digital_Camera/outdoor5/DSC03779.JPG,char_data/5/DSC03779.JPG_2.jpg,720,480,640,18,505,523,238,278,True,7
5,28,kaist_dataset/Korean/Digital_Camera/outdoor5/DSC03780.JPG,char_data/5/DSC03780.JPG_2.jpg,476,480,640,17,247,264,436,464,True,7
5,33,kaist_dataset/Korean/Digital_Camera/outdoor5/DSC03794.JPG,char_data/5/DSC03794.JPG_2.jpg,627,480,640,19,284,303,366,399,True,7
5,95,kaist_dataset/Korean/Digital_Camera/outdoor5/DSC03864.JPG,char_data/5/DSC03864.JPG_2.jpg,5035,480,640,53,164,217,155,250,True,7
5,50,kaist_dataset/Korean/Digital_Camera/outdoor5/DSC03970.JPG,char_data/5/DSC03970.JPG_2.jpg,2050,480,640,41,297,338,92,142,True,7
5,49,kaist_dataset/Korean/Digital_Camera/outdoor5/DSC03979.JPG,char_data/5/DSC03979.JPG_4.jpg,2940,480,640,60,367,427,381,430,True,7
5,51,kaist_dataset/Korean/Digital_Camera/outdoor5/DSC03979.JPG,char_data/5/DSC03979.JPG_5.jpg,3111,480,640,61,503,564,382,433,True,7
5,35,kaist_dataset/Korean/Digital_Camera/outdoor5/DSC03996.JPG,char_data/5/DSC03996.JPG_2.jpg,980,480,640,28,376,404,279,314,True,7
5,33,kaist_dataset/Korean/Digital_Camera/outdoor5/DSC04027.JPG,char_data/5/DSC04027.JPG_4.jpg,594,480,640,18,230,248,387,420,True,7
5,36,kaist_dataset/Korean/Digital_Camera/outdoor5/DSC04027.JPG,char_data/5/DSC04027.JPG_5.jpg,576,480,640,16,442,458,382,418,True,7
5,37,kaist_dataset/Korean/Digital_Camera/outdoor5/DSC04040.JPG,char_data/5/DSC04040.JPG_2.jpg,1295,480,640,35,439,474,342,379,True,7
5,21,kaist_dataset/Korean/Digital_Camera/outdoor6/DSC04041.JPG,char_data/5/DSC04041.JPG_2.jpg,399,480,640,19,496,515,147,168,True,7
5,23,kaist_dataset/Korean/Digital_Camera/outdoor6/DSC04042.JPG,char_data/5/DSC04042.JPG_2.jpg,322,480,640,14,123,137,334,357,True,7
5,28,kaist_dataset/Korean/Digital_Camera/outdoor6/DSC04046.JPG,char_data/5/DSC04046.JPG_2.jpg,504,480,640,18,328,346,259,287,True,7
5,65,kaist_dataset/Korean/Digital_Camera/outdoor6/DSC04073.JPG,char_data/5/DSC04073.JPG_4.jpg,2275,480,640,35,361,396,32,97,True,7
5,61,kaist_dataset/Korean/Digital_Camera/outdoor6/DSC04073.JPG,char_data/5/DSC04073.JPG_5.jpg,1647,480,640,27,515,542,34,95,True,7
5,40,kaist_dataset/Korean/Digital_Camera/outdoor6/DSC04081.JPG,char_data/5/DSC04081.JPG_4.jpg,1880,480,640,47,426,473,317,357,True,7
5,40,kaist_dataset/Korean/Digital_Camera/outdoor6/DSC04081.JPG,char_data/5/DSC04081.JPG_5.jpg,1840,480,640,46,473,519,317,357,True,7
5,49,kaist_dataset/Korean/Digital_Camera/outdoor6/DSC04089.JPG,char_data/5/DSC04089.JPG_2.jpg,1421,480,640,29,465,494,277,326,True,7
5,106,kaist_dataset/Korean/Digital_Camera/outdoor6/DSC04090.JPG,char_data/5/DSC04090.JPG_4.jpg,5194,480,640,49,437,486,182,288,True,7
5,108,kaist_dataset/Korean/Digital_Camera/outdoor6/DSC04090.JPG,char_data/5/DSC04090.JPG_5.jpg,6480,480,640,60,486,546,179,287,True,7
5,90,kaist_dataset/Korean/Digital_Camera/outdoor6/DSC04096.JPG,char_data/5/DSC04096.JPG_4.jpg,4140,480,640,46,213,259,217,307,True,7
5,82,kaist_dataset/Korean/Digital_Camera/outdoor6/DSC04096.JPG,char_data/5/DSC04096.JPG_5.jpg,4674,480,640,57,421,478,225,307,True,7
5,57,kaist_dataset/Korean/Digital_Camera/outdoor6/DSC04100.JPG,char_data/5/DSC04100.JPG_4.jpg,1140,480,640,20,385,405,51,108,True,7
5,59,kaist_dataset/Korean/Digital_Camera/outdoor6/DSC04100.JPG,char_data/5/DSC04100.JPG_5.jpg,1180,480,640,20,502,522,53,112,True,7
5,39,kaist_dataset/Korean/Digital_Camera/outdoor6/DSC04116.JPG,char_data/5/DSC04116.JPG_2.jpg,624,480,640,16,206,222,317,356,True,7
5,52,kaist_dataset/Korean/Digital_Camera/outdoor6/DSC04118.JPG,char_data/5/DSC04118.JPG_2.jpg,1820,480,640,35,277,312,252,304,True,7
5,28,kaist_dataset/Korean/Digital_Camera/outdoor6/DSC04132.JPG,char_data/5/DSC04132.JPG_2.jpg,532,480,640,19,278,297,158,186,True,7
5,56,kaist_dataset/Korean/Digital_Camera/outdoor6/DSC04143.JPG,char_data/5/DSC04143.JPG_2.jpg,1904,480,640,34,256,290,355,411,True,7
5,74,kaist_dataset/Korean/Digital_Camera/outdoor6/DSC04147.JPG,char_data/5/DSC04147.JPG_6.jpg,2960,480,640,40,230,270,177,251,True,7
5,85,kaist_dataset/Korean/Digital_Camera/outdoor6/DSC04147.JPG,char_data/5/DSC04147.JPG_7.jpg,3315,480,640,39,348,387,174,259,True,7
5,80,kaist_dataset/Korean/Digital_Camera/outdoor6/DSC04147.JPG,char_data/5/DSC04147.JPG_8.jpg,3200,480,640,40,426,466,174,254,True,7
5,72,kaist_dataset/Korean/Digital_Camera/outdoor6/DSC04301.JPG,char_data/5/DSC04301.JPG_6.jpg,4464,480,640,62,190,252,359,431,True,7
5,69,kaist_dataset/Korean/Digital_Camera/outdoor6/DSC04301.JPG,char_data/5/DSC04301.JPG_7.jpg,5796,480,640,84,309,393,361,430,True,7
5,74,kaist_dataset/Korean/Digital_Camera/outdoor6/DSC04301.JPG,char_data/5/DSC04301.JPG_8.jpg,5254,480,640,71,508,579,361,435,True,7
5,56,kaist_dataset/Korean/Digital_Camera/outdoor6/DSC04332.JPG,char_data/5/DSC04332.JPG_2.jpg,2800,480,640,50,185,235,351,407,True,7
5,29,kaist_dataset/Korean/Digital_Camera/outdoor6/DSC04343.JPG,char_data/5/DSC04343.JPG_2.jpg,667,480,640,23,323,346,204,233,True,7
5,52,kaist_dataset/Korean/Digital_Camera/outdoor6/DSC04352.JPG,char_data/5/DSC04352.JPG_4.jpg,1508,480,640,29,351,380,283,335,True,7
5,59,kaist_dataset/Korean/Digital_Camera/outdoor6/DSC04352.JPG,char_data/5/DSC04352.JPG_5.jpg,1534,480,640,26,399,425,281,340,True,7
5,56,kaist_dataset/Korean/Digital_Camera/outdoor6/DSC04370.JPG,char_data/5/DSC04370.JPG_6.jpg,2800,480,640,50,227,277,320,376,True,7
5,62,kaist_dataset/Korean/Digital_Camera/outdoor6/DSC04370.JPG,char_data/5/DSC04370.JPG_7.jpg,3348,480,640,54,328,382,323,385,True,7
5,60,kaist_dataset/Korean/Digital_Camera/outdoor6/DSC04370.JPG,char_data/5/DSC04370.JPG_8.jpg,3420,480,640,57,490,547,323,383,True,7
5,46,kaist_dataset/Korean/Digital_Camera/outdoor6/DSC04400.JPG,char_data/5/DSC04400.JPG_4.jpg,1748,480,640,38,416,454,394,440,True,7
5,39,kaist_dataset/Korean/Digital_Camera/outdoor6/DSC04400.JPG,char_data/5/DSC04400.JPG_5.jpg,780,480,640,20,524,544,406,445,True,7
5,57,kaist_dataset/Korean/Digital_Camera/outdoor7/k.jpg,char_data/5/k.jpg_2.jpg,3078,240,320,54,37,91,144,201,True,7
5,145,kaist_dataset/Korean/Digital_Camera/outdoor7/P1010002.JPG,char_data/5/P1010002.JPG_2.jpg,19865,480,640,137,404,541,158,303,True,7
5,35,kaist_dataset/Korean/Digital_Camera/outdoor7/P1010003.JPG,char_data/5/P1010003.JPG_2.jpg,840,480,640,24,351,375,277,312,True,7
5,32,kaist_dataset/Korean/Digital_Camera/outdoor7/P1010005.JPG,char_data/5/P1010005.JPG_2.jpg,992,480,640,31,574,605,188,220,True,7
5,58,kaist_dataset/Korean/Digital_Camera/outdoor7/P1010011.JPG,char_data/5/P1010011.JPG_4.jpg,2320,480,640,40,517,557,223,281,True,7
5,42,kaist_dataset/Korean/Digital_Camera/outdoor7/P1010012.JPG,char_data/5/P1010012.JPG_6.jpg,1008,480,640,24,281,305,220,262,True,7
5,40,kaist_dataset/Korean/Digital_Camera/outdoor7/P1010012.JPG,char_data/5/P1010012.JPG_7.jpg,1160,480,640,29,327,356,220,260,True,7
5,30,kaist_dataset/Korean/Digital_Camera/outdoor7/P1010022.JPG,char_data/5/P1010022.JPG_2.jpg,750,480,640,25,190,215,258,288,True,7
5,56,kaist_dataset/Korean/Digital_Camera/outdoor7/P1010023.JPG,char_data/5/P1010023.JPG_6.jpg,2016,480,640,36,225,261,287,343,True,7
5,56,kaist_dataset/Korean/Digital_Camera/outdoor7/P1010023.JPG,char_data/5/P1010023.JPG_7.jpg,1400,480,640,25,446,471,282,338,True,7
5,53,kaist_dataset/Korean/Digital_Camera/outdoor7/P1010023.JPG,char_data/5/P1010023.JPG_8.jpg,1272,480,640,24,597,621,282,335,True,7
5,32,kaist_dataset/Korean/Digital_Camera/outdoor7/P1010035.JPG,char_data/5/P1010035.JPG_2.jpg,768,480,640,24,151,175,205,237,True,7
5,31,kaist_dataset/Korean/Digital_Camera/outdoor7/P1010054.JPG,char_data/5/P1010054.JPG_2.jpg,620,480,640,20,590,610,227,258,True,7
5,35,kaist_dataset/Korean/Digital_Camera/outdoor7/P1010055.JPG,char_data/5/P1010055.JPG_2.jpg,665,480,640,19,48,67,204,239,True,7
5,32,kaist_dataset/Korean/Digital_Camera/outdoor7/P1010057.JPG,char_data/5/P1010057.JPG_2.jpg,672,480,640,21,586,607,228,260,True,7
5,98,kaist_dataset/Korean/Digital_Camera/outdoor7/P1010079.JPG,char_data/5/P1010079.JPG_2.jpg,5978,480,640,61,328,389,343,441,True,7
5,41,kaist_dataset/Korean/Digital_Camera/outdoor7/P1010082.JPG,char_data/5/P1010082.JPG_6.jpg,1394,480,640,34,245,279,53,94,True,7
5,30,kaist_dataset/Korean/Digital_Camera/outdoor7/P1010091.JPG,char_data/5/P1010091.JPG_8.jpg,810,480,640,27,282,309,233,263,True,7
5,41,kaist_dataset/Korean/Digital_Camera/outdoor7/P1010091.JPG,char_data/5/P1010091.JPG_9.jpg,779,480,640,19,332,351,231,272,True,7
5,33,kaist_dataset/Korean/Digital_Camera/outdoor7/P1010091.JPG,char_data/5/P1010091.JPG_10.jpg,660,480,640,20,376,396,234,267,True,7
5,28,kaist_dataset/Korean/Digital_Camera/outdoor7/P1010091.JPG,char_data/5/P1010091.JPG_11.jpg,644,480,640,23,415,438,239,267,True,7
5,21,kaist_dataset/Korean/Digital_Camera/outdoor7/P1010100.JPG,char_data/5/P1010100.JPG_12.jpg,399,480,640,19,246,265,225,246,True,7
5,23,kaist_dataset/Korean/Digital_Camera/outdoor7/P1010100.JPG,char_data/5/P1010100.JPG_13.jpg,253,480,640,11,303,314,224,247,True,7
5,27,kaist_dataset/Korean/Digital_Camera/outdoor7/P1010100.JPG,char_data/5/P1010100.JPG_14.jpg,540,480,640,20,443,463,217,244,True,7
5,23,kaist_dataset/Korean/Digital_Camera/outdoor7/P1010100.JPG,char_data/5/P1010100.JPG_15.jpg,598,480,640,26,498,524,219,242,True,7
5,44,kaist_dataset/Korean/Digital_Camera/outdoor7/P1010100.JPG,char_data/5/P1010100.JPG_16.jpg,1452,480,640,33,227,260,347,391,True,7
5,44,kaist_dataset/Korean/Digital_Camera/outdoor7/P1010100.JPG,char_data/5/P1010100.JPG_17.jpg,1188,480,640,27,326,353,350,394,True,7
5,34,kaist_dataset/Korean/Digital_Camera/outdoor7/P1010101.JPG,char_data/5/P1010101.JPG_2.jpg,714,480,640,21,402,423,232,266,True,7
5,28,kaist_dataset/Korean/Digital_Camera/outdoor7/P1010107.JPG,char_data/5/P1010107.JPG_2.jpg,476,480,640,17,347,364,228,256,True,7
5,29,kaist_dataset/Korean/Digital_Camera/outdoor7/P1010121.JPG,char_data/5/P1010121.JPG_2.jpg,609,480,640,21,580,601,215,244,True,7
5,60,kaist_dataset/Korean/Digital_Camera/outdoor8/DSC02950.JPG,char_data/5/DSC02950.JPG_2.jpg,2760,480,640,46,402,448,293,353,True,7
5,54,kaist_dataset/Korean/Digital_Camera/outdoor8/P1010171.JPG,char_data/5/P1010171.JPG_2.jpg,1350,480,640,25,543,568,228,282,True,7
5,32,kaist_dataset/Korean/Digital_Camera/outdoor8/P1010178.JPG,char_data/5/P1010178.JPG_2.jpg,640,480,640,20,316,336,389,421,True,7
5,38,kaist_dataset/Korean/Digital_Camera/outdoor8/P1010189.JPG,char_data/5/P1010189.JPG_2.jpg,1254,480,640,33,521,554,229,267,True,7
5,36,kaist_dataset/Korean/Digital_Camera/outdoor8/P1011112.JPG,char_data/5/P1011112.JPG_8.jpg,576,480,640,16,394,410,216,252,True,7
5,30,kaist_dataset/Korean/Digital_Camera/outdoor8/P1011112.JPG,char_data/5/P1011112.JPG_9.jpg,510,480,640,17,530,547,225,255,True,7
5,37,kaist_dataset/Korean/Digital_Camera/outdoor8/P1011112.JPG,char_data/5/P1011112.JPG_10.jpg,592,480,640,16,594,610,224,261,True,7
5,40,kaist_dataset/Korean/Digital_Camera/outdoor8/P1011112.JPG,char_data/5/P1011112.JPG_11.jpg,560,480,640,14,623,637,227,267,True,7
5,29,kaist_dataset/Korean/Digital_Camera/outdoor8/크기변환_P1010033.JPG,char_data/5/크기변환_P1010033.JPG_4.jpg,406,480,640,14,472,486,175,204,True,7
5,29,kaist_dataset/Korean/Digital_Camera/outdoor8/크기변환_P1010033.JPG,char_data/5/크기변환_P1010033.JPG_5.jpg,464,480,640,16,513,529,174,203,True,7
5,57,"kaist_dataset/Korean/Mobile_Phone/(M,K)C-outdoor/P090912033.jpg",char_data/5/P090912033.jpg_2.jpg,1767,480,640,31,285,316,349,406,True,7
5,43,"kaist_dataset/Korean/Mobile_Phone/(M,K)C-outdoor/P090912034.jpg",char_data/5/P090912034.jpg_2.jpg,1333,480,640,31,150,181,262,305,True,7
5,27,"kaist_dataset/Korean/Mobile_Phone/(M,K)C-outdoor/P090912042.jpg",char_data/5/P090912042.jpg_2.jpg,351,480,640,13,381,394,256,283,True,7
5,55,kaist_dataset/Mixed/Digital_Camera/(C.S)A-shadow/DSC03258.JPG,char_data/5/DSC03258.JPG_2.jpg,1870,480,640,34,405,439,370,425,True,7
5,70,kaist_dataset/Mixed/Digital_Camera/(C.S)A-shadow/DSC04326.JPG,char_data/5/DSC04326.JPG_2.jpg,2240,480,640,32,385,417,12,82,True,7
5,31,kaist_dataset/Mixed/Digital_Camera/(C.S)A-shadow/P1010017.JPG,char_data/5/P1010017.JPG_2.jpg,589,480,640,19,130,149,131,162,True,7
5,41,kaist_dataset/Mixed/Digital_Camera/(C.S)A-shadow/P1010019.JPG,char_data/5/P1010019.JPG_2.jpg,1189,480,640,29,451,480,200,241,True,7
5,37,kaist_dataset/Mixed/Digital_Camera/(C.S)B-light/DSC03298.JPG,char_data/5/DSC03298.JPG_2.jpg,740,480,640,20,453,473,288,325,True,7
5,54,kaist_dataset/Mixed/Digital_Camera/(C.S)C-outdoor1/025.JPG,char_data/5/025.JPG_8.jpg,1296,480,640,24,259,283,337,391,True,7
5,56,kaist_dataset/Mixed/Digital_Camera/(C.S)C-outdoor1/025.JPG,char_data/5/025.JPG_9.jpg,1680,480,640,30,311,341,337,393,True,7
5,48,kaist_dataset/Mixed/Digital_Camera/(C.S)C-outdoor1/025.JPG,char_data/5/025.JPG_10.jpg,1296,480,640,27,510,537,342,390,True,7
5,63,kaist_dataset/Mixed/Digital_Camera/(C.S)C-outdoor1/025.JPG,char_data/5/025.JPG_11.jpg,2205,480,640,35,562,597,336,399,True,7
5,24,kaist_dataset/Mixed/Digital_Camera/(C.S)C-outdoor1/047.JPG,char_data/5/047.JPG_2.jpg,216,480,640,9,564,573,238,262,True,7
5,27,kaist_dataset/Mixed/Digital_Camera/(C.S)C-outdoor1/048.JPG,char_data/5/048.JPG_4.jpg,459,480,640,17,359,376,257,284,True,7
5,29,kaist_dataset/Mixed/Digital_Camera/(C.S)C-outdoor1/048.JPG,char_data/5/048.JPG_5.jpg,638,480,640,22,376,398,256,285,True,7
5,53,kaist_dataset/Mixed/Digital_Camera/(C.S)C-outdoor1/080116-0084.jpg,char_data/5/080116-0084.jpg_2.jpg,1431,600,800,27,598,625,304,357,True,7
5,97,kaist_dataset/Mixed/Digital_Camera/(C.S)C-outdoor1/080119-0027.jpg,char_data/5/080119-0027.jpg_2.jpg,4365,1200,1600,45,582,627,710,807,True,7
5,30,kaist_dataset/Mixed/Digital_Camera/(C.S)C-outdoor1/090.JPG,char_data/5/090.JPG_2.jpg,570,480,640,19,417,436,395,425,True,7
5,38,kaist_dataset/Mixed/Digital_Camera/(C.S)C-outdoor1/105.jpg,char_data/5/105.jpg_4.jpg,1292,480,640,34,222,256,384,422,True,7
5,36,kaist_dataset/Mixed/Digital_Camera/(C.S)C-outdoor1/105.jpg,char_data/5/105.jpg_5.jpg,900,480,640,25,317,342,387,423,True,7
5,31,kaist_dataset/Mixed/Digital_Camera/(C.S)C-outdoor1/118.JPG,char_data/5/118.JPG_2.jpg,713,480,640,23,376,399,360,391,True,7
5,41,kaist_dataset/Mixed/Digital_Camera/(C.S)C-outdoor1/2.JPG,char_data/5/2.JPG_2.jpg,820,576,768,20,421,441,65,106,True,7
5,63,kaist_dataset/Mixed/Digital_Camera/(C.S)C-outdoor1/2007-12-08-day-091.jpg,char_data/5/2007-12-08-day-091.jpg_2.jpg,2898,1200,1600,46,1356,1402,622,685,True,7
5,97,kaist_dataset/Mixed/Digital_Camera/(C.S)C-outdoor1/2007-12-08-day-092.jpg,char_data/5/2007-12-08-day-092.jpg_2.jpg,6790,1200,1600,70,968,1038,659,756,True,7
5,226,kaist_dataset/Mixed/Digital_Camera/(C.S)C-outdoor1/2007-12-08-day-118.jpg,char_data/5/2007-12-08-day-118.jpg_2.jpg,24860,1200,1600,110,1080,1190,548,774,True,7
5,343,kaist_dataset/Mixed/Digital_Camera/(C.S)C-outdoor1/2007-12-08-day-137.jpg,char_data/5/2007-12-08-day-137.jpg_2.jpg,79576,1200,1600,232,946,1178,389,732,True,7
5,63,kaist_dataset/Mixed/Digital_Camera/(C.S)C-outdoor1/2007-12-09-day-exterior-086.jpg,char_data/5/2007-12-09-day-exterior-086.jpg_2.jpg,4536,1200,1600,72,1096,1168,723,786,True,7
5,43,kaist_dataset/Mixed/Digital_Camera/(C.S)C-outdoor1/3.JPG,char_data/5/3.JPG_2.jpg,1032,576,768,24,451,475,419,462,True,7
5,28,kaist_dataset/Mixed/Digital_Camera/(C.S)C-outdoor1/47.JPG,char_data/5/47.JPG_2.jpg,448,576,768,16,403,419,476,504,True,7
5,20,kaist_dataset/Mixed/Digital_Camera/(C.S)C-outdoor1/48.JPG,char_data/5/48.JPG_2.jpg,260,576,768,13,437,450,344,364,True,7
5,40,kaist_dataset/Mixed/Digital_Camera/(C.S)C-outdoor1/51.JPG,char_data/5/51.JPG_2.jpg,1120,576,768,28,663,691,377,417,True,7
5,27,kaist_dataset/Mixed/Digital_Camera/(C.S)C-outdoor1/57.JPG,char_data/5/57.JPG_4.jpg,432,500,766,16,638,654,299,326,True,7
5,27,kaist_dataset/Mixed/Digital_Camera/(C.S)C-outdoor1/57.JPG,char_data/5/57.JPG_5.jpg,297,500,766,11,465,476,454,481,True,7
5,113,kaist_dataset/Mixed/Digital_Camera/(C.S)C-outdoor1/DSC02244.JPG,char_data/5/DSC02244.JPG_2.jpg,8023,480,640,71,342,413,112,225,True,7
5,38,kaist_dataset/Mixed/Digital_Camera/(C.S)C-outdoor1/DSC02320.JPG,char_data/5/DSC02320.JPG_2.jpg,874,480,640,23,504,527,351,389,True,7
5,42,kaist_dataset/Mixed/Digital_Camera/(C.S)C-outdoor1/DSC02325.JPG,char_data/5/DSC02325.JPG_2.jpg,840,480,640,20,369,389,304,346,True,7
5,34,kaist_dataset/Mixed/Digital_Camera/(C.S)C-outdoor1/DSC02344.JPG,char_data/5/DSC02344.JPG_2.jpg,680,480,640,20,565,585,257,291,True,7
5,38,kaist_dataset/Mixed/Digital_Camera/(C.S)C-outdoor1/P1010009.JPG,char_data/5/P1010009.JPG_4.jpg,836,480,640,22,293,315,244,282,True,7
5,37,kaist_dataset/Mixed/Digital_Camera/(C.S)C-outdoor1/P1010009.JPG,char_data/5/P1010009.JPG_5.jpg,999,480,640,27,315,342,243,280,True,7
5,38,kaist_dataset/Mixed/Digital_Camera/(C.S)C-outdoor1/P1010011.JPG,char_data/5/P1010011.JPG_5.jpg,646,480,640,17,540,557,310,348,True,7
5,57,kaist_dataset/Mixed/Digital_Camera/(C.S)C-outdoor1/P1010012.JPG,char_data/5/P1010012.JPG_8.jpg,1938,480,640,34,521,555,231,288,True,7
5,62,kaist_dataset/Mixed/Digital_Camera/(C.S)C-outdoor2/DSC02359.JPG,char_data/5/DSC02359.JPG_2.jpg,1922,480,640,31,284,315,406,468,True,7
5,41,kaist_dataset/Mixed/Digital_Camera/(C.S)C-outdoor2/DSC02361.JPG,char_data/5/DSC02361.JPG_4.jpg,656,480,640,16,575,591,373,414,True,7
5,42,kaist_dataset/Mixed/Digital_Camera/(C.S)C-outdoor2/DSC02361.JPG,char_data/5/DSC02361.JPG_5.jpg,924,480,640,22,607,629,374,416,True,7
5,34,kaist_dataset/Mixed/Digital_Camera/(C.S)C-outdoor2/DSC02368.JPG,char_data/5/DSC02368.JPG_6.jpg,442,480,640,13,199,212,384,418,True,7
5,35,kaist_dataset/Mixed/Digital_Camera/(C.S)C-outdoor2/DSC02368.JPG,char_data/5/DSC02368.JPG_7.jpg,735,480,640,21,233,254,382,417,True,7
5,34,kaist_dataset/Mixed/Digital_Camera/(C.S)C-outdoor2/DSC02368.JPG,char_data/5/DSC02368.JPG_8.jpg,884,480,640,26,561,587,381,415,True,7
5,50,kaist_dataset/Mixed/Digital_Camera/(C.S)C-outdoor2/DSC02374.JPG,char_data/5/DSC02374.JPG_2.jpg,1750,480,640,35,411,446,287,337,True,7
5,39,kaist_dataset/Mixed/Digital_Camera/(C.S)C-outdoor2/DSC02376.JPG,char_data/5/DSC02376.JPG_4.jpg,975,480,640,25,469,494,338,377,True,7
5,46,kaist_dataset/Mixed/Digital_Camera/(C.S)C-outdoor2/DSC02376.JPG,char_data/5/DSC02376.JPG_5.jpg,1196,480,640,26,506,532,334,380,True,7
5,56,kaist_dataset/Mixed/Digital_Camera/(C.S)C-outdoor2/DSC02400.JPG,char_data/5/DSC02400.JPG_2.jpg,2016,480,640,36,243,279,397,453,True,7
5,42,kaist_dataset/Mixed/Digital_Camera/(C.S)C-outdoor2/DSC02411.JPG,char_data/5/DSC02411.JPG_4.jpg,882,480,640,21,508,529,345,387,True,7
5,41,kaist_dataset/Mixed/Digital_Camera/(C.S)C-outdoor2/DSC02411.JPG,char_data/5/DSC02411.JPG_5.jpg,1107,480,640,27,529,556,345,386,True,7
5,32,kaist_dataset/Mixed/Digital_Camera/(C.S)C-outdoor2/DSC02422.JPG,char_data/5/DSC02422.JPG_2.jpg,640,480,640,20,461,481,220,252,True,7
5,32,kaist_dataset/Mixed/Digital_Camera/(C.S)C-outdoor2/DSC02447.JPG,char_data/5/DSC02447.JPG_4.jpg,416,480,640,13,543,556,226,258,True,7
5,33,kaist_dataset/Mixed/Digital_Camera/(C.S)C-outdoor2/DSC02447.JPG,char_data/5/DSC02447.JPG_5.jpg,429,480,640,13,557,570,225,258,True,7
5,23,kaist_dataset/Mixed/Digital_Camera/(C.S)C-outdoor2/DSC02477.JPG,char_data/5/DSC02477.JPG_2.jpg,460,480,640,20,134,154,255,278,True,7
5,44,kaist_dataset/Mixed/Digital_Camera/(C.S)C-outdoor2/DSC02490.JPG,char_data/5/DSC02490.JPG_2.jpg,1320,480,640,30,425,455,341,385,True,7
5,33,kaist_dataset/Mixed/Digital_Camera/(C.S)C-outdoor2/DSC02492.JPG,char_data/5/DSC02492.JPG_2.jpg,627,480,640,19,465,484,323,356,True,7
5,40,kaist_dataset/Mixed/Digital_Camera/(C.S)C-outdoor2/DSC02511.JPG,char_data/5/DSC02511.JPG_6.jpg,960,480,640,24,410,434,214,254,True,7
5,42,kaist_dataset/Mixed/Digital_Camera/(C.S)C-outdoor2/DSC02511.JPG,char_data/5/DSC02511.JPG_7.jpg,1092,480,640,26,363,389,397,439,True,7
5,45,kaist_dataset/Mixed/Digital_Camera/(C.S)C-outdoor2/DSC02511.JPG,char_data/5/DSC02511.JPG_8.jpg,1125,480,640,25,388,413,395,440,True,7
5,33,kaist_dataset/Mixed/Digital_Camera/(C.S)C-outdoor2/DSC02543.JPG,char_data/5/DSC02543.JPG_2.jpg,660,480,640,20,434,454,349,382,True,7
5,35,kaist_dataset/Mixed/Digital_Camera/(C.S)C-outdoor2/DSC02553.JPG,char_data/5/DSC02553.JPG_2.jpg,875,480,640,25,430,455,296,331,True,7
5,29,kaist_dataset/Mixed/Digital_Camera/(C.S)C-outdoor2/DSC02555.JPG,char_data/5/DSC02555.JPG_2.jpg,609,480,640,21,155,176,249,278,True,7
5,35,kaist_dataset/Mixed/Digital_Camera/(C.S)C-outdoor2/DSC02560.JPG,char_data/5/DSC02560.JPG_2.jpg,630,480,640,18,617,635,304,339,True,7
5,100,kaist_dataset/Mixed/Digital_Camera/(C.S)C-outdoor2/DSC02865.JPG,char_data/5/DSC02865.JPG_2.jpg,6200,480,640,62,103,165,299,399,True,7
5,28,kaist_dataset/Mixed/Digital_Camera/(C.S)C-outdoor2/DSC02877.JPG,char_data/5/DSC02877.JPG_4.jpg,476,480,640,17,550,567,220,248,True,7
5,30,kaist_dataset/Mixed/Digital_Camera/(C.S)C-outdoor2/DSC02877.JPG,char_data/5/DSC02877.JPG_5.jpg,420,480,640,14,566,580,218,248,True,7
5,29,kaist_dataset/Mixed/Digital_Camera/(C.S)C-outdoor2/DSC02879.JPG,char_data/5/DSC02879.JPG_2.jpg,319,480,640,11,347,358,272,301,True,7
5,32,kaist_dataset/Mixed/Digital_Camera/(C.S)C-outdoor2/DSC02887.JPG,char_data/5/DSC02887.JPG_2.jpg,704,480,640,22,315,337,121,153,True,7
5,40,kaist_dataset/Mixed/Digital_Camera/(C.S)C-outdoor2/DSC02933.JPG,char_data/5/DSC02933.JPG_2.jpg,720,480,640,18,513,531,242,282,True,7
5,33,kaist_dataset/Mixed/Digital_Camera/(C.S)C-outdoor2/DSC02936.JPG,char_data/5/DSC02936.JPG_4.jpg,594,480,640,18,548,566,223,256,True,7
5,31,kaist_dataset/Mixed/Digital_Camera/(C.S)C-outdoor2/DSC02936.JPG,char_data/5/DSC02936.JPG_5.jpg,372,480,640,12,567,579,225,256,True,7
5,45,kaist_dataset/Mixed/Digital_Camera/(C.S)C-outdoor2/DSC02937.JPG,char_data/5/DSC02937.JPG_6.jpg,1080,480,640,24,194,218,198,243,True,7
5,45,kaist_dataset/Mixed/Digital_Camera/(C.S)C-outdoor2/DSC02937.JPG,char_data/5/DSC02937.JPG_7.jpg,900,480,640,20,219,239,198,243,True,7
5,42,kaist_dataset/Mixed/Digital_Camera/(C.S)C-outdoor2/DSC02937.JPG,char_data/5/DSC02937.JPG_8.jpg,1134,480,640,27,265,292,195,237,True,7
5,19,kaist_dataset/Mixed/Digital_Camera/(C.S)C-outdoor2/P1010015.JPG,char_data/5/P1010015.JPG_2.jpg,228,480,640,12,415,427,190,209,True,7
5,36,kaist_dataset/Mixed/Digital_Camera/(C.S)C-outdoor3/DSC02956.JPG,char_data/5/DSC02956.JPG_4.jpg,792,480,640,22,178,200,392,428,True,7
5,36,kaist_dataset/Mixed/Digital_Camera/(C.S)C-outdoor3/DSC02956.JPG,char_data/5/DSC02956.JPG_5.jpg,576,480,640,16,201,217,392,428,True,7
5,41,kaist_dataset/Mixed/Digital_Camera/(C.S)C-outdoor3/DSC02970.JPG,char_data/5/DSC02970.JPG_2.jpg,1189,480,640,29,469,498,360,401,True,7
5,32,kaist_dataset/Mixed/Digital_Camera/(C.S)C-outdoor3/DSC03017.JPG,char_data/5/DSC03017.JPG_4.jpg,448,480,640,14,468,482,243,275,True,7
5,33,kaist_dataset/Mixed/Digital_Camera/(C.S)C-outdoor3/DSC03017.JPG,char_data/5/DSC03017.JPG_5.jpg,660,480,640,20,482,502,245,278,True,7
5,76,kaist_dataset/Mixed/Digital_Camera/(C.S)C-outdoor3/DSC03063.JPG,char_data/5/DSC03063.JPG_4.jpg,5396,480,640,71,333,404,207,283,True,7
5,49,kaist_dataset/Mixed/Digital_Camera/(C.S)C-outdoor3/DSC03063.JPG,char_data/5/DSC03063.JPG_5.jpg,1519,480,640,31,334,365,288,337,True,7
5,65,kaist_dataset/Mixed/Digital_Camera/(C.S)C-outdoor3/DSC03067.JPG,char_data/5/DSC03067.JPG_2.jpg,2210,480,640,34,170,204,195,260,True,7
5,59,kaist_dataset/Mixed/Digital_Camera/(C.S)C-outdoor3/DSC03177.JPG,char_data/5/DSC03177.JPG_2.jpg,1888,480,640,32,140,172,193,252,True,7
5,39,kaist_dataset/Mixed/Digital_Camera/(C.S)C-outdoor3/DSC03185.JPG,char_data/5/DSC03185.JPG_2.jpg,1638,480,640,42,472,514,161,200,True,7
5,46,kaist_dataset/Mixed/Digital_Camera/(C.S)C-outdoor3/DSC03212.JPG,char_data/5/DSC03212.JPG_2.jpg,920,480,640,20,354,374,250,296,True,7
5,48,kaist_dataset/Mixed/Digital_Camera/(C.S)C-outdoor3/DSC03236.JPG,char_data/5/DSC03236.JPG_2.jpg,1344,480,640,28,359,387,418,466,True,7
5,24,kaist_dataset/Mixed/Digital_Camera/(C.S)C-outdoor3/DSC03255.JPG,char_data/5/DSC03255.JPG_4.jpg,600,480,640,25,269,294,184,208,True,7
5,32,kaist_dataset/Mixed/Digital_Camera/(C.S)C-outdoor3/DSC03255.JPG,char_data/5/DSC03255.JPG_5.jpg,608,480,640,19,295,314,180,212,True,7
5,59,kaist_dataset/Mixed/Digital_Camera/(C.S)C-outdoor3/DSC03274.JPG,char_data/5/DSC03274.JPG_2.jpg,2478,480,640,42,429,471,364,423,True,7
5,26,kaist_dataset/Mixed/Digital_Camera/(C.S)C-outdoor3/DSC03292.JPG,char_data/5/DSC03292.JPG_2.jpg,364,480,640,14,526,540,119,145,True,7
5,35,kaist_dataset/Mixed/Digital_Camera/(C.S)C-outdoor3/DSC03301.JPG,char_data/5/DSC03301.JPG_2.jpg,700,480,640,20,421,441,140,175,True,7
5,24,kaist_dataset/Mixed/Digital_Camera/(C.S)C-outdoor3/DSC03303.JPG,char_data/5/DSC03303.JPG_4.jpg,600,480,640,25,348,373,279,303,True,7
5,26,kaist_dataset/Mixed/Digital_Camera/(C.S)C-outdoor3/DSC03303.JPG,char_data/5/DSC03303.JPG_5.jpg,624,480,640,24,400,424,278,304,True,7
5,37,kaist_dataset/Mixed/Digital_Camera/(C.S)C-outdoor3/DSC03312.JPG,char_data/5/DSC03312.JPG_4.jpg,1147,480,640,31,274,305,282,319,True,7
5,42,kaist_dataset/Mixed/Digital_Camera/(C.S)C-outdoor3/DSC03312.JPG,char_data/5/DSC03312.JPG_5.jpg,1344,480,640,32,311,343,279,321,True,7
5,34,kaist_dataset/Mixed/Digital_Camera/(C.S)C-outdoor3/DSC03328.JPG,char_data/5/DSC03328.JPG_4.jpg,544,480,640,16,174,190,401,435,True,7
5,39,kaist_dataset/Mixed/Digital_Camera/(C.S)C-outdoor3/DSC03328.JPG,char_data/5/DSC03328.JPG_5.jpg,663,480,640,17,355,372,398,437,True,7
5,44,kaist_dataset/Mixed/Digital_Camera/(C.S)C-outdoor4/DSC03534.JPG,char_data/5/DSC03534.JPG_2.jpg,1276,480,640,29,290,319,287,331,True,7
5,90,kaist_dataset/Mixed/Digital_Camera/(C.S)C-outdoor4/DSC03544.JPG,char_data/5/DSC03544.JPG_2.jpg,3240,480,640,36,431,467,168,258,True,7
5,28,kaist_dataset/Mixed/Digital_Camera/(C.S)C-outdoor4/DSC03552.JPG,char_data/5/DSC03552.JPG_2.jpg,392,480,640,14,388,402,320,348,True,7
5,37,kaist_dataset/Mixed/Digital_Camera/(C.S)C-outdoor4/DSC03556.JPG,char_data/5/DSC03556.JPG_4.jpg,666,480,640,18,570,588,260,297,True,7
5,37,kaist_dataset/Mixed/Digital_Camera/(C.S)C-outdoor4/DSC03556.JPG,char_data/5/DSC03556.JPG_5.jpg,518,480,640,14,54,68,316,353,True,7
5,29,kaist_dataset/Mixed/Digital_Camera/(C.S)C-outdoor4/DSC03570.JPG,char_data/5/DSC03570.JPG_4.jpg,522,480,640,18,342,360,423,452,True,7
5,32,kaist_dataset/Mixed/Digital_Camera/(C.S)C-outdoor4/DSC03570.JPG,char_data/5/DSC03570.JPG_5.jpg,544,480,640,17,375,392,424,456,True,7
5,30,kaist_dataset/Mixed/Digital_Camera/(C.S)C-outdoor4/DSC03604.JPG,char_data/5/DSC03604.JPG_2.jpg,600,480,640,20,293,313,144,174,True,7
5,30,kaist_dataset/Mixed/Digital_Camera/(C.S)C-outdoor4/DSC03616.JPG,char_data/5/DSC03616.JPG_2.jpg,630,480,640,21,586,607,156,186,True,7
5,39,kaist_dataset/Mixed/Digital_Camera/(C.S)C-outdoor4/DSC03618.JPG,char_data/5/DSC03618.JPG_2.jpg,1092,480,640,28,407,435,409,448,True,7
5,56,kaist_dataset/Mixed/Digital_Camera/(C.S)C-outdoor4/DSC03621.JPG,char_data/5/DSC03621.JPG_2.jpg,1344,480,640,24,464,488,330,386,True,7
5,44,kaist_dataset/Mixed/Digital_Camera/(C.S)C-outdoor4/DSC03631.JPG,char_data/5/DSC03631.JPG_6.jpg,1276,480,640,29,144,173,354,398,True,7
5,43,kaist_dataset/Mixed/Digital_Camera/(C.S)C-outdoor4/DSC03631.JPG,char_data/5/DSC03631.JPG_7.jpg,1376,480,640,32,261,293,355,398,True,7
5,43,kaist_dataset/Mixed/Digital_Camera/(C.S)C-outdoor4/DSC03631.JPG,char_data/5/DSC03631.JPG_8.jpg,1290,480,640,30,348,378,355,398,True,7
5,47,kaist_dataset/Mixed/Digital_Camera/(C.S)C-outdoor4/DSC03633.JPG,char_data/5/DSC03633.JPG_4.jpg,1316,480,640,28,286,314,266,313,True,7
5,43,kaist_dataset/Mixed/Digital_Camera/(C.S)C-outdoor4/DSC03633.JPG,char_data/5/DSC03633.JPG_5.jpg,1118,480,640,26,315,341,267,310,True,7
5,28,kaist_dataset/Mixed/Digital_Camera/(C.S)C-outdoor4/DSC03634.JPG,char_data/5/DSC03634.JPG_10.jpg,644,480,640,23,427,450,429,457,True,7
5,34,kaist_dataset/Mixed/Digital_Camera/(C.S)C-outdoor4/DSC03634.JPG,char_data/5/DSC03634.JPG_11.jpg,816,480,640,24,506,530,424,458,True,7
5,37,kaist_dataset/Mixed/Digital_Camera/(C.S)C-outdoor4/DSC03634.JPG,char_data/5/DSC03634.JPG_12.jpg,740,480,640,20,551,571,425,462,True,7
5,35,kaist_dataset/Mixed/Digital_Camera/(C.S)C-outdoor4/DSC03634.JPG,char_data/5/DSC03634.JPG_13.jpg,945,480,640,27,324,351,243,278,True,7
5,84,kaist_dataset/Mixed/Digital_Camera/(C.S)C-outdoor4/DSC03634.JPG,char_data/5/DSC03634.JPG_14.jpg,6048,480,640,72,255,327,272,356,True,7
5,30,kaist_dataset/Mixed/Digital_Camera/(C.S)C-outdoor4/DSC03640.JPG,char_data/5/DSC03640.JPG_4.jpg,600,480,640,20,269,289,398,428,True,7
5,27,kaist_dataset/Mixed/Digital_Camera/(C.S)C-outdoor4/DSC03640.JPG,char_data/5/DSC03640.JPG_5.jpg,540,480,640,20,289,309,398,425,True,7
5,34,kaist_dataset/Mixed/Digital_Camera/(C.S)C-outdoor4/DSC03642.JPG,char_data/5/DSC03642.JPG_2.jpg,714,480,640,21,550,571,397,431,True,7
5,25,kaist_dataset/Mixed/Digital_Camera/(C.S)C-outdoor4/DSC03643.JPG,char_data/5/DSC03643.JPG_2.jpg,450,480,640,18,577,595,329,354,True,7
5,47,kaist_dataset/Mixed/Digital_Camera/(C.S)C-outdoor4/DSC03655.JPG,char_data/5/DSC03655.JPG_2.jpg,1316,480,640,28,523,551,390,437,True,7
5,34,kaist_dataset/Mixed/Digital_Camera/(C.S)C-outdoor4/DSC03658.JPG,char_data/5/DSC03658.JPG_2.jpg,646,480,640,19,337,356,415,449,True,7
5,33,kaist_dataset/Mixed/Digital_Camera/(C.S)C-outdoor4/DSC03661.JPG,char_data/5/DSC03661.JPG_4.jpg,693,480,640,21,501,522,329,362,True,7
5,36,kaist_dataset/Mixed/Digital_Camera/(C.S)C-outdoor4/DSC03661.JPG,char_data/5/DSC03661.JPG_5.jpg,720,480,640,20,559,579,328,364,True,7
5,59,kaist_dataset/Mixed/Digital_Camera/(C.S)C-outdoor4/DSC03662.JPG,char_data/5/DSC03662.JPG_2.jpg,1534,480,640,26,579,605,411,470,True,7
5,39,kaist_dataset/Mixed/Digital_Camera/(C.S)C-outdoor4/DSC03667.JPG,char_data/5/DSC03667.JPG_2.jpg,663,480,640,17,440,457,373,412,True,7
5,27,kaist_dataset/Mixed/Digital_Camera/(C.S)C-outdoor4/DSC03670.JPG,char_data/5/DSC03670.JPG_4.jpg,243,480,640,9,481,490,450,477,True,7
5,24,kaist_dataset/Mixed/Digital_Camera/(C.S)C-outdoor4/DSC03670.JPG,char_data/5/DSC03670.JPG_5.jpg,192,480,640,8,490,498,450,474,True,7
5,28,kaist_dataset/Mixed/Digital_Camera/(C.S)C-outdoor4/DSC03673.JPG,char_data/5/DSC03673.JPG_2.jpg,588,480,640,21,198,219,310,338,True,7
5,33,kaist_dataset/Mixed/Digital_Camera/(C.S)C-outdoor4/DSC03675.JPG,char_data/5/DSC03675.JPG_2.jpg,924,480,640,28,575,603,345,378,True,7
5,38,kaist_dataset/Mixed/Digital_Camera/(C.S)C-outdoor4/DSC03677.JPG,char_data/5/DSC03677.JPG_4.jpg,418,480,640,11,609,620,310,348,True,7
5,38,kaist_dataset/Mixed/Digital_Camera/(C.S)C-outdoor4/DSC03677.JPG,char_data/5/DSC03677.JPG_5.jpg,456,480,640,12,630,639,306,344,True,7
5,26,kaist_dataset/Mixed/Digital_Camera/(C.S)C-outdoor4/DSC03687.JPG,char_data/5/DSC03687.JPG_2.jpg,312,480,640,12,515,527,403,429,True,7
5,31,kaist_dataset/Mixed/Digital_Camera/(C.S)C-outdoor4/DSC03691.JPG,char_data/5/DSC03691.JPG_2.jpg,589,480,640,19,561,580,221,252,True,7
5,51,kaist_dataset/Mixed/Digital_Camera/(C.S)C-outdoor4/DSC03693.JPG,char_data/5/DSC03693.JPG_2.jpg,1122,480,640,22,509,531,350,401,True,7
5,76,kaist_dataset/Mixed/Digital_Camera/(C.S)C-outdoor4/DSC03702.JPG,char_data/5/DSC03702.JPG_2.jpg,3496,480,640,46,174,220,327,403,True,7
5,31,kaist_dataset/Mixed/Digital_Camera/(C.S)C-outdoor4/DSC03718.JPG,char_data/5/DSC03718.JPG_2.jpg,527,480,640,17,535,552,405,436,True,7
5,29,kaist_dataset/Mixed/Digital_Camera/(C.S)C-outdoor4/DSC03719.JPG,char_data/5/DSC03719.JPG_2.jpg,464,480,640,16,543,559,182,211,True,7
5,28,kaist_dataset/Mixed/Digital_Camera/(C.S)C-outdoor4/DSC03723.JPG,char_data/5/DSC03723.JPG_4.jpg,504,480,640,18,439,457,196,224,True,7
5,28,kaist_dataset/Mixed/Digital_Camera/(C.S)C-outdoor4/DSC03723.JPG,char_data/5/DSC03723.JPG_5.jpg,588,480,640,21,519,540,198,226,True,7
5,33,kaist_dataset/Mixed/Digital_Camera/(C.S)C-outdoor4/DSC03730.JPG,char_data/5/DSC03730.JPG_4.jpg,759,480,640,23,408,431,254,287,True,7
5,33,kaist_dataset/Mixed/Digital_Camera/(C.S)C-outdoor4/DSC03730.JPG,char_data/5/DSC03730.JPG_5.jpg,759,480,640,23,430,453,251,284,True,7
5,40,kaist_dataset/Mixed/Digital_Camera/(C.S)C-outdoor4/DSC03732.JPG,char_data/5/DSC03732.JPG_4.jpg,1080,480,640,27,416,443,391,431,True,7
5,41,kaist_dataset/Mixed/Digital_Camera/(C.S)C-outdoor4/DSC03732.JPG,char_data/5/DSC03732.JPG_5.jpg,1066,480,640,26,443,469,389,430,True,7
5,30,kaist_dataset/Mixed/Digital_Camera/(C.S)C-outdoor4/DSC03734.JPG,char_data/5/DSC03734.JPG_6.jpg,390,480,640,13,550,563,349,379,True,7
5,35,kaist_dataset/Mixed/Digital_Camera/(C.S)C-outdoor4/DSC03734.JPG,char_data/5/DSC03734.JPG_7.jpg,350,480,640,10,564,574,346,381,True,7
5,28,kaist_dataset/Mixed/Digital_Camera/(C.S)C-outdoor4/DSC03734.JPG,char_data/5/DSC03734.JPG_8.jpg,364,480,640,13,573,586,350,378,True,7
5,40,kaist_dataset/Mixed/Digital_Camera/(C.S)C-outdoor4/DSC03735.JPG,char_data/5/DSC03735.JPG_4.jpg,760,480,640,19,535,554,149,189,True,7
5,40,kaist_dataset/Mixed/Digital_Camera/(C.S)C-outdoor4/DSC03735.JPG,char_data/5/DSC03735.JPG_5.jpg,560,480,640,14,555,569,144,184,True,7
5,27,kaist_dataset/Mixed/Digital_Camera/(C.S)C-outdoor4/DSC03737.JPG,char_data/5/DSC03737.JPG_6.jpg,513,480,640,19,231,250,166,193,True,7
5,30,kaist_dataset/Mixed/Digital_Camera/(C.S)C-outdoor4/DSC03737.JPG,char_data/5/DSC03737.JPG_7.jpg,570,480,640,19,400,419,169,199,False,7
5,32,kaist_dataset/Mixed/Digital_Camera/(C.S)C-outdoor4/DSC03737.JPG,char_data/5/DSC03737.JPG_8.jpg,736,480,640,23,456,479,173,205,False,7
5,42,kaist_dataset/Mixed/Digital_Camera/(C.S)C-outdoor4/DSC03738.JPG,char_data/5/DSC03738.JPG_2.jpg,1428,480,640,34,462,496,238,280,False,7
5,35,kaist_dataset/Mixed/Digital_Camera/(C.S)C-outdoor4/DSC03745.JPG,char_data/5/DSC03745.JPG_4.jpg,875,480,640,25,227,252,272,307,False,7
5,33,kaist_dataset/Mixed/Digital_Camera/(C.S)C-outdoor4/DSC03745.JPG,char_data/5/DSC03745.JPG_5.jpg,561,480,640,17,577,594,274,307,False,7
5,31,kaist_dataset/Mixed/Digital_Camera/(C.S)C-outdoor4/DSC03757.JPG,char_data/5/DSC03757.JPG_8.jpg,434,480,640,14,266,280,337,368,False,7
5,29,kaist_dataset/Mixed/Digital_Camera/(C.S)C-outdoor4/DSC03757.JPG,char_data/5/DSC03757.JPG_9.jpg,377,480,640,13,304,317,341,370,False,7
5,33,kaist_dataset/Mixed/Digital_Camera/(C.S)C-outdoor4/DSC03757.JPG,char_data/5/DSC03757.JPG_10.jpg,396,480,640,12,452,464,339,372,False,7
5,29,kaist_dataset/Mixed/Digital_Camera/(C.S)C-outdoor4/DSC03757.JPG,char_data/5/DSC03757.JPG_11.jpg,348,480,640,12,478,490,339,368,False,7
5,41,kaist_dataset/Mixed/Digital_Camera/(C.S)C-outdoor4/DSC03781.JPG,char_data/5/DSC03781.JPG_2.jpg,1312,480,640,32,354,386,378,419,False,7
5,37,kaist_dataset/Mixed/Digital_Camera/(C.S)C-outdoor5/DSC03839.JPG,char_data/5/DSC03839.JPG_2.jpg,555,480,640,15,272,287,363,400,False,7
5,40,kaist_dataset/Mixed/Digital_Camera/(C.S)C-outdoor5/DSC04014.JPG,char_data/5/DSC04014.JPG_4.jpg,840,480,640,21,282,303,300,340,False,7
5,35,kaist_dataset/Mixed/Digital_Camera/(C.S)C-outdoor5/DSC04014.JPG,char_data/5/DSC04014.JPG_5.jpg,700,480,640,20,321,341,303,338,False,7
5,74,kaist_dataset/Mixed/Digital_Camera/(C.S)C-outdoor5/DSC04016.JPG,char_data/5/DSC04016.JPG_2.jpg,2886,480,640,39,207,246,318,392,False,7
5,40,kaist_dataset/Mixed/Digital_Camera/(C.S)C-outdoor5/DSC04070.JPG,char_data/5/DSC04070.JPG_4.jpg,720,480,640,18,489,507,103,143,False,7
5,40,kaist_dataset/Mixed/Digital_Camera/(C.S)C-outdoor5/DSC04070.JPG,char_data/5/DSC04070.JPG_5.jpg,720,480,640,18,525,543,102,142,False,7
5,88,kaist_dataset/Mixed/Digital_Camera/(C.S)C-outdoor5/DSC04111.JPG,char_data/5/DSC04111.JPG_2.jpg,5280,480,640,60,525,585,97,185,False,7
5,48,kaist_dataset/Mixed/Digital_Camera/(C.S)C-outdoor5/DSC04115.JPG,char_data/5/DSC04115.JPG_2.jpg,1488,480,640,31,485,516,353,401,False,7
5,38,kaist_dataset/Mixed/Digital_Camera/(C.S)C-outdoor5/DSC04122.JPG,char_data/5/DSC04122.JPG_2.jpg,570,480,640,15,440,455,411,449,False,7
5,29,kaist_dataset/Mixed/Digital_Camera/(C.S)C-outdoor5/DSC04124.JPG,char_data/5/DSC04124.JPG_2.jpg,464,480,640,16,477,493,308,337,False,7
5,40,kaist_dataset/Mixed/Digital_Camera/(C.S)C-outdoor5/DSC04125.JPG,char_data/5/DSC04125.JPG_4.jpg,840,480,640,21,167,188,180,220,False,7
5,41,kaist_dataset/Mixed/Digital_Camera/(C.S)C-outdoor5/DSC04125.JPG,char_data/5/DSC04125.JPG_5.jpg,738,480,640,18,535,553,414,455,False,7
5,43,kaist_dataset/Mixed/Digital_Camera/(C.S)C-outdoor5/DSC04139.JPG,char_data/5/DSC04139.JPG_2.jpg,731,480,640,17,310,327,394,437,False,7
5,41,kaist_dataset/Mixed/Digital_Camera/(C.S)C-outdoor5/DSC04140.JPG,char_data/5/DSC04140.JPG_2.jpg,492,480,640,12,530,542,343,384,False,7
5,30,kaist_dataset/Mixed/Digital_Camera/(C.S)C-outdoor5/DSC04150.JPG,char_data/5/DSC04150.JPG_2.jpg,450,480,640,15,583,598,364,394,False,7
5,36,kaist_dataset/Mixed/Digital_Camera/(C.S)C-outdoor5/DSC04330.JPG,char_data/5/DSC04330.JPG_4.jpg,936,480,640,26,325,351,184,220,False,7
5,53,kaist_dataset/Mixed/Digital_Camera/(C.S)C-outdoor5/DSC04330.JPG,char_data/5/DSC04330.JPG_5.jpg,1219,480,640,23,418,441,365,418,False,7
5,26,kaist_dataset/Mixed/Digital_Camera/(C.S)C-outdoor5/DSC04357.JPG,char_data/5/DSC04357.JPG_2.jpg,416,480,640,16,185,201,382,408,False,7
5,65,kaist_dataset/Mixed/Digital_Camera/(C.S)C-outdoor5/DSC04364.JPG,char_data/5/DSC04364.JPG_2.jpg,2470,480,640,38,326,364,392,457,False,7
5,68,kaist_dataset/Mixed/Digital_Camera/(C.S)C-outdoor5/DSC04401.JPG,char_data/5/DSC04401.JPG_2.jpg,2176,480,640,32,599,631,243,311,False,7
5,68,kaist_dataset/Mixed/Digital_Camera/(C.S)C-outdoor5/DSC04450.JPG,char_data/5/DSC04450.JPG_2.jpg,2924,480,640,43,306,349,131,199,False,7
5,167,kaist_dataset/Mixed/Digital_Camera/(C.S)C-outdoor5/DSC04451.JPG,char_data/5/DSC04451.JPG_2.jpg,16032,480,640,96,29,125,284,451,False,7
5,26,kaist_dataset/Mixed/Digital_Camera/(C.S)C-outdoor6/DSC03324.JPG,char_data/5/DSC03324.JPG_4.jpg,364,480,640,14,422,436,154,180,False,7
5,25,kaist_dataset/Mixed/Digital_Camera/(C.S)C-outdoor6/DSC03324.JPG,char_data/5/DSC03324.JPG_5.jpg,350,480,640,14,478,492,154,179,False,7
5,30,kaist_dataset/Mixed/Digital_Camera/(C.S)C-outdoor6/P1010020.JPG,char_data/5/P1010020.JPG_2.jpg,750,480,640,25,264,289,233,263,False,7
5,51,kaist_dataset/Mixed/Digital_Camera/(C.S)C-outdoor6/P1010021.JPG,char_data/5/P1010021.JPG_4.jpg,1428,480,640,28,166,194,209,260,False,7
5,35,kaist_dataset/Mixed/Digital_Camera/(C.S)C-outdoor6/P1010021.JPG,char_data/5/P1010021.JPG_5.jpg,875,480,640,25,613,638,206,241,False,7
5,65,kaist_dataset/Mixed/Digital_Camera/(C.S)C-outdoor6/P1010030.JPG,char_data/5/P1010030.JPG_2.jpg,3185,480,640,49,40,89,395,460,False,7
5,35,kaist_dataset/Mixed/Digital_Camera/(C.S)C-outdoor6/P1010056.JPG,char_data/5/P1010056.JPG_2.jpg,735,480,640,21,381,402,231,266,False,7
5,28,kaist_dataset/Mixed/Digital_Camera/(C.S)C-outdoor6/P1010069.JPG,char_data/5/P1010069.JPG_4.jpg,728,480,640,26,529,555,314,342,False,7
5,31,kaist_dataset/Mixed/Digital_Camera/(C.S)C-outdoor6/P1010069.JPG,char_data/5/P1010069.JPG_5.jpg,837,480,640,27,556,583,313,344,False,7
5,28,kaist_dataset/Mixed/Digital_Camera/(C.S)C-outdoor6/P1010075.JPG,char_data/5/P1010075.JPG_4.jpg,504,480,640,18,467,485,316,344,False,7
5,31,kaist_dataset/Mixed/Digital_Camera/(C.S)C-outdoor6/P1010075.JPG,char_data/5/P1010075.JPG_5.jpg,496,480,640,16,501,517,311,342,False,7
5,32,kaist_dataset/Mixed/Digital_Camera/(C.S)C-outdoor6/P1010080.JPG,char_data/5/P1010080.JPG_2.jpg,768,480,640,24,517,541,248,280,False,7
5,28,kaist_dataset/Mixed/Digital_Camera/(C.S)C-outdoor6/P1010082.JPG,char_data/5/P1010082.JPG_7.jpg,616,480,640,22,217,239,231,259,False,7
5,30,kaist_dataset/Mixed/Digital_Camera/(C.S)C-outdoor6/P1010082.JPG,char_data/5/P1010082.JPG_8.jpg,450,480,640,15,287,302,230,260,False,7
5,48,kaist_dataset/Mixed/Digital_Camera/(C.S)C-outdoor6/P1010084.JPG,char_data/5/P1010084.JPG_2.jpg,1824,480,640,38,454,492,188,236,False,7
5,28,kaist_dataset/Mixed/Digital_Camera/(C.S)C-outdoor6/P1010088.JPG,char_data/5/P1010088.JPG_2.jpg,476,480,640,17,358,375,218,246,False,7
5,25,kaist_dataset/Mixed/Digital_Camera/(C.S)C-outdoor6/P1010094.JPG,char_data/5/P1010094.JPG_2.jpg,700,480,640,28,599,627,219,244,False,7
5,28,kaist_dataset/Mixed/Digital_Camera/(C.S)C-outdoor6/P1010097.JPG,char_data/5/P1010097.JPG_4.jpg,560,480,640,20,84,104,182,210,False,7
5,29,kaist_dataset/Mixed/Digital_Camera/(C.S)C-outdoor6/P1010097.JPG,char_data/5/P1010097.JPG_5.jpg,551,480,640,19,453,472,184,213,False,7
5,25,kaist_dataset/Mixed/Digital_Camera/(C.S)C-outdoor6/P1010099.JPG,char_data/5/P1010099.JPG_2.jpg,350,480,640,14,515,529,209,234,False,7
5,29,kaist_dataset/Mixed/Digital_Camera/(C.S)C-outdoor6/P1010111.JPG,char_data/5/P1010111.JPG_4.jpg,551,480,640,19,324,343,343,372,False,7
5,39,kaist_dataset/Mixed/Digital_Camera/(C.S)C-outdoor6/P1010111.JPG,char_data/5/P1010111.JPG_5.jpg,1326,480,640,34,457,491,205,244,False,7
5,27,kaist_dataset/Mixed/Digital_Camera/(C.S)C-outdoor6/P1010114.JPG,char_data/5/P1010114.JPG_2.jpg,756,480,640,28,581,609,216,243,False,7
5,37,kaist_dataset/Mixed/Digital_Camera/(C.S)C-outdoor6/P1010120.JPG,char_data/5/P1010120.JPG_2.jpg,999,480,640,27,475,502,190,227,False,7
5,23,kaist_dataset/Mixed/Digital_Camera/(C.S)C-outdoor6/P1010129.JPG,char_data/5/P1010129.JPG_2.jpg,345,480,640,15,415,430,237,260,False,7
5,32,kaist_dataset/Mixed/Digital_Camera/(C.S)C-outdoor6/P1010138.JPG,char_data/5/P1010138.JPG_2.jpg,736,480,640,23,438,461,183,215,False,7
5,35,kaist_dataset/Mixed/Digital_Camera/(C.S)C-outdoor6/크기변환_fadscf0009_creawell.jpg,char_data/5/크기변환_fadscf0009_creawell.jpg_4.jpg,560,480,640,16,351,367,159,194,False,7
5,32,kaist_dataset/Mixed/Digital_Camera/(C.S)C-outdoor6/크기변환_fadscf0009_creawell.jpg,char_data/5/크기변환_fadscf0009_creawell.jpg_5.jpg,480,480,640,15,424,439,165,197,False,7
5,35,kaist_dataset/Mixed/Digital_Camera/(C.S)C-outdoor6/크기변환_P1010029.JPG,char_data/5/크기변환_P1010029.JPG_4.jpg,630,480,640,18,149,167,102,137,False,7
5,35,kaist_dataset/Mixed/Digital_Camera/(C.S)C-outdoor6/크기변환_P1010029.JPG,char_data/5/크기변환_P1010029.JPG_5.jpg,735,480,640,21,169,190,100,135,False,7
5,51,kaist_dataset/Mixed/Digital_Camera/(C.S)D-indoor1/DSC02733.JPG,char_data/5/DSC02733.JPG_2.jpg,1632,480,640,32,345,377,390,441,False,7
5,51,kaist_dataset/Mixed/Digital_Camera/(C.S)D-indoor1/DSC02797.JPG,char_data/5/DSC02797.JPG_2.jpg,1836,480,640,36,73,109,278,329,False,7
5,53,kaist_dataset/Mixed/Digital_Camera/(C.S)D-indoor1/DSC02801.JPG,char_data/5/DSC02801.JPG_2.jpg,2120,480,640,40,21,61,271,324,False,7
5,54,kaist_dataset/Mixed/Digital_Camera/(C.S)D-indoor1/DSC02802.JPG,char_data/5/DSC02802.JPG_2.jpg,1944,480,640,36,23,59,267,321,False,7
5,123,kaist_dataset/Mixed/Digital_Camera/(C.S)D-indoor1/DSC03455.JPG,char_data/5/DSC03455.JPG_2.jpg,16236,480,640,132,361,493,93,216,False,7
5,53,kaist_dataset/Mixed/Digital_Camera/(C.S)D-indoor1/DSC03986.JPG,char_data/5/DSC03986.JPG_2.jpg,954,480,640,18,437,455,158,211,False,7
5,68,kaist_dataset/Mixed/Digital_Camera/(C.S)D-indoor1/DSC03998.JPG,char_data/5/DSC03998.JPG_4.jpg,2380,480,640,35,412,447,411,479,False,7
5,63,kaist_dataset/Mixed/Digital_Camera/(C.S)D-indoor1/DSC03998.JPG,char_data/5/DSC03998.JPG_5.jpg,2079,480,640,33,515,548,416,479,False,7
5,108,kaist_dataset/Mixed/Digital_Camera/(C.S)D-indoor1/DSC04002.JPG,char_data/5/DSC04002.JPG_4.jpg,7128,480,640,66,194,260,344,452,False,7
5,99,kaist_dataset/Mixed/Digital_Camera/(C.S)D-indoor1/DSC04002.JPG,char_data/5/DSC04002.JPG_5.jpg,5841,480,640,59,387,446,346,445,False,7
5,25,kaist_dataset/Mixed/Digital_Camera/(C.S)D-indoor1/DSC04005.JPG,char_data/5/DSC04005.JPG_2.jpg,450,480,640,18,472,490,438,463,False,7
5,86,kaist_dataset/Mixed/Digital_Camera/(C.S)D-indoor2/DSC04249.JPG,char_data/5/DSC04249.JPG_4.jpg,6536,480,640,76,190,266,88,174,False,7
5,51,kaist_dataset/Mixed/Digital_Camera/(C.S)D-indoor2/DSC04249.JPG,char_data/5/DSC04249.JPG_5.jpg,2091,480,640,41,450,491,213,264,False,7
5,70,kaist_dataset/Mixed/Digital_Camera/(C.S)E-night/DSC02573.JPG,char_data/5/DSC02573.JPG_2.jpg,2660,480,640,38,481,519,146,216,False,7
5,32,kaist_dataset/Mixed/Digital_Camera/(C.S)E-night/DSC02585.JPG,char_data/5/DSC02585.JPG_2.jpg,416,480,640,13,408,421,419,451,False,7
5,31,kaist_dataset/Mixed/Digital_Camera/(C.S)E-night/DSC02623.JPG,char_data/5/DSC02623.JPG_4.jpg,527,480,640,17,164,181,401,432,False,7
5,32,kaist_dataset/Mixed/Digital_Camera/(C.S)E-night/DSC02623.JPG,char_data/5/DSC02623.JPG_5.jpg,704,480,640,22,198,220,400,432,False,7
5,30,kaist_dataset/Mixed/Digital_Camera/(C.S)E-night/DSC02644.JPG,char_data/5/DSC02644.JPG_2.jpg,570,480,640,19,376,395,404,434,False,7
5,31,kaist_dataset/Mixed/Digital_Camera/(C.S)E-night/DSC02660.JPG,char_data/5/DSC02660.JPG_2.jpg,775,480,640,25,286,311,418,449,False,7
5,29,kaist_dataset/Mixed/Digital_Camera/(C.S)E-night/DSC02673.JPG,char_data/5/DSC02673.JPG_2.jpg,609,480,640,21,377,398,304,333,False,7
5,28,kaist_dataset/Mixed/Digital_Camera/(C.S)E-night/DSC02903.JPG,char_data/5/DSC02903.JPG_2.jpg,420,480,640,15,396,411,270,298,False,7
5,36,kaist_dataset/Mixed/Digital_Camera/(C.S)E-night/DSC03031.JPG,char_data/5/DSC03031.JPG_2.jpg,864,480,640,24,80,104,20,56,False,7
5,26,kaist_dataset/Mixed/Digital_Camera/(C.S)E-night/DSC03840.JPG,char_data/5/DSC03840.JPG_2.jpg,338,480,640,13,489,502,211,237,False,7
5,26,kaist_dataset/Mixed/Digital_Camera/(C.S)E-night/P1010155.JPG,char_data/5/P1010155.JPG_2.jpg,286,480,640,11,505,516,284,310,False,7
5,50,kaist_dataset/Mixed/Digital_Camera/(C.S)F-others/2007-12-08-day-113.jpg,char_data/5/2007-12-08-day-113.jpg_2.jpg,950,1200,1600,19,944,963,426,476,False,7
5,49,kaist_dataset/Mixed/Digital_Camera/(C.S)F-others/2007-12-09-day-exterior-023.jpg,char_data/5/2007-12-09-day-exterior-023.jpg_2.jpg,1568,1200,1600,32,1051,1083,597,646,False,7
5,36,kaist_dataset/Mixed/Digital_Camera/(C.S)F-others/DSC02504.JPG,char_data/5/DSC02504.JPG_2.jpg,1044,480,640,29,486,515,386,422,False,7
5,46,kaist_dataset/Mixed/Digital_Camera/(C.S)F-others/DSC02799.JPG,char_data/5/DSC02799.JPG_2.jpg,966,480,640,21,63,84,393,439,False,7
5,62,kaist_dataset/Mixed/Digital_Camera/(C.S)F-others/DSC02800.JPG,char_data/5/DSC02800.JPG_2.jpg,1922,480,640,31,41,72,267,329,False,7
5,45,kaist_dataset/Mixed/Digital_Camera/(C.S)F-others/DSC02893.JPG,char_data/5/DSC02893.JPG_2.jpg,1710,480,640,38,330,368,334,379,False,7
5,85,kaist_dataset/Mixed/Digital_Camera/(C.S)F-others/DSC03224.JPG,char_data/5/DSC03224.JPG_2.jpg,4420,480,640,52,376,428,204,289,False,7
5,33,kaist_dataset/Mixed/Mobile_Phone/(C.M)A-outdoor/P090908006.jpg,char_data/5/P090908006.jpg_2.jpg,891,480,640,27,471,498,363,396,False,7
5,29,kaist_dataset/Mixed/Mobile_Phone/(C.M)A-outdoor/P090912036.jpg,char_data/5/P090912036.jpg_4.jpg,348,480,640,12,227,239,189,218,False,7
5,29,kaist_dataset/Mixed/Mobile_Phone/(C.M)A-outdoor/P090912036.jpg,char_data/5/P090912036.jpg_5.jpg,406,480,640,14,428,442,191,220,False,7
5,36,kaist_dataset/Mixed/Mobile_Phone/(C.M)A-outdoor/P090912038.jpg,char_data/5/P090912038.jpg_2.jpg,612,480,640,17,472,489,155,191,False,7
5,25,kaist_dataset/Mixed/Mobile_Phone/(C.M)A-outdoor/P090912040.jpg,char_data/5/P090912040.jpg_2.jpg,550,480,640,22,241,263,192,217,False,7
5,71,kaist_dataset/Mixed/Mobile_Phone/(C.M)B-indoor/P090831007.jpg,char_data/5/P090831007.jpg_2.jpg,2982,480,640,42,399,441,202,273,False,7
5,109,kaist_dataset/Mixed/Mobile_Phone/(C.M)C-bookCover/P090902019.jpg,char_data/5/P090902019.jpg_4.jpg,4905,480,640,45,124,169,66,175,False,7
5,64,kaist_dataset/Mixed/Mobile_Phone/(C.M)C-bookCover/P090902019.jpg,char_data/5/P090902019.jpg_5.jpg,2240,480,640,35,77,112,281,345,False,7
5,37,kaist_dataset/Mixed/Mobile_Phone/(C.M)C-bookCover/P090903009.jpg,char_data/5/P090903009.jpg_2.jpg,666,480,640,18,200,218,355,392,False,7
5,96,kaist_dataset/Mixed/Mobile_Phone/(C.M)C-bookCover/P090905002.jpg,char_data/5/P090905002.jpg_2.jpg,6624,480,640,69,353,422,42,138,False,7
o,66,kaist_dataset/English/Digital_Camera/(E.S)A-shadow/DSC02857.JPG,char_data/o/DSC02857.JPG_2.jpg,2970,480,640,45,283,328,212,278,True,41
o,74,kaist_dataset/English/Digital_Camera/(E.S)A-shadow/DSC02858.JPG,char_data/o/DSC02858.JPG_2.jpg,4144,480,640,56,229,285,318,392,True,41
o,42,kaist_dataset/English/Digital_Camera/(E.S)A-shadow/DSC03075.JPG,char_data/o/DSC03075.JPG_4.jpg,1008,480,640,24,175,199,357,399,True,41
o,40,kaist_dataset/English/Digital_Camera/(E.S)A-shadow/DSC03075.JPG,char_data/o/DSC03075.JPG_5.jpg,1080,480,640,27,211,238,360,400,True,41
o,51,kaist_dataset/English/Digital_Camera/(E.S)A-shadow/DSC03079.JPG,char_data/o/DSC03079.JPG_4.jpg,1275,480,640,25,327,352,334,385,True,41
o,54,kaist_dataset/English/Digital_Camera/(E.S)A-shadow/DSC03079.JPG,char_data/o/DSC03079.JPG_5.jpg,1404,480,640,26,365,391,332,386,True,41
o,40,kaist_dataset/English/Digital_Camera/(E.S)A-shadow/DSC03081.JPG,char_data/o/DSC03081.JPG_2.jpg,1000,480,640,25,329,354,415,455,True,41
o,36,kaist_dataset/English/Digital_Camera/(E.S)A-shadow/DSC03082.JPG,char_data/o/DSC03082.JPG_2.jpg,792,480,640,22,188,210,385,421,True,41
o,53,kaist_dataset/English/Digital_Camera/(E.S)A-shadow/DSC03084.JPG,char_data/o/DSC03084.JPG_2.jpg,1166,480,640,22,216,238,371,424,True,41
o,58,kaist_dataset/English/Digital_Camera/(E.S)A-shadow/IMG_2647.JPG,char_data/o/IMG_2647.JPG_2.jpg,2958,480,640,51,361,412,262,320,True,41
o,50,kaist_dataset/English/Digital_Camera/(E.S)A-shadow/P090912074.jpg,char_data/o/P090912074.jpg_2.jpg,1100,480,640,22,549,571,82,132,True,41
o,86,kaist_dataset/English/Digital_Camera/(E.S)B-light/DSC02587.JPG,char_data/o/DSC02587.JPG_2.jpg,5246,480,640,61,242,303,335,421,True,41
o,33,kaist_dataset/English/Digital_Camera/(E.S)B-light/크기변환_%B0%A3%C6%C74_fabdent.jpg,char_data/o/크기변환_%B0%A3%C6%C74_fabdent.jpg_2.jpg,396,480,640,12,208,220,257,290,True,41
o,30,kaist_dataset/English/Digital_Camera/(E.S)C-outdoor1/033.jpg,char_data/o/033.jpg_2.jpg,780,232,354,26,145,171,120,150,True,41
o,42,kaist_dataset/English/Digital_Camera/(E.S)C-outdoor1/055.JPG,char_data/o/055.JPG_2.jpg,1386,480,640,33,30,63,205,247,True,41
o,16,kaist_dataset/English/Digital_Camera/(E.S)C-outdoor1/056.JPG,char_data/o/056.JPG_9.jpg,128,480,640,8,276,284,245,261,True,41
o,17,kaist_dataset/English/Digital_Camera/(E.S)C-outdoor1/056.JPG,char_data/o/056.JPG_10.jpg,153,480,640,9,315,324,244,261,True,41
o,62,kaist_dataset/English/Digital_Camera/(E.S)C-outdoor1/056.JPG,char_data/o/056.JPG_11.jpg,3348,480,640,54,365,419,177,239,True,41
o,30,kaist_dataset/English/Digital_Camera/(E.S)C-outdoor1/077.JPG,char_data/o/077.JPG_2.jpg,1140,480,640,38,198,236,216,246,True,41
o,65,kaist_dataset/English/Digital_Camera/(E.S)C-outdoor1/080116-0064.jpg,char_data/o/080116-0064.jpg_2.jpg,2405,600,800,37,463,500,248,313,True,41
o,42,kaist_dataset/English/Digital_Camera/(E.S)C-outdoor1/080116-0066.jpg,char_data/o/080116-0066.jpg_4.jpg,1344,600,800,32,319,351,353,395,True,41
o,38,kaist_dataset/English/Digital_Camera/(E.S)C-outdoor1/080116-0066.jpg,char_data/o/080116-0066.jpg_5.jpg,1482,600,800,39,549,588,358,396,True,41
o,73,kaist_dataset/English/Digital_Camera/(E.S)C-outdoor1/104.jpg,char_data/o/104.jpg_2.jpg,4891,480,640,67,486,553,121,194,True,41
o,58,kaist_dataset/English/Digital_Camera/(E.S)C-outdoor1/107.jpg,char_data/o/107.jpg_4.jpg,3016,480,640,52,210,262,268,326,True,41
o,52,kaist_dataset/English/Digital_Camera/(E.S)C-outdoor1/107.jpg,char_data/o/107.jpg_5.jpg,2808,480,640,54,262,316,270,322,True,41
o,51,kaist_dataset/English/Digital_Camera/(E.S)C-outdoor1/109.jpg,char_data/o/109.jpg_2.jpg,2193,480,640,43,315,358,239,290,True,41
o,80,kaist_dataset/English/Digital_Camera/(E.S)C-outdoor1/129.JPG,char_data/o/129.JPG_2.jpg,3680,480,640,46,506,552,215,295,True,41
o,38,kaist_dataset/English/Digital_Camera/(E.S)C-outdoor1/137.JPG,char_data/o/137.JPG_4.jpg,722,480,640,19,340,359,262,300,True,41
o,37,kaist_dataset/English/Digital_Camera/(E.S)C-outdoor1/137.JPG,char_data/o/137.JPG_5.jpg,703,480,640,19,360,379,262,299,True,41
o,49,kaist_dataset/English/Digital_Camera/(E.S)C-outdoor1/138.JPG,char_data/o/138.JPG_4.jpg,1519,480,640,31,221,252,256,305,True,41
o,39,kaist_dataset/English/Digital_Camera/(E.S)C-outdoor1/138.JPG,char_data/o/138.JPG_5.jpg,1365,480,640,35,377,412,268,307,True,41
o,123,kaist_dataset/English/Digital_Camera/(E.S)C-outdoor1/2007-12-08-day-015.jpg,char_data/o/2007-12-08-day-015.jpg_6.jpg,21156,1200,1600,172,659,831,511,634,True,41
o,37,kaist_dataset/English/Digital_Camera/(E.S)C-outdoor1/2007-12-08-day-015.jpg,char_data/o/2007-12-08-day-015.jpg_7.jpg,925,1200,1600,25,741,766,819,856,True,41
o,33,kaist_dataset/English/Digital_Camera/(E.S)C-outdoor1/2007-12-08-day-015.jpg,char_data/o/2007-12-08-day-015.jpg_8.jpg,1023,1200,1600,31,943,974,827,860,True,41
o,133,kaist_dataset/English/Digital_Camera/(E.S)C-outdoor1/2007-12-08-day-098.jpg,char_data/o/2007-12-08-day-098.jpg_2.jpg,13832,1200,1600,104,1053,1157,521,654,True,41
o,31,kaist_dataset/English/Digital_Camera/(E.S)C-outdoor1/2007-12-09-day-exterior-063.jpg,char_data/o/2007-12-09-day-exterior-063.jpg_6.jpg,713,1200,1600,23,52,75,536,567,True,41
o,28,kaist_dataset/English/Digital_Camera/(E.S)C-outdoor1/2007-12-09-day-exterior-063.jpg,char_data/o/2007-12-09-day-exterior-063.jpg_7.jpg,588,1200,1600,21,169,190,550,578,True,41
o,10,kaist_dataset/English/Digital_Camera/(E.S)C-outdoor1/7.jpg,char_data/o/7.jpg_6.jpg,110,574,680,11,160,171,108,118,True,41
o,12,kaist_dataset/English/Digital_Camera/(E.S)C-outdoor1/7.jpg,char_data/o/7.jpg_7.jpg,144,574,680,12,171,183,109,121,True,41
o,68,kaist_dataset/English/Digital_Camera/(E.S)C-outdoor1/7.jpg,char_data/o/7.jpg_8.jpg,4148,574,680,61,449,510,267,335,True,41
o,44,kaist_dataset/English/Digital_Camera/(E.S)C-outdoor1/DSC02355.JPG,char_data/o/DSC02355.JPG_2.jpg,924,480,640,21,140,161,300,344,True,41
o,28,kaist_dataset/English/Digital_Camera/(E.S)C-outdoor1/DSC02356.JPG,char_data/o/DSC02356.JPG_5.jpg,700,480,640,25,396,421,315,343,True,41
o,24,kaist_dataset/English/Digital_Camera/(E.S)C-outdoor1/DSC02387.JPG,char_data/o/DSC02387.JPG_2.jpg,480,480,640,20,453,473,300,324,True,41
o,114,kaist_dataset/English/Digital_Camera/(E.S)C-outdoor1/DSC02415.JPG,char_data/o/DSC02415.JPG_2.jpg,10260,480,640,90,419,509,76,190,True,41
o,25,kaist_dataset/English/Digital_Camera/(E.S)C-outdoor1/DSC02427.JPG,char_data/o/DSC02427.JPG_13.jpg,575,480,640,23,440,463,373,398,True,41
o,32,kaist_dataset/English/Digital_Camera/(E.S)C-outdoor1/DSC02427.JPG,char_data/o/DSC02427.JPG_14.jpg,768,480,640,24,537,561,372,404,True,41
o,46,kaist_dataset/English/Digital_Camera/(E.S)C-outdoor1/DSC02442.JPG,char_data/o/DSC02442.JPG_2.jpg,1840,480,640,40,352,392,175,221,True,41
o,69,kaist_dataset/English/Digital_Camera/(E.S)C-outdoor1/DSC02524.JPG,char_data/o/DSC02524.JPG_2.jpg,3519,480,640,51,407,458,326,395,True,41
o,30,kaist_dataset/English/Digital_Camera/(E.S)C-outdoor1/DSC02559.JPG,char_data/o/DSC02559.JPG_4.jpg,780,480,640,26,169,195,129,159,True,41
o,29,kaist_dataset/English/Digital_Camera/(E.S)C-outdoor1/DSC02918.JPG,char_data/o/DSC02918.JPG_4.jpg,783,480,640,27,284,311,238,267,True,41
o,31,kaist_dataset/English/Digital_Camera/(E.S)C-outdoor1/DSC02918.JPG,char_data/o/DSC02918.JPG_5.jpg,775,480,640,25,324,349,236,267,True,41
o,74,kaist_dataset/English/Digital_Camera/(E.S)C-outdoor2/DSC02990.JPG,char_data/o/DSC02990.JPG_2.jpg,5254,480,640,71,194,265,169,243,True,41
o,47,kaist_dataset/English/Digital_Camera/(E.S)C-outdoor2/DSC03001.JPG,char_data/o/DSC03001.JPG_4.jpg,1551,480,640,33,79,112,201,248,True,41
o,48,kaist_dataset/English/Digital_Camera/(E.S)C-outdoor2/DSC03001.JPG,char_data/o/DSC03001.JPG_5.jpg,1776,480,640,37,459,496,190,238,True,41
o,36,kaist_dataset/English/Digital_Camera/(E.S)C-outdoor2/DSC03160.JPG,char_data/o/DSC03160.JPG_4.jpg,792,480,640,22,298,320,155,191,True,41
o,41,kaist_dataset/English/Digital_Camera/(E.S)C-outdoor2/DSC03160.JPG,char_data/o/DSC03160.JPG_5.jpg,984,480,640,24,502,526,144,185,True,41
o,30,kaist_dataset/English/Digital_Camera/(E.S)C-outdoor2/DSC03162.JPG,char_data/o/DSC03162.JPG_2.jpg,630,480,640,21,295,316,151,181,True,41
o,38,kaist_dataset/English/Digital_Camera/(E.S)C-outdoor2/DSC03165.JPG,char_data/o/DSC03165.JPG_4.jpg,1330,480,640,35,242,277,245,283,True,41
o,35,kaist_dataset/English/Digital_Camera/(E.S)C-outdoor2/DSC03165.JPG,char_data/o/DSC03165.JPG_5.jpg,1155,480,640,33,351,384,246,281,True,41
o,43,kaist_dataset/English/Digital_Camera/(E.S)C-outdoor2/DSC03167.JPG,char_data/o/DSC03167.JPG_2.jpg,1591,480,640,37,302,339,302,345,True,41
o,34,kaist_dataset/English/Digital_Camera/(E.S)C-outdoor2/DSC03168.JPG,char_data/o/DSC03168.JPG_4.jpg,1258,480,640,37,267,304,307,341,True,41
o,42,kaist_dataset/English/Digital_Camera/(E.S)C-outdoor2/DSC03168.JPG,char_data/o/DSC03168.JPG_5.jpg,1596,480,640,38,377,415,307,349,True,41
o,41,kaist_dataset/English/Digital_Camera/(E.S)C-outdoor2/DSC03169.JPG,char_data/o/DSC03169.JPG_2.jpg,1394,480,640,34,366,400,299,340,True,41
o,43,kaist_dataset/English/Digital_Camera/(E.S)C-outdoor2/DSC03170.JPG,char_data/o/DSC03170.JPG_2.jpg,1892,480,640,44,448,492,317,360,True,41
o,53,kaist_dataset/English/Digital_Camera/(E.S)C-outdoor2/DSC03201.JPG,char_data/o/DSC03201.JPG_4.jpg,1484,480,640,28,331,359,83,136,True,41
o,46,kaist_dataset/English/Digital_Camera/(E.S)C-outdoor2/DSC03201.JPG,char_data/o/DSC03201.JPG_5.jpg,1564,480,640,34,233,267,140,186,True,41
o,38,kaist_dataset/English/Digital_Camera/(E.S)C-outdoor2/DSC03225.JPG,char_data/o/DSC03225.JPG_5.jpg,836,480,640,22,483,505,86,124,True,41
o,41,kaist_dataset/English/Digital_Camera/(E.S)C-outdoor2/DSC03262.JPG,char_data/o/DSC03262.JPG_2.jpg,1189,480,640,29,282,311,149,190,True,41
o,54,kaist_dataset/English/Digital_Camera/(E.S)C-outdoor2/DSC03290.JPG,char_data/o/DSC03290.JPG_4.jpg,1890,480,640,35,211,246,98,152,True,41
o,43,kaist_dataset/English/Digital_Camera/(E.S)C-outdoor2/DSC03290.JPG,char_data/o/DSC03290.JPG_5.jpg,1333,480,640,31,216,247,311,354,True,41
o,45,kaist_dataset/English/Digital_Camera/(E.S)C-outdoor2/DSC03294.JPG,char_data/o/DSC03294.JPG_5.jpg,1305,480,640,29,513,542,310,355,True,41
o,50,kaist_dataset/English/Digital_Camera/(E.S)C-outdoor2/DSC03297.JPG,char_data/o/DSC03297.JPG_5.jpg,1650,480,640,33,588,621,254,304,True,41
o,84,kaist_dataset/English/Digital_Camera/(E.S)C-outdoor2/DSC03408.JPG,char_data/o/DSC03408.JPG_2.jpg,4788,480,640,57,479,536,343,427,True,41
o,50,kaist_dataset/English/Digital_Camera/(E.S)C-outdoor2/DSC03440.JPG,char_data/o/DSC03440.JPG_4.jpg,1850,480,640,37,163,200,29,79,True,41
o,43,kaist_dataset/English/Digital_Camera/(E.S)C-outdoor2/DSC03440.JPG,char_data/o/DSC03440.JPG_5.jpg,1161,480,640,27,387,414,33,76,True,41
o,100,kaist_dataset/English/Digital_Camera/(E.S)C-outdoor2/DSC03786.JPG,char_data/o/DSC03786.JPG_2.jpg,10300,480,640,103,197,300,332,432,True,41
o,41,kaist_dataset/English/Digital_Camera/(E.S)C-outdoor2/DSC03865.JPG,char_data/o/DSC03865.JPG_4.jpg,1066,480,640,26,50,76,55,96,True,41
o,50,kaist_dataset/English/Digital_Camera/(E.S)C-outdoor2/DSC04047.JPG,char_data/o/DSC04047.JPG_2.jpg,2400,480,640,48,398,446,238,288,True,41
o,57,kaist_dataset/English/Digital_Camera/(E.S)C-outdoor2/DSC04052.JPG,char_data/o/DSC04052.JPG_4.jpg,2223,480,640,39,305,344,172,229,True,41
o,33,kaist_dataset/English/Digital_Camera/(E.S)C-outdoor2/DSC04052.JPG,char_data/o/DSC04052.JPG_5.jpg,825,480,640,25,515,540,190,223,True,41
o,44,kaist_dataset/English/Digital_Camera/(E.S)C-outdoor2/DSC04064.JPG,char_data/o/DSC04064.JPG_4.jpg,1364,480,640,31,98,129,130,174,True,41
o,44,kaist_dataset/English/Digital_Camera/(E.S)C-outdoor2/DSC04064.JPG,char_data/o/DSC04064.JPG_5.jpg,1232,480,640,28,130,158,133,177,True,41
o,50,kaist_dataset/English/Digital_Camera/(E.S)C-outdoor2/DSC04066.JPG,char_data/o/DSC04066.JPG_4.jpg,1750,480,640,35,403,438,343,393,True,41
o,58,kaist_dataset/English/Digital_Camera/(E.S)C-outdoor2/DSC04066.JPG,char_data/o/DSC04066.JPG_5.jpg,2030,480,640,35,438,473,336,394,True,41
o,37,kaist_dataset/English/Digital_Camera/(E.S)C-outdoor2/DSC04079.JPG,char_data/o/DSC04079.JPG_16.jpg,1073,480,640,29,142,171,118,155,True,41
o,37,kaist_dataset/English/Digital_Camera/(E.S)C-outdoor2/DSC04079.JPG,char_data/o/DSC04079.JPG_17.jpg,999,480,640,27,171,198,118,155,True,41
o,31,kaist_dataset/English/Digital_Camera/(E.S)C-outdoor2/DSC04079.JPG,char_data/o/DSC04079.JPG_18.jpg,713,480,640,23,258,281,122,153,True,41
o,33,kaist_dataset/English/Digital_Camera/(E.S)C-outdoor2/DSC04079.JPG,char_data/o/DSC04079.JPG_19.jpg,759,480,640,23,342,365,123,156,True,41
o,29,kaist_dataset/English/Digital_Camera/(E.S)C-outdoor2/DSC04079.JPG,char_data/o/DSC04079.JPG_20.jpg,754,480,640,26,124,150,165,194,True,41
o,31,kaist_dataset/English/Digital_Camera/(E.S)C-outdoor2/DSC04437.JPG,char_data/o/DSC04437.JPG_17.jpg,372,480,640,12,245,257,42,73,True,41
o,25,kaist_dataset/English/Digital_Camera/(E.S)C-outdoor2/DSC04437.JPG,char_data/o/DSC04437.JPG_18.jpg,375,480,640,15,254,269,45,70,True,41
o,24,kaist_dataset/English/Digital_Camera/(E.S)C-outdoor2/DSC04437.JPG,char_data/o/DSC04437.JPG_19.jpg,288,480,640,12,295,307,50,74,True,41
o,28,kaist_dataset/English/Digital_Camera/(E.S)C-outdoor2/DSC04437.JPG,char_data/o/DSC04437.JPG_20.jpg,308,480,640,11,334,345,46,74,True,41
o,23,kaist_dataset/English/Digital_Camera/(E.S)C-outdoor2/DSC04437.JPG,char_data/o/DSC04437.JPG_22.jpg,322,480,640,14,232,246,80,103,True,41
o,100,kaist_dataset/English/Digital_Camera/(E.S)C-outdoor2/P1010060.JPG,char_data/o/P1010060.JPG_2.jpg,10400,480,640,104,237,341,137,237,True,41
o,62,kaist_dataset/English/Digital_Camera/(E.S)C-outdoor3/P1010064.JPG,char_data/o/P1010064.JPG_5.jpg,3038,480,640,49,549,598,335,397,True,41
o,30,kaist_dataset/English/Digital_Camera/(E.S)C-outdoor3/크기변환_%B0%A3%C6%C71_m_starfirm.jpg,char_data/o/크기변환_%B0%A3%C6%C71_m_starfirm.jpg_6.jpg,1020,480,640,34,159,193,285,315,True,41
o,27,kaist_dataset/English/Digital_Camera/(E.S)C-outdoor3/크기변환_%B0%A3%C6%C71_m_starfirm.jpg,char_data/o/크기변환_%B0%A3%C6%C71_m_starfirm.jpg_7.jpg,864,480,640,32,193,225,287,314,True,41
o,32,kaist_dataset/English/Digital_Camera/(E.S)C-outdoor3/크기변환_%B0%A3%C6%C71_m_starfirm.jpg,char_data/o/크기변환_%B0%A3%C6%C71_m_starfirm.jpg_8.jpg,832,480,640,26,468,494,285,317,True,41
o,18,kaist_dataset/English/Digital_Camera/(E.S)C-outdoor3/크기변환_P1010076.JPG,char_data/o/크기변환_P1010076.JPG_2.jpg,198,480,640,11,304,315,103,121,True,41
o,33,kaist_dataset/English/Digital_Camera/(E.S)D-indoor/080119-0009.jpg,char_data/o/080119-0009.jpg_14.jpg,495,1200,1600,15,616,631,1028,1061,True,41
o,34,kaist_dataset/English/Digital_Camera/(E.S)D-indoor/080119-0009.jpg,char_data/o/080119-0009.jpg_15.jpg,646,1200,1600,19,711,730,1057,1091,True,41
o,33,kaist_dataset/English/Digital_Camera/(E.S)D-indoor/080119-0009.jpg,char_data/o/080119-0009.jpg_16.jpg,561,1200,1600,17,753,770,1069,1102,True,41
o,41,kaist_dataset/English/Digital_Camera/(E.S)D-indoor/080119-0009.jpg,char_data/o/080119-0009.jpg_17.jpg,574,1200,1600,14,617,631,1067,1108,True,41
o,36,kaist_dataset/English/Digital_Camera/(E.S)D-indoor/080119-0009.jpg,char_data/o/080119-0009.jpg_20.jpg,756,1200,1600,21,762,783,1000,1036,True,41
o,43,kaist_dataset/English/Digital_Camera/(E.S)D-indoor/DSC02719.JPG,char_data/o/DSC02719.JPG_4.jpg,1634,480,640,38,165,203,299,342,True,41
o,51,kaist_dataset/English/Digital_Camera/(E.S)D-indoor/DSC02719.JPG,char_data/o/DSC02719.JPG_5.jpg,1989,480,640,39,302,341,294,345,True,41
o,72,kaist_dataset/English/Digital_Camera/(E.S)D-indoor/DSC02842.JPG,char_data/o/DSC02842.JPG_7.jpg,4824,480,640,67,233,300,78,150,True,41
o,79,kaist_dataset/English/Digital_Camera/(E.S)D-indoor/DSC02842.JPG,char_data/o/DSC02842.JPG_8.jpg,5451,480,640,69,446,515,90,169,True,41
o,47,kaist_dataset/English/Digital_Camera/(E.S)D-indoor/DSC02859.JPG,char_data/o/DSC02859.JPG_2.jpg,1692,480,640,36,401,437,348,395,True,41
o,54,kaist_dataset/English/Digital_Camera/(E.S)D-indoor/DSC03074.JPG,char_data/o/DSC03074.JPG_4.jpg,1188,480,640,22,142,164,268,322,True,41
o,54,kaist_dataset/English/Digital_Camera/(E.S)D-indoor/DSC03074.JPG,char_data/o/DSC03074.JPG_5.jpg,1242,480,640,23,184,207,266,320,True,41
o,44,kaist_dataset/English/Digital_Camera/(E.S)D-indoor/DSC03078.JPG,char_data/o/DSC03078.JPG_8.jpg,1364,480,640,31,167,198,238,282,True,41
o,42,kaist_dataset/English/Digital_Camera/(E.S)D-indoor/DSC03078.JPG,char_data/o/DSC03078.JPG_9.jpg,1302,480,640,31,233,264,240,282,True,41
o,50,kaist_dataset/English/Digital_Camera/(E.S)D-indoor/DSC03078.JPG,char_data/o/DSC03078.JPG_10.jpg,1550,480,640,31,501,532,237,287,True,41
o,44,kaist_dataset/English/Digital_Camera/(E.S)D-indoor/DSC03078.JPG,char_data/o/DSC03078.JPG_11.jpg,1452,480,640,33,413,446,314,358,True,41
o,67,kaist_dataset/English/Digital_Camera/(E.S)D-indoor/DSC03080.JPG,char_data/o/DSC03080.JPG_4.jpg,3417,480,640,51,242,293,371,438,True,41
o,69,kaist_dataset/English/Digital_Camera/(E.S)D-indoor/DSC03080.JPG,char_data/o/DSC03080.JPG_5.jpg,3588,480,640,52,336,388,367,436,True,41
o,40,kaist_dataset/English/Digital_Camera/(E.S)D-indoor/DSC03083.JPG,char_data/o/DSC03083.JPG_2.jpg,1160,480,640,29,210,239,406,446,True,41
o,61,kaist_dataset/English/Digital_Camera/(E.S)D-indoor/DSC03085.JPG,char_data/o/DSC03085.JPG_2.jpg,2074,480,640,34,431,465,378,439,True,41
o,52,kaist_dataset/English/Digital_Camera/(E.S)D-indoor/DSC03087.JPG,char_data/o/DSC03087.JPG_4.jpg,2184,480,640,42,343,385,375,427,True,41
o,54,kaist_dataset/English/Digital_Camera/(E.S)D-indoor/DSC03087.JPG,char_data/o/DSC03087.JPG_5.jpg,2106,480,640,39,410,449,375,429,True,41
o,38,kaist_dataset/English/Digital_Camera/(E.S)D-indoor/DSC03090.JPG,char_data/o/DSC03090.JPG_20.jpg,912,480,640,24,130,154,244,282,True,41
o,38,kaist_dataset/English/Digital_Camera/(E.S)D-indoor/DSC03090.JPG,char_data/o/DSC03090.JPG_21.jpg,836,480,640,22,181,203,246,284,True,41
o,36,kaist_dataset/English/Digital_Camera/(E.S)D-indoor/DSC03090.JPG,char_data/o/DSC03090.JPG_22.jpg,792,480,640,22,351,373,244,280,True,41
o,34,kaist_dataset/English/Digital_Camera/(E.S)D-indoor/DSC03090.JPG,char_data/o/DSC03090.JPG_23.jpg,748,480,640,22,460,482,246,280,True,41
o,32,kaist_dataset/English/Digital_Camera/(E.S)D-indoor/DSC03090.JPG,char_data/o/DSC03090.JPG_24.jpg,832,480,640,26,480,506,247,279,True,41
o,34,kaist_dataset/English/Digital_Camera/(E.S)D-indoor/DSC03090.JPG,char_data/o/DSC03090.JPG_25.jpg,578,480,640,17,253,270,297,331,True,41
o,36,kaist_dataset/English/Digital_Camera/(E.S)D-indoor/DSC03090.JPG,char_data/o/DSC03090.JPG_26.jpg,576,480,640,16,270,286,297,333,True,41
o,45,kaist_dataset/English/Digital_Camera/(E.S)D-indoor/DSC03090.JPG,char_data/o/DSC03090.JPG_27.jpg,765,480,640,17,394,411,291,336,True,41
o,36,kaist_dataset/English/Digital_Camera/(E.S)D-indoor/DSC03090.JPG,char_data/o/DSC03090.JPG_28.jpg,648,480,640,18,461,479,296,332,True,41
o,40,kaist_dataset/English/Digital_Camera/(E.S)D-indoor/DSC03090.JPG,char_data/o/DSC03090.JPG_29.jpg,760,480,640,19,476,495,295,335,True,41
o,53,kaist_dataset/English/Digital_Camera/(E.S)D-indoor/DSC03091.JPG,char_data/o/DSC03091.JPG_4.jpg,2809,480,640,53,489,542,132,185,True,41
o,56,kaist_dataset/English/Digital_Camera/(E.S)D-indoor/DSC03093.JPG,char_data/o/DSC03093.JPG_2.jpg,2632,480,640,47,369,416,133,189,True,41
o,46,kaist_dataset/English/Digital_Camera/(E.S)D-indoor/DSC03112.JPG,char_data/o/DSC03112.JPG_4.jpg,1886,480,640,41,284,325,265,311,True,41
o,47,kaist_dataset/English/Digital_Camera/(E.S)D-indoor/DSC03112.JPG,char_data/o/DSC03112.JPG_5.jpg,1786,480,640,38,325,363,265,312,True,41
o,59,kaist_dataset/English/Digital_Camera/(E.S)D-indoor/DSC03136.JPG,char_data/o/DSC03136.JPG_8.jpg,1829,480,640,31,152,183,258,317,True,41
o,56,kaist_dataset/English/Digital_Camera/(E.S)D-indoor/DSC03136.JPG,char_data/o/DSC03136.JPG_9.jpg,1792,480,640,32,182,214,260,316,True,41
o,57,kaist_dataset/English/Digital_Camera/(E.S)D-indoor/DSC03136.JPG,char_data/o/DSC03136.JPG_10.jpg,1881,480,640,33,294,327,261,318,True,41
o,53,kaist_dataset/English/Digital_Camera/(E.S)D-indoor/DSC03136.JPG,char_data/o/DSC03136.JPG_11.jpg,1537,480,640,29,418,447,265,318,True,41
o,29,kaist_dataset/English/Digital_Camera/(E.S)D-indoor/DSC03142.JPG,char_data/o/DSC03142.JPG_4.jpg,696,480,640,24,350,374,434,463,True,41
o,30,kaist_dataset/English/Digital_Camera/(E.S)D-indoor/DSC03142.JPG,char_data/o/DSC03142.JPG_5.jpg,780,480,640,26,233,259,369,399,True,41
o,34,kaist_dataset/English/Digital_Camera/(E.S)D-indoor/DSC03144.JPG,char_data/o/DSC03144.JPG_8.jpg,714,480,640,21,305,326,240,274,True,41
o,29,kaist_dataset/English/Digital_Camera/(E.S)D-indoor/DSC03144.JPG,char_data/o/DSC03144.JPG_9.jpg,667,480,640,23,483,506,244,273,True,41
o,33,kaist_dataset/English/Digital_Camera/(E.S)D-indoor/DSC03144.JPG,char_data/o/DSC03144.JPG_10.jpg,693,480,640,21,301,322,292,325,True,41
o,25,kaist_dataset/English/Digital_Camera/(E.S)D-indoor/DSC03144.JPG,char_data/o/DSC03144.JPG_11.jpg,500,480,640,20,490,510,295,320,True,41
o,37,kaist_dataset/English/Digital_Camera/(E.S)D-indoor/DSC03145.JPG,char_data/o/DSC03145.JPG_8.jpg,777,480,640,21,196,217,179,216,True,41
o,25,kaist_dataset/English/Digital_Camera/(E.S)D-indoor/DSC03145.JPG,char_data/o/DSC03145.JPG_9.jpg,550,480,640,22,383,405,185,210,True,41
o,34,kaist_dataset/English/Digital_Camera/(E.S)D-indoor/DSC03145.JPG,char_data/o/DSC03145.JPG_10.jpg,680,480,640,20,203,223,125,159,True,41
o,28,kaist_dataset/English/Digital_Camera/(E.S)D-indoor/DSC03145.JPG,char_data/o/DSC03145.JPG_11.jpg,616,480,640,22,378,400,130,158,True,41
o,39,kaist_dataset/English/Digital_Camera/(E.S)D-indoor/DSC03146.JPG,char_data/o/DSC03146.JPG_8.jpg,936,480,640,24,375,399,233,272,True,41
o,37,kaist_dataset/English/Digital_Camera/(E.S)D-indoor/DSC03146.JPG,char_data/o/DSC03146.JPG_9.jpg,888,480,640,24,528,552,238,275,True,41
o,30,kaist_dataset/English/Digital_Camera/(E.S)D-indoor/DSC03146.JPG,char_data/o/DSC03146.JPG_10.jpg,690,480,640,23,438,461,183,213,True,41
o,32,kaist_dataset/English/Digital_Camera/(E.S)D-indoor/DSC03146.JPG,char_data/o/DSC03146.JPG_11.jpg,800,480,640,25,531,556,186,218,True,41
o,32,kaist_dataset/English/Digital_Camera/(E.S)D-indoor/DSC03147.JPG,char_data/o/DSC03147.JPG_8.jpg,736,480,640,23,209,232,301,333,True,41
o,27,kaist_dataset/English/Digital_Camera/(E.S)D-indoor/DSC03147.JPG,char_data/o/DSC03147.JPG_9.jpg,567,480,640,21,508,529,302,329,True,41
o,27,kaist_dataset/English/Digital_Camera/(E.S)D-indoor/DSC03147.JPG,char_data/o/DSC03147.JPG_10.jpg,621,480,640,23,214,237,245,272,True,41
o,36,kaist_dataset/English/Digital_Camera/(E.S)D-indoor/DSC03147.JPG,char_data/o/DSC03147.JPG_11.jpg,792,480,640,22,505,527,241,277,True,41
o,40,kaist_dataset/English/Digital_Camera/(E.S)D-indoor/DSC03149.JPG,char_data/o/DSC03149.JPG_8.jpg,1480,480,640,37,261,298,392,432,True,41
o,38,kaist_dataset/English/Digital_Camera/(E.S)D-indoor/DSC03149.JPG,char_data/o/DSC03149.JPG_9.jpg,1140,480,640,30,297,327,394,432,True,41
o,34,kaist_dataset/English/Digital_Camera/(E.S)D-indoor/DSC03149.JPG,char_data/o/DSC03149.JPG_10.jpg,1020,480,640,30,376,406,400,434,True,41
o,40,kaist_dataset/English/Digital_Camera/(E.S)D-indoor/DSC03149.JPG,char_data/o/DSC03149.JPG_11.jpg,1280,480,640,32,477,509,399,439,True,41
o,45,kaist_dataset/English/Digital_Camera/(E.S)D-indoor/DSC03150.JPG,char_data/o/DSC03150.JPG_4.jpg,1755,480,640,39,81,120,39,84,True,41
o,56,kaist_dataset/English/Digital_Camera/(E.S)D-indoor/DSC03150.JPG,char_data/o/DSC03150.JPG_5.jpg,2240,480,640,40,327,367,26,82,True,41
o,42,kaist_dataset/English/Digital_Camera/(E.S)D-indoor/DSC03151.JPG,char_data/o/DSC03151.JPG_2.jpg,1344,480,640,32,119,151,114,156,True,41
o,63,kaist_dataset/English/Digital_Camera/(E.S)D-indoor/DSC03395.JPG,char_data/o/DSC03395.JPG_2.jpg,2646,480,640,42,195,237,408,471,True,41
o,28,kaist_dataset/English/Digital_Camera/(E.S)D-indoor/DSC03532.JPG,char_data/o/DSC03532.JPG_4.jpg,560,480,640,20,59,79,377,405,True,41
o,23,kaist_dataset/English/Digital_Camera/(E.S)D-indoor/DSC03532.JPG,char_data/o/DSC03532.JPG_5.jpg,414,480,640,18,154,172,386,409,True,41
o,49,kaist_dataset/English/Digital_Camera/(E.S)D-indoor/DSC03936.JPG,char_data/o/DSC03936.JPG_4.jpg,1715,480,640,35,272,307,89,138,True,41
o,50,kaist_dataset/English/Digital_Camera/(E.S)D-indoor/DSC03936.JPG,char_data/o/DSC03936.JPG_5.jpg,1150,480,640,23,540,563,90,140,True,41
o,37,kaist_dataset/English/Digital_Camera/(E.S)D-indoor/DSC03947.JPG,char_data/o/DSC03947.JPG_8.jpg,1221,480,640,33,369,402,282,319,True,41
o,33,kaist_dataset/English/Digital_Camera/(E.S)D-indoor/DSC03947.JPG,char_data/o/DSC03947.JPG_9.jpg,1089,480,640,33,321,354,426,459,True,41
o,40,kaist_dataset/English/Digital_Camera/(E.S)D-indoor/DSC03947.JPG,char_data/o/DSC03947.JPG_10.jpg,1160,480,640,29,435,464,425,465,True,41
o,52,kaist_dataset/English/Digital_Camera/(E.S)D-indoor/DSC04023.JPG,char_data/o/DSC04023.JPG_4.jpg,1976,480,640,38,431,469,252,304,True,41
o,31,kaist_dataset/English/Digital_Camera/(E.S)D-indoor/DSC04023.JPG,char_data/o/DSC04023.JPG_5.jpg,651,480,640,21,415,436,324,355,True,41
o,37,kaist_dataset/English/Digital_Camera/(E.S)D-indoor/크기변환_%B0%A3%C6%C76_fabdent.jpg,char_data/o/크기변환_%B0%A3%C6%C76_fabdent.jpg_2.jpg,777,480,640,21,280,301,193,230,True,41
o,61,kaist_dataset/English/Digital_Camera/(E.S)E-night/111.jpg,char_data/o/111.jpg_2.jpg,2745,480,640,45,328,373,198,259,True,41
o,86,kaist_dataset/English/Digital_Camera/(E.S)E-night/DSC02610.JPG,char_data/o/DSC02610.JPG_8.jpg,7998,480,640,93,216,309,176,262,True,41
o,49,kaist_dataset/English/Digital_Camera/(E.S)E-night/DSC02610.JPG,char_data/o/DSC02610.JPG_9.jpg,1323,480,640,27,228,255,268,317,True,41
o,34,kaist_dataset/English/Digital_Camera/(E.S)E-night/DSC02610.JPG,char_data/o/DSC02610.JPG_10.jpg,1054,480,640,31,324,355,274,308,True,41
o,33,kaist_dataset/English/Digital_Camera/(E.S)E-night/DSC02610.JPG,char_data/o/DSC02610.JPG_11.jpg,858,480,640,26,426,452,269,302,True,41
o,68,kaist_dataset/English/Digital_Camera/(E.S)E-night/DSC02981.JPG,char_data/o/DSC02981.JPG_2.jpg,2720,480,640,40,253,293,380,448,True,41
o,47,kaist_dataset/English/Digital_Camera/(E.S)F-others/080119-0007.jpg,char_data/o/080119-0007.jpg_6.jpg,1927,1200,1600,41,793,834,837,884,True,41
o,51,kaist_dataset/English/Digital_Camera/(E.S)F-others/080119-0007.jpg,char_data/o/080119-0007.jpg_7.jpg,1989,1200,1600,39,974,1013,796,847,True,41
o,33,kaist_dataset/English/Digital_Camera/(E.S)F-others/080119-0007.jpg,char_data/o/080119-0007.jpg_8.jpg,660,1200,1600,20,798,818,910,943,True,41
o,74,kaist_dataset/English/Digital_Camera/(E.S)F-others/DSC02925.JPG,char_data/o/DSC02925.JPG_2.jpg,5402,480,640,73,238,311,264,338,True,41
o,28,kaist_dataset/English/Digital_Camera/(E.S)F-others/DSC03218.JPG,char_data/o/DSC03218.JPG_2.jpg,840,480,640,30,343,373,328,356,True,41
o,87,kaist_dataset/English/Digital_Camera/(E.S)F-others/크기변환_%B0%A3%C6%C72_ktimt007.jpg,char_data/o/크기변환_%B0%A3%C6%C72_ktimt007.jpg_2.jpg,4176,480,640,48,135,183,242,329,True,41
o,62,kaist_dataset/English/Mobile_Phone/(E.M)A-outdoor/P090911071.jpg,char_data/o/P090911071.jpg_6.jpg,2976,480,640,48,133,181,146,208,True,41
o,65,kaist_dataset/English/Mobile_Phone/(E.M)A-outdoor/P090911071.jpg,char_data/o/P090911071.jpg_7.jpg,3445,480,640,53,179,232,145,210,True,41
o,54,kaist_dataset/English/Mobile_Phone/(E.M)A-outdoor/P090911071.jpg,char_data/o/P090911071.jpg_8.jpg,2052,480,640,38,334,372,138,192,True,41
o,49,kaist_dataset/English/Mobile_Phone/(E.M)A-outdoor/P090912072.jpg,char_data/o/P090912072.jpg_2.jpg,2107,480,640,43,72,115,113,162,True,41
o,73,kaist_dataset/English/Mobile_Phone/(E.M)B-indoor/P090831011.jpg,char_data/o/P090831011.jpg_2.jpg,3723,480,640,51,115,166,136,209,True,41
o,52,kaist_dataset/English/Mobile_Phone/(E.M)B-indoor/P090902018.jpg,char_data/o/P090902018.jpg_5.jpg,2496,480,640,48,529,577,202,254,True,41
o,82,kaist_dataset/English/Mobile_Phone/(E.M)B-indoor/P090903003.jpg,char_data/o/P090903003.jpg_2.jpg,6232,480,640,76,184,260,269,351,True,41
o,51,kaist_dataset/English/Mobile_Phone/(E.M)B-indoor/P090903008.jpg,char_data/o/P090903008.jpg_2.jpg,2244,480,640,44,85,129,40,91,True,41
o,53,kaist_dataset/English/Mobile_Phone/(E.M)B-indoor/P090911060.jpg,char_data/o/P090911060.jpg_4.jpg,2014,480,640,38,76,114,22,75,True,41
o,42,kaist_dataset/English/Mobile_Phone/(E.M)B-indoor/P090911060.jpg,char_data/o/P090911060.jpg_5.jpg,1260,480,640,30,333,363,25,67,True,41
o,56,kaist_dataset/English/Mobile_Phone/(E.M)B-indoor/P090911067.jpg,char_data/o/P090911067.jpg_2.jpg,1456,480,640,26,379,405,225,281,True,41
o,120,kaist_dataset/English/Mobile_Phone/(E.M)B-indoor/P090911075.jpg,char_data/o/P090911075.jpg_2.jpg,13800,480,640,115,33,148,120,240,True,41
o,60,kaist_dataset/English/Mobile_Phone/(E.M)B-indoor/P090911080.jpg,char_data/o/P090911080.jpg_2.jpg,2460,480,640,41,228,269,232,292,True,41
o,59,kaist_dataset/English/Mobile_Phone/(E.M)B-indoor/P090911083.jpg,char_data/o/P090911083.jpg_6.jpg,3245,480,640,55,125,180,222,281,True,41
o,64,kaist_dataset/English/Mobile_Phone/(E.M)B-indoor/P090911083.jpg,char_data/o/P090911083.jpg_7.jpg,3712,480,640,58,180,238,219,283,True,41
o,61,kaist_dataset/English/Mobile_Phone/(E.M)B-indoor/P090911083.jpg,char_data/o/P090911083.jpg_8.jpg,3294,480,640,54,393,447,226,287,True,41
o,78,kaist_dataset/English/Mobile_Phone/(E.M)B-indoor/P090911086.jpg,char_data/o/P090911086.jpg_6.jpg,3822,480,640,49,89,138,368,446,True,41
o,79,kaist_dataset/English/Mobile_Phone/(E.M)B-indoor/P090911086.jpg,char_data/o/P090911086.jpg_7.jpg,4424,480,640,56,255,311,373,452,True,41
o,86,kaist_dataset/English/Mobile_Phone/(E.M)B-indoor/P090911086.jpg,char_data/o/P090911086.jpg_8.jpg,4644,480,640,54,429,483,370,456,True,41
o,117,kaist_dataset/English/Mobile_Phone/(E.M)C-bookCover/P090831022.jpg,char_data/o/P090831022.jpg_2.jpg,12753,480,640,109,148,257,158,275,True,41
o,69,kaist_dataset/English/Mobile_Phone/(E.M)C-bookCover/P090831039.jpg,char_data/o/P090831039.jpg_8.jpg,4071,480,640,59,358,417,128,197,True,41
o,65,kaist_dataset/English/Mobile_Phone/(E.M)C-bookCover/P090831039.jpg,char_data/o/P090831039.jpg_9.jpg,3575,480,640,55,231,286,237,302,True,41
o,62,kaist_dataset/English/Mobile_Phone/(E.M)C-bookCover/P090831039.jpg,char_data/o/P090831039.jpg_10.jpg,3720,480,640,60,353,413,239,301,True,41
o,71,kaist_dataset/English/Mobile_Phone/(E.M)C-bookCover/P090831039.jpg,char_data/o/P090831039.jpg_11.jpg,4473,480,640,63,522,585,125,196,True,41
o,24,kaist_dataset/Korean/Digital_Camera/A-shadow/2007-12-09-day-exterior-031.jpg,char_data/o/2007-12-09-day-exterior-031.jpg_2.jpg,360,1200,1600,15,340,355,623,647,True,41
o,42,kaist_dataset/Korean/Digital_Camera/G-others/2007-12-08-day-112.jpg,char_data/o/2007-12-08-day-112.jpg_2.jpg,840,1200,1600,20,641,661,600,642,True,41
o,22,kaist_dataset/Korean/Digital_Camera/indoor1/080119-0029.jpg,char_data/o/080119-0029.jpg_6.jpg,286,1200,1600,13,693,706,656,678,True,41
o,23,kaist_dataset/Korean/Digital_Camera/indoor1/080119-0029.jpg,char_data/o/080119-0029.jpg_7.jpg,299,1200,1600,13,823,836,658,681,True,41
o,17,kaist_dataset/Korean/Digital_Camera/outdoor1/001.JPG,char_data/o/001.JPG_12.jpg,204,480,640,12,119,131,245,262,True,41
o,21,kaist_dataset/Korean/Digital_Camera/outdoor1/001.JPG,char_data/o/001.JPG_13.jpg,273,480,640,13,131,144,244,265,True,41
o,21,kaist_dataset/Korean/Digital_Camera/outdoor1/001.JPG,char_data/o/001.JPG_14.jpg,294,480,640,14,171,185,242,263,True,41
o,19,kaist_dataset/Korean/Digital_Camera/outdoor1/001.JPG,char_data/o/001.JPG_15.jpg,190,480,640,10,249,259,244,263,True,41
o,26,kaist_dataset/Korean/Digital_Camera/outdoor1/001.JPG,char_data/o/001.JPG_16.jpg,260,480,640,10,315,325,241,267,True,41
o,26,kaist_dataset/Korean/Digital_Camera/outdoor1/001.JPG,char_data/o/001.JPG_17.jpg,286,480,640,11,518,529,236,262,True,41
o,35,kaist_dataset/Korean/Digital_Camera/outdoor1/023.JPG,char_data/o/023.JPG_2.jpg,770,480,640,22,457,479,45,80,True,41
o,22,kaist_dataset/Korean/Digital_Camera/outdoor1/2007-12-08-day-087.jpg,char_data/o/2007-12-08-day-087.jpg_6.jpg,418,1200,1600,19,105,124,513,535,True,41
o,25,kaist_dataset/Korean/Digital_Camera/outdoor1/2007-12-08-day-087.jpg,char_data/o/2007-12-08-day-087.jpg_7.jpg,525,1200,1600,21,124,145,510,535,True,41
o,40,kaist_dataset/Korean/Digital_Camera/outdoor1/2007-12-08-day-087.jpg,char_data/o/2007-12-08-day-087.jpg_8.jpg,1520,1200,1600,38,1393,1431,676,716,True,41
o,39,kaist_dataset/Korean/Digital_Camera/outdoor1/54.JPG,char_data/o/54.JPG_2.jpg,1482,523,767,38,335,373,107,146,True,41
o,33,kaist_dataset/Korean/Digital_Camera/outdoor2/080118-0018.jpg,char_data/o/080118-0018.jpg_2.jpg,1617,1200,1600,49,572,621,690,723,True,41
o,35,kaist_dataset/Korean/Digital_Camera/outdoor2/2007-12-09-day-exterior-036.jpg,char_data/o/2007-12-09-day-exterior-036.jpg_4.jpg,980,1200,1600,28,1360,1388,554,589,True,41
o,34,kaist_dataset/Korean/Digital_Camera/outdoor2/2007-12-09-day-exterior-036.jpg,char_data/o/2007-12-09-day-exterior-036.jpg_5.jpg,884,1200,1600,26,1477,1503,558,592,True,41
o,40,kaist_dataset/Mixed/Digital_Camera/(C.S)A-shadow/DSC02609.JPG,char_data/o/DSC02609.JPG_4.jpg,880,480,640,22,343,365,303,343,True,41
o,27,kaist_dataset/Mixed/Digital_Camera/(C.S)A-shadow/DSC02624.JPG,char_data/o/DSC02624.JPG_12.jpg,378,480,640,14,129,143,401,428,True,41
o,30,kaist_dataset/Mixed/Digital_Camera/(C.S)A-shadow/DSC02624.JPG,char_data/o/DSC02624.JPG_13.jpg,480,480,640,16,143,159,401,431,True,41
o,26,kaist_dataset/Mixed/Digital_Camera/(C.S)A-shadow/DSC02624.JPG,char_data/o/DSC02624.JPG_14.jpg,442,480,640,17,278,295,399,425,True,41
o,37,kaist_dataset/Mixed/Digital_Camera/(C.S)B-light/134.JPG,char_data/o/134.JPG_2.jpg,851,480,640,23,410,433,291,328,True,41
o,22,kaist_dataset/Mixed/Digital_Camera/(C.S)C-outdoor1/003.JPG,char_data/o/003.JPG_12.jpg,264,480,640,12,409,421,254,276,True,41
o,26,kaist_dataset/Mixed/Digital_Camera/(C.S)C-outdoor1/003.JPG,char_data/o/003.JPG_13.jpg,260,480,640,10,429,439,255,281,True,41
o,22,kaist_dataset/Mixed/Digital_Camera/(C.S)C-outdoor1/003.JPG,char_data/o/003.JPG_14.jpg,242,480,640,11,487,498,251,273,True,41
o,19,kaist_dataset/Mixed/Digital_Camera/(C.S)C-outdoor1/003.JPG,char_data/o/003.JPG_15.jpg,171,480,640,9,547,556,253,272,True,41
o,19,kaist_dataset/Mixed/Digital_Camera/(C.S)C-outdoor1/003.JPG,char_data/o/003.JPG_16.jpg,209,480,640,11,83,94,269,288,True,41
o,19,kaist_dataset/Mixed/Digital_Camera/(C.S)C-outdoor1/003.JPG,char_data/o/003.JPG_17.jpg,190,480,640,10,215,225,264,283,True,41
o,37,kaist_dataset/Mixed/Digital_Camera/(C.S)C-outdoor1/062.JPG,char_data/o/062.JPG_2.jpg,444,480,640,12,257,269,167,204,True,41
o,32,kaist_dataset/Mixed/Digital_Camera/(C.S)C-outdoor1/080.JPG,char_data/o/080.JPG_2.jpg,928,480,640,29,56,85,113,145,True,41
o,49,kaist_dataset/Mixed/Digital_Camera/(C.S)C-outdoor1/080116-0084.jpg,char_data/o/080116-0084.jpg_4.jpg,2499,600,800,51,592,643,223,272,True,41
o,127,kaist_dataset/Mixed/Digital_Camera/(C.S)C-outdoor1/080118-0014.jpg,char_data/o/080118-0014.jpg_2.jpg,12827,1200,1600,101,1097,1198,757,884,True,41
o,33,kaist_dataset/Mixed/Digital_Camera/(C.S)C-outdoor1/086.JPG,char_data/o/086.JPG_10.jpg,528,480,640,16,216,232,334,367,True,41
o,34,kaist_dataset/Mixed/Digital_Camera/(C.S)C-outdoor1/086.JPG,char_data/o/086.JPG_11.jpg,578,480,640,17,370,387,335,369,True,41
o,43,kaist_dataset/Mixed/Digital_Camera/(C.S)C-outdoor1/101.JPG,char_data/o/101.JPG_2.jpg,2107,480,640,49,420,469,249,292,True,41
o,26,kaist_dataset/Mixed/Digital_Camera/(C.S)C-outdoor1/115.JPG,char_data/o/115.JPG_2.jpg,494,480,640,19,501,520,272,298,True,41
o,56,kaist_dataset/Mixed/Digital_Camera/(C.S)C-outdoor1/130.JPG,char_data/o/130.JPG_2.jpg,2520,480,640,45,211,256,284,340,True,41
o,20,kaist_dataset/Mixed/Digital_Camera/(C.S)C-outdoor1/2.JPG,char_data/o/2.JPG_9.jpg,160,576,768,8,99,107,385,405,True,41
o,24,kaist_dataset/Mixed/Digital_Camera/(C.S)C-outdoor1/2.JPG,char_data/o/2.JPG_10.jpg,96,576,768,4,136,140,384,408,True,41
o,54,kaist_dataset/Mixed/Digital_Camera/(C.S)C-outdoor1/2007-12-08-day-106.jpg,char_data/o/2007-12-08-day-106.jpg_8.jpg,2376,1200,1600,44,454,498,750,804,True,41
o,56,kaist_dataset/Mixed/Digital_Camera/(C.S)C-outdoor1/2007-12-08-day-106.jpg,char_data/o/2007-12-08-day-106.jpg_9.jpg,2184,1200,1600,39,496,535,751,807,True,41
o,50,kaist_dataset/Mixed/Digital_Camera/(C.S)C-outdoor1/2007-12-08-day-106.jpg,char_data/o/2007-12-08-day-106.jpg_10.jpg,2050,1200,1600,41,750,791,753,803,True,41
o,46,kaist_dataset/Mixed/Digital_Camera/(C.S)C-outdoor1/2007-12-08-day-106.jpg,char_data/o/2007-12-08-day-106.jpg_11.jpg,1840,1200,1600,40,927,967,756,802,True,41
o,62,kaist_dataset/Mixed/Digital_Camera/(C.S)C-outdoor1/2007-12-09-day-exterior-044.jpg,char_data/o/2007-12-09-day-exterior-044.jpg_2.jpg,3844,1200,1600,62,1081,1143,831,893,True,41
o,32,kaist_dataset/Mixed/Digital_Camera/(C.S)C-outdoor1/55.JPG,char_data/o/55.JPG_2.jpg,1216,576,768,38,324,362,164,196,True,41
o,18,kaist_dataset/Mixed/Digital_Camera/(C.S)C-outdoor1/DSC02242.JPG,char_data/o/DSC02242.JPG_2.jpg,198,480,640,11,289,300,172,190,True,41
o,26,kaist_dataset/Mixed/Digital_Camera/(C.S)C-outdoor1/DSC02318.JPG,char_data/o/DSC02318.JPG_4.jpg,702,480,640,27,314,341,328,354,True,41
o,36,kaist_dataset/Mixed/Digital_Camera/(C.S)C-outdoor1/DSC02320.JPG,char_data/o/DSC02320.JPG_4.jpg,1008,480,640,28,339,367,236,272,True,41
o,25,kaist_dataset/Mixed/Digital_Camera/(C.S)C-outdoor1/DSC02320.JPG,char_data/o/DSC02320.JPG_5.jpg,250,480,640,10,585,595,254,279,True,41
o,59,kaist_dataset/Mixed/Digital_Camera/(C.S)C-outdoor1/DSC02344.JPG,char_data/o/DSC02344.JPG_2.jpg,3540,480,640,60,408,468,170,229,True,41
o,88,kaist_dataset/Mixed/Digital_Camera/(C.S)C-outdoor1/P1010008.JPG,char_data/o/P1010008.JPG_4.jpg,6160,480,640,70,269,339,115,203,True,41
o,68,kaist_dataset/Mixed/Digital_Camera/(C.S)C-outdoor1/P1010008.JPG,char_data/o/P1010008.JPG_5.jpg,3740,480,640,55,375,430,253,321,True,41
o,23,kaist_dataset/Mixed/Digital_Camera/(C.S)C-outdoor2/DSC02385.JPG,char_data/o/DSC02385.JPG_4.jpg,345,480,640,15,366,381,154,177,True,41
o,22,kaist_dataset/Mixed/Digital_Camera/(C.S)C-outdoor2/DSC02385.JPG,char_data/o/DSC02385.JPG_5.jpg,264,480,640,12,426,438,148,170,True,41
o,45,kaist_dataset/Mixed/Digital_Camera/(C.S)C-outdoor2/DSC02400.JPG,char_data/o/DSC02400.JPG_2.jpg,1485,480,640,33,60,93,324,369,True,41
o,38,kaist_dataset/Mixed/Digital_Camera/(C.S)C-outdoor2/DSC02407.JPG,char_data/o/DSC02407.JPG_4.jpg,1178,480,640,31,359,390,185,223,True,41
o,47,kaist_dataset/Mixed/Digital_Camera/(C.S)C-outdoor2/DSC02407.JPG,char_data/o/DSC02407.JPG_5.jpg,1598,480,640,34,486,520,180,227,True,41
o,35,kaist_dataset/Mixed/Digital_Camera/(C.S)C-outdoor2/DSC02411.JPG,char_data/o/DSC02411.JPG_22.jpg,840,480,640,24,96,120,352,387,True,41
o,30,kaist_dataset/Mixed/Digital_Camera/(C.S)C-outdoor2/DSC02411.JPG,char_data/o/DSC02411.JPG_23.jpg,720,480,640,24,141,165,355,385,True,41
o,36,kaist_dataset/Mixed/Digital_Camera/(C.S)C-outdoor2/DSC02411.JPG,char_data/o/DSC02411.JPG_24.jpg,900,480,640,25,189,214,353,389,True,41
o,38,kaist_dataset/Mixed/Digital_Camera/(C.S)C-outdoor2/DSC02411.JPG,char_data/o/DSC02411.JPG_25.jpg,874,480,640,23,237,260,352,390,True,41
o,36,kaist_dataset/Mixed/Digital_Camera/(C.S)C-outdoor2/DSC02411.JPG,char_data/o/DSC02411.JPG_26.jpg,900,480,640,25,294,319,352,388,True,41
o,55,kaist_dataset/Mixed/Digital_Camera/(C.S)C-outdoor2/DSC02416.JPG,char_data/o/DSC02416.JPG_2.jpg,3685,480,640,67,302,369,215,270,True,41
o,50,kaist_dataset/Mixed/Digital_Camera/(C.S)C-outdoor2/DSC02418.JPG,char_data/o/DSC02418.JPG_4.jpg,2600,480,640,52,140,192,170,220,True,41
o,70,kaist_dataset/Mixed/Digital_Camera/(C.S)C-outdoor2/DSC02425.JPG,char_data/o/DSC02425.JPG_2.jpg,4340,480,640,62,507,569,164,234,True,41
o,20,kaist_dataset/Mixed/Digital_Camera/(C.S)C-outdoor2/DSC02430.JPG,char_data/o/DSC02430.JPG_4.jpg,220,480,640,11,96,107,32,52,True,41
o,64,kaist_dataset/Mixed/Digital_Camera/(C.S)C-outdoor2/DSC02436.JPG,char_data/o/DSC02436.JPG_2.jpg,2112,480,640,33,365,398,188,252,True,41
o,21,kaist_dataset/Mixed/Digital_Camera/(C.S)C-outdoor2/DSC02439.JPG,char_data/o/DSC02439.JPG_4.jpg,294,480,640,14,362,376,113,134,True,41
o,17,kaist_dataset/Mixed/Digital_Camera/(C.S)C-outdoor2/DSC02439.JPG,char_data/o/DSC02439.JPG_5.jpg,323,480,640,19,296,315,116,133,True,41
o,30,kaist_dataset/Mixed/Digital_Camera/(C.S)C-outdoor2/DSC02482.JPG,char_data/o/DSC02482.JPG_4.jpg,690,480,640,23,132,155,276,306,True,41
o,28,kaist_dataset/Mixed/Digital_Camera/(C.S)C-outdoor2/DSC02482.JPG,char_data/o/DSC02482.JPG_5.jpg,616,480,640,22,197,219,276,304,True,41
o,22,kaist_dataset/Mixed/Digital_Camera/(C.S)C-outdoor2/DSC02483.JPG,char_data/o/DSC02483.JPG_4.jpg,352,480,640,16,438,454,151,173,True,41
o,25,kaist_dataset/Mixed/Digital_Camera/(C.S)C-outdoor2/DSC02483.JPG,char_data/o/DSC02483.JPG_5.jpg,425,480,640,17,455,472,150,175,True,41
o,81,kaist_dataset/Mixed/Digital_Camera/(C.S)C-outdoor2/DSC02493.JPG,char_data/o/DSC02493.JPG_2.jpg,4941,480,640,61,262,323,290,371,True,41
o,26,kaist_dataset/Mixed/Digital_Camera/(C.S)C-outdoor2/DSC02511.JPG,char_data/o/DSC02511.JPG_2.jpg,546,480,640,21,210,231,213,239,True,41
o,34,kaist_dataset/Mixed/Digital_Camera/(C.S)C-outdoor2/DSC02532.JPG,char_data/o/DSC02532.JPG_2.jpg,782,480,640,23,426,449,83,117,True,41
o,23,kaist_dataset/Mixed/Digital_Camera/(C.S)C-outdoor2/DSC02545.JPG,char_data/o/DSC02545.JPG_6.jpg,736,480,640,32,128,160,375,398,True,41
o,26,kaist_dataset/Mixed/Digital_Camera/(C.S)C-outdoor2/DSC02545.JPG,char_data/o/DSC02545.JPG_8.jpg,780,480,640,30,273,303,372,398,True,41
o,28,kaist_dataset/Mixed/Digital_Camera/(C.S)C-outdoor2/DSC02560.JPG,char_data/o/DSC02560.JPG_2.jpg,476,480,640,17,245,262,301,329,True,41
o,27,kaist_dataset/Mixed/Digital_Camera/(C.S)C-outdoor2/DSC02624.JPG,char_data/o/DSC02624.JPG_15.jpg,378,480,640,14,129,143,401,428,True,41
o,30,kaist_dataset/Mixed/Digital_Camera/(C.S)C-outdoor2/DSC02624.JPG,char_data/o/DSC02624.JPG_16.jpg,480,480,640,16,143,159,401,431,True,41
o,26,kaist_dataset/Mixed/Digital_Camera/(C.S)C-outdoor2/DSC02624.JPG,char_data/o/DSC02624.JPG_17.jpg,442,480,640,17,278,295,399,425,True,41
o,67,kaist_dataset/Mixed/Digital_Camera/(C.S)C-outdoor2/DSC02701.JPG,char_data/o/DSC02701.JPG_2.jpg,3953,480,640,59,137,196,101,168,True,41
o,117,kaist_dataset/Mixed/Digital_Camera/(C.S)C-outdoor2/DSC02919.JPG,char_data/o/DSC02919.JPG_2.jpg,13572,480,640,116,83,199,356,473,True,41
o,42,kaist_dataset/Mixed/Digital_Camera/(C.S)C-outdoor2/DSC02926.JPG,char_data/o/DSC02926.JPG_2.jpg,1218,480,640,29,109,138,138,180,True,41
o,29,kaist_dataset/Mixed/Digital_Camera/(C.S)C-outdoor2/DSC02927.JPG,char_data/o/DSC02927.JPG_2.jpg,609,480,640,21,234,255,374,403,True,41
o,34,kaist_dataset/Mixed/Digital_Camera/(C.S)C-outdoor2/DSC02928.JPG,char_data/o/DSC02928.JPG_2.jpg,782,480,640,23,385,408,393,427,True,41
o,30,kaist_dataset/Mixed/Digital_Camera/(C.S)C-outdoor2/DSC02936.JPG,char_data/o/DSC02936.JPG_2.jpg,450,480,640,15,283,298,87,117,True,41
o,56,kaist_dataset/Mixed/Digital_Camera/(C.S)C-outdoor2/DSC02940.JPG,char_data/o/DSC02940.JPG_2.jpg,3248,480,640,58,361,419,258,314,True,41
o,39,kaist_dataset/Mixed/Digital_Camera/(C.S)C-outdoor3/DSC02962.JPG,char_data/o/DSC02962.JPG_4.jpg,1482,480,640,38,76,114,299,338,True,41
o,40,kaist_dataset/Mixed/Digital_Camera/(C.S)C-outdoor3/DSC02962.JPG,char_data/o/DSC02962.JPG_5.jpg,1560,480,640,39,115,154,293,333,True,41
o,23,kaist_dataset/Mixed/Digital_Camera/(C.S)C-outdoor3/DSC02970.JPG,char_data/o/DSC02970.JPG_2.jpg,391,480,640,17,220,237,314,337,True,41
o,35,kaist_dataset/Mixed/Digital_Camera/(C.S)C-outdoor3/DSC02978.JPG,char_data/o/DSC02978.JPG_6.jpg,770,480,640,22,209,231,168,203,True,41
o,31,kaist_dataset/Mixed/Digital_Camera/(C.S)C-outdoor3/DSC02978.JPG,char_data/o/DSC02978.JPG_7.jpg,682,480,640,22,318,340,172,203,True,41
o,34,kaist_dataset/Mixed/Digital_Camera/(C.S)C-outdoor3/DSC02978.JPG,char_data/o/DSC02978.JPG_8.jpg,578,480,640,17,375,392,174,208,True,41
o,45,kaist_dataset/Mixed/Digital_Camera/(C.S)C-outdoor3/DSC02989.JPG,char_data/o/DSC02989.JPG_8.jpg,1710,480,640,38,557,595,209,254,True,41
o,24,kaist_dataset/Mixed/Digital_Camera/(C.S)C-outdoor3/DSC03020.JPG,char_data/o/DSC03020.JPG_7.jpg,264,480,640,11,448,459,305,329,True,41
o,31,kaist_dataset/Mixed/Digital_Camera/(C.S)C-outdoor3/DSC03020.JPG,char_data/o/DSC03020.JPG_8.jpg,434,480,640,14,497,511,303,334,True,41
o,53,kaist_dataset/Mixed/Digital_Camera/(C.S)C-outdoor3/DSC03047.JPG,char_data/o/DSC03047.JPG_6.jpg,1325,480,640,25,195,220,202,255,True,41
o,61,kaist_dataset/Mixed/Digital_Camera/(C.S)C-outdoor3/DSC03047.JPG,char_data/o/DSC03047.JPG_7.jpg,1647,480,640,27,306,333,197,258,True,41
o,55,kaist_dataset/Mixed/Digital_Camera/(C.S)C-outdoor3/DSC03047.JPG,char_data/o/DSC03047.JPG_8.jpg,1540,480,640,28,423,451,199,254,True,41
o,39,kaist_dataset/Mixed/Digital_Camera/(C.S)C-outdoor3/DSC03063.JPG,char_data/o/DSC03063.JPG_4.jpg,1170,480,640,30,205,235,287,326,True,41
o,47,kaist_dataset/Mixed/Digital_Camera/(C.S)C-outdoor3/DSC03063.JPG,char_data/o/DSC03063.JPG_5.jpg,1363,480,640,29,380,409,295,342,True,41
o,39,kaist_dataset/Mixed/Digital_Camera/(C.S)C-outdoor3/DSC03177.JPG,char_data/o/DSC03177.JPG_4.jpg,1209,480,640,31,270,301,145,184,True,41
o,45,kaist_dataset/Mixed/Digital_Camera/(C.S)C-outdoor3/DSC03177.JPG,char_data/o/DSC03177.JPG_5.jpg,1260,480,640,28,436,464,146,191,True,41
o,82,kaist_dataset/Mixed/Digital_Camera/(C.S)C-outdoor3/DSC03190.JPG,char_data/o/DSC03190.JPG_6.jpg,6150,480,640,75,141,216,233,315,True,41
o,75,kaist_dataset/Mixed/Digital_Camera/(C.S)C-outdoor3/DSC03190.JPG,char_data/o/DSC03190.JPG_7.jpg,4950,480,640,66,216,282,235,310,True,41
o,87,kaist_dataset/Mixed/Digital_Camera/(C.S)C-outdoor3/DSC03190.JPG,char_data/o/DSC03190.JPG_8.jpg,6177,480,640,71,484,555,234,321,True,41
o,32,kaist_dataset/Mixed/Digital_Camera/(C.S)C-outdoor3/DSC03227.JPG,char_data/o/DSC03227.JPG_2.jpg,608,480,640,19,104,123,111,143,True,41
o,21,kaist_dataset/Mixed/Digital_Camera/(C.S)C-outdoor3/DSC03271.JPG,char_data/o/DSC03271.JPG_7.jpg,420,480,640,20,320,340,118,139,True,41
o,16,kaist_dataset/Mixed/Digital_Camera/(C.S)C-outdoor3/DSC03271.JPG,char_data/o/DSC03271.JPG_8.jpg,256,480,640,16,341,357,122,138,True,41
o,42,kaist_dataset/Mixed/Digital_Camera/(C.S)C-outdoor3/DSC03310.JPG,char_data/o/DSC03310.JPG_2.jpg,840,480,640,20,404,424,128,170,True,41
o,24,kaist_dataset/Mixed/Digital_Camera/(C.S)C-outdoor3/DSC03328.JPG,char_data/o/DSC03328.JPG_4.jpg,360,480,640,15,324,339,245,269,True,41
o,25,kaist_dataset/Mixed/Digital_Camera/(C.S)C-outdoor3/DSC03328.JPG,char_data/o/DSC03328.JPG_5.jpg,325,480,640,13,452,465,237,262,True,41
o,41,kaist_dataset/Mixed/Digital_Camera/(C.S)C-outdoor3/DSC03332.JPG,char_data/o/DSC03332.JPG_6.jpg,1435,480,640,35,260,295,234,275,True,41
o,49,kaist_dataset/Mixed/Digital_Camera/(C.S)C-outdoor3/DSC03332.JPG,char_data/o/DSC03332.JPG_7.jpg,1960,480,640,40,365,405,227,276,True,41
o,46,kaist_dataset/Mixed/Digital_Camera/(C.S)C-outdoor3/DSC03332.JPG,char_data/o/DSC03332.JPG_8.jpg,1840,480,640,40,450,490,220,266,True,41
o,45,kaist_dataset/Mixed/Digital_Camera/(C.S)C-outdoor3/DSC03340.JPG,char_data/o/DSC03340.JPG_2.jpg,1845,480,640,41,517,558,291,336,True,41
o,53,kaist_dataset/Mixed/Digital_Camera/(C.S)C-outdoor3/DSC03409.JPG,char_data/o/DSC03409.JPG_2.jpg,2597,480,640,49,478,527,150,203,True,41
o,29,kaist_dataset/Mixed/Digital_Camera/(C.S)C-outdoor4/DSC03556.JPG,char_data/o/DSC03556.JPG_10.jpg,464,480,640,16,214,230,320,349,True,41
o,30,kaist_dataset/Mixed/Digital_Camera/(C.S)C-outdoor4/DSC03556.JPG,char_data/o/DSC03556.JPG_11.jpg,360,480,640,12,300,312,320,350,True,41
o,24,kaist_dataset/Mixed/Digital_Camera/(C.S)C-outdoor4/DSC03556.JPG,char_data/o/DSC03556.JPG_12.jpg,288,480,640,12,411,423,325,349,True,41
o,25,kaist_dataset/Mixed/Digital_Camera/(C.S)C-outdoor4/DSC03556.JPG,char_data/o/DSC03556.JPG_13.jpg,275,480,640,11,530,541,322,347,True,41
o,23,kaist_dataset/Mixed/Digital_Camera/(C.S)C-outdoor4/DSC03556.JPG,char_data/o/DSC03556.JPG_14.jpg,253,480,640,11,580,591,326,349,True,41
o,73,kaist_dataset/Mixed/Digital_Camera/(C.S)C-outdoor4/DSC03572.JPG,char_data/o/DSC03572.JPG_2.jpg,4453,480,640,61,399,460,132,205,True,41
o,37,kaist_dataset/Mixed/Digital_Camera/(C.S)C-outdoor4/DSC03586.JPG,char_data/o/DSC03586.JPG_4.jpg,777,480,640,21,260,281,158,195,True,41
o,35,kaist_dataset/Mixed/Digital_Camera/(C.S)C-outdoor4/DSC03586.JPG,char_data/o/DSC03586.JPG_5.jpg,735,480,640,21,412,433,162,197,True,41
o,49,kaist_dataset/Mixed/Digital_Camera/(C.S)C-outdoor4/DSC03620.JPG,char_data/o/DSC03620.JPG_2.jpg,2254,480,640,46,465,511,92,141,True,41
o,74,kaist_dataset/Mixed/Digital_Camera/(C.S)C-outdoor4/DSC03630.JPG,char_data/o/DSC03630.JPG_4.jpg,3404,480,640,46,220,266,351,425,True,41
o,75,kaist_dataset/Mixed/Digital_Camera/(C.S)C-outdoor4/DSC03630.JPG,char_data/o/DSC03630.JPG_5.jpg,3075,480,640,41,413,454,353,428,True,41
o,39,kaist_dataset/Mixed/Digital_Camera/(C.S)C-outdoor4/DSC03642.JPG,char_data/o/DSC03642.JPG_2.jpg,897,480,640,23,328,351,252,291,True,41
o,44,kaist_dataset/Mixed/Digital_Camera/(C.S)C-outdoor4/DSC03643.JPG,char_data/o/DSC03643.JPG_2.jpg,1804,480,640,41,285,326,273,317,True,41
o,23,kaist_dataset/Mixed/Digital_Camera/(C.S)C-outdoor4/DSC03667.JPG,char_data/o/DSC03667.JPG_6.jpg,368,480,640,16,184,200,387,410,True,41
o,30,kaist_dataset/Mixed/Digital_Camera/(C.S)C-outdoor4/DSC03667.JPG,char_data/o/DSC03667.JPG_7.jpg,420,480,640,14,213,227,384,414,True,41
o,34,kaist_dataset/Mixed/Digital_Camera/(C.S)C-outdoor4/DSC03667.JPG,char_data/o/DSC03667.JPG_8.jpg,646,480,640,19,278,297,381,415,True,41
o,25,kaist_dataset/Mixed/Digital_Camera/(C.S)C-outdoor4/DSC03670.JPG,char_data/o/DSC03670.JPG_2.jpg,325,480,640,13,363,376,323,348,True,41
o,30,kaist_dataset/Mixed/Digital_Camera/(C.S)C-outdoor4/DSC03672.JPG,char_data/o/DSC03672.JPG_4.jpg,660,480,640,22,301,323,416,446,True,41
o,30,kaist_dataset/Mixed/Digital_Camera/(C.S)C-outdoor4/DSC03672.JPG,char_data/o/DSC03672.JPG_5.jpg,630,480,640,21,377,398,415,445,True,41
o,35,kaist_dataset/Mixed/Digital_Camera/(C.S)C-outdoor4/DSC03718.JPG,char_data/o/DSC03718.JPG_6.jpg,490,480,640,14,368,382,94,129,True,41
o,31,kaist_dataset/Mixed/Digital_Camera/(C.S)C-outdoor4/DSC03718.JPG,char_data/o/DSC03718.JPG_7.jpg,372,480,640,12,43,55,261,292,True,41
o,23,kaist_dataset/Mixed/Digital_Camera/(C.S)C-outdoor4/DSC03718.JPG,char_data/o/DSC03718.JPG_8.jpg,345,480,640,15,215,230,262,285,True,41
o,33,kaist_dataset/Mixed/Digital_Camera/(C.S)C-outdoor4/DSC03719.JPG,char_data/o/DSC03719.JPG_4.jpg,495,480,640,15,46,61,33,66,True,41
o,30,kaist_dataset/Mixed/Digital_Camera/(C.S)C-outdoor4/DSC03719.JPG,char_data/o/DSC03719.JPG_5.jpg,390,480,640,13,224,237,35,65,True,41
o,26,kaist_dataset/Mixed/Digital_Camera/(C.S)C-outdoor4/DSC03758.JPG,char_data/o/DSC03758.JPG_2.jpg,416,480,640,16,188,204,235,261,True,41
o,38,kaist_dataset/Mixed/Digital_Camera/(C.S)C-outdoor4/DSC03773.JPG,char_data/o/DSC03773.JPG_4.jpg,1292,480,640,34,300,334,279,317,True,41
o,37,kaist_dataset/Mixed/Digital_Camera/(C.S)C-outdoor4/DSC03773.JPG,char_data/o/DSC03773.JPG_5.jpg,1628,480,640,44,464,508,292,329,True,41
o,52,kaist_dataset/Mixed/Digital_Camera/(C.S)C-outdoor4/DSC03781.JPG,char_data/o/DSC03781.JPG_2.jpg,2860,480,640,55,241,296,313,365,True,41
o,35,kaist_dataset/Mixed/Digital_Camera/(C.S)C-outdoor5/DSC03821.JPG,char_data/o/DSC03821.JPG_2.jpg,910,480,640,26,404,430,43,78,True,41
o,54,kaist_dataset/Mixed/Digital_Camera/(C.S)C-outdoor5/DSC04029.JPG,char_data/o/DSC04029.JPG_2.jpg,1890,480,640,35,350,385,179,233,True,41
o,75,kaist_dataset/Mixed/Digital_Camera/(C.S)C-outdoor5/DSC04030.JPG,char_data/o/DSC04030.JPG_2.jpg,3975,480,640,53,91,144,187,262,True,41
o,41,kaist_dataset/Mixed/Digital_Camera/(C.S)C-outdoor5/DSC04057.JPG,char_data/o/DSC04057.JPG_2.jpg,738,480,640,18,78,96,118,159,True,41
o,33,kaist_dataset/Mixed/Digital_Camera/(C.S)C-outdoor5/DSC04069.JPG,char_data/o/DSC04069.JPG_10.jpg,759,480,640,23,186,209,424,457,True,41
o,30,kaist_dataset/Mixed/Digital_Camera/(C.S)C-outdoor5/DSC04069.JPG,char_data/o/DSC04069.JPG_11.jpg,630,480,640,21,403,424,424,454,True,41
o,31,kaist_dataset/Mixed/Digital_Camera/(C.S)C-outdoor5/DSC04069.JPG,char_data/o/DSC04069.JPG_12.jpg,589,480,640,19,162,181,390,421,True,41
o,32,kaist_dataset/Mixed/Digital_Camera/(C.S)C-outdoor5/DSC04069.JPG,char_data/o/DSC04069.JPG_13.jpg,544,480,640,17,373,390,382,414,True,41
o,25,kaist_dataset/Mixed/Digital_Camera/(C.S)C-outdoor5/DSC04069.JPG,char_data/o/DSC04069.JPG_14.jpg,575,480,640,23,527,550,385,410,True,41
o,33,kaist_dataset/Mixed/Digital_Camera/(C.S)C-outdoor5/DSC04070.JPG,char_data/o/DSC04070.JPG_2.jpg,429,480,640,13,158,171,110,143,True,41
o,36,kaist_dataset/Mixed/Digital_Camera/(C.S)C-outdoor5/DSC04076.JPG,char_data/o/DSC04076.JPG_4.jpg,1044,480,640,29,248,277,107,143,True,41
o,24,kaist_dataset/Mixed/Digital_Camera/(C.S)C-outdoor5/DSC04076.JPG,char_data/o/DSC04076.JPG_5.jpg,552,480,640,23,492,515,404,428,True,41
o,28,kaist_dataset/Mixed/Digital_Camera/(C.S)C-outdoor5/DSC04091.JPG,char_data/o/DSC04091.JPG_2.jpg,532,480,640,19,383,402,427,455,True,41
o,36,kaist_dataset/Mixed/Digital_Camera/(C.S)C-outdoor5/DSC04104.JPG,char_data/o/DSC04104.JPG_6.jpg,864,480,640,24,395,419,49,85,True,41
o,33,kaist_dataset/Mixed/Digital_Camera/(C.S)C-outdoor5/DSC04104.JPG,char_data/o/DSC04104.JPG_7.jpg,957,480,640,29,456,485,48,81,True,41
o,36,kaist_dataset/Mixed/Digital_Camera/(C.S)C-outdoor5/DSC04104.JPG,char_data/o/DSC04104.JPG_8.jpg,936,480,640,26,522,548,46,82,True,41
o,29,kaist_dataset/Mixed/Digital_Camera/(C.S)C-outdoor5/DSC04125.JPG,char_data/o/DSC04125.JPG_2.jpg,493,480,640,17,257,274,427,456,True,41
o,36,kaist_dataset/Mixed/Digital_Camera/(C.S)C-outdoor5/DSC04129.JPG,char_data/o/DSC04129.JPG_4.jpg,1116,480,640,31,111,142,408,444,True,41
o,42,kaist_dataset/Mixed/Digital_Camera/(C.S)C-outdoor5/DSC04162.JPG,char_data/o/DSC04162.JPG_2.jpg,1428,480,640,34,180,214,331,373,True,41
o,23,kaist_dataset/Mixed/Digital_Camera/(C.S)C-outdoor5/DSC04312.JPG,char_data/o/DSC04312.JPG_6.jpg,345,480,640,15,451,466,151,174,True,41
o,41,kaist_dataset/Mixed/Digital_Camera/(C.S)C-outdoor5/DSC04321.JPG,char_data/o/DSC04321.JPG_2.jpg,861,480,640,21,312,333,198,239,True,41
o,34,kaist_dataset/Mixed/Digital_Camera/(C.S)C-outdoor5/DSC04322.JPG,char_data/o/DSC04322.JPG_4.jpg,680,480,640,20,508,528,229,263,True,41
o,45,kaist_dataset/Mixed/Digital_Camera/(C.S)C-outdoor5/DSC04322.JPG,char_data/o/DSC04322.JPG_5.jpg,945,480,640,21,529,550,226,271,True,41
o,37,kaist_dataset/Mixed/Digital_Camera/(C.S)C-outdoor5/DSC04323.JPG,char_data/o/DSC04323.JPG_4.jpg,740,480,640,20,343,363,204,241,True,41
o,39,kaist_dataset/Mixed/Digital_Camera/(C.S)C-outdoor5/DSC04323.JPG,char_data/o/DSC04323.JPG_5.jpg,702,480,640,18,553,571,209,248,True,41
o,29,kaist_dataset/Mixed/Digital_Camera/(C.S)C-outdoor5/DSC04338.JPG,char_data/o/DSC04338.JPG_10.jpg,725,480,640,25,484,509,207,236,True,41
o,29,kaist_dataset/Mixed/Digital_Camera/(C.S)C-outdoor5/DSC04338.JPG,char_data/o/DSC04338.JPG_11.jpg,667,480,640,23,589,612,205,234,True,41
o,27,kaist_dataset/Mixed/Digital_Camera/(C.S)C-outdoor5/DSC04357.JPG,char_data/o/DSC04357.JPG_4.jpg,297,480,640,11,309,320,383,410,True,41
o,26,kaist_dataset/Mixed/Digital_Camera/(C.S)C-outdoor5/DSC04357.JPG,char_data/o/DSC04357.JPG_5.jpg,416,480,640,16,463,479,354,380,True,41
o,54,kaist_dataset/Mixed/Digital_Camera/(C.S)C-outdoor5/DSC04395.JPG,char_data/o/DSC04395.JPG_2.jpg,2052,480,640,38,447,485,349,403,True,41
o,45,kaist_dataset/Mixed/Digital_Camera/(C.S)C-outdoor5/DSC04399.JPG,char_data/o/DSC04399.JPG_6.jpg,1710,480,640,38,280,318,221,266,True,41
o,46,kaist_dataset/Mixed/Digital_Camera/(C.S)C-outdoor5/DSC04399.JPG,char_data/o/DSC04399.JPG_7.jpg,1472,480,640,32,520,552,214,260,True,41
o,51,kaist_dataset/Mixed/Digital_Camera/(C.S)C-outdoor5/DSC04399.JPG,char_data/o/DSC04399.JPG_8.jpg,1632,480,640,32,281,313,286,337,True,41
o,49,kaist_dataset/Mixed/Digital_Camera/(C.S)C-outdoor5/DSC04456.JPG,char_data/o/DSC04456.JPG_6.jpg,1715,480,640,35,209,244,169,218,True,41
o,43,kaist_dataset/Mixed/Digital_Camera/(C.S)C-outdoor5/DSC04456.JPG,char_data/o/DSC04456.JPG_7.jpg,1462,480,640,34,326,360,176,219,True,41
o,41,kaist_dataset/Mixed/Digital_Camera/(C.S)C-outdoor5/DSC04456.JPG,char_data/o/DSC04456.JPG_8.jpg,1394,480,640,34,557,591,176,217,True,41
o,32,kaist_dataset/Mixed/Digital_Camera/(C.S)C-outdoor6/002.jpg,char_data/o/002.jpg_6.jpg,800,240,352,25,125,150,63,95,True,41
o,34,kaist_dataset/Mixed/Digital_Camera/(C.S)C-outdoor6/002.jpg,char_data/o/002.jpg_7.jpg,986,240,352,29,148,177,64,98,True,41
o,31,kaist_dataset/Mixed/Digital_Camera/(C.S)C-outdoor6/002.jpg,char_data/o/002.jpg_8.jpg,620,240,352,20,209,229,78,109,True,41
o,48,kaist_dataset/Mixed/Digital_Camera/(C.S)C-outdoor6/025.jpg,char_data/o/025.jpg_2.jpg,3024,293,472,63,86,149,75,123,True,41
o,137,kaist_dataset/Mixed/Digital_Camera/(C.S)C-outdoor6/080116-0057.jpg,char_data/o/080116-0057.jpg_10.jpg,17673,1200,1600,129,871,1000,355,492,True,41
o,133,kaist_dataset/Mixed/Digital_Camera/(C.S)C-outdoor6/080116-0057.jpg,char_data/o/080116-0057.jpg_11.jpg,16359,1200,1600,123,1084,1207,577,710,True,41
o,43,kaist_dataset/Mixed/Digital_Camera/(C.S)C-outdoor6/080116-0057.jpg,char_data/o/080116-0057.jpg_12.jpg,1376,1200,1600,32,1107,1139,829,872,True,41
o,51,kaist_dataset/Mixed/Digital_Camera/(C.S)C-outdoor6/080116-0057.jpg,char_data/o/080116-0057.jpg_13.jpg,1683,1200,1600,33,828,861,824,875,True,41
o,41,kaist_dataset/Mixed/Digital_Camera/(C.S)C-outdoor6/080116-0057.jpg,char_data/o/080116-0057.jpg_14.jpg,1230,1200,1600,30,931,961,836,877,True,41
o,23,kaist_dataset/Mixed/Digital_Camera/(C.S)C-outdoor6/090.jpg,char_data/o/090.jpg_2.jpg,322,480,640,14,384,398,165,188,False,41
o,79,kaist_dataset/Mixed/Digital_Camera/(C.S)C-outdoor6/DSC03324.JPG,char_data/o/DSC03324.JPG_8.jpg,5056,480,640,64,222,286,80,159,False,41
o,49,kaist_dataset/Mixed/Digital_Camera/(C.S)C-outdoor6/DSC03324.JPG,char_data/o/DSC03324.JPG_9.jpg,2009,480,640,41,342,383,104,153,False,41
o,75,kaist_dataset/Mixed/Digital_Camera/(C.S)C-outdoor6/DSC03324.JPG,char_data/o/DSC03324.JPG_10.jpg,4500,480,640,60,402,462,72,147,False,41
o,52,kaist_dataset/Mixed/Digital_Camera/(C.S)C-outdoor6/DSC03324.JPG,char_data/o/DSC03324.JPG_11.jpg,2444,480,640,47,525,572,90,142,False,41
o,28,kaist_dataset/Mixed/Digital_Camera/(C.S)C-outdoor6/P1010048.JPG,char_data/o/P1010048.JPG_2.jpg,504,480,640,18,463,481,170,198,False,41
o,18,kaist_dataset/Mixed/Digital_Camera/(C.S)C-outdoor6/P1010065.JPG,char_data/o/P1010065.JPG_4.jpg,306,480,640,17,266,283,236,254,False,41
o,30,kaist_dataset/Mixed/Digital_Camera/(C.S)C-outdoor6/P1010069.JPG,char_data/o/P1010069.JPG_6.jpg,600,480,640,20,206,226,298,328,False,41
o,25,kaist_dataset/Mixed/Digital_Camera/(C.S)C-outdoor6/P1010069.JPG,char_data/o/P1010069.JPG_7.jpg,500,480,640,20,251,271,301,326,False,41
o,27,kaist_dataset/Mixed/Digital_Camera/(C.S)C-outdoor6/P1010069.JPG,char_data/o/P1010069.JPG_8.jpg,540,480,640,20,294,314,303,330,False,41
o,31,kaist_dataset/Mixed/Digital_Camera/(C.S)C-outdoor6/P1010085.JPG,char_data/o/P1010085.JPG_2.jpg,651,480,640,21,55,76,98,129,False,41
o,23,kaist_dataset/Mixed/Digital_Camera/(C.S)C-outdoor6/P1010138.JPG,char_data/o/P1010138.JPG_5.jpg,414,480,640,18,246,264,188,211,False,41
o,35,kaist_dataset/Mixed/Digital_Camera/(C.S)D-indoor1/082.JPG,char_data/o/082.JPG_2.jpg,1015,480,640,29,454,483,178,213,False,41
o,28,kaist_dataset/Mixed/Digital_Camera/(C.S)D-indoor1/DSC02718.JPG,char_data/o/DSC02718.JPG_4.jpg,448,480,640,16,74,90,228,256,False,41
o,31,kaist_dataset/Mixed/Digital_Camera/(C.S)D-indoor1/DSC02718.JPG,char_data/o/DSC02718.JPG_5.jpg,496,480,640,16,126,142,231,262,False,41
o,34,kaist_dataset/Mixed/Digital_Camera/(C.S)D-indoor1/DSC02787.JPG,char_data/o/DSC02787.JPG_8.jpg,544,480,640,16,137,153,386,420,False,41
o,39,kaist_dataset/Mixed/Digital_Camera/(C.S)D-indoor1/DSC02787.JPG,char_data/o/DSC02787.JPG_9.jpg,663,480,640,17,159,176,384,423,False,41
o,33,kaist_dataset/Mixed/Digital_Camera/(C.S)D-indoor1/DSC02787.JPG,char_data/o/DSC02787.JPG_10.jpg,528,480,640,16,371,387,370,403,False,41
o,37,kaist_dataset/Mixed/Digital_Camera/(C.S)D-indoor1/DSC02787.JPG,char_data/o/DSC02787.JPG_11.jpg,777,480,640,21,449,470,365,402,False,41
o,40,kaist_dataset/Mixed/Digital_Camera/(C.S)D-indoor1/DSC02804.JPG,char_data/o/DSC02804.JPG_2.jpg,760,480,640,19,384,403,351,391,False,41
o,43,kaist_dataset/Mixed/Digital_Camera/(C.S)D-indoor1/DSC03073.JPG,char_data/o/DSC03073.JPG_6.jpg,1118,480,640,26,381,407,284,327,False,41
o,29,kaist_dataset/Mixed/Digital_Camera/(C.S)D-indoor1/DSC03073.JPG,char_data/o/DSC03073.JPG_7.jpg,725,480,640,25,408,433,296,325,False,41
o,34,kaist_dataset/Mixed/Digital_Camera/(C.S)D-indoor1/DSC03073.JPG,char_data/o/DSC03073.JPG_8.jpg,986,480,640,29,378,407,336,370,False,41
o,30,kaist_dataset/Mixed/Digital_Camera/(C.S)D-indoor1/DSC03096.JPG,char_data/o/DSC03096.JPG_6.jpg,570,480,640,19,140,159,424,454,False,41
o,32,kaist_dataset/Mixed/Digital_Camera/(C.S)D-indoor1/DSC03096.JPG,char_data/o/DSC03096.JPG_7.jpg,640,480,640,20,318,338,423,455,False,41
o,34,kaist_dataset/Mixed/Digital_Camera/(C.S)D-indoor1/DSC03096.JPG,char_data/o/DSC03096.JPG_8.jpg,612,480,640,18,578,596,429,463,False,41
o,31,kaist_dataset/Mixed/Digital_Camera/(C.S)D-indoor1/DSC03118.JPG,char_data/o/DSC03118.JPG_6.jpg,651,480,640,21,163,184,163,194,False,41
o,38,kaist_dataset/Mixed/Digital_Camera/(C.S)D-indoor1/DSC03118.JPG,char_data/o/DSC03118.JPG_7.jpg,836,480,640,22,417,439,158,196,False,41
o,39,kaist_dataset/Mixed/Digital_Camera/(C.S)D-indoor1/DSC03118.JPG,char_data/o/DSC03118.JPG_8.jpg,858,480,640,22,390,412,230,269,False,41
o,47,kaist_dataset/Mixed/Digital_Camera/(C.S)D-indoor1/DSC03119.JPG,char_data/o/DSC03119.JPG_8.jpg,1410,480,640,30,171,201,167,214,False,41
o,47,kaist_dataset/Mixed/Digital_Camera/(C.S)D-indoor1/DSC03119.JPG,char_data/o/DSC03119.JPG_9.jpg,1316,480,640,28,200,228,168,215,False,41
o,43,kaist_dataset/Mixed/Digital_Camera/(C.S)D-indoor1/DSC03119.JPG,char_data/o/DSC03119.JPG_10.jpg,1204,480,640,28,402,430,169,212,False,41
o,40,kaist_dataset/Mixed/Digital_Camera/(C.S)D-indoor1/DSC03119.JPG,char_data/o/DSC03119.JPG_11.jpg,1080,480,640,27,429,456,168,208,False,41
o,26,kaist_dataset/Mixed/Digital_Camera/(C.S)D-indoor1/DSC03122.JPG,char_data/o/DSC03122.JPG_8.jpg,546,480,640,21,305,326,207,233,False,41
o,32,kaist_dataset/Mixed/Digital_Camera/(C.S)D-indoor1/DSC03122.JPG,char_data/o/DSC03122.JPG_9.jpg,640,480,640,20,349,369,202,234,False,41
o,32,kaist_dataset/Mixed/Digital_Camera/(C.S)D-indoor1/DSC03122.JPG,char_data/o/DSC03122.JPG_10.jpg,640,480,640,20,237,257,152,184,False,41
o,30,kaist_dataset/Mixed/Digital_Camera/(C.S)D-indoor1/DSC03122.JPG,char_data/o/DSC03122.JPG_11.jpg,660,480,640,22,257,279,153,183,False,41
o,48,kaist_dataset/Mixed/Digital_Camera/(C.S)D-indoor1/DSC03123.JPG,char_data/o/DSC03123.JPG_2.jpg,1536,480,640,32,315,347,178,226,False,41
o,35,kaist_dataset/Mixed/Digital_Camera/(C.S)D-indoor1/DSC03124.JPG,char_data/o/DSC03124.JPG_4.jpg,980,480,640,28,237,265,208,243,False,41
o,31,kaist_dataset/Mixed/Digital_Camera/(C.S)D-indoor1/DSC03124.JPG,char_data/o/DSC03124.JPG_5.jpg,806,480,640,26,406,432,203,234,False,41
o,42,kaist_dataset/Mixed/Digital_Camera/(C.S)D-indoor1/DSC03125.JPG,char_data/o/DSC03125.JPG_2.jpg,1134,480,640,27,352,379,188,230,False,41
o,32,kaist_dataset/Mixed/Digital_Camera/(C.S)D-indoor1/DSC03126.JPG,char_data/o/DSC03126.JPG_2.jpg,928,480,640,29,250,279,231,263,False,41
o,33,kaist_dataset/Mixed/Digital_Camera/(C.S)D-indoor1/DSC03129.JPG,char_data/o/DSC03129.JPG_4.jpg,726,480,640,22,311,333,210,243,False,41
o,32,kaist_dataset/Mixed/Digital_Camera/(C.S)D-indoor1/DSC03129.JPG,char_data/o/DSC03129.JPG_5.jpg,800,480,640,25,355,380,211,243,False,41
o,37,kaist_dataset/Mixed/Digital_Camera/(C.S)D-indoor1/DSC03131.JPG,char_data/o/DSC03131.JPG_2.jpg,999,480,640,27,313,340,137,174,False,41
o,35,kaist_dataset/Mixed/Digital_Camera/(C.S)D-indoor1/DSC03132.JPG,char_data/o/DSC03132.JPG_4.jpg,910,480,640,26,173,199,249,284,False,41
o,36,kaist_dataset/Mixed/Digital_Camera/(C.S)D-indoor1/DSC03132.JPG,char_data/o/DSC03132.JPG_5.jpg,936,480,640,26,371,397,251,287,False,41
o,42,kaist_dataset/Mixed/Digital_Camera/(C.S)D-indoor1/DSC03133.JPG,char_data/o/DSC03133.JPG_2.jpg,1428,480,640,34,259,293,157,199,False,41
o,38,kaist_dataset/Mixed/Digital_Camera/(C.S)D-indoor1/DSC03134.JPG,char_data/o/DSC03134.JPG_4.jpg,912,480,640,24,237,261,169,207,False,41
o,36,kaist_dataset/Mixed/Digital_Camera/(C.S)D-indoor1/DSC03134.JPG,char_data/o/DSC03134.JPG_5.jpg,1008,480,640,28,303,331,173,209,False,41
o,47,kaist_dataset/Mixed/Digital_Camera/(C.S)D-indoor1/DSC03135.JPG,char_data/o/DSC03135.JPG_2.jpg,1504,480,640,32,277,309,187,234,False,41
o,32,kaist_dataset/Mixed/Digital_Camera/(C.S)D-indoor1/DSC03466.JPG,char_data/o/DSC03466.JPG_2.jpg,768,480,640,24,423,447,233,265,False,41
o,77,kaist_dataset/Mixed/Digital_Camera/(C.S)D-indoor1/DSC03469.JPG,char_data/o/DSC03469.JPG_4.jpg,4543,480,640,59,109,168,348,425,False,41
o,84,kaist_dataset/Mixed/Digital_Camera/(C.S)D-indoor1/DSC03469.JPG,char_data/o/DSC03469.JPG_5.jpg,4956,480,640,59,411,470,344,428,False,41
o,39,kaist_dataset/Mixed/Digital_Camera/(C.S)D-indoor1/DSC03953.JPG,char_data/o/DSC03953.JPG_2.jpg,702,480,640,18,296,314,388,427,False,41
o,49,kaist_dataset/Mixed/Digital_Camera/(C.S)D-indoor1/DSC04183.JPG,char_data/o/DSC04183.JPG_8.jpg,1176,480,640,24,223,247,245,294,False,41
o,37,kaist_dataset/Mixed/Digital_Camera/(C.S)D-indoor1/DSC04183.JPG,char_data/o/DSC04183.JPG_9.jpg,999,480,640,27,378,405,257,294,False,41
o,35,kaist_dataset/Mixed/Digital_Camera/(C.S)D-indoor1/DSC04183.JPG,char_data/o/DSC04183.JPG_10.jpg,735,480,640,21,439,460,257,292,False,41
o,33,kaist_dataset/Mixed/Digital_Camera/(C.S)D-indoor1/DSC04183.JPG,char_data/o/DSC04183.JPG_11.jpg,825,480,640,25,458,483,259,292,False,41
o,33,kaist_dataset/Mixed/Digital_Camera/(C.S)D-indoor1/DSC04206.JPG,char_data/o/DSC04206.JPG_10.jpg,495,480,640,15,216,231,286,319,False,41
o,35,kaist_dataset/Mixed/Digital_Camera/(C.S)D-indoor1/DSC04206.JPG,char_data/o/DSC04206.JPG_11.jpg,560,480,640,16,318,334,291,326,False,41
o,36,kaist_dataset/Mixed/Digital_Camera/(C.S)D-indoor1/DSC04206.JPG,char_data/o/DSC04206.JPG_12.jpg,576,480,640,16,408,424,294,330,False,41
o,38,kaist_dataset/Mixed/Digital_Camera/(C.S)D-indoor1/DSC04206.JPG,char_data/o/DSC04206.JPG_13.jpg,722,480,640,19,468,487,294,332,False,41
o,38,kaist_dataset/Mixed/Digital_Camera/(C.S)D-indoor1/DSC04206.JPG,char_data/o/DSC04206.JPG_14.jpg,646,480,640,17,487,504,294,332,False,41
o,33,kaist_dataset/Mixed/Digital_Camera/(C.S)D-indoor1/DSC04246.JPG,char_data/o/DSC04246.JPG_4.jpg,594,480,640,18,140,158,250,283,False,41
o,32,kaist_dataset/Mixed/Digital_Camera/(C.S)D-indoor1/DSC04246.JPG,char_data/o/DSC04246.JPG_5.jpg,544,480,640,17,336,353,250,282,False,41
o,37,kaist_dataset/Mixed/Digital_Camera/(C.S)D-indoor2/DSC04248.JPG,char_data/o/DSC04248.JPG_6.jpg,888,480,640,24,174,198,225,262,False,41
o,31,kaist_dataset/Mixed/Digital_Camera/(C.S)D-indoor2/DSC04248.JPG,char_data/o/DSC04248.JPG_7.jpg,713,480,640,23,405,428,224,255,False,41
o,34,kaist_dataset/Mixed/Digital_Camera/(C.S)D-indoor2/DSC04248.JPG,char_data/o/DSC04248.JPG_8.jpg,850,480,640,25,427,452,224,258,False,41
o,37,kaist_dataset/Mixed/Digital_Camera/(C.S)D-indoor2/DSC04249.JPG,char_data/o/DSC04249.JPG_4.jpg,925,480,640,25,357,382,220,257,False,41
o,35,kaist_dataset/Mixed/Digital_Camera/(C.S)D-indoor2/DSC04249.JPG,char_data/o/DSC04249.JPG_5.jpg,980,480,640,28,380,408,219,254,False,41
o,30,kaist_dataset/Mixed/Digital_Camera/(C.S)D-indoor2/DSC04254.JPG,char_data/o/DSC04254.JPG_2.jpg,570,480,640,19,439,458,343,373,False,41
o,48,kaist_dataset/Mixed/Digital_Camera/(C.S)D-indoor2/DSC04421.JPG,char_data/o/DSC04421.JPG_2.jpg,1248,480,640,26,336,362,215,263,False,41
o,25,kaist_dataset/Mixed/Digital_Camera/(C.S)E-night/DSC02569.JPG,char_data/o/DSC02569.JPG_2.jpg,475,480,640,19,255,274,278,303,False,41
o,35,kaist_dataset/Mixed/Digital_Camera/(C.S)E-night/DSC02600.JPG,char_data/o/DSC02600.JPG_2.jpg,1610,480,640,46,283,329,37,72,False,41
o,47,kaist_dataset/Mixed/Digital_Camera/(C.S)E-night/DSC02647.JPG,char_data/o/DSC02647.JPG_2.jpg,2397,480,640,51,160,211,212,259,False,41
o,59,kaist_dataset/Mixed/Digital_Camera/(C.S)E-night/DSC03840.JPG,char_data/o/DSC03840.JPG_2.jpg,2478,480,640,42,98,140,111,170,False,41
o,50,kaist_dataset/Mixed/Digital_Camera/(C.S)F-others/047.jpg,char_data/o/047.jpg_2.jpg,2050,252,339,41,235,276,51,101,False,41
o,35,kaist_dataset/Mixed/Digital_Camera/(C.S)F-others/2007-12-08-day-044.jpg,char_data/o/2007-12-08-day-044.jpg_2.jpg,700,1200,1600,20,840,860,810,845,False,41
o,40,kaist_dataset/Mixed/Digital_Camera/(C.S)F-others/DSC02609.JPG,char_data/o/DSC02609.JPG_5.jpg,880,480,640,22,343,365,303,343,False,41
o,70,kaist_dataset/Mixed/Digital_Camera/(C.S)F-others/DSC02696.JPG,char_data/o/DSC02696.JPG_2.jpg,3780,480,640,54,131,185,307,377,False,41
o,65,kaist_dataset/Mixed/Mobile_Phone/(C.M)A-outdoor/P090912037.jpg,char_data/o/P090912037.jpg_2.jpg,3120,480,640,48,313,361,170,235,False,41
o,31,kaist_dataset/Mixed/Mobile_Phone/(C.M)A-outdoor/P090912078.jpg,char_data/o/P090912078.jpg_4.jpg,775,480,640,25,136,161,314,345,False,41
o,25,kaist_dataset/Mixed/Mobile_Phone/(C.M)A-outdoor/P090912078.jpg,char_data/o/P090912078.jpg_5.jpg,675,480,640,27,421,448,300,325,False,41
o,32,kaist_dataset/Mixed/Mobile_Phone/(C.M)B-indoor/P090831005.jpg,char_data/o/P090831005.jpg_2.jpg,576,480,640,18,268,286,240,272,False,41
o,64,kaist_dataset/Mixed/Mobile_Phone/(C.M)B-indoor/P090831008.jpg,char_data/o/P090831008.jpg_4.jpg,3520,480,640,55,377,432,318,382,False,41
o,59,kaist_dataset/Mixed/Mobile_Phone/(C.M)B-indoor/P090831008.jpg,char_data/o/P090831008.jpg_5.jpg,2478,480,640,42,435,477,322,381,False,41
o,50,kaist_dataset/Mixed/Mobile_Phone/(C.M)B-indoor/P090831010.jpg,char_data/o/P090831010.jpg_4.jpg,1850,480,640,37,427,464,285,335,False,41
o,43,kaist_dataset/Mixed/Mobile_Phone/(C.M)B-indoor/P090831010.jpg,char_data/o/P090831010.jpg_5.jpg,1419,480,640,33,466,499,294,337,False,41
o,44,kaist_dataset/Mixed/Mobile_Phone/(C.M)B-indoor/P090831014.jpg,char_data/o/P090831014.jpg_2.jpg,1628,480,640,37,265,302,173,217,False,41
o,45,kaist_dataset/Mixed/Mobile_Phone/(C.M)B-indoor/P090831015.jpg,char_data/o/P090831015.jpg_2.jpg,1575,480,640,35,327,362,212,257,False,41
o,66,kaist_dataset/Mixed/Mobile_Phone/(C.M)B-indoor/P090831019.jpg,char_data/o/P090831019.jpg_2.jpg,4224,480,640,64,154,218,154,220,False,41
o,47,kaist_dataset/Mixed/Mobile_Phone/(C.M)B-indoor/P090831023.jpg,char_data/o/P090831023.jpg_2.jpg,2068,480,640,44,149,193,282,329,False,41
o,36,kaist_dataset/Mixed/Mobile_Phone/(C.M)C-bookCover/P090831080.jpg,char_data/o/P090831080.jpg_4.jpg,1044,480,640,29,184,213,413,449,False,41
o,32,kaist_dataset/Mixed/Mobile_Phone/(C.M)C-bookCover/P090831080.jpg,char_data/o/P090831080.jpg_5.jpg,1024,480,640,32,301,333,416,448,False,41
o,36,kaist_dataset/Mixed/Mobile_Phone/(C.M)C-bookCover/P090902016.jpg,char_data/o/P090902016.jpg_4.jpg,1008,480,640,28,258,286,140,176,False,41
o,31,kaist_dataset/Mixed/Mobile_Phone/(C.M)C-bookCover/P090902016.jpg,char_data/o/P090902016.jpg_5.jpg,713,480,640,23,306,329,278,309,False,41
o,39,kaist_dataset/Mixed/Mobile_Phone/(C.M)C-bookCover/P090902019.jpg,char_data/o/P090902019.jpg_4.jpg,1599,480,640,41,470,511,303,342,False,41
o,43,kaist_dataset/Mixed/Mobile_Phone/(C.M)C-bookCover/P090902019.jpg,char_data/o/P090902019.jpg_5.jpg,1591,480,640,37,510,547,302,345,False,41
o,28,kaist_dataset/Mixed/Mobile_Phone/(C.M)C-bookCover/P090903024.jpg,char_data/o/P090903024.jpg_4.jpg,700,480,640,25,479,504,116,144,False,41
o,29,kaist_dataset/Mixed/Mobile_Phone/(C.M)C-bookCover/P090903024.jpg,char_data/o/P090903024.jpg_5.jpg,899,480,640,31,356,387,179,208,False,41
o,35,kaist_dataset/Mixed/Mobile_Phone/(C.M)C-bookCover/P090904004.jpg,char_data/o/P090904004.jpg_2.jpg,1155,480,640,33,514,547,403,438,False,41
7,27,kaist_dataset/English/Digital_Camera/(E.S)C-outdoor1/056.JPG,char_data/7/056.JPG_2.jpg,378,480,640,14,556,570,250,277,True,9
7,43,kaist_dataset/English/Digital_Camera/(E.S)C-outdoor1/080116-0065.jpg,char_data/7/080116-0065.jpg_2.jpg,1161,600,800,27,420,447,203,246,True,9
7,107,kaist_dataset/English/Digital_Camera/(E.S)C-outdoor1/2007-12-09-day-exterior-056.jpg,char_data/7/2007-12-09-day-exterior-056.jpg_4.jpg,7918,1200,1600,74,737,811,174,281,True,9
7,110,kaist_dataset/English/Digital_Camera/(E.S)C-outdoor1/2007-12-09-day-exterior-056.jpg,char_data/7/2007-12-09-day-exterior-056.jpg_5.jpg,10120,1200,1600,92,473,565,513,623,True,9
7,43,kaist_dataset/English/Digital_Camera/(E.S)C-outdoor1/DSC02415.JPG,char_data/7/DSC02415.JPG_2.jpg,989,480,640,23,548,571,248,291,True,9
7,53,kaist_dataset/English/Digital_Camera/(E.S)C-outdoor2/DSC03161.JPG,char_data/7/DSC03161.JPG_4.jpg,1749,480,640,33,50,83,226,279,True,9
7,56,kaist_dataset/English/Digital_Camera/(E.S)C-outdoor2/DSC03161.JPG,char_data/7/DSC03161.JPG_5.jpg,1792,480,640,32,82,114,223,279,True,9
7,36,kaist_dataset/English/Digital_Camera/(E.S)C-outdoor2/DSC03294.JPG,char_data/7/DSC03294.JPG_4.jpg,828,480,640,23,245,268,396,432,True,9
7,33,kaist_dataset/English/Digital_Camera/(E.S)C-outdoor2/DSC03294.JPG,char_data/7/DSC03294.JPG_5.jpg,660,480,640,20,334,354,399,432,True,9
7,40,kaist_dataset/English/Digital_Camera/(E.S)C-outdoor2/DSC03436.JPG,char_data/7/DSC03436.JPG_2.jpg,920,480,640,23,291,314,122,162,True,9
7,58,kaist_dataset/English/Digital_Camera/(E.S)C-outdoor2/DSC03650.JPG,char_data/7/DSC03650.JPG_2.jpg,1856,480,640,32,177,209,283,341,True,9
7,30,kaist_dataset/English/Digital_Camera/(E.S)C-outdoor2/DSC03731.JPG,char_data/7/DSC03731.JPG_2.jpg,360,480,640,12,538,550,115,145,True,9
7,30,kaist_dataset/English/Digital_Camera/(E.S)D-indoor/DSC03943.JPG,char_data/7/DSC03943.JPG_2.jpg,570,480,640,19,357,376,312,342,True,9
7,52,kaist_dataset/English/Digital_Camera/(E.S)E-night/DSC02610.JPG,char_data/7/DSC02610.JPG_4.jpg,1612,480,640,31,226,257,381,433,True,9
7,56,kaist_dataset/English/Digital_Camera/(E.S)E-night/DSC02610.JPG,char_data/7/DSC02610.JPG_5.jpg,2296,480,640,41,311,352,374,430,True,9
7,25,kaist_dataset/English/Digital_Camera/(E.S)E-night/크기변환_%BA%F7%BD%BA%BD%C5%B8%DE%B4%BA_01_tjtjdska2008.jpg,char_data/7/크기변환_%BA%F7%BD%BA%BD%C5%B8%DE%B4%BA_01_tjtjdska2008.jpg_2.jpg,500,480,640,20,381,401,277,302,True,9
7,43,kaist_dataset/English/Digital_Camera/(E.S)F-others/m.jpg,char_data/7/m.jpg_2.jpg,645,240,320,15,95,110,173,216,True,9
7,73,kaist_dataset/Korean/Digital_Camera/A-shadow/2007-12-09-day-exterior-026.jpg,char_data/7/2007-12-09-day-exterior-026.jpg_2.jpg,2482,1200,1600,34,958,992,754,827,True,9
7,81,kaist_dataset/Korean/Digital_Camera/A-shadow/2007-12-09-day-exterior-031.jpg,char_data/7/2007-12-09-day-exterior-031.jpg_4.jpg,3888,1200,1600,48,792,840,665,746,True,9
7,81,kaist_dataset/Korean/Digital_Camera/A-shadow/2007-12-09-day-exterior-031.jpg,char_data/7/2007-12-09-day-exterior-031.jpg_5.jpg,4617,1200,1600,57,888,945,667,748,True,9
7,40,kaist_dataset/Korean/Digital_Camera/A-shadow/2007-12-09-day-exterior-040.jpg,char_data/7/2007-12-09-day-exterior-040.jpg_2.jpg,840,1200,1600,21,1035,1056,811,851,True,9
7,67,kaist_dataset/Korean/Digital_Camera/A-shadow/DSC03535.JPG,char_data/7/DSC03535.JPG_2.jpg,2345,480,640,35,457,492,248,315,True,9
7,82,kaist_dataset/Korean/Digital_Camera/A-shadow/DSC03755.JPG,char_data/7/DSC03755.JPG_4.jpg,2214,480,640,27,414,441,208,290,True,9
7,85,kaist_dataset/Korean/Digital_Camera/A-shadow/DSC03755.JPG,char_data/7/DSC03755.JPG_5.jpg,2890,480,640,34,578,612,207,292,True,9
7,35,kaist_dataset/Korean/Digital_Camera/A-shadow/DSC04297.JPG,char_data/7/DSC04297.JPG_2.jpg,455,480,640,13,407,420,205,240,True,9
7,42,kaist_dataset/Korean/Digital_Camera/A-shadow/DSC04315.JPG,char_data/7/DSC04315.JPG_4.jpg,1218,480,640,29,212,241,416,458,True,9
7,47,kaist_dataset/Korean/Digital_Camera/A-shadow/DSC04315.JPG,char_data/7/DSC04315.JPG_5.jpg,1081,480,640,23,271,294,415,462,True,9
7,32,kaist_dataset/Korean/Digital_Camera/E-night/DSC02626.JPG,char_data/7/DSC02626.JPG_6.jpg,480,480,640,15,180,195,372,404,True,9
7,32,kaist_dataset/Korean/Digital_Camera/E-night/DSC02626.JPG,char_data/7/DSC02626.JPG_7.jpg,512,480,640,16,244,260,367,399,True,9
7,30,kaist_dataset/Korean/Digital_Camera/E-night/DSC02626.JPG,char_data/7/DSC02626.JPG_8.jpg,510,480,640,17,329,346,367,397,True,9
7,46,kaist_dataset/Korean/Digital_Camera/E-night/DSC02645.JPG,char_data/7/DSC02645.JPG_4.jpg,1104,480,640,24,454,478,330,376,True,9
7,47,kaist_dataset/Korean/Digital_Camera/E-night/DSC02645.JPG,char_data/7/DSC02645.JPG_5.jpg,1222,480,640,26,482,508,331,378,True,9
7,40,kaist_dataset/Korean/Digital_Camera/E-night/DSC03515.JPG,char_data/7/DSC03515.JPG_2.jpg,720,480,640,18,525,543,272,312,True,9
7,35,kaist_dataset/Korean/Digital_Camera/E-night/DSC03850.JPG,char_data/7/DSC03850.JPG_2.jpg,560,480,640,16,339,355,429,464,True,9
7,24,kaist_dataset/Korean/Digital_Camera/E-night/DSC03870.JPG,char_data/7/DSC03870.JPG_2.jpg,288,480,640,12,346,358,224,248,True,9
7,28,kaist_dataset/Korean/Digital_Camera/E-night/P1010149.JPG,char_data/7/P1010149.JPG_4.jpg,364,480,640,13,577,590,237,265,True,9
7,21,kaist_dataset/Korean/Digital_Camera/E-night/P1010149.JPG,char_data/7/P1010149.JPG_5.jpg,189,480,640,9,603,612,242,263,True,9
7,74,kaist_dataset/Korean/Digital_Camera/G-others/2007-12-08-day-108.jpg,char_data/7/2007-12-08-day-108.jpg_8.jpg,2664,1200,1600,36,887,923,685,759,True,9
7,71,kaist_dataset/Korean/Digital_Camera/G-others/2007-12-08-day-108.jpg,char_data/7/2007-12-08-day-108.jpg_9.jpg,2911,1200,1600,41,947,988,708,779,True,9
7,79,kaist_dataset/Korean/Digital_Camera/G-others/2007-12-08-day-108.jpg,char_data/7/2007-12-08-day-108.jpg_10.jpg,2686,1200,1600,34,903,937,772,851,True,9
7,80,kaist_dataset/Korean/Digital_Camera/G-others/2007-12-08-day-108.jpg,char_data/7/2007-12-08-day-108.jpg_11.jpg,3760,1200,1600,47,965,1012,789,869,True,9
7,46,kaist_dataset/Korean/Digital_Camera/G-others/2007-12-09-day-exterior-083.jpg,char_data/7/2007-12-09-day-exterior-083.jpg_4.jpg,1518,1600,1200,33,631,664,975,1021,True,9
7,56,kaist_dataset/Korean/Digital_Camera/G-others/2007-12-09-day-exterior-083.jpg,char_data/7/2007-12-09-day-exterior-083.jpg_5.jpg,2352,1600,1200,42,439,481,122,178,True,9
7,42,kaist_dataset/Korean/Digital_Camera/G-others/DSC03862.JPG,char_data/7/DSC03862.JPG_2.jpg,714,480,640,17,275,292,352,394,True,9
7,49,kaist_dataset/Korean/Digital_Camera/indoor1/080119-0029.jpg,char_data/7/080119-0029.jpg_2.jpg,980,1200,1600,20,1271,1291,618,667,True,9
7,52,kaist_dataset/Korean/Digital_Camera/indoor2/DSC03474.JPG,char_data/7/DSC03474.JPG_2.jpg,2080,480,640,40,369,409,152,204,True,9
7,61,kaist_dataset/Korean/Digital_Camera/indoor2/DSC03475.JPG,char_data/7/DSC03475.JPG_4.jpg,2440,480,640,40,290,330,89,150,True,9
7,58,kaist_dataset/Korean/Digital_Camera/indoor2/DSC03475.JPG,char_data/7/DSC03475.JPG_5.jpg,2204,480,640,38,421,459,90,148,True,9
7,33,kaist_dataset/Korean/Digital_Camera/indoor2/DSC03564.JPG,char_data/7/DSC03564.JPG_6.jpg,561,480,640,17,286,303,405,438,True,9
7,34,kaist_dataset/Korean/Digital_Camera/indoor2/DSC03564.JPG,char_data/7/DSC03564.JPG_7.jpg,612,480,640,18,351,369,403,437,True,9
7,32,kaist_dataset/Korean/Digital_Camera/indoor2/DSC03564.JPG,char_data/7/DSC03564.JPG_8.jpg,576,480,640,18,384,402,402,434,True,9
7,38,kaist_dataset/Korean/Digital_Camera/indoor2/DSC03983.JPG,char_data/7/DSC03983.JPG_2.jpg,760,480,640,20,395,415,321,359,True,9
7,55,kaist_dataset/Korean/Digital_Camera/indoor2/DSC03994.JPG,char_data/7/DSC03994.JPG_2.jpg,1595,480,640,29,343,372,283,338,True,9
7,42,kaist_dataset/Korean/Digital_Camera/indoor2/DSC03995.JPG,char_data/7/DSC03995.JPG_2.jpg,1218,480,640,29,427,456,267,309,True,9
7,70,kaist_dataset/Korean/Digital_Camera/indoor2/DSC04006.JPG,char_data/7/DSC04006.JPG_2.jpg,2310,480,640,33,181,214,152,222,True,9
7,95,kaist_dataset/Korean/Digital_Camera/indoor2/크기변환_%BD%C7%B3%BB%B0%A3%C6%C7_moon8481.jpg,char_data/7/크기변환_%BD%C7%B3%BB%B0%A3%C6%C7_moon8481.jpg_2.jpg,3515,480,640,37,254,291,330,425,True,9
7,31,kaist_dataset/Korean/Digital_Camera/outdoor1/023.JPG,char_data/7/023.JPG_2.jpg,775,480,640,25,277,302,267,298,True,9
7,29,kaist_dataset/Korean/Digital_Camera/outdoor1/032.JPG,char_data/7/032.JPG_6.jpg,435,480,640,15,141,156,258,287,True,9
7,23,kaist_dataset/Korean/Digital_Camera/outdoor1/032.JPG,char_data/7/032.JPG_7.jpg,437,480,640,19,331,350,260,283,True,9
7,29,kaist_dataset/Korean/Digital_Camera/outdoor1/032.JPG,char_data/7/032.JPG_8.jpg,754,480,640,26,540,566,254,283,True,9
7,37,kaist_dataset/Korean/Digital_Camera/outdoor1/035.JPG,char_data/7/035.JPG_2.jpg,444,480,640,12,537,549,287,324,True,9
7,42,kaist_dataset/Korean/Digital_Camera/outdoor1/052.JPG,char_data/7/052.JPG_2.jpg,1092,480,640,26,379,405,319,361,True,9
7,29,kaist_dataset/Korean/Digital_Camera/outdoor1/071.JPG,char_data/7/071.JPG_2.jpg,493,480,640,17,356,373,258,287,True,9
7,48,kaist_dataset/Korean/Digital_Camera/outdoor1/098.JPG,char_data/7/098.JPG_4.jpg,1344,480,640,28,306,334,352,400,True,9
7,46,kaist_dataset/Korean/Digital_Camera/outdoor1/098.JPG,char_data/7/098.JPG_5.jpg,1702,480,640,37,334,371,353,399,True,9
7,30,kaist_dataset/Korean/Digital_Camera/outdoor1/102.JPG,char_data/7/102.JPG_2.jpg,630,480,640,21,407,428,309,339,True,9
7,32,kaist_dataset/Korean/Digital_Camera/outdoor1/123.JPG,char_data/7/123.JPG_2.jpg,384,480,640,12,83,95,280,312,True,9
7,31,kaist_dataset/Korean/Digital_Camera/outdoor1/125.JPG,char_data/7/125.JPG_4.jpg,620,480,640,20,394,414,256,287,True,9
7,30,kaist_dataset/Korean/Digital_Camera/outdoor1/125.JPG,char_data/7/125.JPG_5.jpg,750,480,640,25,414,439,257,287,True,9
7,22,kaist_dataset/Korean/Digital_Camera/outdoor1/126.JPG,char_data/7/126.JPG_2.jpg,286,480,640,13,554,567,255,277,True,9
7,43,kaist_dataset/Korean/Digital_Camera/outdoor1/2007-12-08-day-047.jpg,char_data/7/2007-12-08-day-047.jpg_2.jpg,1161,1200,1600,27,892,919,711,754,True,9
7,66,kaist_dataset/Korean/Digital_Camera/outdoor1/2007-12-08-day-057.jpg,char_data/7/2007-12-08-day-057.jpg_4.jpg,2310,1200,1600,35,876,911,599,665,True,9
7,70,kaist_dataset/Korean/Digital_Camera/outdoor1/2007-12-08-day-057.jpg,char_data/7/2007-12-08-day-057.jpg_5.jpg,2730,1200,1600,39,1031,1070,593,663,True,9
7,25,kaist_dataset/Korean/Digital_Camera/outdoor1/2007-12-08-day-087.jpg,char_data/7/2007-12-08-day-087.jpg_6.jpg,375,1200,1600,15,18,33,806,831,True,9
7,25,kaist_dataset/Korean/Digital_Camera/outdoor1/2007-12-08-day-087.jpg,char_data/7/2007-12-08-day-087.jpg_7.jpg,400,1200,1600,16,34,50,808,833,True,9
7,29,kaist_dataset/Korean/Digital_Camera/outdoor1/2007-12-08-day-087.jpg,char_data/7/2007-12-08-day-087.jpg_8.jpg,464,1200,1600,16,1,17,806,835,True,9
7,69,kaist_dataset/Korean/Digital_Camera/outdoor1/46.JPG,char_data/7/46.JPG_2.jpg,2415,576,768,35,327,362,366,435,True,9
7,30,kaist_dataset/Korean/Digital_Camera/outdoor1/50.JPG,char_data/7/50.JPG_4.jpg,480,576,768,16,408,424,340,370,True,9
7,33,kaist_dataset/Korean/Digital_Camera/outdoor1/50.JPG,char_data/7/50.JPG_5.jpg,660,576,768,20,425,445,338,371,True,9
7,35,kaist_dataset/Korean/Digital_Camera/outdoor1/53.JPG,char_data/7/53.JPG_2.jpg,735,401,766,21,683,704,227,262,True,9
7,59,kaist_dataset/Korean/Digital_Camera/outdoor2/2007-12-09-day-exterior-016.jpg,char_data/7/2007-12-09-day-exterior-016.jpg_4.jpg,2183,1200,1600,37,56,93,353,412,True,9
7,65,kaist_dataset/Korean/Digital_Camera/outdoor2/2007-12-09-day-exterior-016.jpg,char_data/7/2007-12-09-day-exterior-016.jpg_5.jpg,2665,1200,1600,41,731,772,742,807,True,9
7,57,kaist_dataset/Korean/Digital_Camera/outdoor2/2007-12-09-day-exterior-035.jpg,char_data/7/2007-12-09-day-exterior-035.jpg_2.jpg,1881,1200,1600,33,533,566,706,763,True,9
7,37,kaist_dataset/Korean/Digital_Camera/outdoor2/2007-12-09-day-exterior-036.jpg,char_data/7/2007-12-09-day-exterior-036.jpg_2.jpg,703,1200,1600,19,1468,1487,630,667,True,9
7,50,kaist_dataset/Korean/Digital_Camera/outdoor2/2007-12-09-day-exterior-084.jpg,char_data/7/2007-12-09-day-exterior-084.jpg_2.jpg,1950,1200,1600,39,865,904,794,844,True,9
7,28,kaist_dataset/Korean/Digital_Camera/outdoor2/DSC02304.JPG,char_data/7/DSC02304.JPG_2.jpg,700,480,640,25,326,351,263,291,True,9
7,30,kaist_dataset/Korean/Digital_Camera/outdoor2/DSC02308.JPG,char_data/7/DSC02308.JPG_6.jpg,840,480,640,28,345,373,237,267,True,9
7,33,kaist_dataset/Korean/Digital_Camera/outdoor2/DSC02308.JPG,char_data/7/DSC02308.JPG_7.jpg,891,480,640,27,371,398,236,269,True,9
7,25,kaist_dataset/Korean/Digital_Camera/outdoor2/DSC02308.JPG,char_data/7/DSC02308.JPG_8.jpg,700,480,640,28,400,428,242,267,True,9
7,29,kaist_dataset/Korean/Digital_Camera/outdoor2/DSC02326.JPG,char_data/7/DSC02326.JPG_2.jpg,319,480,640,11,446,457,338,367,True,9
7,41,kaist_dataset/Korean/Digital_Camera/outdoor2/DSC02366.JPG,char_data/7/DSC02366.JPG_4.jpg,1107,480,640,27,416,443,403,444,True,9
7,42,kaist_dataset/Korean/Digital_Camera/outdoor2/DSC02366.JPG,char_data/7/DSC02366.JPG_5.jpg,1176,480,640,28,442,470,404,446,True,9
7,38,kaist_dataset/Korean/Digital_Camera/outdoor2/DSC02381.JPG,char_data/7/DSC02381.JPG_2.jpg,646,480,640,17,342,359,320,358,True,9
7,29,kaist_dataset/Korean/Digital_Camera/outdoor2/DSC02383.JPG,char_data/7/DSC02383.JPG_4.jpg,435,480,640,15,117,132,293,322,True,9
7,34,kaist_dataset/Korean/Digital_Camera/outdoor2/DSC02383.JPG,char_data/7/DSC02383.JPG_5.jpg,578,480,640,17,277,294,287,321,True,9
7,36,kaist_dataset/Korean/Digital_Camera/outdoor2/DSC02393.JPG,char_data/7/DSC02393.JPG_2.jpg,864,480,640,24,522,546,306,342,True,9
7,24,kaist_dataset/Korean/Digital_Camera/outdoor2/DSC02435.JPG,char_data/7/DSC02435.JPG_2.jpg,312,480,640,13,427,440,247,271,True,9
7,80,kaist_dataset/Korean/Digital_Camera/outdoor2/DSC02451.JPG,char_data/7/DSC02451.JPG_2.jpg,4560,480,640,57,317,374,321,401,True,9
7,38,kaist_dataset/Korean/Digital_Camera/outdoor2/DSC02476.JPG,char_data/7/DSC02476.JPG_4.jpg,760,480,640,20,308,328,272,310,True,9
7,36,kaist_dataset/Korean/Digital_Camera/outdoor2/DSC02476.JPG,char_data/7/DSC02476.JPG_5.jpg,828,480,640,23,334,357,272,308,True,9
7,32,kaist_dataset/Korean/Digital_Camera/outdoor2/DSC02488.JPG,char_data/7/DSC02488.JPG_2.jpg,384,480,640,12,624,636,371,403,True,9
7,38,kaist_dataset/Korean/Digital_Camera/outdoor2/DSC02521.JPG,char_data/7/DSC02521.JPG_2.jpg,912,480,640,24,372,396,326,364,True,9
7,50,kaist_dataset/Korean/Digital_Camera/outdoor3/DSC02528.JPG,char_data/7/DSC02528.JPG_2.jpg,1550,480,640,31,302,333,411,461,True,9
7,72,kaist_dataset/Korean/Digital_Camera/outdoor3/DSC02562.JPG,char_data/7/DSC02562.JPG_4.jpg,2736,480,640,38,400,438,358,430,True,9
7,82,kaist_dataset/Korean/Digital_Camera/outdoor3/DSC02562.JPG,char_data/7/DSC02562.JPG_5.jpg,3772,480,640,46,436,482,356,438,True,9
7,42,kaist_dataset/Korean/Digital_Camera/outdoor3/DSC02686.JPG,char_data/7/DSC02686.JPG_6.jpg,1260,480,640,30,270,300,223,265,True,9
7,42,kaist_dataset/Korean/Digital_Camera/outdoor3/DSC02686.JPG,char_data/7/DSC02686.JPG_7.jpg,882,480,640,21,572,593,225,267,True,9
7,47,kaist_dataset/Korean/Digital_Camera/outdoor3/DSC02686.JPG,char_data/7/DSC02686.JPG_8.jpg,1128,480,640,24,594,618,221,268,True,9
7,28,kaist_dataset/Korean/Digital_Camera/outdoor3/DSC02891.JPG,char_data/7/DSC02891.JPG_4.jpg,420,480,640,15,572,587,299,327,True,9
7,26,kaist_dataset/Korean/Digital_Camera/outdoor3/DSC02891.JPG,char_data/7/DSC02891.JPG_5.jpg,364,480,640,14,588,602,301,327,True,9
7,34,kaist_dataset/Korean/Digital_Camera/outdoor3/DSC02939.JPG,char_data/7/DSC02939.JPG_4.jpg,680,480,640,20,358,378,369,403,True,9
7,34,kaist_dataset/Korean/Digital_Camera/outdoor3/DSC02939.JPG,char_data/7/DSC02939.JPG_5.jpg,782,480,640,23,493,516,370,404,True,9
7,38,kaist_dataset/Korean/Digital_Camera/outdoor3/DSC02941.JPG,char_data/7/DSC02941.JPG_2.jpg,874,480,640,23,472,495,257,295,True,9
7,34,kaist_dataset/Korean/Digital_Camera/outdoor3/DSC02971.JPG,char_data/7/DSC02971.JPG_6.jpg,782,480,640,23,298,321,294,328,True,9
7,31,kaist_dataset/Korean/Digital_Camera/outdoor3/DSC02971.JPG,char_data/7/DSC02971.JPG_7.jpg,589,480,640,19,395,414,299,330,True,9
7,38,kaist_dataset/Korean/Digital_Camera/outdoor3/DSC02971.JPG,char_data/7/DSC02971.JPG_8.jpg,1064,480,640,28,414,442,296,334,True,9
7,36,kaist_dataset/Korean/Digital_Camera/outdoor3/DSC02975.JPG,char_data/7/DSC02975.JPG_2.jpg,828,480,640,23,461,484,246,282,True,9
7,32,kaist_dataset/Korean/Digital_Camera/outdoor3/DSC02999.JPG,char_data/7/DSC02999.JPG_4.jpg,480,480,640,15,337,352,433,465,True,9
7,32,kaist_dataset/Korean/Digital_Camera/outdoor3/DSC02999.JPG,char_data/7/DSC02999.JPG_5.jpg,576,480,640,18,352,370,431,463,True,9
7,47,kaist_dataset/Korean/Digital_Camera/outdoor3/DSC03064.JPG,char_data/7/DSC03064.JPG_2.jpg,987,480,640,21,302,323,348,395,True,9
7,30,kaist_dataset/Korean/Digital_Camera/outdoor3/DSC03219.JPG,char_data/7/DSC03219.JPG_2.jpg,570,480,640,19,407,426,412,442,True,9
7,36,kaist_dataset/Korean/Digital_Camera/outdoor3/DSC03232.JPG,char_data/7/DSC03232.JPG_2.jpg,864,480,640,24,322,346,277,313,True,9
7,38,kaist_dataset/Korean/Digital_Camera/outdoor4/DSC03293.JPG,char_data/7/DSC03293.JPG_4.jpg,570,480,640,15,242,257,283,321,True,9
7,35,kaist_dataset/Korean/Digital_Camera/outdoor4/DSC03293.JPG,char_data/7/DSC03293.JPG_5.jpg,735,480,640,21,318,339,285,320,True,9
7,60,kaist_dataset/Korean/Digital_Camera/outdoor4/DSC03313.JPG,char_data/7/DSC03313.JPG_8.jpg,2100,480,640,35,302,337,312,372,True,9
7,54,kaist_dataset/Korean/Digital_Camera/outdoor4/DSC03313.JPG,char_data/7/DSC03313.JPG_9.jpg,1782,480,640,33,417,450,312,366,True,9
7,54,kaist_dataset/Korean/Digital_Camera/outdoor4/DSC03313.JPG,char_data/7/DSC03313.JPG_10.jpg,1836,480,640,34,487,521,313,367,True,9
7,54,kaist_dataset/Korean/Digital_Camera/outdoor4/DSC03313.JPG,char_data/7/DSC03313.JPG_11.jpg,1944,480,640,36,523,559,312,366,True,9
7,49,kaist_dataset/Korean/Digital_Camera/outdoor4/DSC03319.JPG,char_data/7/DSC03319.JPG_4.jpg,1421,480,640,29,214,243,387,436,True,9
7,45,kaist_dataset/Korean/Digital_Camera/outdoor4/DSC03319.JPG,char_data/7/DSC03319.JPG_5.jpg,1125,480,640,25,122,147,81,126,True,9
7,42,kaist_dataset/Korean/Digital_Camera/outdoor4/DSC03545.JPG,char_data/7/DSC03545.JPG_2.jpg,546,480,640,13,116,129,39,81,True,9
7,64,kaist_dataset/Korean/Digital_Camera/outdoor4/DSC03550.JPG,char_data/7/DSC03550.JPG_2.jpg,3456,480,640,54,259,313,308,372,True,9
7,74,kaist_dataset/Korean/Digital_Camera/outdoor4/DSC03553.JPG,char_data/7/DSC03553.JPG_6.jpg,4736,480,640,64,164,228,179,253,True,9
7,80,kaist_dataset/Korean/Digital_Camera/outdoor4/DSC03553.JPG,char_data/7/DSC03553.JPG_7.jpg,5920,480,640,74,391,465,172,252,True,9
7,75,kaist_dataset/Korean/Digital_Camera/outdoor4/DSC03553.JPG,char_data/7/DSC03553.JPG_8.jpg,5700,480,640,76,516,592,175,250,True,9
7,27,kaist_dataset/Korean/Digital_Camera/outdoor4/DSC03555.JPG,char_data/7/DSC03555.JPG_2.jpg,621,480,640,23,439,462,429,456,True,9
7,54,kaist_dataset/Korean/Digital_Camera/outdoor4/DSC03580.JPG,char_data/7/DSC03580.JPG_2.jpg,1674,480,640,31,391,422,201,255,True,9
7,38,kaist_dataset/Korean/Digital_Camera/outdoor4/DSC03592.JPG,char_data/7/DSC03592.JPG_2.jpg,760,480,640,20,84,104,115,153,True,9
7,46,kaist_dataset/Korean/Digital_Camera/outdoor4/DSC03599.JPG,char_data/7/DSC03599.JPG_2.jpg,1012,480,640,22,317,339,306,352,True,9
7,73,kaist_dataset/Korean/Digital_Camera/outdoor4/DSC03606.JPG,char_data/7/DSC03606.JPG_2.jpg,4161,480,640,57,344,401,234,307,True,9
7,54,kaist_dataset/Korean/Digital_Camera/outdoor4/DSC03608.JPG,char_data/7/DSC03608.JPG_2.jpg,1674,480,640,31,521,552,386,440,True,9
7,38,kaist_dataset/Korean/Digital_Camera/outdoor4/DSC03614.JPG,char_data/7/DSC03614.JPG_4.jpg,912,480,640,24,432,456,390,428,True,9
7,45,kaist_dataset/Korean/Digital_Camera/outdoor4/DSC03614.JPG,char_data/7/DSC03614.JPG_5.jpg,855,480,640,19,457,476,384,429,True,9
7,47,kaist_dataset/Korean/Digital_Camera/outdoor5/DSC03626.JPG,char_data/7/DSC03626.JPG_4.jpg,1128,480,640,24,478,502,292,339,True,9
7,51,kaist_dataset/Korean/Digital_Camera/outdoor5/DSC03626.JPG,char_data/7/DSC03626.JPG_5.jpg,1275,480,640,25,504,529,292,343,True,9
7,31,kaist_dataset/Korean/Digital_Camera/outdoor5/DSC03627.JPG,char_data/7/DSC03627.JPG_4.jpg,930,480,640,30,237,267,224,255,True,9
7,36,kaist_dataset/Korean/Digital_Camera/outdoor5/DSC03627.JPG,char_data/7/DSC03627.JPG_5.jpg,1080,480,640,30,357,387,223,259,True,9
7,30,kaist_dataset/Korean/Digital_Camera/outdoor5/DSC03641.JPG,char_data/7/DSC03641.JPG_4.jpg,420,480,640,14,462,476,423,453,True,9
7,31,kaist_dataset/Korean/Digital_Camera/outdoor5/DSC03641.JPG,char_data/7/DSC03641.JPG_5.jpg,620,480,640,20,475,495,420,451,True,9
7,43,kaist_dataset/Korean/Digital_Camera/outdoor5/DSC03645.JPG,char_data/7/DSC03645.JPG_4.jpg,1204,480,640,28,377,405,351,394,True,9
7,42,kaist_dataset/Korean/Digital_Camera/outdoor5/DSC03645.JPG,char_data/7/DSC03645.JPG_5.jpg,1176,480,640,28,422,450,350,392,True,9
7,37,kaist_dataset/Korean/Digital_Camera/outdoor5/DSC03669.JPG,char_data/7/DSC03669.JPG_4.jpg,888,480,640,24,303,327,311,348,True,9
7,38,kaist_dataset/Korean/Digital_Camera/outdoor5/DSC03669.JPG,char_data/7/DSC03669.JPG_5.jpg,950,480,640,25,328,353,312,350,True,9
7,35,kaist_dataset/Korean/Digital_Camera/outdoor5/DSC03671.JPG,char_data/7/DSC03671.JPG_4.jpg,805,480,640,23,351,374,407,442,True,9
7,29,kaist_dataset/Korean/Digital_Camera/outdoor5/DSC03671.JPG,char_data/7/DSC03671.JPG_5.jpg,725,480,640,25,579,604,416,445,True,9
7,26,kaist_dataset/Korean/Digital_Camera/outdoor5/DSC03688.JPG,char_data/7/DSC03688.JPG_4.jpg,312,480,640,12,565,577,229,255,True,9
7,24,kaist_dataset/Korean/Digital_Camera/outdoor5/DSC03688.JPG,char_data/7/DSC03688.JPG_5.jpg,312,480,640,13,584,597,229,253,True,9
7,39,kaist_dataset/Korean/Digital_Camera/outdoor5/DSC03710.JPG,char_data/7/DSC03710.JPG_2.jpg,1326,480,640,34,283,317,405,444,True,9
7,44,kaist_dataset/Korean/Digital_Camera/outdoor5/DSC03717.JPG,char_data/7/DSC03717.JPG_2.jpg,1452,480,640,33,200,233,346,390,True,9
7,38,kaist_dataset/Korean/Digital_Camera/outdoor5/DSC03740.JPG,char_data/7/DSC03740.JPG_2.jpg,912,480,640,24,471,495,286,324,True,9
7,68,kaist_dataset/Korean/Digital_Camera/outdoor5/DSC03749.JPG,char_data/7/DSC03749.JPG_2.jpg,2108,480,640,31,402,433,408,476,True,9
7,33,kaist_dataset/Korean/Digital_Camera/outdoor5/DSC03751.JPG,char_data/7/DSC03751.JPG_4.jpg,660,480,640,20,336,356,409,442,True,9
7,32,kaist_dataset/Korean/Digital_Camera/outdoor5/DSC03751.JPG,char_data/7/DSC03751.JPG_5.jpg,704,480,640,22,357,379,407,439,True,9
7,19,kaist_dataset/Korean/Digital_Camera/outdoor5/DSC03776.JPG,char_data/7/DSC03776.JPG_2.jpg,266,480,640,14,529,543,424,443,True,9
7,44,kaist_dataset/Korean/Digital_Camera/outdoor5/DSC03778.JPG,char_data/7/DSC03778.JPG_2.jpg,616,480,640,14,338,352,335,379,True,9
7,40,kaist_dataset/Korean/Digital_Camera/outdoor5/DSC03794.JPG,char_data/7/DSC03794.JPG_2.jpg,720,480,640,18,402,420,357,397,True,9
7,47,kaist_dataset/Korean/Digital_Camera/outdoor5/DSC03838.JPG,char_data/7/DSC03838.JPG_2.jpg,1175,480,640,25,272,297,200,247,True,9
7,47,kaist_dataset/Korean/Digital_Camera/outdoor5/DSC03970.JPG,char_data/7/DSC03970.JPG_2.jpg,1551,480,640,33,267,300,94,141,True,9
7,55,kaist_dataset/Korean/Digital_Camera/outdoor5/DSC03979.JPG,char_data/7/DSC03979.JPG_2.jpg,3135,480,640,57,302,359,378,433,True,9
7,36,kaist_dataset/Korean/Digital_Camera/outdoor5/DSC03996.JPG,char_data/7/DSC03996.JPG_2.jpg,1080,480,640,30,316,346,281,317,True,9
7,30,kaist_dataset/Korean/Digital_Camera/outdoor5/DSC04027.JPG,char_data/7/DSC04027.JPG_2.jpg,630,480,640,21,369,390,384,414,True,9
7,38,kaist_dataset/Korean/Digital_Camera/outdoor5/DSC04040.JPG,char_data/7/DSC04040.JPG_2.jpg,1330,480,640,35,342,377,341,379,True,9
7,26,kaist_dataset/Korean/Digital_Camera/outdoor6/DSC04041.JPG,char_data/7/DSC04041.JPG_2.jpg,416,480,640,16,446,462,142,168,True,9
7,31,kaist_dataset/Korean/Digital_Camera/outdoor6/DSC04046.JPG,char_data/7/DSC04046.JPG_12.jpg,496,480,640,16,283,299,260,291,True,9
7,29,kaist_dataset/Korean/Digital_Camera/outdoor6/DSC04046.JPG,char_data/7/DSC04046.JPG_13.jpg,319,480,640,11,349,360,260,289,True,9
7,29,kaist_dataset/Korean/Digital_Camera/outdoor6/DSC04046.JPG,char_data/7/DSC04046.JPG_14.jpg,522,480,640,18,375,393,257,286,True,9
7,29,kaist_dataset/Korean/Digital_Camera/outdoor6/DSC04046.JPG,char_data/7/DSC04046.JPG_15.jpg,406,480,640,14,499,513,260,289,True,9
7,26,kaist_dataset/Korean/Digital_Camera/outdoor6/DSC04046.JPG,char_data/7/DSC04046.JPG_16.jpg,364,480,640,14,543,557,263,289,True,9
7,34,kaist_dataset/Korean/Digital_Camera/outdoor6/DSC04046.JPG,char_data/7/DSC04046.JPG_17.jpg,476,480,640,14,575,589,259,293,True,9
7,30,kaist_dataset/Korean/Digital_Camera/outdoor6/DSC04062.JPG,char_data/7/DSC04062.JPG_4.jpg,360,480,640,12,552,564,304,334,True,9
7,24,kaist_dataset/Korean/Digital_Camera/outdoor6/DSC04062.JPG,char_data/7/DSC04062.JPG_5.jpg,192,480,640,8,589,597,308,332,True,9
7,50,kaist_dataset/Korean/Digital_Camera/outdoor6/DSC04089.JPG,char_data/7/DSC04089.JPG_4.jpg,1300,480,640,26,395,421,275,325,True,9
7,47,kaist_dataset/Korean/Digital_Camera/outdoor6/DSC04089.JPG,char_data/7/DSC04089.JPG_5.jpg,1175,480,640,25,420,445,274,321,True,9
7,37,kaist_dataset/Korean/Digital_Camera/outdoor6/DSC04099.JPG,char_data/7/DSC04099.JPG_2.jpg,703,480,640,19,438,457,410,447,True,9
7,30,kaist_dataset/Korean/Digital_Camera/outdoor6/DSC04113.JPG,char_data/7/DSC04113.JPG_8.jpg,900,480,640,30,175,205,442,472,True,9
7,33,kaist_dataset/Korean/Digital_Camera/outdoor6/DSC04113.JPG,char_data/7/DSC04113.JPG_9.jpg,924,480,640,28,275,303,440,473,True,9
7,32,kaist_dataset/Korean/Digital_Camera/outdoor6/DSC04113.JPG,char_data/7/DSC04113.JPG_10.jpg,1056,480,640,33,307,340,443,475,True,9
7,29,kaist_dataset/Korean/Digital_Camera/outdoor6/DSC04113.JPG,char_data/7/DSC04113.JPG_11.jpg,1044,480,640,36,370,406,444,473,True,9
7,36,kaist_dataset/Korean/Digital_Camera/outdoor6/DSC04116.JPG,char_data/7/DSC04116.JPG_2.jpg,612,480,640,17,390,407,317,353,True,9
7,41,kaist_dataset/Korean/Digital_Camera/outdoor6/DSC04121.JPG,char_data/7/DSC04121.JPG_2.jpg,1189,480,640,29,450,479,181,222,True,9
7,46,kaist_dataset/Korean/Digital_Camera/outdoor6/DSC04143.JPG,char_data/7/DSC04143.JPG_2.jpg,1380,480,640,30,352,382,361,407,True,9
7,42,kaist_dataset/Korean/Digital_Camera/outdoor6/DSC04148.JPG,char_data/7/DSC04148.JPG_2.jpg,924,480,640,22,398,420,251,293,True,9
7,58,kaist_dataset/Korean/Digital_Camera/outdoor6/DSC04296.JPG,char_data/7/DSC04296.JPG_2.jpg,1392,480,640,24,423,447,303,361,True,9
7,25,kaist_dataset/Korean/Digital_Camera/outdoor7/P1010005.JPG,char_data/7/P1010005.JPG_2.jpg,675,480,640,27,488,515,191,216,True,9
7,37,kaist_dataset/Korean/Digital_Camera/outdoor7/P1010009.JPG,char_data/7/P1010009.JPG_4.jpg,1036,480,640,28,546,574,266,303,True,9
7,61,kaist_dataset/Korean/Digital_Camera/outdoor7/P1010011.JPG,char_data/7/P1010011.JPG_4.jpg,2623,480,640,43,556,599,218,279,True,9
7,59,kaist_dataset/Korean/Digital_Camera/outdoor7/P1010023.JPG,char_data/7/P1010023.JPG_2.jpg,1652,480,640,28,50,78,291,350,True,9
7,30,kaist_dataset/Korean/Digital_Camera/outdoor7/P1010035.JPG,char_data/7/P1010035.JPG_2.jpg,390,480,640,13,74,87,208,238,True,9
7,40,kaist_dataset/Korean/Digital_Camera/outdoor7/P1010067.JPG,char_data/7/P1010067.JPG_4.jpg,1120,480,640,28,174,202,311,351,True,9
7,60,kaist_dataset/Korean/Digital_Camera/outdoor7/P1010068.JPG,char_data/7/P1010068.JPG_6.jpg,1560,480,640,26,409,435,272,332,True,9
7,59,kaist_dataset/Korean/Digital_Camera/outdoor7/P1010068.JPG,char_data/7/P1010068.JPG_7.jpg,1770,480,640,30,491,521,274,333,True,9
7,56,kaist_dataset/Korean/Digital_Camera/outdoor7/P1010068.JPG,char_data/7/P1010068.JPG_8.jpg,1568,480,640,28,554,582,275,331,True,9
7,48,kaist_dataset/Korean/Digital_Camera/outdoor7/P1010069.JPG,char_data/7/P1010069.JPG_2.jpg,1584,480,640,33,259,292,311,359,True,9
7,55,kaist_dataset/Korean/Digital_Camera/outdoor7/P1010077.JPG,char_data/7/P1010077.JPG_2.jpg,1595,480,640,29,233,262,246,301,True,9
7,32,kaist_dataset/Korean/Digital_Camera/outdoor7/P1010078.JPG,char_data/7/P1010078.JPG_4.jpg,736,480,640,23,267,290,251,283,True,9
7,37,kaist_dataset/Korean/Digital_Camera/outdoor7/P1010078.JPG,char_data/7/P1010078.JPG_5.jpg,888,480,640,24,292,316,251,288,True,9
7,104,kaist_dataset/Korean/Digital_Camera/outdoor7/P1010079.JPG,char_data/7/P1010079.JPG_2.jpg,7488,480,640,72,148,220,335,439,True,9
7,48,kaist_dataset/Korean/Digital_Camera/outdoor7/P1010085.JPG,char_data/7/P1010085.JPG_6.jpg,1776,480,640,37,247,284,269,317,True,9
7,51,kaist_dataset/Korean/Digital_Camera/outdoor7/P1010085.JPG,char_data/7/P1010085.JPG_7.jpg,1836,480,640,36,414,450,267,318,True,9
7,76,kaist_dataset/Korean/Digital_Camera/outdoor7/P1010086.JPG,char_data/7/P1010086.JPG_4.jpg,4332,480,640,57,116,173,255,331,True,9
7,67,kaist_dataset/Korean/Digital_Camera/outdoor7/P1010086.JPG,char_data/7/P1010086.JPG_5.jpg,3685,480,640,55,414,469,259,326,True,9
7,41,kaist_dataset/Korean/Digital_Camera/outdoor7/P1010138.JPG,char_data/7/P1010138.JPG_4.jpg,738,480,640,18,292,310,281,322,True,9
7,37,kaist_dataset/Korean/Digital_Camera/outdoor8/P1010142.JPG,char_data/7/P1010142.JPG_2.jpg,999,480,640,27,306,333,282,319,True,9
7,32,kaist_dataset/Korean/Digital_Camera/outdoor8/P1010143.JPG,char_data/7/P1010143.JPG_2.jpg,576,480,640,18,479,497,278,310,True,9
7,39,kaist_dataset/Korean/Digital_Camera/outdoor8/P1010170.JPG,char_data/7/P1010170.JPG_2.jpg,702,480,640,18,470,488,273,312,True,9
7,51,kaist_dataset/Korean/Digital_Camera/outdoor8/P1010171.JPG,char_data/7/P1010171.JPG_2.jpg,1326,480,640,26,399,425,230,281,True,9
7,76,kaist_dataset/Korean/Digital_Camera/outdoor8/P1010172.JPG,char_data/7/P1010172.JPG_4.jpg,3420,480,640,45,191,236,225,301,True,9
7,65,kaist_dataset/Korean/Digital_Camera/outdoor8/P1010172.JPG,char_data/7/P1010172.JPG_5.jpg,2795,480,640,43,451,494,232,297,True,9
7,26,kaist_dataset/Korean/Digital_Camera/outdoor8/크기변환_P1010033.JPG,char_data/7/크기변환_P1010033.JPG_6.jpg,312,480,640,12,431,443,179,205,True,9
7,28,kaist_dataset/Korean/Digital_Camera/outdoor8/크기변환_P1010033.JPG,char_data/7/크기변환_P1010033.JPG_7.jpg,308,480,640,11,501,512,174,202,True,9
7,45,kaist_dataset/Korean/Digital_Camera/outdoor8/크기변환_P1010033.JPG,char_data/7/크기변환_P1010033.JPG_8.jpg,675,480,640,15,624,639,168,213,True,9
7,31,"kaist_dataset/Korean/Mobile_Phone/(M,K)C-outdoor/P090912042.jpg",char_data/7/P090912042.jpg_2.jpg,527,480,640,17,431,448,247,278,True,9
7,76,"kaist_dataset/Korean/Mobile_Phone/(M,K)E-bookCover/P090831154.jpg",char_data/7/P090831154.jpg_2.jpg,4332,480,640,57,360,417,139,215,True,9
7,38,kaist_dataset/Mixed/Digital_Camera/(C.S)A-shadow/DSC02579.JPG,char_data/7/DSC02579.JPG_4.jpg,988,480,640,26,317,343,400,438,True,9
7,41,kaist_dataset/Mixed/Digital_Camera/(C.S)A-shadow/DSC02579.JPG,char_data/7/DSC02579.JPG_5.jpg,1107,480,640,27,343,370,398,439,True,9
7,44,kaist_dataset/Mixed/Digital_Camera/(C.S)A-shadow/DSC02581.JPG,char_data/7/DSC02581.JPG_2.jpg,924,480,640,21,276,297,381,425,True,9
7,40,kaist_dataset/Mixed/Digital_Camera/(C.S)A-shadow/DSC04306.JPG,char_data/7/DSC04306.JPG_2.jpg,1000,480,640,25,382,407,410,450,True,9
7,43,kaist_dataset/Mixed/Digital_Camera/(C.S)A-shadow/P1010019.JPG,char_data/7/P1010019.JPG_4.jpg,946,480,640,22,318,340,198,241,True,9
7,36,kaist_dataset/Mixed/Digital_Camera/(C.S)A-shadow/P1010019.JPG,char_data/7/P1010019.JPG_5.jpg,792,480,640,22,429,451,201,237,True,9
7,21,kaist_dataset/Mixed/Digital_Camera/(C.S)C-outdoor1/047.JPG,char_data/7/047.JPG_2.jpg,126,480,640,6,601,607,173,194,True,9
7,30,kaist_dataset/Mixed/Digital_Camera/(C.S)C-outdoor1/048.JPG,char_data/7/048.JPG_2.jpg,600,480,640,20,337,357,258,288,True,9
7,44,kaist_dataset/Mixed/Digital_Camera/(C.S)C-outdoor1/081.JPG,char_data/7/081.JPG_2.jpg,2200,480,640,50,190,240,250,294,True,9
7,31,kaist_dataset/Mixed/Digital_Camera/(C.S)C-outdoor1/105.jpg,char_data/7/105.jpg_2.jpg,651,480,640,21,267,288,386,417,True,9
7,22,kaist_dataset/Mixed/Digital_Camera/(C.S)C-outdoor1/114.jpg,char_data/7/114.jpg_2.jpg,352,480,640,16,427,443,375,397,True,9
7,33,kaist_dataset/Mixed/Digital_Camera/(C.S)C-outdoor1/118.JPG,char_data/7/118.JPG_2.jpg,561,480,640,17,445,462,361,394,True,9
7,32,kaist_dataset/Mixed/Digital_Camera/(C.S)C-outdoor1/121.JPG,char_data/7/121.JPG_2.jpg,576,480,640,18,334,352,272,304,True,9
7,39,kaist_dataset/Mixed/Digital_Camera/(C.S)C-outdoor1/2.JPG,char_data/7/2.JPG_6.jpg,741,576,768,19,359,378,67,106,True,9
7,41,kaist_dataset/Mixed/Digital_Camera/(C.S)C-outdoor1/2.JPG,char_data/7/2.JPG_7.jpg,779,576,768,19,379,398,65,106,True,9
7,24,kaist_dataset/Mixed/Digital_Camera/(C.S)C-outdoor1/2.JPG,char_data/7/2.JPG_8.jpg,216,576,768,9,614,623,393,417,True,9
7,71,kaist_dataset/Mixed/Digital_Camera/(C.S)C-outdoor1/2007-12-09-day-exterior-004.jpg,char_data/7/2007-12-09-day-exterior-004.jpg_6.jpg,3266,1200,1600,46,1172,1218,660,731,True,9
7,76,kaist_dataset/Mixed/Digital_Camera/(C.S)C-outdoor1/2007-12-09-day-exterior-004.jpg,char_data/7/2007-12-09-day-exterior-004.jpg_7.jpg,3496,1200,1600,46,1219,1265,657,733,True,9
7,67,kaist_dataset/Mixed/Digital_Camera/(C.S)C-outdoor1/2007-12-09-day-exterior-004.jpg,char_data/7/2007-12-09-day-exterior-004.jpg_8.jpg,3216,1200,1600,48,1322,1370,662,729,True,9
7,44,kaist_dataset/Mixed/Digital_Camera/(C.S)C-outdoor1/2007-12-09-day-exterior-078.jpg,char_data/7/2007-12-09-day-exterior-078.jpg_2.jpg,836,1200,1600,19,710,729,588,632,True,9
7,28,kaist_dataset/Mixed/Digital_Camera/(C.S)C-outdoor1/47.JPG,char_data/7/47.JPG_2.jpg,308,576,768,11,340,351,476,504,True,9
7,25,kaist_dataset/Mixed/Digital_Camera/(C.S)C-outdoor1/48.JPG,char_data/7/48.JPG_4.jpg,325,576,768,13,253,266,341,366,True,9
7,25,kaist_dataset/Mixed/Digital_Camera/(C.S)C-outdoor1/48.JPG,char_data/7/48.JPG_5.jpg,375,576,768,15,400,415,340,365,True,9
7,39,kaist_dataset/Mixed/Digital_Camera/(C.S)C-outdoor1/51.JPG,char_data/7/51.JPG_2.jpg,1131,576,768,29,609,638,377,416,True,9
7,35,kaist_dataset/Mixed/Digital_Camera/(C.S)C-outdoor1/55.JPG,char_data/7/55.JPG_8.jpg,1015,576,768,29,378,407,368,403,True,9
7,36,kaist_dataset/Mixed/Digital_Camera/(C.S)C-outdoor1/55.JPG,char_data/7/55.JPG_9.jpg,864,576,768,24,408,432,367,403,True,9
7,34,kaist_dataset/Mixed/Digital_Camera/(C.S)C-outdoor1/55.JPG,char_data/7/55.JPG_10.jpg,952,576,768,28,433,461,368,402,True,9
7,34,kaist_dataset/Mixed/Digital_Camera/(C.S)C-outdoor1/55.JPG,char_data/7/55.JPG_11.jpg,1122,576,768,33,460,493,366,400,True,9
7,51,kaist_dataset/Mixed/Digital_Camera/(C.S)C-outdoor1/DSC02312.JPG,char_data/7/DSC02312.JPG_2.jpg,1734,480,640,34,246,280,216,267,True,9
7,33,kaist_dataset/Mixed/Digital_Camera/(C.S)C-outdoor1/DSC02325.JPG,char_data/7/DSC02325.JPG_2.jpg,759,480,640,23,389,412,310,343,True,9
7,38,kaist_dataset/Mixed/Digital_Camera/(C.S)C-outdoor1/DSC02344.JPG,char_data/7/DSC02344.JPG_2.jpg,532,480,640,14,586,600,256,294,True,9
7,38,kaist_dataset/Mixed/Digital_Camera/(C.S)C-outdoor1/P1010009.JPG,char_data/7/P1010009.JPG_5.jpg,1026,480,640,27,241,268,240,278,True,9
7,46,kaist_dataset/Mixed/Digital_Camera/(C.S)C-outdoor1/P1010010.JPG,char_data/7/P1010010.JPG_8.jpg,1564,480,640,34,258,292,214,260,True,9
7,37,kaist_dataset/Mixed/Digital_Camera/(C.S)C-outdoor1/P1010010.JPG,char_data/7/P1010010.JPG_9.jpg,1480,480,640,40,296,336,219,256,True,9
7,46,kaist_dataset/Mixed/Digital_Camera/(C.S)C-outdoor1/P1010010.JPG,char_data/7/P1010010.JPG_10.jpg,828,480,640,18,337,355,362,408,True,9
7,44,kaist_dataset/Mixed/Digital_Camera/(C.S)C-outdoor1/P1010010.JPG,char_data/7/P1010010.JPG_11.jpg,704,480,640,16,356,372,363,407,True,9
7,41,kaist_dataset/Mixed/Digital_Camera/(C.S)C-outdoor1/P1010011.JPG,char_data/7/P1010011.JPG_5.jpg,1025,480,640,25,515,540,309,350,True,9
7,50,kaist_dataset/Mixed/Digital_Camera/(C.S)C-outdoor1/P1010012.JPG,char_data/7/P1010012.JPG_2.jpg,1500,480,640,30,359,389,234,284,True,9
7,36,kaist_dataset/Mixed/Digital_Camera/(C.S)C-outdoor2/DSC02368.JPG,char_data/7/DSC02368.JPG_4.jpg,612,480,640,17,489,506,376,412,True,9
7,33,kaist_dataset/Mixed/Digital_Camera/(C.S)C-outdoor2/DSC02368.JPG,char_data/7/DSC02368.JPG_5.jpg,660,480,640,20,510,530,382,415,True,9
7,39,kaist_dataset/Mixed/Digital_Camera/(C.S)C-outdoor2/DSC02377.JPG,char_data/7/DSC02377.JPG_2.jpg,858,480,640,22,557,579,349,388,True,9
7,33,kaist_dataset/Mixed/Digital_Camera/(C.S)C-outdoor2/DSC02379.JPG,char_data/7/DSC02379.JPG_2.jpg,594,480,640,18,454,472,289,322,True,9
7,39,kaist_dataset/Mixed/Digital_Camera/(C.S)C-outdoor2/DSC02389.JPG,char_data/7/DSC02389.JPG_2.jpg,1209,480,640,31,387,418,36,75,True,9
7,35,kaist_dataset/Mixed/Digital_Camera/(C.S)C-outdoor2/DSC02397.JPG,char_data/7/DSC02397.JPG_2.jpg,665,480,640,19,494,513,205,240,True,9
7,38,kaist_dataset/Mixed/Digital_Camera/(C.S)C-outdoor2/DSC02422.JPG,char_data/7/DSC02422.JPG_2.jpg,646,480,640,17,195,212,221,259,True,9
7,35,kaist_dataset/Mixed/Digital_Camera/(C.S)C-outdoor2/DSC02460.JPG,char_data/7/DSC02460.JPG_2.jpg,665,480,640,19,341,360,302,337,True,9
7,24,kaist_dataset/Mixed/Digital_Camera/(C.S)C-outdoor2/DSC02477.JPG,char_data/7/DSC02477.JPG_4.jpg,600,480,640,25,374,399,246,270,True,9
7,29,kaist_dataset/Mixed/Digital_Camera/(C.S)C-outdoor2/DSC02477.JPG,char_data/7/DSC02477.JPG_5.jpg,783,480,640,27,444,471,243,272,True,9
7,31,kaist_dataset/Mixed/Digital_Camera/(C.S)C-outdoor2/DSC02479.JPG,char_data/7/DSC02479.JPG_2.jpg,496,480,640,16,542,558,221,252,True,9
7,39,kaist_dataset/Mixed/Digital_Camera/(C.S)C-outdoor2/DSC02482.JPG,char_data/7/DSC02482.JPG_4.jpg,1131,480,640,29,408,437,320,359,True,9
7,38,kaist_dataset/Mixed/Digital_Camera/(C.S)C-outdoor2/DSC02482.JPG,char_data/7/DSC02482.JPG_5.jpg,1292,480,640,34,451,485,324,362,True,9
7,36,kaist_dataset/Mixed/Digital_Camera/(C.S)C-outdoor2/DSC02511.JPG,char_data/7/DSC02511.JPG_2.jpg,684,480,640,19,336,355,212,248,True,9
7,26,kaist_dataset/Mixed/Digital_Camera/(C.S)C-outdoor2/DSC02555.JPG,char_data/7/DSC02555.JPG_4.jpg,676,480,640,26,416,442,249,275,True,9
7,23,kaist_dataset/Mixed/Digital_Camera/(C.S)C-outdoor2/DSC02555.JPG,char_data/7/DSC02555.JPG_5.jpg,667,480,640,29,487,516,253,276,True,9
7,30,kaist_dataset/Mixed/Digital_Camera/(C.S)C-outdoor2/DSC02556.JPG,char_data/7/DSC02556.JPG_4.jpg,690,480,640,23,379,402,343,373,True,9
7,30,kaist_dataset/Mixed/Digital_Camera/(C.S)C-outdoor2/DSC02556.JPG,char_data/7/DSC02556.JPG_5.jpg,840,480,640,28,402,430,347,377,True,9
7,35,kaist_dataset/Mixed/Digital_Camera/(C.S)C-outdoor2/DSC02887.JPG,char_data/7/DSC02887.JPG_2.jpg,700,480,640,20,283,303,119,154,True,9
7,38,kaist_dataset/Mixed/Digital_Camera/(C.S)C-outdoor2/DSC02894.JPG,char_data/7/DSC02894.JPG_2.jpg,1064,480,640,28,439,467,236,274,True,9
7,37,kaist_dataset/Mixed/Digital_Camera/(C.S)C-outdoor2/DSC02895.JPG,char_data/7/DSC02895.JPG_2.jpg,703,480,640,19,316,335,350,387,True,9
7,38,kaist_dataset/Mixed/Digital_Camera/(C.S)C-outdoor2/DSC02912.JPG,char_data/7/DSC02912.JPG_4.jpg,1254,480,640,33,237,270,438,476,True,9
7,36,kaist_dataset/Mixed/Digital_Camera/(C.S)C-outdoor2/DSC02912.JPG,char_data/7/DSC02912.JPG_5.jpg,1512,480,640,42,408,450,441,477,True,9
7,31,kaist_dataset/Mixed/Digital_Camera/(C.S)C-outdoor2/DSC02926.JPG,char_data/7/DSC02926.JPG_2.jpg,682,480,640,22,399,421,151,182,True,9
7,35,kaist_dataset/Mixed/Digital_Camera/(C.S)C-outdoor2/DSC02930.JPG,char_data/7/DSC02930.JPG_2.jpg,770,480,640,22,300,322,193,228,True,9
7,39,kaist_dataset/Mixed/Digital_Camera/(C.S)C-outdoor2/DSC02933.JPG,char_data/7/DSC02933.JPG_2.jpg,507,480,640,13,571,584,243,282,True,9
7,28,kaist_dataset/Mixed/Digital_Camera/(C.S)C-outdoor2/DSC02936.JPG,char_data/7/DSC02936.JPG_4.jpg,448,480,640,16,505,521,228,256,True,9
7,33,kaist_dataset/Mixed/Digital_Camera/(C.S)C-outdoor2/DSC02936.JPG,char_data/7/DSC02936.JPG_5.jpg,528,480,640,16,595,611,225,258,True,9
7,45,kaist_dataset/Mixed/Digital_Camera/(C.S)C-outdoor2/DSC02938.JPG,char_data/7/DSC02938.JPG_4.jpg,990,480,640,22,435,457,241,286,True,9
7,43,kaist_dataset/Mixed/Digital_Camera/(C.S)C-outdoor2/DSC02938.JPG,char_data/7/DSC02938.JPG_5.jpg,817,480,640,19,458,477,239,282,True,9
7,34,kaist_dataset/Mixed/Digital_Camera/(C.S)C-outdoor2/DSC02947.JPG,char_data/7/DSC02947.JPG_4.jpg,510,480,640,15,419,434,228,262,True,9
7,28,kaist_dataset/Mixed/Digital_Camera/(C.S)C-outdoor2/DSC02947.JPG,char_data/7/DSC02947.JPG_5.jpg,476,480,640,17,435,452,234,262,True,9
7,35,kaist_dataset/Mixed/Digital_Camera/(C.S)C-outdoor2/DSC02954.JPG,char_data/7/DSC02954.JPG_8.jpg,945,480,640,27,191,218,256,291,True,9
7,37,kaist_dataset/Mixed/Digital_Camera/(C.S)C-outdoor2/DSC02954.JPG,char_data/7/DSC02954.JPG_9.jpg,851,480,640,23,240,263,258,295,True,9
7,34,kaist_dataset/Mixed/Digital_Camera/(C.S)C-outdoor2/DSC02954.JPG,char_data/7/DSC02954.JPG_10.jpg,578,480,640,17,542,559,268,302,True,9
7,34,kaist_dataset/Mixed/Digital_Camera/(C.S)C-outdoor2/DSC02954.JPG,char_data/7/DSC02954.JPG_11.jpg,408,480,640,12,579,591,271,305,True,9
7,24,kaist_dataset/Mixed/Digital_Camera/(C.S)C-outdoor2/P1010015.JPG,char_data/7/P1010015.JPG_2.jpg,288,480,640,12,392,404,186,210,True,9
7,34,kaist_dataset/Mixed/Digital_Camera/(C.S)C-outdoor3/DSC02956.JPG,char_data/7/DSC02956.JPG_4.jpg,646,480,640,19,114,133,391,425,True,9
7,44,kaist_dataset/Mixed/Digital_Camera/(C.S)C-outdoor3/DSC02956.JPG,char_data/7/DSC02956.JPG_5.jpg,924,480,640,21,134,155,388,432,True,9
7,39,kaist_dataset/Mixed/Digital_Camera/(C.S)C-outdoor3/DSC02958.JPG,char_data/7/DSC02958.JPG_2.jpg,897,480,640,23,261,284,404,443,True,9
7,38,kaist_dataset/Mixed/Digital_Camera/(C.S)C-outdoor3/DSC02969.JPG,char_data/7/DSC02969.JPG_2.jpg,912,480,640,24,282,306,231,269,True,9
7,43,kaist_dataset/Mixed/Digital_Camera/(C.S)C-outdoor3/DSC02970.JPG,char_data/7/DSC02970.JPG_2.jpg,1247,480,640,29,171,200,361,404,True,9
7,30,kaist_dataset/Mixed/Digital_Camera/(C.S)C-outdoor3/DSC03017.JPG,char_data/7/DSC03017.JPG_4.jpg,450,480,640,15,390,405,242,272,True,9
7,35,kaist_dataset/Mixed/Digital_Camera/(C.S)C-outdoor3/DSC03017.JPG,char_data/7/DSC03017.JPG_5.jpg,560,480,640,16,434,450,243,278,True,9
7,45,kaist_dataset/Mixed/Digital_Camera/(C.S)C-outdoor3/DSC03061.JPG,char_data/7/DSC03061.JPG_8.jpg,585,480,640,13,322,335,248,293,True,9
7,41,kaist_dataset/Mixed/Digital_Camera/(C.S)C-outdoor3/DSC03061.JPG,char_data/7/DSC03061.JPG_9.jpg,820,480,640,20,348,368,252,293,True,9
7,39,kaist_dataset/Mixed/Digital_Camera/(C.S)C-outdoor3/DSC03061.JPG,char_data/7/DSC03061.JPG_10.jpg,663,480,640,17,367,384,251,290,True,9
7,47,kaist_dataset/Mixed/Digital_Camera/(C.S)C-outdoor3/DSC03061.JPG,char_data/7/DSC03061.JPG_11.jpg,611,480,640,13,384,397,248,295,True,9
7,49,kaist_dataset/Mixed/Digital_Camera/(C.S)C-outdoor3/DSC03189.JPG,char_data/7/DSC03189.JPG_2.jpg,1176,480,640,24,389,413,304,353,True,9
7,44,kaist_dataset/Mixed/Digital_Camera/(C.S)C-outdoor3/DSC03212.JPG,char_data/7/DSC03212.JPG_2.jpg,880,480,640,20,395,415,250,294,True,9
7,32,kaist_dataset/Mixed/Digital_Camera/(C.S)C-outdoor3/DSC03255.JPG,char_data/7/DSC03255.JPG_2.jpg,640,480,640,20,210,230,181,213,True,9
7,94,kaist_dataset/Mixed/Digital_Camera/(C.S)C-outdoor3/DSC03271.JPG,char_data/7/DSC03271.JPG_2.jpg,6956,480,640,74,253,327,340,434,True,9
7,68,kaist_dataset/Mixed/Digital_Camera/(C.S)C-outdoor3/DSC03284.JPG,char_data/7/DSC03284.JPG_2.jpg,4760,480,640,70,166,236,335,403,True,9
7,32,kaist_dataset/Mixed/Digital_Camera/(C.S)C-outdoor3/DSC03301.JPG,char_data/7/DSC03301.JPG_2.jpg,512,480,640,16,374,390,142,174,True,9
7,27,kaist_dataset/Mixed/Digital_Camera/(C.S)C-outdoor3/DSC03303.JPG,char_data/7/DSC03303.JPG_2.jpg,567,480,640,21,276,297,280,307,True,9
7,33,kaist_dataset/Mixed/Digital_Camera/(C.S)C-outdoor3/DSC03308.JPG,char_data/7/DSC03308.JPG_2.jpg,726,480,640,22,228,250,249,282,True,9
7,41,kaist_dataset/Mixed/Digital_Camera/(C.S)C-outdoor3/DSC03309.JPG,char_data/7/DSC03309.JPG_2.jpg,984,480,640,24,348,372,257,298,True,9
7,33,kaist_dataset/Mixed/Digital_Camera/(C.S)C-outdoor3/DSC03311.JPG,char_data/7/DSC03311.JPG_4.jpg,495,480,640,15,357,372,368,401,True,9
7,34,kaist_dataset/Mixed/Digital_Camera/(C.S)C-outdoor3/DSC03311.JPG,char_data/7/DSC03311.JPG_5.jpg,578,480,640,17,391,408,367,401,True,9
7,36,kaist_dataset/Mixed/Digital_Camera/(C.S)C-outdoor3/DSC03312.JPG,char_data/7/DSC03312.JPG_2.jpg,1260,480,640,35,153,188,284,320,True,9
7,27,kaist_dataset/Mixed/Digital_Camera/(C.S)C-outdoor3/DSC03315.JPG,char_data/7/DSC03315.JPG_6.jpg,486,480,640,18,361,379,124,151,True,9
7,25,kaist_dataset/Mixed/Digital_Camera/(C.S)C-outdoor3/DSC03315.JPG,char_data/7/DSC03315.JPG_7.jpg,475,480,640,19,412,431,124,149,True,9
7,29,kaist_dataset/Mixed/Digital_Camera/(C.S)C-outdoor3/DSC03315.JPG,char_data/7/DSC03315.JPG_8.jpg,522,480,640,18,431,449,121,150,True,9
7,34,kaist_dataset/Mixed/Digital_Camera/(C.S)C-outdoor3/DSC03316.JPG,char_data/7/DSC03316.JPG_4.jpg,510,480,640,15,293,308,85,119,True,9
7,33,kaist_dataset/Mixed/Digital_Camera/(C.S)C-outdoor3/DSC03316.JPG,char_data/7/DSC03316.JPG_5.jpg,462,480,640,14,454,468,83,116,True,9
7,44,kaist_dataset/Mixed/Digital_Camera/(C.S)C-outdoor3/DSC03323.JPG,char_data/7/DSC03323.JPG_2.jpg,1012,480,640,23,219,242,303,347,True,9
7,63,kaist_dataset/Mixed/Digital_Camera/(C.S)C-outdoor3/DSC03332.JPG,char_data/7/DSC03332.JPG_2.jpg,2142,480,640,34,114,148,339,402,True,9
7,37,kaist_dataset/Mixed/Digital_Camera/(C.S)C-outdoor4/DSC03435.JPG,char_data/7/DSC03435.JPG_2.jpg,740,480,640,20,189,209,409,446,True,9
7,95,kaist_dataset/Mixed/Digital_Camera/(C.S)C-outdoor4/DSC03544.JPG,char_data/7/DSC03544.JPG_2.jpg,3990,480,640,42,466,508,165,260,True,9
7,29,kaist_dataset/Mixed/Digital_Camera/(C.S)C-outdoor4/DSC03549.JPG,char_data/7/DSC03549.JPG_2.jpg,348,480,640,12,319,331,424,453,True,9
7,50,kaist_dataset/Mixed/Digital_Camera/(C.S)C-outdoor4/DSC03571.JPG,char_data/7/DSC03571.JPG_2.jpg,1100,480,640,22,319,341,302,352,True,9
7,48,kaist_dataset/Mixed/Digital_Camera/(C.S)C-outdoor4/DSC03613.JPG,char_data/7/DSC03613.JPG_2.jpg,1152,480,640,24,572,596,28,76,True,9
7,31,kaist_dataset/Mixed/Digital_Camera/(C.S)C-outdoor4/DSC03618.JPG,char_data/7/DSC03618.JPG_2.jpg,651,480,640,21,291,312,412,443,True,9
7,37,kaist_dataset/Mixed/Digital_Camera/(C.S)C-outdoor4/DSC03634.JPG,char_data/7/DSC03634.JPG_2.jpg,740,480,640,20,472,492,425,462,True,9
7,27,kaist_dataset/Mixed/Digital_Camera/(C.S)C-outdoor4/DSC03642.JPG,char_data/7/DSC03642.JPG_2.jpg,432,480,640,16,464,480,401,428,True,9
7,27,kaist_dataset/Mixed/Digital_Camera/(C.S)C-outdoor4/DSC03643.JPG,char_data/7/DSC03643.JPG_2.jpg,513,480,640,19,503,522,327,354,True,9
7,46,kaist_dataset/Mixed/Digital_Camera/(C.S)C-outdoor4/DSC03651.JPG,char_data/7/DSC03651.JPG_6.jpg,1472,480,640,32,332,364,358,404,True,9
7,48,kaist_dataset/Mixed/Digital_Camera/(C.S)C-outdoor4/DSC03651.JPG,char_data/7/DSC03651.JPG_7.jpg,1584,480,640,33,388,421,357,405,True,9
7,51,kaist_dataset/Mixed/Digital_Camera/(C.S)C-outdoor4/DSC03651.JPG,char_data/7/DSC03651.JPG_8.jpg,1836,480,640,36,421,457,354,405,True,9
7,85,kaist_dataset/Mixed/Digital_Camera/(C.S)C-outdoor4/DSC03654.JPG,char_data/7/DSC03654.JPG_4.jpg,2720,480,640,32,377,409,152,237,True,9
7,95,kaist_dataset/Mixed/Digital_Camera/(C.S)C-outdoor4/DSC03654.JPG,char_data/7/DSC03654.JPG_5.jpg,3705,480,640,39,408,447,145,240,True,9
7,55,kaist_dataset/Mixed/Digital_Camera/(C.S)C-outdoor4/DSC03655.JPG,char_data/7/DSC03655.JPG_8.jpg,1045,480,640,19,270,289,384,439,True,9
7,47,kaist_dataset/Mixed/Digital_Camera/(C.S)C-outdoor4/DSC03655.JPG,char_data/7/DSC03655.JPG_9.jpg,940,480,640,20,344,364,387,434,True,9
7,45,kaist_dataset/Mixed/Digital_Camera/(C.S)C-outdoor4/DSC03655.JPG,char_data/7/DSC03655.JPG_10.jpg,855,480,640,19,551,570,393,438,True,9
7,49,kaist_dataset/Mixed/Digital_Camera/(C.S)C-outdoor4/DSC03655.JPG,char_data/7/DSC03655.JPG_11.jpg,1029,480,640,21,571,592,389,438,True,9
7,35,kaist_dataset/Mixed/Digital_Camera/(C.S)C-outdoor4/DSC03656.JPG,char_data/7/DSC03656.JPG_4.jpg,1015,480,640,29,416,445,414,449,True,9
7,39,kaist_dataset/Mixed/Digital_Camera/(C.S)C-outdoor4/DSC03656.JPG,char_data/7/DSC03656.JPG_5.jpg,975,480,640,25,445,470,412,451,True,9
7,40,kaist_dataset/Mixed/Digital_Camera/(C.S)C-outdoor4/DSC03658.JPG,char_data/7/DSC03658.JPG_2.jpg,880,480,640,22,433,455,409,449,True,9
7,42,kaist_dataset/Mixed/Digital_Camera/(C.S)C-outdoor4/DSC03660.JPG,char_data/7/DSC03660.JPG_4.jpg,1218,480,640,29,331,360,93,135,True,9
7,37,kaist_dataset/Mixed/Digital_Camera/(C.S)C-outdoor4/DSC03660.JPG,char_data/7/DSC03660.JPG_5.jpg,888,480,640,24,431,455,91,128,True,9
7,34,kaist_dataset/Mixed/Digital_Camera/(C.S)C-outdoor4/DSC03661.JPG,char_data/7/DSC03661.JPG_4.jpg,578,480,640,17,430,447,331,365,True,9
7,38,kaist_dataset/Mixed/Digital_Camera/(C.S)C-outdoor4/DSC03661.JPG,char_data/7/DSC03661.JPG_5.jpg,570,480,640,15,462,477,329,367,True,9
7,50,kaist_dataset/Mixed/Digital_Camera/(C.S)C-outdoor4/DSC03662.JPG,char_data/7/DSC03662.JPG_2.jpg,1050,480,640,21,559,580,413,463,True,9
7,42,kaist_dataset/Mixed/Digital_Camera/(C.S)C-outdoor4/DSC03665.JPG,char_data/7/DSC03665.JPG_4.jpg,1428,480,640,34,316,350,152,194,True,9
7,38,kaist_dataset/Mixed/Digital_Camera/(C.S)C-outdoor4/DSC03665.JPG,char_data/7/DSC03665.JPG_5.jpg,1368,480,640,36,408,444,155,193,True,9
7,24,kaist_dataset/Mixed/Digital_Camera/(C.S)C-outdoor4/DSC03670.JPG,char_data/7/DSC03670.JPG_2.jpg,312,480,640,13,498,511,449,473,True,9
7,32,kaist_dataset/Mixed/Digital_Camera/(C.S)C-outdoor4/DSC03673.JPG,char_data/7/DSC03673.JPG_2.jpg,768,480,640,24,261,285,309,341,True,9
7,30,kaist_dataset/Mixed/Digital_Camera/(C.S)C-outdoor4/DSC03677.JPG,char_data/7/DSC03677.JPG_2.jpg,360,480,640,12,518,530,316,346,True,9
7,40,kaist_dataset/Mixed/Digital_Camera/(C.S)C-outdoor4/DSC03679.JPG,char_data/7/DSC03679.JPG_2.jpg,1080,480,640,27,260,287,277,317,True,9
7,29,kaist_dataset/Mixed/Digital_Camera/(C.S)C-outdoor4/DSC03687.JPG,char_data/7/DSC03687.JPG_2.jpg,348,480,640,12,446,458,396,425,True,9
7,27,kaist_dataset/Mixed/Digital_Camera/(C.S)C-outdoor4/DSC03689.JPG,char_data/7/DSC03689.JPG_2.jpg,297,480,640,11,551,562,130,157,True,9
7,33,kaist_dataset/Mixed/Digital_Camera/(C.S)C-outdoor4/DSC03691.JPG,char_data/7/DSC03691.JPG_2.jpg,396,480,640,12,616,628,218,251,True,9
7,35,kaist_dataset/Mixed/Digital_Camera/(C.S)C-outdoor4/DSC03718.JPG,char_data/7/DSC03718.JPG_2.jpg,840,480,640,24,568,592,400,435,True,9
7,36,kaist_dataset/Mixed/Digital_Camera/(C.S)C-outdoor4/DSC03719.JPG,char_data/7/DSC03719.JPG_2.jpg,612,480,640,17,575,592,178,214,True,9
7,35,kaist_dataset/Mixed/Digital_Camera/(C.S)C-outdoor4/DSC03722.JPG,char_data/7/DSC03722.JPG_2.jpg,945,480,640,27,271,298,203,238,True,9
7,40,kaist_dataset/Mixed/Digital_Camera/(C.S)C-outdoor4/DSC03724.JPG,char_data/7/DSC03724.JPG_6.jpg,840,480,640,21,379,400,281,321,True,9
7,43,kaist_dataset/Mixed/Digital_Camera/(C.S)C-outdoor4/DSC03724.JPG,char_data/7/DSC03724.JPG_7.jpg,1075,480,640,25,452,477,278,321,True,9
7,43,kaist_dataset/Mixed/Digital_Camera/(C.S)C-outdoor4/DSC03724.JPG,char_data/7/DSC03724.JPG_8.jpg,1118,480,640,26,478,504,275,318,True,9
7,29,kaist_dataset/Mixed/Digital_Camera/(C.S)C-outdoor4/DSC03733.JPG,char_data/7/DSC03733.JPG_2.jpg,435,480,640,15,516,531,176,205,True,9
7,29,kaist_dataset/Mixed/Digital_Camera/(C.S)C-outdoor4/DSC03734.JPG,char_data/7/DSC03734.JPG_2.jpg,406,480,640,14,586,600,350,379,True,9
7,53,kaist_dataset/Mixed/Digital_Camera/(C.S)C-outdoor4/DSC03738.JPG,char_data/7/DSC03738.JPG_4.jpg,1749,480,640,33,338,371,233,286,True,9
7,45,kaist_dataset/Mixed/Digital_Camera/(C.S)C-outdoor4/DSC03738.JPG,char_data/7/DSC03738.JPG_5.jpg,1530,480,640,34,430,464,238,283,True,9
7,36,kaist_dataset/Mixed/Digital_Camera/(C.S)C-outdoor4/DSC03741.JPG,char_data/7/DSC03741.JPG_2.jpg,1188,480,640,33,369,402,364,400,True,9
7,31,kaist_dataset/Mixed/Digital_Camera/(C.S)C-outdoor4/DSC03757.JPG,char_data/7/DSC03757.JPG_6.jpg,434,480,640,14,241,255,337,368,True,9
7,30,kaist_dataset/Mixed/Digital_Camera/(C.S)C-outdoor4/DSC03757.JPG,char_data/7/DSC03757.JPG_7.jpg,390,480,640,13,378,391,339,369,True,9
7,27,kaist_dataset/Mixed/Digital_Camera/(C.S)C-outdoor4/DSC03757.JPG,char_data/7/DSC03757.JPG_8.jpg,297,480,640,11,402,413,340,367,True,9
7,24,kaist_dataset/Mixed/Digital_Camera/(C.S)C-outdoor4/DSC03758.JPG,char_data/7/DSC03758.JPG_2.jpg,408,480,640,17,321,338,307,331,True,9
7,31,kaist_dataset/Mixed/Digital_Camera/(C.S)C-outdoor4/DSC03764.JPG,char_data/7/DSC03764.JPG_2.jpg,651,480,640,21,290,311,269,300,True,9
7,30,kaist_dataset/Mixed/Digital_Camera/(C.S)C-outdoor4/DSC03769.JPG,char_data/7/DSC03769.JPG_2.jpg,330,480,640,11,193,204,416,446,True,9
7,43,kaist_dataset/Mixed/Digital_Camera/(C.S)C-outdoor4/DSC03781.JPG,char_data/7/DSC03781.JPG_2.jpg,1290,480,640,30,231,261,375,418,True,9
7,92,kaist_dataset/Mixed/Digital_Camera/(C.S)C-outdoor4/DSC03787.JPG,char_data/7/DSC03787.JPG_4.jpg,2576,480,640,28,396,424,138,230,True,9
7,88,kaist_dataset/Mixed/Digital_Camera/(C.S)C-outdoor4/DSC03787.JPG,char_data/7/DSC03787.JPG_5.jpg,2992,480,640,34,422,456,136,224,True,9
7,45,kaist_dataset/Mixed/Digital_Camera/(C.S)C-outdoor5/DSC03821.JPG,char_data/7/DSC03821.JPG_2.jpg,1260,480,640,28,354,382,77,122,True,9
7,64,kaist_dataset/Mixed/Digital_Camera/(C.S)C-outdoor5/DSC03837.JPG,char_data/7/DSC03837.JPG_2.jpg,2368,480,640,37,258,295,304,368,True,9
7,40,kaist_dataset/Mixed/Digital_Camera/(C.S)C-outdoor5/DSC03842.JPG,char_data/7/DSC03842.JPG_2.jpg,800,480,640,20,246,266,228,268,True,9
7,82,kaist_dataset/Mixed/Digital_Camera/(C.S)C-outdoor5/DSC04016.JPG,char_data/7/DSC04016.JPG_2.jpg,4100,480,640,50,347,397,106,188,True,9
7,54,kaist_dataset/Mixed/Digital_Camera/(C.S)C-outdoor5/DSC04017.JPG,char_data/7/DSC04017.JPG_4.jpg,1998,480,640,37,273,310,424,478,True,9
7,51,kaist_dataset/Mixed/Digital_Camera/(C.S)C-outdoor5/DSC04017.JPG,char_data/7/DSC04017.JPG_5.jpg,2295,480,640,45,333,378,425,476,True,9
7,23,kaist_dataset/Mixed/Digital_Camera/(C.S)C-outdoor5/DSC04031.JPG,char_data/7/DSC04031.JPG_10.jpg,253,480,640,11,499,510,382,405,True,9
7,23,kaist_dataset/Mixed/Digital_Camera/(C.S)C-outdoor5/DSC04031.JPG,char_data/7/DSC04031.JPG_11.jpg,207,480,640,9,521,530,380,403,True,9
7,25,kaist_dataset/Mixed/Digital_Camera/(C.S)C-outdoor5/DSC04031.JPG,char_data/7/DSC04031.JPG_12.jpg,300,480,640,12,532,544,380,405,True,9
7,24,kaist_dataset/Mixed/Digital_Camera/(C.S)C-outdoor5/DSC04031.JPG,char_data/7/DSC04031.JPG_13.jpg,264,480,640,11,197,208,380,404,True,9
7,24,kaist_dataset/Mixed/Digital_Camera/(C.S)C-outdoor5/DSC04031.JPG,char_data/7/DSC04031.JPG_14.jpg,240,480,640,10,221,231,381,405,True,9
7,55,kaist_dataset/Mixed/Digital_Camera/(C.S)C-outdoor5/DSC04033.JPG,char_data/7/DSC04033.JPG_4.jpg,2310,480,640,42,181,223,281,336,True,9
7,58,kaist_dataset/Mixed/Digital_Camera/(C.S)C-outdoor5/DSC04033.JPG,char_data/7/DSC04033.JPG_5.jpg,2146,480,640,37,302,339,272,330,True,9
7,35,kaist_dataset/Mixed/Digital_Camera/(C.S)C-outdoor5/DSC04048.JPG,char_data/7/DSC04048.JPG_2.jpg,700,480,640,20,312,332,166,201,True,9
7,88,kaist_dataset/Mixed/Digital_Camera/(C.S)C-outdoor5/DSC04054.JPG,char_data/7/DSC04054.JPG_2.jpg,7392,480,640,84,260,344,64,152,True,9
7,39,kaist_dataset/Mixed/Digital_Camera/(C.S)C-outdoor5/DSC04055.JPG,char_data/7/DSC04055.JPG_2.jpg,1443,480,640,37,70,107,369,408,True,9
7,37,kaist_dataset/Mixed/Digital_Camera/(C.S)C-outdoor5/DSC04056.JPG,char_data/7/DSC04056.JPG_2.jpg,851,480,640,23,546,569,258,295,True,9
7,33,kaist_dataset/Mixed/Digital_Camera/(C.S)C-outdoor5/DSC04061.JPG,char_data/7/DSC04061.JPG_4.jpg,495,480,640,15,509,524,146,179,True,9
7,37,kaist_dataset/Mixed/Digital_Camera/(C.S)C-outdoor5/DSC04061.JPG,char_data/7/DSC04061.JPG_5.jpg,592,480,640,16,564,580,141,178,False,9
7,41,kaist_dataset/Mixed/Digital_Camera/(C.S)C-outdoor5/DSC04071.JPG,char_data/7/DSC04071.JPG_2.jpg,820,480,640,20,125,145,361,402,False,9
7,29,kaist_dataset/Mixed/Digital_Camera/(C.S)C-outdoor5/DSC04072.JPG,char_data/7/DSC04072.JPG_10.jpg,377,480,640,13,459,472,350,379,False,9
7,30,kaist_dataset/Mixed/Digital_Camera/(C.S)C-outdoor5/DSC04072.JPG,char_data/7/DSC04072.JPG_11.jpg,390,480,640,13,503,516,350,380,False,9
7,37,kaist_dataset/Mixed/Digital_Camera/(C.S)C-outdoor5/DSC04072.JPG,char_data/7/DSC04072.JPG_12.jpg,407,480,640,11,516,527,344,381,False,9
7,29,kaist_dataset/Mixed/Digital_Camera/(C.S)C-outdoor5/DSC04072.JPG,char_data/7/DSC04072.JPG_13.jpg,406,480,640,14,570,584,351,380,False,9
7,32,kaist_dataset/Mixed/Digital_Camera/(C.S)C-outdoor5/DSC04072.JPG,char_data/7/DSC04072.JPG_14.jpg,384,480,640,12,594,606,349,381,False,9
7,68,kaist_dataset/Mixed/Digital_Camera/(C.S)C-outdoor5/DSC04108.JPG,char_data/7/DSC04108.JPG_6.jpg,2312,480,640,34,388,422,238,306,False,9
7,66,kaist_dataset/Mixed/Digital_Camera/(C.S)C-outdoor5/DSC04108.JPG,char_data/7/DSC04108.JPG_7.jpg,2574,480,640,39,447,486,236,302,False,9
7,67,kaist_dataset/Mixed/Digital_Camera/(C.S)C-outdoor5/DSC04108.JPG,char_data/7/DSC04108.JPG_8.jpg,2412,480,640,36,486,522,234,301,False,9
7,36,kaist_dataset/Mixed/Digital_Camera/(C.S)C-outdoor5/DSC04115.JPG,char_data/7/DSC04115.JPG_2.jpg,936,480,640,26,460,486,356,392,False,9
7,41,kaist_dataset/Mixed/Digital_Camera/(C.S)C-outdoor5/DSC04122.JPG,char_data/7/DSC04122.JPG_2.jpg,656,480,640,16,397,413,410,451,False,9
7,46,kaist_dataset/Mixed/Digital_Camera/(C.S)C-outdoor5/DSC04135.JPG,char_data/7/DSC04135.JPG_2.jpg,1150,480,640,25,424,449,384,430,False,9
7,42,kaist_dataset/Mixed/Digital_Camera/(C.S)C-outdoor5/DSC04139.JPG,char_data/7/DSC04139.JPG_2.jpg,882,480,640,21,387,408,399,441,False,9
7,39,kaist_dataset/Mixed/Digital_Camera/(C.S)C-outdoor5/DSC04140.JPG,char_data/7/DSC04140.JPG_2.jpg,468,480,640,12,564,576,341,380,False,9
7,38,kaist_dataset/Mixed/Digital_Camera/(C.S)C-outdoor5/DSC04144.JPG,char_data/7/DSC04144.JPG_2.jpg,836,480,640,22,325,347,417,455,False,9
7,29,kaist_dataset/Mixed/Digital_Camera/(C.S)C-outdoor5/DSC04146.JPG,char_data/7/DSC04146.JPG_2.jpg,580,480,640,20,286,306,406,435,False,9
7,25,kaist_dataset/Mixed/Digital_Camera/(C.S)C-outdoor5/DSC04150.JPG,char_data/7/DSC04150.JPG_2.jpg,325,480,640,13,503,516,364,389,False,9
7,26,kaist_dataset/Mixed/Digital_Camera/(C.S)C-outdoor5/DSC04151.JPG,char_data/7/DSC04151.JPG_2.jpg,390,480,640,15,470,485,346,372,False,9
7,35,kaist_dataset/Mixed/Digital_Camera/(C.S)C-outdoor5/DSC04155.JPG,char_data/7/DSC04155.JPG_2.jpg,595,480,640,17,510,527,260,295,False,9
7,60,kaist_dataset/Mixed/Digital_Camera/(C.S)C-outdoor5/DSC04364.JPG,char_data/7/DSC04364.JPG_2.jpg,2100,480,640,35,292,327,397,457,False,9
7,44,kaist_dataset/Mixed/Digital_Camera/(C.S)C-outdoor5/DSC04395.JPG,char_data/7/DSC04395.JPG_2.jpg,1100,480,640,25,153,178,289,333,False,9
7,123,kaist_dataset/Mixed/Digital_Camera/(C.S)C-outdoor5/DSC04449.JPG,char_data/7/DSC04449.JPG_2.jpg,9348,480,640,76,345,421,34,157,False,9
7,40,kaist_dataset/Mixed/Digital_Camera/(C.S)C-outdoor5/P1010002.JPG,char_data/7/P1010002.JPG_2.jpg,880,480,640,22,599,621,278,318,False,9
7,23,kaist_dataset/Mixed/Digital_Camera/(C.S)C-outdoor5/P1010004.JPG,char_data/7/P1010004.JPG_6.jpg,322,480,640,14,294,308,311,334,False,9
7,35,kaist_dataset/Mixed/Digital_Camera/(C.S)C-outdoor5/P1010004.JPG,char_data/7/P1010004.JPG_7.jpg,490,480,640,14,346,360,305,340,False,9
7,27,kaist_dataset/Mixed/Digital_Camera/(C.S)C-outdoor5/P1010004.JPG,char_data/7/P1010004.JPG_8.jpg,486,480,640,18,368,386,311,338,False,9
7,147,kaist_dataset/Mixed/Digital_Camera/(C.S)C-outdoor5/P1010006.JPG,char_data/7/P1010006.JPG_2.jpg,15288,480,640,104,105,209,168,315,False,9
7,62,kaist_dataset/Mixed/Digital_Camera/(C.S)C-outdoor6/P1010017.JPG,char_data/7/P1010017.JPG_2.jpg,1488,480,640,24,419,443,181,243,False,9
7,38,kaist_dataset/Mixed/Digital_Camera/(C.S)C-outdoor6/P1010018.JPG,char_data/7/P1010018.JPG_4.jpg,722,480,640,19,277,296,239,277,False,9
7,34,kaist_dataset/Mixed/Digital_Camera/(C.S)C-outdoor6/P1010018.JPG,char_data/7/P1010018.JPG_5.jpg,578,480,640,17,517,534,244,278,False,9
7,31,kaist_dataset/Mixed/Digital_Camera/(C.S)C-outdoor6/P1010020.JPG,char_data/7/P1010020.JPG_6.jpg,527,480,640,17,155,172,336,367,False,9
7,31,kaist_dataset/Mixed/Digital_Camera/(C.S)C-outdoor6/P1010020.JPG,char_data/7/P1010020.JPG_7.jpg,713,480,640,23,121,144,231,262,False,9
7,31,kaist_dataset/Mixed/Digital_Camera/(C.S)C-outdoor6/P1010020.JPG,char_data/7/P1010020.JPG_8.jpg,775,480,640,25,239,264,233,264,False,9
7,37,kaist_dataset/Mixed/Digital_Camera/(C.S)C-outdoor6/P1010056.JPG,char_data/7/P1010056.JPG_2.jpg,481,480,640,13,321,334,227,264,False,9
7,24,kaist_dataset/Mixed/Digital_Camera/(C.S)C-outdoor6/P1010065.JPG,char_data/7/P1010065.JPG_2.jpg,480,480,640,20,347,367,236,260,False,9
7,69,kaist_dataset/Mixed/Digital_Camera/(C.S)C-outdoor6/P1010067.JPG,char_data/7/P1010067.JPG_5.jpg,2277,480,640,33,553,586,298,367,False,9
7,31,kaist_dataset/Mixed/Digital_Camera/(C.S)C-outdoor6/P1010073.JPG,char_data/7/P1010073.JPG_4.jpg,341,480,640,11,399,410,241,272,False,9
7,30,kaist_dataset/Mixed/Digital_Camera/(C.S)C-outdoor6/P1010073.JPG,char_data/7/P1010073.JPG_5.jpg,420,480,640,14,410,424,243,273,False,9
7,43,kaist_dataset/Mixed/Digital_Camera/(C.S)C-outdoor6/P1010074.JPG,char_data/7/P1010074.JPG_2.jpg,2064,480,640,48,302,350,301,344,False,9
7,53,kaist_dataset/Mixed/Digital_Camera/(C.S)C-outdoor6/P1010084.JPG,char_data/7/P1010084.JPG_2.jpg,1908,480,640,36,339,375,186,239,False,9
7,23,kaist_dataset/Mixed/Digital_Camera/(C.S)C-outdoor6/P1010085.JPG,char_data/7/P1010085.JPG_8.jpg,276,480,640,12,382,394,155,178,False,9
7,27,kaist_dataset/Mixed/Digital_Camera/(C.S)C-outdoor6/P1010093.JPG,char_data/7/P1010093.JPG_2.jpg,405,480,640,15,584,599,248,275,False,9
7,29,kaist_dataset/Mixed/Digital_Camera/(C.S)C-outdoor6/P1010103.JPG,char_data/7/P1010103.JPG_2.jpg,493,480,640,17,477,494,203,232,False,9
7,41,kaist_dataset/Mixed/Digital_Camera/(C.S)C-outdoor6/P1010111.JPG,char_data/7/P1010111.JPG_4.jpg,1435,480,640,35,288,323,204,245,False,9
7,37,kaist_dataset/Mixed/Digital_Camera/(C.S)C-outdoor6/P1010111.JPG,char_data/7/P1010111.JPG_5.jpg,1295,480,640,35,387,422,207,244,False,9
7,37,kaist_dataset/Mixed/Digital_Camera/(C.S)C-outdoor6/P1010120.JPG,char_data/7/P1010120.JPG_2.jpg,1073,480,640,29,350,379,192,229,False,9
7,34,kaist_dataset/Mixed/Digital_Camera/(C.S)C-outdoor6/P1010137.JPG,char_data/7/P1010137.JPG_2.jpg,850,480,640,25,46,71,72,106,False,9
7,28,kaist_dataset/Mixed/Digital_Camera/(C.S)C-outdoor6/P1010138.JPG,char_data/7/P1010138.JPG_5.jpg,728,480,640,26,401,427,183,211,False,9
7,33,kaist_dataset/Mixed/Digital_Camera/(C.S)C-outdoor6/크기변환_fadscf0009_creawell.jpg,char_data/7/크기변환_fadscf0009_creawell.jpg_2.jpg,429,480,640,13,368,381,161,194,False,9
7,40,kaist_dataset/Mixed/Digital_Camera/(C.S)D-indoor1/DSC02746.JPG,char_data/7/DSC02746.JPG_2.jpg,1440,480,640,36,62,98,297,337,False,9
7,44,kaist_dataset/Mixed/Digital_Camera/(C.S)D-indoor1/DSC02747.JPG,char_data/7/DSC02747.JPG_2.jpg,1672,480,640,38,8,46,332,376,False,9
7,46,kaist_dataset/Mixed/Digital_Camera/(C.S)D-indoor1/DSC02748.JPG,char_data/7/DSC02748.JPG_2.jpg,1610,480,640,35,35,70,340,386,False,9
7,38,kaist_dataset/Mixed/Digital_Camera/(C.S)D-indoor1/DSC02749.JPG,char_data/7/DSC02749.JPG_2.jpg,1102,480,640,29,63,92,368,406,False,9
7,33,kaist_dataset/Mixed/Digital_Camera/(C.S)D-indoor1/DSC02750.JPG,char_data/7/DSC02750.JPG_2.jpg,1089,480,640,33,49,82,273,306,False,9
7,45,kaist_dataset/Mixed/Digital_Camera/(C.S)D-indoor1/DSC02751.JPG,char_data/7/DSC02751.JPG_2.jpg,1530,480,640,34,52,86,254,299,False,9
7,40,kaist_dataset/Mixed/Digital_Camera/(C.S)D-indoor1/DSC02752.JPG,char_data/7/DSC02752.JPG_2.jpg,1720,480,640,43,15,58,251,291,False,9
7,43,kaist_dataset/Mixed/Digital_Camera/(C.S)D-indoor1/DSC02755.JPG,char_data/7/DSC02755.JPG_2.jpg,1634,480,640,38,29,67,254,297,False,9
7,82,kaist_dataset/Mixed/Digital_Camera/(C.S)D-indoor1/DSC03909.JPG,char_data/7/DSC03909.JPG_8.jpg,2952,480,640,36,1,37,99,181,False,9
7,82,kaist_dataset/Mixed/Digital_Camera/(C.S)D-indoor1/DSC03909.JPG,char_data/7/DSC03909.JPG_9.jpg,3444,480,640,42,78,120,96,178,False,9
7,49,kaist_dataset/Mixed/Digital_Camera/(C.S)D-indoor1/DSC03909.JPG,char_data/7/DSC03909.JPG_10.jpg,1176,480,640,24,412,436,298,347,False,9
7,47,kaist_dataset/Mixed/Digital_Camera/(C.S)D-indoor1/DSC03909.JPG,char_data/7/DSC03909.JPG_11.jpg,940,480,640,20,454,474,295,342,False,9
7,48,kaist_dataset/Mixed/Digital_Camera/(C.S)D-indoor1/DSC03986.JPG,char_data/7/DSC03986.JPG_2.jpg,768,480,640,16,97,113,159,207,False,9
7,84,kaist_dataset/Mixed/Digital_Camera/(C.S)D-indoor1/DSC03998.JPG,char_data/7/DSC03998.JPG_2.jpg,3276,480,640,39,578,617,414,479,False,9
7,89,kaist_dataset/Mixed/Digital_Camera/(C.S)D-indoor1/DSC04002.JPG,char_data/7/DSC04002.JPG_2.jpg,3916,480,640,44,502,546,349,438,False,9
7,26,kaist_dataset/Mixed/Digital_Camera/(C.S)D-indoor1/DSC04005.JPG,char_data/7/DSC04005.JPG_2.jpg,494,480,640,19,278,297,442,468,False,9
7,38,kaist_dataset/Mixed/Digital_Camera/(C.S)D-indoor2/DSC04256.JPG,char_data/7/DSC04256.JPG_4.jpg,874,480,640,23,452,475,146,184,False,9
7,37,kaist_dataset/Mixed/Digital_Camera/(C.S)D-indoor2/DSC04256.JPG,char_data/7/DSC04256.JPG_5.jpg,740,480,640,20,528,548,152,189,False,9
7,41,kaist_dataset/Mixed/Digital_Camera/(C.S)E-night/DSC02569.JPG,char_data/7/DSC02569.JPG_2.jpg,656,480,640,16,439,455,407,448,False,9
7,54,kaist_dataset/Mixed/Digital_Camera/(C.S)E-night/DSC02573.JPG,char_data/7/DSC02573.JPG_2.jpg,2214,480,640,41,443,484,161,215,False,9
7,33,kaist_dataset/Mixed/Digital_Camera/(C.S)E-night/DSC02586.JPG,char_data/7/DSC02586.JPG_8.jpg,462,480,640,14,339,353,395,428,False,9
7,33,kaist_dataset/Mixed/Digital_Camera/(C.S)E-night/DSC02586.JPG,char_data/7/DSC02586.JPG_9.jpg,495,480,640,15,365,380,392,425,False,9
7,34,kaist_dataset/Mixed/Digital_Camera/(C.S)E-night/DSC02586.JPG,char_data/7/DSC02586.JPG_10.jpg,408,480,640,12,396,408,391,425,False,9
7,29,kaist_dataset/Mixed/Digital_Camera/(C.S)E-night/DSC02586.JPG,char_data/7/DSC02586.JPG_11.jpg,580,480,640,20,408,428,391,420,False,9
7,56,kaist_dataset/Mixed/Digital_Camera/(C.S)E-night/DSC02595.JPG,char_data/7/DSC02595.JPG_2.jpg,2296,480,640,41,484,525,341,397,False,9
7,32,kaist_dataset/Mixed/Digital_Camera/(C.S)E-night/DSC02623.JPG,char_data/7/DSC02623.JPG_2.jpg,480,480,640,15,147,162,399,431,False,9
7,38,kaist_dataset/Mixed/Digital_Camera/(C.S)E-night/DSC02647.JPG,char_data/7/DSC02647.JPG_4.jpg,988,480,640,26,302,328,276,314,False,9
7,38,kaist_dataset/Mixed/Digital_Camera/(C.S)E-night/DSC02647.JPG,char_data/7/DSC02647.JPG_5.jpg,798,480,640,21,356,377,269,307,False,9
7,30,kaist_dataset/Mixed/Digital_Camera/(C.S)E-night/DSC02660.JPG,char_data/7/DSC02660.JPG_2.jpg,600,480,640,20,260,280,420,450,False,9
7,37,kaist_dataset/Mixed/Digital_Camera/(C.S)E-night/DSC02673.JPG,char_data/7/DSC02673.JPG_4.jpg,481,480,640,13,338,351,304,341,False,9
7,39,kaist_dataset/Mixed/Digital_Camera/(C.S)E-night/DSC02673.JPG,char_data/7/DSC02673.JPG_5.jpg,585,480,640,15,366,381,300,339,False,9
7,47,kaist_dataset/Mixed/Digital_Camera/(C.S)E-night/DSC03561.JPG,char_data/7/DSC03561.JPG_4.jpg,1739,480,640,37,361,398,251,298,False,9
7,51,kaist_dataset/Mixed/Digital_Camera/(C.S)E-night/DSC03561.JPG,char_data/7/DSC03561.JPG_5.jpg,1938,480,640,38,434,472,248,299,False,9
7,32,kaist_dataset/Mixed/Digital_Camera/(C.S)E-night/DSC03840.JPG,char_data/7/DSC03840.JPG_4.jpg,416,480,640,13,520,533,208,240,False,9
7,33,kaist_dataset/Mixed/Digital_Camera/(C.S)E-night/DSC03840.JPG,char_data/7/DSC03840.JPG_5.jpg,561,480,640,17,534,551,212,245,False,9
7,78,kaist_dataset/Mixed/Digital_Camera/(C.S)E-night/P1010151.JPG,char_data/7/P1010151.JPG_2.jpg,4212,480,640,54,222,276,350,428,False,9
7,74,kaist_dataset/Mixed/Digital_Camera/(C.S)E-night/P1010152.JPG,char_data/7/P1010152.JPG_2.jpg,3700,480,640,50,244,294,222,296,False,9
7,21,kaist_dataset/Mixed/Digital_Camera/(C.S)E-night/P1010155.JPG,char_data/7/P1010155.JPG_2.jpg,252,480,640,12,452,464,286,307,False,9
7,31,kaist_dataset/Mixed/Digital_Camera/(C.S)F-others/2007-12-08-day-044.jpg,char_data/7/2007-12-08-day-044.jpg_4.jpg,527,1200,1600,17,1103,1120,836,867,False,9
7,49,kaist_dataset/Mixed/Digital_Camera/(C.S)F-others/2007-12-08-day-044.jpg,char_data/7/2007-12-08-day-044.jpg_5.jpg,1078,1200,1600,22,47,69,727,776,False,9
7,77,kaist_dataset/Mixed/Digital_Camera/(C.S)F-others/2007-12-08-day-067.jpg,char_data/7/2007-12-08-day-067.jpg_2.jpg,5005,1600,1200,65,1016,1081,1,78,False,9
7,38,kaist_dataset/Mixed/Digital_Camera/(C.S)F-others/DSC02803.JPG,char_data/7/DSC02803.JPG_2.jpg,836,480,640,22,147,169,355,393,False,9
7,82,kaist_dataset/Mixed/Digital_Camera/(C.S)F-others/DSC03224.JPG,char_data/7/DSC03224.JPG_2.jpg,4756,480,640,58,426,484,195,277,False,9
7,31,kaist_dataset/Mixed/Mobile_Phone/(C.M)A-outdoor/P090908006.jpg,char_data/7/P090908006.jpg_2.jpg,744,480,640,24,406,430,367,398,False,9
7,32,kaist_dataset/Mixed/Mobile_Phone/(C.M)A-outdoor/P090912036.jpg,char_data/7/P090912036.jpg_6.jpg,480,480,640,15,174,189,189,221,False,9
7,29,kaist_dataset/Mixed/Mobile_Phone/(C.M)A-outdoor/P090912036.jpg,char_data/7/P090912036.jpg_7.jpg,522,480,640,18,255,273,190,219,False,9
7,34,kaist_dataset/Mixed/Mobile_Phone/(C.M)A-outdoor/P090912036.jpg,char_data/7/P090912036.jpg_8.jpg,782,480,640,23,453,476,190,224,False,9
7,41,kaist_dataset/Mixed/Mobile_Phone/(C.M)A-outdoor/P090912047.jpg,char_data/7/P090912047.jpg_2.jpg,779,480,640,19,312,331,276,317,False,9
7,71,kaist_dataset/Mixed/Mobile_Phone/(C.M)A-outdoor/P090912078.jpg,char_data/7/P090912078.jpg_4.jpg,4331,480,640,61,558,619,209,280,False,9
7,41,kaist_dataset/Mixed/Mobile_Phone/(C.M)A-outdoor/P090912078.jpg,char_data/7/P090912078.jpg_5.jpg,1558,480,640,38,576,614,281,322,False,9
7,41,kaist_dataset/Mixed/Mobile_Phone/(C.M)C-bookCover/P090902016.jpg,char_data/7/P090902016.jpg_2.jpg,1189,480,640,29,374,403,270,311,False,9
a,67,kaist_dataset/English/Digital_Camera/(E.S)A-shadow/DSC02857.JPG,char_data/a/DSC02857.JPG_4.jpg,2747,480,640,41,138,179,210,277,True,31
a,69,kaist_dataset/English/Digital_Camera/(E.S)A-shadow/DSC02857.JPG,char_data/a/DSC02857.JPG_5.jpg,3105,480,640,45,448,493,211,280,True,31
a,77,kaist_dataset/English/Digital_Camera/(E.S)A-shadow/DSC02858.JPG,char_data/a/DSC02858.JPG_4.jpg,3773,480,640,49,62,111,311,388,True,31
a,77,kaist_dataset/English/Digital_Camera/(E.S)A-shadow/DSC02858.JPG,char_data/a/DSC02858.JPG_5.jpg,3773,480,640,49,417,466,319,396,True,31
a,53,kaist_dataset/English/Digital_Camera/(E.S)A-shadow/DSC03026.JPG,char_data/a/DSC03026.JPG_4.jpg,2279,480,640,43,130,173,163,216,True,31
a,47,kaist_dataset/English/Digital_Camera/(E.S)A-shadow/DSC03026.JPG,char_data/a/DSC03026.JPG_5.jpg,1927,480,640,41,274,315,164,211,True,31
a,43,kaist_dataset/English/Digital_Camera/(E.S)A-shadow/DSC03075.JPG,char_data/a/DSC03075.JPG_2.jpg,989,480,640,23,412,435,357,400,True,31
a,41,kaist_dataset/English/Digital_Camera/(E.S)A-shadow/DSC03082.JPG,char_data/a/DSC03082.JPG_4.jpg,779,480,640,19,253,272,384,425,True,31
a,39,kaist_dataset/English/Digital_Camera/(E.S)A-shadow/DSC03082.JPG,char_data/a/DSC03082.JPG_5.jpg,858,480,640,22,404,426,384,423,True,31
a,56,kaist_dataset/English/Digital_Camera/(E.S)A-shadow/DSC03084.JPG,char_data/a/DSC03084.JPG_4.jpg,1176,480,640,21,165,186,372,428,True,31
a,54,kaist_dataset/English/Digital_Camera/(E.S)A-shadow/IMG_2647.JPG,char_data/a/IMG_2647.JPG_6.jpg,2376,480,640,44,208,252,259,313,True,31
a,51,kaist_dataset/English/Digital_Camera/(E.S)A-shadow/IMG_2647.JPG,char_data/a/IMG_2647.JPG_7.jpg,2040,480,640,40,227,267,187,238,True,31
a,59,kaist_dataset/English/Digital_Camera/(E.S)A-shadow/IMG_2647.JPG,char_data/a/IMG_2647.JPG_8.jpg,2478,480,640,42,286,328,103,162,True,31
a,55,kaist_dataset/English/Digital_Camera/(E.S)A-shadow/P090912074.jpg,char_data/a/P090912074.jpg_2.jpg,1595,480,640,29,432,461,83,138,True,31
a,71,kaist_dataset/English/Digital_Camera/(E.S)B-light/DSC02980.JPG,char_data/a/DSC02980.JPG_4.jpg,5538,480,640,78,292,370,77,148,True,31
a,79,kaist_dataset/English/Digital_Camera/(E.S)B-light/DSC02980.JPG,char_data/a/DSC02980.JPG_5.jpg,5530,480,640,70,472,542,92,171,True,31
a,27,kaist_dataset/English/Digital_Camera/(E.S)B-light/크기변환_%B0%A3%C6%C74_fabdent.jpg,char_data/a/크기변환_%B0%A3%C6%C74_fabdent.jpg_5.jpg,567,480,640,21,334,355,257,284,True,31
a,67,kaist_dataset/English/Digital_Camera/(E.S)C-outdoor1/027.jpg,char_data/a/027.jpg_2.jpg,2881,300,472,43,300,343,105,172,True,31
a,48,kaist_dataset/English/Digital_Camera/(E.S)C-outdoor1/031.JPG,char_data/a/031.JPG_2.jpg,1920,480,640,40,421,461,201,249,True,31
a,18,kaist_dataset/English/Digital_Camera/(E.S)C-outdoor1/056.JPG,char_data/a/056.JPG_8.jpg,198,480,640,11,128,139,246,264,True,31
a,62,kaist_dataset/English/Digital_Camera/(E.S)C-outdoor1/056.JPG,char_data/a/056.JPG_10.jpg,3410,480,640,55,151,206,178,240,True,31
a,62,kaist_dataset/English/Digital_Camera/(E.S)C-outdoor1/056.JPG,char_data/a/056.JPG_11.jpg,3286,480,640,53,263,316,177,239,True,31
a,33,kaist_dataset/English/Digital_Camera/(E.S)C-outdoor1/065.jpg,char_data/a/065.jpg_12.jpg,594,374,515,18,85,103,165,198,True,31
a,29,kaist_dataset/English/Digital_Camera/(E.S)C-outdoor1/065.jpg,char_data/a/065.jpg_13.jpg,319,374,515,11,159,170,170,199,True,31
a,26,kaist_dataset/English/Digital_Camera/(E.S)C-outdoor1/065.jpg,char_data/a/065.jpg_14.jpg,364,374,515,14,185,199,174,200,True,31
a,35,kaist_dataset/English/Digital_Camera/(E.S)C-outdoor1/065.jpg,char_data/a/065.jpg_15.jpg,770,374,515,22,341,363,150,185,True,31
a,33,kaist_dataset/English/Digital_Camera/(E.S)C-outdoor1/065.jpg,char_data/a/065.jpg_16.jpg,627,374,515,19,423,442,155,188,True,31
a,36,kaist_dataset/English/Digital_Camera/(E.S)C-outdoor1/065.jpg,char_data/a/065.jpg_17.jpg,936,374,515,26,456,482,150,186,True,31
a,53,kaist_dataset/English/Digital_Camera/(E.S)C-outdoor1/076.JPG,char_data/a/076.JPG_4.jpg,2014,480,640,38,537,575,214,267,True,31
a,16,kaist_dataset/English/Digital_Camera/(E.S)C-outdoor1/076.JPG,char_data/a/076.JPG_5.jpg,80,480,640,5,624,629,321,337,True,31
a,44,kaist_dataset/English/Digital_Camera/(E.S)C-outdoor1/080119-0012.jpg,char_data/a/080119-0012.jpg_2.jpg,2684,1200,1600,61,967,1028,564,608,True,31
a,215,kaist_dataset/English/Digital_Camera/(E.S)C-outdoor1/080119-0035.jpg,char_data/a/080119-0035.jpg_2.jpg,30745,1200,1600,143,906,1049,787,1002,True,31
a,181,kaist_dataset/English/Digital_Camera/(E.S)C-outdoor1/080119-0036.jpg,char_data/a/080119-0036.jpg_2.jpg,21177,1200,1600,117,1164,1281,367,548,True,31
a,41,kaist_dataset/English/Digital_Camera/(E.S)C-outdoor1/1.jpg,char_data/a/1.jpg_8.jpg,1517,480,640,37,405,442,142,183,True,31
a,116,kaist_dataset/English/Digital_Camera/(E.S)C-outdoor1/100.JPG,char_data/a/100.JPG_2.jpg,11252,480,640,97,468,565,71,187,True,31
a,73,kaist_dataset/English/Digital_Camera/(E.S)C-outdoor1/104.jpg,char_data/a/104.jpg_4.jpg,4745,480,640,65,70,135,122,195,True,31
a,75,kaist_dataset/English/Digital_Camera/(E.S)C-outdoor1/104.jpg,char_data/a/104.jpg_5.jpg,3975,480,640,53,320,373,121,196,True,31
a,133,kaist_dataset/English/Digital_Camera/(E.S)C-outdoor1/2007-12-08-day-015.jpg,char_data/a/2007-12-08-day-015.jpg_6.jpg,24206,1200,1600,182,369,551,500,633,True,31
a,139,kaist_dataset/English/Digital_Camera/(E.S)C-outdoor1/2007-12-08-day-015.jpg,char_data/a/2007-12-08-day-015.jpg_7.jpg,27244,1200,1600,196,1089,1285,651,790,True,31
a,37,kaist_dataset/English/Digital_Camera/(E.S)C-outdoor1/2007-12-08-day-015.jpg,char_data/a/2007-12-08-day-015.jpg_8.jpg,1110,1200,1600,30,838,868,819,856,True,31
a,146,kaist_dataset/English/Digital_Camera/(E.S)C-outdoor1/2007-12-08-day-098.jpg,char_data/a/2007-12-08-day-098.jpg_2.jpg,14892,1200,1600,102,225,327,519,665,True,31
a,69,kaist_dataset/English/Digital_Camera/(E.S)C-outdoor1/2007-12-08-day-111.jpg,char_data/a/2007-12-08-day-111.jpg_2.jpg,4761,1200,1600,69,958,1027,513,582,True,31
a,34,kaist_dataset/English/Digital_Camera/(E.S)C-outdoor1/2007-12-09-day-exterior-063.jpg,char_data/a/2007-12-09-day-exterior-063.jpg_2.jpg,714,1200,1600,21,14,35,533,567,True,31
a,13,kaist_dataset/English/Digital_Camera/(E.S)C-outdoor1/7.jpg,char_data/a/7.jpg_2.jpg,130,574,680,10,214,224,108,121,True,31
a,32,kaist_dataset/English/Digital_Camera/(E.S)C-outdoor1/DSC02352.JPG,char_data/a/DSC02352.JPG_4.jpg,736,480,640,23,441,464,325,357,True,31
a,28,kaist_dataset/English/Digital_Camera/(E.S)C-outdoor1/DSC02352.JPG,char_data/a/DSC02352.JPG_5.jpg,532,480,640,19,504,523,326,354,True,31
a,43,kaist_dataset/English/Digital_Camera/(E.S)C-outdoor1/DSC02355.JPG,char_data/a/DSC02355.JPG_6.jpg,946,480,640,22,69,91,304,347,True,31
a,35,kaist_dataset/English/Digital_Camera/(E.S)C-outdoor1/DSC02355.JPG,char_data/a/DSC02355.JPG_7.jpg,665,480,640,19,235,254,310,345,True,31
a,43,kaist_dataset/English/Digital_Camera/(E.S)C-outdoor1/DSC02356.JPG,char_data/a/DSC02356.JPG_11.jpg,731,480,640,17,69,86,307,350,True,31
a,37,kaist_dataset/English/Digital_Camera/(E.S)C-outdoor1/DSC02356.JPG,char_data/a/DSC02356.JPG_12.jpg,814,480,640,22,142,164,308,345,True,31
a,31,kaist_dataset/English/Digital_Camera/(E.S)C-outdoor1/DSC02356.JPG,char_data/a/DSC02356.JPG_13.jpg,558,480,640,18,236,254,311,342,True,31
a,36,kaist_dataset/English/Digital_Camera/(E.S)C-outdoor1/DSC02356.JPG,char_data/a/DSC02356.JPG_14.jpg,756,480,640,21,555,576,314,350,True,31
a,34,kaist_dataset/English/Digital_Camera/(E.S)C-outdoor1/DSC02417.JPG,char_data/a/DSC02417.JPG_6.jpg,646,480,640,19,481,500,136,170,True,31
a,25,kaist_dataset/English/Digital_Camera/(E.S)C-outdoor1/DSC02417.JPG,char_data/a/DSC02417.JPG_7.jpg,425,480,640,17,534,551,142,167,True,31
a,23,kaist_dataset/English/Digital_Camera/(E.S)C-outdoor1/DSC02417.JPG,char_data/a/DSC02417.JPG_8.jpg,345,480,640,15,522,537,183,206,True,31
a,29,kaist_dataset/English/Digital_Camera/(E.S)C-outdoor1/DSC02427.JPG,char_data/a/DSC02427.JPG_2.jpg,609,480,640,21,362,383,371,400,True,31
a,49,kaist_dataset/English/Digital_Camera/(E.S)C-outdoor1/DSC02480.JPG,char_data/a/DSC02480.JPG_4.jpg,1421,480,640,29,235,264,119,168,True,31
a,39,kaist_dataset/English/Digital_Camera/(E.S)C-outdoor1/DSC02480.JPG,char_data/a/DSC02480.JPG_5.jpg,1014,480,640,26,154,180,412,451,True,31
a,73,kaist_dataset/English/Digital_Camera/(E.S)C-outdoor1/DSC02491.JPG,char_data/a/DSC02491.JPG_4.jpg,4161,480,640,57,348,405,139,212,True,31
a,67,kaist_dataset/English/Digital_Camera/(E.S)C-outdoor1/DSC02491.JPG,char_data/a/DSC02491.JPG_5.jpg,3752,480,640,56,328,384,59,126,True,31
a,56,kaist_dataset/English/Digital_Camera/(E.S)C-outdoor1/DSC02514.JPG,char_data/a/DSC02514.JPG_5.jpg,1960,480,640,35,353,388,188,244,True,31
a,73,kaist_dataset/English/Digital_Camera/(E.S)C-outdoor1/DSC02524.JPG,char_data/a/DSC02524.JPG_2.jpg,3796,480,640,52,103,155,327,400,True,31
a,41,kaist_dataset/English/Digital_Camera/(E.S)C-outdoor1/DSC02868.JPG,char_data/a/DSC02868.JPG_2.jpg,779,480,640,19,271,290,402,443,True,31
a,107,kaist_dataset/English/Digital_Camera/(E.S)C-outdoor1/DSC02914.JPG,char_data/a/DSC02914.JPG_2.jpg,5671,480,640,53,127,180,183,290,True,31
a,37,kaist_dataset/English/Digital_Camera/(E.S)C-outdoor1/DSC02918.JPG,char_data/a/DSC02918.JPG_5.jpg,1073,480,640,29,357,386,185,222,True,31
a,70,kaist_dataset/English/Digital_Camera/(E.S)C-outdoor2/DSC02990.JPG,char_data/a/DSC02990.JPG_2.jpg,4480,480,640,64,466,530,189,259,True,31
a,48,kaist_dataset/English/Digital_Camera/(E.S)C-outdoor2/DSC02998.JPG,char_data/a/DSC02998.JPG_2.jpg,1536,480,640,32,256,288,421,469,True,31
a,54,kaist_dataset/English/Digital_Camera/(E.S)C-outdoor2/DSC03001.JPG,char_data/a/DSC03001.JPG_2.jpg,2052,480,640,38,335,373,189,243,True,31
a,38,kaist_dataset/English/Digital_Camera/(E.S)C-outdoor2/DSC03053.JPG,char_data/a/DSC03053.JPG_2.jpg,836,480,640,22,57,79,137,175,True,31
a,36,kaist_dataset/English/Digital_Camera/(E.S)C-outdoor2/DSC03160.JPG,char_data/a/DSC03160.JPG_10.jpg,828,480,640,23,433,456,150,186,True,31
a,37,kaist_dataset/English/Digital_Camera/(E.S)C-outdoor2/DSC03160.JPG,char_data/a/DSC03160.JPG_11.jpg,925,480,640,25,477,502,146,183,True,31
a,43,kaist_dataset/English/Digital_Camera/(E.S)C-outdoor2/DSC03166.JPG,char_data/a/DSC03166.JPG_2.jpg,1634,480,640,38,273,311,273,316,True,31
a,39,kaist_dataset/English/Digital_Camera/(E.S)C-outdoor2/DSC03170.JPG,char_data/a/DSC03170.JPG_2.jpg,1677,480,640,43,368,411,324,363,True,31
a,46,kaist_dataset/English/Digital_Camera/(E.S)C-outdoor2/DSC03192.JPG,char_data/a/DSC03192.JPG_2.jpg,1932,480,640,42,276,318,171,217,True,31
a,51,kaist_dataset/English/Digital_Camera/(E.S)C-outdoor2/DSC03201.JPG,char_data/a/DSC03201.JPG_4.jpg,1428,480,640,28,251,279,83,134,True,31
a,53,kaist_dataset/English/Digital_Camera/(E.S)C-outdoor2/DSC03201.JPG,char_data/a/DSC03201.JPG_5.jpg,1537,480,640,29,375,404,83,136,True,31
a,24,kaist_dataset/English/Digital_Camera/(E.S)C-outdoor2/DSC03208.JPG,char_data/a/DSC03208.JPG_5.jpg,432,480,640,18,333,351,170,194,True,31
a,63,kaist_dataset/English/Digital_Camera/(E.S)C-outdoor2/DSC03229.JPG,char_data/a/DSC03229.JPG_6.jpg,3591,480,640,57,342,399,165,228,True,31
a,68,kaist_dataset/English/Digital_Camera/(E.S)C-outdoor2/DSC03229.JPG,char_data/a/DSC03229.JPG_7.jpg,4148,480,640,61,444,505,157,225,True,31
a,75,kaist_dataset/English/Digital_Camera/(E.S)C-outdoor2/DSC03229.JPG,char_data/a/DSC03229.JPG_8.jpg,2850,480,640,38,568,606,144,219,True,31
a,72,kaist_dataset/English/Digital_Camera/(E.S)C-outdoor2/DSC03276.JPG,char_data/a/DSC03276.JPG_4.jpg,4032,480,640,56,177,233,348,420,True,31
a,71,kaist_dataset/English/Digital_Camera/(E.S)C-outdoor2/DSC03276.JPG,char_data/a/DSC03276.JPG_5.jpg,4473,480,640,63,391,454,342,413,True,31
a,50,kaist_dataset/English/Digital_Camera/(E.S)C-outdoor2/DSC03277.JPG,char_data/a/DSC03277.JPG_2.jpg,2100,480,640,42,488,530,203,253,True,31
a,77,kaist_dataset/English/Digital_Camera/(E.S)C-outdoor2/DSC03281.JPG,char_data/a/DSC03281.JPG_2.jpg,4466,480,640,58,458,516,212,289,True,31
a,39,kaist_dataset/English/Digital_Camera/(E.S)C-outdoor2/DSC03290.JPG,char_data/a/DSC03290.JPG_4.jpg,1326,480,640,34,325,359,103,142,True,31
a,43,kaist_dataset/English/Digital_Camera/(E.S)C-outdoor2/DSC03290.JPG,char_data/a/DSC03290.JPG_5.jpg,1419,480,640,33,315,348,314,357,True,31
a,55,kaist_dataset/English/Digital_Camera/(E.S)C-outdoor2/DSC03412.JPG,char_data/a/DSC03412.JPG_8.jpg,2090,480,640,38,327,365,146,201,True,31
a,64,kaist_dataset/English/Digital_Camera/(E.S)C-outdoor2/DSC03413.JPG,char_data/a/DSC03413.JPG_5.jpg,3328,480,640,52,321,373,130,194,True,31
a,71,kaist_dataset/English/Digital_Camera/(E.S)C-outdoor2/DSC03436.JPG,char_data/a/DSC03436.JPG_2.jpg,4047,480,640,57,439,496,41,112,True,31
a,50,kaist_dataset/English/Digital_Camera/(E.S)C-outdoor2/DSC03440.JPG,char_data/a/DSC03440.JPG_4.jpg,1750,480,640,35,257,292,141,191,True,31
a,41,kaist_dataset/English/Digital_Camera/(E.S)C-outdoor2/DSC03440.JPG,char_data/a/DSC03440.JPG_5.jpg,1148,480,640,28,376,404,151,192,True,31
a,66,kaist_dataset/English/Digital_Camera/(E.S)C-outdoor2/DSC03731.JPG,char_data/a/DSC03731.JPG_2.jpg,3828,480,640,58,252,310,51,117,True,31
a,50,kaist_dataset/English/Digital_Camera/(E.S)C-outdoor2/DSC03765.JPG,char_data/a/DSC03765.JPG_4.jpg,1700,480,640,34,223,257,93,143,True,31
a,51,kaist_dataset/English/Digital_Camera/(E.S)C-outdoor2/DSC03765.JPG,char_data/a/DSC03765.JPG_5.jpg,1734,480,640,34,319,353,88,139,True,31
a,42,kaist_dataset/English/Digital_Camera/(E.S)C-outdoor2/DSC03865.JPG,char_data/a/DSC03865.JPG_10.jpg,1050,480,640,25,120,145,98,140,True,31
a,35,kaist_dataset/English/Digital_Camera/(E.S)C-outdoor2/DSC03865.JPG,char_data/a/DSC03865.JPG_11.jpg,945,480,640,27,191,218,106,141,True,31
a,33,kaist_dataset/English/Digital_Camera/(E.S)C-outdoor2/DSC03865.JPG,char_data/a/DSC03865.JPG_12.jpg,924,480,640,28,122,150,62,95,True,31
a,44,kaist_dataset/English/Digital_Camera/(E.S)C-outdoor2/DSC04035.JPG,char_data/a/DSC04035.JPG_2.jpg,1276,480,640,29,258,287,200,244,True,31
a,51,kaist_dataset/English/Digital_Camera/(E.S)C-outdoor2/DSC04052.JPG,char_data/a/DSC04052.JPG_2.jpg,1785,480,640,35,446,481,173,224,True,31
a,40,kaist_dataset/English/Digital_Camera/(E.S)C-outdoor2/DSC04064.JPG,char_data/a/DSC04064.JPG_4.jpg,1040,480,640,26,243,269,137,177,True,31
a,43,kaist_dataset/English/Digital_Camera/(E.S)C-outdoor2/DSC04064.JPG,char_data/a/DSC04064.JPG_5.jpg,1075,480,640,25,438,463,139,182,True,31
a,35,kaist_dataset/English/Digital_Camera/(E.S)C-outdoor2/DSC04079.JPG,char_data/a/DSC04079.JPG_5.jpg,840,480,640,24,68,92,161,196,True,31
a,53,kaist_dataset/English/Digital_Camera/(E.S)C-outdoor2/DSC04160.JPG,char_data/a/DSC04160.JPG_2.jpg,2915,480,640,55,430,485,337,390,True,31
a,55,kaist_dataset/English/Digital_Camera/(E.S)C-outdoor2/DSC04163.JPG,char_data/a/DSC04163.JPG_2.jpg,2035,480,640,37,306,343,261,316,True,31
a,60,kaist_dataset/English/Digital_Camera/(E.S)C-outdoor2/DSC04251.JPG,char_data/a/DSC04251.JPG_2.jpg,2580,480,640,43,236,279,78,138,True,31
a,98,kaist_dataset/English/Digital_Camera/(E.S)C-outdoor2/DSC04397.JPG,char_data/a/DSC04397.JPG_6.jpg,8330,480,640,85,117,202,219,317,True,31
a,97,kaist_dataset/English/Digital_Camera/(E.S)C-outdoor2/DSC04397.JPG,char_data/a/DSC04397.JPG_7.jpg,7857,480,640,81,307,388,230,327,True,31
a,57,kaist_dataset/English/Digital_Camera/(E.S)C-outdoor2/DSC04397.JPG,char_data/a/DSC04397.JPG_8.jpg,2166,480,640,38,367,405,141,198,True,31
a,94,kaist_dataset/English/Digital_Camera/(E.S)C-outdoor2/DSC04430.JPG,char_data/a/DSC04430.JPG_2.jpg,8742,480,640,93,196,289,167,261,True,31
a,26,kaist_dataset/English/Digital_Camera/(E.S)C-outdoor2/DSC04437.JPG,char_data/a/DSC04437.JPG_2.jpg,338,480,640,13,208,221,77,103,True,31
a,124,kaist_dataset/English/Digital_Camera/(E.S)C-outdoor2/DSC04458.JPG,char_data/a/DSC04458.JPG_2.jpg,10788,480,640,87,135,222,297,421,True,31
a,48,kaist_dataset/English/Digital_Camera/(E.S)C-outdoor2/P1010057.JPG,char_data/a/P1010057.JPG_4.jpg,1152,480,640,24,184,208,201,249,True,31
a,36,kaist_dataset/English/Digital_Camera/(E.S)C-outdoor2/P1010057.JPG,char_data/a/P1010057.JPG_5.jpg,828,480,640,23,357,380,207,243,True,31
a,42,kaist_dataset/English/Digital_Camera/(E.S)C-outdoor3/DSC03038.JPG,char_data/a/DSC03038.JPG_2.jpg,924,480,640,22,147,169,330,372,True,31
a,64,kaist_dataset/English/Digital_Camera/(E.S)C-outdoor3/P1010086.JPG,char_data/a/P1010086.JPG_2.jpg,3520,480,640,55,177,232,87,151,True,31
a,58,kaist_dataset/English/Digital_Camera/(E.S)C-outdoor3/크기변환_%B0%A3%C6%C71_fabdent.jpg,char_data/a/크기변환_%B0%A3%C6%C71_fabdent.jpg_6.jpg,2262,480,640,39,90,129,256,314,True,31
a,59,kaist_dataset/English/Digital_Camera/(E.S)C-outdoor3/크기변환_%B0%A3%C6%C71_fabdent.jpg,char_data/a/크기변환_%B0%A3%C6%C71_fabdent.jpg_7.jpg,2301,480,640,39,347,386,249,308,True,31
a,57,kaist_dataset/English/Digital_Camera/(E.S)C-outdoor3/크기변환_%B0%A3%C6%C71_fabdent.jpg,char_data/a/크기변환_%B0%A3%C6%C71_fabdent.jpg_8.jpg,2565,480,640,45,536,581,242,299,True,31
a,14,kaist_dataset/English/Digital_Camera/(E.S)C-outdoor3/크기변환_P1010076.JPG,char_data/a/크기변환_P1010076.JPG_7.jpg,210,480,640,15,243,258,109,123,True,31
a,11,kaist_dataset/English/Digital_Camera/(E.S)C-outdoor3/크기변환_P1010076.JPG,char_data/a/크기변환_P1010076.JPG_8.jpg,121,480,640,11,221,232,111,122,True,31
a,45,kaist_dataset/English/Digital_Camera/(E.S)D-indoor/080119-0009.jpg,char_data/a/080119-0009.jpg_22.jpg,1215,1200,1600,27,1522,1549,169,214,True,31
a,55,kaist_dataset/English/Digital_Camera/(E.S)D-indoor/080119-0009.jpg,char_data/a/080119-0009.jpg_23.jpg,1430,1200,1600,26,1573,1599,171,226,True,31
a,40,kaist_dataset/English/Digital_Camera/(E.S)D-indoor/080119-0009.jpg,char_data/a/080119-0009.jpg_26.jpg,1440,1200,1600,36,722,758,671,711,True,31
a,36,kaist_dataset/English/Digital_Camera/(E.S)D-indoor/080119-0009.jpg,char_data/a/080119-0009.jpg_27.jpg,1080,1200,1600,30,1075,1105,697,733,True,31
a,34,kaist_dataset/English/Digital_Camera/(E.S)D-indoor/080119-0009.jpg,char_data/a/080119-0009.jpg_28.jpg,544,1200,1600,16,583,599,1012,1046,True,31
a,32,kaist_dataset/English/Digital_Camera/(E.S)D-indoor/080119-0009.jpg,char_data/a/080119-0009.jpg_29.jpg,704,1200,1600,22,816,838,1077,1109,True,31
a,37,kaist_dataset/English/Digital_Camera/(E.S)D-indoor/080119-0009.jpg,char_data/a/080119-0009.jpg_30.jpg,1147,1200,1600,31,879,910,1084,1121,True,31
a,49,kaist_dataset/English/Digital_Camera/(E.S)D-indoor/080119-0009.jpg,char_data/a/080119-0009.jpg_31.jpg,1323,1200,1600,27,1522,1549,92,141,True,31
a,63,kaist_dataset/English/Digital_Camera/(E.S)D-indoor/DSC02719.JPG,char_data/a/DSC02719.JPG_2.jpg,2016,480,640,32,459,491,286,349,True,31
a,77,kaist_dataset/English/Digital_Camera/(E.S)D-indoor/DSC02853.JPG,char_data/a/DSC02853.JPG_5.jpg,3311,480,640,43,324,367,139,216,True,31
a,46,kaist_dataset/English/Digital_Camera/(E.S)D-indoor/DSC02862.JPG,char_data/a/DSC02862.JPG_2.jpg,2438,480,640,53,291,344,259,305,True,31
a,55,kaist_dataset/English/Digital_Camera/(E.S)D-indoor/DSC03074.JPG,char_data/a/DSC03074.JPG_4.jpg,1100,480,640,20,311,331,267,322,True,31
a,64,kaist_dataset/English/Digital_Camera/(E.S)D-indoor/DSC03074.JPG,char_data/a/DSC03074.JPG_5.jpg,1344,480,640,21,353,374,259,323,True,31
a,56,kaist_dataset/English/Digital_Camera/(E.S)D-indoor/DSC03078.JPG,char_data/a/DSC03078.JPG_2.jpg,2016,480,640,36,339,375,305,361,True,31
a,40,kaist_dataset/English/Digital_Camera/(E.S)D-indoor/DSC03083.JPG,char_data/a/DSC03083.JPG_2.jpg,1040,480,640,26,410,436,405,445,True,31
a,56,kaist_dataset/English/Digital_Camera/(E.S)D-indoor/DSC03091.JPG,char_data/a/DSC03091.JPG_4.jpg,2072,480,640,37,322,359,130,186,True,31
a,53,kaist_dataset/English/Digital_Camera/(E.S)D-indoor/DSC03093.JPG,char_data/a/DSC03093.JPG_4.jpg,2226,480,640,42,522,564,138,191,True,31
a,47,kaist_dataset/English/Digital_Camera/(E.S)D-indoor/DSC03093.JPG,char_data/a/DSC03093.JPG_5.jpg,1316,480,640,28,325,353,210,257,True,31
a,36,kaist_dataset/English/Digital_Camera/(E.S)D-indoor/DSC03112.JPG,char_data/a/DSC03112.JPG_2.jpg,900,480,640,25,306,331,211,247,True,31
a,56,kaist_dataset/English/Digital_Camera/(E.S)D-indoor/DSC03136.JPG,char_data/a/DSC03136.JPG_2.jpg,2184,480,640,39,504,543,265,321,True,31
a,39,kaist_dataset/English/Digital_Camera/(E.S)D-indoor/DSC03142.JPG,char_data/a/DSC03142.JPG_4.jpg,1170,480,640,30,260,290,428,467,True,31
a,31,kaist_dataset/English/Digital_Camera/(E.S)D-indoor/DSC03142.JPG,char_data/a/DSC03142.JPG_5.jpg,837,480,640,27,390,417,371,402,True,31
a,34,kaist_dataset/English/Digital_Camera/(E.S)D-indoor/DSC03144.JPG,char_data/a/DSC03144.JPG_2.jpg,816,480,640,24,392,416,292,326,True,31
a,28,kaist_dataset/English/Digital_Camera/(E.S)D-indoor/DSC03145.JPG,char_data/a/DSC03145.JPG_6.jpg,644,480,640,23,237,260,184,212,True,31
a,35,kaist_dataset/English/Digital_Camera/(E.S)D-indoor/DSC03145.JPG,char_data/a/DSC03145.JPG_7.jpg,945,480,640,27,282,309,178,213,True,31
a,27,kaist_dataset/English/Digital_Camera/(E.S)D-indoor/DSC03145.JPG,char_data/a/DSC03145.JPG_8.jpg,648,480,640,24,240,264,128,155,True,31
a,40,kaist_dataset/English/Digital_Camera/(E.S)D-indoor/DSC03146.JPG,char_data/a/DSC03146.JPG_2.jpg,1000,480,640,25,331,356,173,213,True,31
a,31,kaist_dataset/English/Digital_Camera/(E.S)D-indoor/DSC03147.JPG,char_data/a/DSC03147.JPG_6.jpg,775,480,640,25,306,331,299,330,True,31
a,29,kaist_dataset/English/Digital_Camera/(E.S)D-indoor/DSC03147.JPG,char_data/a/DSC03147.JPG_7.jpg,725,480,640,25,406,431,297,326,True,31
a,41,kaist_dataset/English/Digital_Camera/(E.S)D-indoor/DSC03147.JPG,char_data/a/DSC03147.JPG_8.jpg,1025,480,640,25,312,337,233,274,True,31
a,38,kaist_dataset/English/Digital_Camera/(E.S)D-indoor/DSC03149.JPG,char_data/a/DSC03149.JPG_7.jpg,988,480,640,26,145,171,387,425,True,31
a,41,kaist_dataset/English/Digital_Camera/(E.S)D-indoor/DSC03149.JPG,char_data/a/DSC03149.JPG_8.jpg,1271,480,640,31,566,597,396,437,True,31
a,46,kaist_dataset/English/Digital_Camera/(E.S)D-indoor/DSC03150.JPG,char_data/a/DSC03150.JPG_4.jpg,1702,480,640,37,188,225,38,84,True,31
a,52,kaist_dataset/English/Digital_Camera/(E.S)D-indoor/DSC03150.JPG,char_data/a/DSC03150.JPG_5.jpg,1612,480,640,31,464,495,22,74,True,31
a,44,kaist_dataset/English/Digital_Camera/(E.S)D-indoor/DSC03151.JPG,char_data/a/DSC03151.JPG_6.jpg,1408,480,640,32,209,241,116,160,True,31
a,41,kaist_dataset/English/Digital_Camera/(E.S)D-indoor/DSC03151.JPG,char_data/a/DSC03151.JPG_7.jpg,1353,480,640,33,339,372,110,151,True,31
a,40,kaist_dataset/English/Digital_Camera/(E.S)D-indoor/DSC03151.JPG,char_data/a/DSC03151.JPG_8.jpg,1200,480,640,30,495,525,114,154,True,31
a,46,kaist_dataset/English/Digital_Camera/(E.S)D-indoor/DSC03345.JPG,char_data/a/DSC03345.JPG_4.jpg,1610,480,640,35,135,170,104,150,True,31
a,42,kaist_dataset/English/Digital_Camera/(E.S)D-indoor/DSC03345.JPG,char_data/a/DSC03345.JPG_5.jpg,1470,480,640,35,492,527,105,147,True,31
a,49,kaist_dataset/English/Digital_Camera/(E.S)D-indoor/DSC03376.JPG,char_data/a/DSC03376.JPG_2.jpg,1617,480,640,33,232,265,403,452,True,31
a,39,kaist_dataset/English/Digital_Camera/(E.S)D-indoor/DSC03396.JPG,char_data/a/DSC03396.JPG_5.jpg,1053,480,640,27,415,442,348,387,True,31
a,103,kaist_dataset/English/Digital_Camera/(E.S)D-indoor/DSC03398.JPG,char_data/a/DSC03398.JPG_4.jpg,9888,480,640,96,121,217,315,418,True,31
a,99,kaist_dataset/English/Digital_Camera/(E.S)D-indoor/DSC03398.JPG,char_data/a/DSC03398.JPG_5.jpg,8712,480,640,88,422,510,329,428,True,31
a,43,kaist_dataset/English/Digital_Camera/(E.S)D-indoor/DSC03532.JPG,char_data/a/DSC03532.JPG_12.jpg,1720,480,640,40,472,512,432,475,True,31
a,34,kaist_dataset/English/Digital_Camera/(E.S)D-indoor/DSC03532.JPG,char_data/a/DSC03532.JPG_13.jpg,612,480,640,18,118,136,379,413,True,31
a,28,kaist_dataset/English/Digital_Camera/(E.S)D-indoor/DSC03532.JPG,char_data/a/DSC03532.JPG_14.jpg,476,480,640,17,267,284,385,413,True,31
a,23,kaist_dataset/English/Digital_Camera/(E.S)D-indoor/DSC03532.JPG,char_data/a/DSC03532.JPG_15.jpg,460,480,640,20,417,437,386,409,True,31
a,25,kaist_dataset/English/Digital_Camera/(E.S)D-indoor/DSC03532.JPG,char_data/a/DSC03532.JPG_17.jpg,400,480,640,16,566,582,380,405,True,31
a,81,kaist_dataset/English/Digital_Camera/(E.S)D-indoor/DSC03918.JPG,char_data/a/DSC03918.JPG_6.jpg,6318,480,640,78,133,211,288,369,True,31
a,92,kaist_dataset/English/Digital_Camera/(E.S)D-indoor/DSC03918.JPG,char_data/a/DSC03918.JPG_7.jpg,6072,480,640,66,354,420,274,366,True,31
a,49,kaist_dataset/English/Digital_Camera/(E.S)D-indoor/DSC03936.JPG,char_data/a/DSC03936.JPG_4.jpg,1470,480,640,30,367,397,90,139,True,31
a,40,kaist_dataset/English/Digital_Camera/(E.S)D-indoor/DSC03936.JPG,char_data/a/DSC03936.JPG_5.jpg,1040,480,640,26,484,510,171,211,True,31
a,37,kaist_dataset/English/Digital_Camera/(E.S)D-indoor/DSC03947.JPG,char_data/a/DSC03947.JPG_8.jpg,1110,480,640,30,374,404,429,466,True,31
a,83,kaist_dataset/English/Digital_Camera/(E.S)D-indoor/DSC04023.JPG,char_data/a/DSC04023.JPG_8.jpg,3735,480,640,45,223,268,208,291,True,31
a,83,kaist_dataset/English/Digital_Camera/(E.S)D-indoor/DSC04023.JPG,char_data/a/DSC04023.JPG_9.jpg,3320,480,640,40,268,308,215,298,True,31
a,50,kaist_dataset/English/Digital_Camera/(E.S)D-indoor/DSC04023.JPG,char_data/a/DSC04023.JPG_10.jpg,3100,480,640,62,471,533,255,305,True,31
a,37,kaist_dataset/English/Digital_Camera/(E.S)D-indoor/DSC04023.JPG,char_data/a/DSC04023.JPG_11.jpg,925,480,640,25,169,194,307,344,True,31
a,82,kaist_dataset/English/Digital_Camera/(E.S)E-night/DSC02570.JPG,char_data/a/DSC02570.JPG_2.jpg,5248,480,640,64,382,446,252,334,True,31
a,119,kaist_dataset/English/Digital_Camera/(E.S)E-night/DSC02639.JPG,char_data/a/DSC02639.JPG_6.jpg,6307,480,640,53,192,245,218,337,True,31
a,118,kaist_dataset/English/Digital_Camera/(E.S)E-night/DSC02639.JPG,char_data/a/DSC02639.JPG_7.jpg,6844,480,640,58,305,363,223,341,True,31
a,117,kaist_dataset/English/Digital_Camera/(E.S)E-night/DSC02639.JPG,char_data/a/DSC02639.JPG_8.jpg,9009,480,640,77,418,495,224,341,True,31
a,74,kaist_dataset/English/Digital_Camera/(E.S)E-night/DSC02676.JPG,char_data/a/DSC02676.JPG_2.jpg,2886,480,640,39,66,105,216,290,True,31
a,97,kaist_dataset/English/Digital_Camera/(E.S)E-night/DSC02981.JPG,char_data/a/DSC02981.JPG_2.jpg,4559,480,640,47,376,423,27,124,True,31
a,40,kaist_dataset/English/Digital_Camera/(E.S)F-others/080116-0058.jpg,char_data/a/080116-0058.jpg_8.jpg,1040,1200,1600,26,52,78,635,675,True,31
a,53,kaist_dataset/English/Digital_Camera/(E.S)F-others/080119-0007.jpg,char_data/a/080119-0007.jpg_6.jpg,2173,1200,1600,41,886,927,749,802,True,31
a,52,kaist_dataset/English/Digital_Camera/(E.S)F-others/080119-0007.jpg,char_data/a/080119-0007.jpg_7.jpg,2028,1200,1600,39,1068,1107,711,763,True,31
a,84,kaist_dataset/English/Digital_Camera/(E.S)F-others/DSC02925.JPG,char_data/a/DSC02925.JPG_2.jpg,5292,480,640,63,455,518,221,305,True,31
a,26,kaist_dataset/English/Digital_Camera/(E.S)F-others/크기변환_%C4%BF%C7%C7%B5%B9%C3%E2%B0%A3%C6%C7_%281%29_alto99kr.jpg,char_data/a/크기변환_%C4%BF%C7%C7%B5%B9%C3%E2%B0%A3%C6%C7_%281%29_alto99kr.jpg_4.jpg,624,480,640,24,330,354,204,230,True,31
a,25,kaist_dataset/English/Digital_Camera/(E.S)F-others/크기변환_%C4%BF%C7%C7%B5%B9%C3%E2%B0%A3%C6%C7_%281%29_alto99kr.jpg,char_data/a/크기변환_%C4%BF%C7%C7%B5%B9%C3%E2%B0%A3%C6%C7_%281%29_alto99kr.jpg_5.jpg,625,480,640,25,432,457,203,228,True,31
a,108,kaist_dataset/English/Mobile_Phone/(E.M)A-outdoor/P090911070.jpg,char_data/a/P090911070.jpg_2.jpg,13176,480,640,122,130,252,158,266,True,31
a,86,kaist_dataset/English/Mobile_Phone/(E.M)A-outdoor/P090912059.jpg,char_data/a/P090912059.jpg_2.jpg,7310,480,640,85,363,448,159,245,True,31
a,61,kaist_dataset/English/Mobile_Phone/(E.M)A-outdoor/P090912072.jpg,char_data/a/P090912072.jpg_6.jpg,2135,480,640,35,69,104,28,89,True,31
a,59,kaist_dataset/English/Mobile_Phone/(E.M)A-outdoor/P090912072.jpg,char_data/a/P090912072.jpg_7.jpg,1947,480,640,33,127,160,34,93,True,31
a,60,kaist_dataset/English/Mobile_Phone/(E.M)A-outdoor/P090912072.jpg,char_data/a/P090912072.jpg_8.jpg,2460,480,640,41,256,297,37,97,True,31
a,66,kaist_dataset/English/Mobile_Phone/(E.M)B-indoor/P090831011.jpg,char_data/a/P090831011.jpg_2.jpg,2442,480,640,37,435,472,143,209,True,31
a,61,kaist_dataset/English/Mobile_Phone/(E.M)B-indoor/P090902018.jpg,char_data/a/P090902018.jpg_5.jpg,2135,480,640,35,430,465,193,254,True,31
a,118,kaist_dataset/English/Mobile_Phone/(E.M)B-indoor/P090903001.jpg,char_data/a/P090903001.jpg_2.jpg,14278,480,640,121,164,285,141,259,True,31
a,81,kaist_dataset/English/Mobile_Phone/(E.M)B-indoor/P090903004.jpg,char_data/a/P090903004.jpg_2.jpg,6075,480,640,75,385,460,250,331,True,31
a,105,kaist_dataset/English/Mobile_Phone/(E.M)B-indoor/P090903005.jpg,char_data/a/P090903005.jpg_2.jpg,9765,480,640,93,245,338,194,299,True,31
a,78,kaist_dataset/English/Mobile_Phone/(E.M)B-indoor/P090903007.jpg,char_data/a/P090903007.jpg_2.jpg,4758,480,640,61,67,128,259,337,True,31
a,53,kaist_dataset/English/Mobile_Phone/(E.M)B-indoor/P090903008.jpg,char_data/a/P090903008.jpg_2.jpg,2491,480,640,47,488,535,46,99,True,31
a,44,kaist_dataset/English/Mobile_Phone/(E.M)B-indoor/P090911060.jpg,char_data/a/P090911060.jpg_2.jpg,1408,480,640,32,403,435,25,69,True,31
a,59,kaist_dataset/English/Mobile_Phone/(E.M)B-indoor/P090911067.jpg,char_data/a/P090911067.jpg_2.jpg,1888,480,640,32,245,277,219,278,True,31
a,65,kaist_dataset/English/Mobile_Phone/(E.M)B-indoor/P090911081.jpg,char_data/a/P090911081.jpg_2.jpg,2730,480,640,42,269,311,227,292,True,31
a,119,kaist_dataset/English/Mobile_Phone/(E.M)C-bookCover/P090831022.jpg,char_data/a/P090831022.jpg_2.jpg,11662,480,640,98,363,461,156,275,True,31
a,104,kaist_dataset/English/Mobile_Phone/(E.M)C-bookCover/P090831077.jpg,char_data/a/P090831077.jpg_2.jpg,9776,480,640,94,235,329,92,196,True,31
a,41,kaist_dataset/English/Mobile_Phone/(E.M)C-bookCover/P090903030.jpg,char_data/a/P090903030.jpg_8.jpg,1107,480,640,27,65,92,81,122,True,31
a,39,kaist_dataset/English/Mobile_Phone/(E.M)C-bookCover/P090903030.jpg,char_data/a/P090903030.jpg_9.jpg,1053,480,640,27,289,316,75,114,True,31
a,40,kaist_dataset/English/Mobile_Phone/(E.M)C-bookCover/P090903030.jpg,char_data/a/P090903030.jpg_10.jpg,840,480,640,21,473,494,73,113,True,31
a,30,kaist_dataset/English/Mobile_Phone/(E.M)C-bookCover/P090903030.jpg,char_data/a/P090903030.jpg_11.jpg,870,480,640,29,538,567,77,107,True,31
a,92,kaist_dataset/English/Mobile_Phone/(E.M)C-bookCover/P090903054.jpg,char_data/a/P090903054.jpg_4.jpg,6716,480,640,73,95,168,225,317,True,31
a,21,kaist_dataset/Korean/Digital_Camera/A-shadow/2007-12-09-day-exterior-031.jpg,char_data/a/2007-12-09-day-exterior-031.jpg_6.jpg,252,1200,1600,12,385,397,624,645,True,31
a,24,kaist_dataset/Korean/Digital_Camera/A-shadow/2007-12-09-day-exterior-031.jpg,char_data/a/2007-12-09-day-exterior-031.jpg_7.jpg,360,1200,1600,15,496,511,618,642,True,31
a,29,kaist_dataset/Korean/Digital_Camera/A-shadow/2007-12-09-day-exterior-031.jpg,char_data/a/2007-12-09-day-exterior-031.jpg_8.jpg,493,1200,1600,17,545,562,614,643,True,31
a,42,kaist_dataset/Korean/Digital_Camera/G-others/080119-0005.jpg,char_data/a/080119-0005.jpg_6.jpg,1302,1600,1200,31,611,642,1156,1198,True,31
a,37,kaist_dataset/Korean/Digital_Camera/G-others/080119-0005.jpg,char_data/a/080119-0005.jpg_7.jpg,1073,1600,1200,29,712,741,1170,1207,True,31
a,32,kaist_dataset/Korean/Digital_Camera/G-others/080119-0005.jpg,char_data/a/080119-0005.jpg_8.jpg,672,1600,1200,21,674,695,603,635,True,31
a,24,kaist_dataset/Korean/Digital_Camera/indoor1/080119-0029.jpg,char_data/a/080119-0029.jpg_2.jpg,264,1200,1600,11,309,320,584,608,True,31
a,21,kaist_dataset/Korean/Digital_Camera/indoor1/145.JPG,char_data/a/145.JPG_2.jpg,252,480,640,12,243,255,306,327,True,31
a,13,kaist_dataset/Korean/Digital_Camera/outdoor1/001.JPG,char_data/a/001.JPG_4.jpg,156,480,640,12,285,297,247,260,True,31
a,19,kaist_dataset/Korean/Digital_Camera/outdoor1/001.JPG,char_data/a/001.JPG_5.jpg,285,480,640,15,372,387,242,261,True,31
a,26,kaist_dataset/Korean/Digital_Camera/outdoor1/2007-12-08-day-087.jpg,char_data/a/2007-12-08-day-087.jpg_2.jpg,520,1200,1600,20,46,66,517,543,True,31
a,30,kaist_dataset/Korean/Digital_Camera/outdoor1/40.jpg,char_data/a/40.jpg_2.jpg,600,308,367,20,53,73,52,82,True,31
a,36,kaist_dataset/Korean/Digital_Camera/outdoor2/080118-0018.jpg,char_data/a/080118-0018.jpg_4.jpg,1656,1200,1600,46,847,893,693,729,True,31
a,44,kaist_dataset/Korean/Digital_Camera/outdoor2/080118-0018.jpg,char_data/a/080118-0018.jpg_5.jpg,1980,1200,1600,45,1206,1251,695,739,True,31
a,61,kaist_dataset/Korean/Digital_Camera/outdoor2/2007-12-08-day-101.jpg,char_data/a/2007-12-08-day-101.jpg_4.jpg,3050,1200,1600,50,989,1039,401,462,True,31
a,37,kaist_dataset/Korean/Digital_Camera/outdoor2/2007-12-09-day-exterior-036.jpg,char_data/a/2007-12-09-day-exterior-036.jpg_2.jpg,1073,1200,1600,29,1411,1440,556,593,True,31
a,25,kaist_dataset/Korean/Digital_Camera/outdoor6/DSC04292.JPG,char_data/a/DSC04292.JPG_2.jpg,350,480,640,14,139,153,59,84,True,31
a,51,kaist_dataset/Mixed/Digital_Camera/(C.S)A-shadow/DSC03207.JPG,char_data/a/DSC03207.JPG_2.jpg,2142,480,640,42,324,366,208,259,True,31
a,30,kaist_dataset/Mixed/Digital_Camera/(C.S)B-light/134.JPG,char_data/a/134.JPG_4.jpg,540,480,640,18,286,304,293,323,True,31
a,37,kaist_dataset/Mixed/Digital_Camera/(C.S)B-light/134.JPG,char_data/a/134.JPG_5.jpg,740,480,640,20,368,388,291,328,True,31
a,85,kaist_dataset/Mixed/Digital_Camera/(C.S)B-light/DSC04404.JPG,char_data/a/DSC04404.JPG_2.jpg,5270,480,640,62,249,311,229,314,True,31
a,19,kaist_dataset/Mixed/Digital_Camera/(C.S)C-outdoor1/003.JPG,char_data/a/003.JPG_6.jpg,209,480,640,11,316,327,261,280,True,31
a,20,kaist_dataset/Mixed/Digital_Camera/(C.S)C-outdoor1/003.JPG,char_data/a/003.JPG_7.jpg,240,480,640,12,522,534,253,273,True,31
a,18,kaist_dataset/Mixed/Digital_Camera/(C.S)C-outdoor1/003.JPG,char_data/a/003.JPG_8.jpg,162,480,640,9,116,125,271,289,True,31
a,24,kaist_dataset/Mixed/Digital_Camera/(C.S)C-outdoor1/021.JPG,char_data/a/021.JPG_4.jpg,288,480,640,12,466,478,140,164,True,31
a,32,kaist_dataset/Mixed/Digital_Camera/(C.S)C-outdoor1/080.JPG,char_data/a/080.JPG_5.jpg,864,480,640,27,76,103,76,108,True,31
a,111,kaist_dataset/Mixed/Digital_Camera/(C.S)C-outdoor1/080118-0014.jpg,char_data/a/080118-0014.jpg_2.jpg,10989,1200,1600,99,471,570,763,874,True,31
a,41,kaist_dataset/Mixed/Digital_Camera/(C.S)C-outdoor1/1.JPG,char_data/a/1.JPG_9.jpg,1148,576,768,28,449,477,7,48,True,31
a,37,kaist_dataset/Mixed/Digital_Camera/(C.S)C-outdoor1/1.JPG,char_data/a/1.JPG_10.jpg,814,576,768,22,744,766,11,48,True,31
a,26,kaist_dataset/Mixed/Digital_Camera/(C.S)C-outdoor1/115.JPG,char_data/a/115.JPG_2.jpg,442,480,640,17,313,330,281,307,True,31
a,33,kaist_dataset/Mixed/Digital_Camera/(C.S)C-outdoor1/130.JPG,char_data/a/130.JPG_2.jpg,1056,480,640,32,118,150,299,332,True,31
a,37,kaist_dataset/Mixed/Digital_Camera/(C.S)C-outdoor1/133.JPG,char_data/a/133.JPG_2.jpg,888,480,640,24,540,564,338,375,True,31
a,29,kaist_dataset/Mixed/Digital_Camera/(C.S)C-outdoor1/2.JPG,char_data/a/2.JPG_12.jpg,203,576,768,7,70,77,379,408,True,31
a,22,kaist_dataset/Mixed/Digital_Camera/(C.S)C-outdoor1/2.JPG,char_data/a/2.JPG_13.jpg,154,576,768,7,85,92,385,407,True,31
a,56,kaist_dataset/Mixed/Digital_Camera/(C.S)C-outdoor1/2007-12-08-day-106.jpg,char_data/a/2007-12-08-day-106.jpg_2.jpg,3192,1200,1600,57,1251,1308,759,815,True,31
a,52,kaist_dataset/Mixed/Digital_Camera/(C.S)C-outdoor1/2007-12-09-day-exterior-004.jpg,char_data/a/2007-12-09-day-exterior-004.jpg_4.jpg,2444,1200,1600,47,434,481,675,727,True,31
a,52,kaist_dataset/Mixed/Digital_Camera/(C.S)C-outdoor1/2007-12-09-day-exterior-004.jpg,char_data/a/2007-12-09-day-exterior-004.jpg_5.jpg,2444,1200,1600,47,578,625,672,724,True,31
a,34,kaist_dataset/Mixed/Digital_Camera/(C.S)C-outdoor1/47.JPG,char_data/a/47.JPG_2.jpg,816,576,768,24,343,367,183,217,True,31
a,36,kaist_dataset/Mixed/Digital_Camera/(C.S)C-outdoor1/51.JPG,char_data/a/51.JPG_2.jpg,1188,576,768,33,154,187,230,266,True,31
a,75,kaist_dataset/Mixed/Digital_Camera/(C.S)C-outdoor1/8.jpg,char_data/a/8.jpg_6.jpg,4275,400,766,57,29,86,166,241,True,31
a,71,kaist_dataset/Mixed/Digital_Camera/(C.S)C-outdoor1/8.jpg,char_data/a/8.jpg_7.jpg,3763,400,766,53,142,195,165,236,True,31
a,82,kaist_dataset/Mixed/Digital_Camera/(C.S)C-outdoor1/8.jpg,char_data/a/8.jpg_8.jpg,4428,400,766,54,249,303,157,239,True,31
a,31,kaist_dataset/Mixed/Digital_Camera/(C.S)C-outdoor1/DSC02242.JPG,char_data/a/DSC02242.JPG_2.jpg,341,480,640,11,225,236,166,197,True,31
a,30,kaist_dataset/Mixed/Digital_Camera/(C.S)C-outdoor1/DSC02318.JPG,char_data/a/DSC02318.JPG_2.jpg,660,480,640,22,487,509,324,354,True,31
a,20,kaist_dataset/Mixed/Digital_Camera/(C.S)C-outdoor1/DSC02319.JPG,char_data/a/DSC02319.JPG_2.jpg,280,480,640,14,121,135,281,301,True,31
a,64,kaist_dataset/Mixed/Digital_Camera/(C.S)C-outdoor1/DSC02344.JPG,char_data/a/DSC02344.JPG_2.jpg,2752,480,640,43,264,307,160,224,True,31
a,67,kaist_dataset/Mixed/Digital_Camera/(C.S)C-outdoor1/P1010008.JPG,char_data/a/P1010008.JPG_5.jpg,4288,480,640,64,512,576,250,317,True,31
a,51,kaist_dataset/Mixed/Digital_Camera/(C.S)C-outdoor2/DSC02382.JPG,char_data/a/DSC02382.JPG_2.jpg,1887,480,640,37,52,89,265,316,True,31
a,23,kaist_dataset/Mixed/Digital_Camera/(C.S)C-outdoor2/DSC02385.JPG,char_data/a/DSC02385.JPG_5.jpg,483,480,640,21,546,567,137,160,True,31
a,49,kaist_dataset/Mixed/Digital_Camera/(C.S)C-outdoor2/DSC02400.JPG,char_data/a/DSC02400.JPG_2.jpg,1715,480,640,35,500,535,324,373,True,31
a,66,kaist_dataset/Mixed/Digital_Camera/(C.S)C-outdoor2/DSC02418.JPG,char_data/a/DSC02418.JPG_2.jpg,3036,480,640,46,459,505,160,226,True,31
a,24,kaist_dataset/Mixed/Digital_Camera/(C.S)C-outdoor2/DSC02421.JPG,char_data/a/DSC02421.JPG_8.jpg,528,480,640,22,106,128,215,239,True,31
a,22,kaist_dataset/Mixed/Digital_Camera/(C.S)C-outdoor2/DSC02421.JPG,char_data/a/DSC02421.JPG_9.jpg,374,480,640,17,301,318,215,237,True,31
a,16,kaist_dataset/Mixed/Digital_Camera/(C.S)C-outdoor2/DSC02421.JPG,char_data/a/DSC02421.JPG_11.jpg,336,480,640,21,456,477,213,229,True,31
a,73,kaist_dataset/Mixed/Digital_Camera/(C.S)C-outdoor2/DSC02425.JPG,char_data/a/DSC02425.JPG_2.jpg,4234,480,640,58,327,385,168,241,True,31
a,24,kaist_dataset/Mixed/Digital_Camera/(C.S)C-outdoor2/DSC02430.JPG,char_data/a/DSC02430.JPG_2.jpg,360,480,640,15,115,130,189,213,True,31
a,52,kaist_dataset/Mixed/Digital_Camera/(C.S)C-outdoor2/DSC02433.JPG,char_data/a/DSC02433.JPG_2.jpg,2236,480,640,43,233,276,196,248,True,31
a,65,kaist_dataset/Mixed/Digital_Camera/(C.S)C-outdoor2/DSC02436.JPG,char_data/a/DSC02436.JPG_4.jpg,2535,480,640,39,193,232,185,250,True,31
a,68,kaist_dataset/Mixed/Digital_Camera/(C.S)C-outdoor2/DSC02436.JPG,char_data/a/DSC02436.JPG_5.jpg,2992,480,640,44,540,584,187,255,True,31
a,19,kaist_dataset/Mixed/Digital_Camera/(C.S)C-outdoor2/DSC02439.JPG,char_data/a/DSC02439.JPG_5.jpg,361,480,640,19,486,505,113,132,True,31
a,37,kaist_dataset/Mixed/Digital_Camera/(C.S)C-outdoor2/DSC02482.JPG,char_data/a/DSC02482.JPG_2.jpg,1147,480,640,31,66,97,272,309,True,31
a,41,kaist_dataset/Mixed/Digital_Camera/(C.S)C-outdoor2/DSC02519.JPG,char_data/a/DSC02519.JPG_2.jpg,1476,480,640,36,364,400,217,258,True,31
a,31,kaist_dataset/Mixed/Digital_Camera/(C.S)C-outdoor2/DSC02545.JPG,char_data/a/DSC02545.JPG_2.jpg,713,480,640,23,327,350,369,400,True,31
a,35,kaist_dataset/Mixed/Digital_Camera/(C.S)C-outdoor2/DSC02886.JPG,char_data/a/DSC02886.JPG_6.jpg,630,480,640,18,301,319,146,181,True,31
a,26,kaist_dataset/Mixed/Digital_Camera/(C.S)C-outdoor2/DSC02886.JPG,char_data/a/DSC02886.JPG_7.jpg,520,480,640,20,462,482,139,165,True,31
a,29,kaist_dataset/Mixed/Digital_Camera/(C.S)C-outdoor2/DSC02886.JPG,char_data/a/DSC02886.JPG_8.jpg,493,480,640,17,537,554,130,159,True,31
a,47,kaist_dataset/Mixed/Digital_Camera/(C.S)C-outdoor2/DSC02907.JPG,char_data/a/DSC02907.JPG_2.jpg,1880,480,640,40,362,402,97,144,True,31
a,42,kaist_dataset/Mixed/Digital_Camera/(C.S)C-outdoor2/DSC02926.JPG,char_data/a/DSC02926.JPG_2.jpg,1260,480,640,30,202,232,136,178,True,31
a,34,kaist_dataset/Mixed/Digital_Camera/(C.S)C-outdoor2/DSC02927.JPG,char_data/a/DSC02927.JPG_2.jpg,544,480,640,16,290,306,368,402,True,31
a,36,kaist_dataset/Mixed/Digital_Camera/(C.S)C-outdoor2/DSC02928.JPG,char_data/a/DSC02928.JPG_2.jpg,720,480,640,20,457,477,393,429,True,31
a,51,kaist_dataset/Mixed/Digital_Camera/(C.S)C-outdoor2/DSC02936.JPG,char_data/a/DSC02936.JPG_4.jpg,2601,480,640,51,129,180,135,186,True,31
a,54,kaist_dataset/Mixed/Digital_Camera/(C.S)C-outdoor2/DSC02936.JPG,char_data/a/DSC02936.JPG_5.jpg,2646,480,640,49,254,303,137,191,True,31
a,50,kaist_dataset/Mixed/Digital_Camera/(C.S)C-outdoor3/DSC02962.JPG,char_data/a/DSC02962.JPG_4.jpg,1850,480,640,37,440,477,233,283,True,31
a,53,kaist_dataset/Mixed/Digital_Camera/(C.S)C-outdoor3/DSC02962.JPG,char_data/a/DSC02962.JPG_5.jpg,1802,480,640,34,279,313,189,242,True,31
a,25,kaist_dataset/Mixed/Digital_Camera/(C.S)C-outdoor3/DSC02970.JPG,char_data/a/DSC02970.JPG_2.jpg,500,480,640,20,325,345,310,335,True,31
a,42,kaist_dataset/Mixed/Digital_Camera/(C.S)C-outdoor3/DSC02978.JPG,char_data/a/DSC02978.JPG_6.jpg,1008,480,640,24,83,107,160,202,True,31
a,40,kaist_dataset/Mixed/Digital_Camera/(C.S)C-outdoor3/DSC02978.JPG,char_data/a/DSC02978.JPG_7.jpg,1120,480,640,28,154,182,166,206,True,31
a,36,kaist_dataset/Mixed/Digital_Camera/(C.S)C-outdoor3/DSC02978.JPG,char_data/a/DSC02978.JPG_8.jpg,720,480,640,20,278,298,168,204,True,31
a,45,kaist_dataset/Mixed/Digital_Camera/(C.S)C-outdoor3/DSC02989.JPG,char_data/a/DSC02989.JPG_4.jpg,1575,480,640,35,477,512,207,252,True,31
a,92,kaist_dataset/Mixed/Digital_Camera/(C.S)C-outdoor3/DSC03017.JPG,char_data/a/DSC03017.JPG_2.jpg,8280,480,640,90,194,284,150,242,True,31
a,100,kaist_dataset/Mixed/Digital_Camera/(C.S)C-outdoor3/DSC03196.JPG,char_data/a/DSC03196.JPG_4.jpg,8700,480,640,87,359,446,290,390,True,31
a,104,kaist_dataset/Mixed/Digital_Camera/(C.S)C-outdoor3/DSC03196.JPG,char_data/a/DSC03196.JPG_5.jpg,9464,480,640,91,445,536,289,393,True,31
a,51,kaist_dataset/Mixed/Digital_Camera/(C.S)C-outdoor3/DSC03199.JPG,char_data/a/DSC03199.JPG_2.jpg,2040,480,640,40,50,90,335,386,True,31
a,30,kaist_dataset/Mixed/Digital_Camera/(C.S)C-outdoor3/DSC03209.JPG,char_data/a/DSC03209.JPG_7.jpg,870,480,640,29,362,391,420,450,True,31
a,32,kaist_dataset/Mixed/Digital_Camera/(C.S)C-outdoor3/DSC03209.JPG,char_data/a/DSC03209.JPG_8.jpg,1024,480,640,32,433,465,418,450,True,31
a,101,kaist_dataset/Mixed/Digital_Camera/(C.S)C-outdoor3/DSC03210.JPG,char_data/a/DSC03210.JPG_5.jpg,5959,480,640,59,273,332,244,345,True,31
a,32,kaist_dataset/Mixed/Digital_Camera/(C.S)C-outdoor3/DSC03227.JPG,char_data/a/DSC03227.JPG_4.jpg,512,480,640,16,147,163,108,140,True,31
a,33,kaist_dataset/Mixed/Digital_Camera/(C.S)C-outdoor3/DSC03227.JPG,char_data/a/DSC03227.JPG_5.jpg,561,480,640,17,212,229,104,137,True,31
a,51,kaist_dataset/Mixed/Digital_Camera/(C.S)C-outdoor3/DSC03242.JPG,char_data/a/DSC03242.JPG_2.jpg,2499,480,640,49,221,270,174,225,True,31
a,60,kaist_dataset/Mixed/Digital_Camera/(C.S)C-outdoor3/DSC03260.JPG,char_data/a/DSC03260.JPG_2.jpg,2940,480,640,49,91,140,82,142,True,31
a,30,kaist_dataset/Mixed/Digital_Camera/(C.S)C-outdoor3/DSC03271.JPG,char_data/a/DSC03271.JPG_2.jpg,600,480,640,20,290,310,81,111,True,31
a,47,kaist_dataset/Mixed/Digital_Camera/(C.S)C-outdoor3/DSC03310.JPG,char_data/a/DSC03310.JPG_2.jpg,2538,480,640,54,138,192,122,169,True,31
a,29,kaist_dataset/Mixed/Digital_Camera/(C.S)C-outdoor3/DSC03328.JPG,char_data/a/DSC03328.JPG_2.jpg,493,480,640,17,493,510,234,263,True,31
a,79,kaist_dataset/Mixed/Digital_Camera/(C.S)C-outdoor3/DSC03421.JPG,char_data/a/DSC03421.JPG_6.jpg,3081,480,640,39,133,172,228,307,True,31
a,78,kaist_dataset/Mixed/Digital_Camera/(C.S)C-outdoor3/DSC03421.JPG,char_data/a/DSC03421.JPG_7.jpg,3042,480,640,39,428,467,247,325,True,31
a,94,kaist_dataset/Mixed/Digital_Camera/(C.S)C-outdoor3/DSC03421.JPG,char_data/a/DSC03421.JPG_8.jpg,6486,480,640,69,247,316,86,180,True,31
a,70,kaist_dataset/Mixed/Digital_Camera/(C.S)C-outdoor3/DSC03422.JPG,char_data/a/DSC03422.JPG_6.jpg,1890,480,640,27,152,179,237,307,True,31
a,62,kaist_dataset/Mixed/Digital_Camera/(C.S)C-outdoor3/DSC03422.JPG,char_data/a/DSC03422.JPG_8.jpg,1364,480,640,22,345,367,258,320,True,31
a,75,kaist_dataset/Mixed/Digital_Camera/(C.S)C-outdoor3/P1010016.JPG,char_data/a/P1010016.JPG_2.jpg,3150,480,640,42,298,340,179,254,True,31
a,81,kaist_dataset/Mixed/Digital_Camera/(C.S)C-outdoor4/DSC03519.JPG,char_data/a/DSC03519.JPG_2.jpg,6804,480,640,84,440,524,116,197,True,31
a,34,kaist_dataset/Mixed/Digital_Camera/(C.S)C-outdoor4/DSC03556.JPG,char_data/a/DSC03556.JPG_8.jpg,374,480,640,11,158,169,319,353,True,31
a,29,kaist_dataset/Mixed/Digital_Camera/(C.S)C-outdoor4/DSC03556.JPG,char_data/a/DSC03556.JPG_9.jpg,319,480,640,11,255,266,319,348,True,31
a,25,kaist_dataset/Mixed/Digital_Camera/(C.S)C-outdoor4/DSC03556.JPG,char_data/a/DSC03556.JPG_10.jpg,275,480,640,11,489,500,326,351,True,31
a,28,kaist_dataset/Mixed/Digital_Camera/(C.S)C-outdoor4/DSC03556.JPG,char_data/a/DSC03556.JPG_11.jpg,336,480,640,12,614,626,325,353,True,31
a,44,kaist_dataset/Mixed/Digital_Camera/(C.S)C-outdoor4/DSC03571.JPG,char_data/a/DSC03571.JPG_5.jpg,968,480,640,22,537,559,300,344,True,31
a,34,kaist_dataset/Mixed/Digital_Camera/(C.S)C-outdoor4/DSC03586.JPG,char_data/a/DSC03586.JPG_4.jpg,680,480,640,20,149,169,157,191,True,31
a,36,kaist_dataset/Mixed/Digital_Camera/(C.S)C-outdoor4/DSC03586.JPG,char_data/a/DSC03586.JPG_5.jpg,828,480,640,23,325,348,160,196,True,31
a,60,kaist_dataset/Mixed/Digital_Camera/(C.S)C-outdoor4/DSC03635.JPG,char_data/a/DSC03635.JPG_2.jpg,3000,480,640,50,422,472,171,231,True,31
a,62,kaist_dataset/Mixed/Digital_Camera/(C.S)C-outdoor4/DSC03638.JPG,char_data/a/DSC03638.JPG_2.jpg,2666,480,640,43,419,462,120,182,True,31
a,42,kaist_dataset/Mixed/Digital_Camera/(C.S)C-outdoor4/DSC03642.JPG,char_data/a/DSC03642.JPG_4.jpg,966,480,640,23,274,297,253,295,True,31
a,38,kaist_dataset/Mixed/Digital_Camera/(C.S)C-outdoor4/DSC03642.JPG,char_data/a/DSC03642.JPG_5.jpg,760,480,640,20,379,399,249,287,True,31
a,53,kaist_dataset/Mixed/Digital_Camera/(C.S)C-outdoor4/DSC03643.JPG,char_data/a/DSC03643.JPG_2.jpg,2279,480,640,43,203,246,260,313,True,31
a,24,kaist_dataset/Mixed/Digital_Camera/(C.S)C-outdoor4/DSC03661.JPG,char_data/a/DSC03661.JPG_2.jpg,408,480,640,17,103,120,276,300,True,31
a,27,kaist_dataset/Mixed/Digital_Camera/(C.S)C-outdoor4/DSC03670.JPG,char_data/a/DSC03670.JPG_6.jpg,378,480,640,14,255,269,323,350,True,31
a,25,kaist_dataset/Mixed/Digital_Camera/(C.S)C-outdoor4/DSC03670.JPG,char_data/a/DSC03670.JPG_7.jpg,375,480,640,15,463,478,319,344,True,31
a,23,kaist_dataset/Mixed/Digital_Camera/(C.S)C-outdoor4/DSC03670.JPG,char_data/a/DSC03670.JPG_8.jpg,368,480,640,16,503,519,321,344,True,31
a,35,kaist_dataset/Mixed/Digital_Camera/(C.S)C-outdoor4/DSC03672.JPG,char_data/a/DSC03672.JPG_2.jpg,840,480,640,24,203,227,410,445,True,31
a,27,kaist_dataset/Mixed/Digital_Camera/(C.S)C-outdoor4/DSC03682.JPG,char_data/a/DSC03682.JPG_2.jpg,459,480,640,17,492,509,329,356,True,31
a,30,kaist_dataset/Mixed/Digital_Camera/(C.S)C-outdoor4/DSC03718.JPG,char_data/a/DSC03718.JPG_8.jpg,390,480,640,13,299,312,98,128,True,31
a,34,kaist_dataset/Mixed/Digital_Camera/(C.S)C-outdoor4/DSC03718.JPG,char_data/a/DSC03718.JPG_9.jpg,442,480,640,13,68,81,258,292,True,31
a,27,kaist_dataset/Mixed/Digital_Camera/(C.S)C-outdoor4/DSC03718.JPG,char_data/a/DSC03718.JPG_10.jpg,459,480,640,17,112,129,264,291,True,31
a,34,kaist_dataset/Mixed/Digital_Camera/(C.S)C-outdoor4/DSC03718.JPG,char_data/a/DSC03718.JPG_11.jpg,578,480,640,17,166,183,259,293,True,31
a,30,kaist_dataset/Mixed/Digital_Camera/(C.S)C-outdoor4/DSC03719.JPG,char_data/a/DSC03719.JPG_6.jpg,480,480,640,16,70,86,33,63,True,31
a,31,kaist_dataset/Mixed/Digital_Camera/(C.S)C-outdoor4/DSC03719.JPG,char_data/a/DSC03719.JPG_7.jpg,434,480,640,14,120,134,33,64,True,31
a,32,kaist_dataset/Mixed/Digital_Camera/(C.S)C-outdoor4/DSC03719.JPG,char_data/a/DSC03719.JPG_8.jpg,480,480,640,15,173,188,35,67,True,31
a,46,kaist_dataset/Mixed/Digital_Camera/(C.S)C-outdoor4/DSC03730.JPG,char_data/a/DSC03730.JPG_2.jpg,1932,480,640,42,263,305,346,392,True,31
a,62,kaist_dataset/Mixed/Digital_Camera/(C.S)C-outdoor4/DSC03733.JPG,char_data/a/DSC03733.JPG_2.jpg,2914,480,640,47,271,318,218,280,True,31
a,55,kaist_dataset/Mixed/Digital_Camera/(C.S)C-outdoor4/DSC03784.JPG,char_data/a/DSC03784.JPG_4.jpg,1650,480,640,30,429,459,323,378,True,31
a,60,kaist_dataset/Mixed/Digital_Camera/(C.S)C-outdoor4/DSC03784.JPG,char_data/a/DSC03784.JPG_5.jpg,2280,480,640,38,516,554,317,377,True,31
a,35,kaist_dataset/Mixed/Digital_Camera/(C.S)C-outdoor5/DSC03821.JPG,char_data/a/DSC03821.JPG_4.jpg,770,480,640,22,50,72,35,70,True,31
a,39,kaist_dataset/Mixed/Digital_Camera/(C.S)C-outdoor5/DSC03821.JPG,char_data/a/DSC03821.JPG_5.jpg,858,480,640,22,138,160,32,71,True,31
a,33,kaist_dataset/Mixed/Digital_Camera/(C.S)C-outdoor5/DSC03839.JPG,char_data/a/DSC03839.JPG_2.jpg,495,480,640,15,367,382,37,70,True,31
a,74,kaist_dataset/Mixed/Digital_Camera/(C.S)C-outdoor5/DSC04030.JPG,char_data/a/DSC04030.JPG_2.jpg,4218,480,640,57,209,266,184,258,True,31
a,27,kaist_dataset/Mixed/Digital_Camera/(C.S)C-outdoor5/DSC04057.JPG,char_data/a/DSC04057.JPG_4.jpg,459,480,640,17,266,283,120,147,True,31
a,34,kaist_dataset/Mixed/Digital_Camera/(C.S)C-outdoor5/DSC04057.JPG,char_data/a/DSC04057.JPG_5.jpg,680,480,640,20,317,337,117,151,True,31
a,24,kaist_dataset/Mixed/Digital_Camera/(C.S)C-outdoor5/DSC04076.JPG,char_data/a/DSC04076.JPG_4.jpg,456,480,640,19,404,423,403,427,True,31
a,26,kaist_dataset/Mixed/Digital_Camera/(C.S)C-outdoor5/DSC04076.JPG,char_data/a/DSC04076.JPG_5.jpg,312,480,640,12,463,475,401,427,True,31
a,69,kaist_dataset/Mixed/Digital_Camera/(C.S)C-outdoor5/DSC04115.JPG,char_data/a/DSC04115.JPG_2.jpg,3174,480,640,46,130,176,210,279,True,31
a,30,kaist_dataset/Mixed/Digital_Camera/(C.S)C-outdoor5/DSC04151.JPG,char_data/a/DSC04151.JPG_2.jpg,600,480,640,20,92,112,339,369,True,31
a,42,kaist_dataset/Mixed/Digital_Camera/(C.S)C-outdoor5/DSC04154.JPG,char_data/a/DSC04154.JPG_2.jpg,1092,480,640,26,491,517,236,278,True,31
a,32,kaist_dataset/Mixed/Digital_Camera/(C.S)C-outdoor5/DSC04290.JPG,char_data/a/DSC04290.JPG_2.jpg,544,480,640,17,134,151,381,413,True,31
a,35,kaist_dataset/Mixed/Digital_Camera/(C.S)C-outdoor5/DSC04321.JPG,char_data/a/DSC04321.JPG_6.jpg,875,480,640,25,168,193,194,229,True,31
a,31,kaist_dataset/Mixed/Digital_Camera/(C.S)C-outdoor5/DSC04321.JPG,char_data/a/DSC04321.JPG_7.jpg,713,480,640,23,263,286,204,235,True,31
a,32,kaist_dataset/Mixed/Digital_Camera/(C.S)C-outdoor5/DSC04321.JPG,char_data/a/DSC04321.JPG_8.jpg,640,480,640,20,356,376,203,235,True,31
a,46,kaist_dataset/Mixed/Digital_Camera/(C.S)C-outdoor5/DSC04322.JPG,char_data/a/DSC04322.JPG_6.jpg,966,480,640,21,64,85,212,258,True,31
a,42,kaist_dataset/Mixed/Digital_Camera/(C.S)C-outdoor5/DSC04322.JPG,char_data/a/DSC04322.JPG_7.jpg,840,480,640,20,159,179,219,261,True,31
a,39,kaist_dataset/Mixed/Digital_Camera/(C.S)C-outdoor5/DSC04322.JPG,char_data/a/DSC04322.JPG_8.jpg,819,480,640,21,363,384,223,262,True,31
a,37,kaist_dataset/Mixed/Digital_Camera/(C.S)C-outdoor5/DSC04323.JPG,char_data/a/DSC04323.JPG_4.jpg,703,480,640,19,132,151,200,237,True,31
a,28,kaist_dataset/Mixed/Digital_Camera/(C.S)C-outdoor5/DSC04323.JPG,char_data/a/DSC04323.JPG_5.jpg,588,480,640,21,209,230,207,235,True,31
a,38,kaist_dataset/Mixed/Digital_Camera/(C.S)C-outdoor5/DSC04338.JPG,char_data/a/DSC04338.JPG_10.jpg,950,480,640,25,303,328,198,236,True,31
a,40,kaist_dataset/Mixed/Digital_Camera/(C.S)C-outdoor5/DSC04338.JPG,char_data/a/DSC04338.JPG_11.jpg,800,480,640,20,551,571,199,239,True,31
a,24,kaist_dataset/Mixed/Digital_Camera/(C.S)C-outdoor5/DSC04357.JPG,char_data/a/DSC04357.JPG_9.jpg,384,480,640,16,339,355,356,380,True,31
a,25,kaist_dataset/Mixed/Digital_Camera/(C.S)C-outdoor5/DSC04357.JPG,char_data/a/DSC04357.JPG_10.jpg,375,480,640,15,367,382,353,378,True,31
a,22,kaist_dataset/Mixed/Digital_Camera/(C.S)C-outdoor5/DSC04357.JPG,char_data/a/DSC04357.JPG_11.jpg,330,480,640,15,395,410,358,380,True,31
a,55,kaist_dataset/Mixed/Digital_Camera/(C.S)C-outdoor5/DSC04399.JPG,char_data/a/DSC04399.JPG_4.jpg,1870,480,640,34,377,411,211,266,True,31
a,50,kaist_dataset/Mixed/Digital_Camera/(C.S)C-outdoor5/DSC04399.JPG,char_data/a/DSC04399.JPG_5.jpg,1900,480,640,38,385,423,283,333,True,31
a,36,kaist_dataset/Mixed/Digital_Camera/(C.S)C-outdoor5/DSC04429.JPG,char_data/a/DSC04429.JPG_2.jpg,576,480,640,16,203,219,257,293,False,31
a,48,kaist_dataset/Mixed/Digital_Camera/(C.S)C-outdoor5/DSC04456.JPG,char_data/a/DSC04456.JPG_2.jpg,1680,480,640,35,449,484,168,216,False,31
a,140,kaist_dataset/Mixed/Digital_Camera/(C.S)C-outdoor6/080116-0057.jpg,char_data/a/080116-0057.jpg_7.jpg,17500,1200,1600,125,412,537,577,717,False,31
a,42,kaist_dataset/Mixed/Digital_Camera/(C.S)C-outdoor6/080116-0057.jpg,char_data/a/080116-0057.jpg_8.jpg,1218,1200,1600,29,244,273,924,966,False,31
a,33,kaist_dataset/Mixed/Digital_Camera/(C.S)C-outdoor6/090.jpg,char_data/a/090.jpg_5.jpg,792,480,640,24,233,257,158,191,False,31
a,29,kaist_dataset/Mixed/Digital_Camera/(C.S)C-outdoor6/P1010021.JPG,char_data/a/P1010021.JPG_2.jpg,638,480,640,22,502,524,214,243,False,31
a,33,kaist_dataset/Mixed/Digital_Camera/(C.S)C-outdoor6/P1010048.JPG,char_data/a/P1010048.JPG_4.jpg,462,480,640,14,506,520,170,203,False,31
a,34,kaist_dataset/Mixed/Digital_Camera/(C.S)C-outdoor6/P1010048.JPG,char_data/a/P1010048.JPG_5.jpg,680,480,640,20,574,594,173,207,False,31
a,89,kaist_dataset/Mixed/Digital_Camera/(C.S)C-outdoor6/P1010093.JPG,char_data/a/P1010093.JPG_2.jpg,9167,480,640,103,269,372,135,224,False,31
a,61,kaist_dataset/Mixed/Digital_Camera/(C.S)C-outdoor6/P1010116.JPG,char_data/a/P1010116.JPG_2.jpg,1098,480,640,18,337,355,204,265,False,31
a,24,kaist_dataset/Mixed/Digital_Camera/(C.S)C-outdoor6/P1010132.JPG,char_data/a/P1010132.JPG_2.jpg,336,480,640,14,142,156,109,133,False,31
a,20,kaist_dataset/Mixed/Digital_Camera/(C.S)C-outdoor6/P1010138.JPG,char_data/a/P1010138.JPG_5.jpg,380,480,640,19,131,150,184,204,False,31
a,25,kaist_dataset/Mixed/Digital_Camera/(C.S)C-outdoor6/크기변환_P1010029.JPG,char_data/a/크기변환_P1010029.JPG_6.jpg,375,480,640,15,127,142,21,46,False,31
a,24,kaist_dataset/Mixed/Digital_Camera/(C.S)C-outdoor6/크기변환_P1010029.JPG,char_data/a/크기변환_P1010029.JPG_7.jpg,336,480,640,14,178,192,21,45,False,31
a,26,kaist_dataset/Mixed/Digital_Camera/(C.S)C-outdoor6/크기변환_P1010029.JPG,char_data/a/크기변환_P1010029.JPG_8.jpg,390,480,640,15,330,345,20,46,False,31
a,33,kaist_dataset/Mixed/Digital_Camera/(C.S)D-indoor1/082.JPG,char_data/a/082.JPG_5.jpg,891,480,640,27,222,249,187,220,False,31
a,32,kaist_dataset/Mixed/Digital_Camera/(C.S)D-indoor1/DSC02718.JPG,char_data/a/DSC02718.JPG_2.jpg,384,480,640,12,182,194,241,273,False,31
a,54,kaist_dataset/Mixed/Digital_Camera/(C.S)D-indoor1/DSC02770.JPG,char_data/a/DSC02770.JPG_2.jpg,2160,480,640,40,372,412,357,411,False,31
a,31,kaist_dataset/Mixed/Digital_Camera/(C.S)D-indoor1/DSC02787.JPG,char_data/a/DSC02787.JPG_4.jpg,496,480,640,16,263,279,380,411,False,31
a,36,kaist_dataset/Mixed/Digital_Camera/(C.S)D-indoor1/DSC02787.JPG,char_data/a/DSC02787.JPG_5.jpg,684,480,640,19,333,352,372,408,False,31
a,35,kaist_dataset/Mixed/Digital_Camera/(C.S)D-indoor1/DSC03073.JPG,char_data/a/DSC03073.JPG_2.jpg,805,480,640,23,283,306,292,327,False,31
a,30,kaist_dataset/Mixed/Digital_Camera/(C.S)D-indoor1/DSC03096.JPG,char_data/a/DSC03096.JPG_6.jpg,540,480,640,18,82,100,423,453,False,31
a,32,kaist_dataset/Mixed/Digital_Camera/(C.S)D-indoor1/DSC03096.JPG,char_data/a/DSC03096.JPG_7.jpg,544,480,640,17,112,129,423,455,False,31
a,35,kaist_dataset/Mixed/Digital_Camera/(C.S)D-indoor1/DSC03096.JPG,char_data/a/DSC03096.JPG_8.jpg,560,480,640,16,384,400,425,460,False,31
a,39,kaist_dataset/Mixed/Digital_Camera/(C.S)D-indoor1/DSC03118.JPG,char_data/a/DSC03118.JPG_8.jpg,975,480,640,25,225,250,156,195,False,31
a,40,kaist_dataset/Mixed/Digital_Camera/(C.S)D-indoor1/DSC03118.JPG,char_data/a/DSC03118.JPG_9.jpg,1000,480,640,25,334,359,153,193,False,31
a,40,kaist_dataset/Mixed/Digital_Camera/(C.S)D-indoor1/DSC03118.JPG,char_data/a/DSC03118.JPG_10.jpg,1000,480,640,25,464,489,155,195,False,31
a,39,kaist_dataset/Mixed/Digital_Camera/(C.S)D-indoor1/DSC03118.JPG,char_data/a/DSC03118.JPG_11.jpg,1053,480,640,27,185,212,230,269,False,31
a,41,kaist_dataset/Mixed/Digital_Camera/(C.S)D-indoor1/DSC03119.JPG,char_data/a/DSC03119.JPG_2.jpg,1189,480,640,29,305,334,168,209,False,31
a,48,kaist_dataset/Mixed/Digital_Camera/(C.S)D-indoor1/DSC03121.JPG,char_data/a/DSC03121.JPG_2.jpg,1536,480,640,32,328,360,205,253,False,31
a,48,kaist_dataset/Mixed/Digital_Camera/(C.S)D-indoor1/DSC03123.JPG,char_data/a/DSC03123.JPG_4.jpg,1536,480,640,32,250,282,181,229,False,31
a,42,kaist_dataset/Mixed/Digital_Camera/(C.S)D-indoor1/DSC03123.JPG,char_data/a/DSC03123.JPG_5.jpg,1218,480,640,29,399,428,181,223,False,31
a,42,kaist_dataset/Mixed/Digital_Camera/(C.S)D-indoor1/DSC03125.JPG,char_data/a/DSC03125.JPG_2.jpg,1386,480,640,33,256,289,189,231,False,31
a,44,kaist_dataset/Mixed/Digital_Camera/(C.S)D-indoor1/DSC03126.JPG,char_data/a/DSC03126.JPG_2.jpg,1452,480,640,33,337,370,221,265,False,31
a,58,kaist_dataset/Mixed/Digital_Camera/(C.S)D-indoor1/DSC03130.JPG,char_data/a/DSC03130.JPG_4.jpg,2378,480,640,41,273,314,172,230,False,31
a,48,kaist_dataset/Mixed/Digital_Camera/(C.S)D-indoor1/DSC03130.JPG,char_data/a/DSC03130.JPG_5.jpg,1920,480,640,40,399,439,178,226,False,31
a,36,kaist_dataset/Mixed/Digital_Camera/(C.S)D-indoor1/DSC03131.JPG,char_data/a/DSC03131.JPG_2.jpg,1188,480,640,33,416,449,142,178,False,31
a,48,kaist_dataset/Mixed/Digital_Camera/(C.S)D-indoor1/DSC03133.JPG,char_data/a/DSC03133.JPG_2.jpg,1584,480,640,33,184,217,148,196,False,31
a,37,kaist_dataset/Mixed/Digital_Camera/(C.S)D-indoor1/DSC03134.JPG,char_data/a/DSC03134.JPG_2.jpg,1036,480,640,28,379,407,171,208,False,31
a,46,kaist_dataset/Mixed/Digital_Camera/(C.S)D-indoor1/DSC03135.JPG,char_data/a/DSC03135.JPG_2.jpg,1702,480,640,37,390,427,197,243,False,31
a,50,kaist_dataset/Mixed/Digital_Camera/(C.S)D-indoor1/DSC03455.JPG,char_data/a/DSC03455.JPG_2.jpg,1350,480,640,27,288,315,398,448,False,31
a,34,kaist_dataset/Mixed/Digital_Camera/(C.S)D-indoor1/DSC03466.JPG,char_data/a/DSC03466.JPG_2.jpg,748,480,640,22,339,361,235,269,False,31
a,80,kaist_dataset/Mixed/Digital_Camera/(C.S)D-indoor1/DSC03469.JPG,char_data/a/DSC03469.JPG_2.jpg,5360,480,640,67,293,360,348,428,False,31
a,43,kaist_dataset/Mixed/Digital_Camera/(C.S)D-indoor1/DSC03912.JPG,char_data/a/DSC03912.JPG_2.jpg,1247,480,640,29,316,345,46,89,False,31
a,57,kaist_dataset/Mixed/Digital_Camera/(C.S)D-indoor1/DSC03925.JPG,char_data/a/DSC03925.JPG_4.jpg,1938,480,640,34,356,390,380,437,False,31
a,53,kaist_dataset/Mixed/Digital_Camera/(C.S)D-indoor1/DSC03925.JPG,char_data/a/DSC03925.JPG_5.jpg,2120,480,640,40,417,457,383,436,False,31
a,35,kaist_dataset/Mixed/Digital_Camera/(C.S)D-indoor1/DSC04206.JPG,char_data/a/DSC04206.JPG_2.jpg,490,480,640,14,245,259,287,322,False,31
a,40,kaist_dataset/Mixed/Digital_Camera/(C.S)D-indoor1/DSC04246.JPG,char_data/a/DSC04246.JPG_6.jpg,760,480,640,19,203,222,250,290,False,31
a,32,kaist_dataset/Mixed/Digital_Camera/(C.S)D-indoor1/DSC04246.JPG,char_data/a/DSC04246.JPG_7.jpg,480,480,640,15,369,384,250,282,False,31
a,32,kaist_dataset/Mixed/Digital_Camera/(C.S)D-indoor1/DSC04246.JPG,char_data/a/DSC04246.JPG_8.jpg,448,480,640,14,489,503,249,281,False,31
a,39,kaist_dataset/Mixed/Digital_Camera/(C.S)D-indoor2/DSC04249.JPG,char_data/a/DSC04249.JPG_2.jpg,975,480,640,25,205,230,218,257,False,31
a,34,kaist_dataset/Mixed/Digital_Camera/(C.S)D-indoor2/DSC04254.JPG,char_data/a/DSC04254.JPG_6.jpg,578,480,640,17,184,201,344,378,False,31
a,28,kaist_dataset/Mixed/Digital_Camera/(C.S)D-indoor2/DSC04254.JPG,char_data/a/DSC04254.JPG_7.jpg,476,480,640,17,264,281,347,375,False,31
a,35,kaist_dataset/Mixed/Digital_Camera/(C.S)D-indoor2/DSC04254.JPG,char_data/a/DSC04254.JPG_8.jpg,630,480,640,18,400,418,341,376,False,31
a,40,kaist_dataset/Mixed/Digital_Camera/(C.S)E-night/DSC02574.JPG,char_data/a/DSC02574.JPG_7.jpg,1040,480,640,26,449,475,155,195,False,31
a,36,kaist_dataset/Mixed/Digital_Camera/(C.S)E-night/DSC02574.JPG,char_data/a/DSC02574.JPG_8.jpg,972,480,640,27,520,547,152,188,False,31
a,97,kaist_dataset/Mixed/Digital_Camera/(C.S)E-night/DSC02586.JPG,char_data/a/DSC02586.JPG_2.jpg,8730,480,640,90,191,281,265,362,False,31
a,42,kaist_dataset/Mixed/Digital_Camera/(C.S)E-night/DSC02647.JPG,char_data/a/DSC02647.JPG_2.jpg,1932,480,640,46,288,334,200,242,False,31
a,23,kaist_dataset/Mixed/Digital_Camera/(C.S)E-night/DSC03516.JPG,char_data/a/DSC03516.JPG_2.jpg,437,480,640,19,137,156,114,137,False,31
a,49,kaist_dataset/Mixed/Digital_Camera/(C.S)F-others/047.jpg,char_data/a/047.jpg_2.jpg,1813,252,339,37,125,162,72,121,False,31
a,83,kaist_dataset/Mixed/Digital_Camera/(C.S)F-others/2007-12-08-day-044.jpg,char_data/a/2007-12-08-day-044.jpg_2.jpg,4814,1200,1600,58,327,385,429,512,False,31
a,68,kaist_dataset/Mixed/Mobile_Phone/(C.M)A-outdoor/P090912037.jpg,char_data/a/P090912037.jpg_2.jpg,3264,480,640,48,156,204,173,241,False,31
a,34,kaist_dataset/Mixed/Mobile_Phone/(C.M)A-outdoor/P090912062.jpg,char_data/a/P090912062.jpg_4.jpg,646,480,640,19,498,517,126,160,False,31
a,30,kaist_dataset/Mixed/Mobile_Phone/(C.M)A-outdoor/P090912062.jpg,char_data/a/P090912062.jpg_5.jpg,510,480,640,17,616,633,125,155,False,31
a,34,kaist_dataset/Mixed/Mobile_Phone/(C.M)A-outdoor/P090912078.jpg,char_data/a/P090912078.jpg_4.jpg,1020,480,640,30,282,312,308,342,False,31
a,37,kaist_dataset/Mixed/Mobile_Phone/(C.M)A-outdoor/P090912078.jpg,char_data/a/P090912078.jpg_5.jpg,1036,480,640,28,364,392,296,333,False,31
a,43,kaist_dataset/Mixed/Mobile_Phone/(C.M)B-indoor/P090831012.jpg,char_data/a/P090831012.jpg_4.jpg,1419,480,640,33,242,275,181,224,False,31
a,41,kaist_dataset/Mixed/Mobile_Phone/(C.M)B-indoor/P090831012.jpg,char_data/a/P090831012.jpg_5.jpg,1312,480,640,32,352,384,184,225,False,31
a,41,kaist_dataset/Mixed/Mobile_Phone/(C.M)B-indoor/P090831013.jpg,char_data/a/P090831013.jpg_4.jpg,1312,480,640,32,347,379,200,241,False,31
a,44,kaist_dataset/Mixed/Mobile_Phone/(C.M)B-indoor/P090831013.jpg,char_data/a/P090831013.jpg_5.jpg,1540,480,640,35,455,490,201,245,False,31
a,53,kaist_dataset/Mixed/Mobile_Phone/(C.M)B-indoor/P090831015.jpg,char_data/a/P090831015.jpg_2.jpg,1961,480,640,37,155,192,209,262,False,31
a,47,kaist_dataset/Mixed/Mobile_Phone/(C.M)B-indoor/P090831017.jpg,char_data/a/P090831017.jpg_2.jpg,1786,480,640,38,358,396,248,295,False,31
a,47,kaist_dataset/Mixed/Mobile_Phone/(C.M)B-indoor/P090831023.jpg,char_data/a/P090831023.jpg_2.jpg,2115,480,640,45,298,343,278,325,False,31
a,38,kaist_dataset/Mixed/Mobile_Phone/(C.M)C-bookCover/P090831080.jpg,char_data/a/P090831080.jpg_4.jpg,912,480,640,24,282,306,337,375,False,31
a,30,kaist_dataset/Mixed/Mobile_Phone/(C.M)C-bookCover/P090831080.jpg,char_data/a/P090831080.jpg_5.jpg,960,480,640,32,321,353,378,408,False,31
a,46,kaist_dataset/Mixed/Mobile_Phone/(C.M)C-bookCover/P090831113.jpg,char_data/a/P090831113.jpg_2.jpg,1564,480,640,34,424,458,247,293,False,31
a,24,kaist_dataset/Mixed/Mobile_Phone/(C.M)C-bookCover/P090831115.jpg,char_data/a/P090831115.jpg_5.jpg,504,480,640,21,300,321,181,205,False,31
a,32,kaist_dataset/Mixed/Mobile_Phone/(C.M)C-bookCover/P090831118.jpg,char_data/a/P090831118.jpg_4.jpg,640,480,640,20,133,153,222,254,False,31
a,39,kaist_dataset/Mixed/Mobile_Phone/(C.M)C-bookCover/P090831118.jpg,char_data/a/P090831118.jpg_5.jpg,897,480,640,23,244,267,218,257,False,31
a,45,kaist_dataset/Mixed/Mobile_Phone/(C.M)C-bookCover/P090831121.jpg,char_data/a/P090831121.jpg_2.jpg,1620,480,640,36,303,339,323,368,False,31
a,47,kaist_dataset/Mixed/Mobile_Phone/(C.M)C-bookCover/P090831122.jpg,char_data/a/P090831122.jpg_2.jpg,1645,480,640,35,365,400,269,316,False,31
a,44,kaist_dataset/Mixed/Mobile_Phone/(C.M)C-bookCover/P090831124.jpg,char_data/a/P090831124.jpg_5.jpg,1144,480,640,26,255,281,402,446,False,31
a,49,kaist_dataset/Mixed/Mobile_Phone/(C.M)C-bookCover/P090831125.jpg,char_data/a/P090831125.jpg_4.jpg,1470,480,640,30,296,326,277,326,False,31
a,46,kaist_dataset/Mixed/Mobile_Phone/(C.M)C-bookCover/P090831125.jpg,char_data/a/P090831125.jpg_5.jpg,1610,480,640,35,356,391,277,323,False,31
a,55,kaist_dataset/Mixed/Mobile_Phone/(C.M)C-bookCover/P090831126.jpg,char_data/a/P090831126.jpg_4.jpg,1980,480,640,36,269,305,287,342,False,31
a,51,kaist_dataset/Mixed/Mobile_Phone/(C.M)C-bookCover/P090831126.jpg,char_data/a/P090831126.jpg_5.jpg,1785,480,640,35,340,375,292,343,False,31
a,38,kaist_dataset/Mixed/Mobile_Phone/(C.M)C-bookCover/P090902016.jpg,char_data/a/P090902016.jpg_4.jpg,988,480,640,26,331,357,140,178,False,31
a,25,kaist_dataset/Mixed/Mobile_Phone/(C.M)C-bookCover/P090902016.jpg,char_data/a/P090902016.jpg_5.jpg,500,480,640,20,207,227,279,304,False,31
a,42,kaist_dataset/Mixed/Mobile_Phone/(C.M)C-bookCover/P090902019.jpg,char_data/a/P090902019.jpg_2.jpg,1554,480,640,37,353,390,303,345,False,31
a,30,kaist_dataset/Mixed/Mobile_Phone/(C.M)C-bookCover/P090903024.jpg,char_data/a/P090903024.jpg_2.jpg,750,480,640,25,460,485,228,258,False,31
a,46,kaist_dataset/Mixed/Mobile_Phone/(C.M)C-bookCover/P090903083.jpg,char_data/a/P090903083.jpg_4.jpg,1978,480,640,43,112,155,178,224,False,31
a,35,kaist_dataset/Mixed/Mobile_Phone/(C.M)C-bookCover/P090904005.jpg,char_data/a/P090904005.jpg_2.jpg,945,480,640,27,295,322,119,154,False,31
6,22,kaist_dataset/English/Digital_Camera/(E.S)C-outdoor1/042.JPG,char_data/6/042.JPG_2.jpg,374,480,640,17,502,519,321,343,True,8
6,28,kaist_dataset/English/Digital_Camera/(E.S)C-outdoor1/056.JPG,char_data/6/056.JPG_2.jpg,224,480,640,8,530,538,250,278,True,8
6,94,kaist_dataset/English/Digital_Camera/(E.S)C-outdoor1/DSC02491.JPG,char_data/6/DSC02491.JPG_2.jpg,4888,480,640,52,286,338,307,401,True,8
6,43,kaist_dataset/English/Digital_Camera/(E.S)C-outdoor2/DSC03053.JPG,char_data/6/DSC03053.JPG_2.jpg,1247,480,640,29,361,390,128,171,True,8
6,35,kaist_dataset/English/Digital_Camera/(E.S)C-outdoor2/DSC03162.JPG,char_data/6/DSC03162.JPG_4.jpg,595,480,640,17,440,457,147,182,True,8
6,32,kaist_dataset/English/Digital_Camera/(E.S)C-outdoor2/DSC03162.JPG,char_data/6/DSC03162.JPG_5.jpg,576,480,640,18,469,487,150,182,True,8
6,35,kaist_dataset/English/Digital_Camera/(E.S)C-outdoor2/DSC03436.JPG,char_data/6/DSC03436.JPG_2.jpg,945,480,640,27,414,441,124,159,True,8
6,64,kaist_dataset/English/Digital_Camera/(E.S)C-outdoor2/DSC03650.JPG,char_data/6/DSC03650.JPG_4.jpg,2176,480,640,34,208,242,284,348,True,8
6,56,kaist_dataset/English/Digital_Camera/(E.S)C-outdoor2/DSC03650.JPG,char_data/6/DSC03650.JPG_5.jpg,1624,480,640,29,330,359,292,348,True,8
6,50,kaist_dataset/English/Digital_Camera/(E.S)C-outdoor3/P1010086.JPG,char_data/6/P1010086.JPG_4.jpg,1550,480,640,31,574,605,95,145,True,8
6,48,kaist_dataset/English/Digital_Camera/(E.S)C-outdoor3/P1010086.JPG,char_data/6/P1010086.JPG_5.jpg,1104,480,640,23,525,548,94,142,True,8
6,92,kaist_dataset/English/Digital_Camera/(E.S)D-indoor/DSC03087.JPG,char_data/6/DSC03087.JPG_2.jpg,7912,480,640,86,324,410,137,229,True,8
6,57,kaist_dataset/English/Digital_Camera/(E.S)E-night/DSC02610.JPG,char_data/6/DSC02610.JPG_4.jpg,1482,480,640,26,103,129,383,440,True,8
6,54,kaist_dataset/English/Digital_Camera/(E.S)E-night/DSC02610.JPG,char_data/6/DSC02610.JPG_5.jpg,1620,480,640,30,185,215,381,435,True,8
6,49,kaist_dataset/English/Digital_Camera/(E.S)F-others/080119-0007.jpg,char_data/6/080119-0007.jpg_2.jpg,1372,1200,1600,28,1049,1077,225,274,True,8
6,47,kaist_dataset/English/Digital_Camera/(E.S)F-others/2007-12-09-day-exterior-047.jpg,char_data/6/2007-12-09-day-exterior-047.jpg_4.jpg,564,1200,1600,12,3,15,565,612,True,8
6,46,kaist_dataset/English/Digital_Camera/(E.S)F-others/2007-12-09-day-exterior-047.jpg,char_data/6/2007-12-09-day-exterior-047.jpg_5.jpg,552,1200,1600,12,74,86,594,640,True,8
6,38,kaist_dataset/English/Digital_Camera/(E.S)F-others/DSC02923.JPG,char_data/6/DSC02923.JPG_2.jpg,570,480,640,15,356,371,392,430,True,8
6,45,kaist_dataset/English/Digital_Camera/(E.S)F-others/m.jpg,char_data/6/m.jpg_4.jpg,900,240,320,20,53,73,177,222,True,8
6,39,kaist_dataset/English/Digital_Camera/(E.S)F-others/m.jpg,char_data/6/m.jpg_5.jpg,858,240,320,22,72,94,177,216,True,8
6,132,kaist_dataset/Korean/Digital_Camera/A-shadow/089.JPG,char_data/6/089.JPG_2.jpg,11088,480,640,84,257,341,163,295,True,8
6,43,kaist_dataset/Korean/Digital_Camera/A-shadow/2007-12-09-day-exterior-025.jpg,char_data/6/2007-12-09-day-exterior-025.jpg_2.jpg,1075,1200,1600,25,957,982,738,781,True,8
6,68,kaist_dataset/Korean/Digital_Camera/A-shadow/2007-12-09-day-exterior-026.jpg,char_data/6/2007-12-09-day-exterior-026.jpg_2.jpg,2584,1200,1600,38,919,957,756,824,True,8
6,83,kaist_dataset/Korean/Digital_Camera/A-shadow/2007-12-09-day-exterior-031.jpg,char_data/6/2007-12-09-day-exterior-031.jpg_2.jpg,3486,1200,1600,42,603,645,665,748,True,8
6,36,kaist_dataset/Korean/Digital_Camera/A-shadow/2007-12-09-day-exterior-040.jpg,char_data/6/2007-12-09-day-exterior-040.jpg_2.jpg,720,1200,1600,20,1000,1020,812,848,True,8
6,35,kaist_dataset/Korean/Digital_Camera/A-shadow/DSC02598.JPG,char_data/6/DSC02598.JPG_4.jpg,735,480,640,21,522,543,415,450,True,8
6,159,kaist_dataset/Korean/Digital_Camera/A-shadow/DSC02670.JPG,char_data/6/DSC02670.JPG_2.jpg,14151,480,640,89,99,188,23,182,True,8
6,72,kaist_dataset/Korean/Digital_Camera/A-shadow/DSC03536.JPG,char_data/6/DSC03536.JPG_4.jpg,3240,480,640,45,348,393,245,317,True,8
6,77,kaist_dataset/Korean/Digital_Camera/A-shadow/DSC03536.JPG,char_data/6/DSC03536.JPG_5.jpg,3696,480,640,48,472,520,233,310,True,8
6,74,kaist_dataset/Korean/Digital_Camera/A-shadow/DSC03755.JPG,char_data/6/DSC03755.JPG_4.jpg,2442,480,640,33,318,351,209,283,True,8
6,71,kaist_dataset/Korean/Digital_Camera/A-shadow/DSC03755.JPG,char_data/6/DSC03755.JPG_5.jpg,2698,480,640,38,478,516,208,279,True,8
6,35,kaist_dataset/Korean/Digital_Camera/A-shadow/DSC04297.JPG,char_data/6/DSC04297.JPG_2.jpg,595,480,640,17,448,465,208,243,True,8
6,89,kaist_dataset/Korean/Digital_Camera/A-shadow/DSC04311.JPG,char_data/6/DSC04311.JPG_2.jpg,4806,480,640,54,263,317,258,347,True,8
6,31,kaist_dataset/Korean/Digital_Camera/B-light/DSC02987.JPG,char_data/6/DSC02987.JPG_8.jpg,434,480,640,14,458,472,276,307,True,8
6,31,kaist_dataset/Korean/Digital_Camera/B-light/DSC02987.JPG,char_data/6/DSC02987.JPG_9.jpg,496,480,640,16,472,488,277,308,True,8
6,30,kaist_dataset/Korean/Digital_Camera/B-light/DSC02987.JPG,char_data/6/DSC02987.JPG_10.jpg,420,480,640,14,542,556,279,309,True,8
6,30,kaist_dataset/Korean/Digital_Camera/B-light/DSC02987.JPG,char_data/6/DSC02987.JPG_11.jpg,360,480,640,12,584,596,281,311,True,8
6,54,kaist_dataset/Korean/Digital_Camera/E-night/DSC02594.JPG,char_data/6/DSC02594.JPG_2.jpg,1998,480,640,37,149,186,380,434,True,8
6,60,kaist_dataset/Korean/Digital_Camera/E-night/DSC02597.JPG,char_data/6/DSC02597.JPG_2.jpg,1740,480,640,29,406,435,286,346,True,8
6,31,kaist_dataset/Korean/Digital_Camera/E-night/DSC02626.JPG,char_data/6/DSC02626.JPG_4.jpg,372,480,640,12,102,114,378,409,True,8
6,33,kaist_dataset/Korean/Digital_Camera/E-night/DSC02626.JPG,char_data/6/DSC02626.JPG_5.jpg,561,480,640,17,345,362,364,397,True,8
6,47,kaist_dataset/Korean/Digital_Camera/E-night/DSC02645.JPG,char_data/6/DSC02645.JPG_2.jpg,1363,480,640,29,331,360,334,381,True,8
6,47,kaist_dataset/Korean/Digital_Camera/E-night/DSC02649.JPG,char_data/6/DSC02649.JPG_4.jpg,1034,480,640,22,470,492,391,438,True,8
6,45,kaist_dataset/Korean/Digital_Camera/E-night/DSC02649.JPG,char_data/6/DSC02649.JPG_5.jpg,720,480,640,16,566,582,392,437,True,8
6,38,kaist_dataset/Korean/Digital_Camera/E-night/DSC02658.JPG,char_data/6/DSC02658.JPG_2.jpg,1026,480,640,27,259,286,352,390,True,8
6,42,kaist_dataset/Korean/Digital_Camera/E-night/DSC03515.JPG,char_data/6/DSC03515.JPG_2.jpg,798,480,640,19,473,492,276,318,True,8
6,41,kaist_dataset/Korean/Digital_Camera/E-night/DSC03850.JPG,char_data/6/DSC03850.JPG_6.jpg,820,480,640,20,384,404,425,466,True,8
6,36,kaist_dataset/Korean/Digital_Camera/E-night/DSC03850.JPG,char_data/6/DSC03850.JPG_7.jpg,540,480,640,15,421,436,429,465,True,8
6,37,kaist_dataset/Korean/Digital_Camera/E-night/DSC03850.JPG,char_data/6/DSC03850.JPG_8.jpg,814,480,640,22,435,457,428,465,True,8
6,26,kaist_dataset/Korean/Digital_Camera/E-night/DSC03870.JPG,char_data/6/DSC03870.JPG_4.jpg,390,480,640,15,407,422,222,248,True,8
6,31,kaist_dataset/Korean/Digital_Camera/E-night/DSC03870.JPG,char_data/6/DSC03870.JPG_5.jpg,713,480,640,23,422,445,220,251,True,8
6,37,kaist_dataset/Korean/Digital_Camera/E-night/P1010146.JPG,char_data/6/P1010146.JPG_2.jpg,444,480,640,12,332,344,242,279,True,8
6,22,kaist_dataset/Korean/Digital_Camera/E-night/P1010149.JPG,char_data/6/P1010149.JPG_2.jpg,352,480,640,16,560,576,242,264,True,8
6,151,kaist_dataset/Korean/Digital_Camera/F-bookCover/DSC02822.JPG,char_data/6/DSC02822.JPG_2.jpg,16006,480,640,106,11,117,67,218,True,8
6,97,kaist_dataset/Korean/Digital_Camera/F-bookCover/DSC02829.JPG,char_data/6/DSC02829.JPG_2.jpg,6693,480,640,69,211,280,44,141,True,8
6,92,kaist_dataset/Korean/Digital_Camera/F-bookCover/DSC02832.JPG,char_data/6/DSC02832.JPG_2.jpg,5704,480,640,62,224,286,336,428,True,8
6,86,kaist_dataset/Korean/Digital_Camera/F-bookCover/DSC02833.JPG,char_data/6/DSC02833.JPG_2.jpg,4644,480,640,54,231,285,361,447,True,8
6,110,kaist_dataset/Korean/Digital_Camera/F-bookCover/DSC02834.JPG,char_data/6/DSC02834.JPG_2.jpg,8690,480,640,79,206,285,319,429,True,8
6,46,kaist_dataset/Korean/Digital_Camera/G-others/2007-12-08-day-045.jpg,char_data/6/2007-12-08-day-045.jpg_6.jpg,552,1200,1600,12,121,133,795,841,True,8
6,41,kaist_dataset/Korean/Digital_Camera/G-others/2007-12-08-day-045.jpg,char_data/6/2007-12-08-day-045.jpg_7.jpg,410,1200,1600,10,1,11,807,848,True,8
6,45,kaist_dataset/Korean/Digital_Camera/G-others/2007-12-08-day-045.jpg,char_data/6/2007-12-08-day-045.jpg_8.jpg,675,1200,1600,15,69,84,800,845,True,8
6,21,kaist_dataset/Korean/Digital_Camera/G-others/2007-12-08-day-112.jpg,char_data/6/2007-12-08-day-112.jpg_6.jpg,252,1200,1600,12,389,401,1172,1193,True,8
6,87,kaist_dataset/Korean/Digital_Camera/G-others/2007-12-08-day-112.jpg,char_data/6/2007-12-08-day-112.jpg_7.jpg,4611,1200,1600,53,754,807,434,521,True,8
6,57,kaist_dataset/Korean/Digital_Camera/G-others/2007-12-08-day-112.jpg,char_data/6/2007-12-08-day-112.jpg_8.jpg,1311,1200,1600,23,715,738,555,612,True,8
6,111,kaist_dataset/Korean/Digital_Camera/G-others/2007-12-09-day-exterior-062.jpg,char_data/6/2007-12-09-day-exterior-062.jpg_2.jpg,3441,1600,1200,31,505,536,1396,1507,True,8
6,46,kaist_dataset/Korean/Digital_Camera/G-others/2007-12-09-day-exterior-083.jpg,char_data/6/2007-12-09-day-exterior-083.jpg_4.jpg,1426,1600,1200,31,543,574,968,1014,True,8
6,58,kaist_dataset/Korean/Digital_Camera/G-others/2007-12-09-day-exterior-083.jpg,char_data/6/2007-12-09-day-exterior-083.jpg_5.jpg,2262,1600,1200,39,329,368,124,182,True,8
6,57,kaist_dataset/Korean/Digital_Camera/G-others/DSC03434.JPG,char_data/6/DSC03434.JPG_2.jpg,1596,480,640,28,293,321,25,82,True,8
6,42,kaist_dataset/Korean/Digital_Camera/G-others/DSC03862.JPG,char_data/6/DSC03862.JPG_2.jpg,714,480,640,17,337,354,354,396,True,8
6,44,kaist_dataset/Korean/Digital_Camera/indoor1/080119-0018.jpg,char_data/6/080119-0018.jpg_4.jpg,1100,1200,1600,25,1060,1085,940,984,True,8
6,40,kaist_dataset/Korean/Digital_Camera/indoor1/080119-0018.jpg,char_data/6/080119-0018.jpg_5.jpg,1480,1200,1600,37,1205,1242,944,984,True,8
6,96,kaist_dataset/Korean/Digital_Camera/indoor1/080119-0029.jpg,char_data/6/080119-0029.jpg_4.jpg,4032,1200,1600,42,563,605,572,668,True,8
6,79,kaist_dataset/Korean/Digital_Camera/indoor1/080119-0029.jpg,char_data/6/080119-0029.jpg_5.jpg,2449,1200,1600,31,1402,1433,983,1062,True,8
6,143,kaist_dataset/Korean/Digital_Camera/indoor1/080119-0030.jpg,char_data/6/080119-0030.jpg_4.jpg,12870,1200,1600,90,1096,1186,571,714,True,8
6,29,kaist_dataset/Korean/Digital_Camera/indoor1/080119-0030.jpg,char_data/6/080119-0030.jpg_5.jpg,319,1200,1600,11,772,783,862,891,True,8
6,61,kaist_dataset/Korean/Digital_Camera/indoor2/DSC03475.JPG,char_data/6/DSC03475.JPG_2.jpg,2379,480,640,39,330,369,88,149,True,8
6,37,kaist_dataset/Korean/Digital_Camera/indoor2/DSC03975.JPG,char_data/6/DSC03975.JPG_4.jpg,592,480,640,16,166,182,290,327,True,8
6,29,kaist_dataset/Korean/Digital_Camera/indoor2/DSC03975.JPG,char_data/6/DSC03975.JPG_5.jpg,406,480,640,14,228,242,290,319,True,8
6,40,kaist_dataset/Korean/Digital_Camera/indoor2/DSC03983.JPG,char_data/6/DSC03983.JPG_4.jpg,920,480,640,23,304,327,324,364,True,8
6,37,kaist_dataset/Korean/Digital_Camera/indoor2/DSC03983.JPG,char_data/6/DSC03983.JPG_5.jpg,962,480,640,26,415,441,322,359,True,8
6,52,kaist_dataset/Korean/Digital_Camera/indoor2/DSC04204.JPG,char_data/6/DSC04204.JPG_4.jpg,1768,480,640,34,381,415,205,257,True,8
6,46,kaist_dataset/Korean/Digital_Camera/indoor2/DSC04204.JPG,char_data/6/DSC04204.JPG_5.jpg,1104,480,640,24,475,499,276,322,True,8
6,70,kaist_dataset/Korean/Digital_Camera/indoor2/P071209063.jpg,char_data/6/P071209063.jpg_2.jpg,3710,1200,1600,53,1020,1073,1069,1139,True,8
6,18,kaist_dataset/Korean/Digital_Camera/outdoor1/006.JPG,char_data/6/006.JPG_2.jpg,324,480,640,18,298,316,255,273,True,8
6,23,kaist_dataset/Korean/Digital_Camera/outdoor1/011.JPG,char_data/6/011.JPG_2.jpg,552,480,640,24,362,386,257,280,True,8
6,15,kaist_dataset/Korean/Digital_Camera/outdoor1/013.JPG,char_data/6/013.JPG_6.jpg,120,480,640,8,378,386,253,268,True,8
6,17,kaist_dataset/Korean/Digital_Camera/outdoor1/013.JPG,char_data/6/013.JPG_7.jpg,170,480,640,10,429,439,249,266,True,8
6,18,kaist_dataset/Korean/Digital_Camera/outdoor1/013.JPG,char_data/6/013.JPG_8.jpg,288,480,640,16,441,457,248,266,True,8
6,20,kaist_dataset/Korean/Digital_Camera/outdoor1/017.JPG,char_data/6/017.JPG_4.jpg,360,480,640,18,426,444,272,292,True,8
6,24,kaist_dataset/Korean/Digital_Camera/outdoor1/017.JPG,char_data/6/017.JPG_5.jpg,384,480,640,16,506,522,270,294,True,8
6,33,kaist_dataset/Korean/Digital_Camera/outdoor1/023.JPG,char_data/6/023.JPG_2.jpg,693,480,640,21,167,188,270,303,True,8
6,24,kaist_dataset/Korean/Digital_Camera/outdoor1/028.JPG,char_data/6/028.JPG_2.jpg,288,480,640,12,300,312,263,287,True,8
6,31,kaist_dataset/Korean/Digital_Camera/outdoor1/029.JPG,char_data/6/029.JPG_4.jpg,775,480,640,25,260,285,290,321,True,8
6,30,kaist_dataset/Korean/Digital_Camera/outdoor1/029.JPG,char_data/6/029.JPG_5.jpg,780,480,640,26,380,406,291,321,True,8
6,33,kaist_dataset/Korean/Digital_Camera/outdoor1/032.JPG,char_data/6/032.JPG_8.jpg,561,480,640,17,88,105,256,289,True,8
6,28,kaist_dataset/Korean/Digital_Camera/outdoor1/032.JPG,char_data/6/032.JPG_9.jpg,588,480,640,21,264,285,260,288,True,8
6,24,kaist_dataset/Korean/Digital_Camera/outdoor1/032.JPG,char_data/6/032.JPG_10.jpg,408,480,640,17,350,367,262,286,True,8
6,28,kaist_dataset/Korean/Digital_Camera/outdoor1/032.JPG,char_data/6/032.JPG_11.jpg,532,480,640,19,438,457,254,282,True,8
6,34,kaist_dataset/Korean/Digital_Camera/outdoor1/035.JPG,char_data/6/035.JPG_4.jpg,646,480,640,19,322,341,286,320,True,8
6,28,kaist_dataset/Korean/Digital_Camera/outdoor1/035.JPG,char_data/6/035.JPG_5.jpg,532,480,640,19,473,492,288,316,True,8
6,32,kaist_dataset/Korean/Digital_Camera/outdoor1/040.JPG,char_data/6/040.JPG_2.jpg,736,480,640,23,248,271,297,329,True,8
6,44,kaist_dataset/Korean/Digital_Camera/outdoor1/052.JPG,char_data/6/052.JPG_2.jpg,1100,480,640,25,270,295,319,363,True,8
6,36,kaist_dataset/Korean/Digital_Camera/outdoor1/059.JPG,char_data/6/059.JPG_4.jpg,648,480,640,18,406,424,321,357,True,8
6,35,kaist_dataset/Korean/Digital_Camera/outdoor1/059.JPG,char_data/6/059.JPG_5.jpg,630,480,640,18,541,559,327,362,True,8
6,26,kaist_dataset/Korean/Digital_Camera/outdoor1/069.JPG,char_data/6/069.JPG_2.jpg,494,480,640,19,278,297,271,297,True,8
6,16,kaist_dataset/Korean/Digital_Camera/outdoor1/070.JPG,char_data/6/070.JPG_4.jpg,208,480,640,13,372,385,254,270,True,8
6,18,kaist_dataset/Korean/Digital_Camera/outdoor1/070.JPG,char_data/6/070.JPG_5.jpg,234,480,640,13,446,459,250,268,True,8
6,25,kaist_dataset/Korean/Digital_Camera/outdoor1/071.JPG,char_data/6/071.JPG_2.jpg,550,480,640,22,260,282,259,284,True,8
6,34,kaist_dataset/Korean/Digital_Camera/outdoor1/123.JPG,char_data/6/123.JPG_2.jpg,748,480,640,22,452,474,273,307,True,8
6,34,kaist_dataset/Korean/Digital_Camera/outdoor1/128.JPG,char_data/6/128.JPG_2.jpg,510,480,640,15,379,394,115,149,True,8
6,44,kaist_dataset/Korean/Digital_Camera/outdoor1/2007-12-08-day-047.jpg,char_data/6/2007-12-08-day-047.jpg_2.jpg,1364,1200,1600,31,860,891,711,755,True,8
6,58,kaist_dataset/Korean/Digital_Camera/outdoor1/2007-12-08-day-057.jpg,char_data/6/2007-12-08-day-057.jpg_2.jpg,2320,1200,1600,40,836,876,602,660,True,8
6,67,kaist_dataset/Korean/Digital_Camera/outdoor1/46.JPG,char_data/6/46.JPG_4.jpg,2144,576,768,32,203,235,371,438,True,8
6,68,kaist_dataset/Korean/Digital_Camera/outdoor1/46.JPG,char_data/6/46.JPG_5.jpg,2312,576,768,34,292,326,369,437,True,8
6,31,kaist_dataset/Korean/Digital_Camera/outdoor1/50.JPG,char_data/6/50.JPG_2.jpg,558,576,768,18,322,340,336,367,True,8
6,42,kaist_dataset/Korean/Digital_Camera/outdoor1/54.JPG,char_data/6/54.JPG_2.jpg,1176,523,767,28,410,438,367,409,True,8
6,75,kaist_dataset/Korean/Digital_Camera/outdoor2/2007-12-08-day-101.jpg,char_data/6/2007-12-08-day-101.jpg_2.jpg,2775,1200,1600,37,993,1030,637,712,True,8
6,70,kaist_dataset/Korean/Digital_Camera/outdoor2/2007-12-09-day-exterior-009.jpg,char_data/6/2007-12-09-day-exterior-009.jpg_2.jpg,2660,1200,1600,38,741,779,677,747,True,8
6,76,kaist_dataset/Korean/Digital_Camera/outdoor2/2007-12-09-day-exterior-012.jpg,char_data/6/2007-12-09-day-exterior-012.jpg_2.jpg,3344,1200,1600,44,1064,1108,621,697,True,8
6,60,kaist_dataset/Korean/Digital_Camera/outdoor2/2007-12-09-day-exterior-016.jpg,char_data/6/2007-12-09-day-exterior-016.jpg_2.jpg,2400,1200,1600,40,549,589,747,807,True,8
6,65,kaist_dataset/Korean/Digital_Camera/outdoor2/2007-12-09-day-exterior-033.jpg,char_data/6/2007-12-09-day-exterior-033.jpg_4.jpg,4745,1200,1600,73,503,576,723,788,True,8
6,65,kaist_dataset/Korean/Digital_Camera/outdoor2/2007-12-09-day-exterior-033.jpg,char_data/6/2007-12-09-day-exterior-033.jpg_5.jpg,4940,1200,1600,76,956,1032,728,793,True,8
6,51,kaist_dataset/Korean/Digital_Camera/outdoor2/2007-12-09-day-exterior-035.jpg,char_data/6/2007-12-09-day-exterior-035.jpg_8.jpg,1632,1200,1600,32,444,476,706,757,True,8
6,50,kaist_dataset/Korean/Digital_Camera/outdoor2/2007-12-09-day-exterior-035.jpg,char_data/6/2007-12-09-day-exterior-035.jpg_9.jpg,1600,1200,1600,32,776,808,717,767,True,8
6,48,kaist_dataset/Korean/Digital_Camera/outdoor2/2007-12-09-day-exterior-035.jpg,char_data/6/2007-12-09-day-exterior-035.jpg_10.jpg,2064,1200,1600,43,1018,1061,722,770,True,8
6,51,kaist_dataset/Korean/Digital_Camera/outdoor2/2007-12-09-day-exterior-035.jpg,char_data/6/2007-12-09-day-exterior-035.jpg_11.jpg,2091,1200,1600,41,1215,1256,724,775,True,8
6,35,kaist_dataset/Korean/Digital_Camera/outdoor2/2007-12-09-day-exterior-036.jpg,char_data/6/2007-12-09-day-exterior-036.jpg_4.jpg,770,1200,1600,22,1452,1474,631,666,True,8
6,45,kaist_dataset/Korean/Digital_Camera/outdoor2/2007-12-09-day-exterior-036.jpg,char_data/6/2007-12-09-day-exterior-036.jpg_5.jpg,1125,1200,1600,25,1553,1578,627,672,True,8
6,43,kaist_dataset/Korean/Digital_Camera/outdoor2/2007-12-09-day-exterior-084.jpg,char_data/6/2007-12-09-day-exterior-084.jpg_2.jpg,1376,1200,1600,32,769,801,802,845,True,8
6,32,kaist_dataset/Korean/Digital_Camera/outdoor2/DSC02308.JPG,char_data/6/DSC02308.JPG_2.jpg,1312,480,640,41,426,467,238,270,True,8
6,32,kaist_dataset/Korean/Digital_Camera/outdoor2/DSC02310.JPG,char_data/6/DSC02310.JPG_2.jpg,1056,480,640,33,259,292,208,240,True,8
6,22,kaist_dataset/Korean/Digital_Camera/outdoor2/DSC02314.JPG,char_data/6/DSC02314.JPG_2.jpg,528,480,640,24,424,448,207,229,True,8
6,32,kaist_dataset/Korean/Digital_Camera/outdoor2/DSC02326.JPG,char_data/6/DSC02326.JPG_2.jpg,480,480,640,15,461,476,333,365,True,8
6,42,kaist_dataset/Korean/Digital_Camera/outdoor2/DSC02366.JPG,char_data/6/DSC02366.JPG_2.jpg,1008,480,640,24,344,368,404,446,True,8
6,38,kaist_dataset/Korean/Digital_Camera/outdoor2/DSC02372.JPG,char_data/6/DSC02372.JPG_2.jpg,532,480,640,14,550,564,281,319,True,8
6,30,kaist_dataset/Korean/Digital_Camera/outdoor2/DSC02373.JPG,char_data/6/DSC02373.JPG_2.jpg,450,480,640,15,405,420,334,364,True,8
6,34,kaist_dataset/Korean/Digital_Camera/outdoor2/DSC02380.JPG,char_data/6/DSC02380.JPG_2.jpg,476,480,640,14,432,446,233,267,True,8
6,36,kaist_dataset/Korean/Digital_Camera/outdoor2/DSC02393.JPG,char_data/6/DSC02393.JPG_2.jpg,828,480,640,23,494,517,305,341,True,8
6,40,kaist_dataset/Korean/Digital_Camera/outdoor2/DSC02467.JPG,char_data/6/DSC02467.JPG_2.jpg,880,480,640,22,246,268,255,295,True,8
6,28,kaist_dataset/Korean/Digital_Camera/outdoor2/DSC02470.JPG,char_data/6/DSC02470.JPG_4.jpg,560,480,640,20,200,220,182,210,True,8
6,57,kaist_dataset/Korean/Digital_Camera/outdoor2/DSC02470.JPG,char_data/6/DSC02470.JPG_5.jpg,1881,480,640,33,292,325,377,434,True,8
6,29,kaist_dataset/Korean/Digital_Camera/outdoor2/DSC02476.JPG,char_data/6/DSC02476.JPG_2.jpg,725,480,640,25,248,273,278,307,True,8
6,26,kaist_dataset/Korean/Digital_Camera/outdoor2/DSC02506.JPG,char_data/6/DSC02506.JPG_2.jpg,858,480,640,33,268,301,439,465,True,8
6,53,kaist_dataset/Korean/Digital_Camera/outdoor2/DSC02512.JPG,char_data/6/DSC02512.JPG_4.jpg,1749,480,640,33,422,455,288,341,True,8
6,50,kaist_dataset/Korean/Digital_Camera/outdoor2/DSC02512.JPG,char_data/6/DSC02512.JPG_5.jpg,1650,480,640,33,509,542,288,338,True,8
6,57,kaist_dataset/Korean/Digital_Camera/outdoor2/DSC02515.JPG,char_data/6/DSC02515.JPG_4.jpg,2451,480,640,43,251,294,323,380,True,8
6,59,kaist_dataset/Korean/Digital_Camera/outdoor2/DSC02515.JPG,char_data/6/DSC02515.JPG_5.jpg,2242,480,640,38,417,455,334,393,True,8
6,122,kaist_dataset/Korean/Digital_Camera/outdoor2/DSC02520.JPG,char_data/6/DSC02520.JPG_2.jpg,3660,480,640,30,431,461,297,419,True,8
6,35,kaist_dataset/Korean/Digital_Camera/outdoor2/DSC02521.JPG,char_data/6/DSC02521.JPG_2.jpg,805,480,640,23,310,333,327,362,True,8
6,43,kaist_dataset/Korean/Digital_Camera/outdoor2/DSC02523.JPG,char_data/6/DSC02523.JPG_2.jpg,860,480,640,20,476,496,334,377,True,8
6,103,kaist_dataset/Korean/Digital_Camera/outdoor3/DSC02525.JPG,char_data/6/DSC02525.JPG_2.jpg,8652,480,640,84,180,264,27,130,True,8
6,44,kaist_dataset/Korean/Digital_Camera/outdoor3/DSC02528.JPG,char_data/6/DSC02528.JPG_4.jpg,1672,480,640,38,202,240,410,454,True,8
6,44,kaist_dataset/Korean/Digital_Camera/outdoor3/DSC02528.JPG,char_data/6/DSC02528.JPG_5.jpg,1540,480,640,35,365,400,410,454,True,8
6,25,kaist_dataset/Korean/Digital_Camera/outdoor3/DSC02529.JPG,char_data/6/DSC02529.JPG_2.jpg,325,480,640,13,550,563,373,398,True,8
6,31,kaist_dataset/Korean/Digital_Camera/outdoor3/DSC02531.JPG,char_data/6/DSC02531.JPG_4.jpg,651,480,640,21,225,246,352,383,True,8
6,35,kaist_dataset/Korean/Digital_Camera/outdoor3/DSC02531.JPG,char_data/6/DSC02531.JPG_5.jpg,735,480,640,21,352,373,345,380,True,8
6,29,kaist_dataset/Korean/Digital_Camera/outdoor3/DSC02558.JPG,char_data/6/DSC02558.JPG_2.jpg,435,480,640,15,500,515,220,249,True,8
6,38,kaist_dataset/Korean/Digital_Camera/outdoor3/DSC02561.JPG,char_data/6/DSC02561.JPG_4.jpg,988,480,640,26,237,263,352,390,True,8
6,41,kaist_dataset/Korean/Digital_Camera/outdoor3/DSC02561.JPG,char_data/6/DSC02561.JPG_5.jpg,902,480,640,22,300,322,353,394,True,8
6,67,kaist_dataset/Korean/Digital_Camera/outdoor3/DSC02562.JPG,char_data/6/DSC02562.JPG_2.jpg,2479,480,640,37,230,267,361,428,True,8
6,35,kaist_dataset/Korean/Digital_Camera/outdoor3/DSC02598.JPG,char_data/6/DSC02598.JPG_5.jpg,735,480,640,21,522,543,415,450,True,8
6,36,kaist_dataset/Korean/Digital_Camera/outdoor3/DSC02899.JPG,char_data/6/DSC02899.JPG_2.jpg,1332,480,640,37,413,450,232,268,True,8
6,36,kaist_dataset/Korean/Digital_Camera/outdoor3/DSC02943.JPG,char_data/6/DSC02943.JPG_4.jpg,828,480,640,23,372,395,431,467,True,8
6,33,kaist_dataset/Korean/Digital_Camera/outdoor3/DSC02943.JPG,char_data/6/DSC02943.JPG_5.jpg,858,480,640,26,393,419,435,468,True,8
6,67,kaist_dataset/Korean/Digital_Camera/outdoor3/DSC02951.JPG,char_data/6/DSC02951.JPG_2.jpg,3685,480,640,55,173,228,390,457,True,8
6,115,kaist_dataset/Korean/Digital_Camera/outdoor3/DSC02983.JPG,char_data/6/DSC02983.JPG_2.jpg,6325,480,640,55,200,255,296,411,True,8
6,44,kaist_dataset/Korean/Digital_Camera/outdoor3/DSC02994.JPG,char_data/6/DSC02994.JPG_2.jpg,1364,480,640,31,366,397,285,329,True,8
6,39,kaist_dataset/Korean/Digital_Camera/outdoor3/DSC02999.JPG,char_data/6/DSC02999.JPG_2.jpg,702,480,640,18,369,387,428,467,True,8
6,62,kaist_dataset/Korean/Digital_Camera/outdoor3/DSC03221.JPG,char_data/6/DSC03221.JPG_2.jpg,1488,480,640,24,104,128,78,140,True,8
6,105,kaist_dataset/Korean/Digital_Camera/outdoor3/DSC03222.JPG,char_data/6/DSC03222.JPG_2.jpg,4935,480,640,47,244,291,355,460,True,8
6,57,kaist_dataset/Korean/Digital_Camera/outdoor4/DSC03261.JPG,char_data/6/DSC03261.JPG_2.jpg,2109,480,640,37,276,313,389,446,True,8
6,98,kaist_dataset/Korean/Digital_Camera/outdoor4/DSC03542.JPG,char_data/6/DSC03542.JPG_6.jpg,5488,480,640,56,190,246,236,334,True,8
6,102,kaist_dataset/Korean/Digital_Camera/outdoor4/DSC03542.JPG,char_data/6/DSC03542.JPG_7.jpg,4692,480,640,46,443,489,234,336,True,8
6,106,kaist_dataset/Korean/Digital_Camera/outdoor4/DSC03542.JPG,char_data/6/DSC03542.JPG_8.jpg,5406,480,640,51,534,585,230,336,True,8
6,66,kaist_dataset/Korean/Digital_Camera/outdoor4/DSC03550.JPG,char_data/6/DSC03550.JPG_4.jpg,3498,480,640,53,342,395,306,372,True,8
6,66,kaist_dataset/Korean/Digital_Camera/outdoor4/DSC03550.JPG,char_data/6/DSC03550.JPG_5.jpg,4422,480,640,67,503,570,307,373,True,8
6,95,kaist_dataset/Korean/Digital_Camera/outdoor4/DSC03566.JPG,char_data/6/DSC03566.JPG_12.jpg,5795,480,640,61,209,270,148,243,True,8
6,95,kaist_dataset/Korean/Digital_Camera/outdoor4/DSC03566.JPG,char_data/6/DSC03566.JPG_13.jpg,5605,480,640,59,333,392,147,242,True,8
6,97,kaist_dataset/Korean/Digital_Camera/outdoor4/DSC03566.JPG,char_data/6/DSC03566.JPG_14.jpg,5432,480,640,56,393,449,145,242,True,8
6,34,kaist_dataset/Korean/Digital_Camera/outdoor4/DSC03566.JPG,char_data/6/DSC03566.JPG_15.jpg,2210,480,640,65,168,233,93,127,True,8
6,38,kaist_dataset/Korean/Digital_Camera/outdoor4/DSC03566.JPG,char_data/6/DSC03566.JPG_16.jpg,2546,480,640,67,291,358,90,128,True,8
6,35,kaist_dataset/Korean/Digital_Camera/outdoor4/DSC03566.JPG,char_data/6/DSC03566.JPG_17.jpg,2275,480,640,65,356,421,87,122,True,8
6,64,kaist_dataset/Korean/Digital_Camera/outdoor4/DSC03599.JPG,char_data/6/DSC03599.JPG_2.jpg,2432,480,640,38,331,369,230,294,True,8
6,41,kaist_dataset/Korean/Digital_Camera/outdoor4/DSC03602.JPG,char_data/6/DSC03602.JPG_2.jpg,2009,480,640,49,246,295,311,352,True,8
6,49,kaist_dataset/Korean/Digital_Camera/outdoor4/DSC03603.JPG,char_data/6/DSC03603.JPG_2.jpg,1764,480,640,36,265,301,386,435,True,8
6,29,kaist_dataset/Korean/Digital_Camera/outdoor5/DSC03636.JPG,char_data/6/DSC03636.JPG_6.jpg,464,480,640,16,313,329,160,189,True,8
6,32,kaist_dataset/Korean/Digital_Camera/outdoor5/DSC03636.JPG,char_data/6/DSC03636.JPG_7.jpg,416,480,640,13,344,357,155,187,True,8
6,34,kaist_dataset/Korean/Digital_Camera/outdoor5/DSC03636.JPG,char_data/6/DSC03636.JPG_8.jpg,680,480,640,20,322,342,397,431,True,8
6,38,kaist_dataset/Korean/Digital_Camera/outdoor5/DSC03645.JPG,char_data/6/DSC03645.JPG_6.jpg,1064,480,640,28,449,477,353,391,True,8
6,38,kaist_dataset/Korean/Digital_Camera/outdoor5/DSC03645.JPG,char_data/6/DSC03645.JPG_7.jpg,1102,480,640,29,477,506,353,391,True,8
6,35,kaist_dataset/Korean/Digital_Camera/outdoor5/DSC03645.JPG,char_data/6/DSC03645.JPG_8.jpg,1120,480,640,32,507,539,354,389,True,8
6,39,kaist_dataset/Korean/Digital_Camera/outdoor5/DSC03685.JPG,char_data/6/DSC03685.JPG_4.jpg,936,480,640,24,169,193,185,224,True,8
6,38,kaist_dataset/Korean/Digital_Camera/outdoor5/DSC03685.JPG,char_data/6/DSC03685.JPG_5.jpg,874,480,640,23,418,441,187,225,True,8
6,28,kaist_dataset/Korean/Digital_Camera/outdoor5/DSC03688.JPG,char_data/6/DSC03688.JPG_2.jpg,364,480,640,13,598,611,227,255,True,8
6,42,kaist_dataset/Korean/Digital_Camera/outdoor5/DSC03708.JPG,char_data/6/DSC03708.JPG_2.jpg,1218,480,640,29,482,511,264,306,True,8
6,36,kaist_dataset/Korean/Digital_Camera/outdoor5/DSC03740.JPG,char_data/6/DSC03740.JPG_2.jpg,684,480,640,19,495,514,286,322,True,8
6,34,kaist_dataset/Korean/Digital_Camera/outdoor5/DSC03751.JPG,char_data/6/DSC03751.JPG_2.jpg,952,480,640,28,379,407,407,441,True,8
6,29,kaist_dataset/Korean/Digital_Camera/outdoor5/DSC03779.JPG,char_data/6/DSC03779.JPG_2.jpg,696,480,640,24,544,568,245,274,True,8
6,38,kaist_dataset/Korean/Digital_Camera/outdoor5/DSC03794.JPG,char_data/6/DSC03794.JPG_6.jpg,874,480,640,23,302,325,364,402,True,8
6,42,kaist_dataset/Korean/Digital_Camera/outdoor5/DSC03794.JPG,char_data/6/DSC03794.JPG_7.jpg,756,480,640,18,324,342,360,402,True,8
6,37,kaist_dataset/Korean/Digital_Camera/outdoor5/DSC03794.JPG,char_data/6/DSC03794.JPG_8.jpg,703,480,640,19,363,382,362,399,True,8
6,50,kaist_dataset/Korean/Digital_Camera/outdoor5/DSC03838.JPG,char_data/6/DSC03838.JPG_6.jpg,1400,480,640,28,343,371,202,252,True,8
6,54,kaist_dataset/Korean/Digital_Camera/outdoor5/DSC03838.JPG,char_data/6/DSC03838.JPG_7.jpg,1512,480,640,28,396,424,202,256,True,8
6,51,kaist_dataset/Korean/Digital_Camera/outdoor5/DSC03838.JPG,char_data/6/DSC03838.JPG_8.jpg,1683,480,640,33,423,456,206,257,True,8
6,57,kaist_dataset/Korean/Digital_Camera/outdoor5/DSC03858.JPG,char_data/6/DSC03858.JPG_2.jpg,3135,480,640,55,106,161,400,457,True,8
6,85,kaist_dataset/Korean/Digital_Camera/outdoor5/DSC03864.JPG,char_data/6/DSC03864.JPG_4.jpg,4335,480,640,51,266,317,159,244,True,8
6,86,kaist_dataset/Korean/Digital_Camera/outdoor5/DSC03864.JPG,char_data/6/DSC03864.JPG_5.jpg,4730,480,640,55,378,433,168,254,True,8
6,45,kaist_dataset/Korean/Digital_Camera/outdoor5/DSC03970.JPG,char_data/6/DSC03970.JPG_2.jpg,1485,480,640,33,99,132,95,140,True,8
6,53,kaist_dataset/Korean/Digital_Camera/outdoor5/DSC03979.JPG,char_data/6/DSC03979.JPG_2.jpg,3551,480,640,67,121,188,378,431,True,8
6,31,kaist_dataset/Korean/Digital_Camera/outdoor5/DSC04027.JPG,char_data/6/DSC04027.JPG_4.jpg,465,480,640,15,249,264,388,419,True,8
6,44,kaist_dataset/Korean/Digital_Camera/outdoor5/DSC04027.JPG,char_data/6/DSC04027.JPG_5.jpg,836,480,640,19,459,478,374,418,True,8
6,24,kaist_dataset/Korean/Digital_Camera/outdoor6/DSC04042.JPG,char_data/6/DSC04042.JPG_4.jpg,360,480,640,15,137,152,332,356,True,8
6,26,kaist_dataset/Korean/Digital_Camera/outdoor6/DSC04042.JPG,char_data/6/DSC04042.JPG_5.jpg,416,480,640,16,153,169,330,356,True,8
6,104,kaist_dataset/Korean/Digital_Camera/outdoor6/DSC04090.JPG,char_data/6/DSC04090.JPG_2.jpg,4680,480,640,45,255,300,186,290,True,8
6,37,kaist_dataset/Korean/Digital_Camera/outdoor6/DSC04099.JPG,char_data/6/DSC04099.JPG_4.jpg,851,480,640,23,530,553,413,450,True,8
6,38,kaist_dataset/Korean/Digital_Camera/outdoor6/DSC04099.JPG,char_data/6/DSC04099.JPG_5.jpg,912,480,640,24,554,578,412,450,True,8
6,57,kaist_dataset/Korean/Digital_Camera/outdoor6/DSC04100.JPG,char_data/6/DSC04100.JPG_4.jpg,1938,480,640,34,300,334,49,106,True,8
6,56,kaist_dataset/Korean/Digital_Camera/outdoor6/DSC04100.JPG,char_data/6/DSC04100.JPG_5.jpg,1400,480,640,25,406,431,50,106,True,8
6,36,kaist_dataset/Korean/Digital_Camera/outdoor6/DSC04112.JPG,char_data/6/DSC04112.JPG_2.jpg,612,480,640,17,507,524,273,309,True,8
6,39,kaist_dataset/Korean/Digital_Camera/outdoor6/DSC04116.JPG,char_data/6/DSC04116.JPG_2.jpg,507,480,640,13,409,422,315,354,True,8
6,31,kaist_dataset/Korean/Digital_Camera/outdoor6/DSC04132.JPG,char_data/6/DSC04132.JPG_2.jpg,620,480,640,20,331,351,153,184,True,8
6,31,kaist_dataset/Korean/Digital_Camera/outdoor6/DSC04138.JPG,char_data/6/DSC04138.JPG_4.jpg,868,480,640,28,302,330,153,184,True,8
6,29,kaist_dataset/Korean/Digital_Camera/outdoor6/DSC04138.JPG,char_data/6/DSC04138.JPG_5.jpg,783,480,640,27,354,381,156,185,True,8
6,78,kaist_dataset/Korean/Digital_Camera/outdoor6/DSC04301.JPG,char_data/6/DSC04301.JPG_2.jpg,5304,480,640,68,382,450,363,441,True,8
6,62,kaist_dataset/Korean/Digital_Camera/outdoor6/DSC04370.JPG,char_data/6/DSC04370.JPG_2.jpg,3286,480,640,53,382,435,318,380,True,8
6,43,kaist_dataset/Korean/Digital_Camera/outdoor7/P1010012.JPG,char_data/6/P1010012.JPG_2.jpg,1161,480,640,27,359,386,219,262,True,8
6,32,kaist_dataset/Korean/Digital_Camera/outdoor7/P1010022.JPG,char_data/6/P1010022.JPG_2.jpg,928,480,640,29,162,191,258,290,True,8
6,40,kaist_dataset/Korean/Digital_Camera/outdoor7/P1010035.JPG,char_data/6/P1010035.JPG_2.jpg,600,480,640,15,137,152,202,242,True,8
6,38,kaist_dataset/Korean/Digital_Camera/outdoor7/P1010061.JPG,char_data/6/P1010061.JPG_4.jpg,1026,480,640,27,397,424,319,357,True,8
6,37,kaist_dataset/Korean/Digital_Camera/outdoor7/P1010061.JPG,char_data/6/P1010061.JPG_5.jpg,1073,480,640,29,519,548,320,357,True,8
6,37,kaist_dataset/Korean/Digital_Camera/outdoor7/P1010078.JPG,char_data/6/P1010078.JPG_2.jpg,851,480,640,23,316,339,251,288,True,8
6,32,kaist_dataset/Korean/Digital_Camera/outdoor7/P1010082.JPG,char_data/6/P1010082.JPG_8.jpg,1056,480,640,33,276,309,54,86,True,8
6,33,kaist_dataset/Korean/Digital_Camera/outdoor7/P1010082.JPG,char_data/6/P1010082.JPG_9.jpg,891,480,640,27,307,334,49,82,True,8
6,23,kaist_dataset/Korean/Digital_Camera/outdoor7/P1010112.JPG,char_data/6/P1010112.JPG_2.jpg,322,480,640,14,549,563,360,383,True,8
6,31,kaist_dataset/Korean/Digital_Camera/outdoor7/P1010121.JPG,char_data/6/P1010121.JPG_4.jpg,651,480,640,21,490,511,209,240,True,8
6,31,kaist_dataset/Korean/Digital_Camera/outdoor7/P1010121.JPG,char_data/6/P1010121.JPG_5.jpg,899,480,640,29,602,631,212,243,True,8
6,39,kaist_dataset/Korean/Digital_Camera/outdoor7/P1010138.JPG,char_data/6/P1010138.JPG_2.jpg,624,480,640,16,347,363,283,322,True,8
6,43,kaist_dataset/Korean/Digital_Camera/outdoor8/P1010142.JPG,char_data/6/P1010142.JPG_2.jpg,1075,480,640,25,377,402,277,320,True,8
6,36,kaist_dataset/Korean/Digital_Camera/outdoor8/P1010143.JPG,char_data/6/P1010143.JPG_2.jpg,720,480,640,20,459,479,273,309,True,8
6,37,kaist_dataset/Korean/Digital_Camera/outdoor8/P1010170.JPG,char_data/6/P1010170.JPG_4.jpg,999,480,640,27,419,446,273,310,True,8
6,37,kaist_dataset/Korean/Digital_Camera/outdoor8/P1010170.JPG,char_data/6/P1010170.JPG_5.jpg,777,480,640,21,447,468,274,311,True,8
6,38,kaist_dataset/Korean/Digital_Camera/outdoor8/P1011112.JPG,char_data/6/P1011112.JPG_4.jpg,912,480,640,24,351,375,210,248,True,8
6,32,kaist_dataset/Korean/Digital_Camera/outdoor8/P1011112.JPG,char_data/6/P1011112.JPG_5.jpg,736,480,640,23,409,432,217,249,True,8
6,47,kaist_dataset/Mixed/Digital_Camera/(C.S)A-shadow/DSC02567.JPG,char_data/6/DSC02567.JPG_4.jpg,1504,480,640,32,221,253,143,190,True,8
6,40,kaist_dataset/Mixed/Digital_Camera/(C.S)A-shadow/DSC02579.JPG,char_data/6/DSC02579.JPG_6.jpg,1000,480,640,25,239,264,396,436,True,8
6,41,kaist_dataset/Mixed/Digital_Camera/(C.S)A-shadow/DSC02579.JPG,char_data/6/DSC02579.JPG_7.jpg,1107,480,640,27,372,399,400,441,True,8
6,37,kaist_dataset/Mixed/Digital_Camera/(C.S)A-shadow/DSC02579.JPG,char_data/6/DSC02579.JPG_8.jpg,1258,480,640,34,400,434,397,434,True,8
6,43,kaist_dataset/Mixed/Digital_Camera/(C.S)A-shadow/DSC02581.JPG,char_data/6/DSC02581.JPG_6.jpg,1118,480,640,26,249,275,384,427,True,8
6,38,kaist_dataset/Mixed/Digital_Camera/(C.S)A-shadow/DSC02581.JPG,char_data/6/DSC02581.JPG_7.jpg,912,480,640,24,326,350,386,424,True,8
6,36,kaist_dataset/Mixed/Digital_Camera/(C.S)A-shadow/DSC02581.JPG,char_data/6/DSC02581.JPG_8.jpg,756,480,640,21,353,374,387,423,True,8
6,30,kaist_dataset/Mixed/Digital_Camera/(C.S)A-shadow/DSC02624.JPG,char_data/6/DSC02624.JPG_8.jpg,330,480,640,11,442,453,398,428,True,8
6,32,kaist_dataset/Mixed/Digital_Camera/(C.S)A-shadow/DSC02624.JPG,char_data/6/DSC02624.JPG_9.jpg,320,480,640,10,492,502,398,430,True,8
6,37,kaist_dataset/Mixed/Digital_Camera/(C.S)A-shadow/DSC03257.JPG,char_data/6/DSC03257.JPG_2.jpg,888,480,640,24,404,428,377,414,True,8
6,37,kaist_dataset/Mixed/Digital_Camera/(C.S)A-shadow/DSC04306.JPG,char_data/6/DSC04306.JPG_2.jpg,740,480,640,20,323,343,408,445,True,8
6,27,kaist_dataset/Mixed/Digital_Camera/(C.S)A-shadow/P1010017.JPG,char_data/6/P1010017.JPG_2.jpg,405,480,640,15,115,130,132,159,True,8
6,27,kaist_dataset/Mixed/Digital_Camera/(C.S)C-outdoor1/008.JPG,char_data/6/008.JPG_6.jpg,405,480,640,15,458,473,265,292,True,8
6,28,kaist_dataset/Mixed/Digital_Camera/(C.S)C-outdoor1/008.JPG,char_data/6/008.JPG_7.jpg,476,480,640,17,535,552,266,294,True,8
6,26,kaist_dataset/Mixed/Digital_Camera/(C.S)C-outdoor1/008.JPG,char_data/6/008.JPG_8.jpg,390,480,640,15,552,567,264,290,True,8
6,39,kaist_dataset/Mixed/Digital_Camera/(C.S)C-outdoor1/009.JPG,char_data/6/009.JPG_2.jpg,663,480,640,17,284,301,318,357,True,8
6,21,kaist_dataset/Mixed/Digital_Camera/(C.S)C-outdoor1/014.JPG,char_data/6/014.JPG_2.jpg,252,480,640,12,168,180,278,299,True,8
6,57,kaist_dataset/Mixed/Digital_Camera/(C.S)C-outdoor1/025.JPG,char_data/6/025.JPG_4.jpg,1653,480,640,29,151,180,331,388,True,8
6,54,kaist_dataset/Mixed/Digital_Camera/(C.S)C-outdoor1/025.JPG,char_data/6/025.JPG_5.jpg,1404,480,640,26,411,437,341,395,True,8
6,29,kaist_dataset/Mixed/Digital_Camera/(C.S)C-outdoor1/027.JPG,char_data/6/027.JPG_2.jpg,348,480,640,12,412,424,277,306,True,8
6,24,kaist_dataset/Mixed/Digital_Camera/(C.S)C-outdoor1/047.JPG,char_data/6/047.JPG_4.jpg,192,480,640,8,591,599,171,195,True,8
6,20,kaist_dataset/Mixed/Digital_Camera/(C.S)C-outdoor1/047.JPG,char_data/6/047.JPG_5.jpg,200,480,640,10,608,618,174,194,True,8
6,32,kaist_dataset/Mixed/Digital_Camera/(C.S)C-outdoor1/048.JPG,char_data/6/048.JPG_2.jpg,640,480,640,20,398,418,255,287,True,8
6,28,kaist_dataset/Mixed/Digital_Camera/(C.S)C-outdoor1/054.JPG,char_data/6/054.JPG_2.jpg,504,480,640,18,473,491,302,330,True,8
6,95,kaist_dataset/Mixed/Digital_Camera/(C.S)C-outdoor1/080119-0027.jpg,char_data/6/080119-0027.jpg_2.jpg,4370,1200,1600,46,535,581,712,807,True,8
6,48,kaist_dataset/Mixed/Digital_Camera/(C.S)C-outdoor1/081.JPG,char_data/6/081.JPG_2.jpg,1536,480,640,32,158,190,250,298,True,8
6,31,kaist_dataset/Mixed/Digital_Camera/(C.S)C-outdoor1/090.JPG,char_data/6/090.JPG_4.jpg,651,480,640,21,491,512,396,427,True,8
6,31,kaist_dataset/Mixed/Digital_Camera/(C.S)C-outdoor1/090.JPG,char_data/6/090.JPG_5.jpg,837,480,640,27,509,536,395,426,True,8
6,20,kaist_dataset/Mixed/Digital_Camera/(C.S)C-outdoor1/114.jpg,char_data/6/114.jpg_2.jpg,340,480,640,17,290,307,371,391,True,8
6,37,kaist_dataset/Mixed/Digital_Camera/(C.S)C-outdoor1/118.JPG,char_data/6/118.JPG_2.jpg,925,480,640,25,418,443,357,394,True,8
6,24,kaist_dataset/Mixed/Digital_Camera/(C.S)C-outdoor1/2.JPG,char_data/6/2.JPG_2.jpg,240,576,768,10,581,591,393,417,True,8
6,64,kaist_dataset/Mixed/Digital_Camera/(C.S)C-outdoor1/2007-12-08-day-091.jpg,char_data/6/2007-12-08-day-091.jpg_2.jpg,3648,1200,1600,57,1405,1462,627,691,True,8
6,97,kaist_dataset/Mixed/Digital_Camera/(C.S)C-outdoor1/2007-12-08-day-092.jpg,char_data/6/2007-12-08-day-092.jpg_2.jpg,8051,1200,1600,83,1039,1122,658,755,True,8
6,229,kaist_dataset/Mixed/Digital_Camera/(C.S)C-outdoor1/2007-12-08-day-118.jpg,char_data/6/2007-12-08-day-118.jpg_2.jpg,33434,1200,1600,146,915,1061,482,711,True,8
6,39,kaist_dataset/Mixed/Digital_Camera/(C.S)C-outdoor1/2007-12-08-day-130.jpg,char_data/6/2007-12-08-day-130.jpg_2.jpg,1014,1200,1600,26,981,1007,755,794,True,8
6,67,kaist_dataset/Mixed/Digital_Camera/(C.S)C-outdoor1/2007-12-09-day-exterior-004.jpg,char_data/6/2007-12-09-day-exterior-004.jpg_2.jpg,3350,1200,1600,50,1028,1078,660,727,True,8
6,46,kaist_dataset/Mixed/Digital_Camera/(C.S)C-outdoor1/2007-12-09-day-exterior-037.jpg,char_data/6/2007-12-09-day-exterior-037.jpg_2.jpg,1794,1200,1600,39,703,742,710,756,True,8
6,56,kaist_dataset/Mixed/Digital_Camera/(C.S)C-outdoor1/2007-12-09-day-exterior-078.jpg,char_data/6/2007-12-09-day-exterior-078.jpg_2.jpg,1456,1200,1600,26,445,471,595,651,True,8
6,77,kaist_dataset/Mixed/Digital_Camera/(C.S)C-outdoor1/2007-12-09-day-exterior-086.jpg,char_data/6/2007-12-09-day-exterior-086.jpg_2.jpg,5005,1200,1600,65,764,829,713,790,True,8
6,36,kaist_dataset/Mixed/Digital_Camera/(C.S)C-outdoor1/45.JPG,char_data/6/45.JPG_2.jpg,1224,576,768,34,307,341,367,403,True,8
6,30,kaist_dataset/Mixed/Digital_Camera/(C.S)C-outdoor1/47.JPG,char_data/6/47.JPG_2.jpg,450,576,768,15,324,339,473,503,True,8
6,25,kaist_dataset/Mixed/Digital_Camera/(C.S)C-outdoor1/48.JPG,char_data/6/48.JPG_2.jpg,350,576,768,14,215,229,339,364,True,8
6,39,kaist_dataset/Mixed/Digital_Camera/(C.S)C-outdoor1/51.JPG,char_data/6/51.JPG_2.jpg,1170,576,768,30,524,554,376,415,True,8
6,32,kaist_dataset/Mixed/Digital_Camera/(C.S)C-outdoor1/55.JPG,char_data/6/55.JPG_2.jpg,864,576,768,27,306,333,370,402,True,8
6,39,kaist_dataset/Mixed/Digital_Camera/(C.S)C-outdoor1/56.JPG,char_data/6/56.JPG_2.jpg,1287,576,768,33,355,388,302,341,True,8
6,28,kaist_dataset/Mixed/Digital_Camera/(C.S)C-outdoor1/57.JPG,char_data/6/57.JPG_2.jpg,448,500,766,16,339,355,293,321,True,8
6,29,kaist_dataset/Mixed/Digital_Camera/(C.S)C-outdoor1/DSC02242.JPG,char_data/6/DSC02242.JPG_2.jpg,435,480,640,15,558,573,261,290,True,8
6,83,kaist_dataset/Mixed/Digital_Camera/(C.S)C-outdoor1/DSC02244.JPG,char_data/6/DSC02244.JPG_2.jpg,3652,480,640,44,228,272,351,434,True,8
6,47,kaist_dataset/Mixed/Digital_Camera/(C.S)C-outdoor1/DSC02322.JPG,char_data/6/DSC02322.JPG_4.jpg,1222,480,640,26,217,243,363,410,True,8
6,44,kaist_dataset/Mixed/Digital_Camera/(C.S)C-outdoor1/DSC02322.JPG,char_data/6/DSC02322.JPG_5.jpg,1100,480,640,25,326,351,364,408,True,8
6,36,kaist_dataset/Mixed/Digital_Camera/(C.S)C-outdoor1/DSC02344.JPG,char_data/6/DSC02344.JPG_2.jpg,684,480,640,19,511,530,254,290,True,8
6,46,kaist_dataset/Mixed/Digital_Camera/(C.S)C-outdoor1/P1010009.JPG,char_data/6/P1010009.JPG_2.jpg,1150,480,640,25,268,293,238,284,True,8
6,37,kaist_dataset/Mixed/Digital_Camera/(C.S)C-outdoor1/P1010011.JPG,char_data/6/P1010011.JPG_2.jpg,592,480,640,16,558,574,310,347,True,8
6,32,kaist_dataset/Mixed/Digital_Camera/(C.S)C-outdoor2/DSC02368.JPG,char_data/6/DSC02368.JPG_6.jpg,608,480,640,19,178,197,384,416,True,8
6,31,kaist_dataset/Mixed/Digital_Camera/(C.S)C-outdoor2/DSC02368.JPG,char_data/6/DSC02368.JPG_7.jpg,558,480,640,18,427,445,382,413,True,8
6,37,kaist_dataset/Mixed/Digital_Camera/(C.S)C-outdoor2/DSC02368.JPG,char_data/6/DSC02368.JPG_8.jpg,518,480,640,14,545,559,380,417,True,8
6,43,kaist_dataset/Mixed/Digital_Camera/(C.S)C-outdoor2/DSC02374.JPG,char_data/6/DSC02374.JPG_2.jpg,1161,480,640,27,360,387,292,335,True,8
6,34,kaist_dataset/Mixed/Digital_Camera/(C.S)C-outdoor2/DSC02379.JPG,char_data/6/DSC02379.JPG_2.jpg,510,480,640,15,472,487,291,325,True,8
6,28,kaist_dataset/Mixed/Digital_Camera/(C.S)C-outdoor2/DSC02397.JPG,char_data/6/DSC02397.JPG_2.jpg,616,480,640,22,461,483,207,235,True,8
6,46,kaist_dataset/Mixed/Digital_Camera/(C.S)C-outdoor2/DSC02413.JPG,char_data/6/DSC02413.JPG_2.jpg,1242,480,640,27,375,402,206,252,True,8
6,38,kaist_dataset/Mixed/Digital_Camera/(C.S)C-outdoor2/DSC02460.JPG,char_data/6/DSC02460.JPG_10.jpg,684,480,640,18,323,341,303,341,True,8
6,36,kaist_dataset/Mixed/Digital_Camera/(C.S)C-outdoor2/DSC02460.JPG,char_data/6/DSC02460.JPG_11.jpg,720,480,640,20,377,397,303,339,True,8
6,30,kaist_dataset/Mixed/Digital_Camera/(C.S)C-outdoor2/DSC02460.JPG,char_data/6/DSC02460.JPG_12.jpg,660,480,640,22,396,418,304,334,True,8
6,35,kaist_dataset/Mixed/Digital_Camera/(C.S)C-outdoor2/DSC02460.JPG,char_data/6/DSC02460.JPG_13.jpg,665,480,640,19,417,436,304,339,True,8
6,41,kaist_dataset/Mixed/Digital_Camera/(C.S)C-outdoor2/DSC02460.JPG,char_data/6/DSC02460.JPG_14.jpg,820,480,640,20,437,457,303,344,True,8
6,50,kaist_dataset/Mixed/Digital_Camera/(C.S)C-outdoor2/DSC02461.JPG,char_data/6/DSC02461.JPG_2.jpg,2850,480,640,57,168,225,287,337,True,8
6,34,kaist_dataset/Mixed/Digital_Camera/(C.S)C-outdoor2/DSC02466.JPG,char_data/6/DSC02466.JPG_2.jpg,918,480,640,27,193,220,256,290,True,8
6,21,kaist_dataset/Mixed/Digital_Camera/(C.S)C-outdoor2/DSC02477.JPG,char_data/6/DSC02477.JPG_2.jpg,420,480,640,20,76,96,256,277,True,8
6,35,kaist_dataset/Mixed/Digital_Camera/(C.S)C-outdoor2/DSC02479.JPG,char_data/6/DSC02479.JPG_4.jpg,665,480,640,19,463,482,221,256,True,8
6,29,kaist_dataset/Mixed/Digital_Camera/(C.S)C-outdoor2/DSC02479.JPG,char_data/6/DSC02479.JPG_5.jpg,464,480,640,16,508,524,223,252,True,8
6,44,kaist_dataset/Mixed/Digital_Camera/(C.S)C-outdoor2/DSC02482.JPG,char_data/6/DSC02482.JPG_2.jpg,1628,480,640,37,369,406,322,366,True,8
6,36,kaist_dataset/Mixed/Digital_Camera/(C.S)C-outdoor2/DSC02489.JPG,char_data/6/DSC02489.JPG_2.jpg,828,480,640,23,278,301,261,297,True,8
6,42,kaist_dataset/Mixed/Digital_Camera/(C.S)C-outdoor2/DSC02490.JPG,char_data/6/DSC02490.JPG_2.jpg,924,480,640,22,297,319,342,384,True,8
6,34,kaist_dataset/Mixed/Digital_Camera/(C.S)C-outdoor2/DSC02492.JPG,char_data/6/DSC02492.JPG_2.jpg,646,480,640,19,373,392,324,358,True,8
6,72,kaist_dataset/Mixed/Digital_Camera/(C.S)C-outdoor2/DSC02502.JPG,char_data/6/DSC02502.JPG_2.jpg,2664,480,640,37,128,165,346,418,True,8
6,42,kaist_dataset/Mixed/Digital_Camera/(C.S)C-outdoor2/DSC02511.JPG,char_data/6/DSC02511.JPG_4.jpg,966,480,640,23,313,336,204,246,True,8
6,44,kaist_dataset/Mixed/Digital_Camera/(C.S)C-outdoor2/DSC02511.JPG,char_data/6/DSC02511.JPG_5.jpg,1144,480,640,26,264,290,390,434,True,8
6,80,kaist_dataset/Mixed/Digital_Camera/(C.S)C-outdoor2/DSC02513.JPG,char_data/6/DSC02513.JPG_2.jpg,3520,480,640,44,193,237,139,219,True,8
6,39,kaist_dataset/Mixed/Digital_Camera/(C.S)C-outdoor2/DSC02533.JPG,char_data/6/DSC02533.JPG_2.jpg,1326,480,640,34,241,275,362,401,True,8
6,38,kaist_dataset/Mixed/Digital_Camera/(C.S)C-outdoor2/DSC02543.JPG,char_data/6/DSC02543.JPG_4.jpg,836,480,640,22,335,357,349,387,True,8
6,34,kaist_dataset/Mixed/Digital_Camera/(C.S)C-outdoor2/DSC02543.JPG,char_data/6/DSC02543.JPG_5.jpg,714,480,640,21,396,417,348,382,True,8
6,37,kaist_dataset/Mixed/Digital_Camera/(C.S)C-outdoor2/DSC02545.JPG,char_data/6/DSC02545.JPG_2.jpg,1147,480,640,31,251,282,400,437,True,8
6,41,kaist_dataset/Mixed/Digital_Camera/(C.S)C-outdoor2/DSC02553.JPG,char_data/6/DSC02553.JPG_2.jpg,984,480,640,24,325,349,296,337,True,8
6,23,kaist_dataset/Mixed/Digital_Camera/(C.S)C-outdoor2/DSC02555.JPG,char_data/6/DSC02555.JPG_2.jpg,483,480,640,21,89,110,253,276,True,8
6,31,kaist_dataset/Mixed/Digital_Camera/(C.S)C-outdoor2/DSC02556.JPG,char_data/6/DSC02556.JPG_2.jpg,775,480,640,25,308,333,342,373,True,8
6,41,kaist_dataset/Mixed/Digital_Camera/(C.S)C-outdoor2/DSC02557.JPG,char_data/6/DSC02557.JPG_2.jpg,697,480,640,17,392,409,210,251,True,8
6,31,kaist_dataset/Mixed/Digital_Camera/(C.S)C-outdoor2/DSC02560.JPG,char_data/6/DSC02560.JPG_4.jpg,527,480,640,17,527,544,304,335,True,8
6,30,kaist_dataset/Mixed/Digital_Camera/(C.S)C-outdoor2/DSC02560.JPG,char_data/6/DSC02560.JPG_5.jpg,480,480,640,16,580,596,307,337,True,8
6,47,kaist_dataset/Mixed/Digital_Camera/(C.S)C-outdoor2/DSC02567.JPG,char_data/6/DSC02567.JPG_5.jpg,1504,480,640,32,221,253,143,190,True,8
6,30,kaist_dataset/Mixed/Digital_Camera/(C.S)C-outdoor2/DSC02624.JPG,char_data/6/DSC02624.JPG_10.jpg,330,480,640,11,442,453,398,428,True,8
6,32,kaist_dataset/Mixed/Digital_Camera/(C.S)C-outdoor2/DSC02624.JPG,char_data/6/DSC02624.JPG_11.jpg,320,480,640,10,492,502,398,430,True,8
6,29,kaist_dataset/Mixed/Digital_Camera/(C.S)C-outdoor2/DSC02877.JPG,char_data/6/DSC02877.JPG_2.jpg,464,480,640,16,529,545,218,247,True,8
6,37,kaist_dataset/Mixed/Digital_Camera/(C.S)C-outdoor2/DSC02895.JPG,char_data/6/DSC02895.JPG_4.jpg,740,480,640,20,239,259,361,398,True,8
6,37,kaist_dataset/Mixed/Digital_Camera/(C.S)C-outdoor2/DSC02895.JPG,char_data/6/DSC02895.JPG_5.jpg,888,480,640,24,335,359,348,385,True,8
6,43,kaist_dataset/Mixed/Digital_Camera/(C.S)C-outdoor2/DSC02937.JPG,char_data/6/DSC02937.JPG_2.jpg,1075,480,640,25,148,173,203,246,True,8
6,50,kaist_dataset/Mixed/Digital_Camera/(C.S)C-outdoor3/DSC02989.JPG,char_data/6/DSC02989.JPG_4.jpg,1050,480,640,21,533,554,346,396,True,8
6,39,kaist_dataset/Mixed/Digital_Camera/(C.S)C-outdoor3/DSC02989.JPG,char_data/6/DSC02989.JPG_5.jpg,897,480,640,23,576,599,354,393,True,8
6,30,kaist_dataset/Mixed/Digital_Camera/(C.S)C-outdoor3/DSC03051.JPG,char_data/6/DSC03051.JPG_2.jpg,540,480,640,18,267,285,323,353,True,8
6,43,kaist_dataset/Mixed/Digital_Camera/(C.S)C-outdoor3/DSC03061.JPG,char_data/6/DSC03061.JPG_4.jpg,731,480,640,17,305,322,250,293,True,8
6,46,kaist_dataset/Mixed/Digital_Camera/(C.S)C-outdoor3/DSC03061.JPG,char_data/6/DSC03061.JPG_5.jpg,1058,480,640,23,395,418,248,294,True,8
6,34,kaist_dataset/Mixed/Digital_Camera/(C.S)C-outdoor3/DSC03062.JPG,char_data/6/DSC03062.JPG_2.jpg,578,480,640,17,279,296,244,278,True,8
6,58,kaist_dataset/Mixed/Digital_Camera/(C.S)C-outdoor3/DSC03067.JPG,char_data/6/DSC03067.JPG_2.jpg,2378,480,640,41,304,345,195,253,True,8
6,49,kaist_dataset/Mixed/Digital_Camera/(C.S)C-outdoor3/DSC03189.JPG,char_data/6/DSC03189.JPG_4.jpg,1470,480,640,30,534,564,301,350,True,8
6,48,kaist_dataset/Mixed/Digital_Camera/(C.S)C-outdoor3/DSC03189.JPG,char_data/6/DSC03189.JPG_5.jpg,1488,480,640,31,564,595,298,346,True,8
6,46,kaist_dataset/Mixed/Digital_Camera/(C.S)C-outdoor3/DSC03212.JPG,char_data/6/DSC03212.JPG_2.jpg,1012,480,640,22,459,481,252,298,True,8
6,65,kaist_dataset/Mixed/Digital_Camera/(C.S)C-outdoor3/DSC03273.JPG,char_data/6/DSC03273.JPG_2.jpg,2600,480,640,40,510,550,283,348,True,8
6,66,kaist_dataset/Mixed/Digital_Camera/(C.S)C-outdoor3/DSC03302.JPG,char_data/6/DSC03302.JPG_2.jpg,3036,480,640,46,546,592,248,314,True,8
6,32,kaist_dataset/Mixed/Digital_Camera/(C.S)C-outdoor3/DSC03308.JPG,char_data/6/DSC03308.JPG_2.jpg,896,480,640,28,314,342,248,280,True,8
6,36,kaist_dataset/Mixed/Digital_Camera/(C.S)C-outdoor3/DSC03316.JPG,char_data/6/DSC03316.JPG_2.jpg,504,480,640,14,309,323,82,118,True,8
6,60,kaist_dataset/Mixed/Digital_Camera/(C.S)C-outdoor3/DSC03323.JPG,char_data/6/DSC03323.JPG_2.jpg,2460,480,640,41,551,592,260,320,True,8
6,39,kaist_dataset/Mixed/Digital_Camera/(C.S)C-outdoor4/DSC03435.JPG,char_data/6/DSC03435.JPG_2.jpg,624,480,640,16,539,555,414,453,True,8
6,46,kaist_dataset/Mixed/Digital_Camera/(C.S)C-outdoor4/DSC03548.JPG,char_data/6/DSC03548.JPG_2.jpg,2070,480,640,45,191,236,391,437,True,8
6,41,kaist_dataset/Mixed/Digital_Camera/(C.S)C-outdoor4/DSC03549.JPG,char_data/6/DSC03549.JPG_6.jpg,779,480,640,19,576,595,177,218,True,8
6,31,kaist_dataset/Mixed/Digital_Camera/(C.S)C-outdoor4/DSC03549.JPG,char_data/6/DSC03549.JPG_7.jpg,775,480,640,25,553,578,220,251,True,8
6,31,kaist_dataset/Mixed/Digital_Camera/(C.S)C-outdoor4/DSC03549.JPG,char_data/6/DSC03549.JPG_8.jpg,372,480,640,12,359,371,423,454,True,8
6,26,kaist_dataset/Mixed/Digital_Camera/(C.S)C-outdoor4/DSC03552.JPG,char_data/6/DSC03552.JPG_4.jpg,468,480,640,18,411,429,323,349,True,8
6,27,kaist_dataset/Mixed/Digital_Camera/(C.S)C-outdoor4/DSC03552.JPG,char_data/6/DSC03552.JPG_5.jpg,378,480,640,14,447,461,322,349,True,8
6,42,kaist_dataset/Mixed/Digital_Camera/(C.S)C-outdoor4/DSC03556.JPG,char_data/6/DSC03556.JPG_4.jpg,1134,480,640,27,485,512,254,296,True,8
6,31,kaist_dataset/Mixed/Digital_Camera/(C.S)C-outdoor4/DSC03556.JPG,char_data/6/DSC03556.JPG_5.jpg,465,480,640,15,354,369,318,349,True,8
6,48,kaist_dataset/Mixed/Digital_Camera/(C.S)C-outdoor4/DSC03569.JPG,char_data/6/DSC03569.JPG_2.jpg,1584,480,640,33,547,580,165,213,True,8
6,47,kaist_dataset/Mixed/Digital_Camera/(C.S)C-outdoor4/DSC03571.JPG,char_data/6/DSC03571.JPG_2.jpg,1081,480,640,23,410,433,300,347,True,8
6,213,kaist_dataset/Mixed/Digital_Camera/(C.S)C-outdoor4/DSC03586.JPG,char_data/6/DSC03586.JPG_2.jpg,50694,480,640,238,205,443,237,450,False,8
6,51,kaist_dataset/Mixed/Digital_Camera/(C.S)C-outdoor4/DSC03613.JPG,char_data/6/DSC03613.JPG_2.jpg,1122,480,640,22,494,516,24,75,False,8
6,55,kaist_dataset/Mixed/Digital_Camera/(C.S)C-outdoor4/DSC03621.JPG,char_data/6/DSC03621.JPG_2.jpg,1210,480,640,22,413,435,329,384,False,8
6,30,kaist_dataset/Mixed/Digital_Camera/(C.S)C-outdoor4/DSC03640.JPG,char_data/6/DSC03640.JPG_2.jpg,660,480,640,22,359,381,399,429,False,8
6,29,kaist_dataset/Mixed/Digital_Camera/(C.S)C-outdoor4/DSC03655.JPG,char_data/6/DSC03655.JPG_2.jpg,551,480,640,19,493,512,404,433,False,8
6,51,kaist_dataset/Mixed/Digital_Camera/(C.S)C-outdoor4/DSC03662.JPG,char_data/6/DSC03662.JPG_4.jpg,1428,480,640,28,513,541,411,462,False,8
6,49,kaist_dataset/Mixed/Digital_Camera/(C.S)C-outdoor4/DSC03662.JPG,char_data/6/DSC03662.JPG_5.jpg,980,480,640,20,542,562,413,462,False,8
6,34,kaist_dataset/Mixed/Digital_Camera/(C.S)C-outdoor4/DSC03667.JPG,char_data/6/DSC03667.JPG_2.jpg,544,480,640,16,505,521,374,408,False,8
6,25,kaist_dataset/Mixed/Digital_Camera/(C.S)C-outdoor4/DSC03670.JPG,char_data/6/DSC03670.JPG_2.jpg,250,480,640,10,454,464,447,472,False,8
6,28,kaist_dataset/Mixed/Digital_Camera/(C.S)C-outdoor4/DSC03674.JPG,char_data/6/DSC03674.JPG_2.jpg,392,480,640,14,531,545,422,450,False,8
6,33,kaist_dataset/Mixed/Digital_Camera/(C.S)C-outdoor4/DSC03676.JPG,char_data/6/DSC03676.JPG_2.jpg,462,480,640,14,154,168,272,305,False,8
6,25,kaist_dataset/Mixed/Digital_Camera/(C.S)C-outdoor4/DSC03687.JPG,char_data/6/DSC03687.JPG_2.jpg,250,480,640,10,474,484,402,427,False,8
6,33,kaist_dataset/Mixed/Digital_Camera/(C.S)C-outdoor4/DSC03716.JPG,char_data/6/DSC03716.JPG_2.jpg,462,480,640,14,615,629,250,283,False,8
6,29,kaist_dataset/Mixed/Digital_Camera/(C.S)C-outdoor4/DSC03723.JPG,char_data/6/DSC03723.JPG_2.jpg,638,480,640,22,498,520,197,226,False,8
6,41,kaist_dataset/Mixed/Digital_Camera/(C.S)C-outdoor4/DSC03730.JPG,char_data/6/DSC03730.JPG_4.jpg,1148,480,640,28,452,480,245,286,False,8
6,35,kaist_dataset/Mixed/Digital_Camera/(C.S)C-outdoor4/DSC03730.JPG,char_data/6/DSC03730.JPG_5.jpg,735,480,640,21,480,501,247,282,False,8
6,40,kaist_dataset/Mixed/Digital_Camera/(C.S)C-outdoor4/DSC03732.JPG,char_data/6/DSC03732.JPG_4.jpg,1200,480,640,30,470,500,391,431,False,8
6,38,kaist_dataset/Mixed/Digital_Camera/(C.S)C-outdoor4/DSC03732.JPG,char_data/6/DSC03732.JPG_5.jpg,1178,480,640,31,501,532,390,428,False,8
6,30,kaist_dataset/Mixed/Digital_Camera/(C.S)C-outdoor4/DSC03733.JPG,char_data/6/DSC03733.JPG_4.jpg,450,480,640,15,553,568,176,206,False,8
6,36,kaist_dataset/Mixed/Digital_Camera/(C.S)C-outdoor4/DSC03733.JPG,char_data/6/DSC03733.JPG_5.jpg,612,480,640,17,581,598,172,208,False,8
6,35,kaist_dataset/Mixed/Digital_Camera/(C.S)C-outdoor4/DSC03741.JPG,char_data/6/DSC03741.JPG_4.jpg,1085,480,640,31,448,479,366,401,False,8
6,43,kaist_dataset/Mixed/Digital_Camera/(C.S)C-outdoor4/DSC03741.JPG,char_data/6/DSC03741.JPG_5.jpg,1247,480,640,29,480,509,361,404,False,8
6,33,kaist_dataset/Mixed/Digital_Camera/(C.S)C-outdoor4/DSC03745.JPG,char_data/6/DSC03745.JPG_2.jpg,759,480,640,23,253,276,273,306,False,8
6,32,kaist_dataset/Mixed/Digital_Camera/(C.S)C-outdoor4/DSC03757.JPG,char_data/6/DSC03757.JPG_2.jpg,384,480,640,12,429,441,339,371,False,8
6,67,kaist_dataset/Mixed/Digital_Camera/(C.S)C-outdoor5/DSC04016.JPG,char_data/6/DSC04016.JPG_4.jpg,2479,480,640,37,247,284,324,391,False,8
6,70,kaist_dataset/Mixed/Digital_Camera/(C.S)C-outdoor5/DSC04016.JPG,char_data/6/DSC04016.JPG_5.jpg,2590,480,640,37,286,323,322,392,False,8
6,21,kaist_dataset/Mixed/Digital_Camera/(C.S)C-outdoor5/DSC04031.JPG,char_data/6/DSC04031.JPG_6.jpg,231,480,640,11,510,521,382,403,False,8
6,29,kaist_dataset/Mixed/Digital_Camera/(C.S)C-outdoor5/DSC04031.JPG,char_data/6/DSC04031.JPG_7.jpg,348,480,640,12,209,221,378,407,False,8
6,25,kaist_dataset/Mixed/Digital_Camera/(C.S)C-outdoor5/DSC04031.JPG,char_data/6/DSC04031.JPG_8.jpg,325,480,640,13,233,246,380,405,False,8
6,53,kaist_dataset/Mixed/Digital_Camera/(C.S)C-outdoor5/DSC04033.JPG,char_data/6/DSC04033.JPG_6.jpg,2226,480,640,42,259,301,278,331,False,8
6,52,kaist_dataset/Mixed/Digital_Camera/(C.S)C-outdoor5/DSC04033.JPG,char_data/6/DSC04033.JPG_7.jpg,1872,480,640,36,338,374,271,323,False,8
6,54,kaist_dataset/Mixed/Digital_Camera/(C.S)C-outdoor5/DSC04033.JPG,char_data/6/DSC04033.JPG_8.jpg,2052,480,640,38,456,494,264,318,False,8
6,36,kaist_dataset/Mixed/Digital_Camera/(C.S)C-outdoor5/DSC04056.JPG,char_data/6/DSC04056.JPG_2.jpg,900,480,640,25,520,545,259,295,False,8
6,39,kaist_dataset/Mixed/Digital_Camera/(C.S)C-outdoor5/DSC04071.JPG,char_data/6/DSC04071.JPG_6.jpg,1092,480,640,28,187,215,362,401,False,8
6,43,kaist_dataset/Mixed/Digital_Camera/(C.S)C-outdoor5/DSC04071.JPG,char_data/6/DSC04071.JPG_7.jpg,1290,480,640,30,233,263,357,400,False,8
6,32,kaist_dataset/Mixed/Digital_Camera/(C.S)C-outdoor5/DSC04071.JPG,char_data/6/DSC04071.JPG_8.jpg,768,480,640,24,486,510,369,401,False,8
6,28,kaist_dataset/Mixed/Digital_Camera/(C.S)C-outdoor5/DSC04086.JPG,char_data/6/DSC04086.JPG_2.jpg,420,480,640,15,451,466,371,399,False,8
6,30,kaist_dataset/Mixed/Digital_Camera/(C.S)C-outdoor5/DSC04146.JPG,char_data/6/DSC04146.JPG_4.jpg,570,480,640,19,351,370,407,437,False,8
6,30,kaist_dataset/Mixed/Digital_Camera/(C.S)C-outdoor5/DSC04146.JPG,char_data/6/DSC04146.JPG_5.jpg,660,480,640,22,387,409,405,435,False,8
6,27,kaist_dataset/Mixed/Digital_Camera/(C.S)C-outdoor5/DSC04151.JPG,char_data/6/DSC04151.JPG_2.jpg,486,480,640,18,489,507,349,376,False,8
6,31,kaist_dataset/Mixed/Digital_Camera/(C.S)C-outdoor5/DSC04155.JPG,char_data/6/DSC04155.JPG_4.jpg,527,480,640,17,572,589,262,293,False,8
6,32,kaist_dataset/Mixed/Digital_Camera/(C.S)C-outdoor5/DSC04155.JPG,char_data/6/DSC04155.JPG_5.jpg,768,480,640,24,589,613,263,295,False,8
6,121,kaist_dataset/Mixed/Digital_Camera/(C.S)C-outdoor5/DSC04449.JPG,char_data/6/DSC04449.JPG_4.jpg,9922,480,640,82,208,290,34,155,False,8
6,131,kaist_dataset/Mixed/Digital_Camera/(C.S)C-outdoor5/DSC04449.JPG,char_data/6/DSC04449.JPG_5.jpg,10087,480,640,77,478,555,34,165,False,8
6,37,kaist_dataset/Mixed/Digital_Camera/(C.S)C-outdoor5/P1010002.JPG,char_data/6/P1010002.JPG_2.jpg,925,480,640,25,548,573,281,318,False,8
6,41,kaist_dataset/Mixed/Digital_Camera/(C.S)C-outdoor6/P1010018.JPG,char_data/6/P1010018.JPG_4.jpg,902,480,640,22,230,252,238,279,False,8
6,32,kaist_dataset/Mixed/Digital_Camera/(C.S)C-outdoor6/P1010018.JPG,char_data/6/P1010018.JPG_5.jpg,704,480,640,22,495,517,243,275,False,8
6,41,kaist_dataset/Mixed/Digital_Camera/(C.S)C-outdoor6/P1010021.JPG,char_data/6/P1010021.JPG_4.jpg,1271,480,640,31,224,255,208,249,False,8
6,43,kaist_dataset/Mixed/Digital_Camera/(C.S)C-outdoor6/P1010021.JPG,char_data/6/P1010021.JPG_5.jpg,1247,480,640,29,255,284,207,250,False,8
6,71,kaist_dataset/Mixed/Digital_Camera/(C.S)C-outdoor6/P1010054.JPG,char_data/6/P1010054.JPG_2.jpg,4544,480,640,64,366,430,367,438,False,8
6,36,kaist_dataset/Mixed/Digital_Camera/(C.S)C-outdoor6/P1010056.JPG,char_data/6/P1010056.JPG_4.jpg,684,480,640,19,333,352,228,264,False,8
6,34,kaist_dataset/Mixed/Digital_Camera/(C.S)C-outdoor6/P1010056.JPG,char_data/6/P1010056.JPG_5.jpg,714,480,640,21,419,440,227,261,False,8
6,29,kaist_dataset/Mixed/Digital_Camera/(C.S)C-outdoor6/P1010082.JPG,char_data/6/P1010082.JPG_10.jpg,696,480,640,24,259,283,230,259,False,8
6,31,kaist_dataset/Mixed/Digital_Camera/(C.S)C-outdoor6/P1010082.JPG,char_data/6/P1010082.JPG_11.jpg,527,480,640,17,306,323,229,260,False,8
6,20,kaist_dataset/Mixed/Digital_Camera/(C.S)C-outdoor6/P1010085.JPG,char_data/6/P1010085.JPG_2.jpg,340,480,640,17,350,367,159,179,False,8
6,36,kaist_dataset/Mixed/Digital_Camera/(C.S)C-outdoor6/P1010097.JPG,char_data/6/P1010097.JPG_8.jpg,900,480,640,25,113,138,175,211,False,8
6,37,kaist_dataset/Mixed/Digital_Camera/(C.S)C-outdoor6/P1010097.JPG,char_data/6/P1010097.JPG_9.jpg,814,480,640,22,137,159,175,212,False,8
6,22,kaist_dataset/Mixed/Digital_Camera/(C.S)C-outdoor6/P1010097.JPG,char_data/6/P1010097.JPG_10.jpg,462,480,640,21,513,534,190,212,False,8
6,27,kaist_dataset/Mixed/Digital_Camera/(C.S)C-outdoor6/P1010097.JPG,char_data/6/P1010097.JPG_11.jpg,486,480,640,18,534,552,186,213,False,8
6,22,kaist_dataset/Mixed/Digital_Camera/(C.S)C-outdoor6/P1010099.JPG,char_data/6/P1010099.JPG_2.jpg,264,480,640,12,546,558,212,234,False,8
6,26,kaist_dataset/Mixed/Digital_Camera/(C.S)C-outdoor6/P1010137.JPG,char_data/6/P1010137.JPG_2.jpg,494,480,640,19,506,525,181,207,False,8
6,35,kaist_dataset/Mixed/Digital_Camera/(C.S)C-outdoor6/크기변환_fadscf0009_creawell.jpg,char_data/6/크기변환_fadscf0009_creawell.jpg_2.jpg,665,480,640,19,381,400,157,192,False,8
6,57,kaist_dataset/Mixed/Digital_Camera/(C.S)D-indoor1/DSC02733.JPG,char_data/6/DSC02733.JPG_2.jpg,2337,480,640,41,435,476,389,446,False,8
6,117,kaist_dataset/Mixed/Digital_Camera/(C.S)D-indoor1/DSC03455.JPG,char_data/6/DSC03455.JPG_2.jpg,14859,480,640,127,262,389,52,169,False,8
6,45,kaist_dataset/Mixed/Digital_Camera/(C.S)D-indoor1/DSC03980.JPG,char_data/6/DSC03980.JPG_2.jpg,1710,480,640,38,284,322,304,349,False,8
6,48,kaist_dataset/Mixed/Digital_Camera/(C.S)D-indoor1/DSC03986.JPG,char_data/6/DSC03986.JPG_2.jpg,720,480,640,15,82,97,160,208,False,8
6,44,kaist_dataset/Mixed/Digital_Camera/(C.S)D-indoor2/DSC04256.JPG,char_data/6/DSC04256.JPG_2.jpg,924,480,640,21,588,609,146,190,False,8
6,34,kaist_dataset/Mixed/Digital_Camera/(C.S)E-night/DSC02569.JPG,char_data/6/DSC02569.JPG_2.jpg,646,480,640,19,350,369,413,447,False,8
6,57,kaist_dataset/Mixed/Digital_Camera/(C.S)E-night/DSC02573.JPG,char_data/6/DSC02573.JPG_2.jpg,1710,480,640,30,349,379,171,228,False,8
6,59,kaist_dataset/Mixed/Digital_Camera/(C.S)E-night/DSC02574.JPG,char_data/6/DSC02574.JPG_2.jpg,2006,480,640,34,315,349,412,471,False,8
6,48,kaist_dataset/Mixed/Digital_Camera/(C.S)E-night/DSC02575.JPG,char_data/6/DSC02575.JPG_2.jpg,1584,480,640,33,290,323,357,405,False,8
6,40,kaist_dataset/Mixed/Digital_Camera/(C.S)E-night/DSC02586.JPG,char_data/6/DSC02586.JPG_2.jpg,560,480,640,14,325,339,390,430,False,8
6,36,kaist_dataset/Mixed/Digital_Camera/(C.S)E-night/DSC02623.JPG,char_data/6/DSC02623.JPG_2.jpg,612,480,640,17,109,126,398,434,False,8
6,35,kaist_dataset/Mixed/Digital_Camera/(C.S)E-night/DSC02644.JPG,char_data/6/DSC02644.JPG_2.jpg,560,480,640,16,320,336,399,434,False,8
6,36,kaist_dataset/Mixed/Digital_Camera/(C.S)E-night/DSC02647.JPG,char_data/6/DSC02647.JPG_2.jpg,1080,480,640,30,219,249,284,320,False,8
6,29,kaist_dataset/Mixed/Digital_Camera/(C.S)E-night/DSC02660.JPG,char_data/6/DSC02660.JPG_4.jpg,696,480,640,24,228,252,422,451,False,8
6,30,kaist_dataset/Mixed/Digital_Camera/(C.S)E-night/DSC02660.JPG,char_data/6/DSC02660.JPG_5.jpg,750,480,640,25,342,367,419,449,False,8
6,41,kaist_dataset/Mixed/Digital_Camera/(C.S)E-night/DSC02673.JPG,char_data/6/DSC02673.JPG_4.jpg,615,480,640,15,298,313,303,344,False,8
6,39,kaist_dataset/Mixed/Digital_Camera/(C.S)E-night/DSC02673.JPG,char_data/6/DSC02673.JPG_5.jpg,702,480,640,18,464,482,297,336,False,8
6,37,kaist_dataset/Mixed/Digital_Camera/(C.S)E-night/DSC02678.JPG,char_data/6/DSC02678.JPG_2.jpg,555,480,640,15,385,400,394,431,False,8
6,32,kaist_dataset/Mixed/Digital_Camera/(C.S)E-night/DSC02903.JPG,char_data/6/DSC02903.JPG_4.jpg,576,480,640,18,378,396,269,301,False,8
6,35,kaist_dataset/Mixed/Digital_Camera/(C.S)E-night/DSC02903.JPG,char_data/6/DSC02903.JPG_5.jpg,840,480,640,24,421,445,268,303,False,8
6,58,kaist_dataset/Mixed/Digital_Camera/(C.S)E-night/P1010147.JPG,char_data/6/P1010147.JPG_2.jpg,2204,480,640,38,270,308,258,316,False,8
6,82,kaist_dataset/Mixed/Digital_Camera/(C.S)E-night/P1010151.JPG,char_data/6/P1010151.JPG_2.jpg,4756,480,640,58,376,434,347,429,False,8
6,26,kaist_dataset/Mixed/Digital_Camera/(C.S)E-night/P1010155.JPG,char_data/6/P1010155.JPG_2.jpg,338,480,640,13,481,494,285,311,False,8
6,39,kaist_dataset/Mixed/Digital_Camera/(C.S)F-others/2007-12-08-day-044.jpg,char_data/6/2007-12-08-day-044.jpg_2.jpg,585,1200,1600,15,1043,1058,823,862,False,8
6,46,kaist_dataset/Mixed/Digital_Camera/(C.S)F-others/2007-12-08-day-113.jpg,char_data/6/2007-12-08-day-113.jpg_2.jpg,966,1200,1600,21,852,873,402,448,False,8
6,53,kaist_dataset/Mixed/Digital_Camera/(C.S)F-others/2007-12-09-day-exterior-023.jpg,char_data/6/2007-12-09-day-exterior-023.jpg_2.jpg,2226,1200,1600,42,896,938,582,635,False,8
6,37,kaist_dataset/Mixed/Digital_Camera/(C.S)F-others/DSC02504.JPG,char_data/6/DSC02504.JPG_2.jpg,1110,480,640,30,246,276,333,370,False,8
6,32,kaist_dataset/Mixed/Mobile_Phone/(C.M)A-outdoor/P090912036.jpg,char_data/6/P090912036.jpg_2.jpg,544,480,640,17,158,175,190,222,False,8
6,42,kaist_dataset/Mixed/Mobile_Phone/(C.M)C-bookCover/P090903009.jpg,char_data/6/P090903009.jpg_2.jpg,756,480,640,18,432,450,355,397,False,8
6,91,kaist_dataset/Mixed/Mobile_Phone/(C.M)C-bookCover/P090905002.jpg,char_data/6/P090905002.jpg_2.jpg,6643,480,640,73,462,535,43,134,False,8
3,27,kaist_dataset/English/Digital_Camera/(E.S)B-light/080116-0059.jpg,char_data/3/080116-0059.jpg_2.jpg,405,1200,1600,15,630,645,953,980,True,5
3,24,kaist_dataset/English/Digital_Camera/(E.S)C-outdoor1/042.JPG,char_data/3/042.JPG_2.jpg,288,480,640,12,518,530,320,344,True,5
3,51,kaist_dataset/English/Digital_Camera/(E.S)C-outdoor1/080116-0065.jpg,char_data/3/080116-0065.jpg_2.jpg,969,600,800,19,215,234,363,414,True,5
3,37,kaist_dataset/English/Digital_Camera/(E.S)C-outdoor1/DSC02364.JPG,char_data/3/DSC02364.JPG_2.jpg,518,480,640,14,582,596,352,389,True,5
3,184,kaist_dataset/English/Digital_Camera/(E.S)C-outdoor2/DSC02949.JPG,char_data/3/DSC02949.JPG_2.jpg,7176,480,640,39,352,391,59,243,True,5
3,35,kaist_dataset/English/Digital_Camera/(E.S)C-outdoor2/DSC03162.JPG,char_data/3/DSC03162.JPG_2.jpg,665,480,640,19,566,585,146,181,True,5
3,67,kaist_dataset/English/Digital_Camera/(E.S)C-outdoor2/DSC04163.JPG,char_data/3/DSC04163.JPG_4.jpg,2613,480,640,39,233,272,315,382,True,5
3,64,kaist_dataset/English/Digital_Camera/(E.S)C-outdoor2/DSC04163.JPG,char_data/3/DSC04163.JPG_5.jpg,2816,480,640,44,338,382,315,379,True,5
3,34,kaist_dataset/English/Digital_Camera/(E.S)D-indoor/DSC03943.JPG,char_data/3/DSC03943.JPG_2.jpg,510,480,640,15,376,391,311,345,True,5
3,52,kaist_dataset/English/Digital_Camera/(E.S)F-others/2007-12-09-day-exterior-047.jpg,char_data/3/2007-12-09-day-exterior-047.jpg_6.jpg,728,1200,1600,14,44,58,578,630,True,5
3,47,kaist_dataset/English/Digital_Camera/(E.S)F-others/2007-12-09-day-exterior-047.jpg,char_data/3/2007-12-09-day-exterior-047.jpg_7.jpg,658,1200,1600,14,58,72,587,634,True,5
3,41,kaist_dataset/English/Digital_Camera/(E.S)F-others/2007-12-09-day-exterior-047.jpg,char_data/3/2007-12-09-day-exterior-047.jpg_8.jpg,533,1200,1600,13,87,100,601,642,True,5
3,74,kaist_dataset/English/Mobile_Phone/(E.M)B-indoor/P090902018.jpg,char_data/3/P090902018.jpg_4.jpg,3034,480,640,41,194,235,164,238,True,5
3,75,kaist_dataset/English/Mobile_Phone/(E.M)B-indoor/P090902018.jpg,char_data/3/P090902018.jpg_5.jpg,2625,480,640,35,257,292,289,364,True,5
3,77,kaist_dataset/Korean/Digital_Camera/A-shadow/2007-12-09-day-exterior-031.jpg,char_data/3/2007-12-09-day-exterior-031.jpg_2.jpg,3696,1200,1600,48,745,793,670,747,True,5
3,41,kaist_dataset/Korean/Digital_Camera/A-shadow/DSC02598.JPG,char_data/3/DSC02598.JPG_8.jpg,779,480,640,19,574,593,413,454,True,5
3,40,kaist_dataset/Korean/Digital_Camera/A-shadow/DSC02598.JPG,char_data/3/DSC02598.JPG_9.jpg,760,480,640,19,593,612,415,455,True,5
3,163,kaist_dataset/Korean/Digital_Camera/A-shadow/DSC02670.JPG,char_data/3/DSC02670.JPG_4.jpg,10595,480,640,65,338,403,14,177,True,5
3,155,kaist_dataset/Korean/Digital_Camera/A-shadow/DSC02670.JPG,char_data/3/DSC02670.JPG_5.jpg,10695,480,640,69,409,478,18,173,True,5
3,78,kaist_dataset/Korean/Digital_Camera/A-shadow/DSC03535.JPG,char_data/3/DSC03535.JPG_2.jpg,3198,480,640,41,313,354,247,325,True,5
3,130,kaist_dataset/Korean/Digital_Camera/A-shadow/DSC04300.JPG,char_data/3/DSC04300.JPG_2.jpg,6500,480,640,50,209,259,219,349,True,5
3,22,kaist_dataset/Korean/Digital_Camera/E-night/103.jpg,char_data/3/103.jpg_4.jpg,154,480,640,7,194,201,314,336,True,5
3,18,kaist_dataset/Korean/Digital_Camera/E-night/103.jpg,char_data/3/103.jpg_5.jpg,144,480,640,8,202,210,315,333,True,5
3,52,kaist_dataset/Korean/Digital_Camera/E-night/DSC02594.JPG,char_data/3/DSC02594.JPG_2.jpg,2080,480,640,40,195,235,378,430,True,5
3,56,kaist_dataset/Korean/Digital_Camera/E-night/DSC02597.JPG,char_data/3/DSC02597.JPG_2.jpg,1736,480,640,31,434,465,285,341,True,5
3,49,kaist_dataset/Korean/Digital_Camera/E-night/DSC02645.JPG,char_data/3/DSC02645.JPG_2.jpg,1274,480,640,26,363,389,331,380,True,5
3,122,kaist_dataset/Korean/Digital_Camera/F-bookCover/DSC02827.JPG,char_data/3/DSC02827.JPG_2.jpg,11956,480,640,98,90,188,293,415,True,5
3,109,kaist_dataset/Korean/Digital_Camera/F-bookCover/DSC02832.JPG,char_data/3/DSC02832.JPG_2.jpg,6649,480,640,61,205,266,22,131,True,5
3,90,kaist_dataset/Korean/Digital_Camera/F-bookCover/DSC02833.JPG,char_data/3/DSC02833.JPG_2.jpg,4140,480,640,46,203,249,46,136,True,5
3,101,kaist_dataset/Korean/Digital_Camera/F-bookCover/DSC02835.JPG,char_data/3/DSC02835.JPG_2.jpg,6666,480,640,66,172,238,15,116,True,5
3,185,kaist_dataset/Korean/Digital_Camera/F-bookCover/P090911043.jpg,char_data/3/P090911043.jpg_2.jpg,17760,480,640,96,85,181,143,328,True,5
3,48,kaist_dataset/Korean/Digital_Camera/G-others/2007-12-08-day-045.jpg,char_data/3/2007-12-08-day-045.jpg_2.jpg,864,1200,1600,18,132,150,794,842,True,5
3,44,kaist_dataset/Korean/Digital_Camera/G-others/2007-12-09-day-exterior-083.jpg,char_data/3/2007-12-09-day-exterior-083.jpg_4.jpg,1364,1600,1200,31,574,605,972,1016,True,5
3,52,kaist_dataset/Korean/Digital_Camera/G-others/2007-12-09-day-exterior-083.jpg,char_data/3/2007-12-09-day-exterior-083.jpg_5.jpg,1872,1600,1200,36,370,406,126,178,True,5
3,29,kaist_dataset/Korean/Digital_Camera/G-others/DSC03863.JPG,char_data/3/DSC03863.JPG_4.jpg,348,480,640,12,228,240,406,435,True,5
3,26,kaist_dataset/Korean/Digital_Camera/G-others/DSC03863.JPG,char_data/3/DSC03863.JPG_5.jpg,364,480,640,14,240,254,407,433,True,5
3,52,kaist_dataset/Korean/Digital_Camera/indoor1/080119-0018.jpg,char_data/3/080119-0018.jpg_8.jpg,1352,1200,1600,26,1041,1067,695,747,True,5
3,53,kaist_dataset/Korean/Digital_Camera/indoor1/080119-0018.jpg,char_data/3/080119-0018.jpg_9.jpg,1484,1200,1600,28,969,997,773,826,True,5
3,46,kaist_dataset/Korean/Digital_Camera/indoor1/080119-0018.jpg,char_data/3/080119-0018.jpg_10.jpg,1150,1200,1600,25,1084,1109,940,986,True,5
3,46,kaist_dataset/Korean/Digital_Camera/indoor1/080119-0018.jpg,char_data/3/080119-0018.jpg_11.jpg,1150,1200,1600,25,1132,1157,936,982,True,5
3,89,kaist_dataset/Korean/Digital_Camera/indoor1/080119-0029.jpg,char_data/3/080119-0029.jpg_4.jpg,3382,1200,1600,38,523,561,573,662,True,5
3,44,kaist_dataset/Korean/Digital_Camera/indoor1/080119-0029.jpg,char_data/3/080119-0029.jpg_5.jpg,660,1200,1600,15,1254,1269,620,664,True,5
3,88,kaist_dataset/Korean/Digital_Camera/indoor1/080119-0030.jpg,char_data/3/080119-0030.jpg_4.jpg,4400,1200,1600,50,961,1011,433,521,True,5
3,28,kaist_dataset/Korean/Digital_Camera/indoor1/080119-0030.jpg,char_data/3/080119-0030.jpg_5.jpg,308,1200,1600,11,761,772,865,893,True,5
3,185,kaist_dataset/Korean/Digital_Camera/indoor1/DSC02699.JPG,char_data/3/DSC02699.JPG_2.jpg,20165,480,640,109,8,117,234,419,True,5
3,155,kaist_dataset/Korean/Digital_Camera/indoor1/DSC02700.JPG,char_data/3/DSC02700.JPG_4.jpg,16895,480,640,109,96,205,208,363,True,5
3,32,kaist_dataset/Korean/Digital_Camera/indoor1/DSC02700.JPG,char_data/3/DSC02700.JPG_5.jpg,512,480,640,16,270,286,425,457,True,5
3,62,kaist_dataset/Korean/Digital_Camera/indoor1/DSC02715.JPG,char_data/3/DSC02715.JPG_2.jpg,2790,480,640,45,283,328,174,236,True,5
3,87,kaist_dataset/Korean/Digital_Camera/indoor1/DSC02728.JPG,char_data/3/DSC02728.JPG_2.jpg,6003,480,640,69,288,357,169,256,True,5
3,88,kaist_dataset/Korean/Digital_Camera/indoor1/DSC03364.JPG,char_data/3/DSC03364.JPG_2.jpg,6424,480,640,73,189,262,236,324,True,5
3,116,kaist_dataset/Korean/Digital_Camera/indoor1/DSC03374.JPG,char_data/3/DSC03374.JPG_2.jpg,9744,480,640,84,128,212,290,406,True,5
3,49,kaist_dataset/Korean/Digital_Camera/indoor2/DSC03474.JPG,char_data/3/DSC03474.JPG_2.jpg,1568,480,640,32,339,371,210,259,True,5
3,25,kaist_dataset/Korean/Digital_Camera/outdoor1/002.JPG,char_data/3/002.JPG_2.jpg,275,480,640,11,349,360,374,399,True,5
3,19,kaist_dataset/Korean/Digital_Camera/outdoor1/006.JPG,char_data/3/006.JPG_2.jpg,285,480,640,15,365,380,253,272,True,5
3,28,kaist_dataset/Korean/Digital_Camera/outdoor1/011.JPG,char_data/3/011.JPG_2.jpg,616,480,640,22,385,407,254,282,True,5
3,13,kaist_dataset/Korean/Digital_Camera/outdoor1/013.JPG,char_data/3/013.JPG_2.jpg,143,480,640,11,389,400,252,265,True,5
3,27,kaist_dataset/Korean/Digital_Camera/outdoor1/032.JPG,char_data/3/032.JPG_6.jpg,567,480,640,21,367,388,259,286,True,5
3,31,kaist_dataset/Korean/Digital_Camera/outdoor1/032.JPG,char_data/3/032.JPG_7.jpg,651,480,640,21,455,476,253,284,True,5
3,32,kaist_dataset/Korean/Digital_Camera/outdoor1/032.JPG,char_data/3/032.JPG_8.jpg,480,480,640,15,507,522,255,287,True,5
3,31,kaist_dataset/Korean/Digital_Camera/outdoor1/035.JPG,char_data/3/035.JPG_4.jpg,496,480,640,16,289,305,287,318,True,5
3,33,kaist_dataset/Korean/Digital_Camera/outdoor1/035.JPG,char_data/3/035.JPG_5.jpg,561,480,640,17,521,538,285,318,True,5
3,27,kaist_dataset/Korean/Digital_Camera/outdoor1/040.JPG,char_data/3/040.JPG_6.jpg,702,480,640,26,313,339,301,328,True,5
3,29,kaist_dataset/Korean/Digital_Camera/outdoor1/040.JPG,char_data/3/040.JPG_7.jpg,783,480,640,27,338,365,299,328,True,5
3,28,kaist_dataset/Korean/Digital_Camera/outdoor1/040.JPG,char_data/3/040.JPG_8.jpg,644,480,640,23,365,388,302,330,True,5
3,49,kaist_dataset/Korean/Digital_Camera/outdoor1/052.JPG,char_data/3/052.JPG_4.jpg,931,480,640,19,301,320,317,366,True,5
3,40,kaist_dataset/Korean/Digital_Camera/outdoor1/052.JPG,char_data/3/052.JPG_5.jpg,1240,480,640,31,439,470,322,362,True,5
3,47,kaist_dataset/Korean/Digital_Camera/outdoor1/098.JPG,char_data/3/098.JPG_2.jpg,1551,480,640,33,137,170,353,400,True,5
3,27,kaist_dataset/Korean/Digital_Camera/outdoor1/102.JPG,char_data/3/102.JPG_2.jpg,540,480,640,20,309,329,308,335,True,5
3,33,kaist_dataset/Korean/Digital_Camera/outdoor1/123.JPG,char_data/3/123.JPG_2.jpg,594,480,640,18,212,230,277,310,True,5
3,28,kaist_dataset/Korean/Digital_Camera/outdoor1/125.JPG,char_data/3/125.JPG_2.jpg,560,480,640,20,310,330,257,285,True,5
3,23,kaist_dataset/Korean/Digital_Camera/outdoor1/126.JPG,char_data/3/126.JPG_4.jpg,667,480,640,29,274,303,266,289,True,5
3,21,kaist_dataset/Korean/Digital_Camera/outdoor1/126.JPG,char_data/3/126.JPG_5.jpg,252,480,640,12,567,579,259,280,True,5
3,40,kaist_dataset/Korean/Digital_Camera/outdoor1/127.JPG,char_data/3/127.JPG_2.jpg,1080,480,640,27,366,393,269,309,True,5
3,43,kaist_dataset/Korean/Digital_Camera/outdoor1/54.JPG,char_data/3/54.JPG_2.jpg,1204,523,767,28,636,664,362,405,True,5
3,37,kaist_dataset/Korean/Digital_Camera/outdoor2/2007-12-08-day-101.jpg,char_data/3/2007-12-08-day-101.jpg_2.jpg,629,1200,1600,17,844,861,744,781,True,5
3,73,kaist_dataset/Korean/Digital_Camera/outdoor2/2007-12-09-day-exterior-012.jpg,char_data/3/2007-12-09-day-exterior-012.jpg_2.jpg,3212,1200,1600,44,1108,1152,622,695,True,5
3,40,kaist_dataset/Korean/Digital_Camera/outdoor2/2007-12-09-day-exterior-036.jpg,char_data/3/2007-12-09-day-exterior-036.jpg_2.jpg,840,1200,1600,21,1502,1523,629,669,True,5
3,37,kaist_dataset/Korean/Digital_Camera/outdoor2/2007-12-09-day-exterior-084.jpg,char_data/3/2007-12-09-day-exterior-084.jpg_2.jpg,1258,1200,1600,34,803,837,801,838,True,5
3,29,kaist_dataset/Korean/Digital_Camera/outdoor2/DSC02304.JPG,char_data/3/DSC02304.JPG_2.jpg,812,480,640,28,351,379,264,293,True,5
3,31,kaist_dataset/Korean/Digital_Camera/outdoor2/DSC02308.JPG,char_data/3/DSC02308.JPG_2.jpg,930,480,640,30,287,317,238,269,True,5
3,33,kaist_dataset/Korean/Digital_Camera/outdoor2/DSC02310.JPG,char_data/3/DSC02310.JPG_2.jpg,1089,480,640,33,377,410,211,244,True,5
3,37,kaist_dataset/Korean/Digital_Camera/outdoor2/DSC02311.JPG,char_data/3/DSC02311.JPG_4.jpg,777,480,640,21,492,513,252,289,True,5
3,34,kaist_dataset/Korean/Digital_Camera/outdoor2/DSC02311.JPG,char_data/3/DSC02311.JPG_5.jpg,884,480,640,26,530,556,251,285,True,5
3,42,kaist_dataset/Korean/Digital_Camera/outdoor2/DSC02366.JPG,char_data/3/DSC02366.JPG_2.jpg,966,480,640,23,369,392,407,449,True,5
3,39,kaist_dataset/Korean/Digital_Camera/outdoor2/DSC02371.JPG,char_data/3/DSC02371.JPG_2.jpg,741,480,640,19,196,215,241,280,True,5
3,33,kaist_dataset/Korean/Digital_Camera/outdoor2/DSC02372.JPG,char_data/3/DSC02372.JPG_2.jpg,396,480,640,12,536,548,283,316,True,5
3,40,kaist_dataset/Korean/Digital_Camera/outdoor2/DSC02381.JPG,char_data/3/DSC02381.JPG_2.jpg,800,480,640,20,255,275,312,352,True,5
3,31,kaist_dataset/Korean/Digital_Camera/outdoor2/DSC02383.JPG,char_data/3/DSC02383.JPG_6.jpg,496,480,640,16,62,78,298,329,True,5
3,35,kaist_dataset/Korean/Digital_Camera/outdoor2/DSC02383.JPG,char_data/3/DSC02383.JPG_7.jpg,420,480,640,12,103,115,292,327,True,5
3,33,kaist_dataset/Korean/Digital_Camera/outdoor2/DSC02383.JPG,char_data/3/DSC02383.JPG_8.jpg,528,480,640,16,295,311,287,320,True,5
3,41,kaist_dataset/Korean/Digital_Camera/outdoor2/DSC02386.JPG,char_data/3/DSC02386.JPG_6.jpg,861,480,640,21,466,487,252,293,True,5
3,36,kaist_dataset/Korean/Digital_Camera/outdoor2/DSC02386.JPG,char_data/3/DSC02386.JPG_7.jpg,756,480,640,21,518,539,252,288,True,5
3,35,kaist_dataset/Korean/Digital_Camera/outdoor2/DSC02386.JPG,char_data/3/DSC02386.JPG_8.jpg,840,480,640,24,538,562,252,287,True,5
3,34,kaist_dataset/Korean/Digital_Camera/outdoor2/DSC02396.JPG,char_data/3/DSC02396.JPG_4.jpg,782,480,640,23,434,457,371,405,True,5
3,35,kaist_dataset/Korean/Digital_Camera/outdoor2/DSC02396.JPG,char_data/3/DSC02396.JPG_5.jpg,1050,480,640,30,502,532,367,402,True,5
3,22,kaist_dataset/Korean/Digital_Camera/outdoor2/DSC02424.JPG,char_data/3/DSC02424.JPG_2.jpg,286,480,640,13,485,498,246,268,True,5
3,38,kaist_dataset/Korean/Digital_Camera/outdoor2/DSC02426.JPG,char_data/3/DSC02426.JPG_2.jpg,1140,480,640,30,590,620,210,248,True,5
3,24,kaist_dataset/Korean/Digital_Camera/outdoor2/DSC02441.JPG,char_data/3/DSC02441.JPG_6.jpg,360,480,640,15,460,475,203,227,True,5
3,30,kaist_dataset/Korean/Digital_Camera/outdoor2/DSC02441.JPG,char_data/3/DSC02441.JPG_7.jpg,540,480,640,18,499,517,202,232,True,5
3,28,kaist_dataset/Korean/Digital_Camera/outdoor2/DSC02441.JPG,char_data/3/DSC02441.JPG_8.jpg,392,480,640,14,517,531,202,230,True,5
3,36,kaist_dataset/Korean/Digital_Camera/outdoor2/DSC02467.JPG,char_data/3/DSC02467.JPG_2.jpg,684,480,640,19,269,288,253,289,True,5
3,31,kaist_dataset/Korean/Digital_Camera/outdoor2/DSC02470.JPG,char_data/3/DSC02470.JPG_4.jpg,651,480,640,21,265,286,177,208,True,5
3,29,kaist_dataset/Korean/Digital_Camera/outdoor2/DSC02470.JPG,char_data/3/DSC02470.JPG_5.jpg,609,480,640,21,313,334,174,203,True,5
3,50,kaist_dataset/Korean/Digital_Camera/outdoor2/DSC02485.JPG,char_data/3/DSC02485.JPG_2.jpg,1900,480,640,38,144,182,275,325,True,5
3,39,kaist_dataset/Korean/Digital_Camera/outdoor2/DSC02488.JPG,char_data/3/DSC02488.JPG_4.jpg,858,480,640,22,508,530,370,409,True,5
3,40,kaist_dataset/Korean/Digital_Camera/outdoor2/DSC02488.JPG,char_data/3/DSC02488.JPG_5.jpg,760,480,640,19,575,594,370,410,True,5
3,55,kaist_dataset/Korean/Digital_Camera/outdoor2/DSC02512.JPG,char_data/3/DSC02512.JPG_2.jpg,1650,480,640,30,455,485,287,342,True,5
3,53,kaist_dataset/Korean/Digital_Camera/outdoor2/DSC02515.JPG,char_data/3/DSC02515.JPG_2.jpg,2067,480,640,39,295,334,328,381,True,5
3,126,kaist_dataset/Korean/Digital_Camera/outdoor2/DSC02520.JPG,char_data/3/DSC02520.JPG_6.jpg,4410,480,640,35,367,402,297,423,True,5
3,121,kaist_dataset/Korean/Digital_Camera/outdoor2/DSC02520.JPG,char_data/3/DSC02520.JPG_7.jpg,4598,480,640,38,504,542,294,415,True,5
3,120,kaist_dataset/Korean/Digital_Camera/outdoor2/DSC02520.JPG,char_data/3/DSC02520.JPG_8.jpg,4560,480,640,38,569,607,298,418,True,5
3,29,kaist_dataset/Korean/Digital_Camera/outdoor2/DSC02521.JPG,char_data/3/DSC02521.JPG_2.jpg,609,480,640,21,334,355,326,355,True,5
3,119,kaist_dataset/Korean/Digital_Camera/outdoor3/DSC02525.JPG,char_data/3/DSC02525.JPG_2.jpg,8568,480,640,72,100,172,17,136,True,5
3,27,kaist_dataset/Korean/Digital_Camera/outdoor3/DSC02529.JPG,char_data/3/DSC02529.JPG_2.jpg,243,480,640,9,589,598,372,399,True,5
3,33,kaist_dataset/Korean/Digital_Camera/outdoor3/DSC02531.JPG,char_data/3/DSC02531.JPG_2.jpg,660,480,640,20,248,268,351,384,True,5
3,34,kaist_dataset/Korean/Digital_Camera/outdoor3/DSC02558.JPG,char_data/3/DSC02558.JPG_4.jpg,544,480,640,16,514,530,218,252,True,5
3,33,kaist_dataset/Korean/Digital_Camera/outdoor3/DSC02558.JPG,char_data/3/DSC02558.JPG_5.jpg,462,480,640,14,587,601,218,251,True,5
3,41,kaist_dataset/Korean/Digital_Camera/outdoor3/DSC02598.JPG,char_data/3/DSC02598.JPG_10.jpg,779,480,640,19,574,593,413,454,True,5
3,40,kaist_dataset/Korean/Digital_Camera/outdoor3/DSC02598.JPG,char_data/3/DSC02598.JPG_11.jpg,760,480,640,19,593,612,415,455,True,5
3,48,kaist_dataset/Korean/Digital_Camera/outdoor3/DSC02697.JPG,char_data/3/DSC02697.JPG_2.jpg,1968,480,640,41,299,340,378,426,True,5
3,34,kaist_dataset/Korean/Digital_Camera/outdoor3/DSC02698.JPG,char_data/3/DSC02698.JPG_2.jpg,612,480,640,18,347,365,403,437,True,5
3,33,kaist_dataset/Korean/Digital_Camera/outdoor3/DSC02888.JPG,char_data/3/DSC02888.JPG_6.jpg,858,480,640,26,233,259,423,456,True,5
3,30,kaist_dataset/Korean/Digital_Camera/outdoor3/DSC02888.JPG,char_data/3/DSC02888.JPG_7.jpg,810,480,640,27,301,328,420,450,True,5
3,33,kaist_dataset/Korean/Digital_Camera/outdoor3/DSC02888.JPG,char_data/3/DSC02888.JPG_8.jpg,957,480,640,29,448,477,418,451,True,5
3,41,kaist_dataset/Korean/Digital_Camera/outdoor3/DSC02941.JPG,char_data/3/DSC02941.JPG_2.jpg,1230,480,640,30,494,524,255,296,True,5
3,64,kaist_dataset/Korean/Digital_Camera/outdoor3/DSC02953.JPG,char_data/3/DSC02953.JPG_2.jpg,1984,480,640,31,492,523,383,447,True,5
3,35,kaist_dataset/Korean/Digital_Camera/outdoor3/DSC02971.JPG,char_data/3/DSC02971.JPG_4.jpg,1050,480,640,30,342,372,298,333,True,5
3,35,kaist_dataset/Korean/Digital_Camera/outdoor3/DSC02971.JPG,char_data/3/DSC02971.JPG_5.jpg,770,480,640,22,373,395,298,333,True,5
3,38,kaist_dataset/Korean/Digital_Camera/outdoor3/DSC02975.JPG,char_data/3/DSC02975.JPG_2.jpg,836,480,640,22,440,462,244,282,True,5
3,45,kaist_dataset/Korean/Digital_Camera/outdoor3/DSC02994.JPG,char_data/3/DSC02994.JPG_2.jpg,1395,480,640,31,397,428,289,334,True,5
3,164,kaist_dataset/Korean/Digital_Camera/outdoor3/DSC03066.JPG,char_data/3/DSC03066.JPG_2.jpg,26404,480,640,161,179,340,240,404,True,5
3,115,kaist_dataset/Korean/Digital_Camera/outdoor3/DSC03159.JPG,char_data/3/DSC03159.JPG_2.jpg,6900,480,640,60,227,287,225,340,True,5
3,61,kaist_dataset/Korean/Digital_Camera/outdoor3/DSC03198.JPG,char_data/3/DSC03198.JPG_2.jpg,2684,480,640,44,220,264,200,261,True,5
3,65,kaist_dataset/Korean/Digital_Camera/outdoor3/DSC03221.JPG,char_data/3/DSC03221.JPG_2.jpg,4160,480,640,64,42,106,80,145,True,5
3,90,kaist_dataset/Korean/Digital_Camera/outdoor3/DSC03222.JPG,char_data/3/DSC03222.JPG_2.jpg,7290,480,640,81,166,247,358,448,True,5
3,58,kaist_dataset/Korean/Digital_Camera/outdoor4/DSC03261.JPG,char_data/3/DSC03261.JPG_4.jpg,2320,480,640,40,349,389,398,456,True,5
3,54,kaist_dataset/Korean/Digital_Camera/outdoor4/DSC03261.JPG,char_data/3/DSC03261.JPG_5.jpg,2214,480,640,41,428,469,403,457,True,5
3,84,kaist_dataset/Korean/Digital_Camera/outdoor4/DSC03320.JPG,char_data/3/DSC03320.JPG_2.jpg,4284,480,640,51,294,345,380,464,True,5
3,64,kaist_dataset/Korean/Digital_Camera/outdoor4/DSC03537.JPG,char_data/3/DSC03537.JPG_4.jpg,2816,480,640,44,267,311,130,194,True,5
3,61,kaist_dataset/Korean/Digital_Camera/outdoor4/DSC03537.JPG,char_data/3/DSC03537.JPG_5.jpg,2257,480,640,37,353,390,128,189,True,5
3,100,kaist_dataset/Korean/Digital_Camera/outdoor4/DSC03542.JPG,char_data/3/DSC03542.JPG_2.jpg,4800,480,640,48,245,293,234,334,True,5
3,72,kaist_dataset/Korean/Digital_Camera/outdoor4/DSC03555.JPG,char_data/3/DSC03555.JPG_2.jpg,3096,480,640,43,262,305,353,425,True,5
3,61,kaist_dataset/Korean/Digital_Camera/outdoor4/DSC03592.JPG,char_data/3/DSC03592.JPG_8.jpg,1769,480,640,29,430,459,57,118,True,5
3,39,kaist_dataset/Korean/Digital_Camera/outdoor4/DSC03592.JPG,char_data/3/DSC03592.JPG_9.jpg,819,480,640,21,298,319,117,156,True,5
3,36,kaist_dataset/Korean/Digital_Camera/outdoor4/DSC03592.JPG,char_data/3/DSC03592.JPG_10.jpg,792,480,640,22,498,520,125,161,True,5
3,39,kaist_dataset/Korean/Digital_Camera/outdoor4/DSC03592.JPG,char_data/3/DSC03592.JPG_11.jpg,819,480,640,21,605,626,124,163,True,5
3,41,kaist_dataset/Korean/Digital_Camera/outdoor4/DSC03598.JPG,char_data/3/DSC03598.JPG_2.jpg,1353,480,640,33,282,315,267,308,True,5
3,49,kaist_dataset/Korean/Digital_Camera/outdoor4/DSC03603.JPG,char_data/3/DSC03603.JPG_4.jpg,1421,480,640,29,262,291,52,101,True,5
3,41,kaist_dataset/Korean/Digital_Camera/outdoor4/DSC03603.JPG,char_data/3/DSC03603.JPG_5.jpg,902,480,640,22,321,343,287,328,True,5
3,57,kaist_dataset/Korean/Digital_Camera/outdoor4/DSC03607.JPG,char_data/3/DSC03607.JPG_2.jpg,2736,480,640,48,77,125,96,153,True,5
3,45,kaist_dataset/Korean/Digital_Camera/outdoor4/DSC03614.JPG,char_data/3/DSC03614.JPG_2.jpg,1080,480,640,24,409,433,389,434,True,5
3,31,kaist_dataset/Korean/Digital_Camera/outdoor5/DSC03636.JPG,char_data/3/DSC03636.JPG_2.jpg,527,480,640,17,276,293,397,428,True,5
3,32,kaist_dataset/Korean/Digital_Camera/outdoor5/DSC03641.JPG,char_data/3/DSC03641.JPG_2.jpg,576,480,640,18,442,460,422,454,True,5
3,37,kaist_dataset/Korean/Digital_Camera/outdoor5/DSC03671.JPG,char_data/3/DSC03671.JPG_2.jpg,814,480,640,22,491,513,410,447,True,5
3,25,kaist_dataset/Korean/Digital_Camera/outdoor5/DSC03688.JPG,char_data/3/DSC03688.JPG_2.jpg,350,480,640,14,618,632,227,252,True,5
3,36,kaist_dataset/Korean/Digital_Camera/outdoor5/DSC03692.JPG,char_data/3/DSC03692.JPG_2.jpg,540,480,640,15,504,519,188,224,True,5
3,68,kaist_dataset/Korean/Digital_Camera/outdoor5/DSC03694.JPG,char_data/3/DSC03694.JPG_2.jpg,1836,480,640,27,572,599,118,186,True,5
3,93,kaist_dataset/Korean/Digital_Camera/outdoor5/DSC03715.JPG,char_data/3/DSC03715.JPG_2.jpg,4371,480,640,47,503,550,79,172,True,5
3,29,kaist_dataset/Korean/Digital_Camera/outdoor5/DSC03736.JPG,char_data/3/DSC03736.JPG_4.jpg,464,480,640,16,384,400,406,435,True,5
3,29,kaist_dataset/Korean/Digital_Camera/outdoor5/DSC03736.JPG,char_data/3/DSC03736.JPG_5.jpg,464,480,640,16,400,416,406,435,True,5
3,64,kaist_dataset/Korean/Digital_Camera/outdoor5/DSC03749.JPG,char_data/3/DSC03749.JPG_2.jpg,2176,480,640,34,545,579,411,475,True,5
3,22,kaist_dataset/Korean/Digital_Camera/outdoor5/DSC03752.JPG,char_data/3/DSC03752.JPG_2.jpg,220,480,640,10,122,132,412,434,True,5
3,30,kaist_dataset/Korean/Digital_Camera/outdoor5/DSC03777.JPG,char_data/3/DSC03777.JPG_4.jpg,390,480,640,13,141,154,345,375,True,5
3,29,kaist_dataset/Korean/Digital_Camera/outdoor5/DSC03777.JPG,char_data/3/DSC03777.JPG_5.jpg,435,480,640,15,213,228,342,371,True,5
3,72,kaist_dataset/Korean/Digital_Camera/outdoor5/DSC03790.JPG,char_data/3/DSC03790.JPG_2.jpg,4248,480,640,59,498,557,149,221,True,5
3,36,kaist_dataset/Korean/Digital_Camera/outdoor5/DSC03794.JPG,char_data/3/DSC03794.JPG_2.jpg,648,480,640,18,384,402,359,395,True,5
3,32,kaist_dataset/Korean/Digital_Camera/outdoor5/DSC03853.JPG,char_data/3/DSC03853.JPG_2.jpg,512,480,640,16,428,444,117,149,True,5
3,38,kaist_dataset/Korean/Digital_Camera/outdoor5/DSC03858.JPG,char_data/3/DSC03858.JPG_2.jpg,722,480,640,19,468,487,415,453,True,5
3,89,kaist_dataset/Korean/Digital_Camera/outdoor5/DSC03864.JPG,char_data/3/DSC03864.JPG_2.jpg,5251,480,640,59,529,588,169,258,True,5
3,56,kaist_dataset/Korean/Digital_Camera/outdoor5/DSC03979.JPG,char_data/3/DSC03979.JPG_4.jpg,3920,480,640,70,191,261,377,433,True,5
3,47,kaist_dataset/Korean/Digital_Camera/outdoor5/DSC03979.JPG,char_data/3/DSC03979.JPG_5.jpg,3008,480,640,64,438,502,387,434,True,5
3,38,kaist_dataset/Korean/Digital_Camera/outdoor5/DSC04027.JPG,char_data/3/DSC04027.JPG_2.jpg,950,480,640,25,168,193,389,427,True,5
3,27,kaist_dataset/Korean/Digital_Camera/outdoor6/DSC04042.JPG,char_data/3/DSC04042.JPG_2.jpg,351,480,640,13,86,99,331,358,True,5
3,82,kaist_dataset/Korean/Digital_Camera/outdoor6/DSC04083.JPG,char_data/3/DSC04083.JPG_2.jpg,3362,480,640,41,436,477,157,239,True,5
3,38,kaist_dataset/Korean/Digital_Camera/outdoor6/DSC04116.JPG,char_data/3/DSC04116.JPG_6.jpg,646,480,640,17,272,289,319,357,True,5
3,41,kaist_dataset/Korean/Digital_Camera/outdoor6/DSC04116.JPG,char_data/3/DSC04116.JPG_7.jpg,615,480,640,15,360,375,316,357,True,5
3,34,kaist_dataset/Korean/Digital_Camera/outdoor6/DSC04116.JPG,char_data/3/DSC04116.JPG_8.jpg,510,480,640,15,423,438,319,353,True,5
3,49,kaist_dataset/Korean/Digital_Camera/outdoor6/DSC04136.JPG,char_data/3/DSC04136.JPG_2.jpg,1274,480,640,26,350,376,328,377,True,5
3,40,kaist_dataset/Korean/Digital_Camera/outdoor6/DSC04148.JPG,char_data/3/DSC04148.JPG_2.jpg,680,480,640,17,445,462,255,295,True,5
3,77,kaist_dataset/Korean/Digital_Camera/outdoor6/DSC04292.JPG,char_data/3/DSC04292.JPG_2.jpg,3696,480,640,48,454,502,14,91,True,5
3,55,kaist_dataset/Korean/Digital_Camera/outdoor6/DSC04296.JPG,char_data/3/DSC04296.JPG_4.jpg,1320,480,640,24,261,285,315,370,True,5
3,59,kaist_dataset/Korean/Digital_Camera/outdoor6/DSC04296.JPG,char_data/3/DSC04296.JPG_5.jpg,1121,480,640,19,304,323,308,367,True,5
3,23,kaist_dataset/Korean/Digital_Camera/outdoor6/DSC04341.JPG,char_data/3/DSC04341.JPG_4.jpg,414,480,640,18,547,565,226,249,True,5
3,26,kaist_dataset/Korean/Digital_Camera/outdoor6/DSC04341.JPG,char_data/3/DSC04341.JPG_5.jpg,572,480,640,22,562,584,222,248,True,5
3,80,kaist_dataset/Korean/Digital_Camera/outdoor6/DSC04359.JPG,char_data/3/DSC04359.JPG_2.jpg,3120,480,640,39,185,224,111,191,True,5
3,40,kaist_dataset/Korean/Digital_Camera/outdoor6/DSC04400.JPG,char_data/3/DSC04400.JPG_2.jpg,760,480,640,19,307,326,225,265,True,5
3,151,kaist_dataset/Korean/Digital_Camera/outdoor6/DSC04446.JPG,char_data/3/DSC04446.JPG_2.jpg,13439,480,640,89,229,318,274,425,True,5
3,50,kaist_dataset/Korean/Digital_Camera/outdoor7/k.jpg,char_data/3/k.jpg_2.jpg,1700,240,320,34,90,124,144,194,True,5
3,32,kaist_dataset/Korean/Digital_Camera/outdoor7/P1010004.JPG,char_data/3/P1010004.JPG_4.jpg,416,480,640,13,503,516,295,327,True,5
3,33,kaist_dataset/Korean/Digital_Camera/outdoor7/P1010004.JPG,char_data/3/P1010004.JPG_5.jpg,429,480,640,13,524,537,294,327,True,5
3,42,kaist_dataset/Korean/Digital_Camera/outdoor7/P1010009.JPG,char_data/3/P1010009.JPG_2.jpg,1050,480,640,25,444,469,263,305,True,5
3,55,kaist_dataset/Korean/Digital_Camera/outdoor7/P1010011.JPG,char_data/3/P1010011.JPG_6.jpg,2090,480,640,38,349,387,224,279,True,5
3,52,kaist_dataset/Korean/Digital_Camera/outdoor7/P1010011.JPG,char_data/3/P1010011.JPG_7.jpg,1924,480,640,37,480,517,226,278,True,5
3,42,kaist_dataset/Korean/Digital_Camera/outdoor7/P1010012.JPG,char_data/3/P1010012.JPG_2.jpg,1344,480,640,32,415,447,221,263,True,5
3,81,kaist_dataset/Korean/Digital_Camera/outdoor7/P1010017.JPG,char_data/3/P1010017.JPG_2.jpg,1782,480,640,22,360,382,348,429,True,5
3,28,kaist_dataset/Korean/Digital_Camera/outdoor7/P1010022.JPG,char_data/3/P1010022.JPG_2.jpg,812,480,640,29,133,162,258,286,True,5
3,54,kaist_dataset/Korean/Digital_Camera/outdoor7/P1010023.JPG,char_data/3/P1010023.JPG_2.jpg,1350,480,640,25,545,570,283,337,True,5
3,30,kaist_dataset/Korean/Digital_Camera/outdoor7/P1010055.JPG,char_data/3/P1010055.JPG_4.jpg,1050,480,640,35,120,155,207,237,True,5
3,36,kaist_dataset/Korean/Digital_Camera/outdoor7/P1010061.JPG,char_data/3/P1010061.JPG_2.jpg,936,480,640,26,466,492,319,355,True,5
3,74,kaist_dataset/Korean/Digital_Camera/outdoor7/P1010066.JPG,char_data/3/P1010066.JPG_2.jpg,3700,480,640,50,280,330,335,409,True,5
3,41,kaist_dataset/Korean/Digital_Camera/outdoor7/P1010069.JPG,char_data/3/P1010069.JPG_2.jpg,697,480,640,17,576,593,318,359,True,5
3,103,kaist_dataset/Korean/Digital_Camera/outdoor7/P1010079.JPG,char_data/3/P1010079.JPG_2.jpg,8137,480,640,79,519,598,335,438,True,5
3,62,kaist_dataset/Korean/Digital_Camera/outdoor7/P1010080.JPG,char_data/3/P1010080.JPG_4.jpg,1984,480,640,32,457,489,193,255,True,5
3,40,kaist_dataset/Korean/Digital_Camera/outdoor7/P1010082.JPG,char_data/3/P1010082.JPG_4.jpg,1560,480,640,39,334,373,47,87,True,5
3,34,kaist_dataset/Korean/Digital_Camera/outdoor7/P1010091.JPG,char_data/3/P1010091.JPG_2.jpg,544,480,640,16,312,328,231,265,True,5
3,48,kaist_dataset/Korean/Digital_Camera/outdoor7/P1010111.JPG,char_data/3/P1010111.JPG_2.jpg,1728,480,640,36,527,563,219,267,True,5
3,27,kaist_dataset/Korean/Digital_Camera/outdoor7/P1010112.JPG,char_data/3/P1010112.JPG_2.jpg,486,480,640,18,419,437,360,387,True,5
3,26,kaist_dataset/Korean/Digital_Camera/outdoor7/P1010124.JPG,char_data/3/P1010124.JPG_6.jpg,416,480,640,16,317,333,149,175,True,5
3,18,kaist_dataset/Korean/Digital_Camera/outdoor7/P1010124.JPG,char_data/3/P1010124.JPG_7.jpg,324,480,640,18,346,364,156,174,True,5
3,20,kaist_dataset/Korean/Digital_Camera/outdoor7/P1010124.JPG,char_data/3/P1010124.JPG_8.jpg,300,480,640,15,378,393,154,174,True,5
3,55,kaist_dataset/Korean/Digital_Camera/outdoor8/DSC02950.JPG,char_data/3/DSC02950.JPG_2.jpg,2310,480,640,42,359,401,296,351,True,5
3,36,kaist_dataset/Korean/Digital_Camera/outdoor8/P1010143.JPG,char_data/3/P1010143.JPG_2.jpg,864,480,640,24,359,383,268,304,True,5
3,70,kaist_dataset/Korean/Digital_Camera/outdoor8/P1010160.JPG,char_data/3/P1010160.JPG_2.jpg,3780,480,640,54,437,491,222,292,True,5
3,53,kaist_dataset/Korean/Digital_Camera/outdoor8/P1010171.JPG,char_data/3/P1010171.JPG_2.jpg,1749,480,640,33,484,517,229,282,True,5
3,31,kaist_dataset/Korean/Digital_Camera/outdoor8/P1010189.JPG,char_data/3/P1010189.JPG_4.jpg,1054,480,640,34,369,403,232,263,True,5
3,38,kaist_dataset/Korean/Digital_Camera/outdoor8/P1010189.JPG,char_data/3/P1010189.JPG_5.jpg,950,480,640,25,462,487,229,267,True,5
3,56,"kaist_dataset/Korean/Mobile_Phone/(M,K)C-outdoor/P090912033.jpg",char_data/3/P090912033.jpg_2.jpg,2128,480,640,38,338,376,353,409,True,5
3,48,"kaist_dataset/Korean/Mobile_Phone/(M,K)C-outdoor/P090912034.jpg",char_data/3/P090912034.jpg_2.jpg,1104,480,640,23,262,285,257,305,True,5
3,36,"kaist_dataset/Korean/Mobile_Phone/(M,K)C-outdoor/P090912042.jpg",char_data/3/P090912042.jpg_6.jpg,540,480,640,15,404,419,248,284,True,5
3,36,"kaist_dataset/Korean/Mobile_Phone/(M,K)C-outdoor/P090912042.jpg",char_data/3/P090912042.jpg_7.jpg,468,480,640,13,418,431,249,285,True,5
3,31,"kaist_dataset/Korean/Mobile_Phone/(M,K)C-outdoor/P090912042.jpg",char_data/3/P090912042.jpg_8.jpg,496,480,640,16,448,464,250,281,True,5
3,45,"kaist_dataset/Korean/Mobile_Phone/(M,K)E-bookCover/P090831033.jpg",char_data/3/P090831033.jpg_2.jpg,1260,480,640,28,238,266,409,454,True,5
3,103,"kaist_dataset/Korean/Mobile_Phone/(M,K)E-bookCover/P090831035.jpg",char_data/3/P090831035.jpg_2.jpg,4223,480,640,41,12,53,32,135,True,5
3,128,"kaist_dataset/Korean/Mobile_Phone/(M,K)E-bookCover/P090911010.jpg",char_data/3/P090911010.jpg_2.jpg,13440,480,640,105,361,466,130,258,True,5
3,39,kaist_dataset/Mixed/Digital_Camera/(C.S)A-shadow/DSC02581.JPG,char_data/3/DSC02581.JPG_2.jpg,1482,480,640,38,390,428,389,428,True,5
3,35,kaist_dataset/Mixed/Digital_Camera/(C.S)A-shadow/DSC03257.JPG,char_data/3/DSC03257.JPG_2.jpg,700,480,640,20,298,318,384,419,True,5
3,67,kaist_dataset/Mixed/Digital_Camera/(C.S)A-shadow/DSC04326.JPG,char_data/3/DSC04326.JPG_2.jpg,1809,480,640,27,479,506,16,83,True,5
3,33,kaist_dataset/Mixed/Digital_Camera/(C.S)B-light/DSC03298.JPG,char_data/3/DSC03298.JPG_2.jpg,462,480,640,14,387,401,287,320,True,5
3,35,kaist_dataset/Mixed/Digital_Camera/(C.S)C-outdoor1/009.JPG,char_data/3/009.JPG_4.jpg,805,480,640,23,388,411,319,354,True,5
3,36,kaist_dataset/Mixed/Digital_Camera/(C.S)C-outdoor1/009.JPG,char_data/3/009.JPG_5.jpg,1008,480,640,28,411,439,317,353,True,5
3,25,kaist_dataset/Mixed/Digital_Camera/(C.S)C-outdoor1/027.JPG,char_data/3/027.JPG_2.jpg,375,480,640,15,466,481,278,303,True,5
3,21,kaist_dataset/Mixed/Digital_Camera/(C.S)C-outdoor1/047.JPG,char_data/3/047.JPG_4.jpg,189,480,640,9,574,583,174,195,True,5
3,24,kaist_dataset/Mixed/Digital_Camera/(C.S)C-outdoor1/047.JPG,char_data/3/047.JPG_5.jpg,312,480,640,13,623,636,241,265,True,5
3,31,kaist_dataset/Mixed/Digital_Camera/(C.S)C-outdoor1/048.JPG,char_data/3/048.JPG_2.jpg,682,480,640,22,299,321,257,288,True,5
3,46,kaist_dataset/Mixed/Digital_Camera/(C.S)C-outdoor1/080116-0084.jpg,char_data/3/080116-0084.jpg_2.jpg,1518,600,800,33,502,535,304,350,True,5
3,65,kaist_dataset/Mixed/Digital_Camera/(C.S)C-outdoor1/080119-0008.jpg,char_data/3/080119-0008.jpg_4.jpg,1755,1200,1600,27,1289,1316,655,720,True,5
3,77,kaist_dataset/Mixed/Digital_Camera/(C.S)C-outdoor1/080119-0008.jpg,char_data/3/080119-0008.jpg_5.jpg,4851,1200,1600,63,973,1036,831,908,True,5
3,89,kaist_dataset/Mixed/Digital_Camera/(C.S)C-outdoor1/080119-0027.jpg,char_data/3/080119-0027.jpg_2.jpg,4450,1200,1600,50,484,534,713,802,True,5
3,31,kaist_dataset/Mixed/Digital_Camera/(C.S)C-outdoor1/090.JPG,char_data/3/090.JPG_6.jpg,620,480,640,20,185,205,353,384,True,5
3,30,kaist_dataset/Mixed/Digital_Camera/(C.S)C-outdoor1/090.JPG,char_data/3/090.JPG_7.jpg,660,480,640,22,569,591,365,395,True,5
3,31,kaist_dataset/Mixed/Digital_Camera/(C.S)C-outdoor1/090.JPG,char_data/3/090.JPG_8.jpg,620,480,640,20,395,415,390,421,True,5
3,38,kaist_dataset/Mixed/Digital_Camera/(C.S)C-outdoor1/105.jpg,char_data/3/105.jpg_2.jpg,760,480,640,20,342,362,386,424,True,5
3,106,kaist_dataset/Mixed/Digital_Camera/(C.S)C-outdoor1/112.JPG,char_data/3/112.JPG_4.jpg,19398,480,640,183,12,195,14,120,True,5
3,60,kaist_dataset/Mixed/Digital_Camera/(C.S)C-outdoor1/112.JPG,char_data/3/112.JPG_5.jpg,3300,480,640,55,81,136,282,342,True,5
3,21,kaist_dataset/Mixed/Digital_Camera/(C.S)C-outdoor1/114.jpg,char_data/3/114.jpg_8.jpg,336,480,640,16,314,330,374,395,True,5
3,25,kaist_dataset/Mixed/Digital_Camera/(C.S)C-outdoor1/114.jpg,char_data/3/114.jpg_9.jpg,375,480,640,15,359,374,374,399,True,5
3,24,kaist_dataset/Mixed/Digital_Camera/(C.S)C-outdoor1/114.jpg,char_data/3/114.jpg_10.jpg,360,480,640,15,383,398,374,398,True,5
3,25,kaist_dataset/Mixed/Digital_Camera/(C.S)C-outdoor1/114.jpg,char_data/3/114.jpg_11.jpg,425,480,640,17,404,421,373,398,True,5
3,28,kaist_dataset/Mixed/Digital_Camera/(C.S)C-outdoor1/121.JPG,char_data/3/121.JPG_4.jpg,448,480,640,16,444,460,276,304,True,5
3,24,kaist_dataset/Mixed/Digital_Camera/(C.S)C-outdoor1/121.JPG,char_data/3/121.JPG_5.jpg,456,480,640,19,486,505,278,302,True,5
3,63,kaist_dataset/Mixed/Digital_Camera/(C.S)C-outdoor1/2007-12-08-day-091.jpg,char_data/3/2007-12-08-day-091.jpg_2.jpg,2394,1200,1600,38,1318,1356,624,687,True,5
3,92,kaist_dataset/Mixed/Digital_Camera/(C.S)C-outdoor1/2007-12-08-day-092.jpg,char_data/3/2007-12-08-day-092.jpg_2.jpg,6256,1200,1600,68,898,966,662,754,True,5
3,63,kaist_dataset/Mixed/Digital_Camera/(C.S)C-outdoor1/2007-12-09-day-exterior-004.jpg,char_data/3/2007-12-09-day-exterior-004.jpg_4.jpg,3024,1200,1600,48,1080,1128,659,722,True,5
3,70,kaist_dataset/Mixed/Digital_Camera/(C.S)C-outdoor1/2007-12-09-day-exterior-004.jpg,char_data/3/2007-12-09-day-exterior-004.jpg_5.jpg,3640,1200,1600,52,1266,1318,665,735,True,5
3,58,kaist_dataset/Mixed/Digital_Camera/(C.S)C-outdoor1/2007-12-09-day-exterior-078.jpg,char_data/3/2007-12-09-day-exterior-078.jpg_2.jpg,1160,1200,1600,20,813,833,578,636,True,5
3,30,kaist_dataset/Mixed/Digital_Camera/(C.S)C-outdoor1/47.JPG,char_data/3/47.JPG_2.jpg,420,576,768,14,360,374,474,504,True,5
3,23,kaist_dataset/Mixed/Digital_Camera/(C.S)C-outdoor1/48.JPG,char_data/3/48.JPG_2.jpg,276,576,768,12,283,295,342,365,True,5
3,38,kaist_dataset/Mixed/Digital_Camera/(C.S)C-outdoor1/51.JPG,char_data/3/51.JPG_2.jpg,950,576,768,25,692,717,378,416,True,5
3,33,kaist_dataset/Mixed/Digital_Camera/(C.S)C-outdoor1/55.JPG,char_data/3/55.JPG_2.jpg,858,576,768,26,334,360,370,403,True,5
3,39,kaist_dataset/Mixed/Digital_Camera/(C.S)C-outdoor1/56.JPG,char_data/3/56.JPG_2.jpg,1326,576,768,34,509,543,298,337,True,5
3,27,kaist_dataset/Mixed/Digital_Camera/(C.S)C-outdoor1/57.JPG,char_data/3/57.JPG_2.jpg,378,500,766,14,386,400,294,321,True,5
3,33,kaist_dataset/Mixed/Digital_Camera/(C.S)C-outdoor1/DSC02242.JPG,char_data/3/DSC02242.JPG_2.jpg,561,480,640,17,598,615,258,291,True,5
3,47,kaist_dataset/Mixed/Digital_Camera/(C.S)C-outdoor1/DSC02312.JPG,char_data/3/DSC02312.JPG_2.jpg,1551,480,640,33,197,230,215,262,True,5
3,35,kaist_dataset/Mixed/Digital_Camera/(C.S)C-outdoor1/DSC02349.JPG,char_data/3/DSC02349.JPG_8.jpg,770,480,640,22,315,337,200,235,True,5
3,43,kaist_dataset/Mixed/Digital_Camera/(C.S)C-outdoor1/DSC02349.JPG,char_data/3/DSC02349.JPG_9.jpg,817,480,640,19,389,408,194,237,True,5
3,35,kaist_dataset/Mixed/Digital_Camera/(C.S)C-outdoor1/DSC02349.JPG,char_data/3/DSC02349.JPG_10.jpg,630,480,640,18,389,407,430,465,True,5
3,35,kaist_dataset/Mixed/Digital_Camera/(C.S)C-outdoor1/DSC02349.JPG,char_data/3/DSC02349.JPG_11.jpg,560,480,640,16,442,458,426,461,True,5
3,39,kaist_dataset/Mixed/Digital_Camera/(C.S)C-outdoor1/P1010010.JPG,char_data/3/P1010010.JPG_4.jpg,1599,480,640,41,493,534,210,249,True,5
3,48,kaist_dataset/Mixed/Digital_Camera/(C.S)C-outdoor1/P1010010.JPG,char_data/3/P1010010.JPG_5.jpg,1248,480,640,26,448,474,359,407,True,5
3,40,kaist_dataset/Mixed/Digital_Camera/(C.S)C-outdoor1/P1010011.JPG,char_data/3/P1010011.JPG_8.jpg,960,480,640,24,442,466,311,351,True,5
3,34,kaist_dataset/Mixed/Digital_Camera/(C.S)C-outdoor2/DSC02368.JPG,char_data/3/DSC02368.JPG_4.jpg,510,480,640,15,158,173,384,418,True,5
3,39,kaist_dataset/Mixed/Digital_Camera/(C.S)C-outdoor2/DSC02368.JPG,char_data/3/DSC02368.JPG_5.jpg,741,480,640,19,528,547,380,419,True,5
3,40,kaist_dataset/Mixed/Digital_Camera/(C.S)C-outdoor2/DSC02376.JPG,char_data/3/DSC02376.JPG_2.jpg,840,480,640,21,556,577,334,374,True,5
3,44,kaist_dataset/Mixed/Digital_Camera/(C.S)C-outdoor2/DSC02377.JPG,char_data/3/DSC02377.JPG_2.jpg,968,480,640,22,580,602,352,396,True,5
3,32,kaist_dataset/Mixed/Digital_Camera/(C.S)C-outdoor2/DSC02379.JPG,char_data/3/DSC02379.JPG_6.jpg,448,480,640,14,430,444,289,321,True,5
3,33,kaist_dataset/Mixed/Digital_Camera/(C.S)C-outdoor2/DSC02379.JPG,char_data/3/DSC02379.JPG_7.jpg,594,480,640,18,487,505,290,323,True,5
3,37,kaist_dataset/Mixed/Digital_Camera/(C.S)C-outdoor2/DSC02379.JPG,char_data/3/DSC02379.JPG_8.jpg,703,480,640,19,505,524,287,324,True,5
3,40,kaist_dataset/Mixed/Digital_Camera/(C.S)C-outdoor2/DSC02389.JPG,char_data/3/DSC02389.JPG_6.jpg,1440,480,640,36,202,238,256,296,True,5
3,40,kaist_dataset/Mixed/Digital_Camera/(C.S)C-outdoor2/DSC02389.JPG,char_data/3/DSC02389.JPG_7.jpg,1400,480,640,35,274,309,252,292,True,5
3,37,kaist_dataset/Mixed/Digital_Camera/(C.S)C-outdoor2/DSC02389.JPG,char_data/3/DSC02389.JPG_8.jpg,2035,480,640,55,375,430,248,285,True,5
3,56,kaist_dataset/Mixed/Digital_Camera/(C.S)C-outdoor2/DSC02400.JPG,char_data/3/DSC02400.JPG_2.jpg,1960,480,640,35,302,337,398,454,True,5
3,39,kaist_dataset/Mixed/Digital_Camera/(C.S)C-outdoor2/DSC02419.JPG,char_data/3/DSC02419.JPG_4.jpg,663,480,640,17,497,514,212,251,True,5
3,34,kaist_dataset/Mixed/Digital_Camera/(C.S)C-outdoor2/DSC02419.JPG,char_data/3/DSC02419.JPG_5.jpg,748,480,640,22,579,601,218,252,True,5
3,32,kaist_dataset/Mixed/Digital_Camera/(C.S)C-outdoor2/DSC02447.JPG,char_data/3/DSC02447.JPG_2.jpg,384,480,640,12,505,517,225,257,True,5
3,32,kaist_dataset/Mixed/Digital_Camera/(C.S)C-outdoor2/DSC02466.JPG,char_data/3/DSC02466.JPG_2.jpg,864,480,640,27,319,346,257,289,True,5
3,29,kaist_dataset/Mixed/Digital_Camera/(C.S)C-outdoor2/DSC02477.JPG,char_data/3/DSC02477.JPG_2.jpg,725,480,640,25,93,118,253,282,True,5
3,31,kaist_dataset/Mixed/Digital_Camera/(C.S)C-outdoor2/DSC02479.JPG,char_data/3/DSC02479.JPG_2.jpg,496,480,640,16,482,498,221,252,True,5
3,55,kaist_dataset/Mixed/Digital_Camera/(C.S)C-outdoor2/DSC02483.JPG,char_data/3/DSC02483.JPG_2.jpg,3355,480,640,61,25,86,295,350,True,5
3,35,kaist_dataset/Mixed/Digital_Camera/(C.S)C-outdoor2/DSC02489.JPG,char_data/3/DSC02489.JPG_2.jpg,700,480,640,20,301,321,263,298,True,5
3,48,kaist_dataset/Mixed/Digital_Camera/(C.S)C-outdoor2/DSC02490.JPG,char_data/3/DSC02490.JPG_2.jpg,1104,480,640,23,378,401,340,388,True,5
3,75,kaist_dataset/Mixed/Digital_Camera/(C.S)C-outdoor2/DSC02502.JPG,char_data/3/DSC02502.JPG_2.jpg,5700,480,640,76,415,491,335,410,True,5
3,66,kaist_dataset/Mixed/Digital_Camera/(C.S)C-outdoor2/DSC02503.JPG,char_data/3/DSC02503.JPG_4.jpg,3366,480,640,51,263,314,349,415,True,5
3,68,kaist_dataset/Mixed/Digital_Camera/(C.S)C-outdoor2/DSC02503.JPG,char_data/3/DSC02503.JPG_5.jpg,3060,480,640,45,366,411,348,416,True,5
3,43,kaist_dataset/Mixed/Digital_Camera/(C.S)C-outdoor2/DSC02511.JPG,char_data/3/DSC02511.JPG_6.jpg,1161,480,640,27,289,316,393,436,True,5
3,44,kaist_dataset/Mixed/Digital_Camera/(C.S)C-outdoor2/DSC02511.JPG,char_data/3/DSC02511.JPG_7.jpg,1188,480,640,27,336,363,400,444,True,5
3,50,kaist_dataset/Mixed/Digital_Camera/(C.S)C-outdoor2/DSC02511.JPG,char_data/3/DSC02511.JPG_8.jpg,1350,480,640,27,411,438,396,446,True,5
3,60,kaist_dataset/Mixed/Digital_Camera/(C.S)C-outdoor2/DSC02519.JPG,char_data/3/DSC02519.JPG_2.jpg,3000,480,640,50,107,157,154,214,True,5
3,37,kaist_dataset/Mixed/Digital_Camera/(C.S)C-outdoor2/DSC02543.JPG,char_data/3/DSC02543.JPG_4.jpg,666,480,640,18,357,375,349,386,True,5
3,32,kaist_dataset/Mixed/Digital_Camera/(C.S)C-outdoor2/DSC02543.JPG,char_data/3/DSC02543.JPG_5.jpg,640,480,640,20,455,475,348,380,True,5
3,45,kaist_dataset/Mixed/Digital_Camera/(C.S)C-outdoor2/DSC02545.JPG,char_data/3/DSC02545.JPG_2.jpg,1440,480,640,32,542,574,392,437,True,5
3,28,kaist_dataset/Mixed/Digital_Camera/(C.S)C-outdoor2/DSC02555.JPG,char_data/3/DSC02555.JPG_2.jpg,700,480,640,25,110,135,251,279,True,5
3,33,kaist_dataset/Mixed/Digital_Camera/(C.S)C-outdoor2/DSC02557.JPG,char_data/3/DSC02557.JPG_4.jpg,825,480,640,25,409,434,214,247,True,5
3,36,kaist_dataset/Mixed/Digital_Camera/(C.S)C-outdoor2/DSC02557.JPG,char_data/3/DSC02557.JPG_5.jpg,756,480,640,21,471,492,209,245,True,5
3,96,kaist_dataset/Mixed/Digital_Camera/(C.S)C-outdoor2/DSC02865.JPG,char_data/3/DSC02865.JPG_2.jpg,5184,480,640,54,355,409,309,405,True,5
3,29,kaist_dataset/Mixed/Digital_Camera/(C.S)C-outdoor2/DSC02877.JPG,char_data/3/DSC02877.JPG_4.jpg,406,480,640,14,578,592,219,248,True,5
3,28,kaist_dataset/Mixed/Digital_Camera/(C.S)C-outdoor2/DSC02877.JPG,char_data/3/DSC02877.JPG_5.jpg,532,480,640,19,592,611,219,247,True,5
3,41,kaist_dataset/Mixed/Digital_Camera/(C.S)C-outdoor2/DSC02885.JPG,char_data/3/DSC02885.JPG_2.jpg,820,480,640,20,558,578,63,104,True,5
3,33,kaist_dataset/Mixed/Digital_Camera/(C.S)C-outdoor2/DSC02894.JPG,char_data/3/DSC02894.JPG_2.jpg,957,480,640,29,358,387,250,283,True,5
3,35,kaist_dataset/Mixed/Digital_Camera/(C.S)C-outdoor2/DSC02895.JPG,char_data/3/DSC02895.JPG_2.jpg,665,480,640,19,282,301,354,389,True,5
3,36,kaist_dataset/Mixed/Digital_Camera/(C.S)C-outdoor2/DSC02926.JPG,char_data/3/DSC02926.JPG_2.jpg,792,480,640,22,487,509,150,186,True,5
3,40,kaist_dataset/Mixed/Digital_Camera/(C.S)C-outdoor2/DSC02937.JPG,char_data/3/DSC02937.JPG_2.jpg,920,480,640,23,241,264,199,239,True,5
3,22,kaist_dataset/Mixed/Digital_Camera/(C.S)C-outdoor2/P1010015.JPG,char_data/3/P1010015.JPG_6.jpg,220,480,640,10,262,272,186,208,True,5
3,20,kaist_dataset/Mixed/Digital_Camera/(C.S)C-outdoor2/P1010015.JPG,char_data/3/P1010015.JPG_7.jpg,240,480,640,12,369,381,188,208,True,5
3,25,kaist_dataset/Mixed/Digital_Camera/(C.S)C-outdoor2/P1010015.JPG,char_data/3/P1010015.JPG_8.jpg,325,480,640,13,402,415,188,213,True,5
3,37,kaist_dataset/Mixed/Digital_Camera/(C.S)C-outdoor3/DSC03062.JPG,char_data/3/DSC03062.JPG_2.jpg,666,480,640,18,364,382,243,280,True,5
3,42,kaist_dataset/Mixed/Digital_Camera/(C.S)C-outdoor3/DSC03185.JPG,char_data/3/DSC03185.JPG_2.jpg,1764,480,640,42,290,332,151,193,True,5
3,46,kaist_dataset/Mixed/Digital_Camera/(C.S)C-outdoor3/DSC03187.JPG,char_data/3/DSC03187.JPG_2.jpg,1380,480,640,30,393,423,389,435,True,5
3,55,kaist_dataset/Mixed/Digital_Camera/(C.S)C-outdoor3/DSC03199.JPG,char_data/3/DSC03199.JPG_6.jpg,1760,480,640,32,247,279,324,379,True,5
3,59,kaist_dataset/Mixed/Digital_Camera/(C.S)C-outdoor3/DSC03199.JPG,char_data/3/DSC03199.JPG_7.jpg,2478,480,640,42,464,506,321,380,True,5
3,56,kaist_dataset/Mixed/Digital_Camera/(C.S)C-outdoor3/DSC03199.JPG,char_data/3/DSC03199.JPG_8.jpg,2072,480,640,37,515,552,321,377,True,5
3,50,kaist_dataset/Mixed/Digital_Camera/(C.S)C-outdoor3/DSC03212.JPG,char_data/3/DSC03212.JPG_2.jpg,750,480,640,15,482,497,250,300,True,5
3,37,kaist_dataset/Mixed/Digital_Camera/(C.S)C-outdoor3/DSC03250.JPG,char_data/3/DSC03250.JPG_2.jpg,703,480,640,19,577,596,404,441,True,5
3,36,kaist_dataset/Mixed/Digital_Camera/(C.S)C-outdoor3/DSC03259.JPG,char_data/3/DSC03259.JPG_2.jpg,612,480,640,17,380,397,358,394,True,5
3,57,kaist_dataset/Mixed/Digital_Camera/(C.S)C-outdoor3/DSC03267.JPG,char_data/3/DSC03267.JPG_2.jpg,2679,480,640,47,242,289,58,115,True,5
3,25,kaist_dataset/Mixed/Digital_Camera/(C.S)C-outdoor3/DSC03292.JPG,char_data/3/DSC03292.JPG_2.jpg,400,480,640,16,591,607,120,145,True,5
3,35,kaist_dataset/Mixed/Digital_Camera/(C.S)C-outdoor3/DSC03301.JPG,char_data/3/DSC03301.JPG_2.jpg,1015,480,640,29,538,567,136,171,True,5
3,57,kaist_dataset/Mixed/Digital_Camera/(C.S)C-outdoor3/DSC03314.JPG,char_data/3/DSC03314.JPG_2.jpg,1710,480,640,30,458,488,363,420,True,5
3,30,kaist_dataset/Mixed/Digital_Camera/(C.S)C-outdoor3/DSC03316.JPG,char_data/3/DSC03316.JPG_6.jpg,390,480,640,13,245,258,90,120,True,5
3,41,kaist_dataset/Mixed/Digital_Camera/(C.S)C-outdoor3/DSC03316.JPG,char_data/3/DSC03316.JPG_7.jpg,533,480,640,13,401,414,78,119,True,5
3,32,kaist_dataset/Mixed/Digital_Camera/(C.S)C-outdoor3/DSC03316.JPG,char_data/3/DSC03316.JPG_8.jpg,448,480,640,14,580,594,80,112,True,5
3,95,kaist_dataset/Mixed/Digital_Camera/(C.S)C-outdoor3/DSC03340.JPG,char_data/3/DSC03340.JPG_2.jpg,7790,480,640,82,291,373,252,347,True,5
3,36,kaist_dataset/Mixed/Digital_Camera/(C.S)C-outdoor4/DSC03435.JPG,char_data/3/DSC03435.JPG_2.jpg,576,480,640,16,498,514,417,453,True,5
3,30,kaist_dataset/Mixed/Digital_Camera/(C.S)C-outdoor4/DSC03446.JPG,char_data/3/DSC03446.JPG_4.jpg,780,480,640,26,267,293,292,322,True,5
3,27,kaist_dataset/Mixed/Digital_Camera/(C.S)C-outdoor4/DSC03446.JPG,char_data/3/DSC03446.JPG_5.jpg,972,480,640,36,409,445,294,321,True,5
3,29,kaist_dataset/Mixed/Digital_Camera/(C.S)C-outdoor4/DSC03549.JPG,char_data/3/DSC03549.JPG_2.jpg,377,480,640,13,345,358,424,453,True,5
3,31,kaist_dataset/Mixed/Digital_Camera/(C.S)C-outdoor4/DSC03570.JPG,char_data/3/DSC03570.JPG_2.jpg,403,480,640,13,361,374,421,452,True,5
3,27,kaist_dataset/Mixed/Digital_Camera/(C.S)C-outdoor4/DSC03581.JPG,char_data/3/DSC03581.JPG_2.jpg,378,480,640,14,548,562,123,150,True,5
3,50,kaist_dataset/Mixed/Digital_Camera/(C.S)C-outdoor4/DSC03604.JPG,char_data/3/DSC03604.JPG_2.jpg,1350,480,640,27,277,304,80,130,True,5
3,50,kaist_dataset/Mixed/Digital_Camera/(C.S)C-outdoor4/DSC03617.JPG,char_data/3/DSC03617.JPG_2.jpg,1850,480,640,37,272,309,377,427,True,5
3,47,kaist_dataset/Mixed/Digital_Camera/(C.S)C-outdoor4/DSC03631.JPG,char_data/3/DSC03631.JPG_2.jpg,1175,480,640,25,294,319,355,402,True,5
3,39,kaist_dataset/Mixed/Digital_Camera/(C.S)C-outdoor4/DSC03665.JPG,char_data/3/DSC03665.JPG_4.jpg,1209,480,640,31,445,476,153,192,True,5
3,40,kaist_dataset/Mixed/Digital_Camera/(C.S)C-outdoor4/DSC03665.JPG,char_data/3/DSC03665.JPG_5.jpg,1560,480,640,39,475,514,153,193,True,5
3,35,kaist_dataset/Mixed/Digital_Camera/(C.S)C-outdoor4/DSC03673.JPG,char_data/3/DSC03673.JPG_4.jpg,735,480,640,21,220,241,307,342,True,5
3,37,kaist_dataset/Mixed/Digital_Camera/(C.S)C-outdoor4/DSC03673.JPG,char_data/3/DSC03673.JPG_5.jpg,740,480,640,20,328,348,305,342,True,5
3,39,kaist_dataset/Mixed/Digital_Camera/(C.S)C-outdoor4/DSC03675.JPG,char_data/3/DSC03675.JPG_2.jpg,741,480,640,19,530,549,342,381,True,5
3,42,kaist_dataset/Mixed/Digital_Camera/(C.S)C-outdoor4/DSC03679.JPG,char_data/3/DSC03679.JPG_2.jpg,966,480,640,23,359,382,277,319,True,5
3,37,kaist_dataset/Mixed/Digital_Camera/(C.S)C-outdoor4/DSC03691.JPG,char_data/3/DSC03691.JPG_6.jpg,629,480,640,17,424,441,219,256,True,5
3,34,kaist_dataset/Mixed/Digital_Camera/(C.S)C-outdoor4/DSC03691.JPG,char_data/3/DSC03691.JPG_7.jpg,646,480,640,19,470,489,222,256,True,5
3,36,kaist_dataset/Mixed/Digital_Camera/(C.S)C-outdoor4/DSC03691.JPG,char_data/3/DSC03691.JPG_8.jpg,612,480,640,17,599,616,218,254,True,5
3,43,kaist_dataset/Mixed/Digital_Camera/(C.S)C-outdoor4/DSC03724.JPG,char_data/3/DSC03724.JPG_2.jpg,1161,480,640,27,503,530,274,317,True,5
3,33,kaist_dataset/Mixed/Digital_Camera/(C.S)C-outdoor4/DSC03730.JPG,char_data/3/DSC03730.JPG_2.jpg,693,480,640,21,374,395,255,288,False,5
3,40,kaist_dataset/Mixed/Digital_Camera/(C.S)C-outdoor4/DSC03732.JPG,char_data/3/DSC03732.JPG_2.jpg,1000,480,640,25,373,398,392,432,False,5
3,26,kaist_dataset/Mixed/Digital_Camera/(C.S)C-outdoor4/DSC03735.JPG,char_data/3/DSC03735.JPG_2.jpg,546,480,640,21,516,537,152,178,False,5
3,32,kaist_dataset/Mixed/Digital_Camera/(C.S)C-outdoor4/DSC03737.JPG,char_data/3/DSC03737.JPG_2.jpg,608,480,640,19,545,564,171,203,False,5
3,57,kaist_dataset/Mixed/Digital_Camera/(C.S)C-outdoor4/DSC03738.JPG,char_data/3/DSC03738.JPG_2.jpg,2736,480,640,48,83,131,221,278,False,5
3,34,kaist_dataset/Mixed/Digital_Camera/(C.S)C-outdoor4/DSC03745.JPG,char_data/3/DSC03745.JPG_2.jpg,782,480,640,23,206,229,270,304,False,5
3,38,kaist_dataset/Mixed/Digital_Camera/(C.S)C-outdoor4/DSC03781.JPG,char_data/3/DSC03781.JPG_2.jpg,1140,480,640,30,321,351,380,418,False,5
3,42,kaist_dataset/Mixed/Digital_Camera/(C.S)C-outdoor5/DSC04014.JPG,char_data/3/DSC04014.JPG_2.jpg,756,480,640,18,302,320,300,342,False,5
3,23,kaist_dataset/Mixed/Digital_Camera/(C.S)C-outdoor5/DSC04031.JPG,char_data/3/DSC04031.JPG_4.jpg,230,480,640,10,486,496,381,404,False,5
3,27,kaist_dataset/Mixed/Digital_Camera/(C.S)C-outdoor5/DSC04031.JPG,char_data/3/DSC04031.JPG_5.jpg,324,480,640,12,180,192,381,408,False,5
3,51,kaist_dataset/Mixed/Digital_Camera/(C.S)C-outdoor5/DSC04033.JPG,char_data/3/DSC04033.JPG_2.jpg,1785,480,640,35,529,564,264,315,False,5
3,29,kaist_dataset/Mixed/Digital_Camera/(C.S)C-outdoor5/DSC04048.JPG,char_data/3/DSC04048.JPG_4.jpg,464,480,640,16,391,407,172,201,False,5
3,29,kaist_dataset/Mixed/Digital_Camera/(C.S)C-outdoor5/DSC04048.JPG,char_data/3/DSC04048.JPG_5.jpg,464,480,640,16,416,432,172,201,False,5
3,42,kaist_dataset/Mixed/Digital_Camera/(C.S)C-outdoor5/DSC04071.JPG,char_data/3/DSC04071.JPG_4.jpg,1134,480,640,27,263,290,360,402,False,5
3,43,kaist_dataset/Mixed/Digital_Camera/(C.S)C-outdoor5/DSC04071.JPG,char_data/3/DSC04071.JPG_5.jpg,860,480,640,20,549,569,361,404,False,5
3,31,kaist_dataset/Mixed/Digital_Camera/(C.S)C-outdoor5/DSC04072.JPG,char_data/3/DSC04072.JPG_2.jpg,372,480,640,12,527,539,350,381,False,5
3,46,kaist_dataset/Mixed/Digital_Camera/(C.S)C-outdoor5/DSC04094.JPG,char_data/3/DSC04094.JPG_2.jpg,2116,480,640,46,280,326,385,431,False,5
3,44,kaist_dataset/Mixed/Digital_Camera/(C.S)C-outdoor5/DSC04098.JPG,char_data/3/DSC04098.JPG_2.jpg,616,480,640,14,465,479,311,355,False,5
3,35,kaist_dataset/Mixed/Digital_Camera/(C.S)C-outdoor5/DSC04122.JPG,char_data/3/DSC04122.JPG_2.jpg,455,480,640,13,346,359,412,447,False,5
3,32,kaist_dataset/Mixed/Digital_Camera/(C.S)C-outdoor5/DSC04124.JPG,char_data/3/DSC04124.JPG_2.jpg,512,480,640,16,510,526,307,339,False,5
3,39,kaist_dataset/Mixed/Digital_Camera/(C.S)C-outdoor5/DSC04135.JPG,char_data/3/DSC04135.JPG_2.jpg,1053,480,640,27,535,562,393,432,False,5
3,32,kaist_dataset/Mixed/Digital_Camera/(C.S)C-outdoor5/DSC04146.JPG,char_data/3/DSC04146.JPG_2.jpg,576,480,640,18,370,388,405,437,False,5
3,76,kaist_dataset/Mixed/Digital_Camera/(C.S)C-outdoor5/DSC04153.JPG,char_data/3/DSC04153.JPG_2.jpg,5168,480,640,68,138,206,197,273,False,5
3,73,kaist_dataset/Mixed/Digital_Camera/(C.S)C-outdoor5/DSC04290.JPG,char_data/3/DSC04290.JPG_2.jpg,3942,480,640,54,449,503,339,412,False,5
3,37,kaist_dataset/Mixed/Digital_Camera/(C.S)C-outdoor5/DSC04330.JPG,char_data/3/DSC04330.JPG_4.jpg,1554,480,640,42,497,539,161,198,False,5
3,63,kaist_dataset/Mixed/Digital_Camera/(C.S)C-outdoor5/DSC04330.JPG,char_data/3/DSC04330.JPG_5.jpg,2079,480,640,33,532,565,356,419,False,5
3,42,kaist_dataset/Mixed/Digital_Camera/(C.S)C-outdoor5/DSC04337.JPG,char_data/3/DSC04337.JPG_2.jpg,966,480,640,23,470,493,320,362,False,5
3,64,kaist_dataset/Mixed/Digital_Camera/(C.S)C-outdoor5/DSC04364.JPG,char_data/3/DSC04364.JPG_6.jpg,2432,480,640,38,216,254,389,453,False,5
3,65,kaist_dataset/Mixed/Digital_Camera/(C.S)C-outdoor5/DSC04364.JPG,char_data/3/DSC04364.JPG_7.jpg,2535,480,640,39,360,399,391,456,False,5
3,67,kaist_dataset/Mixed/Digital_Camera/(C.S)C-outdoor5/DSC04364.JPG,char_data/3/DSC04364.JPG_8.jpg,2345,480,640,35,397,432,390,457,False,5
3,119,kaist_dataset/Mixed/Digital_Camera/(C.S)C-outdoor5/DSC04449.JPG,char_data/3/DSC04449.JPG_2.jpg,7259,480,640,61,421,482,35,154,False,5
3,62,kaist_dataset/Mixed/Digital_Camera/(C.S)C-outdoor5/DSC04461.JPG,char_data/3/DSC04461.JPG_2.jpg,5022,480,640,81,308,389,343,405,False,5
3,25,kaist_dataset/Mixed/Digital_Camera/(C.S)C-outdoor6/117.JPG,char_data/3/117.JPG_2.jpg,325,480,640,13,514,527,262,287,False,5
3,27,kaist_dataset/Mixed/Digital_Camera/(C.S)C-outdoor6/DSC03324.JPG,char_data/3/DSC03324.JPG_2.jpg,486,480,640,18,492,510,152,179,False,5
3,40,kaist_dataset/Mixed/Digital_Camera/(C.S)C-outdoor6/P1010018.JPG,char_data/3/P1010018.JPG_2.jpg,960,480,640,24,253,277,240,280,False,5
3,80,kaist_dataset/Mixed/Digital_Camera/(C.S)C-outdoor6/P1010055.JPG,char_data/3/P1010055.JPG_5.jpg,4960,480,640,62,416,478,263,343,False,5
3,34,kaist_dataset/Mixed/Digital_Camera/(C.S)C-outdoor6/P1010065.JPG,char_data/3/P1010065.JPG_4.jpg,748,480,640,22,407,429,227,261,False,5
3,33,kaist_dataset/Mixed/Digital_Camera/(C.S)C-outdoor6/P1010065.JPG,char_data/3/P1010065.JPG_5.jpg,759,480,640,23,429,452,229,262,False,5
3,35,kaist_dataset/Mixed/Digital_Camera/(C.S)C-outdoor6/P1010074.JPG,char_data/3/P1010074.JPG_2.jpg,1365,480,640,39,236,275,307,342,False,5
3,34,kaist_dataset/Mixed/Digital_Camera/(C.S)C-outdoor6/P1010080.JPG,char_data/3/P1010080.JPG_5.jpg,952,480,640,28,549,577,251,285,False,5
3,26,kaist_dataset/Mixed/Digital_Camera/(C.S)C-outdoor6/P1010082.JPG,char_data/3/P1010082.JPG_5.jpg,494,480,640,19,502,521,231,257,False,5
3,28,kaist_dataset/Mixed/Digital_Camera/(C.S)C-outdoor6/P1010085.JPG,char_data/3/P1010085.JPG_2.jpg,616,480,640,22,432,454,154,182,False,5
3,54,kaist_dataset/Mixed/Digital_Camera/(C.S)C-outdoor6/P1010087.JPG,char_data/3/P1010087.JPG_2.jpg,1890,480,640,35,479,514,179,233,False,5
3,27,kaist_dataset/Mixed/Digital_Camera/(C.S)C-outdoor6/P1010094.JPG,char_data/3/P1010094.JPG_2.jpg,567,480,640,21,504,525,217,244,False,5
3,21,kaist_dataset/Mixed/Digital_Camera/(C.S)C-outdoor6/P1010097.JPG,char_data/3/P1010097.JPG_2.jpg,441,480,640,21,491,512,190,211,False,5
3,26,kaist_dataset/Mixed/Digital_Camera/(C.S)C-outdoor6/P1010114.JPG,char_data/3/P1010114.JPG_2.jpg,598,480,640,23,537,560,215,241,False,5
3,39,kaist_dataset/Mixed/Digital_Camera/(C.S)C-outdoor6/P1010120.JPG,char_data/3/P1010120.JPG_2.jpg,975,480,640,25,423,448,192,231,False,5
3,30,kaist_dataset/Mixed/Digital_Camera/(C.S)C-outdoor6/P1010132.JPG,char_data/3/P1010132.JPG_2.jpg,780,480,640,26,482,508,94,124,False,5
3,31,kaist_dataset/Mixed/Digital_Camera/(C.S)C-outdoor6/P1010138.JPG,char_data/3/P1010138.JPG_2.jpg,682,480,640,22,474,496,185,216,False,5
3,32,kaist_dataset/Mixed/Digital_Camera/(C.S)C-outdoor6/크기변환_fadscf0009_creawell.jpg,char_data/3/크기변환_fadscf0009_creawell.jpg_4.jpg,480,480,640,15,308,323,157,189,False,5
3,34,kaist_dataset/Mixed/Digital_Camera/(C.S)C-outdoor6/크기변환_fadscf0009_creawell.jpg,char_data/3/크기변환_fadscf0009_creawell.jpg_5.jpg,612,480,640,18,454,472,166,200,False,5
3,227,kaist_dataset/Mixed/Digital_Camera/(C.S)D-indoor1/DSC02724.JPG,char_data/3/DSC02724.JPG_2.jpg,39725,480,640,175,130,305,170,397,False,5
3,119,kaist_dataset/Mixed/Digital_Camera/(C.S)D-indoor1/DSC03455.JPG,char_data/3/DSC03455.JPG_2.jpg,11662,480,640,98,168,266,53,172,False,5
3,99,kaist_dataset/Mixed/Digital_Camera/(C.S)D-indoor1/DSC03478.JPG,char_data/3/DSC03478.JPG_2.jpg,7425,480,640,75,91,166,99,198,False,5
3,43,kaist_dataset/Mixed/Digital_Camera/(C.S)D-indoor1/DSC03980.JPG,char_data/3/DSC03980.JPG_2.jpg,1677,480,640,39,463,502,314,357,False,5
3,50,kaist_dataset/Mixed/Digital_Camera/(C.S)D-indoor1/DSC03986.JPG,char_data/3/DSC03986.JPG_2.jpg,850,480,640,17,327,344,160,210,False,5
3,43,kaist_dataset/Mixed/Digital_Camera/(C.S)D-indoor2/DSC04256.JPG,char_data/3/DSC04256.JPG_4.jpg,817,480,640,19,499,518,146,189,False,5
3,42,kaist_dataset/Mixed/Digital_Camera/(C.S)D-indoor2/DSC04256.JPG,char_data/3/DSC04256.JPG_5.jpg,882,480,640,21,547,568,151,193,False,5
3,80,kaist_dataset/Mixed/Digital_Camera/(C.S)D-indoor2/DSC04463.JPG,char_data/3/DSC04463.JPG_2.jpg,6880,480,640,86,467,553,38,118,False,5
3,56,kaist_dataset/Mixed/Digital_Camera/(C.S)E-night/DSC02573.JPG,char_data/3/DSC02573.JPG_2.jpg,2128,480,640,38,377,415,170,226,False,5
3,62,kaist_dataset/Mixed/Digital_Camera/(C.S)E-night/DSC02574.JPG,char_data/3/DSC02574.JPG_4.jpg,1860,480,640,30,349,379,411,473,False,5
3,58,kaist_dataset/Mixed/Digital_Camera/(C.S)E-night/DSC02574.JPG,char_data/3/DSC02574.JPG_5.jpg,1798,480,640,31,507,538,407,465,False,5
3,50,kaist_dataset/Mixed/Digital_Camera/(C.S)E-night/DSC02575.JPG,char_data/3/DSC02575.JPG_2.jpg,1450,480,640,29,538,567,366,416,False,5
3,31,kaist_dataset/Mixed/Digital_Camera/(C.S)E-night/DSC02585.JPG,char_data/3/DSC02585.JPG_2.jpg,682,480,640,22,370,392,418,449,False,5
3,74,kaist_dataset/Mixed/Digital_Camera/(C.S)E-night/DSC02600.JPG,char_data/3/DSC02600.JPG_2.jpg,5106,480,640,69,97,166,388,462,False,5
3,31,kaist_dataset/Mixed/Digital_Camera/(C.S)E-night/DSC02623.JPG,char_data/3/DSC02623.JPG_2.jpg,496,480,640,16,181,197,399,430,False,5
3,37,kaist_dataset/Mixed/Digital_Camera/(C.S)E-night/DSC02644.JPG,char_data/3/DSC02644.JPG_6.jpg,814,480,640,22,334,356,399,436,False,5
3,37,kaist_dataset/Mixed/Digital_Camera/(C.S)E-night/DSC02644.JPG,char_data/3/DSC02644.JPG_7.jpg,629,480,640,17,412,429,399,436,False,5
3,27,kaist_dataset/Mixed/Digital_Camera/(C.S)E-night/DSC02644.JPG,char_data/3/DSC02644.JPG_8.jpg,594,480,640,22,430,452,409,436,False,5
3,37,kaist_dataset/Mixed/Digital_Camera/(C.S)E-night/DSC02647.JPG,char_data/3/DSC02647.JPG_2.jpg,999,480,640,27,248,275,279,316,False,5
3,33,kaist_dataset/Mixed/Digital_Camera/(C.S)E-night/DSC02673.JPG,char_data/3/DSC02673.JPG_4.jpg,561,480,640,17,538,555,303,336,False,5
3,37,kaist_dataset/Mixed/Digital_Camera/(C.S)E-night/DSC02673.JPG,char_data/3/DSC02673.JPG_5.jpg,592,480,640,16,554,570,302,339,False,5
3,37,kaist_dataset/Mixed/Digital_Camera/(C.S)E-night/DSC02903.JPG,char_data/3/DSC02903.JPG_2.jpg,592,480,640,16,354,370,263,300,False,5
3,55,kaist_dataset/Mixed/Digital_Camera/(C.S)E-night/P1010147.JPG,char_data/3/P1010147.JPG_2.jpg,2090,480,640,38,388,426,256,311,False,5
3,32,kaist_dataset/Mixed/Digital_Camera/(C.S)F-others/2007-12-08-day-044.jpg,char_data/3/2007-12-08-day-044.jpg_2.jpg,448,1200,1600,14,1054,1068,829,861,False,5
3,51,kaist_dataset/Mixed/Digital_Camera/(C.S)F-others/2007-12-09-day-exterior-023.jpg,char_data/3/2007-12-09-day-exterior-023.jpg_2.jpg,1887,1200,1600,37,1012,1049,592,643,False,5
3,38,kaist_dataset/Mixed/Digital_Camera/(C.S)F-others/DSC02504.JPG,char_data/3/DSC02504.JPG_2.jpg,1178,480,640,31,387,418,364,402,False,5
3,44,kaist_dataset/Mixed/Digital_Camera/(C.S)F-others/DSC02893.JPG,char_data/3/DSC02893.JPG_4.jpg,1452,480,640,33,416,449,332,376,False,5
3,40,kaist_dataset/Mixed/Digital_Camera/(C.S)F-others/DSC02893.JPG,char_data/3/DSC02893.JPG_5.jpg,1560,480,640,39,486,525,324,364,False,5
3,87,kaist_dataset/Mixed/Digital_Camera/(C.S)F-others/DSC03224.JPG,char_data/3/DSC03224.JPG_2.jpg,4611,480,640,53,277,330,224,311,False,5
3,30,kaist_dataset/Mixed/Mobile_Phone/(C.M)A-outdoor/P090912036.jpg,char_data/3/P090912036.jpg_4.jpg,420,480,640,14,190,204,189,219,False,5
3,29,kaist_dataset/Mixed/Mobile_Phone/(C.M)A-outdoor/P090912036.jpg,char_data/3/P090912036.jpg_5.jpg,406,480,640,14,388,402,192,221,False,5
3,37,kaist_dataset/Mixed/Mobile_Phone/(C.M)A-outdoor/P090912038.jpg,char_data/3/P090912038.jpg_4.jpg,814,480,640,22,351,373,158,195,False,5
3,38,kaist_dataset/Mixed/Mobile_Phone/(C.M)A-outdoor/P090912038.jpg,char_data/3/P090912038.jpg_5.jpg,798,480,640,21,430,451,156,194,False,5
3,35,kaist_dataset/Mixed/Mobile_Phone/(C.M)A-outdoor/P090912068.jpg,char_data/3/P090912068.jpg_2.jpg,1015,480,640,29,387,416,128,163,False,5
3,65,kaist_dataset/Mixed/Mobile_Phone/(C.M)B-indoor/P090831007.jpg,char_data/3/P090831007.jpg_6.jpg,3250,480,640,50,437,487,131,196,False,5
3,58,kaist_dataset/Mixed/Mobile_Phone/(C.M)B-indoor/P090831007.jpg,char_data/3/P090831007.jpg_7.jpg,2900,480,640,50,115,165,272,330,False,5
3,65,kaist_dataset/Mixed/Mobile_Phone/(C.M)B-indoor/P090831007.jpg,char_data/3/P090831007.jpg_8.jpg,2470,480,640,38,313,351,273,338,False,5
O,78,kaist_dataset/English/Digital_Camera/(E.S)A-shadow/DSC02423.JPG,char_data/O/DSC02423.JPG_4.jpg,6318,480,640,81,82,163,148,226,True,25
O,73,kaist_dataset/English/Digital_Camera/(E.S)A-shadow/DSC02423.JPG,char_data/O/DSC02423.JPG_5.jpg,6059,480,640,83,249,332,157,230,True,25
O,101,kaist_dataset/English/Digital_Camera/(E.S)A-shadow/DSC02629.JPG,char_data/O/DSC02629.JPG_2.jpg,7070,480,640,70,301,371,304,405,True,25
O,97,kaist_dataset/English/Digital_Camera/(E.S)A-shadow/DSC02633.JPG,char_data/O/DSC02633.JPG_4.jpg,6111,480,640,63,77,140,173,270,True,25
O,96,kaist_dataset/English/Digital_Camera/(E.S)A-shadow/DSC02633.JPG,char_data/O/DSC02633.JPG_5.jpg,5760,480,640,60,373,433,180,276,True,25
O,40,kaist_dataset/English/Digital_Camera/(E.S)A-shadow/P1010044.JPG,char_data/O/P1010044.JPG_6.jpg,1240,480,640,31,245,276,357,397,True,25
O,44,kaist_dataset/English/Digital_Camera/(E.S)A-shadow/P1010044.JPG,char_data/O/P1010044.JPG_7.jpg,1232,480,640,28,433,461,352,396,True,25
O,35,kaist_dataset/English/Digital_Camera/(E.S)A-shadow/P1010044.JPG,char_data/O/P1010044.JPG_8.jpg,1155,480,640,33,217,250,151,186,True,25
O,113,kaist_dataset/English/Digital_Camera/(E.S)B-light/080116-0053.jpg,char_data/O/080116-0053.jpg_2.jpg,10057,600,800,89,511,600,224,337,True,25
O,205,kaist_dataset/English/Digital_Camera/(E.S)B-light/080116-0059.jpg,char_data/O/080116-0059.jpg_14.jpg,42230,1200,1600,206,310,516,9,214,True,25
O,189,kaist_dataset/English/Digital_Camera/(E.S)B-light/080116-0059.jpg,char_data/O/080116-0059.jpg_15.jpg,28161,1200,1600,149,1242,1391,99,288,True,25
O,231,kaist_dataset/English/Digital_Camera/(E.S)B-light/080116-0059.jpg,char_data/O/080116-0059.jpg_16.jpg,27027,1200,1600,117,984,1101,508,739,True,25
O,29,kaist_dataset/English/Digital_Camera/(E.S)B-light/080116-0059.jpg,char_data/O/080116-0059.jpg_17.jpg,435,1200,1600,15,644,659,799,828,True,25
O,28,kaist_dataset/English/Digital_Camera/(E.S)B-light/080116-0059.jpg,char_data/O/080116-0059.jpg_18.jpg,532,1200,1600,19,1086,1105,798,826,True,25
O,33,kaist_dataset/English/Digital_Camera/(E.S)B-light/080116-0059.jpg,char_data/O/080116-0059.jpg_19.jpg,528,1200,1600,16,694,710,771,804,True,25
O,32,kaist_dataset/English/Digital_Camera/(E.S)B-light/080116-0059.jpg,char_data/O/080116-0059.jpg_20.jpg,448,1200,1600,14,1120,1134,767,799,True,25
O,77,kaist_dataset/English/Digital_Camera/(E.S)B-light/080119-0038.jpg,char_data/O/080119-0038.jpg_2.jpg,5775,1200,1600,75,262,337,684,761,True,25
O,48,kaist_dataset/English/Digital_Camera/(E.S)B-light/DSC02712.JPG,char_data/O/DSC02712.JPG_4.jpg,1632,480,640,34,184,218,217,265,True,25
O,51,kaist_dataset/English/Digital_Camera/(E.S)B-light/DSC02712.JPG,char_data/O/DSC02712.JPG_5.jpg,1683,480,640,33,307,340,219,270,True,25
O,46,kaist_dataset/English/Digital_Camera/(E.S)B-light/DSC03007.JPG,char_data/O/DSC03007.JPG_10.jpg,1426,480,640,31,183,214,274,320,True,25
O,42,kaist_dataset/English/Digital_Camera/(E.S)B-light/DSC03007.JPG,char_data/O/DSC03007.JPG_11.jpg,1344,480,640,32,213,245,276,318,True,25
O,44,kaist_dataset/English/Digital_Camera/(E.S)B-light/DSC03007.JPG,char_data/O/DSC03007.JPG_12.jpg,1364,480,640,31,319,350,274,318,True,25
O,42,kaist_dataset/English/Digital_Camera/(E.S)B-light/DSC03007.JPG,char_data/O/DSC03007.JPG_13.jpg,1344,480,640,32,415,447,278,320,True,25
O,91,kaist_dataset/English/Digital_Camera/(E.S)B-light/DSC03007.JPG,char_data/O/DSC03007.JPG_14.jpg,5733,480,640,63,400,463,160,251,True,25
O,30,kaist_dataset/English/Digital_Camera/(E.S)B-light/v.jpg,char_data/O/v.jpg_4.jpg,690,240,320,23,119,142,57,87,True,25
O,21,kaist_dataset/English/Digital_Camera/(E.S)B-light/v.jpg,char_data/O/v.jpg_5.jpg,504,240,320,24,224,248,60,81,True,25
O,94,kaist_dataset/English/Digital_Camera/(E.S)B-light/크기변환_%B0%A3%C6%C7_ktimt007.jpg,char_data/O/크기변환_%B0%A3%C6%C7_ktimt007.jpg_2.jpg,7144,480,640,76,400,476,209,303,True,25
O,44,kaist_dataset/English/Digital_Camera/(E.S)C-outdoor1/004.jpg,char_data/O/004.jpg_2.jpg,1628,269,413,37,98,135,34,78,True,25
O,23,kaist_dataset/English/Digital_Camera/(E.S)C-outdoor1/056.JPG,char_data/O/056.JPG_8.jpg,391,480,640,17,146,163,242,265,True,25
O,43,kaist_dataset/English/Digital_Camera/(E.S)C-outdoor1/080116-0065.jpg,char_data/O/080116-0065.jpg_4.jpg,1247,600,800,29,319,348,327,370,True,25
O,41,kaist_dataset/English/Digital_Camera/(E.S)C-outdoor1/080116-0065.jpg,char_data/O/080116-0065.jpg_5.jpg,1271,600,800,31,504,535,343,384,True,25
O,54,kaist_dataset/English/Digital_Camera/(E.S)C-outdoor1/080118-0011.jpg,char_data/O/080118-0011.jpg_6.jpg,2808,1200,1600,52,754,806,943,997,True,25
O,66,kaist_dataset/English/Digital_Camera/(E.S)C-outdoor1/080118-0011.jpg,char_data/O/080118-0011.jpg_7.jpg,3102,1200,1600,47,1082,1129,930,996,True,25
O,71,kaist_dataset/English/Digital_Camera/(E.S)C-outdoor1/080118-0011.jpg,char_data/O/080118-0011.jpg_8.jpg,4402,1200,1600,62,689,751,526,597,True,25
O,235,kaist_dataset/English/Digital_Camera/(E.S)C-outdoor1/080119-0004.jpg,char_data/O/080119-0004.jpg_2.jpg,60395,1200,1600,257,1032,1289,520,755,True,25
O,370,kaist_dataset/English/Digital_Camera/(E.S)C-outdoor1/080120-0001.jpg,char_data/O/080120-0001.jpg_2.jpg,145040,1200,1600,392,404,796,486,856,True,25
O,83,kaist_dataset/English/Digital_Camera/(E.S)C-outdoor1/110.jpg,char_data/O/110.jpg_4.jpg,4067,480,640,49,377,426,193,276,True,25
O,80,kaist_dataset/English/Digital_Camera/(E.S)C-outdoor1/110.jpg,char_data/O/110.jpg_5.jpg,5120,480,640,64,503,567,192,272,True,25
O,52,kaist_dataset/English/Digital_Camera/(E.S)C-outdoor1/113.jpg,char_data/O/113.jpg_2.jpg,2132,480,640,41,254,295,167,219,True,25
O,189,kaist_dataset/English/Digital_Camera/(E.S)C-outdoor1/2007-12-08-day-099.jpg,char_data/O/2007-12-08-day-099.jpg_2.jpg,21546,1200,1600,114,1375,1489,468,657,True,25
O,202,kaist_dataset/English/Digital_Camera/(E.S)C-outdoor1/2007-12-08-day-117.jpg,char_data/O/2007-12-08-day-117.jpg_2.jpg,31714,1200,1600,157,455,612,519,721,True,25
O,118,kaist_dataset/English/Digital_Camera/(E.S)C-outdoor1/2007-12-09-day-exterior-063.jpg,char_data/O/2007-12-09-day-exterior-063.jpg_8.jpg,11800,1200,1600,100,1064,1164,452,570,True,25
O,98,kaist_dataset/English/Digital_Camera/(E.S)C-outdoor1/DSC02345.JPG,char_data/O/DSC02345.JPG_8.jpg,11662,480,640,119,408,527,131,229,True,25
O,30,kaist_dataset/English/Digital_Camera/(E.S)C-outdoor1/DSC02345.JPG,char_data/O/DSC02345.JPG_9.jpg,690,480,640,23,306,329,237,267,True,25
O,35,kaist_dataset/English/Digital_Camera/(E.S)C-outdoor1/DSC02345.JPG,char_data/O/DSC02345.JPG_10.jpg,735,480,640,21,329,350,236,271,True,25
O,30,kaist_dataset/English/Digital_Camera/(E.S)C-outdoor1/DSC02345.JPG,char_data/O/DSC02345.JPG_11.jpg,720,480,640,24,467,491,236,266,True,25
O,73,kaist_dataset/English/Digital_Camera/(E.S)C-outdoor1/DSC02356.JPG,char_data/O/DSC02356.JPG_4.jpg,4307,480,640,59,99,158,166,239,True,25
O,68,kaist_dataset/English/Digital_Camera/(E.S)C-outdoor1/DSC02394.JPG,char_data/O/DSC02394.JPG_2.jpg,4624,480,640,68,65,133,260,328,True,25
O,77,kaist_dataset/English/Digital_Camera/(E.S)C-outdoor1/DSC02395.JPG,char_data/O/DSC02395.JPG_2.jpg,6314,480,640,82,263,345,217,294,True,25
O,142,kaist_dataset/English/Digital_Camera/(E.S)C-outdoor1/DSC02406.JPG,char_data/O/DSC02406.JPG_2.jpg,18602,480,640,131,258,389,267,409,True,25
O,70,kaist_dataset/English/Digital_Camera/(E.S)C-outdoor1/DSC02408.JPG,char_data/O/DSC02408.JPG_2.jpg,5180,480,640,74,429,503,273,343,True,25
O,69,kaist_dataset/English/Digital_Camera/(E.S)C-outdoor1/DSC02417.JPG,char_data/O/DSC02417.JPG_2.jpg,5175,480,640,75,117,192,138,207,True,25
O,124,kaist_dataset/English/Digital_Camera/(E.S)C-outdoor1/DSC02427.JPG,char_data/O/DSC02427.JPG_10.jpg,9300,480,640,75,137,212,105,229,True,25
O,50,kaist_dataset/English/Digital_Camera/(E.S)C-outdoor1/DSC02427.JPG,char_data/O/DSC02427.JPG_11.jpg,1450,480,640,29,447,476,235,285,True,25
O,50,kaist_dataset/English/Digital_Camera/(E.S)C-outdoor1/DSC02427.JPG,char_data/O/DSC02427.JPG_12.jpg,1500,480,640,30,526,556,236,286,True,25
O,119,kaist_dataset/English/Digital_Camera/(E.S)C-outdoor1/DSC02450.JPG,char_data/O/DSC02450.JPG_4.jpg,6426,480,640,54,111,165,68,187,True,25
O,116,kaist_dataset/English/Digital_Camera/(E.S)C-outdoor1/DSC02450.JPG,char_data/O/DSC02450.JPG_5.jpg,6148,480,640,53,420,473,74,190,True,25
O,162,kaist_dataset/English/Digital_Camera/(E.S)C-outdoor1/DSC02475.JPG,char_data/O/DSC02475.JPG_2.jpg,20088,480,640,124,235,359,73,235,True,25
O,83,kaist_dataset/English/Digital_Camera/(E.S)C-outdoor1/DSC02491.JPG,char_data/O/DSC02491.JPG_2.jpg,6972,480,640,84,76,160,128,211,True,25
O,59,kaist_dataset/English/Digital_Camera/(E.S)C-outdoor1/DSC02501.JPG,char_data/O/DSC02501.JPG_2.jpg,3540,480,640,60,455,515,294,353,True,25
O,94,kaist_dataset/English/Digital_Camera/(E.S)C-outdoor1/DSC02514.JPG,char_data/O/DSC02514.JPG_2.jpg,5358,480,640,57,11,68,146,240,True,25
O,48,kaist_dataset/English/Digital_Camera/(E.S)C-outdoor1/DSC02559.JPG,char_data/O/DSC02559.JPG_5.jpg,2592,480,640,54,372,426,113,161,True,25
O,103,kaist_dataset/English/Digital_Camera/(E.S)C-outdoor1/DSC02590.JPG,char_data/O/DSC02590.JPG_2.jpg,7210,480,640,70,424,494,126,229,True,25
O,35,kaist_dataset/English/Digital_Camera/(E.S)C-outdoor1/DSC02618.JPG,char_data/O/DSC02618.JPG_2.jpg,630,480,640,18,266,284,173,208,True,25
O,68,kaist_dataset/English/Digital_Camera/(E.S)C-outdoor2/DSC03012.JPG,char_data/O/DSC03012.JPG_4.jpg,4216,480,640,62,374,436,211,279,True,25
O,79,kaist_dataset/English/Digital_Camera/(E.S)C-outdoor2/DSC03012.JPG,char_data/O/DSC03012.JPG_5.jpg,4187,480,640,53,437,490,208,287,True,25
O,53,kaist_dataset/English/Digital_Camera/(E.S)C-outdoor2/DSC03023.JPG,char_data/O/DSC03023.JPG_4.jpg,1431,480,640,27,239,266,299,352,True,25
O,49,kaist_dataset/English/Digital_Camera/(E.S)C-outdoor2/DSC03023.JPG,char_data/O/DSC03023.JPG_5.jpg,1470,480,640,30,358,388,300,349,True,25
O,64,kaist_dataset/English/Digital_Camera/(E.S)C-outdoor2/DSC03161.JPG,char_data/O/DSC03161.JPG_2.jpg,1920,480,640,30,455,485,202,266,True,25
O,71,kaist_dataset/English/Digital_Camera/(E.S)C-outdoor2/DSC03191.JPG,char_data/O/DSC03191.JPG_2.jpg,4615,480,640,65,151,216,227,298,True,25
O,91,kaist_dataset/English/Digital_Camera/(E.S)C-outdoor2/DSC03200.JPG,char_data/O/DSC03200.JPG_2.jpg,9828,480,640,108,52,160,229,320,True,25
O,47,kaist_dataset/English/Digital_Camera/(E.S)C-outdoor2/DSC03203.JPG,char_data/O/DSC03203.JPG_2.jpg,1927,480,640,41,282,323,313,360,True,25
O,75,kaist_dataset/English/Digital_Camera/(E.S)C-outdoor2/DSC03225.JPG,char_data/O/DSC03225.JPG_4.jpg,4350,480,640,58,108,166,47,122,True,25
O,70,kaist_dataset/English/Digital_Camera/(E.S)C-outdoor2/DSC03264.JPG,char_data/O/DSC03264.JPG_2.jpg,4550,480,640,65,167,232,157,227,True,25
O,60,kaist_dataset/English/Digital_Camera/(E.S)C-outdoor2/DSC03294.JPG,char_data/O/DSC03294.JPG_4.jpg,1980,480,640,33,286,319,291,351,True,25
O,59,kaist_dataset/English/Digital_Camera/(E.S)C-outdoor2/DSC03297.JPG,char_data/O/DSC03297.JPG_4.jpg,2537,480,640,43,183,226,258,317,True,25
O,50,kaist_dataset/English/Digital_Camera/(E.S)C-outdoor2/DSC03412.JPG,char_data/O/DSC03412.JPG_8.jpg,3000,480,640,60,148,208,399,449,True,25
O,58,kaist_dataset/English/Digital_Camera/(E.S)C-outdoor2/DSC03412.JPG,char_data/O/DSC03412.JPG_9.jpg,3306,480,640,57,257,314,398,456,True,25
O,66,kaist_dataset/English/Digital_Camera/(E.S)C-outdoor2/DSC03412.JPG,char_data/O/DSC03412.JPG_10.jpg,4026,480,640,61,372,433,398,464,True,25
O,63,kaist_dataset/English/Digital_Camera/(E.S)C-outdoor2/DSC03412.JPG,char_data/O/DSC03412.JPG_11.jpg,4032,480,640,64,363,427,271,334,True,25
O,53,kaist_dataset/English/Digital_Camera/(E.S)C-outdoor2/DSC03413.JPG,char_data/O/DSC03413.JPG_2.jpg,2809,480,640,53,428,481,210,263,True,25
O,81,kaist_dataset/English/Digital_Camera/(E.S)C-outdoor2/DSC03414.JPG,char_data/O/DSC03414.JPG_4.jpg,7533,480,640,93,248,341,253,334,True,25
O,58,kaist_dataset/English/Digital_Camera/(E.S)C-outdoor2/DSC03414.JPG,char_data/O/DSC03414.JPG_5.jpg,4408,480,640,76,43,119,354,412,True,25
O,78,kaist_dataset/English/Digital_Camera/(E.S)C-outdoor2/DSC03432.JPG,char_data/O/DSC03432.JPG_4.jpg,4290,480,640,55,188,243,359,437,True,25
O,86,kaist_dataset/English/Digital_Camera/(E.S)C-outdoor2/DSC03432.JPG,char_data/O/DSC03432.JPG_5.jpg,4300,480,640,50,482,532,357,443,True,25
O,46,kaist_dataset/English/Digital_Camera/(E.S)C-outdoor2/DSC03575.JPG,char_data/O/DSC03575.JPG_4.jpg,1426,480,640,31,259,290,179,225,True,25
O,53,kaist_dataset/English/Digital_Camera/(E.S)C-outdoor2/DSC03575.JPG,char_data/O/DSC03575.JPG_5.jpg,2067,480,640,39,129,168,260,313,True,25
O,66,kaist_dataset/English/Digital_Camera/(E.S)C-outdoor2/DSC03759.JPG,char_data/O/DSC03759.JPG_6.jpg,6930,480,640,105,177,282,194,260,True,25
O,64,kaist_dataset/English/Digital_Camera/(E.S)C-outdoor2/DSC03759.JPG,char_data/O/DSC03759.JPG_7.jpg,7168,480,640,112,281,393,197,261,True,25
O,60,kaist_dataset/English/Digital_Camera/(E.S)C-outdoor2/DSC03759.JPG,char_data/O/DSC03759.JPG_8.jpg,7560,480,640,126,424,550,124,184,True,25
O,39,kaist_dataset/English/Digital_Camera/(E.S)C-outdoor2/DSC03831.JPG,char_data/O/DSC03831.JPG_4.jpg,858,480,640,22,340,362,124,163,True,25
O,39,kaist_dataset/English/Digital_Camera/(E.S)C-outdoor2/DSC03831.JPG,char_data/O/DSC03831.JPG_5.jpg,897,480,640,23,429,452,128,167,True,25
O,65,kaist_dataset/English/Digital_Camera/(E.S)C-outdoor2/DSC03865.JPG,char_data/O/DSC03865.JPG_5.jpg,3185,480,640,49,533,582,97,162,True,25
O,72,kaist_dataset/English/Digital_Camera/(E.S)C-outdoor2/DSC04079.JPG,char_data/O/DSC04079.JPG_14.jpg,4248,480,640,59,251,310,267,339,True,25
O,54,kaist_dataset/English/Digital_Camera/(E.S)C-outdoor2/DSC04079.JPG,char_data/O/DSC04079.JPG_15.jpg,2376,480,640,44,346,390,46,100,True,25
O,42,kaist_dataset/English/Digital_Camera/(E.S)C-outdoor2/DSC04080.JPG,char_data/O/DSC04080.JPG_2.jpg,1848,480,640,44,464,508,306,348,True,25
O,63,kaist_dataset/English/Digital_Camera/(E.S)C-outdoor2/DSC04120.JPG,char_data/O/DSC04120.JPG_2.jpg,2520,480,640,40,492,532,139,202,True,25
O,45,kaist_dataset/English/Digital_Camera/(E.S)C-outdoor2/DSC04361.JPG,char_data/O/DSC04361.JPG_2.jpg,1080,480,640,24,266,290,235,280,True,25
O,34,kaist_dataset/English/Digital_Camera/(E.S)C-outdoor2/DSC04437.JPG,char_data/O/DSC04437.JPG_16.jpg,578,480,640,17,173,190,39,73,True,25
O,32,kaist_dataset/English/Digital_Camera/(E.S)C-outdoor2/DSC04437.JPG,char_data/O/DSC04437.JPG_21.jpg,416,480,640,13,176,189,75,107,True,25
O,74,kaist_dataset/English/Digital_Camera/(E.S)C-outdoor2/DSC04437.JPG,char_data/O/DSC04437.JPG_23.jpg,4810,480,640,65,370,435,107,181,True,25
O,57,kaist_dataset/English/Digital_Camera/(E.S)C-outdoor2/DSC04464.JPG,char_data/O/DSC04464.JPG_2.jpg,2565,480,640,45,304,349,330,387,True,25
O,57,kaist_dataset/English/Digital_Camera/(E.S)C-outdoor2/f.jpg,char_data/O/f.jpg_2.jpg,3078,240,320,54,100,154,66,123,True,25
O,53,kaist_dataset/English/Digital_Camera/(E.S)C-outdoor2/IMG_2481.JPG,char_data/O/IMG_2481.JPG_4.jpg,3392,480,640,64,222,286,261,314,True,25
O,57,kaist_dataset/English/Digital_Camera/(E.S)C-outdoor2/IMG_2481.JPG,char_data/O/IMG_2481.JPG_5.jpg,3477,480,640,61,296,357,192,249,True,25
O,85,kaist_dataset/English/Digital_Camera/(E.S)C-outdoor2/P1010015.JPG,char_data/O/P1010015.JPG_2.jpg,5440,480,640,64,19,83,132,217,True,25
O,48,kaist_dataset/English/Digital_Camera/(E.S)C-outdoor3/DSC02690.JPG,char_data/O/DSC02690.JPG_2.jpg,2304,480,640,48,235,283,226,274,True,25
O,60,kaist_dataset/English/Digital_Camera/(E.S)C-outdoor3/DSC02788.JPG,char_data/O/DSC02788.JPG_8.jpg,1920,480,640,32,201,233,317,377,True,25
O,58,kaist_dataset/English/Digital_Camera/(E.S)C-outdoor3/DSC02788.JPG,char_data/O/DSC02788.JPG_9.jpg,2146,480,640,37,233,270,315,373,True,25
O,63,kaist_dataset/English/Digital_Camera/(E.S)C-outdoor3/DSC02788.JPG,char_data/O/DSC02788.JPG_10.jpg,2709,480,640,43,301,344,216,279,True,25
O,60,kaist_dataset/English/Digital_Camera/(E.S)C-outdoor3/DSC02788.JPG,char_data/O/DSC02788.JPG_11.jpg,2100,480,640,35,345,380,213,273,True,25
O,75,kaist_dataset/English/Digital_Camera/(E.S)C-outdoor3/DSC03046.JPG,char_data/O/DSC03046.JPG_2.jpg,4425,480,640,59,468,527,117,192,True,25
O,82,kaist_dataset/English/Digital_Camera/(E.S)C-outdoor3/P1010064.JPG,char_data/O/P1010064.JPG_4.jpg,4428,480,640,54,190,244,313,395,True,25
O,94,kaist_dataset/English/Digital_Camera/(E.S)C-outdoor3/P1010133.JPG,char_data/O/P1010133.JPG_4.jpg,8178,480,640,87,303,390,155,249,True,25
O,91,kaist_dataset/English/Digital_Camera/(E.S)C-outdoor3/P1010133.JPG,char_data/O/P1010133.JPG_5.jpg,7098,480,640,78,389,467,151,242,True,25
O,79,kaist_dataset/English/Digital_Camera/(E.S)C-outdoor3/P1010138.JPG,char_data/O/P1010138.JPG_4.jpg,5214,480,640,66,183,249,76,155,True,25
O,39,kaist_dataset/English/Digital_Camera/(E.S)C-outdoor3/r.jpg,char_data/O/r.jpg_2.jpg,1482,240,320,38,91,129,53,92,True,25
O,35,kaist_dataset/English/Digital_Camera/(E.S)C-outdoor3/u.jpg,char_data/O/u.jpg_4.jpg,1190,240,320,34,163,197,92,127,True,25
O,36,kaist_dataset/English/Digital_Camera/(E.S)C-outdoor3/u.jpg,char_data/O/u.jpg_5.jpg,1548,240,320,43,202,245,96,132,True,25
O,58,kaist_dataset/English/Digital_Camera/(E.S)C-outdoor3/크기변환_P1010028.JPG,char_data/O/크기변환_P1010028.JPG_4.jpg,3248,480,640,56,192,248,169,227,True,25
O,58,kaist_dataset/English/Digital_Camera/(E.S)C-outdoor3/크기변환_P1010028.JPG,char_data/O/크기변환_P1010028.JPG_5.jpg,3132,480,640,54,450,504,174,232,True,25
O,29,kaist_dataset/English/Digital_Camera/(E.S)D-indoor/080119-0009.jpg,char_data/O/080119-0009.jpg_18.jpg,667,1200,1600,23,61,84,1056,1085,True,25
O,25,kaist_dataset/English/Digital_Camera/(E.S)D-indoor/080119-0009.jpg,char_data/O/080119-0009.jpg_19.jpg,575,1200,1600,23,88,111,1055,1080,True,25
O,116,kaist_dataset/English/Digital_Camera/(E.S)D-indoor/080119-0015.jpg,char_data/O/080119-0015.jpg_6.jpg,16124,1200,1600,139,652,791,509,625,True,25
O,30,kaist_dataset/English/Digital_Camera/(E.S)D-indoor/080119-0015.jpg,char_data/O/080119-0015.jpg_7.jpg,990,1200,1600,33,703,736,635,665,True,25
O,30,kaist_dataset/English/Digital_Camera/(E.S)D-indoor/080119-0015.jpg,char_data/O/080119-0015.jpg_8.jpg,1080,1200,1600,36,845,881,625,655,True,25
O,69,kaist_dataset/English/Digital_Camera/(E.S)D-indoor/DSC02769.JPG,char_data/O/DSC02769.JPG_8.jpg,3450,480,640,50,134,184,217,286,True,25
O,65,kaist_dataset/English/Digital_Camera/(E.S)D-indoor/DSC02769.JPG,char_data/O/DSC02769.JPG_9.jpg,2990,480,640,46,185,231,218,283,True,25
O,59,kaist_dataset/English/Digital_Camera/(E.S)D-indoor/DSC02769.JPG,char_data/O/DSC02769.JPG_10.jpg,2891,480,640,49,265,314,136,195,True,25
O,58,kaist_dataset/English/Digital_Camera/(E.S)D-indoor/DSC02769.JPG,char_data/O/DSC02769.JPG_11.jpg,2784,480,640,48,315,363,136,194,True,25
O,114,kaist_dataset/English/Digital_Camera/(E.S)D-indoor/DSC02842.JPG,char_data/O/DSC02842.JPG_6.jpg,13224,480,640,116,233,349,351,465,True,25
O,111,kaist_dataset/English/Digital_Camera/(E.S)D-indoor/DSC02852.JPG,char_data/O/DSC02852.JPG_4.jpg,7770,480,640,70,157,227,313,424,True,25
O,104,kaist_dataset/English/Digital_Camera/(E.S)D-indoor/DSC02852.JPG,char_data/O/DSC02852.JPG_5.jpg,6864,480,640,66,430,496,314,418,True,25
O,70,kaist_dataset/English/Digital_Camera/(E.S)D-indoor/DSC03091.JPG,char_data/O/DSC03091.JPG_5.jpg,4340,480,640,62,374,436,199,269,True,25
O,88,kaist_dataset/English/Digital_Camera/(E.S)D-indoor/DSC03365.JPG,char_data/O/DSC03365.JPG_2.jpg,7568,480,640,86,206,292,368,456,True,25
O,49,kaist_dataset/English/Digital_Camera/(E.S)D-indoor/DSC03401.JPG,char_data/O/DSC03401.JPG_2.jpg,1862,480,640,38,351,389,234,283,True,25
O,67,kaist_dataset/English/Digital_Camera/(E.S)D-indoor/DSC03883.JPG,char_data/O/DSC03883.JPG_4.jpg,2747,480,640,41,84,125,321,388,True,25
O,57,kaist_dataset/English/Digital_Camera/(E.S)D-indoor/DSC03883.JPG,char_data/O/DSC03883.JPG_5.jpg,2451,480,640,43,517,560,310,367,True,25
O,67,kaist_dataset/English/Digital_Camera/(E.S)D-indoor/DSC03887.JPG,char_data/O/DSC03887.JPG_2.jpg,3886,480,640,58,265,323,168,235,True,25
O,34,kaist_dataset/English/Digital_Camera/(E.S)D-indoor/DSC03896.JPG,char_data/O/DSC03896.JPG_2.jpg,1156,480,640,34,449,483,348,382,True,25
O,30,kaist_dataset/English/Digital_Camera/(E.S)D-indoor/DSC03901.JPG,char_data/O/DSC03901.JPG_6.jpg,780,480,640,26,347,373,263,293,True,25
O,33,kaist_dataset/English/Digital_Camera/(E.S)D-indoor/DSC03901.JPG,char_data/O/DSC03901.JPG_7.jpg,891,480,640,27,308,335,124,157,True,25
O,37,kaist_dataset/English/Digital_Camera/(E.S)D-indoor/DSC03901.JPG,char_data/O/DSC03901.JPG_8.jpg,1110,480,640,30,418,448,117,154,True,25
O,108,kaist_dataset/English/Digital_Camera/(E.S)D-indoor/DSC03911.JPG,char_data/O/DSC03911.JPG_2.jpg,7560,480,640,70,450,520,322,430,True,25
O,60,kaist_dataset/English/Digital_Camera/(E.S)D-indoor/DSC03918.JPG,char_data/O/DSC03918.JPG_2.jpg,2040,480,640,34,184,218,405,465,True,25
O,42,kaist_dataset/English/Digital_Camera/(E.S)D-indoor/DSC03942.JPG,char_data/O/DSC03942.JPG_4.jpg,840,480,640,20,124,144,3,45,True,25
O,37,kaist_dataset/English/Digital_Camera/(E.S)D-indoor/DSC03942.JPG,char_data/O/DSC03942.JPG_5.jpg,629,480,640,17,144,161,5,42,True,25
O,37,kaist_dataset/English/Digital_Camera/(E.S)D-indoor/DSC03943.JPG,char_data/O/DSC03943.JPG_2.jpg,740,480,640,20,332,352,311,348,True,25
O,41,kaist_dataset/English/Digital_Camera/(E.S)D-indoor/DSC03947.JPG,char_data/O/DSC03947.JPG_11.jpg,1353,480,640,33,472,505,413,454,True,25
O,76,kaist_dataset/English/Digital_Camera/(E.S)D-indoor/DSC04255.JPG,char_data/O/DSC04255.JPG_2.jpg,6840,480,640,90,215,305,301,377,True,25
O,33,kaist_dataset/English/Digital_Camera/(E.S)D-indoor/z.jpg,char_data/O/z.jpg_2.jpg,594,240,320,18,111,129,64,97,True,25
O,110,kaist_dataset/English/Digital_Camera/(E.S)E-night/DSC02606.JPG,char_data/O/DSC02606.JPG_2.jpg,11770,480,640,107,219,326,197,307,True,25
O,69,kaist_dataset/English/Digital_Camera/(E.S)F-others/032.jpg,char_data/O/032.jpg_2.jpg,3864,245,422,56,114,170,30,99,True,25
O,160,kaist_dataset/English/Digital_Camera/(E.S)F-others/080116-0058.jpg,char_data/O/080116-0058.jpg_6.jpg,13600,1200,1600,85,750,835,361,521,True,25
O,127,kaist_dataset/English/Digital_Camera/(E.S)F-others/080116-0058.jpg,char_data/O/080116-0058.jpg_7.jpg,5969,1200,1600,47,1048,1095,498,625,True,25
O,137,kaist_dataset/English/Digital_Camera/(E.S)F-others/080116-0058.jpg,char_data/O/080116-0058.jpg_8.jpg,4110,1200,1600,30,962,992,742,879,True,25
O,166,kaist_dataset/English/Digital_Camera/(E.S)F-others/080116-0060.jpg,char_data/O/080116-0060.jpg_4.jpg,30876,1200,1600,186,193,379,462,628,True,25
O,134,kaist_dataset/English/Digital_Camera/(E.S)F-others/080116-0060.jpg,char_data/O/080116-0060.jpg_5.jpg,15946,1200,1600,119,1185,1304,389,523,True,25
O,291,kaist_dataset/English/Digital_Camera/(E.S)F-others/080119-0011.jpg,char_data/O/080119-0011.jpg_2.jpg,38994,1200,1600,134,1178,1312,569,860,True,25
O,200,kaist_dataset/English/Digital_Camera/(E.S)F-others/080119-0013.jpg,char_data/O/080119-0013.jpg_2.jpg,36400,1200,1600,182,373,555,475,675,True,25
O,49,kaist_dataset/English/Digital_Camera/(E.S)F-others/086.jpg,char_data/O/086.jpg_8.jpg,1225,480,640,25,197,222,287,336,True,25
O,55,kaist_dataset/English/Digital_Camera/(E.S)F-others/086.jpg,char_data/O/086.jpg_9.jpg,880,480,640,16,337,353,314,369,True,25
O,192,kaist_dataset/English/Digital_Camera/(E.S)F-others/2007-12-09-day-exterior-047.jpg,char_data/O/2007-12-09-day-exterior-047.jpg_8.jpg,28608,1200,1600,149,790,939,456,648,True,25
O,163,kaist_dataset/English/Digital_Camera/(E.S)F-others/2007-12-09-day-exterior-047.jpg,char_data/O/2007-12-09-day-exterior-047.jpg_9.jpg,20701,1200,1600,127,1167,1294,517,680,True,25
O,42,kaist_dataset/English/Digital_Camera/(E.S)F-others/2007-12-09-day-exterior-047.jpg,char_data/O/2007-12-09-day-exterior-047.jpg_10.jpg,1134,1200,1600,27,663,690,1070,1112,True,25
O,38,kaist_dataset/English/Digital_Camera/(E.S)F-others/2007-12-09-day-exterior-047.jpg,char_data/O/2007-12-09-day-exterior-047.jpg_11.jpg,1064,1200,1600,28,732,760,1071,1109,True,25
O,112,kaist_dataset/English/Digital_Camera/(E.S)F-others/DSC02646.JPG,char_data/O/DSC02646.JPG_4.jpg,4704,480,640,42,47,89,302,414,True,25
O,101,kaist_dataset/English/Digital_Camera/(E.S)F-others/DSC02646.JPG,char_data/O/DSC02646.JPG_5.jpg,4848,480,640,48,235,283,241,342,True,25
O,100,kaist_dataset/English/Digital_Camera/(E.S)F-others/DSC02923.JPG,char_data/O/DSC02923.JPG_2.jpg,9200,480,640,92,229,321,281,381,True,25
O,32,kaist_dataset/English/Digital_Camera/(E.S)F-others/m.jpg,char_data/O/m.jpg_2.jpg,768,240,320,24,258,282,92,124,True,25
O,80,kaist_dataset/English/Digital_Camera/(E.S)F-others/크기변환_%C4%BF%C7%C7%B5%B9%C3%E2%B0%A3%C6%C7_%281%29_alto99kr.jpg,char_data/O/크기변환_%C4%BF%C7%C7%B5%B9%C3%E2%B0%A3%C6%C7_%281%29_alto99kr.jpg_2.jpg,5760,480,640,72,200,272,278,358,True,25
O,81,kaist_dataset/English/Mobile_Phone/(E.M)B-indoor/P090902018.jpg,char_data/O/P090902018.jpg_4.jpg,3888,480,640,48,215,263,51,132,True,25
O,61,kaist_dataset/English/Mobile_Phone/(E.M)B-indoor/P090911084.jpg,char_data/O/P090911084.jpg_2.jpg,2562,480,640,42,80,122,150,211,True,25
O,70,kaist_dataset/English/Mobile_Phone/(E.M)C-bookCover/P090831042.jpg,char_data/O/P090831042.jpg_2.jpg,4060,480,640,58,48,106,199,269,True,25
O,64,kaist_dataset/English/Mobile_Phone/(E.M)C-bookCover/P090831075.jpg,char_data/O/P090831075.jpg_4.jpg,3840,480,640,60,176,236,157,221,True,25
O,65,kaist_dataset/English/Mobile_Phone/(E.M)C-bookCover/P090831075.jpg,char_data/O/P090831075.jpg_5.jpg,4160,480,640,64,390,454,161,226,True,25
O,49,kaist_dataset/English/Mobile_Phone/(E.M)C-bookCover/P090903015.jpg,char_data/O/P090903015.jpg_6.jpg,1911,480,640,39,338,377,76,125,True,25
O,42,kaist_dataset/English/Mobile_Phone/(E.M)C-bookCover/P090903015.jpg,char_data/O/P090903015.jpg_7.jpg,1512,480,640,36,160,196,150,192,True,25
O,48,kaist_dataset/English/Mobile_Phone/(E.M)C-bookCover/P090903015.jpg,char_data/O/P090903015.jpg_8.jpg,1872,480,640,39,441,480,140,188,True,25
O,59,kaist_dataset/English/Mobile_Phone/(E.M)C-bookCover/P090903054.jpg,char_data/O/P090903054.jpg_4.jpg,2242,480,640,38,239,277,352,411,True,25
O,55,kaist_dataset/English/Mobile_Phone/(E.M)C-bookCover/P090903054.jpg,char_data/O/P090903054.jpg_5.jpg,1925,480,640,35,457,492,351,406,True,25
O,41,kaist_dataset/English/Mobile_Phone/(E.M)C-bookCover/P090903055.jpg,char_data/O/P090903055.jpg_6.jpg,1353,480,640,33,290,323,69,110,True,25
O,38,kaist_dataset/English/Mobile_Phone/(E.M)C-bookCover/P090903055.jpg,char_data/O/P090903055.jpg_7.jpg,1102,480,640,29,327,356,406,444,True,25
O,35,kaist_dataset/English/Mobile_Phone/(E.M)C-bookCover/P090903055.jpg,char_data/O/P090903055.jpg_8.jpg,1330,480,640,38,398,436,408,443,True,25
O,43,kaist_dataset/English/Mobile_Phone/(E.M)C-bookCover/P090903056.jpg,char_data/O/P090903056.jpg_2.jpg,1505,480,640,35,283,318,200,243,True,25
O,77,kaist_dataset/English/Mobile_Phone/(E.M)C-bookCover/P090903071.jpg,char_data/O/P090903071.jpg_2.jpg,5467,480,640,71,400,471,147,224,True,25
O,105,kaist_dataset/English/Mobile_Phone/(E.M)C-bookCover/P090903076.jpg,char_data/O/P090903076.jpg_2.jpg,9030,480,640,86,367,453,176,281,True,25
O,149,kaist_dataset/English/Mobile_Phone/(E.M)C-bookCover/P090903082.jpg,char_data/O/P090903082.jpg_2.jpg,20711,480,640,139,186,325,32,181,True,25
O,26,kaist_dataset/Korean/Digital_Camera/indoor1/080119-0029.jpg,char_data/O/080119-0029.jpg_8.jpg,546,1200,1600,21,885,906,657,683,True,25
O,19,kaist_dataset/Korean/Digital_Camera/indoor1/146.JPG,char_data/O/146.JPG_4.jpg,304,480,640,16,291,307,267,286,True,25
O,15,kaist_dataset/Korean/Digital_Camera/indoor1/146.JPG,char_data/O/146.JPG_5.jpg,150,480,640,10,337,347,271,286,True,25
O,55,kaist_dataset/Korean/Digital_Camera/outdoor2/2007-12-08-day-101.jpg,char_data/O/2007-12-08-day-101.jpg_2.jpg,2805,1200,1600,51,186,237,1093,1148,True,25
O,72,kaist_dataset/Korean/Digital_Camera/outdoor2/2007-12-09-day-exterior-068.jpg,char_data/O/2007-12-09-day-exterior-068.jpg_2.jpg,4104,1200,1600,57,540,597,955,1027,True,25
O,38,kaist_dataset/Mixed/Digital_Camera/(C.S)A-shadow/DSC02568.JPG,char_data/O/DSC02568.JPG_4.jpg,874,480,640,23,260,283,145,183,True,25
O,44,kaist_dataset/Mixed/Digital_Camera/(C.S)A-shadow/DSC02902.JPG,char_data/O/DSC02902.JPG_6.jpg,1276,480,640,29,244,273,384,428,True,25
O,44,kaist_dataset/Mixed/Digital_Camera/(C.S)A-shadow/DSC02902.JPG,char_data/O/DSC02902.JPG_7.jpg,1012,480,640,23,273,296,379,423,True,25
O,45,kaist_dataset/Mixed/Digital_Camera/(C.S)A-shadow/DSC02902.JPG,char_data/O/DSC02902.JPG_8.jpg,1215,480,640,27,355,382,370,415,True,25
O,66,kaist_dataset/Mixed/Digital_Camera/(C.S)A-shadow/DSC03520.JPG,char_data/O/DSC03520.JPG_2.jpg,3696,480,640,56,261,317,48,114,True,25
O,112,kaist_dataset/Mixed/Digital_Camera/(C.S)C-outdoor1/008.JPG,char_data/O/008.JPG_4.jpg,7280,480,640,65,254,319,137,249,True,25
O,115,kaist_dataset/Mixed/Digital_Camera/(C.S)C-outdoor1/008.JPG,char_data/O/008.JPG_5.jpg,7360,480,640,64,529,593,134,249,True,25
O,108,kaist_dataset/Mixed/Digital_Camera/(C.S)C-outdoor1/027.JPG,char_data/O/027.JPG_2.jpg,7776,480,640,72,231,303,158,266,True,25
O,148,kaist_dataset/Mixed/Digital_Camera/(C.S)C-outdoor1/038.JPG,char_data/O/038.JPG_2.jpg,23384,480,640,158,22,180,154,302,True,25
O,82,kaist_dataset/Mixed/Digital_Camera/(C.S)C-outdoor1/046.JPG,char_data/O/046.JPG_2.jpg,3936,480,640,48,438,486,186,268,True,25
O,26,kaist_dataset/Mixed/Digital_Camera/(C.S)C-outdoor1/054.JPG,char_data/O/054.JPG_4.jpg,780,480,640,30,242,272,278,304,True,25
O,28,kaist_dataset/Mixed/Digital_Camera/(C.S)C-outdoor1/054.JPG,char_data/O/054.JPG_5.jpg,728,480,640,26,272,298,277,305,True,25
O,49,kaist_dataset/Mixed/Digital_Camera/(C.S)C-outdoor1/080116-0084.jpg,char_data/O/080116-0084.jpg_5.jpg,2205,600,800,45,402,447,300,349,True,25
O,53,kaist_dataset/Mixed/Digital_Camera/(C.S)C-outdoor1/080119-0006.jpg,char_data/O/080119-0006.jpg_4.jpg,3180,1200,1600,60,611,671,736,789,True,25
O,63,kaist_dataset/Mixed/Digital_Camera/(C.S)C-outdoor1/080119-0006.jpg,char_data/O/080119-0006.jpg_5.jpg,3654,1200,1600,58,882,940,734,797,True,25
O,179,kaist_dataset/Mixed/Digital_Camera/(C.S)C-outdoor1/080119-0017.jpg,char_data/O/080119-0017.jpg_4.jpg,26671,1200,1600,149,441,590,557,736,True,25
O,163,kaist_dataset/Mixed/Digital_Camera/(C.S)C-outdoor1/080119-0017.jpg,char_data/O/080119-0017.jpg_5.jpg,21353,1200,1600,131,1131,1262,551,714,True,25
O,72,kaist_dataset/Mixed/Digital_Camera/(C.S)C-outdoor1/080119-0027.jpg,char_data/O/080119-0027.jpg_4.jpg,3672,1200,1600,51,923,974,720,792,True,25
O,50,kaist_dataset/Mixed/Digital_Camera/(C.S)C-outdoor1/080119-0027.jpg,char_data/O/080119-0027.jpg_5.jpg,1900,1200,1600,38,1038,1076,1050,1100,True,25
O,117,kaist_dataset/Mixed/Digital_Camera/(C.S)C-outdoor1/080119-0037.jpg,char_data/O/080119-0037.jpg_4.jpg,9945,1200,1600,85,96,181,885,1002,True,25
O,117,kaist_dataset/Mixed/Digital_Camera/(C.S)C-outdoor1/080119-0037.jpg,char_data/O/080119-0037.jpg_5.jpg,7605,1200,1600,65,1307,1372,826,943,True,25
O,30,kaist_dataset/Mixed/Digital_Camera/(C.S)C-outdoor1/114.jpg,char_data/O/114.jpg_4.jpg,1080,480,640,36,214,250,269,299,True,25
O,22,kaist_dataset/Mixed/Digital_Camera/(C.S)C-outdoor1/114.jpg,char_data/O/114.jpg_5.jpg,506,480,640,23,202,225,366,388,True,25
O,64,kaist_dataset/Mixed/Digital_Camera/(C.S)C-outdoor1/2.JPG,char_data/O/2.JPG_8.jpg,3008,576,768,47,464,511,206,270,True,25
O,25,kaist_dataset/Mixed/Digital_Camera/(C.S)C-outdoor1/2.JPG,char_data/O/2.JPG_11.jpg,375,576,768,15,601,616,370,395,True,25
O,53,kaist_dataset/Mixed/Digital_Camera/(C.S)C-outdoor1/2007-12-08-day-130.jpg,char_data/O/2007-12-08-day-130.jpg_4.jpg,2650,1200,1600,50,584,634,689,742,True,25
O,45,kaist_dataset/Mixed/Digital_Camera/(C.S)C-outdoor1/2007-12-08-day-130.jpg,char_data/O/2007-12-08-day-130.jpg_5.jpg,2070,1200,1600,46,636,682,693,738,True,25
O,29,kaist_dataset/Mixed/Digital_Camera/(C.S)C-outdoor1/2007-12-09-day-exterior-051.jpg,char_data/O/2007-12-09-day-exterior-051.jpg_2.jpg,638,1200,1600,22,526,548,609,638,True,25
O,22,kaist_dataset/Mixed/Digital_Camera/(C.S)C-outdoor1/3.JPG,char_data/O/3.JPG_10.jpg,396,576,768,18,259,277,63,85,True,25
O,25,kaist_dataset/Mixed/Digital_Camera/(C.S)C-outdoor1/3.JPG,char_data/O/3.JPG_11.jpg,450,576,768,18,293,311,60,85,True,25
O,27,kaist_dataset/Mixed/Digital_Camera/(C.S)C-outdoor1/3.JPG,char_data/O/3.JPG_12.jpg,486,576,768,18,462,480,52,79,True,25
O,32,kaist_dataset/Mixed/Digital_Camera/(C.S)C-outdoor1/3.JPG,char_data/O/3.JPG_13.jpg,736,576,768,23,497,520,51,83,True,25
O,24,kaist_dataset/Mixed/Digital_Camera/(C.S)C-outdoor1/3.JPG,char_data/O/3.JPG_14.jpg,240,576,768,10,637,647,291,315,True,25
O,26,kaist_dataset/Mixed/Digital_Camera/(C.S)C-outdoor1/DSC02240.JPG,char_data/O/DSC02240.JPG_6.jpg,754,480,640,29,116,145,289,315,True,25
O,28,kaist_dataset/Mixed/Digital_Camera/(C.S)C-outdoor1/DSC02240.JPG,char_data/O/DSC02240.JPG_7.jpg,700,480,640,25,397,422,288,316,True,25
O,26,kaist_dataset/Mixed/Digital_Camera/(C.S)C-outdoor1/DSC02240.JPG,char_data/O/DSC02240.JPG_8.jpg,754,480,640,29,147,176,284,310,True,25
O,31,kaist_dataset/Mixed/Digital_Camera/(C.S)C-outdoor1/DSC02318.JPG,char_data/O/DSC02318.JPG_5.jpg,1147,480,640,37,378,415,324,355,True,25
O,23,kaist_dataset/Mixed/Digital_Camera/(C.S)C-outdoor1/DSC02319.JPG,char_data/O/DSC02319.JPG_2.jpg,575,480,640,25,85,110,249,272,True,25
O,51,kaist_dataset/Mixed/Digital_Camera/(C.S)C-outdoor1/DSC02325.JPG,char_data/O/DSC02325.JPG_4.jpg,2040,480,640,40,345,385,244,295,True,25
O,40,kaist_dataset/Mixed/Digital_Camera/(C.S)C-outdoor1/DSC02325.JPG,char_data/O/DSC02325.JPG_5.jpg,1840,480,640,46,383,429,244,284,True,25
O,52,kaist_dataset/Mixed/Digital_Camera/(C.S)C-outdoor1/P1010009.JPG,char_data/O/P1010009.JPG_2.jpg,2860,480,640,55,272,327,185,237,True,25
O,54,kaist_dataset/Mixed/Digital_Camera/(C.S)C-outdoor2/DSC02365.JPG,char_data/O/DSC02365.JPG_2.jpg,2160,480,640,40,385,425,82,136,True,25
O,30,kaist_dataset/Mixed/Digital_Camera/(C.S)C-outdoor2/DSC02397.JPG,char_data/O/DSC02397.JPG_2.jpg,510,480,640,17,98,115,140,170,True,25
O,21,kaist_dataset/Mixed/Digital_Camera/(C.S)C-outdoor2/DSC02411.JPG,char_data/O/DSC02411.JPG_18.jpg,147,480,640,7,550,557,272,293,True,25
O,13,kaist_dataset/Mixed/Digital_Camera/(C.S)C-outdoor2/DSC02411.JPG,char_data/O/DSC02411.JPG_19.jpg,130,480,640,10,571,581,277,290,True,25
O,15,kaist_dataset/Mixed/Digital_Camera/(C.S)C-outdoor2/DSC02411.JPG,char_data/O/DSC02411.JPG_20.jpg,120,480,640,8,596,604,276,291,True,25
O,21,kaist_dataset/Mixed/Digital_Camera/(C.S)C-outdoor2/DSC02411.JPG,char_data/O/DSC02411.JPG_21.jpg,294,480,640,14,616,630,273,294,True,25
O,33,kaist_dataset/Mixed/Digital_Camera/(C.S)C-outdoor2/DSC02418.JPG,char_data/O/DSC02418.JPG_5.jpg,792,480,640,24,54,78,87,120,True,25
O,44,kaist_dataset/Mixed/Digital_Camera/(C.S)C-outdoor2/DSC02429.JPG,char_data/O/DSC02429.JPG_4.jpg,1848,480,640,42,387,429,115,159,True,25
O,36,kaist_dataset/Mixed/Digital_Camera/(C.S)C-outdoor2/DSC02429.JPG,char_data/O/DSC02429.JPG_5.jpg,1512,480,640,42,505,547,117,153,True,25
O,30,kaist_dataset/Mixed/Digital_Camera/(C.S)C-outdoor2/DSC02430.JPG,char_data/O/DSC02430.JPG_5.jpg,690,480,640,23,172,195,184,214,True,25
O,21,kaist_dataset/Mixed/Digital_Camera/(C.S)C-outdoor2/DSC02477.JPG,char_data/O/DSC02477.JPG_2.jpg,273,480,640,13,136,149,156,177,True,25
O,83,kaist_dataset/Mixed/Digital_Camera/(C.S)C-outdoor2/DSC02513.JPG,char_data/O/DSC02513.JPG_2.jpg,3154,480,640,38,316,354,234,317,True,25
O,36,kaist_dataset/Mixed/Digital_Camera/(C.S)C-outdoor2/DSC02545.JPG,char_data/O/DSC02545.JPG_7.jpg,1116,480,640,31,181,212,366,402,True,25
O,23,kaist_dataset/Mixed/Digital_Camera/(C.S)C-outdoor2/DSC02555.JPG,char_data/O/DSC02555.JPG_2.jpg,368,480,640,16,152,168,154,177,True,25
O,38,kaist_dataset/Mixed/Digital_Camera/(C.S)C-outdoor2/DSC02568.JPG,char_data/O/DSC02568.JPG_5.jpg,874,480,640,23,260,283,145,183,True,25
O,39,kaist_dataset/Mixed/Digital_Camera/(C.S)C-outdoor2/DSC02864.JPG,char_data/O/DSC02864.JPG_2.jpg,1287,480,640,33,494,527,259,298,True,25
O,43,kaist_dataset/Mixed/Digital_Camera/(C.S)C-outdoor2/DSC02867.JPG,char_data/O/DSC02867.JPG_2.jpg,1462,480,640,34,278,312,401,444,True,25
O,52,kaist_dataset/Mixed/Digital_Camera/(C.S)C-outdoor2/DSC02869.JPG,char_data/O/DSC02869.JPG_2.jpg,1664,480,640,32,254,286,134,186,True,25
O,73,kaist_dataset/Mixed/Digital_Camera/(C.S)C-outdoor2/DSC02870.JPG,char_data/O/DSC02870.JPG_2.jpg,3869,480,640,53,267,320,276,349,True,25
O,30,kaist_dataset/Mixed/Digital_Camera/(C.S)C-outdoor2/DSC02890.JPG,char_data/O/DSC02890.JPG_4.jpg,840,480,640,28,111,139,408,438,True,25
O,32,kaist_dataset/Mixed/Digital_Camera/(C.S)C-outdoor2/DSC02890.JPG,char_data/O/DSC02890.JPG_5.jpg,768,480,640,24,139,163,407,439,True,25
O,35,kaist_dataset/Mixed/Digital_Camera/(C.S)C-outdoor2/DSC02910.JPG,char_data/O/DSC02910.JPG_2.jpg,805,480,640,23,292,315,56,91,True,25
O,107,kaist_dataset/Mixed/Digital_Camera/(C.S)C-outdoor2/DSC02917.JPG,char_data/O/DSC02917.JPG_10.jpg,8239,480,640,77,350,427,73,180,True,25
O,110,kaist_dataset/Mixed/Digital_Camera/(C.S)C-outdoor2/DSC02917.JPG,char_data/O/DSC02917.JPG_11.jpg,9240,480,640,84,495,579,70,180,True,25
O,34,kaist_dataset/Mixed/Digital_Camera/(C.S)C-outdoor2/DSC02917.JPG,char_data/O/DSC02917.JPG_12.jpg,816,480,640,24,79,103,222,256,True,25
O,32,kaist_dataset/Mixed/Digital_Camera/(C.S)C-outdoor2/DSC02917.JPG,char_data/O/DSC02917.JPG_13.jpg,640,480,640,20,122,142,223,255,True,25
O,29,kaist_dataset/Mixed/Digital_Camera/(C.S)C-outdoor2/DSC02917.JPG,char_data/O/DSC02917.JPG_14.jpg,551,480,640,19,178,197,226,255,True,25
O,35,kaist_dataset/Mixed/Digital_Camera/(C.S)C-outdoor3/DSC02986.JPG,char_data/O/DSC02986.JPG_2.jpg,1400,480,640,40,462,502,282,317,True,25
O,45,kaist_dataset/Mixed/Digital_Camera/(C.S)C-outdoor3/DSC02989.JPG,char_data/O/DSC02989.JPG_9.jpg,1575,480,640,35,395,430,264,309,True,25
O,44,kaist_dataset/Mixed/Digital_Camera/(C.S)C-outdoor3/DSC02989.JPG,char_data/O/DSC02989.JPG_10.jpg,1672,480,640,38,457,495,269,313,True,25
O,47,kaist_dataset/Mixed/Digital_Camera/(C.S)C-outdoor3/DSC02989.JPG,char_data/O/DSC02989.JPG_11.jpg,1645,480,640,35,564,599,268,315,True,25
O,162,kaist_dataset/Mixed/Digital_Camera/(C.S)C-outdoor3/DSC03006.JPG,char_data/O/DSC03006.JPG_2.jpg,13284,480,640,82,411,493,106,268,True,25
O,52,kaist_dataset/Mixed/Digital_Camera/(C.S)C-outdoor3/DSC03010.JPG,char_data/O/DSC03010.JPG_4.jpg,2288,480,640,44,283,327,96,148,True,25
O,47,kaist_dataset/Mixed/Digital_Camera/(C.S)C-outdoor3/DSC03010.JPG,char_data/O/DSC03010.JPG_5.jpg,1692,480,640,36,408,444,79,126,True,25
O,35,kaist_dataset/Mixed/Digital_Camera/(C.S)C-outdoor3/DSC03020.JPG,char_data/O/DSC03020.JPG_6.jpg,945,480,640,27,555,582,265,300,True,25
O,20,kaist_dataset/Mixed/Digital_Camera/(C.S)C-outdoor3/DSC03033.JPG,char_data/O/DSC03033.JPG_4.jpg,260,480,640,13,54,67,156,176,True,25
O,18,kaist_dataset/Mixed/Digital_Camera/(C.S)C-outdoor3/DSC03033.JPG,char_data/O/DSC03033.JPG_5.jpg,252,480,640,14,141,155,151,169,True,25
O,28,kaist_dataset/Mixed/Digital_Camera/(C.S)C-outdoor3/DSC03035.JPG,char_data/O/DSC03035.JPG_6.jpg,728,480,640,26,352,378,372,400,True,25
O,33,kaist_dataset/Mixed/Digital_Camera/(C.S)C-outdoor3/DSC03035.JPG,char_data/O/DSC03035.JPG_7.jpg,660,480,640,20,349,369,402,435,True,25
O,37,kaist_dataset/Mixed/Digital_Camera/(C.S)C-outdoor3/DSC03035.JPG,char_data/O/DSC03035.JPG_8.jpg,888,480,640,24,369,393,400,437,True,25
O,70,kaist_dataset/Mixed/Digital_Camera/(C.S)C-outdoor3/DSC03048.JPG,char_data/O/DSC03048.JPG_2.jpg,3430,480,640,49,326,375,131,201,True,25
O,78,kaist_dataset/Mixed/Digital_Camera/(C.S)C-outdoor3/DSC03055.JPG,char_data/O/DSC03055.JPG_2.jpg,6084,480,640,78,201,279,256,334,True,25
O,96,kaist_dataset/Mixed/Digital_Camera/(C.S)C-outdoor3/DSC03176.JPG,char_data/O/DSC03176.JPG_2.jpg,9120,480,640,95,122,217,269,365,True,25
O,52,kaist_dataset/Mixed/Digital_Camera/(C.S)C-outdoor3/DSC03186.JPG,char_data/O/DSC03186.JPG_2.jpg,2340,480,640,45,58,103,103,155,True,25
O,37,kaist_dataset/Mixed/Digital_Camera/(C.S)C-outdoor3/DSC03242.JPG,char_data/O/DSC03242.JPG_4.jpg,1184,480,640,32,191,223,319,356,True,25
O,40,kaist_dataset/Mixed/Digital_Camera/(C.S)C-outdoor3/DSC03242.JPG,char_data/O/DSC03242.JPG_5.jpg,1320,480,640,33,220,253,316,356,True,25
O,36,kaist_dataset/Mixed/Digital_Camera/(C.S)C-outdoor3/DSC03250.JPG,char_data/O/DSC03250.JPG_4.jpg,828,480,640,23,444,467,364,400,True,25
O,28,kaist_dataset/Mixed/Digital_Camera/(C.S)C-outdoor3/DSC03250.JPG,char_data/O/DSC03250.JPG_5.jpg,588,480,640,21,467,488,371,399,True,25
O,36,kaist_dataset/Mixed/Digital_Camera/(C.S)C-outdoor3/DSC03254.JPG,char_data/O/DSC03254.JPG_2.jpg,1332,480,640,37,112,149,226,262,True,25
O,118,kaist_dataset/Mixed/Digital_Camera/(C.S)C-outdoor3/DSC03259.JPG,char_data/O/DSC03259.JPG_2.jpg,10502,480,640,89,181,270,72,190,True,25
O,95,kaist_dataset/Mixed/Digital_Camera/(C.S)C-outdoor3/DSC03260.JPG,char_data/O/DSC03260.JPG_2.jpg,6555,480,640,69,280,349,65,160,True,25
O,33,kaist_dataset/Mixed/Digital_Camera/(C.S)C-outdoor3/DSC03271.JPG,char_data/O/DSC03271.JPG_6.jpg,1287,480,640,39,236,275,80,113,True,25
O,57,kaist_dataset/Mixed/Digital_Camera/(C.S)C-outdoor3/DSC03306.JPG,char_data/O/DSC03306.JPG_4.jpg,1995,480,640,35,314,349,396,453,True,25
O,63,kaist_dataset/Mixed/Digital_Camera/(C.S)C-outdoor3/DSC03306.JPG,char_data/O/DSC03306.JPG_5.jpg,2394,480,640,38,506,544,390,453,True,25
O,39,kaist_dataset/Mixed/Digital_Camera/(C.S)C-outdoor3/DSC03329.JPG,char_data/O/DSC03329.JPG_4.jpg,1248,480,640,32,468,500,439,478,True,25
O,33,kaist_dataset/Mixed/Digital_Camera/(C.S)C-outdoor3/DSC03329.JPG,char_data/O/DSC03329.JPG_5.jpg,1056,480,640,32,530,562,445,478,True,25
O,40,kaist_dataset/Mixed/Digital_Camera/(C.S)C-outdoor3/DSC03330.JPG,char_data/O/DSC03330.JPG_4.jpg,1280,480,640,32,149,181,390,430,True,25
O,33,kaist_dataset/Mixed/Digital_Camera/(C.S)C-outdoor3/DSC03330.JPG,char_data/O/DSC03330.JPG_5.jpg,1056,480,640,32,203,235,398,431,True,25
O,46,kaist_dataset/Mixed/Digital_Camera/(C.S)C-outdoor3/DSC03331.JPG,char_data/O/DSC03331.JPG_4.jpg,1104,480,640,24,149,173,376,422,True,25
O,41,kaist_dataset/Mixed/Digital_Camera/(C.S)C-outdoor3/DSC03331.JPG,char_data/O/DSC03331.JPG_5.jpg,1271,480,640,31,194,225,380,421,True,25
O,43,kaist_dataset/Mixed/Digital_Camera/(C.S)C-outdoor4/DSC03581.JPG,char_data/O/DSC03581.JPG_2.jpg,1548,480,640,36,50,86,191,234,True,25
O,67,kaist_dataset/Mixed/Digital_Camera/(C.S)C-outdoor4/DSC03640.JPG,char_data/O/DSC03640.JPG_2.jpg,4288,480,640,64,387,451,304,371,True,25
O,93,kaist_dataset/Mixed/Digital_Camera/(C.S)C-outdoor4/DSC03652.JPG,char_data/O/DSC03652.JPG_2.jpg,7905,480,640,85,21,106,178,271,True,25
O,85,kaist_dataset/Mixed/Digital_Camera/(C.S)C-outdoor4/DSC03666.JPG,char_data/O/DSC03666.JPG_2.jpg,5780,480,640,68,161,229,162,247,True,25
O,62,kaist_dataset/Mixed/Digital_Camera/(C.S)C-outdoor4/DSC03673.JPG,char_data/O/DSC03673.JPG_4.jpg,2232,480,640,36,217,253,179,241,True,25
O,59,kaist_dataset/Mixed/Digital_Camera/(C.S)C-outdoor4/DSC03673.JPG,char_data/O/DSC03673.JPG_5.jpg,2242,480,640,38,335,373,184,243,True,25
O,38,kaist_dataset/Mixed/Digital_Camera/(C.S)C-outdoor4/DSC03679.JPG,char_data/O/DSC03679.JPG_2.jpg,1064,480,640,28,171,199,101,139,False,25
O,73,kaist_dataset/Mixed/Digital_Camera/(C.S)C-outdoor4/DSC03687.JPG,char_data/O/DSC03687.JPG_2.jpg,3796,480,640,52,177,229,321,394,False,25
O,51,kaist_dataset/Mixed/Digital_Camera/(C.S)C-outdoor4/DSC03707.JPG,char_data/O/DSC03707.JPG_6.jpg,1683,480,640,33,357,390,90,141,False,25
O,54,kaist_dataset/Mixed/Digital_Camera/(C.S)C-outdoor4/DSC03707.JPG,char_data/O/DSC03707.JPG_7.jpg,1998,480,640,37,388,425,89,143,False,25
O,53,kaist_dataset/Mixed/Digital_Camera/(C.S)C-outdoor4/DSC03707.JPG,char_data/O/DSC03707.JPG_8.jpg,1749,480,640,33,265,298,150,203,False,25
O,34,kaist_dataset/Mixed/Digital_Camera/(C.S)C-outdoor4/DSC03711.JPG,char_data/O/DSC03711.JPG_4.jpg,952,480,640,28,519,547,385,419,False,25
O,41,kaist_dataset/Mixed/Digital_Camera/(C.S)C-outdoor4/DSC03711.JPG,char_data/O/DSC03711.JPG_5.jpg,1435,480,640,35,546,581,382,423,False,25
O,34,kaist_dataset/Mixed/Digital_Camera/(C.S)C-outdoor4/DSC03716.JPG,char_data/O/DSC03716.JPG_2.jpg,578,480,640,17,271,288,239,273,False,25
O,66,kaist_dataset/Mixed/Digital_Camera/(C.S)C-outdoor4/DSC03756.JPG,char_data/O/DSC03756.JPG_6.jpg,3564,480,640,54,234,288,387,453,False,25
O,65,kaist_dataset/Mixed/Digital_Camera/(C.S)C-outdoor4/DSC03756.JPG,char_data/O/DSC03756.JPG_7.jpg,3380,480,640,52,386,438,383,448,False,25
O,65,kaist_dataset/Mixed/Digital_Camera/(C.S)C-outdoor4/DSC03756.JPG,char_data/O/DSC03756.JPG_8.jpg,3770,480,640,58,436,494,384,449,False,25
O,40,kaist_dataset/Mixed/Digital_Camera/(C.S)C-outdoor4/DSC03764.JPG,char_data/O/DSC03764.JPG_2.jpg,920,480,640,23,159,182,230,270,False,25
O,115,kaist_dataset/Mixed/Digital_Camera/(C.S)C-outdoor5/DSC03819.JPG,char_data/O/DSC03819.JPG_4.jpg,12880,480,640,112,109,221,66,181,False,25
O,43,kaist_dataset/Mixed/Digital_Camera/(C.S)C-outdoor5/DSC03819.JPG,char_data/O/DSC03819.JPG_5.jpg,946,480,640,22,432,454,367,410,False,25
O,90,kaist_dataset/Mixed/Digital_Camera/(C.S)C-outdoor5/DSC03839.JPG,char_data/O/DSC03839.JPG_2.jpg,6930,480,640,77,302,379,199,289,False,25
O,59,kaist_dataset/Mixed/Digital_Camera/(C.S)C-outdoor5/DSC04014.JPG,char_data/O/DSC04014.JPG_2.jpg,2950,480,640,50,351,401,99,158,False,25
O,62,kaist_dataset/Mixed/Digital_Camera/(C.S)C-outdoor5/DSC04060.JPG,char_data/O/DSC04060.JPG_6.jpg,2480,480,640,40,110,150,181,243,False,25
O,54,kaist_dataset/Mixed/Digital_Camera/(C.S)C-outdoor5/DSC04060.JPG,char_data/O/DSC04060.JPG_7.jpg,1998,480,640,37,306,343,100,154,False,25
O,54,kaist_dataset/Mixed/Digital_Camera/(C.S)C-outdoor5/DSC04060.JPG,char_data/O/DSC04060.JPG_8.jpg,1674,480,640,31,535,566,95,149,False,25
O,48,kaist_dataset/Mixed/Digital_Camera/(C.S)C-outdoor5/DSC04098.JPG,char_data/O/DSC04098.JPG_4.jpg,1632,480,640,34,335,369,65,113,False,25
O,46,kaist_dataset/Mixed/Digital_Camera/(C.S)C-outdoor5/DSC04098.JPG,char_data/O/DSC04098.JPG_5.jpg,1840,480,640,40,423,463,75,121,False,25
O,51,kaist_dataset/Mixed/Digital_Camera/(C.S)C-outdoor5/DSC04119.JPG,char_data/O/DSC04119.JPG_2.jpg,1989,480,640,39,543,582,137,188,False,25
O,51,kaist_dataset/Mixed/Digital_Camera/(C.S)C-outdoor5/DSC04129.JPG,char_data/O/DSC04129.JPG_5.jpg,2040,480,640,40,243,283,368,419,False,25
O,43,kaist_dataset/Mixed/Digital_Camera/(C.S)C-outdoor5/DSC04312.JPG,char_data/O/DSC04312.JPG_7.jpg,1161,480,640,27,425,452,105,148,False,25
O,44,kaist_dataset/Mixed/Digital_Camera/(C.S)C-outdoor5/DSC04312.JPG,char_data/O/DSC04312.JPG_8.jpg,1496,480,640,34,449,483,108,152,False,25
O,48,kaist_dataset/Mixed/Digital_Camera/(C.S)C-outdoor5/DSC04338.JPG,char_data/O/DSC04338.JPG_8.jpg,1536,480,640,32,185,217,192,240,False,25
O,43,kaist_dataset/Mixed/Digital_Camera/(C.S)C-outdoor5/DSC04338.JPG,char_data/O/DSC04338.JPG_9.jpg,1462,480,640,34,213,247,196,239,False,25
O,63,kaist_dataset/Mixed/Digital_Camera/(C.S)C-outdoor5/DSC04349.JPG,char_data/O/DSC04349.JPG_2.jpg,3780,480,640,60,323,383,302,365,False,25
O,25,kaist_dataset/Mixed/Digital_Camera/(C.S)C-outdoor5/DSC04360.JPG,char_data/O/DSC04360.JPG_8.jpg,300,480,640,12,79,91,316,341,False,25
O,24,kaist_dataset/Mixed/Digital_Camera/(C.S)C-outdoor5/DSC04360.JPG,char_data/O/DSC04360.JPG_9.jpg,312,480,640,13,91,104,318,342,False,25
O,34,kaist_dataset/Mixed/Digital_Camera/(C.S)C-outdoor5/DSC04360.JPG,char_data/O/DSC04360.JPG_10.jpg,510,480,640,15,102,117,380,414,False,25
O,34,kaist_dataset/Mixed/Digital_Camera/(C.S)C-outdoor5/DSC04360.JPG,char_data/O/DSC04360.JPG_11.jpg,510,480,640,15,117,132,380,414,False,25
O,73,kaist_dataset/Mixed/Digital_Camera/(C.S)C-outdoor5/DSC04368.JPG,char_data/O/DSC04368.JPG_2.jpg,3577,480,640,49,321,370,274,347,False,25
O,78,kaist_dataset/Mixed/Digital_Camera/(C.S)C-outdoor5/DSC04401.JPG,char_data/O/DSC04401.JPG_2.jpg,5460,480,640,70,88,158,1,78,False,25
O,37,kaist_dataset/Mixed/Digital_Camera/(C.S)C-outdoor5/DSC04434.JPG,char_data/O/DSC04434.JPG_2.jpg,999,480,640,27,313,340,390,427,False,25
O,57,kaist_dataset/Mixed/Digital_Camera/(C.S)C-outdoor5/DSC04447.JPG,char_data/O/DSC04447.JPG_2.jpg,2850,480,640,50,444,494,344,401,False,25
O,153,kaist_dataset/Mixed/Digital_Camera/(C.S)C-outdoor5/DSC04451.JPG,char_data/O/DSC04451.JPG_2.jpg,13617,480,640,89,351,440,286,439,False,25
O,115,kaist_dataset/Mixed/Digital_Camera/(C.S)C-outdoor5/DSC04465.JPG,char_data/O/DSC04465.JPG_2.jpg,8050,480,640,70,347,417,278,393,False,25
O,19,kaist_dataset/Mixed/Digital_Camera/(C.S)C-outdoor6/P1010063.JPG,char_data/O/P1010063.JPG_4.jpg,190,480,640,10,440,450,351,370,False,25
O,50,kaist_dataset/Mixed/Digital_Camera/(C.S)C-outdoor6/P1010063.JPG,char_data/O/P1010063.JPG_5.jpg,2050,480,640,41,308,349,334,384,False,25
O,17,kaist_dataset/Mixed/Digital_Camera/(C.S)C-outdoor6/P1010065.JPG,char_data/O/P1010065.JPG_5.jpg,153,480,640,9,71,80,108,125,False,25
O,32,kaist_dataset/Mixed/Digital_Camera/(C.S)C-outdoor6/P1010090.JPG,char_data/O/P1010090.JPG_2.jpg,736,480,640,23,441,464,198,230,False,25
O,19,kaist_dataset/Mixed/Digital_Camera/(C.S)C-outdoor6/P1010114.JPG,char_data/O/P1010114.JPG_2.jpg,323,480,640,17,328,345,222,241,False,25
O,44,kaist_dataset/Mixed/Digital_Camera/(C.S)C-outdoor6/P1010132.JPG,char_data/O/P1010132.JPG_2.jpg,1980,480,640,45,375,420,157,201,False,25
O,46,kaist_dataset/Mixed/Digital_Camera/(C.S)D-indoor1/DSC02713.JPG,char_data/O/DSC02713.JPG_4.jpg,1932,480,640,42,174,216,151,197,False,25
O,43,kaist_dataset/Mixed/Digital_Camera/(C.S)D-indoor1/DSC02713.JPG,char_data/O/DSC02713.JPG_5.jpg,1935,480,640,45,342,387,156,199,False,25
O,122,kaist_dataset/Mixed/Digital_Camera/(C.S)D-indoor1/DSC02739.JPG,char_data/O/DSC02739.JPG_2.jpg,12566,480,640,103,215,318,350,472,False,25
O,110,kaist_dataset/Mixed/Digital_Camera/(C.S)D-indoor1/DSC02840.JPG,char_data/O/DSC02840.JPG_4.jpg,13310,480,640,121,173,294,118,228,False,25
O,120,kaist_dataset/Mixed/Digital_Camera/(C.S)D-indoor1/DSC02840.JPG,char_data/O/DSC02840.JPG_5.jpg,14640,480,640,122,177,299,239,359,False,25
O,41,kaist_dataset/Mixed/Digital_Camera/(C.S)D-indoor1/DSC03372.JPG,char_data/O/DSC03372.JPG_6.jpg,1558,480,640,38,73,111,404,445,False,25
O,36,kaist_dataset/Mixed/Digital_Camera/(C.S)D-indoor1/DSC03372.JPG,char_data/O/DSC03372.JPG_7.jpg,1512,480,640,42,110,152,415,451,False,25
O,39,kaist_dataset/Mixed/Digital_Camera/(C.S)D-indoor1/DSC03372.JPG,char_data/O/DSC03372.JPG_8.jpg,1755,480,640,45,455,500,403,442,False,25
O,103,kaist_dataset/Mixed/Digital_Camera/(C.S)D-indoor1/DSC03890.JPG,char_data/O/DSC03890.JPG_2.jpg,8652,480,640,84,284,368,238,341,False,25
O,57,kaist_dataset/Mixed/Digital_Camera/(C.S)D-indoor1/DSC03959.JPG,char_data/O/DSC03959.JPG_4.jpg,3135,480,640,55,248,303,109,166,False,25
O,22,kaist_dataset/Mixed/Digital_Camera/(C.S)D-indoor1/DSC03959.JPG,char_data/O/DSC03959.JPG_5.jpg,418,480,640,19,279,298,190,212,False,25
O,39,kaist_dataset/Mixed/Digital_Camera/(C.S)D-indoor1/DSC03980.JPG,char_data/O/DSC03980.JPG_8.jpg,975,480,640,25,176,201,135,174,False,25
O,31,kaist_dataset/Mixed/Digital_Camera/(C.S)D-indoor1/DSC03980.JPG,char_data/O/DSC03980.JPG_9.jpg,775,480,640,25,361,386,144,175,False,25
O,38,kaist_dataset/Mixed/Digital_Camera/(C.S)D-indoor1/DSC03980.JPG,char_data/O/DSC03980.JPG_10.jpg,874,480,640,23,460,483,146,184,False,25
O,36,kaist_dataset/Mixed/Digital_Camera/(C.S)D-indoor1/DSC03980.JPG,char_data/O/DSC03980.JPG_11.jpg,720,480,640,20,563,583,150,186,False,25
O,50,kaist_dataset/Mixed/Digital_Camera/(C.S)D-indoor1/DSC04009.JPG,char_data/O/DSC04009.JPG_6.jpg,1800,480,640,36,235,271,399,449,False,25
O,49,kaist_dataset/Mixed/Digital_Camera/(C.S)D-indoor1/DSC04009.JPG,char_data/O/DSC04009.JPG_7.jpg,1764,480,640,36,379,415,399,448,False,25
O,46,kaist_dataset/Mixed/Digital_Camera/(C.S)D-indoor1/DSC04009.JPG,char_data/O/DSC04009.JPG_8.jpg,1380,480,640,30,420,450,403,449,False,25
O,158,kaist_dataset/Mixed/Digital_Camera/(C.S)D-indoor1/DSC04173.JPG,char_data/O/DSC04173.JPG_2.jpg,12324,480,640,78,100,178,314,472,False,25
O,141,kaist_dataset/Mixed/Digital_Camera/(C.S)D-indoor1/DSC04233.JPG,char_data/O/DSC04233.JPG_2.jpg,19881,480,640,141,321,462,16,157,False,25
O,84,kaist_dataset/Mixed/Digital_Camera/(C.S)E-night/DSC02660.JPG,char_data/O/DSC02660.JPG_4.jpg,6132,480,640,73,313,386,216,300,False,25
O,30,kaist_dataset/Mixed/Digital_Camera/(C.S)E-night/DSC02660.JPG,char_data/O/DSC02660.JPG_5.jpg,630,480,640,21,225,246,387,417,False,25
O,58,kaist_dataset/Mixed/Digital_Camera/(C.S)E-night/DSC03517.JPG,char_data/O/DSC03517.JPG_2.jpg,2204,480,640,38,428,466,192,250,False,25
O,36,kaist_dataset/Mixed/Digital_Camera/(C.S)E-night/DSC03871.JPG,char_data/O/DSC03871.JPG_2.jpg,1260,480,640,35,155,190,181,217,False,25
O,51,kaist_dataset/Mixed/Digital_Camera/(C.S)E-night/사진9.jpg수정.jpg,char_data/O/사진9.jpg수정.jpg_2.jpg,2244,480,680,44,169,213,252,303,False,25
O,35,kaist_dataset/Mixed/Digital_Camera/(C.S)F-others/097.jpg,char_data/O/097.jpg_2.jpg,385,480,640,11,312,323,165,200,False,25
O,67,kaist_dataset/Mixed/Digital_Camera/(C.S)F-others/58.JPG,char_data/O/58.JPG_4.jpg,3015,764,499,45,61,106,166,233,False,25
O,58,kaist_dataset/Mixed/Digital_Camera/(C.S)F-others/58.JPG,char_data/O/58.JPG_5.jpg,2610,764,499,45,166,211,179,237,False,25
O,112,kaist_dataset/Mixed/Digital_Camera/(C.S)F-others/DSC02504.JPG,char_data/O/DSC02504.JPG_2.jpg,11536,480,640,103,231,334,187,299,False,25
O,39,kaist_dataset/Mixed/Mobile_Phone/(C.M)C-bookCover/P090831062.jpg,char_data/O/P090831062.jpg_2.jpg,1443,480,640,37,54,91,307,346,False,25
O,56,kaist_dataset/Mixed/Mobile_Phone/(C.M)C-bookCover/P090903092.jpg,char_data/O/P090903092.jpg_2.jpg,2296,480,640,41,487,528,202,258,False,25
n,79,kaist_dataset/English/Digital_Camera/(E.S)A-shadow/DSC03077.JPG,char_data/n/DSC03077.JPG_2.jpg,6557,480,640,83,348,431,353,432,True,40
n,55,kaist_dataset/English/Digital_Camera/(E.S)A-shadow/DSC03079.JPG,char_data/n/DSC03079.JPG_2.jpg,1265,480,640,23,304,327,334,389,True,40
n,53,kaist_dataset/English/Digital_Camera/(E.S)A-shadow/DSC03084.JPG,char_data/n/DSC03084.JPG_4.jpg,1696,480,640,32,238,270,372,425,True,40
n,57,kaist_dataset/English/Digital_Camera/(E.S)A-shadow/DSC03084.JPG,char_data/n/DSC03084.JPG_5.jpg,1653,480,640,29,519,548,369,426,True,40
n,54,kaist_dataset/English/Digital_Camera/(E.S)A-shadow/IMG_2647.JPG,char_data/n/IMG_2647.JPG_2.jpg,2376,480,640,44,400,444,186,240,True,40
n,46,kaist_dataset/English/Digital_Camera/(E.S)A-shadow/P090912074.jpg,char_data/n/P090912074.jpg_2.jpg,1610,480,640,35,573,608,90,136,True,40
n,83,kaist_dataset/English/Digital_Camera/(E.S)B-light/DSC02587.JPG,char_data/n/DSC02587.JPG_2.jpg,4897,480,640,59,540,599,342,425,True,40
n,80,kaist_dataset/English/Digital_Camera/(E.S)B-light/DSC02980.JPG,char_data/n/DSC02980.JPG_2.jpg,5920,480,640,74,440,514,180,260,True,40
n,91,kaist_dataset/English/Digital_Camera/(E.S)B-light/크기변환_%B0%A3%C6%C7_ktimt007.jpg,char_data/n/크기변환_%B0%A3%C6%C7_ktimt007.jpg_2.jpg,5005,480,640,55,202,257,208,299,True,40
n,55,kaist_dataset/English/Digital_Camera/(E.S)C-outdoor1/001.jpg,char_data/n/001.jpg_10.jpg,2860,257,470,52,154,206,100,155,True,40
n,56,kaist_dataset/English/Digital_Camera/(E.S)C-outdoor1/033.jpg,char_data/n/033.jpg_2.jpg,2912,232,354,52,227,279,61,117,True,40
n,35,kaist_dataset/English/Digital_Camera/(E.S)C-outdoor1/036.jpg,char_data/n/036.jpg_2.jpg,1050,197,354,30,83,113,75,110,True,40
n,62,kaist_dataset/English/Digital_Camera/(E.S)C-outdoor1/056.JPG,char_data/n/056.JPG_4.jpg,3534,480,640,57,206,263,176,238,True,40
n,61,kaist_dataset/English/Digital_Camera/(E.S)C-outdoor1/056.JPG,char_data/n/056.JPG_5.jpg,3233,480,640,53,418,471,178,239,True,40
n,33,kaist_dataset/English/Digital_Camera/(E.S)C-outdoor1/077.JPG,char_data/n/077.JPG_2.jpg,1320,480,640,40,324,364,209,242,True,40
n,61,kaist_dataset/English/Digital_Camera/(E.S)C-outdoor1/109.jpg,char_data/n/109.jpg_2.jpg,2074,480,640,34,376,410,182,243,True,40
n,50,kaist_dataset/English/Digital_Camera/(E.S)C-outdoor1/138.JPG,char_data/n/138.JPG_2.jpg,1750,480,640,35,310,345,258,308,True,40
n,160,kaist_dataset/English/Digital_Camera/(E.S)C-outdoor1/2007-12-08-day-015.jpg,char_data/n/2007-12-08-day-015.jpg_6.jpg,35520,1200,1600,222,832,1054,500,660,True,40
n,39,kaist_dataset/English/Digital_Camera/(E.S)C-outdoor1/2007-12-08-day-015.jpg,char_data/n/2007-12-08-day-015.jpg_7.jpg,1209,1200,1600,31,868,899,820,859,True,40
n,37,kaist_dataset/English/Digital_Camera/(E.S)C-outdoor1/2007-12-08-day-015.jpg,char_data/n/2007-12-08-day-015.jpg_8.jpg,1147,1200,1600,31,974,1005,827,864,True,40
n,86,kaist_dataset/English/Digital_Camera/(E.S)C-outdoor1/2007-12-08-day-111.jpg,char_data/n/2007-12-08-day-111.jpg_2.jpg,5848,1200,1600,68,1030,1098,501,587,True,40
n,118,kaist_dataset/English/Digital_Camera/(E.S)C-outdoor1/2007-12-09-day-exterior-056.jpg,char_data/n/2007-12-09-day-exterior-056.jpg_2.jpg,10384,1200,1600,88,955,1043,507,625,True,40
n,78,kaist_dataset/English/Digital_Camera/(E.S)C-outdoor1/7.jpg,char_data/n/7.jpg_2.jpg,4368,574,680,56,393,449,264,342,True,40
n,133,kaist_dataset/English/Digital_Camera/(E.S)C-outdoor1/DSC02354.JPG,char_data/n/DSC02354.JPG_2.jpg,12369,480,640,93,336,429,188,321,True,40
n,34,kaist_dataset/English/Digital_Camera/(E.S)C-outdoor1/DSC02355.JPG,char_data/n/DSC02355.JPG_6.jpg,918,480,640,27,160,187,305,339,True,40
n,84,kaist_dataset/English/Digital_Camera/(E.S)C-outdoor1/DSC02355.JPG,char_data/n/DSC02355.JPG_7.jpg,5628,480,640,67,458,525,286,370,True,40
n,87,kaist_dataset/English/Digital_Camera/(E.S)C-outdoor1/DSC02355.JPG,char_data/n/DSC02355.JPG_8.jpg,6873,480,640,79,527,606,284,371,True,40
n,116,kaist_dataset/English/Digital_Camera/(E.S)C-outdoor1/DSC02415.JPG,char_data/n/DSC02415.JPG_2.jpg,12644,480,640,109,518,627,83,199,True,40
n,40,kaist_dataset/English/Digital_Camera/(E.S)C-outdoor1/DSC02480.JPG,char_data/n/DSC02480.JPG_2.jpg,1280,480,640,32,332,364,403,443,True,40
n,74,kaist_dataset/English/Digital_Camera/(E.S)C-outdoor1/DSC02491.JPG,char_data/n/DSC02491.JPG_6.jpg,3700,480,640,50,199,249,231,305,True,40
n,66,kaist_dataset/English/Digital_Camera/(E.S)C-outdoor1/DSC02491.JPG,char_data/n/DSC02491.JPG_7.jpg,3366,480,640,51,259,310,143,209,True,40
n,64,kaist_dataset/English/Digital_Camera/(E.S)C-outdoor1/DSC02491.JPG,char_data/n/DSC02491.JPG_8.jpg,3328,480,640,52,383,435,62,126,True,40
n,35,kaist_dataset/English/Digital_Camera/(E.S)C-outdoor1/DSC02500.JPG,char_data/n/DSC02500.JPG_16.jpg,1155,480,640,33,428,461,303,338,True,40
n,69,kaist_dataset/English/Digital_Camera/(E.S)C-outdoor1/DSC02524.JPG,char_data/n/DSC02524.JPG_2.jpg,3726,480,640,54,160,214,330,399,True,40
n,38,kaist_dataset/English/Digital_Camera/(E.S)C-outdoor1/DSC02868.JPG,char_data/n/DSC02868.JPG_2.jpg,494,480,640,13,323,336,403,441,True,40
n,38,kaist_dataset/English/Digital_Camera/(E.S)C-outdoor1/DSC02918.JPG,char_data/n/DSC02918.JPG_6.jpg,1178,480,640,31,157,188,233,271,True,40
n,31,kaist_dataset/English/Digital_Camera/(E.S)C-outdoor1/DSC02918.JPG,char_data/n/DSC02918.JPG_7.jpg,1178,480,640,38,519,557,229,260,True,40
n,47,kaist_dataset/English/Digital_Camera/(E.S)C-outdoor2/DSC02998.JPG,char_data/n/DSC02998.JPG_2.jpg,1645,480,640,35,352,387,423,470,True,40
n,52,kaist_dataset/English/Digital_Camera/(E.S)C-outdoor2/DSC03000.JPG,char_data/n/DSC03000.JPG_4.jpg,1976,480,640,38,191,229,291,343,True,40
n,50,kaist_dataset/English/Digital_Camera/(E.S)C-outdoor2/DSC03000.JPG,char_data/n/DSC03000.JPG_5.jpg,2000,480,640,40,227,267,290,340,True,40
n,51,kaist_dataset/English/Digital_Camera/(E.S)C-outdoor2/DSC03001.JPG,char_data/n/DSC03001.JPG_2.jpg,2193,480,640,43,164,207,200,251,True,40
n,39,kaist_dataset/English/Digital_Camera/(E.S)C-outdoor2/DSC03165.JPG,char_data/n/DSC03165.JPG_4.jpg,1365,480,640,35,276,311,245,284,True,40
n,38,kaist_dataset/English/Digital_Camera/(E.S)C-outdoor2/DSC03165.JPG,char_data/n/DSC03165.JPG_5.jpg,1596,480,640,42,387,429,246,284,True,40
n,45,kaist_dataset/English/Digital_Camera/(E.S)C-outdoor2/DSC03170.JPG,char_data/n/DSC03170.JPG_2.jpg,1710,480,640,38,409,447,316,361,True,40
n,46,kaist_dataset/English/Digital_Camera/(E.S)C-outdoor2/DSC03201.JPG,char_data/n/DSC03201.JPG_2.jpg,1840,480,640,40,195,235,140,186,True,40
n,41,kaist_dataset/English/Digital_Camera/(E.S)C-outdoor2/DSC03203.JPG,char_data/n/DSC03203.JPG_4.jpg,1189,480,640,29,149,178,376,417,True,40
n,36,kaist_dataset/English/Digital_Camera/(E.S)C-outdoor2/DSC03225.JPG,char_data/n/DSC03225.JPG_4.jpg,864,480,640,24,333,357,82,118,True,40
n,32,kaist_dataset/English/Digital_Camera/(E.S)C-outdoor2/DSC03225.JPG,char_data/n/DSC03225.JPG_5.jpg,800,480,640,25,504,529,91,123,True,40
n,61,kaist_dataset/English/Digital_Camera/(E.S)C-outdoor2/DSC03229.JPG,char_data/n/DSC03229.JPG_2.jpg,2989,480,640,49,397,446,163,224,True,40
n,47,kaist_dataset/English/Digital_Camera/(E.S)C-outdoor2/DSC03262.JPG,char_data/n/DSC03262.JPG_4.jpg,1457,480,640,31,54,85,129,176,True,40
n,47,kaist_dataset/English/Digital_Camera/(E.S)C-outdoor2/DSC03262.JPG,char_data/n/DSC03262.JPG_5.jpg,1410,480,640,30,314,344,147,194,True,40
n,68,kaist_dataset/English/Digital_Camera/(E.S)C-outdoor2/DSC03281.JPG,char_data/n/DSC03281.JPG_4.jpg,3672,480,640,54,268,322,237,305,True,40
n,98,kaist_dataset/English/Digital_Camera/(E.S)C-outdoor2/DSC03281.JPG,char_data/n/DSC03281.JPG_5.jpg,6370,480,640,65,511,576,207,305,True,40
n,46,kaist_dataset/English/Digital_Camera/(E.S)C-outdoor2/DSC03290.JPG,char_data/n/DSC03290.JPG_4.jpg,1288,480,640,28,255,283,413,459,True,40
n,46,kaist_dataset/English/Digital_Camera/(E.S)C-outdoor2/DSC03290.JPG,char_data/n/DSC03290.JPG_5.jpg,1426,480,640,31,283,314,313,359,True,40
n,65,kaist_dataset/English/Digital_Camera/(E.S)C-outdoor2/DSC03412.JPG,char_data/n/DSC03412.JPG_4.jpg,3055,480,640,47,205,252,148,213,True,40
n,37,kaist_dataset/English/Digital_Camera/(E.S)C-outdoor2/DSC03440.JPG,char_data/n/DSC03440.JPG_2.jpg,1258,480,640,34,245,279,35,72,True,40
n,112,kaist_dataset/English/Digital_Camera/(E.S)C-outdoor2/DSC03663.JPG,char_data/n/DSC03663.JPG_2.jpg,8848,480,640,79,531,610,177,289,True,40
n,60,kaist_dataset/English/Digital_Camera/(E.S)C-outdoor2/DSC03761.JPG,char_data/n/DSC03761.JPG_2.jpg,3240,480,640,54,269,323,351,411,True,40
n,53,kaist_dataset/English/Digital_Camera/(E.S)C-outdoor2/DSC03765.JPG,char_data/n/DSC03765.JPG_2.jpg,2067,480,640,39,256,295,90,143,True,40
n,106,kaist_dataset/English/Digital_Camera/(E.S)C-outdoor2/DSC03786.JPG,char_data/n/DSC03786.JPG_6.jpg,9752,480,640,92,205,297,52,158,True,40
n,100,kaist_dataset/English/Digital_Camera/(E.S)C-outdoor2/DSC03786.JPG,char_data/n/DSC03786.JPG_7.jpg,8900,480,640,89,295,384,50,150,True,40
n,113,kaist_dataset/English/Digital_Camera/(E.S)C-outdoor2/DSC03786.JPG,char_data/n/DSC03786.JPG_8.jpg,10396,480,640,92,171,263,188,301,True,40
n,40,kaist_dataset/English/Digital_Camera/(E.S)C-outdoor2/DSC03865.JPG,char_data/n/DSC03865.JPG_4.jpg,1080,480,640,27,217,244,103,143,True,40
n,38,kaist_dataset/English/Digital_Camera/(E.S)C-outdoor2/DSC03865.JPG,char_data/n/DSC03865.JPG_5.jpg,1064,480,640,28,150,178,61,99,True,40
n,51,kaist_dataset/English/Digital_Camera/(E.S)C-outdoor2/DSC04035.JPG,char_data/n/DSC04035.JPG_4.jpg,1683,480,640,33,159,192,193,244,True,40
n,43,kaist_dataset/English/Digital_Camera/(E.S)C-outdoor2/DSC04035.JPG,char_data/n/DSC04035.JPG_5.jpg,1462,480,640,34,396,430,200,243,True,40
n,53,kaist_dataset/English/Digital_Camera/(E.S)C-outdoor2/DSC04047.JPG,char_data/n/DSC04047.JPG_2.jpg,3127,480,640,59,241,300,234,287,True,40
n,52,kaist_dataset/English/Digital_Camera/(E.S)C-outdoor2/DSC04052.JPG,char_data/n/DSC04052.JPG_2.jpg,1820,480,640,35,345,380,173,225,True,40
n,40,kaist_dataset/English/Digital_Camera/(E.S)C-outdoor2/DSC04064.JPG,char_data/n/DSC04064.JPG_4.jpg,1240,480,640,31,157,188,133,173,True,40
n,46,kaist_dataset/English/Digital_Camera/(E.S)C-outdoor2/DSC04064.JPG,char_data/n/DSC04064.JPG_5.jpg,1380,480,640,30,213,243,131,177,True,40
n,40,kaist_dataset/English/Digital_Camera/(E.S)C-outdoor2/DSC04079.JPG,char_data/n/DSC04079.JPG_8.jpg,1040,480,640,26,144,170,198,238,True,40
n,98,kaist_dataset/English/Digital_Camera/(E.S)C-outdoor2/DSC04397.JPG,char_data/n/DSC04397.JPG_2.jpg,6958,480,640,71,199,270,217,315,True,40
n,99,kaist_dataset/English/Digital_Camera/(E.S)C-outdoor2/DSC04430.JPG,char_data/n/DSC04430.JPG_2.jpg,9801,480,640,99,261,360,298,397,True,40
n,106,kaist_dataset/English/Digital_Camera/(E.S)C-outdoor2/DSC04431.JPG,char_data/n/DSC04431.JPG_2.jpg,9646,480,640,91,289,380,284,390,True,40
n,21,kaist_dataset/English/Digital_Camera/(E.S)C-outdoor2/DSC04437.JPG,char_data/n/DSC04437.JPG_18.jpg,315,480,640,15,365,380,82,103,True,40
n,65,kaist_dataset/English/Digital_Camera/(E.S)C-outdoor2/DSC04437.JPG,char_data/n/DSC04437.JPG_19.jpg,3185,480,640,49,166,215,118,183,True,40
n,64,kaist_dataset/English/Digital_Camera/(E.S)C-outdoor2/DSC04437.JPG,char_data/n/DSC04437.JPG_20.jpg,2880,480,640,45,215,260,118,182,True,40
n,101,kaist_dataset/English/Digital_Camera/(E.S)C-outdoor2/P1010060.JPG,char_data/n/P1010060.JPG_2.jpg,11413,480,640,113,342,455,133,234,True,40
n,24,kaist_dataset/English/Digital_Camera/(E.S)C-outdoor3/P1010123.JPG,char_data/n/P1010123.JPG_8.jpg,312,480,640,13,542,555,71,95,True,40
n,25,kaist_dataset/English/Digital_Camera/(E.S)C-outdoor3/P1010123.JPG,char_data/n/P1010123.JPG_9.jpg,400,480,640,16,561,577,136,161,True,40
n,23,kaist_dataset/English/Digital_Camera/(E.S)C-outdoor3/P1010123.JPG,char_data/n/P1010123.JPG_10.jpg,322,480,640,14,50,64,75,98,True,40
n,25,kaist_dataset/English/Digital_Camera/(E.S)C-outdoor3/P1010123.JPG,char_data/n/P1010123.JPG_11.jpg,525,480,640,21,58,79,145,170,True,40
n,50,kaist_dataset/English/Digital_Camera/(E.S)C-outdoor3/크기변환_%B0%A3%C6%C71_fabdent.jpg,char_data/n/크기변환_%B0%A3%C6%C71_fabdent.jpg_2.jpg,2450,480,640,49,485,534,247,297,True,40
n,19,kaist_dataset/English/Digital_Camera/(E.S)C-outdoor3/크기변환_P1010076.JPG,char_data/n/크기변환_P1010076.JPG_5.jpg,247,480,640,13,208,221,106,125,True,40
n,29,kaist_dataset/English/Digital_Camera/(E.S)D-indoor/080119-0009.jpg,char_data/n/080119-0009.jpg_13.jpg,870,1200,1600,30,861,891,692,721,True,40
n,23,kaist_dataset/English/Digital_Camera/(E.S)D-indoor/080119-0009.jpg,char_data/n/080119-0009.jpg_14.jpg,621,1200,1600,27,1109,1136,700,723,True,40
n,34,kaist_dataset/English/Digital_Camera/(E.S)D-indoor/080119-0009.jpg,char_data/n/080119-0009.jpg_15.jpg,544,1200,1600,16,632,648,1033,1067,True,40
n,35,kaist_dataset/English/Digital_Camera/(E.S)D-indoor/080119-0009.jpg,char_data/n/080119-0009.jpg_16.jpg,700,1200,1600,20,837,857,1079,1114,True,40
n,42,kaist_dataset/English/Digital_Camera/(E.S)D-indoor/080119-0009.jpg,char_data/n/080119-0009.jpg_17.jpg,798,1200,1600,19,909,928,1085,1127,True,40
n,57,kaist_dataset/English/Digital_Camera/(E.S)D-indoor/DSC03074.JPG,char_data/n/DSC03074.JPG_6.jpg,1197,480,640,21,164,185,266,323,True,40
n,68,kaist_dataset/English/Digital_Camera/(E.S)D-indoor/DSC03074.JPG,char_data/n/DSC03074.JPG_7.jpg,1360,480,640,20,333,353,259,327,True,40
n,57,kaist_dataset/English/Digital_Camera/(E.S)D-indoor/DSC03074.JPG,char_data/n/DSC03074.JPG_8.jpg,1140,480,640,20,475,495,261,318,True,40
n,63,kaist_dataset/English/Digital_Camera/(E.S)D-indoor/DSC03076.JPG,char_data/n/DSC03076.JPG_2.jpg,2205,480,640,35,287,322,298,361,True,40
n,47,kaist_dataset/English/Digital_Camera/(E.S)D-indoor/DSC03078.JPG,char_data/n/DSC03078.JPG_2.jpg,1927,480,640,41,444,485,314,361,True,40
n,52,kaist_dataset/English/Digital_Camera/(E.S)D-indoor/DSC03085.JPG,char_data/n/DSC03085.JPG_2.jpg,1456,480,640,28,140,168,378,430,True,40
n,58,kaist_dataset/English/Digital_Camera/(E.S)D-indoor/DSC03087.JPG,char_data/n/DSC03087.JPG_2.jpg,2320,480,640,40,301,341,372,430,True,40
n,33,kaist_dataset/English/Digital_Camera/(E.S)D-indoor/DSC03090.JPG,char_data/n/DSC03090.JPG_2.jpg,693,480,640,21,373,394,247,280,True,40
n,58,kaist_dataset/English/Digital_Camera/(E.S)D-indoor/DSC03136.JPG,char_data/n/DSC03136.JPG_2.jpg,1914,480,640,33,327,360,260,318,True,40
n,32,kaist_dataset/English/Digital_Camera/(E.S)D-indoor/DSC03142.JPG,char_data/n/DSC03142.JPG_4.jpg,992,480,640,31,375,406,433,465,True,40
n,32,kaist_dataset/English/Digital_Camera/(E.S)D-indoor/DSC03142.JPG,char_data/n/DSC03142.JPG_5.jpg,736,480,640,23,418,441,370,402,True,40
n,29,kaist_dataset/English/Digital_Camera/(E.S)D-indoor/DSC03144.JPG,char_data/n/DSC03144.JPG_10.jpg,696,480,640,24,184,208,242,271,True,40
n,34,kaist_dataset/English/Digital_Camera/(E.S)D-indoor/DSC03144.JPG,char_data/n/DSC03144.JPG_11.jpg,816,480,640,24,325,349,239,273,True,40
n,33,kaist_dataset/English/Digital_Camera/(E.S)D-indoor/DSC03144.JPG,char_data/n/DSC03144.JPG_12.jpg,726,480,640,22,181,203,290,323,True,40
n,30,kaist_dataset/English/Digital_Camera/(E.S)D-indoor/DSC03144.JPG,char_data/n/DSC03144.JPG_13.jpg,750,480,640,25,322,347,292,322,True,40
n,31,kaist_dataset/English/Digital_Camera/(E.S)D-indoor/DSC03144.JPG,char_data/n/DSC03144.JPG_14.jpg,744,480,640,24,368,392,290,321,True,40
n,29,kaist_dataset/English/Digital_Camera/(E.S)D-indoor/DSC03145.JPG,char_data/n/DSC03145.JPG_2.jpg,667,480,640,23,260,283,181,210,True,40
n,30,kaist_dataset/English/Digital_Camera/(E.S)D-indoor/DSC03146.JPG,char_data/n/DSC03146.JPG_6.jpg,750,480,640,25,399,424,237,267,True,40
n,32,kaist_dataset/English/Digital_Camera/(E.S)D-indoor/DSC03146.JPG,char_data/n/DSC03146.JPG_7.jpg,768,480,640,24,356,380,177,209,True,40
n,33,kaist_dataset/English/Digital_Camera/(E.S)D-indoor/DSC03146.JPG,char_data/n/DSC03146.JPG_8.jpg,858,480,640,26,460,486,183,216,True,40
n,33,kaist_dataset/English/Digital_Camera/(E.S)D-indoor/DSC03147.JPG,char_data/n/DSC03147.JPG_10.jpg,792,480,640,24,234,258,299,332,True,40
n,29,kaist_dataset/English/Digital_Camera/(E.S)D-indoor/DSC03147.JPG,char_data/n/DSC03147.JPG_11.jpg,696,480,640,24,332,356,299,328,True,40
n,29,kaist_dataset/English/Digital_Camera/(E.S)D-indoor/DSC03147.JPG,char_data/n/DSC03147.JPG_12.jpg,667,480,640,23,383,406,298,327,True,40
n,31,kaist_dataset/English/Digital_Camera/(E.S)D-indoor/DSC03147.JPG,char_data/n/DSC03147.JPG_13.jpg,806,480,640,26,237,263,243,274,True,40
n,31,kaist_dataset/English/Digital_Camera/(E.S)D-indoor/DSC03147.JPG,char_data/n/DSC03147.JPG_14.jpg,775,480,640,25,337,362,240,271,True,40
n,42,kaist_dataset/English/Digital_Camera/(E.S)D-indoor/DSC03149.JPG,char_data/n/DSC03149.JPG_2.jpg,1386,480,640,33,171,204,388,430,True,40
n,45,kaist_dataset/English/Digital_Camera/(E.S)D-indoor/DSC03150.JPG,char_data/n/DSC03150.JPG_2.jpg,1890,480,640,42,225,267,35,80,True,40
n,39,kaist_dataset/English/Digital_Camera/(E.S)D-indoor/DSC03151.JPG,char_data/n/DSC03151.JPG_4.jpg,1365,480,640,35,241,276,113,152,True,40
n,44,kaist_dataset/English/Digital_Camera/(E.S)D-indoor/DSC03151.JPG,char_data/n/DSC03151.JPG_5.jpg,1672,480,640,38,524,562,110,154,True,40
n,42,kaist_dataset/English/Digital_Camera/(E.S)D-indoor/DSC03345.JPG,char_data/n/DSC03345.JPG_4.jpg,1722,480,640,41,276,317,107,149,True,40
n,40,kaist_dataset/English/Digital_Camera/(E.S)D-indoor/DSC03345.JPG,char_data/n/DSC03345.JPG_5.jpg,1280,480,640,32,530,562,104,144,True,40
n,47,kaist_dataset/English/Digital_Camera/(E.S)D-indoor/DSC03376.JPG,char_data/n/DSC03376.JPG_2.jpg,1786,480,640,38,358,396,401,448,True,40
n,42,kaist_dataset/English/Digital_Camera/(E.S)D-indoor/DSC03532.JPG,char_data/n/DSC03532.JPG_15.jpg,1512,480,640,36,240,276,435,477,True,40
n,38,kaist_dataset/English/Digital_Camera/(E.S)D-indoor/DSC03532.JPG,char_data/n/DSC03532.JPG_16.jpg,1482,480,640,39,397,436,435,473,True,40
n,26,kaist_dataset/English/Digital_Camera/(E.S)D-indoor/DSC03532.JPG,char_data/n/DSC03532.JPG_17.jpg,416,480,640,16,35,51,377,403,True,40
n,27,kaist_dataset/English/Digital_Camera/(E.S)D-indoor/DSC03532.JPG,char_data/n/DSC03532.JPG_18.jpg,594,480,640,22,172,194,384,411,True,40
n,24,kaist_dataset/English/Digital_Camera/(E.S)D-indoor/DSC03532.JPG,char_data/n/DSC03532.JPG_19.jpg,408,480,640,17,323,340,387,411,True,40
n,28,kaist_dataset/English/Digital_Camera/(E.S)D-indoor/DSC03532.JPG,char_data/n/DSC03532.JPG_20.jpg,364,480,640,13,591,604,376,404,True,40
n,47,kaist_dataset/English/Digital_Camera/(E.S)D-indoor/DSC03936.JPG,char_data/n/DSC03936.JPG_2.jpg,1692,480,640,36,396,432,90,137,True,40
n,28,kaist_dataset/English/Digital_Camera/(E.S)D-indoor/DSC04023.JPG,char_data/n/DSC04023.JPG_2.jpg,756,480,640,27,266,293,320,348,True,40
n,43,kaist_dataset/English/Digital_Camera/(E.S)D-indoor/크기변환_%B0%A3%C6%C76_fabdent.jpg,char_data/n/크기변환_%B0%A3%C6%C76_fabdent.jpg_2.jpg,1118,480,640,26,220,246,194,237,True,40
n,73,kaist_dataset/English/Digital_Camera/(E.S)E-night/DSC02570.JPG,char_data/n/DSC02570.JPG_2.jpg,4380,480,640,60,203,263,252,325,True,40
n,100,kaist_dataset/English/Digital_Camera/(E.S)E-night/DSC02604.JPG,char_data/n/DSC02604.JPG_2.jpg,11100,480,640,111,464,575,236,336,True,40
n,38,kaist_dataset/English/Digital_Camera/(E.S)E-night/DSC02610.JPG,char_data/n/DSC02610.JPG_2.jpg,1140,480,640,30,76,106,276,314,True,40
n,99,kaist_dataset/English/Digital_Camera/(E.S)E-night/DSC02981.JPG,char_data/n/DSC02981.JPG_2.jpg,6336,480,640,64,320,384,195,294,True,40
n,66,kaist_dataset/English/Digital_Camera/(E.S)E-night/크기변환_P1010163.JPG,char_data/n/크기변환_P1010163.JPG_4.jpg,4752,480,640,72,103,175,105,171,True,40
n,83,kaist_dataset/English/Digital_Camera/(E.S)E-night/크기변환_P1010163.JPG,char_data/n/크기변환_P1010163.JPG_5.jpg,6225,480,640,75,393,468,99,182,True,40
n,138,kaist_dataset/English/Digital_Camera/(E.S)F-others/080116-0060.jpg,char_data/n/080116-0060.jpg_2.jpg,12420,1200,1600,90,1387,1477,368,506,True,40
n,51,kaist_dataset/English/Digital_Camera/(E.S)F-others/080119-0007.jpg,char_data/n/080119-0007.jpg_10.jpg,2295,1200,1600,45,1013,1058,787,838,True,40
n,60,kaist_dataset/English/Digital_Camera/(E.S)F-others/080119-0007.jpg,char_data/n/080119-0007.jpg_12.jpg,2580,1200,1600,43,19,62,732,792,True,40
n,37,kaist_dataset/English/Digital_Camera/(E.S)F-others/080119-0007.jpg,char_data/n/080119-0007.jpg_13.jpg,814,1200,1600,22,943,965,877,914,True,40
n,51,kaist_dataset/English/Digital_Camera/(E.S)F-others/080119-0007.jpg,char_data/n/080119-0007.jpg_14.jpg,2040,1200,1600,40,756,796,779,830,True,40
n,83,kaist_dataset/English/Digital_Camera/(E.S)F-others/크기변환_%B0%A3%C6%C72_ktimt007.jpg,char_data/n/크기변환_%B0%A3%C6%C72_ktimt007.jpg_4.jpg,4316,480,640,52,186,238,239,322,True,40
n,95,kaist_dataset/English/Digital_Camera/(E.S)F-others/크기변환_%B0%A3%C6%C72_ktimt007.jpg,char_data/n/크기변환_%B0%A3%C6%C72_ktimt007.jpg_5.jpg,9405,480,640,99,508,607,189,284,True,40
n,26,kaist_dataset/English/Digital_Camera/(E.S)F-others/크기변환_%C4%BF%C7%C7%B5%B9%C3%E2%B0%A3%C6%C7_%281%29_alto99kr.jpg,char_data/n/크기변환_%C4%BF%C7%C7%B5%B9%C3%E2%B0%A3%C6%C7_%281%29_alto99kr.jpg_2.jpg,754,480,640,29,459,488,204,230,True,40
n,106,kaist_dataset/English/Mobile_Phone/(E.M)A-outdoor/P090911070.jpg,char_data/n/P090911070.jpg_4.jpg,11978,480,640,113,21,134,159,265,True,40
n,108,kaist_dataset/English/Mobile_Phone/(E.M)A-outdoor/P090911070.jpg,char_data/n/P090911070.jpg_5.jpg,13392,480,640,124,448,572,168,276,True,40
n,50,kaist_dataset/English/Mobile_Phone/(E.M)A-outdoor/P090911071.jpg,char_data/n/P090911071.jpg_2.jpg,1400,480,640,28,415,443,134,184,True,40
n,45,kaist_dataset/English/Mobile_Phone/(E.M)B-indoor/P090902018.jpg,char_data/n/P090902018.jpg_5.jpg,2250,480,640,50,576,626,204,249,True,40
n,79,kaist_dataset/English/Mobile_Phone/(E.M)B-indoor/P090903004.jpg,char_data/n/P090903004.jpg_2.jpg,7031,480,640,89,66,155,255,334,True,40
n,57,kaist_dataset/English/Mobile_Phone/(E.M)B-indoor/P090903008.jpg,char_data/n/P090903008.jpg_2.jpg,3021,480,640,53,294,347,36,93,True,40
n,63,kaist_dataset/English/Mobile_Phone/(E.M)B-indoor/P090911067.jpg,char_data/n/P090911067.jpg_2.jpg,1701,480,640,27,406,433,225,288,True,40
n,140,kaist_dataset/English/Mobile_Phone/(E.M)B-indoor/P090911075.jpg,char_data/n/P090911075.jpg_2.jpg,16940,480,640,121,482,603,243,383,True,40
n,64,kaist_dataset/English/Mobile_Phone/(E.M)B-indoor/P090911080.jpg,char_data/n/P090911080.jpg_2.jpg,2752,480,640,43,371,414,237,301,True,40
n,65,kaist_dataset/English/Mobile_Phone/(E.M)B-indoor/P090911081.jpg,char_data/n/P090911081.jpg_2.jpg,3185,480,640,49,397,446,214,279,True,40
n,44,kaist_dataset/English/Mobile_Phone/(E.M)B-indoor/P090911084.jpg,char_data/n/P090911084.jpg_4.jpg,1188,480,640,27,319,346,162,206,True,40
n,46,kaist_dataset/English/Mobile_Phone/(E.M)B-indoor/P090911084.jpg,char_data/n/P090911084.jpg_5.jpg,1426,480,640,31,494,525,157,203,True,40
n,81,kaist_dataset/English/Mobile_Phone/(E.M)C-bookCover/P090831039.jpg,char_data/n/P090831039.jpg_8.jpg,4860,480,640,60,54,114,122,203,True,40
n,72,kaist_dataset/English/Mobile_Phone/(E.M)C-bookCover/P090831039.jpg,char_data/n/P090831039.jpg_9.jpg,4392,480,640,61,225,286,130,202,True,40
n,66,kaist_dataset/English/Mobile_Phone/(E.M)C-bookCover/P090831039.jpg,char_data/n/P090831039.jpg_10.jpg,4422,480,640,67,418,485,128,194,True,40
n,74,kaist_dataset/English/Mobile_Phone/(E.M)C-bookCover/P090831039.jpg,char_data/n/P090831039.jpg_11.jpg,4810,480,640,65,287,352,236,310,True,40
n,91,kaist_dataset/English/Mobile_Phone/(E.M)C-bookCover/P090831077.jpg,char_data/n/P090831077.jpg_4.jpg,8463,480,640,93,216,309,281,372,True,40
n,105,kaist_dataset/English/Mobile_Phone/(E.M)C-bookCover/P090831077.jpg,char_data/n/P090831077.jpg_5.jpg,9345,480,640,89,421,510,273,378,True,40
n,36,kaist_dataset/English/Mobile_Phone/(E.M)C-bookCover/P090903030.jpg,char_data/n/P090903030.jpg_4.jpg,828,480,640,23,253,276,76,112,True,40
n,39,kaist_dataset/English/Mobile_Phone/(E.M)C-bookCover/P090903030.jpg,char_data/n/P090903030.jpg_5.jpg,858,480,640,22,371,393,78,117,True,40
n,83,kaist_dataset/English/Mobile_Phone/(E.M)C-bookCover/P090903054.jpg,char_data/n/P090903054.jpg_4.jpg,6059,480,640,73,170,243,228,311,True,40
n,22,kaist_dataset/Korean/Digital_Camera/A-shadow/2007-12-09-day-exterior-031.jpg,char_data/n/2007-12-09-day-exterior-031.jpg_4.jpg,484,1200,1600,22,396,418,623,645,True,40
n,24,kaist_dataset/Korean/Digital_Camera/A-shadow/2007-12-09-day-exterior-031.jpg,char_data/n/2007-12-09-day-exterior-031.jpg_5.jpg,432,1200,1600,18,563,581,616,640,True,40
n,29,kaist_dataset/Korean/Digital_Camera/G-others/080119-0005.jpg,char_data/n/080119-0005.jpg_2.jpg,754,1600,1200,26,760,786,622,651,True,40
n,41,kaist_dataset/Korean/Digital_Camera/G-others/2007-12-08-day-112.jpg,char_data/n/2007-12-08-day-112.jpg_2.jpg,820,1200,1600,20,696,716,577,618,True,40
n,22,kaist_dataset/Korean/Digital_Camera/indoor1/080119-0029.jpg,char_data/n/080119-0029.jpg_4.jpg,286,1200,1600,13,707,720,656,678,True,40
n,21,kaist_dataset/Korean/Digital_Camera/indoor1/080119-0029.jpg,char_data/n/080119-0029.jpg_5.jpg,273,1200,1600,13,780,793,658,679,True,40
n,21,kaist_dataset/Korean/Digital_Camera/indoor1/145.JPG,char_data/n/145.JPG_2.jpg,294,480,640,14,255,269,306,327,True,40
n,25,kaist_dataset/Korean/Digital_Camera/outdoor1/001.JPG,char_data/n/001.JPG_11.jpg,375,480,640,15,325,340,241,266,True,40
n,15,kaist_dataset/Korean/Digital_Camera/outdoor1/001.JPG,char_data/n/001.JPG_12.jpg,150,480,640,10,230,240,245,260,True,40
n,13,kaist_dataset/Korean/Digital_Camera/outdoor1/001.JPG,char_data/n/001.JPG_13.jpg,130,480,640,10,388,398,245,258,True,40
n,19,kaist_dataset/Korean/Digital_Camera/outdoor1/001.JPG,char_data/n/001.JPG_14.jpg,152,480,640,8,530,538,240,259,True,40
n,65,kaist_dataset/Korean/Digital_Camera/outdoor2/2007-12-08-day-101.jpg,char_data/n/2007-12-08-day-101.jpg_4.jpg,3120,1200,1600,48,669,717,383,448,True,40
n,25,kaist_dataset/Mixed/Digital_Camera/(C.S)A-shadow/DSC02624.JPG,char_data/n/DSC02624.JPG_8.jpg,425,480,640,17,158,175,402,427,True,40
n,25,kaist_dataset/Mixed/Digital_Camera/(C.S)A-shadow/DSC02624.JPG,char_data/n/DSC02624.JPG_9.jpg,375,480,640,15,212,227,403,428,True,40
n,56,kaist_dataset/Mixed/Digital_Camera/(C.S)A-shadow/DSC03207.JPG,char_data/n/DSC03207.JPG_2.jpg,2184,480,640,39,481,520,206,262,True,40
n,38,kaist_dataset/Mixed/Digital_Camera/(C.S)B-light/134.JPG,char_data/n/134.JPG_2.jpg,1292,480,640,34,433,467,291,329,True,40
n,89,kaist_dataset/Mixed/Digital_Camera/(C.S)B-light/DSC04404.JPG,char_data/n/DSC04404.JPG_2.jpg,8188,480,640,92,310,402,228,317,True,40
n,20,kaist_dataset/Mixed/Digital_Camera/(C.S)C-outdoor1/003.JPG,char_data/n/003.JPG_12.jpg,220,480,640,11,328,339,261,281,True,40
n,23,kaist_dataset/Mixed/Digital_Camera/(C.S)C-outdoor1/003.JPG,char_data/n/003.JPG_13.jpg,276,480,640,12,396,408,253,276,True,40
n,18,kaist_dataset/Mixed/Digital_Camera/(C.S)C-outdoor1/003.JPG,char_data/n/003.JPG_14.jpg,180,480,640,10,470,480,255,273,True,40
n,18,kaist_dataset/Mixed/Digital_Camera/(C.S)C-outdoor1/003.JPG,char_data/n/003.JPG_15.jpg,288,480,640,16,557,573,252,270,True,40
n,23,kaist_dataset/Mixed/Digital_Camera/(C.S)C-outdoor1/003.JPG,char_data/n/003.JPG_16.jpg,184,480,640,8,139,147,266,289,True,40
n,20,kaist_dataset/Mixed/Digital_Camera/(C.S)C-outdoor1/003.JPG,char_data/n/003.JPG_17.jpg,240,480,640,12,278,290,263,283,True,40
n,67,kaist_dataset/Mixed/Digital_Camera/(C.S)C-outdoor1/014.JPG,char_data/n/014.JPG_2.jpg,2010,480,640,30,107,137,195,262,True,40
n,23,kaist_dataset/Mixed/Digital_Camera/(C.S)C-outdoor1/080.JPG,char_data/n/080.JPG_7.jpg,805,480,640,35,183,218,85,108,True,40
n,35,kaist_dataset/Mixed/Digital_Camera/(C.S)C-outdoor1/080.JPG,char_data/n/080.JPG_8.jpg,1085,480,640,31,169,200,114,149,True,40
n,30,kaist_dataset/Mixed/Digital_Camera/(C.S)C-outdoor1/086.JPG,char_data/n/086.JPG_7.jpg,390,480,640,13,235,248,336,366,True,40
n,25,kaist_dataset/Mixed/Digital_Camera/(C.S)C-outdoor1/086.JPG,char_data/n/086.JPG_8.jpg,400,480,640,16,320,336,338,363,True,40
n,24,kaist_dataset/Mixed/Digital_Camera/(C.S)C-outdoor1/115.JPG,char_data/n/115.JPG_2.jpg,480,480,640,20,270,290,283,307,True,40
n,41,kaist_dataset/Mixed/Digital_Camera/(C.S)C-outdoor1/133.JPG,char_data/n/133.JPG_4.jpg,820,480,640,20,564,584,339,380,True,40
n,43,kaist_dataset/Mixed/Digital_Camera/(C.S)C-outdoor1/133.JPG,char_data/n/133.JPG_5.jpg,989,480,640,23,583,606,338,381,True,40
n,26,kaist_dataset/Mixed/Digital_Camera/(C.S)C-outdoor1/2.JPG,char_data/n/2.JPG_7.jpg,208,576,768,8,77,85,382,408,True,40
n,68,kaist_dataset/Mixed/Digital_Camera/(C.S)C-outdoor1/2007-12-08-day-118.jpg,char_data/n/2007-12-08-day-118.jpg_2.jpg,3468,1200,1600,51,1319,1370,412,480,True,40
n,56,kaist_dataset/Mixed/Digital_Camera/(C.S)C-outdoor1/2007-12-09-day-exterior-044.jpg,char_data/n/2007-12-09-day-exterior-044.jpg_2.jpg,2912,1200,1600,52,825,877,834,890,True,40
n,60,kaist_dataset/Mixed/Digital_Camera/(C.S)C-outdoor1/8.jpg,char_data/n/8.jpg_2.jpg,3420,400,766,57,303,360,171,231,True,40
n,21,kaist_dataset/Mixed/Digital_Camera/(C.S)C-outdoor1/DSC02242.JPG,char_data/n/DSC02242.JPG_2.jpg,231,480,640,11,255,266,174,195,True,40
n,35,kaist_dataset/Mixed/Digital_Camera/(C.S)C-outdoor1/DSC02325.JPG,char_data/n/DSC02325.JPG_5.jpg,595,480,640,17,262,279,319,354,True,40
n,59,kaist_dataset/Mixed/Digital_Camera/(C.S)C-outdoor1/DSC02344.JPG,char_data/n/DSC02344.JPG_2.jpg,2950,480,640,50,182,232,162,221,True,40
n,23,kaist_dataset/Mixed/Digital_Camera/(C.S)C-outdoor2/DSC02385.JPG,char_data/n/DSC02385.JPG_8.jpg,345,480,640,15,461,476,147,170,True,40
n,47,kaist_dataset/Mixed/Digital_Camera/(C.S)C-outdoor2/DSC02407.JPG,char_data/n/DSC02407.JPG_2.jpg,1457,480,640,31,248,279,179,226,True,40
n,55,kaist_dataset/Mixed/Digital_Camera/(C.S)C-outdoor2/DSC02416.JPG,char_data/n/DSC02416.JPG_2.jpg,3025,480,640,55,433,488,207,262,True,40
n,24,kaist_dataset/Mixed/Digital_Camera/(C.S)C-outdoor2/DSC02421.JPG,char_data/n/DSC02421.JPG_4.jpg,600,480,640,25,225,250,212,236,True,40
n,22,kaist_dataset/Mixed/Digital_Camera/(C.S)C-outdoor2/DSC02421.JPG,char_data/n/DSC02421.JPG_5.jpg,572,480,640,26,320,346,213,235,True,40
n,71,kaist_dataset/Mixed/Digital_Camera/(C.S)C-outdoor2/DSC02425.JPG,char_data/n/DSC02425.JPG_2.jpg,4615,480,640,65,383,448,166,237,True,40
n,62,kaist_dataset/Mixed/Digital_Camera/(C.S)C-outdoor2/DSC02433.JPG,char_data/n/DSC02433.JPG_2.jpg,2604,480,640,42,112,154,188,250,True,40
n,72,kaist_dataset/Mixed/Digital_Camera/(C.S)C-outdoor2/DSC02434.JPG,char_data/n/DSC02434.JPG_2.jpg,4680,480,640,65,571,636,204,276,True,40
n,69,kaist_dataset/Mixed/Digital_Camera/(C.S)C-outdoor2/DSC02436.JPG,char_data/n/DSC02436.JPG_2.jpg,2277,480,640,33,437,470,186,255,True,40
n,21,kaist_dataset/Mixed/Digital_Camera/(C.S)C-outdoor2/DSC02439.JPG,char_data/n/DSC02439.JPG_8.jpg,357,480,640,17,401,418,113,134,True,40
n,25,kaist_dataset/Mixed/Digital_Camera/(C.S)C-outdoor2/DSC02483.JPG,char_data/n/DSC02483.JPG_2.jpg,350,480,640,14,297,311,154,179,True,40
n,30,kaist_dataset/Mixed/Digital_Camera/(C.S)C-outdoor2/DSC02511.JPG,char_data/n/DSC02511.JPG_2.jpg,690,480,640,23,231,254,213,243,True,40
n,41,kaist_dataset/Mixed/Digital_Camera/(C.S)C-outdoor2/DSC02532.JPG,char_data/n/DSC02532.JPG_2.jpg,779,480,640,19,450,469,83,124,True,40
n,26,kaist_dataset/Mixed/Digital_Camera/(C.S)C-outdoor2/DSC02545.JPG,char_data/n/DSC02545.JPG_2.jpg,624,480,640,24,519,543,365,391,True,40
n,25,kaist_dataset/Mixed/Digital_Camera/(C.S)C-outdoor2/DSC02624.JPG,char_data/n/DSC02624.JPG_10.jpg,425,480,640,17,158,175,402,427,True,40
n,25,kaist_dataset/Mixed/Digital_Camera/(C.S)C-outdoor2/DSC02624.JPG,char_data/n/DSC02624.JPG_11.jpg,375,480,640,15,212,227,403,428,True,40
n,43,kaist_dataset/Mixed/Digital_Camera/(C.S)C-outdoor2/DSC02869.JPG,char_data/n/DSC02869.JPG_4.jpg,860,480,640,20,203,223,140,183,True,40
n,42,kaist_dataset/Mixed/Digital_Camera/(C.S)C-outdoor2/DSC02869.JPG,char_data/n/DSC02869.JPG_5.jpg,798,480,640,19,287,306,143,185,True,40
n,28,kaist_dataset/Mixed/Digital_Camera/(C.S)C-outdoor2/DSC02886.JPG,char_data/n/DSC02886.JPG_2.jpg,672,480,640,24,318,342,145,173,True,40
n,29,kaist_dataset/Mixed/Digital_Camera/(C.S)C-outdoor2/DSC02912.JPG,char_data/n/DSC02912.JPG_2.jpg,493,480,640,17,256,273,14,43,True,40
n,116,kaist_dataset/Mixed/Digital_Camera/(C.S)C-outdoor2/DSC02919.JPG,char_data/n/DSC02919.JPG_2.jpg,15776,480,640,136,501,637,348,464,True,40
n,54,kaist_dataset/Mixed/Digital_Camera/(C.S)C-outdoor2/DSC02936.JPG,char_data/n/DSC02936.JPG_4.jpg,2538,480,640,47,440,487,138,192,True,40
n,31,kaist_dataset/Mixed/Digital_Camera/(C.S)C-outdoor2/DSC02936.JPG,char_data/n/DSC02936.JPG_5.jpg,620,480,640,20,164,184,81,112,True,40
n,38,kaist_dataset/Mixed/Digital_Camera/(C.S)C-outdoor3/DSC02978.JPG,char_data/n/DSC02978.JPG_4.jpg,760,480,640,20,298,318,165,203,True,40
n,31,kaist_dataset/Mixed/Digital_Camera/(C.S)C-outdoor3/DSC02978.JPG,char_data/n/DSC02978.JPG_5.jpg,682,480,640,22,340,362,173,204,True,40
n,49,kaist_dataset/Mixed/Digital_Camera/(C.S)C-outdoor3/DSC02989.JPG,char_data/n/DSC02989.JPG_2.jpg,1813,480,640,37,596,633,207,256,True,40
n,75,kaist_dataset/Mixed/Digital_Camera/(C.S)C-outdoor3/DSC03017.JPG,char_data/n/DSC03017.JPG_2.jpg,7500,480,640,100,481,581,163,238,True,40
n,57,kaist_dataset/Mixed/Digital_Camera/(C.S)C-outdoor3/DSC03047.JPG,char_data/n/DSC03047.JPG_6.jpg,1653,480,640,29,220,249,198,255,True,40
n,63,kaist_dataset/Mixed/Digital_Camera/(C.S)C-outdoor3/DSC03047.JPG,char_data/n/DSC03047.JPG_7.jpg,2079,480,640,33,330,363,196,259,True,40
n,59,kaist_dataset/Mixed/Digital_Camera/(C.S)C-outdoor3/DSC03047.JPG,char_data/n/DSC03047.JPG_8.jpg,1593,480,640,27,453,480,195,254,True,40
n,44,kaist_dataset/Mixed/Digital_Camera/(C.S)C-outdoor3/DSC03063.JPG,char_data/n/DSC03063.JPG_4.jpg,1144,480,640,26,235,261,285,329,True,40
n,46,kaist_dataset/Mixed/Digital_Camera/(C.S)C-outdoor3/DSC03063.JPG,char_data/n/DSC03063.JPG_5.jpg,966,480,640,21,314,335,290,336,True,40
n,37,kaist_dataset/Mixed/Digital_Camera/(C.S)C-outdoor3/DSC03177.JPG,char_data/n/DSC03177.JPG_2.jpg,1073,480,640,29,361,390,150,187,True,40
n,34,kaist_dataset/Mixed/Digital_Camera/(C.S)C-outdoor3/DSC03209.JPG,char_data/n/DSC03209.JPG_2.jpg,850,480,640,25,467,492,415,449,True,40
n,29,kaist_dataset/Mixed/Digital_Camera/(C.S)C-outdoor3/DSC03227.JPG,char_data/n/DSC03227.JPG_2.jpg,406,480,640,14,198,212,107,136,True,40
n,27,kaist_dataset/Mixed/Digital_Camera/(C.S)C-outdoor3/DSC03271.JPG,char_data/n/DSC03271.JPG_2.jpg,621,480,640,23,311,334,83,110,True,40
n,74,kaist_dataset/Mixed/Digital_Camera/(C.S)C-outdoor3/DSC03299.JPG,char_data/n/DSC03299.JPG_2.jpg,5106,480,640,69,507,576,387,461,True,40
n,122,kaist_dataset/Mixed/Digital_Camera/(C.S)C-outdoor3/DSC03421.JPG,char_data/n/DSC03421.JPG_2.jpg,8174,480,640,67,392,459,69,191,True,40
n,36,kaist_dataset/Mixed/Digital_Camera/(C.S)C-outdoor4/DSC03556.JPG,char_data/n/DSC03556.JPG_8.jpg,396,480,640,11,171,182,317,353,True,40
n,32,kaist_dataset/Mixed/Digital_Camera/(C.S)C-outdoor4/DSC03556.JPG,char_data/n/DSC03556.JPG_9.jpg,384,480,640,12,180,192,319,351,True,40
n,27,kaist_dataset/Mixed/Digital_Camera/(C.S)C-outdoor4/DSC03556.JPG,char_data/n/DSC03556.JPG_10.jpg,270,480,640,10,230,240,324,351,True,40
n,30,kaist_dataset/Mixed/Digital_Camera/(C.S)C-outdoor4/DSC03556.JPG,char_data/n/DSC03556.JPG_11.jpg,360,480,640,12,541,553,323,353,True,40
n,73,kaist_dataset/Mixed/Digital_Camera/(C.S)C-outdoor4/DSC03572.JPG,char_data/n/DSC03572.JPG_2.jpg,4672,480,640,64,460,524,129,202,True,40
n,38,kaist_dataset/Mixed/Digital_Camera/(C.S)C-outdoor4/DSC03586.JPG,char_data/n/DSC03586.JPG_6.jpg,722,480,640,19,172,191,155,193,True,40
n,36,kaist_dataset/Mixed/Digital_Camera/(C.S)C-outdoor4/DSC03586.JPG,char_data/n/DSC03586.JPG_7.jpg,792,480,640,22,191,213,156,192,True,40
n,34,kaist_dataset/Mixed/Digital_Camera/(C.S)C-outdoor4/DSC03586.JPG,char_data/n/DSC03586.JPG_8.jpg,680,480,640,20,281,301,160,194,True,40
n,77,kaist_dataset/Mixed/Digital_Camera/(C.S)C-outdoor4/DSC03630.JPG,char_data/n/DSC03630.JPG_2.jpg,3696,480,640,48,367,415,351,428,True,40
n,39,kaist_dataset/Mixed/Digital_Camera/(C.S)C-outdoor4/DSC03642.JPG,char_data/n/DSC03642.JPG_4.jpg,1014,480,640,26,351,377,252,291,True,40
n,41,kaist_dataset/Mixed/Digital_Camera/(C.S)C-outdoor4/DSC03642.JPG,char_data/n/DSC03642.JPG_5.jpg,1066,480,640,26,488,514,244,285,True,40
n,54,kaist_dataset/Mixed/Digital_Camera/(C.S)C-outdoor4/DSC03643.JPG,char_data/n/DSC03643.JPG_4.jpg,2052,480,640,38,326,364,270,324,True,40
n,46,kaist_dataset/Mixed/Digital_Camera/(C.S)C-outdoor4/DSC03643.JPG,char_data/n/DSC03643.JPG_5.jpg,1564,480,640,34,470,504,276,322,True,40
n,23,kaist_dataset/Mixed/Digital_Camera/(C.S)C-outdoor4/DSC03670.JPG,char_data/n/DSC03670.JPG_6.jpg,322,480,640,14,269,283,322,345,True,40
n,24,kaist_dataset/Mixed/Digital_Camera/(C.S)C-outdoor4/DSC03670.JPG,char_data/n/DSC03670.JPG_7.jpg,480,480,640,20,375,395,323,347,True,40
n,24,kaist_dataset/Mixed/Digital_Camera/(C.S)C-outdoor4/DSC03670.JPG,char_data/n/DSC03670.JPG_8.jpg,360,480,640,15,519,534,321,345,True,40
n,33,kaist_dataset/Mixed/Digital_Camera/(C.S)C-outdoor4/DSC03672.JPG,char_data/n/DSC03672.JPG_2.jpg,594,480,640,18,229,247,414,447,True,40
n,33,kaist_dataset/Mixed/Digital_Camera/(C.S)C-outdoor4/DSC03682.JPG,char_data/n/DSC03682.JPG_2.jpg,825,480,640,25,435,460,328,361,True,40
n,27,kaist_dataset/Mixed/Digital_Camera/(C.S)C-outdoor4/DSC03718.JPG,char_data/n/DSC03718.JPG_2.jpg,540,480,640,20,230,250,261,288,True,40
n,31,kaist_dataset/Mixed/Digital_Camera/(C.S)C-outdoor4/DSC03719.JPG,char_data/n/DSC03719.JPG_2.jpg,558,480,640,18,237,255,32,63,True,40
n,37,kaist_dataset/Mixed/Digital_Camera/(C.S)C-outdoor4/DSC03773.JPG,char_data/n/DSC03773.JPG_2.jpg,1258,480,640,34,187,221,276,313,True,40
n,45,kaist_dataset/Mixed/Digital_Camera/(C.S)C-outdoor4/DSC03781.JPG,char_data/n/DSC03781.JPG_6.jpg,2160,480,640,48,231,279,265,310,True,40
n,42,kaist_dataset/Mixed/Digital_Camera/(C.S)C-outdoor4/DSC03781.JPG,char_data/n/DSC03781.JPG_7.jpg,1722,480,640,41,249,290,222,264,True,40
n,42,kaist_dataset/Mixed/Digital_Camera/(C.S)C-outdoor4/DSC03781.JPG,char_data/n/DSC03781.JPG_8.jpg,1806,480,640,43,292,335,223,265,True,40
n,64,kaist_dataset/Mixed/Digital_Camera/(C.S)C-outdoor4/DSC03784.JPG,char_data/n/DSC03784.JPG_4.jpg,2688,480,640,42,138,180,321,385,True,40
n,61,kaist_dataset/Mixed/Digital_Camera/(C.S)C-outdoor4/DSC03784.JPG,char_data/n/DSC03784.JPG_5.jpg,1891,480,640,31,554,585,318,379,True,40
n,34,kaist_dataset/Mixed/Digital_Camera/(C.S)C-outdoor5/DSC03821.JPG,char_data/n/DSC03821.JPG_4.jpg,714,480,640,21,226,247,38,72,True,40
n,35,kaist_dataset/Mixed/Digital_Camera/(C.S)C-outdoor5/DSC03821.JPG,char_data/n/DSC03821.JPG_5.jpg,700,480,640,20,431,451,45,80,True,40
n,52,kaist_dataset/Mixed/Digital_Camera/(C.S)C-outdoor5/DSC04029.JPG,char_data/n/DSC04029.JPG_2.jpg,1664,480,640,32,386,418,178,230,True,40
n,26,kaist_dataset/Mixed/Digital_Camera/(C.S)C-outdoor5/DSC04057.JPG,char_data/n/DSC04057.JPG_2.jpg,520,480,640,20,336,356,115,141,True,40
n,32,kaist_dataset/Mixed/Digital_Camera/(C.S)C-outdoor5/DSC04069.JPG,char_data/n/DSC04069.JPG_10.jpg,608,480,640,19,212,231,427,459,True,40
n,31,kaist_dataset/Mixed/Digital_Camera/(C.S)C-outdoor5/DSC04069.JPG,char_data/n/DSC04069.JPG_11.jpg,713,480,640,23,298,321,423,454,True,40
n,30,kaist_dataset/Mixed/Digital_Camera/(C.S)C-outdoor5/DSC04069.JPG,char_data/n/DSC04069.JPG_12.jpg,660,480,640,22,251,273,388,418,True,40
n,34,kaist_dataset/Mixed/Digital_Camera/(C.S)C-outdoor5/DSC04069.JPG,char_data/n/DSC04069.JPG_13.jpg,816,480,640,24,391,415,381,415,True,40
n,32,kaist_dataset/Mixed/Digital_Camera/(C.S)C-outdoor5/DSC04069.JPG,char_data/n/DSC04069.JPG_14.jpg,864,480,640,27,546,573,378,410,True,40
n,34,kaist_dataset/Mixed/Digital_Camera/(C.S)C-outdoor5/DSC04070.JPG,char_data/n/DSC04070.JPG_2.jpg,680,480,640,20,213,233,111,145,True,40
n,42,kaist_dataset/Mixed/Digital_Camera/(C.S)C-outdoor5/DSC04076.JPG,char_data/n/DSC04076.JPG_6.jpg,1596,480,640,38,275,313,104,146,True,40
n,43,kaist_dataset/Mixed/Digital_Camera/(C.S)C-outdoor5/DSC04076.JPG,char_data/n/DSC04076.JPG_7.jpg,1591,480,640,37,396,433,100,143,True,40
n,23,kaist_dataset/Mixed/Digital_Camera/(C.S)C-outdoor5/DSC04076.JPG,char_data/n/DSC04076.JPG_8.jpg,437,480,640,19,420,439,403,426,True,40
n,24,kaist_dataset/Mixed/Digital_Camera/(C.S)C-outdoor5/DSC04091.JPG,char_data/n/DSC04091.JPG_2.jpg,384,480,640,16,288,304,430,454,True,40
n,48,kaist_dataset/Mixed/Digital_Camera/(C.S)C-outdoor5/DSC04097.JPG,char_data/n/DSC04097.JPG_2.jpg,1872,480,640,39,366,405,198,246,True,40
n,62,kaist_dataset/Mixed/Digital_Camera/(C.S)C-outdoor5/DSC04122.JPG,char_data/n/DSC04122.JPG_2.jpg,3472,480,640,56,274,330,325,387,True,40
n,28,kaist_dataset/Mixed/Digital_Camera/(C.S)C-outdoor5/DSC04125.JPG,char_data/n/DSC04125.JPG_6.jpg,504,480,640,18,79,97,433,461,True,40
n,30,kaist_dataset/Mixed/Digital_Camera/(C.S)C-outdoor5/DSC04125.JPG,char_data/n/DSC04125.JPG_7.jpg,420,480,640,14,111,125,431,461,True,40
n,28,kaist_dataset/Mixed/Digital_Camera/(C.S)C-outdoor5/DSC04125.JPG,char_data/n/DSC04125.JPG_8.jpg,476,480,640,17,220,237,430,458,True,40
n,39,kaist_dataset/Mixed/Digital_Camera/(C.S)C-outdoor5/DSC04162.JPG,char_data/n/DSC04162.JPG_2.jpg,1209,480,640,31,214,245,332,371,True,40
n,27,kaist_dataset/Mixed/Digital_Camera/(C.S)C-outdoor5/DSC04312.JPG,char_data/n/DSC04312.JPG_2.jpg,432,480,640,16,466,482,150,177,True,40
n,44,kaist_dataset/Mixed/Digital_Camera/(C.S)C-outdoor5/DSC04321.JPG,char_data/n/DSC04321.JPG_10.jpg,1056,480,640,24,101,125,187,231,True,40
n,34,kaist_dataset/Mixed/Digital_Camera/(C.S)C-outdoor5/DSC04321.JPG,char_data/n/DSC04321.JPG_11.jpg,782,480,640,23,146,169,196,230,True,40
n,39,kaist_dataset/Mixed/Digital_Camera/(C.S)C-outdoor5/DSC04321.JPG,char_data/n/DSC04321.JPG_13.jpg,897,480,640,23,333,356,197,236,True,40
n,36,kaist_dataset/Mixed/Digital_Camera/(C.S)C-outdoor5/DSC04321.JPG,char_data/n/DSC04321.JPG_14.jpg,756,480,640,21,430,451,205,241,True,40
n,41,kaist_dataset/Mixed/Digital_Camera/(C.S)C-outdoor5/DSC04322.JPG,char_data/n/DSC04322.JPG_4.jpg,1066,480,640,26,83,109,216,257,True,40
n,43,kaist_dataset/Mixed/Digital_Camera/(C.S)C-outdoor5/DSC04322.JPG,char_data/n/DSC04322.JPG_5.jpg,860,480,640,20,330,350,220,263,True,40
n,32,kaist_dataset/Mixed/Digital_Camera/(C.S)C-outdoor5/DSC04323.JPG,char_data/n/DSC04323.JPG_8.jpg,640,480,640,20,149,169,201,233,True,40
n,31,kaist_dataset/Mixed/Digital_Camera/(C.S)C-outdoor5/DSC04323.JPG,char_data/n/DSC04323.JPG_9.jpg,620,480,640,20,574,594,212,243,False,40
n,34,kaist_dataset/Mixed/Digital_Camera/(C.S)C-outdoor5/DSC04323.JPG,char_data/n/DSC04323.JPG_11.jpg,510,480,640,15,413,428,207,241,False,40
n,49,kaist_dataset/Mixed/Digital_Camera/(C.S)C-outdoor5/DSC04338.JPG,char_data/n/DSC04338.JPG_6.jpg,980,480,640,20,405,425,190,239,False,40
n,36,kaist_dataset/Mixed/Digital_Camera/(C.S)C-outdoor5/DSC04338.JPG,char_data/n/DSC04338.JPG_7.jpg,684,480,640,19,456,475,200,236,False,40
n,32,kaist_dataset/Mixed/Digital_Camera/(C.S)C-outdoor5/DSC04338.JPG,char_data/n/DSC04338.JPG_8.jpg,640,480,640,20,611,631,202,234,False,40
n,27,kaist_dataset/Mixed/Digital_Camera/(C.S)C-outdoor5/DSC04357.JPG,char_data/n/DSC04357.JPG_2.jpg,513,480,640,19,320,339,381,408,False,40
n,46,kaist_dataset/Mixed/Digital_Camera/(C.S)C-outdoor5/DSC04399.JPG,char_data/n/DSC04399.JPG_2.jpg,1656,480,640,36,511,547,285,331,False,40
n,49,kaist_dataset/Mixed/Digital_Camera/(C.S)C-outdoor5/DSC04456.JPG,char_data/n/DSC04456.JPG_2.jpg,1470,480,640,30,245,275,169,218,False,40
n,134,kaist_dataset/Mixed/Digital_Camera/(C.S)C-outdoor6/080116-0057.jpg,char_data/n/080116-0057.jpg_10.jpg,17554,1200,1600,131,548,679,580,714,False,40
n,52,kaist_dataset/Mixed/Digital_Camera/(C.S)C-outdoor6/080116-0057.jpg,char_data/n/080116-0057.jpg_11.jpg,1456,1200,1600,28,1204,1232,827,879,False,40
n,52,kaist_dataset/Mixed/Digital_Camera/(C.S)C-outdoor6/080116-0057.jpg,char_data/n/080116-0057.jpg_12.jpg,1612,1200,1600,31,861,892,823,875,False,40
n,52,kaist_dataset/Mixed/Digital_Camera/(C.S)C-outdoor6/080116-0057.jpg,char_data/n/080116-0057.jpg_13.jpg,1768,1200,1600,34,961,995,827,879,False,40
n,48,kaist_dataset/Mixed/Digital_Camera/(C.S)C-outdoor6/080116-0057.jpg,char_data/n/080116-0057.jpg_14.jpg,1632,1200,1600,34,361,395,919,967,False,40
n,50,kaist_dataset/Mixed/Digital_Camera/(C.S)C-outdoor6/117.JPG,char_data/n/117.JPG_2.jpg,2800,480,640,56,171,227,193,243,False,40
n,28,kaist_dataset/Mixed/Digital_Camera/(C.S)C-outdoor6/P1010048.JPG,char_data/n/P1010048.JPG_2.jpg,616,480,640,22,552,574,173,201,False,40
n,26,kaist_dataset/Mixed/Digital_Camera/(C.S)C-outdoor6/P1010065.JPG,char_data/n/P1010065.JPG_6.jpg,338,480,640,13,283,296,232,258,False,40
n,35,kaist_dataset/Mixed/Digital_Camera/(C.S)C-outdoor6/P1010085.JPG,char_data/n/P1010085.JPG_4.jpg,945,480,640,27,169,196,131,166,False,40
n,26,kaist_dataset/Mixed/Digital_Camera/(C.S)C-outdoor6/P1010085.JPG,char_data/n/P1010085.JPG_5.jpg,598,480,640,23,78,101,99,125,False,40
n,36,kaist_dataset/Mixed/Digital_Camera/(C.S)D-indoor1/DSC02787.JPG,char_data/n/DSC02787.JPG_6.jpg,612,480,640,17,119,136,388,424,False,40
n,32,kaist_dataset/Mixed/Digital_Camera/(C.S)D-indoor1/DSC02787.JPG,char_data/n/DSC02787.JPG_7.jpg,576,480,640,18,314,332,376,408,False,40
n,37,kaist_dataset/Mixed/Digital_Camera/(C.S)D-indoor1/DSC02787.JPG,char_data/n/DSC02787.JPG_8.jpg,777,480,640,21,388,409,372,409,False,40
n,32,kaist_dataset/Mixed/Digital_Camera/(C.S)D-indoor1/DSC02804.JPG,char_data/n/DSC02804.JPG_2.jpg,864,480,640,27,464,491,349,381,False,40
n,27,kaist_dataset/Mixed/Digital_Camera/(C.S)D-indoor1/DSC03096.JPG,char_data/n/DSC03096.JPG_6.jpg,513,480,640,19,185,204,428,455,False,40
n,27,kaist_dataset/Mixed/Digital_Camera/(C.S)D-indoor1/DSC03096.JPG,char_data/n/DSC03096.JPG_7.jpg,486,480,640,18,467,485,431,458,False,40
n,29,kaist_dataset/Mixed/Digital_Camera/(C.S)D-indoor1/DSC03096.JPG,char_data/n/DSC03096.JPG_8.jpg,580,480,640,20,597,617,431,460,False,40
n,42,kaist_dataset/Mixed/Digital_Camera/(C.S)D-indoor1/DSC03118.JPG,char_data/n/DSC03118.JPG_4.jpg,1176,480,640,28,249,277,155,197,False,40
n,33,kaist_dataset/Mixed/Digital_Camera/(C.S)D-indoor1/DSC03118.JPG,char_data/n/DSC03118.JPG_5.jpg,792,480,640,24,440,464,157,190,False,40
n,43,kaist_dataset/Mixed/Digital_Camera/(C.S)D-indoor1/DSC03119.JPG,char_data/n/DSC03119.JPG_4.jpg,1204,480,640,28,228,256,169,212,False,40
n,38,kaist_dataset/Mixed/Digital_Camera/(C.S)D-indoor1/DSC03119.JPG,char_data/n/DSC03119.JPG_5.jpg,1292,480,640,34,457,491,169,207,False,40
n,32,kaist_dataset/Mixed/Digital_Camera/(C.S)D-indoor1/DSC03122.JPG,char_data/n/DSC03122.JPG_4.jpg,672,480,640,21,268,289,204,236,False,40
n,30,kaist_dataset/Mixed/Digital_Camera/(C.S)D-indoor1/DSC03122.JPG,char_data/n/DSC03122.JPG_5.jpg,750,480,640,25,324,349,153,183,False,40
n,28,kaist_dataset/Mixed/Digital_Camera/(C.S)D-indoor1/DSC03124.JPG,char_data/n/DSC03124.JPG_2.jpg,756,480,640,27,433,460,203,231,False,40
n,46,kaist_dataset/Mixed/Digital_Camera/(C.S)D-indoor1/DSC03125.JPG,char_data/n/DSC03125.JPG_2.jpg,1380,480,640,30,288,318,188,234,False,40
n,34,kaist_dataset/Mixed/Digital_Camera/(C.S)D-indoor1/DSC03131.JPG,char_data/n/DSC03131.JPG_2.jpg,1088,480,640,32,339,371,139,173,False,40
n,36,kaist_dataset/Mixed/Digital_Camera/(C.S)D-indoor1/DSC03132.JPG,char_data/n/DSC03132.JPG_2.jpg,1296,480,640,36,394,430,254,290,False,40
n,40,kaist_dataset/Mixed/Digital_Camera/(C.S)D-indoor1/DSC03133.JPG,char_data/n/DSC03133.JPG_5.jpg,1440,480,640,36,292,328,157,197,False,40
n,46,kaist_dataset/Mixed/Digital_Camera/(C.S)D-indoor1/DSC03135.JPG,char_data/n/DSC03135.JPG_2.jpg,1518,480,640,33,306,339,187,233,False,40
n,83,kaist_dataset/Mixed/Digital_Camera/(C.S)D-indoor1/DSC03469.JPG,char_data/n/DSC03469.JPG_2.jpg,4150,480,640,50,358,408,349,432,False,40
n,73,kaist_dataset/Mixed/Digital_Camera/(C.S)D-indoor1/DSC03909.JPG,char_data/n/DSC03909.JPG_4.jpg,3504,480,640,48,480,528,107,180,False,40
n,76,kaist_dataset/Mixed/Digital_Camera/(C.S)D-indoor1/DSC03909.JPG,char_data/n/DSC03909.JPG_5.jpg,3572,480,640,47,539,586,197,273,False,40
n,36,kaist_dataset/Mixed/Digital_Camera/(C.S)D-indoor1/DSC04206.JPG,char_data/n/DSC04206.JPG_2.jpg,648,480,640,18,424,442,294,330,False,40
n,33,kaist_dataset/Mixed/Digital_Camera/(C.S)D-indoor2/DSC04248.JPG,char_data/n/DSC04248.JPG_4.jpg,693,480,640,21,199,220,226,259,False,40
n,36,kaist_dataset/Mixed/Digital_Camera/(C.S)D-indoor2/DSC04248.JPG,char_data/n/DSC04248.JPG_5.jpg,900,480,640,25,297,322,222,258,False,40
n,35,kaist_dataset/Mixed/Digital_Camera/(C.S)D-indoor2/DSC04249.JPG,char_data/n/DSC04249.JPG_2.jpg,770,480,640,22,268,290,219,254,False,40
n,30,kaist_dataset/Mixed/Digital_Camera/(C.S)D-indoor2/DSC04254.JPG,char_data/n/DSC04254.JPG_9.jpg,630,480,640,21,201,222,346,376,False,40
n,33,kaist_dataset/Mixed/Digital_Camera/(C.S)D-indoor2/DSC04254.JPG,char_data/n/DSC04254.JPG_10.jpg,660,480,640,20,457,477,340,373,False,40
n,31,kaist_dataset/Mixed/Digital_Camera/(C.S)D-indoor2/DSC04254.JPG,char_data/n/DSC04254.JPG_11.jpg,558,480,640,18,519,537,342,373,False,40
n,38,kaist_dataset/Mixed/Digital_Camera/(C.S)E-night/DSC02574.JPG,char_data/n/DSC02574.JPG_5.jpg,1140,480,640,30,545,575,151,189,False,40
n,102,kaist_dataset/Mixed/Digital_Camera/(C.S)E-night/DSC02586.JPG,char_data/n/DSC02586.JPG_2.jpg,10914,480,640,107,516,623,243,345,False,40
n,46,kaist_dataset/Mixed/Digital_Camera/(C.S)E-night/DSC02647.JPG,char_data/n/DSC02647.JPG_2.jpg,2438,480,640,53,332,385,199,245,False,40
n,22,kaist_dataset/Mixed/Digital_Camera/(C.S)E-night/P1010151.JPG,char_data/n/P1010151.JPG_2.jpg,264,480,640,12,493,505,203,225,False,40
n,44,kaist_dataset/Mixed/Digital_Camera/(C.S)F-others/047.jpg,char_data/n/047.jpg_2.jpg,1716,252,339,39,163,202,71,115,False,40
n,44,kaist_dataset/Mixed/Digital_Camera/(C.S)F-others/2007-12-08-day-067.jpg,char_data/n/2007-12-08-day-067.jpg_2.jpg,2684,1600,1200,61,427,488,1116,1160,False,40
n,31,kaist_dataset/Mixed/Mobile_Phone/(C.M)A-outdoor/P090912078.jpg,char_data/n/P090912078.jpg_4.jpg,837,480,640,27,162,189,312,343,False,40
n,28,kaist_dataset/Mixed/Mobile_Phone/(C.M)A-outdoor/P090912078.jpg,char_data/n/P090912078.jpg_5.jpg,896,480,640,32,448,480,300,328,False,40
n,29,kaist_dataset/Mixed/Mobile_Phone/(C.M)B-indoor/P090831005.jpg,char_data/n/P090831005.jpg_4.jpg,493,480,640,17,215,232,242,271,False,40
n,25,kaist_dataset/Mixed/Mobile_Phone/(C.M)B-indoor/P090831005.jpg,char_data/n/P090831005.jpg_5.jpg,400,480,640,16,302,318,246,271,False,40
n,49,kaist_dataset/Mixed/Mobile_Phone/(C.M)B-indoor/P090831010.jpg,char_data/n/P090831010.jpg_2.jpg,1813,480,640,37,257,294,292,341,False,40
n,49,kaist_dataset/Mixed/Mobile_Phone/(C.M)B-indoor/P090831013.jpg,char_data/n/P090831013.jpg_2.jpg,2107,480,640,43,136,179,194,243,False,40
n,49,kaist_dataset/Mixed/Mobile_Phone/(C.M)B-indoor/P090831017.jpg,char_data/n/P090831017.jpg_2.jpg,1617,480,640,33,325,358,246,295,False,40
n,57,kaist_dataset/Mixed/Mobile_Phone/(C.M)B-indoor/P090831018.jpg,char_data/n/P090831018.jpg_2.jpg,2280,480,640,40,252,292,234,291,False,40
n,66,kaist_dataset/Mixed/Mobile_Phone/(C.M)B-indoor/P090831019.jpg,char_data/n/P090831019.jpg_2.jpg,3696,480,640,56,221,277,157,223,False,40
n,35,kaist_dataset/Mixed/Mobile_Phone/(C.M)C-bookCover/P090831080.jpg,char_data/n/P090831080.jpg_6.jpg,1190,480,640,34,211,245,414,449,False,40
n,34,kaist_dataset/Mixed/Mobile_Phone/(C.M)C-bookCover/P090831080.jpg,char_data/n/P090831080.jpg_7.jpg,952,480,640,28,387,415,411,445,False,40
n,35,kaist_dataset/Mixed/Mobile_Phone/(C.M)C-bookCover/P090831080.jpg,char_data/n/P090831080.jpg_8.jpg,945,480,640,27,355,382,379,414,False,40
n,46,kaist_dataset/Mixed/Mobile_Phone/(C.M)C-bookCover/P090831113.jpg,char_data/n/P090831113.jpg_2.jpg,1978,480,640,43,458,501,246,292,False,40
n,27,kaist_dataset/Mixed/Mobile_Phone/(C.M)C-bookCover/P090831115.jpg,char_data/n/P090831115.jpg_2.jpg,621,480,640,23,321,344,178,205,False,40
n,34,kaist_dataset/Mixed/Mobile_Phone/(C.M)C-bookCover/P090831118.jpg,char_data/n/P090831118.jpg_4.jpg,986,480,640,29,154,183,223,257,False,40
n,42,kaist_dataset/Mixed/Mobile_Phone/(C.M)C-bookCover/P090831118.jpg,char_data/n/P090831118.jpg_5.jpg,1134,480,640,27,286,313,219,261,False,40
n,51,kaist_dataset/Mixed/Mobile_Phone/(C.M)C-bookCover/P090831119.jpg,char_data/n/P090831119.jpg_2.jpg,1683,480,640,33,374,407,223,274,False,40
n,40,kaist_dataset/Mixed/Mobile_Phone/(C.M)C-bookCover/P090902019.jpg,char_data/n/P090902019.jpg_2.jpg,1480,480,640,37,319,356,303,343,False,40
n,27,kaist_dataset/Mixed/Mobile_Phone/(C.M)C-bookCover/P090903024.jpg,char_data/n/P090903024.jpg_4.jpg,702,480,640,26,353,379,233,260,False,40
n,34,kaist_dataset/Mixed/Mobile_Phone/(C.M)C-bookCover/P090903024.jpg,char_data/n/P090903024.jpg_5.jpg,1020,480,640,30,529,559,225,259,False,40
n,45,kaist_dataset/Mixed/Mobile_Phone/(C.M)C-bookCover/P090903083.jpg,char_data/n/P090903083.jpg_4.jpg,2160,480,640,48,462,510,180,225,False,40
n,43,kaist_dataset/Mixed/Mobile_Phone/(C.M)C-bookCover/P090903083.jpg,char_data/n/P090903083.jpg_5.jpg,1978,480,640,46,156,202,176,219,False,40
A,113,kaist_dataset/English/Digital_Camera/(E.S)A-shadow/DSC02317.JPG,char_data/A/DSC02317.JPG_2.jpg,9492,480,640,84,518,602,205,318,True,12
A,73,kaist_dataset/English/Digital_Camera/(E.S)A-shadow/DSC02423.JPG,char_data/A/DSC02423.JPG_6.jpg,4526,480,640,62,467,529,163,236,True,12
A,45,kaist_dataset/English/Digital_Camera/(E.S)A-shadow/DSC02423.JPG,char_data/A/DSC02423.JPG_7.jpg,1665,480,640,37,188,225,239,284,True,12
A,40,kaist_dataset/English/Digital_Camera/(E.S)A-shadow/DSC02423.JPG,char_data/A/DSC02423.JPG_8.jpg,1520,480,640,38,407,445,242,282,True,12
A,79,kaist_dataset/English/Digital_Camera/(E.S)A-shadow/DSC03084.JPG,char_data/A/DSC03084.JPG_5.jpg,3081,480,640,39,281,320,352,431,True,12
A,35,kaist_dataset/English/Digital_Camera/(E.S)A-shadow/P1010044.JPG,char_data/A/P1010044.JPG_2.jpg,840,480,640,24,255,279,185,220,True,12
A,130,kaist_dataset/English/Digital_Camera/(E.S)B-light/080116-0053.jpg,char_data/A/080116-0053.jpg_2.jpg,11570,600,800,89,190,279,213,343,True,12
A,184,kaist_dataset/English/Digital_Camera/(E.S)B-light/080116-0059.jpg,char_data/A/080116-0059.jpg_22.jpg,18584,1200,1600,101,581,682,307,491,True,12
A,236,kaist_dataset/English/Digital_Camera/(E.S)B-light/080116-0059.jpg,char_data/A/080116-0059.jpg_23.jpg,33748,1200,1600,143,553,696,491,727,True,12
A,26,kaist_dataset/English/Digital_Camera/(E.S)B-light/080116-0059.jpg,char_data/A/080116-0059.jpg_24.jpg,364,1200,1600,14,1114,1128,824,850,True,12
A,32,kaist_dataset/English/Digital_Camera/(E.S)B-light/080116-0059.jpg,char_data/A/080116-0059.jpg_25.jpg,544,1200,1600,17,657,674,825,857,True,12
A,28,kaist_dataset/English/Digital_Camera/(E.S)B-light/080116-0059.jpg,char_data/A/080116-0059.jpg_26.jpg,644,1200,1600,23,453,476,802,830,True,12
A,26,kaist_dataset/English/Digital_Camera/(E.S)B-light/080116-0059.jpg,char_data/A/080116-0059.jpg_27.jpg,390,1200,1600,15,521,536,803,829,True,12
A,25,kaist_dataset/English/Digital_Camera/(E.S)B-light/080116-0059.jpg,char_data/A/080116-0059.jpg_28.jpg,375,1200,1600,15,990,1005,801,826,True,12
A,31,kaist_dataset/English/Digital_Camera/(E.S)B-light/080116-0059.jpg,char_data/A/080116-0059.jpg_29.jpg,868,1200,1600,28,451,479,772,803,True,12
A,38,kaist_dataset/English/Digital_Camera/(E.S)B-light/080116-0059.jpg,char_data/A/080116-0059.jpg_30.jpg,646,1200,1600,17,496,513,767,805,True,12
A,27,kaist_dataset/English/Digital_Camera/(E.S)B-light/080116-0059.jpg,char_data/A/080116-0059.jpg_31.jpg,702,1200,1600,26,781,807,771,798,True,12
A,31,kaist_dataset/English/Digital_Camera/(E.S)B-light/080116-0059.jpg,char_data/A/080116-0059.jpg_32.jpg,527,1200,1600,17,856,873,769,800,True,12
A,34,kaist_dataset/English/Digital_Camera/(E.S)B-light/x.jpg,char_data/A/x.jpg_4.jpg,1326,240,320,39,128,167,71,105,True,12
A,22,kaist_dataset/English/Digital_Camera/(E.S)B-light/x.jpg,char_data/A/x.jpg_5.jpg,396,240,320,18,203,221,103,125,True,12
A,83,kaist_dataset/English/Digital_Camera/(E.S)B-light/크기변환_%B0%A3%C6%C74_fabdent.jpg,char_data/A/크기변환_%B0%A3%C6%C74_fabdent.jpg_4.jpg,4565,480,640,55,220,275,151,234,True,12
A,96,kaist_dataset/English/Digital_Camera/(E.S)C-outdoor1/029.jpg,char_data/A/029.jpg_2.jpg,9696,250,472,101,159,260,61,157,True,12
A,56,kaist_dataset/English/Digital_Camera/(E.S)C-outdoor1/034.JPG,char_data/A/034.JPG_4.jpg,3360,480,640,60,110,170,194,250,True,12
A,56,kaist_dataset/English/Digital_Camera/(E.S)C-outdoor1/034.JPG,char_data/A/034.JPG_5.jpg,2856,480,640,51,489,540,199,255,True,12
A,58,kaist_dataset/English/Digital_Camera/(E.S)C-outdoor1/035.jpg,char_data/A/035.jpg_4.jpg,1682,210,354,29,127,156,24,82,True,12
A,65,kaist_dataset/English/Digital_Camera/(E.S)C-outdoor1/035.jpg,char_data/A/035.jpg_5.jpg,2080,210,354,32,147,179,83,148,True,12
A,31,kaist_dataset/English/Digital_Camera/(E.S)C-outdoor1/041.JPG,char_data/A/041.JPG_2.jpg,837,480,640,27,560,587,254,285,True,12
A,68,kaist_dataset/English/Digital_Camera/(E.S)C-outdoor1/042.JPG,char_data/A/042.JPG_2.jpg,3876,480,640,57,508,565,214,282,True,12
A,72,kaist_dataset/English/Digital_Camera/(E.S)C-outdoor1/055.JPG,char_data/A/055.JPG_2.jpg,3312,480,640,46,382,428,185,257,True,12
A,24,kaist_dataset/English/Digital_Camera/(E.S)C-outdoor1/056.JPG,char_data/A/056.JPG_9.jpg,312,480,640,13,163,176,242,266,True,12
A,20,kaist_dataset/English/Digital_Camera/(E.S)C-outdoor1/061.jpg,char_data/A/061.jpg_4.jpg,400,219,323,20,154,174,87,107,True,12
A,19,kaist_dataset/English/Digital_Camera/(E.S)C-outdoor1/061.jpg,char_data/A/061.jpg_5.jpg,418,219,323,22,151,173,71,90,True,12
A,55,kaist_dataset/English/Digital_Camera/(E.S)C-outdoor1/064.JPG,char_data/A/064.JPG_4.jpg,1980,480,640,36,173,209,180,235,True,12
A,52,kaist_dataset/English/Digital_Camera/(E.S)C-outdoor1/064.JPG,char_data/A/064.JPG_5.jpg,1612,480,640,31,362,393,185,237,True,12
A,64,kaist_dataset/English/Digital_Camera/(E.S)C-outdoor1/080.jpg,char_data/A/080.jpg_4.jpg,1600,253,350,25,238,263,91,155,True,12
A,43,kaist_dataset/English/Digital_Camera/(E.S)C-outdoor1/080116-0065.jpg,char_data/A/080116-0065.jpg_4.jpg,1419,600,800,33,487,520,204,247,True,12
A,91,kaist_dataset/English/Digital_Camera/(E.S)C-outdoor1/080116-0065.jpg,char_data/A/080116-0065.jpg_5.jpg,4550,600,800,50,203,253,236,327,True,12
A,67,kaist_dataset/English/Digital_Camera/(E.S)C-outdoor1/080118-0011.jpg,char_data/A/080118-0011.jpg_2.jpg,3752,1200,1600,56,756,812,596,663,True,12
A,175,kaist_dataset/English/Digital_Camera/(E.S)C-outdoor1/080119-0020.jpg,char_data/A/080119-0020.jpg_2.jpg,21350,1200,1600,122,432,554,468,643,True,12
A,97,kaist_dataset/English/Digital_Camera/(E.S)C-outdoor1/083.JPG,char_data/A/083.JPG_2.jpg,7566,480,640,78,235,313,175,272,True,12
A,47,kaist_dataset/English/Digital_Camera/(E.S)C-outdoor1/089.jpg,char_data/A/089.jpg_6.jpg,1081,480,640,23,231,254,289,336,True,12
A,64,kaist_dataset/English/Digital_Camera/(E.S)C-outdoor1/089.jpg,char_data/A/089.jpg_7.jpg,1344,480,640,21,391,412,269,333,True,12
A,71,kaist_dataset/English/Digital_Camera/(E.S)C-outdoor1/089.jpg,char_data/A/089.jpg_8.jpg,1491,480,640,21,464,485,261,332,True,12
A,75,kaist_dataset/English/Digital_Camera/(E.S)C-outdoor1/110.jpg,char_data/A/110.jpg_2.jpg,4500,480,640,60,148,208,193,268,True,12
A,210,kaist_dataset/English/Digital_Camera/(E.S)C-outdoor1/2007-12-08-day-099.jpg,char_data/A/2007-12-08-day-099.jpg_2.jpg,25410,1200,1600,121,1024,1145,461,671,True,12
A,47,kaist_dataset/English/Digital_Camera/(E.S)C-outdoor1/6.jpg,char_data/A/6.jpg_4.jpg,1692,255,731,36,99,135,99,146,True,12
A,42,kaist_dataset/English/Digital_Camera/(E.S)C-outdoor1/6.jpg,char_data/A/6.jpg_5.jpg,1848,255,731,44,302,346,99,141,True,12
A,73,kaist_dataset/English/Digital_Camera/(E.S)C-outdoor1/DSC02243.JPG,char_data/A/DSC02243.JPG_2.jpg,2701,480,640,37,286,323,201,274,True,12
A,96,kaist_dataset/English/Digital_Camera/(E.S)C-outdoor1/DSC02306.JPG,char_data/A/DSC02306.JPG_4.jpg,7968,480,640,83,251,334,146,242,True,12
A,93,kaist_dataset/English/Digital_Camera/(E.S)C-outdoor1/DSC02306.JPG,char_data/A/DSC02306.JPG_5.jpg,8277,480,640,89,538,627,154,247,True,12
A,34,kaist_dataset/English/Digital_Camera/(E.S)C-outdoor1/DSC02345.JPG,char_data/A/DSC02345.JPG_2.jpg,680,480,640,20,424,444,233,267,True,12
A,186,kaist_dataset/English/Digital_Camera/(E.S)C-outdoor1/DSC02355.JPG,char_data/A/DSC02355.JPG_8.jpg,25110,480,640,135,314,449,211,397,True,12
A,78,kaist_dataset/English/Digital_Camera/(E.S)C-outdoor1/DSC02356.JPG,char_data/A/DSC02356.JPG_10.jpg,4368,480,640,56,494,550,166,244,True,12
A,72,kaist_dataset/English/Digital_Camera/(E.S)C-outdoor1/DSC02395.JPG,char_data/A/DSC02395.JPG_2.jpg,4608,480,640,64,184,248,296,368,True,12
A,77,kaist_dataset/English/Digital_Camera/(E.S)C-outdoor1/DSC02398.JPG,char_data/A/DSC02398.JPG_2.jpg,4004,480,640,52,171,223,240,317,True,12
A,97,kaist_dataset/English/Digital_Camera/(E.S)C-outdoor1/DSC02410.JPG,char_data/A/DSC02410.JPG_4.jpg,8342,480,640,86,23,109,115,212,True,12
A,86,kaist_dataset/English/Digital_Camera/(E.S)C-outdoor1/DSC02410.JPG,char_data/A/DSC02410.JPG_5.jpg,6794,480,640,79,314,393,117,203,True,12
A,118,kaist_dataset/English/Digital_Camera/(E.S)C-outdoor1/DSC02500.JPG,char_data/A/DSC02500.JPG_4.jpg,8024,480,640,68,106,174,169,287,True,12
A,110,kaist_dataset/English/Digital_Camera/(E.S)C-outdoor1/DSC02500.JPG,char_data/A/DSC02500.JPG_5.jpg,8030,480,640,73,399,472,169,279,True,12
A,60,kaist_dataset/English/Digital_Camera/(E.S)C-outdoor1/DSC02501.JPG,char_data/A/DSC02501.JPG_2.jpg,3240,480,640,54,289,343,299,359,True,12
A,83,kaist_dataset/English/Digital_Camera/(E.S)C-outdoor1/DSC02514.JPG,char_data/A/DSC02514.JPG_4.jpg,3652,480,640,44,157,201,155,238,True,12
A,137,kaist_dataset/English/Digital_Camera/(E.S)C-outdoor1/DSC02618.JPG,char_data/A/DSC02618.JPG_2.jpg,16577,480,640,121,261,382,212,349,True,12
A,74,kaist_dataset/English/Digital_Camera/(E.S)C-outdoor1/DSC02897.JPG,char_data/A/DSC02897.JPG_2.jpg,4218,480,640,57,203,260,293,367,True,12
A,50,kaist_dataset/English/Digital_Camera/(E.S)C-outdoor1/DSC02918.JPG,char_data/A/DSC02918.JPG_4.jpg,2950,480,640,59,167,226,174,224,True,12
A,180,kaist_dataset/English/Digital_Camera/(E.S)C-outdoor2/DSC02949.JPG,char_data/A/DSC02949.JPG_2.jpg,6660,480,640,37,250,287,63,243,True,12
A,98,kaist_dataset/English/Digital_Camera/(E.S)C-outdoor2/DSC02984.JPG,char_data/A/DSC02984.JPG_2.jpg,6860,480,640,70,148,218,101,199,True,12
A,87,kaist_dataset/English/Digital_Camera/(E.S)C-outdoor2/DSC02993.JPG,char_data/A/DSC02993.JPG_2.jpg,5481,480,640,63,218,281,117,204,True,12
A,48,kaist_dataset/English/Digital_Camera/(E.S)C-outdoor2/DSC03023.JPG,char_data/A/DSC03023.JPG_4.jpg,1152,480,640,24,192,216,301,349,True,12
A,51,kaist_dataset/English/Digital_Camera/(E.S)C-outdoor2/DSC03023.JPG,char_data/A/DSC03023.JPG_5.jpg,1530,480,640,30,285,315,303,354,True,12
A,68,kaist_dataset/English/Digital_Camera/(E.S)C-outdoor2/DSC03025.JPG,char_data/A/DSC03025.JPG_2.jpg,2516,480,640,37,216,253,125,193,True,12
A,165,kaist_dataset/English/Digital_Camera/(E.S)C-outdoor2/DSC03160.JPG,char_data/A/DSC03160.JPG_8.jpg,25410,480,640,154,193,347,214,379,True,12
A,154,kaist_dataset/English/Digital_Camera/(E.S)C-outdoor2/DSC03160.JPG,char_data/A/DSC03160.JPG_9.jpg,24640,480,640,160,442,602,216,370,True,12
A,54,kaist_dataset/English/Digital_Camera/(E.S)C-outdoor2/DSC03161.JPG,char_data/A/DSC03161.JPG_4.jpg,1404,480,640,26,336,362,212,266,True,12
A,65,kaist_dataset/English/Digital_Camera/(E.S)C-outdoor2/DSC03161.JPG,char_data/A/DSC03161.JPG_5.jpg,2015,480,640,31,390,421,206,271,True,12
A,68,kaist_dataset/English/Digital_Camera/(E.S)C-outdoor2/DSC03191.JPG,char_data/A/DSC03191.JPG_2.jpg,3672,480,640,54,137,191,141,209,True,12
A,44,kaist_dataset/English/Digital_Camera/(E.S)C-outdoor2/DSC03203.JPG,char_data/A/DSC03203.JPG_2.jpg,1540,480,640,35,469,504,316,360,True,12
A,68,kaist_dataset/English/Digital_Camera/(E.S)C-outdoor2/DSC03208.JPG,char_data/A/DSC03208.JPG_4.jpg,5848,480,640,86,254,340,200,268,True,12
A,69,kaist_dataset/English/Digital_Camera/(E.S)C-outdoor2/DSC03225.JPG,char_data/A/DSC03225.JPG_2.jpg,4071,480,640,59,241,300,51,120,True,12
A,68,kaist_dataset/English/Digital_Camera/(E.S)C-outdoor2/DSC03264.JPG,char_data/A/DSC03264.JPG_2.jpg,3536,480,640,52,242,294,229,297,True,12
A,65,kaist_dataset/English/Digital_Camera/(E.S)C-outdoor2/DSC03307.JPG,char_data/A/DSC03307.JPG_2.jpg,2665,480,640,41,265,306,224,289,True,12
A,43,kaist_dataset/English/Digital_Camera/(E.S)C-outdoor2/DSC03317.JPG,char_data/A/DSC03317.JPG_6.jpg,946,480,640,22,438,460,259,302,True,12
A,37,kaist_dataset/English/Digital_Camera/(E.S)C-outdoor2/DSC03317.JPG,char_data/A/DSC03317.JPG_7.jpg,777,480,640,21,433,454,200,237,True,12
A,43,kaist_dataset/English/Digital_Camera/(E.S)C-outdoor2/DSC03317.JPG,char_data/A/DSC03317.JPG_8.jpg,946,480,640,22,493,515,197,240,True,12
A,67,kaist_dataset/English/Digital_Camera/(E.S)C-outdoor2/DSC03412.JPG,char_data/A/DSC03412.JPG_6.jpg,4355,480,640,65,472,537,397,464,True,12
A,75,kaist_dataset/English/Digital_Camera/(E.S)C-outdoor2/DSC03412.JPG,char_data/A/DSC03412.JPG_7.jpg,4725,480,640,63,145,208,135,210,True,12
A,69,kaist_dataset/English/Digital_Camera/(E.S)C-outdoor2/DSC03413.JPG,char_data/A/DSC03413.JPG_4.jpg,3381,480,640,49,232,281,192,261,True,12
A,80,kaist_dataset/English/Digital_Camera/(E.S)C-outdoor2/DSC03432.JPG,char_data/A/DSC03432.JPG_2.jpg,5040,480,640,63,353,416,357,437,True,12
A,52,kaist_dataset/English/Digital_Camera/(E.S)C-outdoor2/DSC03575.JPG,char_data/A/DSC03575.JPG_2.jpg,1664,480,640,32,233,265,261,313,True,12
A,48,kaist_dataset/English/Digital_Camera/(E.S)C-outdoor2/DSC03650.JPG,char_data/A/DSC03650.JPG_4.jpg,1536,480,640,32,145,177,211,259,True,12
A,46,kaist_dataset/English/Digital_Camera/(E.S)C-outdoor2/DSC03650.JPG,char_data/A/DSC03650.JPG_5.jpg,1426,480,640,31,251,282,212,258,True,12
A,65,kaist_dataset/English/Digital_Camera/(E.S)C-outdoor2/DSC03684.JPG,char_data/A/DSC03684.JPG_2.jpg,2600,480,640,40,380,420,88,153,True,12
A,142,kaist_dataset/English/Digital_Camera/(E.S)C-outdoor2/DSC03786.JPG,char_data/A/DSC03786.JPG_2.jpg,16188,480,640,114,90,204,17,159,True,12
A,69,kaist_dataset/English/Digital_Camera/(E.S)C-outdoor2/DSC03865.JPG,char_data/A/DSC03865.JPG_13.jpg,3243,480,640,47,340,387,87,156,True,12
A,67,kaist_dataset/English/Digital_Camera/(E.S)C-outdoor2/DSC03865.JPG,char_data/A/DSC03865.JPG_14.jpg,3015,480,640,45,450,495,95,162,True,12
A,75,kaist_dataset/English/Digital_Camera/(E.S)C-outdoor2/DSC04079.JPG,char_data/A/DSC04079.JPG_4.jpg,3900,480,640,52,461,513,269,344,True,12
A,36,kaist_dataset/English/Digital_Camera/(E.S)C-outdoor2/DSC04080.JPG,char_data/A/DSC04080.JPG_2.jpg,1368,480,640,38,288,326,357,393,True,12
A,59,kaist_dataset/English/Digital_Camera/(E.S)C-outdoor2/DSC04120.JPG,char_data/A/DSC04120.JPG_4.jpg,2065,480,640,35,85,120,146,205,True,12
A,54,kaist_dataset/English/Digital_Camera/(E.S)C-outdoor2/DSC04120.JPG,char_data/A/DSC04120.JPG_5.jpg,1998,480,640,37,301,338,149,203,True,12
A,67,kaist_dataset/English/Digital_Camera/(E.S)C-outdoor2/DSC04131.JPG,char_data/A/DSC04131.JPG_2.jpg,5293,480,640,79,318,397,134,201,True,12
A,69,kaist_dataset/English/Digital_Camera/(E.S)C-outdoor2/DSC04410.JPG,char_data/A/DSC04410.JPG_2.jpg,4416,480,640,64,273,337,148,217,True,12
A,61,kaist_dataset/English/Digital_Camera/(E.S)C-outdoor2/DSC04464.JPG,char_data/A/DSC04464.JPG_2.jpg,2318,480,640,38,131,169,317,378,True,12
A,59,kaist_dataset/English/Digital_Camera/(E.S)C-outdoor3/DSC02788.JPG,char_data/A/DSC02788.JPG_2.jpg,2006,480,640,34,204,238,230,289,True,12
A,81,kaist_dataset/English/Digital_Camera/(E.S)C-outdoor3/P1010138.JPG,char_data/A/P1010138.JPG_4.jpg,5751,480,640,71,476,547,74,155,True,12
A,95,kaist_dataset/English/Digital_Camera/(E.S)C-outdoor3/r.jpg,char_data/A/r.jpg_2.jpg,7600,240,320,80,96,176,94,189,True,12
A,48,kaist_dataset/English/Digital_Camera/(E.S)C-outdoor3/s.jpg,char_data/A/s.jpg_2.jpg,1968,240,320,41,183,224,79,127,True,12
A,90,kaist_dataset/English/Digital_Camera/(E.S)C-outdoor3/u.jpg,char_data/A/u.jpg_2.jpg,6030,240,320,67,32,99,64,154,True,12
A,59,kaist_dataset/English/Digital_Camera/(E.S)C-outdoor3/크기변환_%B0%A3%C6%C718_m_starfirm.jpg,char_data/A/크기변환_%B0%A3%C6%C718_m_starfirm.jpg_2.jpg,3009,480,640,51,414,465,203,262,True,12
A,65,kaist_dataset/English/Digital_Camera/(E.S)C-outdoor3/크기변환_P1010028.JPG,char_data/A/크기변환_P1010028.JPG_2.jpg,3055,480,640,47,350,397,170,235,True,12
A,47,kaist_dataset/English/Digital_Camera/(E.S)C-outdoor3/크기변환_P1010076.JPG,char_data/A/크기변환_P1010076.JPG_6.jpg,1833,480,640,39,244,283,125,172,True,12
A,96,kaist_dataset/English/Digital_Camera/(E.S)D-indoor/080119-0009.jpg,char_data/A/080119-0009.jpg_24.jpg,8160,1200,1600,85,839,924,573,669,True,12
A,91,kaist_dataset/English/Digital_Camera/(E.S)D-indoor/080119-0009.jpg,char_data/A/080119-0009.jpg_25.jpg,7280,1200,1600,80,1048,1128,583,674,True,12
A,40,kaist_dataset/English/Digital_Camera/(E.S)D-indoor/080119-0009.jpg,char_data/A/080119-0009.jpg_32.jpg,1160,1200,1600,29,5,34,1071,1111,True,12
A,29,kaist_dataset/English/Digital_Camera/(E.S)D-indoor/308.jpg,char_data/A/308.jpg_4.jpg,696,212,385,24,67,91,47,76,True,12
A,34,kaist_dataset/English/Digital_Camera/(E.S)D-indoor/308.jpg,char_data/A/308.jpg_5.jpg,1020,212,385,30,219,249,49,83,True,12
A,64,kaist_dataset/English/Digital_Camera/(E.S)D-indoor/DSC02769.JPG,char_data/A/DSC02769.JPG_2.jpg,3200,480,640,50,137,187,135,199,True,12
A,129,kaist_dataset/English/Digital_Camera/(E.S)D-indoor/DSC02842.JPG,char_data/A/DSC02842.JPG_2.jpg,13287,480,640,103,460,563,339,468,True,12
A,92,kaist_dataset/English/Digital_Camera/(E.S)D-indoor/DSC02853.JPG,char_data/A/DSC02853.JPG_4.jpg,6348,480,640,69,192,261,126,218,True,12
A,118,kaist_dataset/English/Digital_Camera/(E.S)D-indoor/DSC02860.JPG,char_data/A/DSC02860.JPG_2.jpg,14278,480,640,121,124,245,42,160,True,12
A,53,kaist_dataset/English/Digital_Camera/(E.S)D-indoor/DSC03071.JPG,char_data/A/DSC03071.JPG_2.jpg,2173,480,640,41,361,402,231,284,True,12
A,97,kaist_dataset/English/Digital_Camera/(E.S)D-indoor/DSC03080.JPG,char_data/A/DSC03080.JPG_2.jpg,12804,480,640,132,243,375,113,210,True,12
A,63,kaist_dataset/English/Digital_Camera/(E.S)D-indoor/DSC03091.JPG,char_data/A/DSC03091.JPG_5.jpg,4284,480,640,68,518,586,208,271,True,12
A,41,kaist_dataset/English/Digital_Camera/(E.S)D-indoor/DSC03149.JPG,char_data/A/DSC03149.JPG_6.jpg,1804,480,640,44,52,96,380,421,True,12
A,80,kaist_dataset/English/Digital_Camera/(E.S)D-indoor/DSC03367.JPG,char_data/A/DSC03367.JPG_2.jpg,6080,480,640,76,169,245,34,114,True,12
A,67,kaist_dataset/English/Digital_Camera/(E.S)D-indoor/DSC03396.JPG,char_data/A/DSC03396.JPG_4.jpg,3819,480,640,57,533,590,221,288,True,12
A,98,kaist_dataset/English/Digital_Camera/(E.S)D-indoor/DSC03402.JPG,char_data/A/DSC03402.JPG_2.jpg,8134,480,640,83,289,372,182,280,True,12
A,67,kaist_dataset/English/Digital_Camera/(E.S)D-indoor/DSC03403.JPG,char_data/A/DSC03403.JPG_2.jpg,3886,480,640,58,278,336,202,269,True,12
A,31,kaist_dataset/English/Digital_Camera/(E.S)D-indoor/DSC03532.JPG,char_data/A/DSC03532.JPG_16.jpg,620,480,640,20,525,545,376,407,True,12
A,61,kaist_dataset/English/Digital_Camera/(E.S)D-indoor/DSC03883.JPG,char_data/A/DSC03883.JPG_2.jpg,2684,480,640,44,340,384,310,371,True,12
A,76,kaist_dataset/English/Digital_Camera/(E.S)D-indoor/DSC03896.JPG,char_data/A/DSC03896.JPG_2.jpg,3572,480,640,47,190,237,260,336,True,12
A,31,kaist_dataset/English/Digital_Camera/(E.S)D-indoor/DSC03901.JPG,char_data/A/DSC03901.JPG_4.jpg,620,480,640,20,219,239,266,297,True,12
A,56,kaist_dataset/English/Digital_Camera/(E.S)D-indoor/DSC03901.JPG,char_data/A/DSC03901.JPG_5.jpg,2576,480,640,46,368,414,170,226,True,12
A,52,kaist_dataset/English/Digital_Camera/(E.S)D-indoor/DSC03918.JPG,char_data/A/DSC03918.JPG_8.jpg,1612,480,640,31,345,376,409,461,True,12
A,36,kaist_dataset/English/Digital_Camera/(E.S)D-indoor/DSC03935.JPG,char_data/A/DSC03935.JPG_8.jpg,792,480,640,22,308,330,43,79,True,12
A,34,kaist_dataset/English/Digital_Camera/(E.S)D-indoor/DSC03935.JPG,char_data/A/DSC03935.JPG_9.jpg,816,480,640,24,348,372,45,79,True,12
A,37,kaist_dataset/English/Digital_Camera/(E.S)D-indoor/DSC03935.JPG,char_data/A/DSC03935.JPG_10.jpg,814,480,640,22,387,409,48,85,True,12
A,43,kaist_dataset/English/Digital_Camera/(E.S)D-indoor/DSC03935.JPG,char_data/A/DSC03935.JPG_11.jpg,1032,480,640,24,463,487,48,91,True,12
A,43,kaist_dataset/English/Digital_Camera/(E.S)D-indoor/DSC03942.JPG,char_data/A/DSC03942.JPG_4.jpg,1247,480,640,29,428,457,370,413,True,12
A,39,kaist_dataset/English/Digital_Camera/(E.S)D-indoor/DSC03942.JPG,char_data/A/DSC03942.JPG_5.jpg,975,480,640,25,518,543,375,414,True,12
A,78,kaist_dataset/English/Digital_Camera/(E.S)D-indoor/DSC03943.JPG,char_data/A/DSC03943.JPG_4.jpg,4602,480,640,59,384,443,209,287,True,12
A,27,kaist_dataset/English/Digital_Camera/(E.S)D-indoor/DSC03943.JPG,char_data/A/DSC03943.JPG_5.jpg,621,480,640,23,219,242,319,346,True,12
A,66,kaist_dataset/English/Digital_Camera/(E.S)D-indoor/DSC03947.JPG,char_data/A/DSC03947.JPG_6.jpg,3894,480,640,59,463,522,184,250,True,12
A,37,kaist_dataset/English/Digital_Camera/(E.S)D-indoor/DSC03947.JPG,char_data/A/DSC03947.JPG_7.jpg,1110,480,640,30,268,298,418,455,True,12
A,20,kaist_dataset/English/Digital_Camera/(E.S)D-indoor/z.jpg,char_data/A/z.jpg_2.jpg,280,240,320,14,144,158,75,95,True,12
A,15,kaist_dataset/English/Digital_Camera/(E.S)E-night/111.jpg,char_data/A/111.jpg_4.jpg,135,480,640,9,232,241,285,300,True,12
A,16,kaist_dataset/English/Digital_Camera/(E.S)E-night/111.jpg,char_data/A/111.jpg_5.jpg,192,480,640,12,305,317,269,285,True,12
A,90,kaist_dataset/English/Digital_Camera/(E.S)E-night/DSC02641.JPG,char_data/A/DSC02641.JPG_2.jpg,5220,480,640,58,197,255,268,358,True,12
A,99,kaist_dataset/English/Digital_Camera/(E.S)E-night/DSC02674.JPG,char_data/A/DSC02674.JPG_2.jpg,8514,480,640,86,312,398,198,297,True,12
A,92,kaist_dataset/English/Digital_Camera/(E.S)E-night/DSC02675.JPG,char_data/A/DSC02675.JPG_2.jpg,6624,480,640,72,132,204,176,268,True,12
A,34,kaist_dataset/English/Digital_Camera/(E.S)E-night/t.jpg,char_data/A/t.jpg_2.jpg,816,240,320,24,129,153,69,103,True,12
A,90,kaist_dataset/English/Digital_Camera/(E.S)E-night/크기변환_P1010163.JPG,char_data/A/크기변환_P1010163.JPG_2.jpg,7920,480,640,88,15,103,84,174,True,12
A,63,kaist_dataset/English/Digital_Camera/(E.S)F-others/032.jpg,char_data/A/032.jpg_2.jpg,3339,245,422,53,300,353,101,164,True,12
A,122,kaist_dataset/English/Digital_Camera/(E.S)F-others/080116-0058.jpg,char_data/A/080116-0058.jpg_6.jpg,4270,1200,1600,35,828,863,594,716,True,12
A,148,kaist_dataset/English/Digital_Camera/(E.S)F-others/080116-0058.jpg,char_data/A/080116-0058.jpg_7.jpg,7992,1200,1600,54,815,869,724,872,True,12
A,70,kaist_dataset/English/Digital_Camera/(E.S)F-others/080119-0007.jpg,char_data/A/080119-0007.jpg_8.jpg,3290,1200,1600,47,709,756,770,840,True,12
A,401,kaist_dataset/English/Digital_Camera/(E.S)F-others/080119-0011.jpg,char_data/A/080119-0011.jpg_2.jpg,87017,1200,1600,217,597,814,314,715,True,12
A,195,kaist_dataset/English/Digital_Camera/(E.S)F-others/080119-0013.jpg,char_data/A/080119-0013.jpg_2.jpg,29250,1200,1600,150,565,715,566,761,True,12
A,190,kaist_dataset/English/Digital_Camera/(E.S)F-others/080119-0014.jpg,char_data/A/080119-0014.jpg_2.jpg,29260,1200,1600,154,319,473,390,580,True,12
A,213,kaist_dataset/English/Digital_Camera/(E.S)F-others/080119-0016.jpg,char_data/A/080119-0016.jpg_2.jpg,31524,1200,1600,148,1246,1394,583,796,True,12
A,55,kaist_dataset/English/Digital_Camera/(E.S)F-others/086.jpg,char_data/A/086.jpg_2.jpg,1265,480,640,23,243,266,296,351,True,12
A,126,kaist_dataset/English/Digital_Camera/(E.S)F-others/2007-12-09-day-exterior-047.jpg,char_data/A/2007-12-09-day-exterior-047.jpg_4.jpg,12852,1200,1600,102,344,446,440,566,True,12
A,61,kaist_dataset/English/Digital_Camera/(E.S)F-others/2007-12-09-day-exterior-047.jpg,char_data/A/2007-12-09-day-exterior-047.jpg_5.jpg,2806,1200,1600,46,1361,1407,541,602,True,12
A,49,kaist_dataset/English/Digital_Camera/(E.S)F-others/DSC02884.JPG,char_data/A/DSC02884.JPG_4.jpg,1715,480,640,35,147,182,99,148,True,12
A,43,kaist_dataset/English/Digital_Camera/(E.S)F-others/DSC02884.JPG,char_data/A/DSC02884.JPG_5.jpg,1720,480,640,40,381,421,54,97,True,12
A,88,kaist_dataset/English/Digital_Camera/(E.S)F-others/DSC03291.JPG,char_data/A/DSC03291.JPG_2.jpg,4224,480,640,48,192,240,170,258,True,12
A,44,kaist_dataset/English/Digital_Camera/(E.S)F-others/m.jpg,char_data/A/m.jpg_2.jpg,1320,240,320,30,200,230,96,140,True,12
A,43,kaist_dataset/English/Digital_Camera/(E.S)F-others/크기변환_%B0%A3%C6%C716_m_starfirm.jpg,char_data/A/크기변환_%B0%A3%C6%C716_m_starfirm.jpg_4.jpg,1161,480,640,27,304,331,209,252,True,12
A,41,kaist_dataset/English/Digital_Camera/(E.S)F-others/크기변환_%B0%A3%C6%C716_m_starfirm.jpg,char_data/A/크기변환_%B0%A3%C6%C716_m_starfirm.jpg_5.jpg,1025,480,640,25,365,390,218,259,True,12
A,60,kaist_dataset/English/Digital_Camera/(E.S)F-others/크기변환_%B0%A3%C6%C77_m_starfirm.jpg,char_data/A/크기변환_%B0%A3%C6%C77_m_starfirm.jpg_4.jpg,2340,480,640,39,323,362,109,169,True,12
A,60,kaist_dataset/English/Digital_Camera/(E.S)F-others/크기변환_%B0%A3%C6%C77_m_starfirm.jpg,char_data/A/크기변환_%B0%A3%C6%C77_m_starfirm.jpg_5.jpg,2220,480,640,37,283,320,163,223,True,12
A,112,kaist_dataset/English/Mobile_Phone/(E.M)A-outdoor/P090911064.jpg,char_data/A/P090911064.jpg_2.jpg,14448,480,640,129,307,436,121,233,True,12
A,115,kaist_dataset/English/Mobile_Phone/(E.M)A-outdoor/P090911085.jpg,char_data/A/P090911085.jpg_2.jpg,12075,480,640,105,28,133,120,235,True,12
A,78,kaist_dataset/English/Mobile_Phone/(E.M)B-indoor/P090902018.jpg,char_data/A/P090902018.jpg_4.jpg,3354,480,640,43,365,408,59,137,True,12
A,118,kaist_dataset/English/Mobile_Phone/(E.M)B-indoor/P090903002.jpg,char_data/A/P090903002.jpg_2.jpg,13334,480,640,113,10,123,278,396,True,12
A,102,kaist_dataset/English/Mobile_Phone/(E.M)B-indoor/P090911086.jpg,char_data/A/P090911086.jpg_2.jpg,10098,480,640,99,11,110,226,328,True,12
A,133,kaist_dataset/English/Mobile_Phone/(E.M)C-bookCover/P090831037.jpg,char_data/A/P090831037.jpg_2.jpg,14364,480,640,108,60,168,50,183,True,12
A,132,kaist_dataset/English/Mobile_Phone/(E.M)C-bookCover/P090831039.jpg,char_data/A/P090831039.jpg_2.jpg,15312,480,640,116,20,136,216,348,True,12
A,83,kaist_dataset/English/Mobile_Phone/(E.M)C-bookCover/P090831042.jpg,char_data/A/P090831042.jpg_2.jpg,4648,480,640,56,342,398,194,277,True,12
A,65,kaist_dataset/English/Mobile_Phone/(E.M)C-bookCover/P090831075.jpg,char_data/A/P090831075.jpg_4.jpg,3770,480,640,58,509,567,158,223,True,12
A,63,kaist_dataset/English/Mobile_Phone/(E.M)C-bookCover/P090831075.jpg,char_data/A/P090831075.jpg_5.jpg,3276,480,640,52,348,400,282,345,True,12
A,47,kaist_dataset/English/Mobile_Phone/(E.M)C-bookCover/P090903015.jpg,char_data/A/P090903015.jpg_2.jpg,1833,480,640,39,234,273,148,195,True,12
A,73,kaist_dataset/English/Mobile_Phone/(E.M)C-bookCover/P090903041.jpg,char_data/A/P090903041.jpg_2.jpg,5110,480,640,70,6,76,11,84,True,12
A,100,kaist_dataset/English/Mobile_Phone/(E.M)C-bookCover/P090903050.jpg,char_data/A/P090903050.jpg_2.jpg,9000,480,640,90,244,334,83,183,True,12
A,59,kaist_dataset/English/Mobile_Phone/(E.M)C-bookCover/P090903054.jpg,char_data/A/P090903054.jpg_5.jpg,1829,480,640,31,140,171,354,413,True,12
A,74,kaist_dataset/English/Mobile_Phone/(E.M)C-bookCover/P090903055.jpg,char_data/A/P090903055.jpg_2.jpg,6068,480,640,82,396,478,166,240,True,12
A,80,kaist_dataset/English/Mobile_Phone/(E.M)C-bookCover/P090903056.jpg,char_data/A/P090903056.jpg_2.jpg,7840,480,640,98,387,485,308,388,True,12
A,81,kaist_dataset/English/Mobile_Phone/(E.M)C-bookCover/P090903071.jpg,char_data/A/P090903071.jpg_8.jpg,5103,480,640,63,176,239,141,222,True,12
A,69,kaist_dataset/English/Mobile_Phone/(E.M)C-bookCover/P090903071.jpg,char_data/A/P090903071.jpg_9.jpg,3726,480,640,54,159,213,223,292,True,12
A,71,kaist_dataset/English/Mobile_Phone/(E.M)C-bookCover/P090903071.jpg,char_data/A/P090903071.jpg_10.jpg,4331,480,640,61,271,332,220,291,True,12
A,33,kaist_dataset/English/Mobile_Phone/(E.M)C-bookCover/P090903071.jpg,char_data/A/P090903071.jpg_11.jpg,990,480,640,30,251,281,301,334,True,12
A,97,kaist_dataset/English/Mobile_Phone/(E.M)C-bookCover/P090903076.jpg,char_data/A/P090903076.jpg_4.jpg,7566,480,640,78,295,373,288,385,True,12
A,50,kaist_dataset/English/Mobile_Phone/(E.M)C-bookCover/P090903076.jpg,char_data/A/P090903076.jpg_5.jpg,2100,480,640,42,208,250,387,437,True,12
A,157,kaist_dataset/English/Mobile_Phone/(E.M)C-bookCover/P090903081.jpg,char_data/A/P090903081.jpg_4.jpg,12089,480,640,77,132,209,99,256,True,12
A,168,kaist_dataset/English/Mobile_Phone/(E.M)C-bookCover/P090903081.jpg,char_data/A/P090903081.jpg_5.jpg,14616,480,640,87,498,585,111,279,True,12
A,105,kaist_dataset/English/Mobile_Phone/(E.M)C-bookCover/P090905007.jpg,char_data/A/P090905007.jpg_4.jpg,9450,480,640,90,15,105,143,248,True,12
A,82,kaist_dataset/English/Mobile_Phone/(E.M)C-bookCover/P090905007.jpg,char_data/A/P090905007.jpg_5.jpg,5084,480,640,62,428,490,170,252,True,12
A,17,kaist_dataset/Korean/Digital_Camera/E-night/103.jpg,char_data/A/103.jpg_2.jpg,255,480,640,15,398,413,154,171,True,12
A,19,kaist_dataset/Korean/Digital_Camera/G-others/5.jpg,char_data/A/5.jpg_6.jpg,228,553,798,12,43,55,38,57,True,12
A,18,kaist_dataset/Korean/Digital_Camera/G-others/5.jpg,char_data/A/5.jpg_7.jpg,234,553,798,13,107,120,39,57,True,12
A,17,kaist_dataset/Korean/Digital_Camera/G-others/5.jpg,char_data/A/5.jpg_8.jpg,221,553,798,13,138,151,39,56,True,12
A,31,kaist_dataset/Korean/Digital_Camera/outdoor2/2007-12-08-day-101.jpg,char_data/A/2007-12-08-day-101.jpg_5.jpg,620,1200,1600,20,294,314,1051,1082,True,12
A,71,kaist_dataset/Korean/Digital_Camera/outdoor2/2007-12-09-day-exterior-016.jpg,char_data/A/2007-12-09-day-exterior-016.jpg_2.jpg,4331,1200,1600,61,4,65,730,801,True,12
A,53,kaist_dataset/Korean/Digital_Camera/outdoor2/2007-12-09-day-exterior-035.jpg,char_data/A/2007-12-09-day-exterior-035.jpg_2.jpg,1749,1200,1600,33,1135,1168,719,772,True,12
A,34,kaist_dataset/Mixed/Digital_Camera/(C.S)A-shadow/DSC02568.JPG,char_data/A/DSC02568.JPG_4.jpg,1122,480,640,33,121,154,143,177,True,12
A,33,kaist_dataset/Mixed/Digital_Camera/(C.S)A-shadow/DSC02624.JPG,char_data/A/DSC02624.JPG_4.jpg,627,480,640,19,192,211,396,429,True,12
A,117,kaist_dataset/Mixed/Digital_Camera/(C.S)C-outdoor1/008.JPG,char_data/A/008.JPG_4.jpg,7020,480,640,60,114,174,136,253,True,12
A,126,kaist_dataset/Mixed/Digital_Camera/(C.S)C-outdoor1/008.JPG,char_data/A/008.JPG_5.jpg,7812,480,640,62,401,463,132,258,True,12
A,62,kaist_dataset/Mixed/Digital_Camera/(C.S)C-outdoor1/014.JPG,char_data/A/014.JPG_2.jpg,1674,480,640,27,176,203,198,260,True,12
A,25,kaist_dataset/Mixed/Digital_Camera/(C.S)C-outdoor1/021.JPG,char_data/A/021.JPG_5.jpg,350,480,640,14,465,479,206,231,True,12
A,91,kaist_dataset/Mixed/Digital_Camera/(C.S)C-outdoor1/038.JPG,char_data/A/038.JPG_2.jpg,4004,480,640,44,495,539,211,302,True,12
A,72,kaist_dataset/Mixed/Digital_Camera/(C.S)C-outdoor1/046.JPG,char_data/A/046.JPG_2.jpg,4248,480,640,59,95,154,205,277,True,12
A,144,kaist_dataset/Mixed/Digital_Camera/(C.S)C-outdoor1/049.JPG,char_data/A/049.JPG_2.jpg,8064,480,640,56,413,469,177,321,True,12
A,32,kaist_dataset/Mixed/Digital_Camera/(C.S)C-outdoor1/054.JPG,char_data/A/054.JPG_2.jpg,800,480,640,25,351,376,273,305,True,12
A,50,kaist_dataset/Mixed/Digital_Camera/(C.S)C-outdoor1/080119-0006.jpg,char_data/A/080119-0006.jpg_4.jpg,2850,1200,1600,57,468,525,737,787,True,12
A,59,kaist_dataset/Mixed/Digital_Camera/(C.S)C-outdoor1/080119-0006.jpg,char_data/A/080119-0006.jpg_5.jpg,3658,1200,1600,62,750,812,733,792,True,12
A,66,kaist_dataset/Mixed/Digital_Camera/(C.S)C-outdoor1/080119-0008.jpg,char_data/A/080119-0008.jpg_2.jpg,2640,1200,1600,40,1203,1243,655,721,True,12
A,178,kaist_dataset/Mixed/Digital_Camera/(C.S)C-outdoor1/080119-0017.jpg,char_data/A/080119-0017.jpg_2.jpg,21538,1200,1600,121,879,1000,552,730,True,12
A,80,kaist_dataset/Mixed/Digital_Camera/(C.S)C-outdoor1/080119-0027.jpg,char_data/A/080119-0027.jpg_2.jpg,4400,1200,1600,55,697,752,720,800,True,12
A,133,kaist_dataset/Mixed/Digital_Camera/(C.S)C-outdoor1/080119-0037.jpg,char_data/A/080119-0037.jpg_2.jpg,11571,1200,1600,87,642,729,861,994,True,12
A,27,kaist_dataset/Mixed/Digital_Camera/(C.S)C-outdoor1/090.JPG,char_data/A/090.JPG_4.jpg,702,480,640,26,414,440,364,391,True,12
A,55,kaist_dataset/Mixed/Digital_Camera/(C.S)C-outdoor1/1.JPG,char_data/A/1.JPG_11.jpg,1980,576,768,36,528,564,281,336,True,12
A,134,kaist_dataset/Mixed/Digital_Camera/(C.S)C-outdoor1/113.JPG,char_data/A/113.JPG_2.jpg,7772,480,640,58,200,258,79,213,True,12
A,28,kaist_dataset/Mixed/Digital_Camera/(C.S)C-outdoor1/121.JPG,char_data/A/121.JPG_2.jpg,532,480,640,19,73,92,216,244,True,12
A,22,kaist_dataset/Mixed/Digital_Camera/(C.S)C-outdoor1/135.JPG,char_data/A/135.JPG_4.jpg,374,480,640,17,295,312,199,221,True,12
A,22,kaist_dataset/Mixed/Digital_Camera/(C.S)C-outdoor1/135.JPG,char_data/A/135.JPG_5.jpg,418,480,640,19,327,346,197,219,True,12
A,75,kaist_dataset/Mixed/Digital_Camera/(C.S)C-outdoor1/2.JPG,char_data/A/2.JPG_10.jpg,3375,576,768,45,298,343,208,283,True,12
A,63,kaist_dataset/Mixed/Digital_Camera/(C.S)C-outdoor1/2.JPG,char_data/A/2.JPG_11.jpg,2772,576,768,44,385,429,208,271,True,12
A,27,kaist_dataset/Mixed/Digital_Camera/(C.S)C-outdoor1/2.JPG,char_data/A/2.JPG_14.jpg,324,576,768,12,539,551,369,396,True,12
A,61,kaist_dataset/Mixed/Digital_Camera/(C.S)C-outdoor1/2007-12-08-day-091.jpg,char_data/A/2007-12-08-day-091.jpg_4.jpg,2928,1200,1600,48,285,333,608,669,True,12
A,64,kaist_dataset/Mixed/Digital_Camera/(C.S)C-outdoor1/2007-12-08-day-091.jpg,char_data/A/2007-12-08-day-091.jpg_5.jpg,3520,1200,1600,55,574,629,596,660,True,12
A,39,kaist_dataset/Mixed/Digital_Camera/(C.S)C-outdoor1/2007-12-08-day-103.jpg,char_data/A/2007-12-08-day-103.jpg_4.jpg,1209,1200,1600,31,556,587,610,649,True,12
A,42,kaist_dataset/Mixed/Digital_Camera/(C.S)C-outdoor1/2007-12-08-day-103.jpg,char_data/A/2007-12-08-day-103.jpg_5.jpg,1386,1200,1600,33,658,691,618,660,True,12
A,54,kaist_dataset/Mixed/Digital_Camera/(C.S)C-outdoor1/2007-12-08-day-130.jpg,char_data/A/2007-12-08-day-130.jpg_2.jpg,2322,1200,1600,43,774,817,694,748,True,12
A,81,kaist_dataset/Mixed/Digital_Camera/(C.S)C-outdoor1/2007-12-09-day-exterior-051.jpg,char_data/A/2007-12-09-day-exterior-051.jpg_8.jpg,7452,1200,1600,92,754,846,377,458,True,12
A,76,kaist_dataset/Mixed/Digital_Camera/(C.S)C-outdoor1/2007-12-09-day-exterior-051.jpg,char_data/A/2007-12-09-day-exterior-051.jpg_9.jpg,7752,1200,1600,102,914,1016,376,452,True,12
A,88,kaist_dataset/Mixed/Digital_Camera/(C.S)C-outdoor1/2007-12-09-day-exterior-051.jpg,char_data/A/2007-12-09-day-exterior-051.jpg_10.jpg,7920,1200,1600,90,193,283,1093,1181,True,12
A,83,kaist_dataset/Mixed/Digital_Camera/(C.S)C-outdoor1/2007-12-09-day-exterior-051.jpg,char_data/A/2007-12-09-day-exterior-051.jpg_11.jpg,9628,1200,1600,116,1361,1477,1103,1186,True,12
A,48,kaist_dataset/Mixed/Digital_Camera/(C.S)C-outdoor1/3.JPG,char_data/A/3.JPG_2.jpg,1056,576,768,22,636,658,417,465,True,12
A,32,kaist_dataset/Mixed/Digital_Camera/(C.S)C-outdoor1/DSC02240.JPG,char_data/A/DSC02240.JPG_2.jpg,960,480,640,30,254,284,281,313,True,12
A,121,kaist_dataset/Mixed/Digital_Camera/(C.S)C-outdoor1/P1010008.JPG,char_data/A/P1010008.JPG_4.jpg,13431,480,640,111,213,324,219,340,True,12
A,34,kaist_dataset/Mixed/Digital_Camera/(C.S)C-outdoor2/DSC02385.JPG,char_data/A/DSC02385.JPG_4.jpg,612,480,640,18,498,516,137,171,True,12
A,33,kaist_dataset/Mixed/Digital_Camera/(C.S)C-outdoor2/DSC02419.JPG,char_data/A/DSC02419.JPG_4.jpg,990,480,640,30,117,147,208,241,True,12
A,31,kaist_dataset/Mixed/Digital_Camera/(C.S)C-outdoor2/DSC02419.JPG,char_data/A/DSC02419.JPG_5.jpg,992,480,640,32,182,214,210,241,True,12
A,20,kaist_dataset/Mixed/Digital_Camera/(C.S)C-outdoor2/DSC02421.JPG,char_data/A/DSC02421.JPG_10.jpg,620,480,640,31,403,434,210,230,True,12
A,24,kaist_dataset/Mixed/Digital_Camera/(C.S)C-outdoor2/DSC02439.JPG,char_data/A/DSC02439.JPG_4.jpg,528,480,640,22,438,460,108,132,True,12
A,23,kaist_dataset/Mixed/Digital_Camera/(C.S)C-outdoor2/DSC02477.JPG,char_data/A/DSC02477.JPG_2.jpg,322,480,640,14,100,114,157,180,True,12
A,50,kaist_dataset/Mixed/Digital_Camera/(C.S)C-outdoor2/DSC02502.JPG,char_data/A/DSC02502.JPG_2.jpg,2050,480,640,41,141,182,81,131,True,12
A,120,kaist_dataset/Mixed/Digital_Camera/(C.S)C-outdoor2/DSC02551.JPG,char_data/A/DSC02551.JPG_2.jpg,12600,480,640,105,161,266,270,390,True,12
A,24,kaist_dataset/Mixed/Digital_Camera/(C.S)C-outdoor2/DSC02555.JPG,char_data/A/DSC02555.JPG_2.jpg,408,480,640,17,111,128,152,176,True,12
A,34,kaist_dataset/Mixed/Digital_Camera/(C.S)C-outdoor2/DSC02568.JPG,char_data/A/DSC02568.JPG_5.jpg,1122,480,640,33,121,154,143,177,True,12
A,33,kaist_dataset/Mixed/Digital_Camera/(C.S)C-outdoor2/DSC02624.JPG,char_data/A/DSC02624.JPG_5.jpg,627,480,640,19,192,211,396,429,True,12
A,49,kaist_dataset/Mixed/Digital_Camera/(C.S)C-outdoor2/DSC02872.JPG,char_data/A/DSC02872.JPG_2.jpg,1323,480,640,27,266,293,217,266,True,12
A,37,kaist_dataset/Mixed/Digital_Camera/(C.S)C-outdoor2/DSC02910.JPG,char_data/A/DSC02910.JPG_4.jpg,703,480,640,19,354,373,54,91,True,12
A,36,kaist_dataset/Mixed/Digital_Camera/(C.S)C-outdoor2/DSC02910.JPG,char_data/A/DSC02910.JPG_5.jpg,828,480,640,23,460,483,55,91,True,12
A,51,kaist_dataset/Mixed/Digital_Camera/(C.S)C-outdoor2/DSC02924.JPG,char_data/A/DSC02924.JPG_2.jpg,2040,480,640,40,210,250,314,365,True,12
A,39,kaist_dataset/Mixed/Digital_Camera/(C.S)C-outdoor3/DSC02989.JPG,char_data/A/DSC02989.JPG_5.jpg,1170,480,640,30,262,292,267,306,True,12
A,162,kaist_dataset/Mixed/Digital_Camera/(C.S)C-outdoor3/DSC03006.JPG,char_data/A/DSC03006.JPG_4.jpg,14256,480,640,88,255,343,97,259,True,12
A,143,kaist_dataset/Mixed/Digital_Camera/(C.S)C-outdoor3/DSC03006.JPG,char_data/A/DSC03006.JPG_5.jpg,9867,480,640,69,568,637,117,260,True,12
A,44,kaist_dataset/Mixed/Digital_Camera/(C.S)C-outdoor3/DSC03020.JPG,char_data/A/DSC03020.JPG_6.jpg,924,480,640,21,288,309,255,299,True,12
A,39,kaist_dataset/Mixed/Digital_Camera/(C.S)C-outdoor3/DSC03020.JPG,char_data/A/DSC03020.JPG_7.jpg,975,480,640,25,401,426,260,299,True,12
A,30,kaist_dataset/Mixed/Digital_Camera/(C.S)C-outdoor3/DSC03020.JPG,char_data/A/DSC03020.JPG_8.jpg,690,480,640,23,476,499,267,297,True,12
A,23,kaist_dataset/Mixed/Digital_Camera/(C.S)C-outdoor3/DSC03033.JPG,char_data/A/DSC03033.JPG_2.jpg,368,480,640,16,113,129,127,150,True,12
A,37,kaist_dataset/Mixed/Digital_Camera/(C.S)C-outdoor3/DSC03035.JPG,char_data/A/DSC03035.JPG_2.jpg,666,480,640,18,266,284,364,401,True,12
A,67,kaist_dataset/Mixed/Digital_Camera/(C.S)C-outdoor3/DSC03048.JPG,char_data/A/DSC03048.JPG_2.jpg,2881,480,640,43,376,419,128,195,True,12
A,41,kaist_dataset/Mixed/Digital_Camera/(C.S)C-outdoor3/DSC03061.JPG,char_data/A/DSC03061.JPG_2.jpg,1804,480,640,44,355,399,157,198,True,12
A,78,kaist_dataset/Mixed/Digital_Camera/(C.S)C-outdoor3/DSC03164.JPG,char_data/A/DSC03164.JPG_2.jpg,5850,480,640,75,140,215,80,158,True,12
A,121,kaist_dataset/Mixed/Digital_Camera/(C.S)C-outdoor3/DSC03186.JPG,char_data/A/DSC03186.JPG_2.jpg,14762,480,640,122,367,489,33,154,True,12
A,35,kaist_dataset/Mixed/Digital_Camera/(C.S)C-outdoor3/DSC03209.JPG,char_data/A/DSC03209.JPG_6.jpg,1050,480,640,30,175,205,415,450,True,12
A,39,kaist_dataset/Mixed/Digital_Camera/(C.S)C-outdoor3/DSC03210.JPG,char_data/A/DSC03210.JPG_4.jpg,663,480,640,17,157,174,143,182,True,12
A,105,kaist_dataset/Mixed/Digital_Camera/(C.S)C-outdoor3/DSC03217.JPG,char_data/A/DSC03217.JPG_2.jpg,15540,480,640,148,36,184,222,327,True,12
A,99,kaist_dataset/Mixed/Digital_Camera/(C.S)C-outdoor3/DSC03247.JPG,char_data/A/DSC03247.JPG_2.jpg,5643,480,640,57,136,193,135,234,True,12
A,47,kaist_dataset/Mixed/Digital_Camera/(C.S)C-outdoor3/DSC03249.JPG,char_data/A/DSC03249.JPG_2.jpg,1551,480,640,33,195,228,238,285,True,12
A,26,kaist_dataset/Mixed/Digital_Camera/(C.S)C-outdoor3/DSC03255.JPG,char_data/A/DSC03255.JPG_2.jpg,364,480,640,14,524,538,178,204,True,12
A,119,kaist_dataset/Mixed/Digital_Camera/(C.S)C-outdoor3/DSC03259.JPG,char_data/A/DSC03259.JPG_2.jpg,14399,480,640,121,396,517,66,185,True,12
A,59,kaist_dataset/Mixed/Digital_Camera/(C.S)C-outdoor3/DSC03283.JPG,char_data/A/DSC03283.JPG_2.jpg,3186,480,640,54,184,238,72,131,True,12
A,63,kaist_dataset/Mixed/Digital_Camera/(C.S)C-outdoor3/DSC03306.JPG,char_data/A/DSC03306.JPG_2.jpg,2142,480,640,34,426,460,391,454,True,12
A,72,kaist_dataset/Mixed/Digital_Camera/(C.S)C-outdoor3/DSC03415.JPG,char_data/A/DSC03415.JPG_2.jpg,2592,480,640,36,363,399,160,232,True,12
A,81,kaist_dataset/Mixed/Digital_Camera/(C.S)C-outdoor3/DSC03422.JPG,char_data/A/DSC03422.JPG_7.jpg,3402,480,640,42,271,313,239,320,True,12
A,48,kaist_dataset/Mixed/Digital_Camera/(C.S)C-outdoor4/DSC03531.JPG,char_data/A/DSC03531.JPG_2.jpg,1968,480,640,41,437,478,350,398,True,12
A,89,kaist_dataset/Mixed/Digital_Camera/(C.S)C-outdoor4/DSC03571.JPG,char_data/A/DSC03571.JPG_4.jpg,5429,480,640,61,414,475,186,275,True,12
A,74,kaist_dataset/Mixed/Digital_Camera/(C.S)C-outdoor4/DSC03640.JPG,char_data/A/DSC03640.JPG_2.jpg,4440,480,640,60,448,508,304,378,True,12
A,53,kaist_dataset/Mixed/Digital_Camera/(C.S)C-outdoor4/DSC03666.JPG,char_data/A/DSC03666.JPG_2.jpg,2067,480,640,39,26,65,143,196,True,12
A,63,kaist_dataset/Mixed/Digital_Camera/(C.S)C-outdoor4/DSC03673.JPG,char_data/A/DSC03673.JPG_2.jpg,2331,480,640,37,135,172,182,245,True,12
A,40,kaist_dataset/Mixed/Digital_Camera/(C.S)C-outdoor4/DSC03679.JPG,char_data/A/DSC03679.JPG_2.jpg,920,480,640,23,57,80,96,136,True,12
A,69,kaist_dataset/Mixed/Digital_Camera/(C.S)C-outdoor4/DSC03687.JPG,char_data/A/DSC03687.JPG_8.jpg,4071,480,640,59,278,337,324,393,True,12
A,67,kaist_dataset/Mixed/Digital_Camera/(C.S)C-outdoor4/DSC03687.JPG,char_data/A/DSC03687.JPG_9.jpg,3417,480,640,51,392,443,323,390,True,12
A,23,kaist_dataset/Mixed/Digital_Camera/(C.S)C-outdoor4/DSC03687.JPG,char_data/A/DSC03687.JPG_10.jpg,368,480,640,16,174,190,296,319,True,12
A,29,kaist_dataset/Mixed/Digital_Camera/(C.S)C-outdoor4/DSC03687.JPG,char_data/A/DSC03687.JPG_11.jpg,435,480,640,15,220,235,294,323,True,12
A,42,kaist_dataset/Mixed/Digital_Camera/(C.S)C-outdoor4/DSC03711.JPG,char_data/A/DSC03711.JPG_2.jpg,1008,480,640,24,384,408,381,423,True,12
A,36,kaist_dataset/Mixed/Digital_Camera/(C.S)C-outdoor4/DSC03716.JPG,char_data/A/DSC03716.JPG_4.jpg,468,480,640,13,389,402,237,273,True,12
A,34,kaist_dataset/Mixed/Digital_Camera/(C.S)C-outdoor4/DSC03716.JPG,char_data/A/DSC03716.JPG_5.jpg,442,480,640,13,414,427,239,273,True,12
A,46,kaist_dataset/Mixed/Digital_Camera/(C.S)C-outdoor4/DSC03781.JPG,char_data/A/DSC03781.JPG_2.jpg,3404,480,640,74,174,248,217,263,True,12
A,29,kaist_dataset/Mixed/Digital_Camera/(C.S)C-outdoor5/DSC03829.JPG,char_data/A/DSC03829.JPG_2.jpg,551,480,640,19,303,322,178,207,True,12
A,40,kaist_dataset/Mixed/Digital_Camera/(C.S)C-outdoor5/DSC03837.JPG,char_data/A/DSC03837.JPG_2.jpg,1200,480,640,30,244,274,379,419,True,12
A,55,kaist_dataset/Mixed/Digital_Camera/(C.S)C-outdoor5/DSC04014.JPG,char_data/A/DSC04014.JPG_2.jpg,2090,480,640,38,232,270,99,154,True,12
A,22,kaist_dataset/Mixed/Digital_Camera/(C.S)C-outdoor5/DSC04031.JPG,char_data/A/DSC04031.JPG_2.jpg,242,480,640,11,433,444,384,406,True,12
A,49,kaist_dataset/Mixed/Digital_Camera/(C.S)C-outdoor5/DSC04055.JPG,char_data/A/DSC04055.JPG_4.jpg,1813,480,640,37,294,331,179,228,True,12
A,108,kaist_dataset/Mixed/Digital_Camera/(C.S)C-outdoor5/DSC04055.JPG,char_data/A/DSC04055.JPG_5.jpg,10260,480,640,95,184,279,245,353,False,12
A,30,kaist_dataset/Mixed/Digital_Camera/(C.S)C-outdoor5/DSC04056.JPG,char_data/A/DSC04056.JPG_2.jpg,870,480,640,29,147,176,284,314,False,12
A,55,kaist_dataset/Mixed/Digital_Camera/(C.S)C-outdoor5/DSC04060.JPG,char_data/A/DSC04060.JPG_2.jpg,2090,480,640,38,314,352,179,234,False,12
A,25,kaist_dataset/Mixed/Digital_Camera/(C.S)C-outdoor5/DSC04091.JPG,char_data/A/DSC04091.JPG_2.jpg,475,480,640,19,321,340,428,453,False,12
A,40,kaist_dataset/Mixed/Digital_Camera/(C.S)C-outdoor5/DSC04098.JPG,char_data/A/DSC04098.JPG_4.jpg,1640,480,640,41,133,174,91,131,False,12
A,35,kaist_dataset/Mixed/Digital_Camera/(C.S)C-outdoor5/DSC04098.JPG,char_data/A/DSC04098.JPG_5.jpg,1190,480,640,34,216,250,78,113,False,12
A,54,kaist_dataset/Mixed/Digital_Camera/(C.S)C-outdoor5/DSC04119.JPG,char_data/A/DSC04119.JPG_2.jpg,2106,480,640,39,381,420,125,179,False,12
A,50,kaist_dataset/Mixed/Digital_Camera/(C.S)C-outdoor5/DSC04305.JPG,char_data/A/DSC04305.JPG_4.jpg,1850,480,640,37,360,397,81,131,False,12
A,51,kaist_dataset/Mixed/Digital_Camera/(C.S)C-outdoor5/DSC04305.JPG,char_data/A/DSC04305.JPG_5.jpg,1581,480,640,31,471,502,79,130,False,12
A,43,kaist_dataset/Mixed/Digital_Camera/(C.S)C-outdoor5/DSC04312.JPG,char_data/A/DSC04312.JPG_2.jpg,1290,480,640,30,360,390,103,146,False,12
A,37,kaist_dataset/Mixed/Digital_Camera/(C.S)C-outdoor5/DSC04338.JPG,char_data/A/DSC04338.JPG_8.jpg,851,480,640,23,119,142,197,234,False,12
A,40,kaist_dataset/Mixed/Digital_Camera/(C.S)C-outdoor5/DSC04338.JPG,char_data/A/DSC04338.JPG_9.jpg,1400,480,640,35,246,281,197,237,False,12
A,26,kaist_dataset/Mixed/Digital_Camera/(C.S)C-outdoor5/DSC04357.JPG,char_data/A/DSC04357.JPG_8.jpg,546,480,640,21,244,265,352,378,False,12
A,36,kaist_dataset/Mixed/Digital_Camera/(C.S)C-outdoor5/DSC04434.JPG,char_data/A/DSC04434.JPG_10.jpg,576,480,640,16,177,193,266,302,False,12
A,30,kaist_dataset/Mixed/Digital_Camera/(C.S)C-outdoor5/DSC04434.JPG,char_data/A/DSC04434.JPG_11.jpg,540,480,640,18,215,233,273,303,False,12
A,35,kaist_dataset/Mixed/Digital_Camera/(C.S)C-outdoor5/DSC04434.JPG,char_data/A/DSC04434.JPG_12.jpg,490,480,640,14,296,310,270,305,False,12
A,37,kaist_dataset/Mixed/Digital_Camera/(C.S)C-outdoor5/DSC04434.JPG,char_data/A/DSC04434.JPG_13.jpg,962,480,640,26,213,239,388,425,False,12
A,35,kaist_dataset/Mixed/Digital_Camera/(C.S)C-outdoor5/DSC04434.JPG,char_data/A/DSC04434.JPG_14.jpg,840,480,640,24,267,291,389,424,False,12
A,32,kaist_dataset/Mixed/Digital_Camera/(C.S)C-outdoor5/P1010004.JPG,char_data/A/P1010004.JPG_2.jpg,1504,480,640,47,497,544,249,281,False,12
A,234,kaist_dataset/Mixed/Digital_Camera/(C.S)C-outdoor6/080116-0057.jpg,char_data/A/080116-0057.jpg_6.jpg,41418,1200,1600,177,152,329,277,511,False,12
A,52,kaist_dataset/Mixed/Digital_Camera/(C.S)C-outdoor6/117.JPG,char_data/A/117.JPG_2.jpg,3692,480,640,71,83,154,191,243,False,12
A,33,kaist_dataset/Mixed/Digital_Camera/(C.S)C-outdoor6/DSC03324.JPG,char_data/A/DSC03324.JPG_2.jpg,693,480,640,21,39,60,60,93,False,12
A,16,kaist_dataset/Mixed/Digital_Camera/(C.S)C-outdoor6/P1010065.JPG,char_data/A/P1010065.JPG_6.jpg,176,480,640,11,105,116,110,126,False,12
A,22,kaist_dataset/Mixed/Digital_Camera/(C.S)C-outdoor6/P1010065.JPG,char_data/A/P1010065.JPG_7.jpg,308,480,640,14,186,200,107,129,False,12
A,20,kaist_dataset/Mixed/Digital_Camera/(C.S)C-outdoor6/P1010065.JPG,char_data/A/P1010065.JPG_8.jpg,220,480,640,11,227,238,108,128,False,12
A,27,kaist_dataset/Mixed/Digital_Camera/(C.S)C-outdoor6/P1010088.JPG,char_data/A/P1010088.JPG_4.jpg,513,480,640,19,287,306,181,208,False,12
A,28,kaist_dataset/Mixed/Digital_Camera/(C.S)C-outdoor6/P1010088.JPG,char_data/A/P1010088.JPG_5.jpg,672,480,640,24,384,408,178,206,False,12
A,28,kaist_dataset/Mixed/Digital_Camera/(C.S)C-outdoor6/P1010090.JPG,char_data/A/P1010090.JPG_2.jpg,588,480,640,21,222,243,202,230,False,12
A,28,kaist_dataset/Mixed/Digital_Camera/(C.S)C-outdoor6/P1010095.JPG,char_data/A/P1010095.JPG_2.jpg,280,480,640,10,148,158,183,211,False,12
A,53,kaist_dataset/Mixed/Digital_Camera/(C.S)D-indoor1/082.JPG,char_data/A/082.JPG_4.jpg,1908,480,640,36,128,164,174,227,False,12
A,39,kaist_dataset/Mixed/Digital_Camera/(C.S)D-indoor1/DSC02714.JPG,char_data/A/DSC02714.JPG_2.jpg,1599,480,640,41,235,276,75,114,False,12
A,91,kaist_dataset/Mixed/Digital_Camera/(C.S)D-indoor1/DSC02732.JPG,char_data/A/DSC02732.JPG_2.jpg,6734,480,640,74,259,333,139,230,False,12
A,45,kaist_dataset/Mixed/Digital_Camera/(C.S)D-indoor1/DSC02782.JPG,char_data/A/DSC02782.JPG_2.jpg,2340,480,640,52,97,149,177,222,False,12
A,35,kaist_dataset/Mixed/Digital_Camera/(C.S)D-indoor1/DSC02785.JPG,char_data/A/DSC02785.JPG_2.jpg,2100,480,640,60,79,139,244,279,False,12
A,117,kaist_dataset/Mixed/Digital_Camera/(C.S)D-indoor1/DSC02840.JPG,char_data/A/DSC02840.JPG_2.jpg,13455,480,640,115,408,523,236,353,False,12
A,81,kaist_dataset/Mixed/Digital_Camera/(C.S)D-indoor1/DSC03472.JPG,char_data/A/DSC03472.JPG_2.jpg,4617,480,640,57,313,370,18,99,False,12
A,57,kaist_dataset/Mixed/Digital_Camera/(C.S)D-indoor1/DSC03479.JPG,char_data/A/DSC03479.JPG_2.jpg,2508,480,640,44,147,191,275,332,False,12
A,45,kaist_dataset/Mixed/Digital_Camera/(C.S)D-indoor1/DSC03483.JPG,char_data/A/DSC03483.JPG_2.jpg,1440,480,640,32,317,349,374,419,False,12
A,35,kaist_dataset/Mixed/Digital_Camera/(C.S)D-indoor1/DSC03904.JPG,char_data/A/DSC03904.JPG_2.jpg,665,480,640,19,291,310,213,248,False,12
A,43,kaist_dataset/Mixed/Digital_Camera/(C.S)D-indoor1/DSC03980.JPG,char_data/A/DSC03980.JPG_6.jpg,946,480,640,22,236,258,133,176,False,12
A,35,kaist_dataset/Mixed/Digital_Camera/(C.S)D-indoor1/DSC03980.JPG,char_data/A/DSC03980.JPG_7.jpg,840,480,640,24,396,420,147,182,False,12
A,38,kaist_dataset/Mixed/Digital_Camera/(C.S)D-indoor1/DSC03980.JPG,char_data/A/DSC03980.JPG_8.jpg,950,480,640,25,511,536,145,183,False,12
A,45,kaist_dataset/Mixed/Digital_Camera/(C.S)D-indoor1/DSC04183.JPG,char_data/A/DSC04183.JPG_2.jpg,1395,480,640,31,293,324,249,294,False,12
A,42,kaist_dataset/Mixed/Digital_Camera/(C.S)D-indoor1/DSC04203.JPG,char_data/A/DSC04203.JPG_2.jpg,1092,480,640,26,68,94,287,329,False,12
A,178,kaist_dataset/Mixed/Digital_Camera/(C.S)D-indoor1/DSC04223.JPG,char_data/A/DSC04223.JPG_2.jpg,22250,480,640,125,62,187,12,190,False,12
A,51,kaist_dataset/Mixed/Digital_Camera/(C.S)D-indoor2/DSC04421.JPG,char_data/A/DSC04421.JPG_2.jpg,2142,480,640,42,83,125,205,256,False,12
A,77,kaist_dataset/Mixed/Digital_Camera/(C.S)D-indoor2/P090911016.jpg,char_data/A/P090911016.jpg_2.jpg,4851,480,640,63,421,484,305,382,False,12
A,30,kaist_dataset/Mixed/Digital_Camera/(C.S)E-night/DSC02569.JPG,char_data/A/DSC02569.JPG_2.jpg,810,480,640,27,273,300,276,306,False,12
A,43,kaist_dataset/Mixed/Digital_Camera/(C.S)E-night/DSC02574.JPG,char_data/A/DSC02574.JPG_6.jpg,1032,480,640,24,299,323,148,191,False,12
A,66,kaist_dataset/Mixed/Digital_Camera/(C.S)E-night/DSC02660.JPG,char_data/A/DSC02660.JPG_4.jpg,4356,480,640,66,262,328,74,140,False,12
A,32,kaist_dataset/Mixed/Digital_Camera/(C.S)E-night/DSC02660.JPG,char_data/A/DSC02660.JPG_5.jpg,704,480,640,22,347,369,380,412,False,12
A,58,kaist_dataset/Mixed/Digital_Camera/(C.S)E-night/DSC02672.JPG,char_data/A/DSC02672.JPG_4.jpg,2320,480,640,40,74,114,93,151,False,12
A,51,kaist_dataset/Mixed/Digital_Camera/(C.S)E-night/DSC02672.JPG,char_data/A/DSC02672.JPG_5.jpg,1122,480,640,22,476,498,170,221,False,12
A,29,kaist_dataset/Mixed/Digital_Camera/(C.S)E-night/DSC02673.JPG,char_data/A/DSC02673.JPG_2.jpg,319,480,640,11,422,433,306,335,False,12
A,75,kaist_dataset/Mixed/Digital_Camera/(C.S)E-night/DSC03031.JPG,char_data/A/DSC03031.JPG_2.jpg,4125,480,640,55,350,405,66,141,False,12
A,38,kaist_dataset/Mixed/Digital_Camera/(C.S)E-night/DSC03871.JPG,char_data/A/DSC03871.JPG_6.jpg,874,480,640,23,243,266,183,221,False,12
A,39,kaist_dataset/Mixed/Digital_Camera/(C.S)E-night/DSC03871.JPG,char_data/A/DSC03871.JPG_7.jpg,819,480,640,21,405,426,188,227,False,12
A,32,kaist_dataset/Mixed/Digital_Camera/(C.S)E-night/DSC03871.JPG,char_data/A/DSC03871.JPG_8.jpg,576,480,640,18,478,496,195,227,False,12
A,52,kaist_dataset/Mixed/Digital_Camera/(C.S)F-others/085.jpg,char_data/A/085.jpg_2.jpg,1664,480,640,32,440,472,164,216,False,12
A,32,kaist_dataset/Mixed/Digital_Camera/(C.S)F-others/097.jpg,char_data/A/097.jpg_2.jpg,544,480,640,17,196,213,163,195,False,12
A,164,kaist_dataset/Mixed/Digital_Camera/(C.S)F-others/2007-12-09-day-exterior-032.jpg,char_data/A/2007-12-09-day-exterior-032.jpg_2.jpg,13940,1600,1200,85,539,624,977,1141,False,12
A,124,kaist_dataset/Mixed/Digital_Camera/(C.S)F-others/DSC02504.JPG,char_data/A/DSC02504.JPG_8.jpg,14756,480,640,119,47,166,135,259,False,12
A,47,kaist_dataset/Mixed/Digital_Camera/(C.S)F-others/DSC02504.JPG,char_data/A/DSC02504.JPG_9.jpg,1598,480,640,34,126,160,262,309,False,12
A,42,kaist_dataset/Mixed/Digital_Camera/(C.S)F-others/DSC02504.JPG,char_data/A/DSC02504.JPG_10.jpg,1134,480,640,27,373,400,320,362,False,12
A,35,kaist_dataset/Mixed/Digital_Camera/(C.S)F-others/DSC02504.JPG,char_data/A/DSC02504.JPG_11.jpg,1190,480,640,34,450,484,339,374,False,12
A,62,kaist_dataset/Mixed/Digital_Camera/(C.S)F-others/DSC02611.JPG,char_data/A/DSC02611.JPG_2.jpg,3410,480,640,55,258,313,79,141,False,12
A,39,kaist_dataset/Mixed/Mobile_Phone/(C.M)B-indoor/P090831021.jpg,char_data/A/P090831021.jpg_2.jpg,897,480,640,23,258,281,44,83,False,12
A,45,kaist_dataset/Mixed/Mobile_Phone/(C.M)C-bookCover/P090831115.jpg,char_data/A/P090831115.jpg_4.jpg,1710,480,640,38,215,253,162,207,False,12
A,67,kaist_dataset/Mixed/Mobile_Phone/(C.M)C-bookCover/P090831124.jpg,char_data/A/P090831124.jpg_4.jpg,2948,480,640,44,302,346,110,177,False,12
A,109,kaist_dataset/Mixed/Mobile_Phone/(C.M)C-bookCover/P090831136.jpg,char_data/A/P090831136.jpg_6.jpg,9592,480,640,88,51,139,114,223,False,12
A,113,kaist_dataset/Mixed/Mobile_Phone/(C.M)C-bookCover/P090831136.jpg,char_data/A/P090831136.jpg_7.jpg,11187,480,640,99,226,325,113,226,False,12
A,110,kaist_dataset/Mixed/Mobile_Phone/(C.M)C-bookCover/P090831136.jpg,char_data/A/P090831136.jpg_8.jpg,10670,480,640,97,488,585,120,230,False,12
A,63,kaist_dataset/Mixed/Mobile_Phone/(C.M)C-bookCover/P090903083.jpg,char_data/A/P090903083.jpg_5.jpg,3024,480,640,48,263,311,169,232,False,12
A,98,kaist_dataset/Mixed/Mobile_Phone/(C.M)C-bookCover/P090905002.jpg,char_data/A/P090905002.jpg_2.jpg,8134,480,640,83,130,213,33,131,False,12
S,95,kaist_dataset/English/Digital_Camera/(E.S)A-shadow/DSC02633.JPG,char_data/S/DSC02633.JPG_2.jpg,5985,480,640,63,494,557,187,282,True,28
S,113,kaist_dataset/English/Digital_Camera/(E.S)A-shadow/DSC03077.JPG,char_data/S/DSC03077.JPG_2.jpg,11413,480,640,101,57,158,315,428,True,28
S,121,kaist_dataset/English/Digital_Camera/(E.S)A-shadow/P1010035.JPG,char_data/S/P1010035.JPG_2.jpg,12221,480,640,101,213,314,162,283,True,28
S,38,kaist_dataset/English/Digital_Camera/(E.S)A-shadow/P1010044.JPG,char_data/S/P1010044.JPG_2.jpg,1178,480,640,31,188,219,358,396,True,28
S,205,kaist_dataset/English/Digital_Camera/(E.S)B-light/080116-0059.jpg,char_data/S/080116-0059.jpg_18.jpg,25010,1200,1600,122,927,1049,47,252,True,28
S,227,kaist_dataset/English/Digital_Camera/(E.S)B-light/080116-0059.jpg,char_data/S/080116-0059.jpg_19.jpg,26559,1200,1600,117,695,812,502,729,True,28
S,229,kaist_dataset/English/Digital_Camera/(E.S)B-light/080116-0059.jpg,char_data/S/080116-0059.jpg_20.jpg,26335,1200,1600,115,814,929,504,733,True,28
S,38,kaist_dataset/English/Digital_Camera/(E.S)B-light/080116-0059.jpg,char_data/S/080116-0059.jpg_21.jpg,570,1200,1600,15,489,504,825,863,True,28
S,25,kaist_dataset/English/Digital_Camera/(E.S)B-light/080116-0059.jpg,char_data/S/080116-0059.jpg_22.jpg,350,1200,1600,14,1004,1018,826,851,True,28
S,29,kaist_dataset/English/Digital_Camera/(E.S)B-light/080116-0059.jpg,char_data/S/080116-0059.jpg_23.jpg,406,1200,1600,14,801,815,825,854,True,28
S,29,kaist_dataset/English/Digital_Camera/(E.S)B-light/080116-0059.jpg,char_data/S/080116-0059.jpg_24.jpg,551,1200,1600,19,782,801,799,828,True,28
S,32,kaist_dataset/English/Digital_Camera/(E.S)B-light/080116-0059.jpg,char_data/S/080116-0059.jpg_25.jpg,512,1200,1600,16,541,557,772,804,True,28
S,35,kaist_dataset/English/Digital_Camera/(E.S)B-light/080116-0059.jpg,char_data/S/080116-0059.jpg_26.jpg,840,1200,1600,24,621,645,769,804,True,28
S,70,kaist_dataset/English/Digital_Camera/(E.S)B-light/080119-0038.jpg,char_data/S/080119-0038.jpg_2.jpg,3850,1200,1600,55,1091,1146,684,754,True,28
S,47,kaist_dataset/English/Digital_Camera/(E.S)B-light/DSC03007.JPG,char_data/S/DSC03007.JPG_2.jpg,1363,480,640,29,385,414,277,324,True,28
S,25,kaist_dataset/English/Digital_Camera/(E.S)B-light/v.jpg,char_data/S/v.jpg_2.jpg,400,240,320,16,187,203,56,81,True,28
S,18,kaist_dataset/English/Digital_Camera/(E.S)B-light/x.jpg,char_data/S/x.jpg_2.jpg,288,240,320,16,81,97,116,134,True,28
S,37,kaist_dataset/English/Digital_Camera/(E.S)C-outdoor1/041.JPG,char_data/S/041.JPG_2.jpg,1073,480,640,29,394,423,249,286,True,28
S,47,kaist_dataset/English/Digital_Camera/(E.S)C-outdoor1/064.JPG,char_data/S/064.JPG_2.jpg,1269,480,640,27,267,294,182,229,True,28
S,85,kaist_dataset/English/Digital_Camera/(E.S)C-outdoor1/080116-0064.jpg,char_data/S/080116-0064.jpg_2.jpg,2720,600,800,32,389,421,226,311,True,28
S,69,kaist_dataset/English/Digital_Camera/(E.S)C-outdoor1/080118-0011.jpg,char_data/S/080118-0011.jpg_2.jpg,3381,1200,1600,49,660,709,938,1007,True,28
S,54,kaist_dataset/English/Digital_Camera/(E.S)C-outdoor1/080119-0012.jpg,char_data/S/080119-0012.jpg_2.jpg,1296,1200,1600,24,701,725,579,633,True,28
S,157,kaist_dataset/English/Digital_Camera/(E.S)C-outdoor1/080119-0020.jpg,char_data/S/080119-0020.jpg_2.jpg,20096,1200,1600,128,1032,1160,478,635,True,28
S,47,kaist_dataset/English/Digital_Camera/(E.S)C-outdoor1/089.jpg,char_data/S/089.jpg_2.jpg,705,480,640,15,353,368,284,331,True,28
S,136,kaist_dataset/English/Digital_Camera/(E.S)C-outdoor1/129.JPG,char_data/S/129.JPG_2.jpg,12376,480,640,91,103,194,174,310,True,28
S,188,kaist_dataset/English/Digital_Camera/(E.S)C-outdoor1/2007-12-08-day-015.jpg,char_data/S/2007-12-08-day-015.jpg_6.jpg,34028,1200,1600,181,188,369,445,633,True,28
S,132,kaist_dataset/English/Digital_Camera/(E.S)C-outdoor1/2007-12-09-day-exterior-063.jpg,char_data/S/2007-12-09-day-exterior-063.jpg_2.jpg,9504,1200,1600,72,894,966,428,560,True,28
S,40,kaist_dataset/English/Digital_Camera/(E.S)C-outdoor1/6.jpg,char_data/S/6.jpg_2.jpg,1520,255,731,38,189,227,100,140,True,28
S,100,kaist_dataset/English/Digital_Camera/(E.S)C-outdoor1/DSC02345.JPG,char_data/S/DSC02345.JPG_6.jpg,11400,480,640,114,76,190,131,231,True,28
S,35,kaist_dataset/English/Digital_Camera/(E.S)C-outdoor1/DSC02345.JPG,char_data/S/DSC02345.JPG_7.jpg,1085,480,640,31,79,110,239,274,True,28
S,32,kaist_dataset/English/Digital_Camera/(E.S)C-outdoor1/DSC02345.JPG,char_data/S/DSC02345.JPG_8.jpg,704,480,640,22,174,196,241,273,True,28
S,138,kaist_dataset/English/Digital_Camera/(E.S)C-outdoor1/DSC02406.JPG,char_data/S/DSC02406.JPG_2.jpg,14214,480,640,103,62,165,269,407,True,28
S,81,kaist_dataset/English/Digital_Camera/(E.S)C-outdoor1/DSC02408.JPG,char_data/S/DSC02408.JPG_2.jpg,5184,480,640,64,306,370,264,345,True,28
S,124,kaist_dataset/English/Digital_Camera/(E.S)C-outdoor1/DSC02427.JPG,char_data/S/DSC02427.JPG_8.jpg,8680,480,640,70,211,281,104,228,True,28
S,51,kaist_dataset/English/Digital_Camera/(E.S)C-outdoor1/DSC02427.JPG,char_data/S/DSC02427.JPG_9.jpg,1377,480,640,27,279,306,237,288,True,28
S,50,kaist_dataset/English/Digital_Camera/(E.S)C-outdoor1/DSC02427.JPG,char_data/S/DSC02427.JPG_10.jpg,1200,480,640,24,395,419,235,285,True,28
S,49,kaist_dataset/English/Digital_Camera/(E.S)C-outdoor1/DSC02427.JPG,char_data/S/DSC02427.JPG_11.jpg,1176,480,640,24,422,446,235,284,True,28
S,137,kaist_dataset/English/Digital_Camera/(E.S)C-outdoor1/DSC02448.JPG,char_data/S/DSC02448.JPG_2.jpg,12193,480,640,89,106,195,189,326,True,28
S,120,kaist_dataset/English/Digital_Camera/(E.S)C-outdoor1/DSC02450.JPG,char_data/S/DSC02450.JPG_2.jpg,5880,480,640,49,524,573,73,193,True,28
S,154,kaist_dataset/English/Digital_Camera/(E.S)C-outdoor1/DSC02475.JPG,char_data/S/DSC02475.JPG_2.jpg,17094,480,640,111,366,477,72,226,True,28
S,65,kaist_dataset/English/Digital_Camera/(E.S)C-outdoor1/DSC02480.JPG,char_data/S/DSC02480.JPG_6.jpg,3965,480,640,61,353,414,192,257,True,28
S,83,kaist_dataset/English/Digital_Camera/(E.S)C-outdoor1/DSC02491.JPG,char_data/S/DSC02491.JPG_2.jpg,4399,480,640,53,80,133,44,127,True,28
S,22,kaist_dataset/English/Digital_Camera/(E.S)C-outdoor1/DSC02500.JPG,char_data/S/DSC02500.JPG_6.jpg,330,480,640,15,7,22,105,127,True,28
S,25,kaist_dataset/English/Digital_Camera/(E.S)C-outdoor1/DSC02500.JPG,char_data/S/DSC02500.JPG_7.jpg,325,480,640,13,68,81,83,108,True,28
S,93,kaist_dataset/English/Digital_Camera/(E.S)C-outdoor1/DSC02514.JPG,char_data/S/DSC02514.JPG_2.jpg,4650,480,640,50,63,113,146,239,True,28
S,94,kaist_dataset/English/Digital_Camera/(E.S)C-outdoor1/DSC02524.JPG,char_data/S/DSC02524.JPG_2.jpg,6768,480,640,72,31,103,306,400,True,28
S,37,kaist_dataset/English/Digital_Camera/(E.S)C-outdoor1/DSC02618.JPG,char_data/S/DSC02618.JPG_4.jpg,481,480,640,13,330,343,174,211,True,28
S,37,kaist_dataset/English/Digital_Camera/(E.S)C-outdoor1/DSC02618.JPG,char_data/S/DSC02618.JPG_5.jpg,629,480,640,17,340,357,175,212,True,28
S,67,kaist_dataset/English/Digital_Camera/(E.S)C-outdoor1/DSC02619.JPG,char_data/S/DSC02619.JPG_6.jpg,2412,480,640,36,120,156,219,286,True,28
S,68,kaist_dataset/English/Digital_Camera/(E.S)C-outdoor1/DSC02619.JPG,char_data/S/DSC02619.JPG_7.jpg,2856,480,640,42,271,313,215,283,True,28
S,69,kaist_dataset/English/Digital_Camera/(E.S)C-outdoor1/DSC02619.JPG,char_data/S/DSC02619.JPG_8.jpg,3519,480,640,51,310,361,213,282,True,28
S,87,kaist_dataset/English/Digital_Camera/(E.S)C-outdoor1/DSC02897.JPG,char_data/S/DSC02897.JPG_2.jpg,4263,480,640,49,260,309,285,372,True,28
S,184,kaist_dataset/English/Digital_Camera/(E.S)C-outdoor2/DSC02949.JPG,char_data/S/DSC02949.JPG_2.jpg,11776,480,640,64,188,252,63,247,True,28
S,57,kaist_dataset/English/Digital_Camera/(E.S)C-outdoor2/DSC03001.JPG,char_data/S/DSC03001.JPG_2.jpg,2679,480,640,47,210,257,187,244,True,28
S,69,kaist_dataset/English/Digital_Camera/(E.S)C-outdoor2/DSC03012.JPG,char_data/S/DSC03012.JPG_4.jpg,3174,480,640,46,28,74,212,281,True,28
S,63,kaist_dataset/English/Digital_Camera/(E.S)C-outdoor2/DSC03012.JPG,char_data/S/DSC03012.JPG_5.jpg,2709,480,640,43,295,338,215,278,True,28
S,55,kaist_dataset/English/Digital_Camera/(E.S)C-outdoor2/DSC03023.JPG,char_data/S/DSC03023.JPG_2.jpg,1210,480,640,22,266,288,299,354,True,28
S,68,kaist_dataset/English/Digital_Camera/(E.S)C-outdoor2/DSC03025.JPG,char_data/S/DSC03025.JPG_2.jpg,2516,480,640,37,287,324,129,197,True,28
S,73,kaist_dataset/English/Digital_Camera/(E.S)C-outdoor2/DSC03050.JPG,char_data/S/DSC03050.JPG_2.jpg,5840,480,640,80,241,321,211,284,True,28
S,41,kaist_dataset/English/Digital_Camera/(E.S)C-outdoor2/DSC03160.JPG,char_data/S/DSC03160.JPG_5.jpg,820,480,640,20,246,266,399,440,True,28
S,49,kaist_dataset/English/Digital_Camera/(E.S)C-outdoor2/DSC03161.JPG,char_data/S/DSC03161.JPG_2.jpg,1274,480,640,26,543,569,221,270,True,28
S,61,kaist_dataset/English/Digital_Camera/(E.S)C-outdoor2/DSC03167.JPG,char_data/S/DSC03167.JPG_2.jpg,3477,480,640,57,207,264,294,355,True,28
S,74,kaist_dataset/English/Digital_Camera/(E.S)C-outdoor2/DSC03191.JPG,char_data/S/DSC03191.JPG_2.jpg,3996,480,640,54,84,138,137,211,True,28
S,44,kaist_dataset/English/Digital_Camera/(E.S)C-outdoor2/DSC03203.JPG,char_data/S/DSC03203.JPG_4.jpg,1540,480,640,35,213,248,313,357,True,28
S,65,kaist_dataset/English/Digital_Camera/(E.S)C-outdoor2/DSC03277.JPG,char_data/S/DSC03277.JPG_2.jpg,3640,480,640,56,70,126,177,242,True,28
S,48,kaist_dataset/English/Digital_Camera/(E.S)C-outdoor2/DSC03279.JPG,char_data/S/DSC03279.JPG_4.jpg,1440,480,640,30,140,170,208,256,True,28
S,46,kaist_dataset/English/Digital_Camera/(E.S)C-outdoor2/DSC03279.JPG,char_data/S/DSC03279.JPG_5.jpg,1242,480,640,27,235,262,211,257,True,28
S,54,kaist_dataset/English/Digital_Camera/(E.S)C-outdoor2/DSC03317.JPG,char_data/S/DSC03317.JPG_2.jpg,1134,480,640,21,392,413,190,244,True,28
S,138,kaist_dataset/English/Digital_Camera/(E.S)C-outdoor2/DSC03408.JPG,char_data/S/DSC03408.JPG_2.jpg,12420,480,640,90,18,108,296,434,True,28
S,135,kaist_dataset/English/Digital_Camera/(E.S)C-outdoor2/DSC03410.JPG,char_data/S/DSC03410.JPG_2.jpg,20520,480,640,152,56,208,287,422,True,28
S,76,kaist_dataset/English/Digital_Camera/(E.S)C-outdoor2/DSC03411.JPG,char_data/S/DSC03411.JPG_2.jpg,5624,480,640,74,223,297,163,239,True,28
S,58,kaist_dataset/English/Digital_Camera/(E.S)C-outdoor2/DSC03413.JPG,char_data/S/DSC03413.JPG_2.jpg,2668,480,640,46,335,381,205,263,True,28
S,70,kaist_dataset/English/Digital_Camera/(E.S)C-outdoor2/DSC03414.JPG,char_data/S/DSC03414.JPG_4.jpg,5250,480,640,75,176,251,257,327,True,28
S,66,kaist_dataset/English/Digital_Camera/(E.S)C-outdoor2/DSC03414.JPG,char_data/S/DSC03414.JPG_5.jpg,3762,480,640,57,364,421,346,412,True,28
S,45,kaist_dataset/English/Digital_Camera/(E.S)C-outdoor2/DSC03575.JPG,char_data/S/DSC03575.JPG_6.jpg,1485,480,640,33,384,417,180,225,True,28
S,51,kaist_dataset/English/Digital_Camera/(E.S)C-outdoor2/DSC03575.JPG,char_data/S/DSC03575.JPG_7.jpg,1581,480,640,31,440,471,261,312,True,28
S,54,kaist_dataset/English/Digital_Camera/(E.S)C-outdoor2/DSC03575.JPG,char_data/S/DSC03575.JPG_8.jpg,1890,480,640,35,471,506,263,317,True,28
S,48,kaist_dataset/English/Digital_Camera/(E.S)C-outdoor2/DSC03650.JPG,char_data/S/DSC03650.JPG_2.jpg,1392,480,640,29,331,360,213,261,True,28
S,135,kaist_dataset/English/Digital_Camera/(E.S)C-outdoor2/DSC03663.JPG,char_data/S/DSC03663.JPG_2.jpg,12420,480,640,92,228,320,153,288,True,28
S,62,kaist_dataset/English/Digital_Camera/(E.S)C-outdoor2/DSC03684.JPG,char_data/S/DSC03684.JPG_2.jpg,2604,480,640,42,216,258,83,145,True,28
S,53,kaist_dataset/English/Digital_Camera/(E.S)C-outdoor2/DSC03705.JPG,char_data/S/DSC03705.JPG_2.jpg,1961,480,640,37,325,362,313,366,True,28
S,101,kaist_dataset/English/Digital_Camera/(E.S)C-outdoor2/DSC03761.JPG,char_data/S/DSC03761.JPG_4.jpg,6767,480,640,67,154,221,320,421,True,28
S,61,kaist_dataset/English/Digital_Camera/(E.S)C-outdoor2/DSC03765.JPG,char_data/S/DSC03765.JPG_2.jpg,3294,480,640,54,170,224,83,144,True,28
S,36,kaist_dataset/English/Digital_Camera/(E.S)C-outdoor2/DSC03831.JPG,char_data/S/DSC03831.JPG_2.jpg,828,480,640,23,406,429,128,164,True,28
S,65,kaist_dataset/English/Digital_Camera/(E.S)C-outdoor2/DSC03865.JPG,char_data/S/DSC03865.JPG_5.jpg,2535,480,640,39,493,532,93,158,True,28
S,43,kaist_dataset/English/Digital_Camera/(E.S)C-outdoor2/DSC04064.JPG,char_data/S/DSC04064.JPG_7.jpg,1161,480,640,27,499,526,137,180,True,28
S,32,kaist_dataset/English/Digital_Camera/(E.S)C-outdoor2/DSC04064.JPG,char_data/S/DSC04064.JPG_8.jpg,832,480,640,26,598,624,150,182,True,28
S,62,kaist_dataset/English/Digital_Camera/(E.S)C-outdoor2/DSC04079.JPG,char_data/S/DSC04079.JPG_8.jpg,2232,480,640,36,432,468,42,104,True,28
S,68,kaist_dataset/English/Digital_Camera/(E.S)C-outdoor2/DSC04087.JPG,char_data/S/DSC04087.JPG_2.jpg,3400,480,640,50,214,264,124,192,True,28
S,58,kaist_dataset/English/Digital_Camera/(E.S)C-outdoor2/DSC04120.JPG,char_data/S/DSC04120.JPG_2.jpg,2088,480,640,36,422,458,142,200,True,28
S,133,kaist_dataset/English/Digital_Camera/(E.S)C-outdoor2/DSC04163.JPG,char_data/S/DSC04163.JPG_2.jpg,13965,480,640,105,419,524,112,245,True,28
S,37,kaist_dataset/English/Digital_Camera/(E.S)C-outdoor2/DSC04361.JPG,char_data/S/DSC04361.JPG_2.jpg,925,480,640,25,386,411,243,280,True,28
S,130,kaist_dataset/English/Digital_Camera/(E.S)C-outdoor2/DSC04430.JPG,char_data/S/DSC04430.JPG_6.jpg,17030,480,640,131,36,167,266,396,True,28
S,141,kaist_dataset/English/Digital_Camera/(E.S)C-outdoor2/DSC04431.JPG,char_data/S/DSC04431.JPG_6.jpg,16074,480,640,114,62,176,93,234,True,28
S,142,kaist_dataset/English/Digital_Camera/(E.S)C-outdoor2/DSC04431.JPG,char_data/S/DSC04431.JPG_7.jpg,15762,480,640,111,76,187,250,392,True,28
S,60,kaist_dataset/English/Digital_Camera/(E.S)C-outdoor2/DSC04464.JPG,char_data/S/DSC04464.JPG_2.jpg,2820,480,640,47,210,257,324,384,True,28
S,63,kaist_dataset/English/Digital_Camera/(E.S)C-outdoor2/IMG_2481.JPG,char_data/S/IMG_2481.JPG_2.jpg,2079,480,640,33,356,389,188,251,True,28
S,78,kaist_dataset/English/Digital_Camera/(E.S)C-outdoor2/P1010015.JPG,char_data/S/P1010015.JPG_2.jpg,5070,480,640,65,344,409,139,217,True,28
S,50,kaist_dataset/English/Digital_Camera/(E.S)C-outdoor3/DSC02690.JPG,char_data/S/DSC02690.JPG_2.jpg,2550,480,640,51,413,464,209,259,True,28
S,76,kaist_dataset/English/Digital_Camera/(E.S)C-outdoor3/DSC03046.JPG,char_data/S/DSC03046.JPG_4.jpg,3724,480,640,49,299,348,126,202,True,28
S,75,kaist_dataset/English/Digital_Camera/(E.S)C-outdoor3/DSC03046.JPG,char_data/S/DSC03046.JPG_5.jpg,3900,480,640,52,368,420,125,200,True,28
S,72,kaist_dataset/English/Digital_Camera/(E.S)C-outdoor3/P1010123.JPG,char_data/S/P1010123.JPG_6.jpg,4248,480,640,59,215,274,73,145,True,28
S,84,kaist_dataset/English/Digital_Camera/(E.S)C-outdoor3/P1010133.JPG,char_data/S/P1010133.JPG_2.jpg,4704,480,640,56,394,450,72,156,True,28
S,98,kaist_dataset/English/Digital_Camera/(E.S)C-outdoor3/r.jpg,char_data/S/r.jpg_2.jpg,7350,240,320,75,21,96,94,192,True,28
S,46,kaist_dataset/English/Digital_Camera/(E.S)D-indoor/080119-0009.jpg,char_data/S/080119-0009.jpg_18.jpg,1012,1200,1600,22,561,583,994,1040,True,28
S,74,kaist_dataset/English/Digital_Camera/(E.S)D-indoor/080119-0009.jpg,char_data/S/080119-0009.jpg_23.jpg,2294,1200,1600,31,1444,1475,69,143,True,28
S,115,kaist_dataset/English/Digital_Camera/(E.S)D-indoor/080119-0015.jpg,char_data/S/080119-0015.jpg_8.jpg,11845,1200,1600,103,792,895,500,615,True,28
S,120,kaist_dataset/English/Digital_Camera/(E.S)D-indoor/080119-0015.jpg,char_data/S/080119-0015.jpg_9.jpg,12240,1200,1600,102,895,997,491,611,True,28
S,34,kaist_dataset/English/Digital_Camera/(E.S)D-indoor/080119-0015.jpg,char_data/S/080119-0015.jpg_10.jpg,1020,1200,1600,30,902,932,619,653,True,28
S,36,kaist_dataset/English/Digital_Camera/(E.S)D-indoor/080119-0015.jpg,char_data/S/080119-0015.jpg_11.jpg,900,1200,1600,25,957,982,613,649,True,28
S,136,kaist_dataset/English/Digital_Camera/(E.S)D-indoor/DSC02842.JPG,char_data/S/DSC02842.JPG_2.jpg,18904,480,640,139,424,563,199,335,True,28
S,82,kaist_dataset/English/Digital_Camera/(E.S)D-indoor/DSC03076.JPG,char_data/S/DSC03076.JPG_2.jpg,4264,480,640,52,147,199,286,368,True,28
S,43,kaist_dataset/English/Digital_Camera/(E.S)D-indoor/DSC03142.JPG,char_data/S/DSC03142.JPG_4.jpg,1376,480,640,32,176,208,357,400,True,28
S,41,kaist_dataset/English/Digital_Camera/(E.S)D-indoor/DSC03147.JPG,char_data/S/DSC03147.JPG_4.jpg,943,480,640,23,284,307,292,333,True,28
S,48,kaist_dataset/English/Digital_Camera/(E.S)D-indoor/DSC03147.JPG,char_data/S/DSC03147.JPG_5.jpg,1248,480,640,26,286,312,230,278,True,28
S,101,kaist_dataset/English/Digital_Camera/(E.S)D-indoor/DSC03366.JPG,char_data/S/DSC03366.JPG_2.jpg,7070,480,640,70,294,364,349,450,True,28
S,109,kaist_dataset/English/Digital_Camera/(E.S)D-indoor/DSC03402.JPG,char_data/S/DSC03402.JPG_2.jpg,8175,480,640,75,118,193,186,295,True,28
S,81,kaist_dataset/English/Digital_Camera/(E.S)D-indoor/DSC03403.JPG,char_data/S/DSC03403.JPG_2.jpg,5184,480,640,64,146,210,202,283,True,28
S,62,kaist_dataset/English/Digital_Camera/(E.S)D-indoor/DSC03881.JPG,char_data/S/DSC03881.JPG_2.jpg,2480,480,640,40,401,441,302,364,True,28
S,63,kaist_dataset/English/Digital_Camera/(E.S)D-indoor/DSC03887.JPG,char_data/S/DSC03887.JPG_2.jpg,3087,480,640,49,346,395,167,230,True,28
S,56,kaist_dataset/English/Digital_Camera/(E.S)D-indoor/DSC03918.JPG,char_data/S/DSC03918.JPG_5.jpg,1960,480,640,35,399,434,409,465,True,28
S,39,kaist_dataset/English/Digital_Camera/(E.S)D-indoor/DSC03935.JPG,char_data/S/DSC03935.JPG_2.jpg,663,480,640,17,196,213,39,78,True,28
S,80,kaist_dataset/English/Digital_Camera/(E.S)D-indoor/DSC03941.JPG,char_data/S/DSC03941.JPG_2.jpg,4000,480,640,50,384,434,228,308,True,28
S,37,kaist_dataset/English/Digital_Camera/(E.S)D-indoor/DSC03942.JPG,char_data/S/DSC03942.JPG_6.jpg,925,480,640,25,349,374,370,407,True,28
S,42,kaist_dataset/English/Digital_Camera/(E.S)D-indoor/DSC03942.JPG,char_data/S/DSC03942.JPG_7.jpg,882,480,640,21,374,395,368,410,True,28
S,43,kaist_dataset/English/Digital_Camera/(E.S)D-indoor/DSC03942.JPG,char_data/S/DSC03942.JPG_8.jpg,1032,480,640,24,468,492,372,415,True,28
S,82,kaist_dataset/English/Digital_Camera/(E.S)D-indoor/DSC04255.JPG,char_data/S/DSC04255.JPG_2.jpg,6314,480,640,77,442,519,298,380,True,28
S,26,kaist_dataset/English/Digital_Camera/(E.S)E-night/111.jpg,char_data/S/111.jpg_8.jpg,234,480,640,9,261,270,282,308,True,28
S,25,kaist_dataset/English/Digital_Camera/(E.S)E-night/111.jpg,char_data/S/111.jpg_9.jpg,250,480,640,10,271,281,282,307,True,28
S,18,kaist_dataset/English/Digital_Camera/(E.S)E-night/111.jpg,char_data/S/111.jpg_10.jpg,162,480,640,9,269,278,266,284,True,28
S,22,kaist_dataset/English/Digital_Camera/(E.S)E-night/111.jpg,char_data/S/111.jpg_11.jpg,198,480,640,9,318,327,267,289,True,28
S,148,kaist_dataset/English/Digital_Camera/(E.S)E-night/DSC02570.JPG,char_data/S/DSC02570.JPG_2.jpg,8732,480,640,59,90,149,203,351,True,28
S,112,kaist_dataset/English/Digital_Camera/(E.S)E-night/DSC02610.JPG,char_data/S/DSC02610.JPG_8.jpg,10528,480,640,94,86,180,151,263,True,28
S,88,kaist_dataset/English/Digital_Camera/(E.S)E-night/DSC02674.JPG,char_data/S/DSC02674.JPG_2.jpg,8272,480,640,94,526,620,197,285,True,28
S,114,kaist_dataset/English/Digital_Camera/(E.S)E-night/크기변환_%BA%F7%BD%BA%BD%C5%B8%DE%B4%BA_01_tjtjdska2008.jpg,char_data/S/크기변환_%BA%F7%BD%BA%BD%C5%B8%DE%B4%BA_01_tjtjdska2008.jpg_4.jpg,7980,480,640,70,378,448,156,270,True,28
S,28,kaist_dataset/English/Digital_Camera/(E.S)E-night/크기변환_%BA%F7%BD%BA%BD%C5%B8%DE%B4%BA_01_tjtjdska2008.jpg,char_data/S/크기변환_%BA%F7%BD%BA%BD%C5%B8%DE%B4%BA_01_tjtjdska2008.jpg_5.jpg,616,480,640,22,241,263,274,302,True,28
S,135,kaist_dataset/English/Digital_Camera/(E.S)F-others/080116-0058.jpg,char_data/S/080116-0058.jpg_6.jpg,6210,1200,1600,46,955,1001,459,594,True,28
S,151,kaist_dataset/English/Digital_Camera/(E.S)F-others/080116-0058.jpg,char_data/S/080116-0058.jpg_7.jpg,5587,1200,1600,37,868,905,725,876,True,28
S,143,kaist_dataset/English/Digital_Camera/(E.S)F-others/080116-0058.jpg,char_data/S/080116-0058.jpg_8.jpg,5005,1200,1600,35,907,942,735,878,True,28
S,151,kaist_dataset/English/Digital_Camera/(E.S)F-others/080116-0060.jpg,char_data/S/080116-0060.jpg_2.jpg,11778,1200,1600,78,977,1055,399,550,True,28
S,45,kaist_dataset/English/Digital_Camera/(E.S)F-others/080119-0007.jpg,char_data/S/080119-0007.jpg_2.jpg,2340,1200,1600,52,1193,1245,651,696,True,28
S,114,kaist_dataset/English/Digital_Camera/(E.S)F-others/080119-0014.jpg,char_data/S/080119-0014.jpg_5.jpg,7752,1200,1600,68,1372,1440,765,879,True,28
S,187,kaist_dataset/English/Digital_Camera/(E.S)F-others/2007-12-09-day-exterior-047.jpg,char_data/S/2007-12-09-day-exterior-047.jpg_4.jpg,20944,1200,1600,112,940,1052,471,658,True,28
S,39,kaist_dataset/English/Digital_Camera/(E.S)F-others/2007-12-09-day-exterior-047.jpg,char_data/S/2007-12-09-day-exterior-047.jpg_5.jpg,819,1200,1600,21,690,711,1070,1109,True,28
S,98,kaist_dataset/English/Digital_Camera/(E.S)F-others/DSC02923.JPG,char_data/S/DSC02923.JPG_4.jpg,8330,480,640,85,39,124,307,405,True,28
S,97,kaist_dataset/English/Digital_Camera/(E.S)F-others/DSC02923.JPG,char_data/S/DSC02923.JPG_5.jpg,8148,480,640,84,123,207,299,396,True,28
S,54,kaist_dataset/English/Digital_Camera/(E.S)F-others/DSC03218.JPG,char_data/S/DSC03218.JPG_4.jpg,2160,480,640,40,110,150,316,370,True,28
S,61,kaist_dataset/English/Digital_Camera/(E.S)F-others/크기변환_%B0%A3%C6%C77_m_starfirm.jpg,char_data/S/크기변환_%B0%A3%C6%C77_m_starfirm.jpg_4.jpg,2867,480,640,47,241,288,83,144,True,28
S,60,kaist_dataset/English/Digital_Camera/(E.S)F-others/크기변환_%B0%A3%C6%C77_m_starfirm.jpg,char_data/S/크기변환_%B0%A3%C6%C77_m_starfirm.jpg_5.jpg,2460,480,640,41,287,328,96,156,True,28
S,122,kaist_dataset/English/Mobile_Phone/(E.M)A-outdoor/P090911085.jpg,char_data/S/P090911085.jpg_2.jpg,8784,480,640,72,132,204,120,242,True,28
S,72,kaist_dataset/English/Mobile_Phone/(E.M)B-indoor/P090902018.jpg,char_data/S/P090902018.jpg_10.jpg,2736,480,640,38,408,446,62,134,True,28
S,74,kaist_dataset/English/Mobile_Phone/(E.M)B-indoor/P090902018.jpg,char_data/S/P090902018.jpg_11.jpg,3552,480,640,48,445,493,59,133,True,28
S,77,kaist_dataset/English/Mobile_Phone/(E.M)B-indoor/P090902018.jpg,char_data/S/P090902018.jpg_12.jpg,2772,480,640,36,59,95,162,239,True,28
S,69,kaist_dataset/English/Mobile_Phone/(E.M)B-indoor/P090902018.jpg,char_data/S/P090902018.jpg_14.jpg,3381,480,640,49,104,153,290,359,True,28
S,76,kaist_dataset/English/Mobile_Phone/(E.M)C-bookCover/P090831042.jpg,char_data/S/P090831042.jpg_2.jpg,4560,480,640,60,561,621,195,271,True,28
S,67,kaist_dataset/English/Mobile_Phone/(E.M)C-bookCover/P090831075.jpg,char_data/S/P090831075.jpg_4.jpg,2077,480,640,31,307,338,159,226,True,28
S,63,kaist_dataset/English/Mobile_Phone/(E.M)C-bookCover/P090831075.jpg,char_data/S/P090831075.jpg_5.jpg,2142,480,640,34,340,374,160,223,True,28
S,42,kaist_dataset/English/Mobile_Phone/(E.M)C-bookCover/P090903015.jpg,char_data/S/P090903015.jpg_2.jpg,1176,480,640,28,485,513,78,120,True,28
S,49,kaist_dataset/English/Mobile_Phone/(E.M)C-bookCover/P090903041.jpg,char_data/S/P090903041.jpg_2.jpg,2205,480,640,45,168,213,26,75,True,28
S,119,kaist_dataset/English/Mobile_Phone/(E.M)C-bookCover/P090903050.jpg,char_data/S/P090903050.jpg_2.jpg,11067,480,640,93,34,127,71,190,True,28
S,34,kaist_dataset/English/Mobile_Phone/(E.M)C-bookCover/P090903055.jpg,char_data/S/P090903055.jpg_2.jpg,1326,480,640,39,327,366,72,106,True,28
S,37,kaist_dataset/English/Mobile_Phone/(E.M)C-bookCover/P090903056.jpg,char_data/S/P090903056.jpg_2.jpg,1258,480,640,34,328,362,203,240,True,28
S,77,kaist_dataset/English/Mobile_Phone/(E.M)C-bookCover/P090903071.jpg,char_data/S/P090903071.jpg_6.jpg,4312,480,640,56,338,394,146,223,True,28
S,69,kaist_dataset/English/Mobile_Phone/(E.M)C-bookCover/P090903071.jpg,char_data/S/P090903071.jpg_7.jpg,2898,480,640,42,420,462,228,297,True,28
S,40,kaist_dataset/English/Mobile_Phone/(E.M)C-bookCover/P090903071.jpg,char_data/S/P090903071.jpg_8.jpg,1200,480,640,30,419,449,302,342,True,28
S,90,kaist_dataset/English/Mobile_Phone/(E.M)C-bookCover/P090903076.jpg,char_data/S/P090903076.jpg_4.jpg,5940,480,640,66,476,542,296,386,True,28
S,43,kaist_dataset/English/Mobile_Phone/(E.M)C-bookCover/P090903076.jpg,char_data/S/P090903076.jpg_5.jpg,1462,480,640,34,447,481,397,440,True,28
S,15,kaist_dataset/Korean/Digital_Camera/E-night/103.jpg,char_data/S/103.jpg_2.jpg,120,480,640,8,380,388,154,169,True,28
S,21,kaist_dataset/Korean/Digital_Camera/G-others/5.jpg,char_data/S/5.jpg_4.jpg,294,553,798,14,17,31,38,59,True,28
S,19,kaist_dataset/Korean/Digital_Camera/G-others/5.jpg,char_data/S/5.jpg_5.jpg,247,553,798,13,173,186,39,58,True,28
S,17,kaist_dataset/Korean/Digital_Camera/indoor1/146.JPG,char_data/S/146.JPG_2.jpg,187,480,640,11,311,322,271,288,True,28
S,22,kaist_dataset/Korean/Digital_Camera/outdoor1/001.JPG,char_data/S/001.JPG_7.jpg,374,480,640,17,77,94,244,266,True,28
S,26,kaist_dataset/Korean/Digital_Camera/outdoor2/2007-12-08-day-109.jpg,char_data/S/2007-12-08-day-109.jpg_2.jpg,286,1200,1600,11,140,151,829,855,True,28
S,84,kaist_dataset/Korean/Digital_Camera/outdoor6/DSC04439.JPG,char_data/S/DSC04439.JPG_2.jpg,4704,480,640,56,165,221,53,137,True,28
S,31,kaist_dataset/Mixed/Digital_Camera/(C.S)A-shadow/DSC02568.JPG,char_data/S/DSC02568.JPG_4.jpg,837,480,640,27,209,236,149,180,True,28
S,104,kaist_dataset/Mixed/Digital_Camera/(C.S)A-shadow/DSC02609.JPG,char_data/S/DSC02609.JPG_8.jpg,7176,480,640,69,157,226,205,309,True,28
S,37,kaist_dataset/Mixed/Digital_Camera/(C.S)A-shadow/DSC02609.JPG,char_data/S/DSC02609.JPG_9.jpg,925,480,640,25,162,187,319,356,True,28
S,55,kaist_dataset/Mixed/Digital_Camera/(C.S)A-shadow/DSC02902.JPG,char_data/S/DSC02902.JPG_2.jpg,1925,480,640,35,167,202,382,437,True,28
S,80,kaist_dataset/Mixed/Digital_Camera/(C.S)A-shadow/DSC03207.JPG,char_data/S/DSC03207.JPG_2.jpg,4400,480,640,55,139,194,183,263,True,28
S,34,kaist_dataset/Mixed/Digital_Camera/(C.S)B-light/134.JPG,char_data/S/134.JPG_4.jpg,748,480,640,22,188,210,293,327,True,28
S,32,kaist_dataset/Mixed/Digital_Camera/(C.S)B-light/134.JPG,char_data/S/134.JPG_5.jpg,704,480,640,22,330,352,293,325,True,28
S,72,kaist_dataset/Mixed/Digital_Camera/(C.S)C-outdoor1/003.JPG,char_data/S/003.JPG_6.jpg,2016,480,640,28,317,345,81,153,True,28
S,26,kaist_dataset/Mixed/Digital_Camera/(C.S)C-outdoor1/003.JPG,char_data/S/003.JPG_7.jpg,260,480,640,10,238,248,260,286,True,28
S,79,kaist_dataset/Mixed/Digital_Camera/(C.S)C-outdoor1/014.JPG,char_data/S/014.JPG_2.jpg,2291,480,640,29,3,32,184,263,True,28
S,72,kaist_dataset/Mixed/Digital_Camera/(C.S)C-outdoor1/046.JPG,char_data/S/046.JPG_2.jpg,3528,480,640,49,533,582,197,269,True,28
S,30,kaist_dataset/Mixed/Digital_Camera/(C.S)C-outdoor1/054.JPG,char_data/S/054.JPG_4.jpg,780,480,640,26,217,243,274,304,True,28
S,34,kaist_dataset/Mixed/Digital_Camera/(C.S)C-outdoor1/054.JPG,char_data/S/054.JPG_5.jpg,714,480,640,21,329,350,272,306,True,28
S,117,kaist_dataset/Mixed/Digital_Camera/(C.S)C-outdoor1/080116-0084.jpg,char_data/S/080116-0084.jpg_4.jpg,10413,600,800,89,129,218,143,260,True,28
S,53,kaist_dataset/Mixed/Digital_Camera/(C.S)C-outdoor1/080116-0084.jpg,char_data/S/080116-0084.jpg_5.jpg,1696,600,800,32,324,356,294,347,True,28
S,193,kaist_dataset/Mixed/Digital_Camera/(C.S)C-outdoor1/080118-0007.jpg,char_data/S/080118-0007.jpg_2.jpg,24704,1200,1600,128,29,157,436,629,True,28
S,196,kaist_dataset/Mixed/Digital_Camera/(C.S)C-outdoor1/080118-0014.jpg,char_data/S/080118-0014.jpg_2.jpg,21364,1200,1600,109,362,471,679,875,True,28
S,66,kaist_dataset/Mixed/Digital_Camera/(C.S)C-outdoor1/080119-0006.jpg,char_data/S/080119-0006.jpg_2.jpg,3036,1200,1600,46,1134,1180,734,800,True,28
S,81,kaist_dataset/Mixed/Digital_Camera/(C.S)C-outdoor1/080119-0027.jpg,char_data/S/080119-0027.jpg_4.jpg,3645,1200,1600,45,753,798,720,801,True,28
S,46,kaist_dataset/Mixed/Digital_Camera/(C.S)C-outdoor1/080119-0027.jpg,char_data/S/080119-0027.jpg_5.jpg,1656,1200,1600,36,941,977,1056,1102,True,28
S,269,kaist_dataset/Mixed/Digital_Camera/(C.S)C-outdoor1/080119-0033.jpg,char_data/S/080119-0033.jpg_2.jpg,42771,1200,1600,159,406,565,431,700,True,28
S,114,kaist_dataset/Mixed/Digital_Camera/(C.S)C-outdoor1/080119-0037.jpg,char_data/S/080119-0037.jpg_2.jpg,7296,1200,1600,64,1186,1250,836,950,True,28
S,37,kaist_dataset/Mixed/Digital_Camera/(C.S)C-outdoor1/114.jpg,char_data/S/114.jpg_2.jpg,1591,480,640,43,384,427,320,357,True,28
S,49,kaist_dataset/Mixed/Digital_Camera/(C.S)C-outdoor1/119.JPG,char_data/S/119.JPG_2.jpg,1666,480,640,34,423,457,192,241,True,28
S,27,kaist_dataset/Mixed/Digital_Camera/(C.S)C-outdoor1/121.JPG,char_data/S/121.JPG_4.jpg,540,480,640,20,54,74,216,243,True,28
S,30,kaist_dataset/Mixed/Digital_Camera/(C.S)C-outdoor1/121.JPG,char_data/S/121.JPG_5.jpg,570,480,640,19,118,137,215,245,True,28
S,43,kaist_dataset/Mixed/Digital_Camera/(C.S)C-outdoor1/2007-12-08-day-103.jpg,char_data/S/2007-12-08-day-103.jpg_2.jpg,1720,1200,1600,40,517,557,606,649,True,28
S,55,kaist_dataset/Mixed/Digital_Camera/(C.S)C-outdoor1/2007-12-08-day-130.jpg,char_data/S/2007-12-08-day-130.jpg_4.jpg,2805,1200,1600,51,533,584,686,741,True,28
S,51,kaist_dataset/Mixed/Digital_Camera/(C.S)C-outdoor1/2007-12-08-day-130.jpg,char_data/S/2007-12-08-day-130.jpg_5.jpg,2295,1200,1600,45,729,774,695,746,True,28
S,83,kaist_dataset/Mixed/Digital_Camera/(C.S)C-outdoor1/2007-12-09-day-exterior-044.jpg,char_data/S/2007-12-09-day-exterior-044.jpg_6.jpg,8715,1200,1600,105,394,499,326,409,True,28
S,80,kaist_dataset/Mixed/Digital_Camera/(C.S)C-outdoor1/2007-12-09-day-exterior-044.jpg,char_data/S/2007-12-09-day-exterior-044.jpg_7.jpg,5360,1200,1600,67,952,1019,811,891,True,28
S,88,kaist_dataset/Mixed/Digital_Camera/(C.S)C-outdoor1/2007-12-09-day-exterior-044.jpg,char_data/S/2007-12-09-day-exterior-044.jpg_8.jpg,4840,1200,1600,55,1286,1341,958,1046,True,28
S,52,kaist_dataset/Mixed/Digital_Camera/(C.S)C-outdoor1/3.JPG,char_data/S/3.JPG_8.jpg,1664,576,768,32,439,471,228,280,True,28
S,49,kaist_dataset/Mixed/Digital_Camera/(C.S)C-outdoor1/3.JPG,char_data/S/3.JPG_9.jpg,980,576,768,20,615,635,417,466,True,28
S,23,kaist_dataset/Mixed/Digital_Camera/(C.S)C-outdoor1/3.JPG,char_data/S/3.JPG_10.jpg,230,576,768,10,611,621,293,316,True,28
S,18,kaist_dataset/Mixed/Digital_Camera/(C.S)C-outdoor1/3.JPG,char_data/S/3.JPG_11.jpg,252,576,768,14,135,149,291,309,True,28
S,55,kaist_dataset/Mixed/Digital_Camera/(C.S)C-outdoor1/51.JPG,char_data/S/51.JPG_2.jpg,2365,576,768,43,109,152,213,268,True,28
S,29,kaist_dataset/Mixed/Digital_Camera/(C.S)C-outdoor1/DSC02318.JPG,char_data/S/DSC02318.JPG_2.jpg,667,480,640,23,266,289,321,350,True,28
S,30,kaist_dataset/Mixed/Digital_Camera/(C.S)C-outdoor1/DSC02320.JPG,char_data/S/DSC02320.JPG_2.jpg,660,480,640,22,494,516,245,275,True,28
S,80,kaist_dataset/Mixed/Digital_Camera/(C.S)C-outdoor1/DSC02325.JPG,char_data/S/DSC02325.JPG_4.jpg,3920,480,640,49,169,218,212,292,True,28
S,47,kaist_dataset/Mixed/Digital_Camera/(C.S)C-outdoor1/P1010009.JPG,char_data/S/P1010009.JPG_4.jpg,1692,480,640,36,517,553,196,243,True,28
S,51,kaist_dataset/Mixed/Digital_Camera/(C.S)C-outdoor1/P1010009.JPG,char_data/S/P1010009.JPG_5.jpg,2448,480,640,48,551,599,192,243,True,28
S,33,kaist_dataset/Mixed/Digital_Camera/(C.S)C-outdoor2/DSC02385.JPG,char_data/S/DSC02385.JPG_2.jpg,495,480,640,15,385,400,147,180,True,28
S,69,kaist_dataset/Mixed/Digital_Camera/(C.S)C-outdoor2/DSC02418.JPG,char_data/S/DSC02418.JPG_4.jpg,4830,480,640,70,25,95,155,224,True,28
S,30,kaist_dataset/Mixed/Digital_Camera/(C.S)C-outdoor2/DSC02421.JPG,char_data/S/DSC02421.JPG_4.jpg,870,480,640,29,54,83,209,239,True,28
S,31,kaist_dataset/Mixed/Digital_Camera/(C.S)C-outdoor2/DSC02421.JPG,char_data/S/DSC02421.JPG_5.jpg,930,480,640,30,170,200,208,239,True,28
S,100,kaist_dataset/Mixed/Digital_Camera/(C.S)C-outdoor2/DSC02433.JPG,char_data/S/DSC02433.JPG_2.jpg,4300,480,640,43,37,80,165,265,True,28
S,28,kaist_dataset/Mixed/Digital_Camera/(C.S)C-outdoor2/DSC02439.JPG,char_data/S/DSC02439.JPG_2.jpg,560,480,640,20,317,337,107,135,True,28
S,31,kaist_dataset/Mixed/Digital_Camera/(C.S)C-outdoor2/DSC02483.JPG,char_data/S/DSC02483.JPG_5.jpg,682,480,640,22,382,404,147,178,True,28
S,39,kaist_dataset/Mixed/Digital_Camera/(C.S)C-outdoor2/DSC02557.JPG,char_data/S/DSC02557.JPG_2.jpg,1014,480,640,26,52,78,223,262,True,28
S,31,kaist_dataset/Mixed/Digital_Camera/(C.S)C-outdoor2/DSC02568.JPG,char_data/S/DSC02568.JPG_5.jpg,837,480,640,27,209,236,149,180,True,28
S,39,kaist_dataset/Mixed/Digital_Camera/(C.S)C-outdoor2/DSC02864.JPG,char_data/S/DSC02864.JPG_2.jpg,1131,480,640,29,527,556,257,296,True,28
S,72,kaist_dataset/Mixed/Digital_Camera/(C.S)C-outdoor2/DSC02866.JPG,char_data/S/DSC02866.JPG_2.jpg,2520,480,640,35,594,629,104,176,True,28
S,44,kaist_dataset/Mixed/Digital_Camera/(C.S)C-outdoor2/DSC02867.JPG,char_data/S/DSC02867.JPG_2.jpg,1364,480,640,31,311,342,401,445,True,28
S,48,kaist_dataset/Mixed/Digital_Camera/(C.S)C-outdoor2/DSC02869.JPG,char_data/S/DSC02869.JPG_4.jpg,912,480,640,19,112,131,133,181,True,28
S,69,kaist_dataset/Mixed/Digital_Camera/(C.S)C-outdoor2/DSC02870.JPG,char_data/S/DSC02870.JPG_2.jpg,3657,480,640,53,175,228,274,343,True,28
S,38,kaist_dataset/Mixed/Digital_Camera/(C.S)C-outdoor2/DSC02910.JPG,char_data/S/DSC02910.JPG_4.jpg,798,480,640,21,313,334,53,91,True,28
S,36,kaist_dataset/Mixed/Digital_Camera/(C.S)C-outdoor2/DSC02910.JPG,char_data/S/DSC02910.JPG_5.jpg,684,480,640,19,424,443,54,90,True,28
S,35,kaist_dataset/Mixed/Digital_Camera/(C.S)C-outdoor2/DSC02912.JPG,char_data/S/DSC02912.JPG_2.jpg,1155,480,640,33,210,243,9,44,True,28
S,113,kaist_dataset/Mixed/Digital_Camera/(C.S)C-outdoor2/DSC02917.JPG,char_data/S/DSC02917.JPG_12.jpg,7910,480,640,70,210,280,68,181,True,28
S,119,kaist_dataset/Mixed/Digital_Camera/(C.S)C-outdoor2/DSC02917.JPG,char_data/S/DSC02917.JPG_13.jpg,8568,480,640,72,277,349,64,183,True,28
S,113,kaist_dataset/Mixed/Digital_Camera/(C.S)C-outdoor2/DSC02917.JPG,char_data/S/DSC02917.JPG_14.jpg,8136,480,640,72,425,497,68,181,True,28
S,36,kaist_dataset/Mixed/Digital_Camera/(C.S)C-outdoor2/DSC02917.JPG,char_data/S/DSC02917.JPG_15.jpg,720,480,640,20,40,60,220,256,True,28
S,34,kaist_dataset/Mixed/Digital_Camera/(C.S)C-outdoor2/DSC02917.JPG,char_data/S/DSC02917.JPG_16.jpg,680,480,640,20,59,79,222,256,True,28
S,33,kaist_dataset/Mixed/Digital_Camera/(C.S)C-outdoor2/DSC02917.JPG,char_data/S/DSC02917.JPG_17.jpg,693,480,640,21,101,122,226,259,True,28
S,36,kaist_dataset/Mixed/Digital_Camera/(C.S)C-outdoor3/DSC02986.JPG,char_data/S/DSC02986.JPG_2.jpg,1260,480,640,35,326,361,281,317,True,28
S,63,kaist_dataset/Mixed/Digital_Camera/(C.S)C-outdoor3/DSC02989.JPG,char_data/S/DSC02989.JPG_4.jpg,3276,480,640,52,399,451,191,254,True,28
S,42,kaist_dataset/Mixed/Digital_Camera/(C.S)C-outdoor3/DSC02989.JPG,char_data/S/DSC02989.JPG_5.jpg,1260,480,640,30,500,530,271,313,True,28
S,40,kaist_dataset/Mixed/Digital_Camera/(C.S)C-outdoor3/DSC03020.JPG,char_data/S/DSC03020.JPG_4.jpg,1360,480,640,34,521,555,261,301,True,28
S,22,kaist_dataset/Mixed/Digital_Camera/(C.S)C-outdoor3/DSC03033.JPG,char_data/S/DSC03033.JPG_2.jpg,308,480,640,14,115,129,153,175,True,28
S,46,kaist_dataset/Mixed/Digital_Camera/(C.S)C-outdoor3/DSC03223.JPG,char_data/S/DSC03223.JPG_2.jpg,1426,480,640,31,99,130,430,476,True,28
S,35,kaist_dataset/Mixed/Digital_Camera/(C.S)C-outdoor3/DSC03233.JPG,char_data/S/DSC03233.JPG_2.jpg,840,480,640,24,41,65,287,322,True,28
S,100,kaist_dataset/Mixed/Digital_Camera/(C.S)C-outdoor3/DSC03247.JPG,char_data/S/DSC03247.JPG_4.jpg,5700,480,640,57,524,581,164,264,True,28
S,93,kaist_dataset/Mixed/Digital_Camera/(C.S)C-outdoor3/DSC03247.JPG,char_data/S/DSC03247.JPG_5.jpg,4743,480,640,51,223,274,141,234,True,28
S,74,kaist_dataset/Mixed/Digital_Camera/(C.S)C-outdoor3/DSC03265.JPG,char_data/S/DSC03265.JPG_2.jpg,3996,480,640,54,151,205,187,261,True,28
S,80,kaist_dataset/Mixed/Digital_Camera/(C.S)C-outdoor3/DSC03266.JPG,char_data/S/DSC03266.JPG_2.jpg,4160,480,640,52,132,184,169,249,True,28
S,30,kaist_dataset/Mixed/Digital_Camera/(C.S)C-outdoor3/DSC03271.JPG,char_data/S/DSC03271.JPG_2.jpg,720,480,640,24,256,280,113,143,True,28
S,75,kaist_dataset/Mixed/Digital_Camera/(C.S)C-outdoor3/DSC03274.JPG,char_data/S/DSC03274.JPG_2.jpg,4800,480,640,64,342,406,83,158,True,28
S,76,kaist_dataset/Mixed/Digital_Camera/(C.S)C-outdoor3/DSC03311.JPG,char_data/S/DSC03311.JPG_2.jpg,5852,480,640,77,16,93,308,384,True,28
S,61,kaist_dataset/Mixed/Digital_Camera/(C.S)C-outdoor3/DSC03429.JPG,char_data/S/DSC03429.JPG_2.jpg,2562,480,640,42,396,438,137,198,True,28
S,44,kaist_dataset/Mixed/Digital_Camera/(C.S)C-outdoor4/DSC03604.JPG,char_data/S/DSC03604.JPG_2.jpg,1452,480,640,33,344,377,212,256,True,28
S,95,kaist_dataset/Mixed/Digital_Camera/(C.S)C-outdoor4/DSC03651.JPG,char_data/S/DSC03651.JPG_2.jpg,7315,480,640,77,270,347,167,262,True,28
S,72,kaist_dataset/Mixed/Digital_Camera/(C.S)C-outdoor4/DSC03661.JPG,char_data/S/DSC03661.JPG_2.jpg,2016,480,640,28,457,485,240,312,True,28
S,36,kaist_dataset/Mixed/Digital_Camera/(C.S)C-outdoor4/DSC03666.JPG,char_data/S/DSC03666.JPG_2.jpg,1188,480,640,33,114,147,116,152,True,28
S,64,kaist_dataset/Mixed/Digital_Camera/(C.S)C-outdoor4/DSC03673.JPG,char_data/S/DSC03673.JPG_2.jpg,3072,480,640,48,86,134,181,245,True,28
S,39,kaist_dataset/Mixed/Digital_Camera/(C.S)C-outdoor4/DSC03679.JPG,char_data/S/DSC03679.JPG_2.jpg,1014,480,640,26,123,149,99,138,True,28
S,26,kaist_dataset/Mixed/Digital_Camera/(C.S)C-outdoor4/DSC03687.JPG,char_data/S/DSC03687.JPG_2.jpg,442,480,640,17,143,160,296,322,True,28
S,36,kaist_dataset/Mixed/Digital_Camera/(C.S)C-outdoor4/DSC03711.JPG,char_data/S/DSC03711.JPG_4.jpg,648,480,640,18,310,328,389,425,True,28
S,41,kaist_dataset/Mixed/Digital_Camera/(C.S)C-outdoor4/DSC03711.JPG,char_data/S/DSC03711.JPG_5.jpg,984,480,640,24,440,464,382,423,True,28
S,34,kaist_dataset/Mixed/Digital_Camera/(C.S)C-outdoor4/DSC03716.JPG,char_data/S/DSC03716.JPG_2.jpg,578,480,640,17,427,444,240,274,True,28
S,35,kaist_dataset/Mixed/Digital_Camera/(C.S)C-outdoor4/DSC03718.JPG,char_data/S/DSC03718.JPG_4.jpg,525,480,640,15,336,351,93,128,True,28
S,133,kaist_dataset/Mixed/Digital_Camera/(C.S)C-outdoor5/DSC03819.JPG,char_data/S/DSC03819.JPG_2.jpg,9975,480,640,75,294,369,57,190,True,28
S,34,kaist_dataset/Mixed/Digital_Camera/(C.S)C-outdoor5/DSC03829.JPG,char_data/S/DSC03829.JPG_2.jpg,714,480,640,21,404,425,176,210,True,28
S,43,kaist_dataset/Mixed/Digital_Camera/(C.S)C-outdoor5/DSC03839.JPG,char_data/S/DSC03839.JPG_6.jpg,989,480,640,23,171,194,31,74,True,28
S,43,kaist_dataset/Mixed/Digital_Camera/(C.S)C-outdoor5/DSC03839.JPG,char_data/S/DSC03839.JPG_7.jpg,946,480,640,22,344,366,31,74,True,28
S,89,kaist_dataset/Mixed/Digital_Camera/(C.S)C-outdoor5/DSC03839.JPG,char_data/S/DSC03839.JPG_8.jpg,7209,480,640,81,235,316,201,290,True,28
S,47,kaist_dataset/Mixed/Digital_Camera/(C.S)C-outdoor5/DSC03847.JPG,char_data/S/DSC03847.JPG_2.jpg,1316,480,640,28,313,341,86,133,True,28
S,54,kaist_dataset/Mixed/Digital_Camera/(C.S)C-outdoor5/DSC04014.JPG,char_data/S/DSC04014.JPG_2.jpg,2214,480,640,41,269,310,102,156,True,28
S,121,kaist_dataset/Mixed/Digital_Camera/(C.S)C-outdoor5/DSC04055.JPG,char_data/S/DSC04055.JPG_2.jpg,9801,480,640,81,469,550,239,360,True,28
S,57,kaist_dataset/Mixed/Digital_Camera/(C.S)C-outdoor5/DSC04060.JPG,char_data/S/DSC04060.JPG_4.jpg,2622,480,640,46,67,113,184,241,True,28
S,62,kaist_dataset/Mixed/Digital_Camera/(C.S)C-outdoor5/DSC04060.JPG,char_data/S/DSC04060.JPG_5.jpg,2604,480,640,42,240,282,175,237,True,28
S,39,kaist_dataset/Mixed/Digital_Camera/(C.S)C-outdoor5/DSC04063.JPG,char_data/S/DSC04063.JPG_2.jpg,663,480,640,17,584,601,310,349,True,28
S,46,kaist_dataset/Mixed/Digital_Camera/(C.S)C-outdoor5/DSC04065.JPG,char_data/S/DSC04065.JPG_4.jpg,1288,480,640,28,449,477,135,181,True,28
S,40,kaist_dataset/Mixed/Digital_Camera/(C.S)C-outdoor5/DSC04065.JPG,char_data/S/DSC04065.JPG_5.jpg,1320,480,640,33,576,609,144,184,True,28
S,46,kaist_dataset/Mixed/Digital_Camera/(C.S)C-outdoor5/DSC04098.JPG,char_data/S/DSC04098.JPG_2.jpg,1610,480,640,35,463,498,84,130,True,28
S,57,kaist_dataset/Mixed/Digital_Camera/(C.S)C-outdoor5/DSC04111.JPG,char_data/S/DSC04111.JPG_2.jpg,1596,480,640,28,444,472,113,170,True,28
S,45,kaist_dataset/Mixed/Digital_Camera/(C.S)C-outdoor5/DSC04119.JPG,char_data/S/DSC04119.JPG_2.jpg,1530,480,640,34,481,515,138,183,False,28
S,83,kaist_dataset/Mixed/Digital_Camera/(C.S)C-outdoor5/DSC04122.JPG,char_data/S/DSC04122.JPG_2.jpg,5146,480,640,62,330,392,302,385,False,28
S,95,kaist_dataset/Mixed/Digital_Camera/(C.S)C-outdoor5/DSC04151.JPG,char_data/S/DSC04151.JPG_2.jpg,7030,480,640,74,415,489,238,333,False,28
S,48,kaist_dataset/Mixed/Digital_Camera/(C.S)C-outdoor5/DSC04322.JPG,char_data/S/DSC04322.JPG_2.jpg,1440,480,640,30,433,463,215,263,False,28
S,39,kaist_dataset/Mixed/Digital_Camera/(C.S)C-outdoor5/DSC04338.JPG,char_data/S/DSC04338.JPG_2.jpg,663,480,640,17,31,48,195,234,False,28
S,29,kaist_dataset/Mixed/Digital_Camera/(C.S)C-outdoor5/DSC04360.JPG,char_data/S/DSC04360.JPG_6.jpg,551,480,640,19,121,140,314,343,False,28
S,30,kaist_dataset/Mixed/Digital_Camera/(C.S)C-outdoor5/DSC04360.JPG,char_data/S/DSC04360.JPG_7.jpg,360,480,640,12,126,138,345,375,False,28
S,35,kaist_dataset/Mixed/Digital_Camera/(C.S)C-outdoor5/DSC04360.JPG,char_data/S/DSC04360.JPG_8.jpg,805,480,640,23,50,73,375,410,False,28
S,72,kaist_dataset/Mixed/Digital_Camera/(C.S)C-outdoor5/DSC04368.JPG,char_data/S/DSC04368.JPG_2.jpg,3672,480,640,51,273,324,277,349,False,28
S,64,kaist_dataset/Mixed/Digital_Camera/(C.S)C-outdoor5/DSC04401.JPG,char_data/S/DSC04401.JPG_2.jpg,2816,480,640,44,156,200,13,77,False,28
S,195,kaist_dataset/Mixed/Digital_Camera/(C.S)C-outdoor6/080116-0057.jpg,char_data/S/080116-0057.jpg_8.jpg,23400,1200,1600,120,881,1001,522,717,False,28
S,23,kaist_dataset/Mixed/Digital_Camera/(C.S)C-outdoor6/P1010063.JPG,char_data/S/P1010063.JPG_2.jpg,299,480,640,13,222,235,435,458,False,28
S,22,kaist_dataset/Mixed/Digital_Camera/(C.S)C-outdoor6/P1010065.JPG,char_data/S/P1010065.JPG_2.jpg,264,480,640,12,163,175,106,128,False,28
S,29,kaist_dataset/Mixed/Digital_Camera/(C.S)C-outdoor6/P1010090.JPG,char_data/S/P1010090.JPG_2.jpg,754,480,640,26,196,222,203,232,False,28
S,25,kaist_dataset/Mixed/Digital_Camera/(C.S)C-outdoor6/P1010114.JPG,char_data/S/P1010114.JPG_4.jpg,400,480,640,16,221,237,220,245,False,28
S,25,kaist_dataset/Mixed/Digital_Camera/(C.S)C-outdoor6/P1010114.JPG,char_data/S/P1010114.JPG_5.jpg,350,480,640,14,274,288,219,244,False,28
S,89,kaist_dataset/Mixed/Digital_Camera/(C.S)C-outdoor6/P1010116.JPG,char_data/S/P1010116.JPG_2.jpg,2403,480,640,27,230,257,182,271,False,28
S,51,kaist_dataset/Mixed/Digital_Camera/(C.S)C-outdoor6/P1010132.JPG,char_data/S/P1010132.JPG_2.jpg,2040,480,640,40,533,573,150,201,False,28
S,80,kaist_dataset/Mixed/Digital_Camera/(C.S)D-indoor1/DSC02756.JPG,char_data/S/DSC02756.JPG_4.jpg,4480,480,640,56,159,215,186,266,False,28
S,34,kaist_dataset/Mixed/Digital_Camera/(C.S)D-indoor1/DSC02756.JPG,char_data/S/DSC02756.JPG_5.jpg,714,480,640,21,380,401,145,179,False,28
S,40,kaist_dataset/Mixed/Digital_Camera/(C.S)D-indoor1/DSC02804.JPG,char_data/S/DSC02804.JPG_2.jpg,800,480,640,20,269,289,352,392,False,28
S,58,kaist_dataset/Mixed/Digital_Camera/(C.S)D-indoor1/DSC03119.JPG,char_data/S/DSC03119.JPG_2.jpg,1798,480,640,31,141,172,155,213,False,28
S,54,kaist_dataset/Mixed/Digital_Camera/(C.S)D-indoor1/DSC03132.JPG,char_data/S/DSC03132.JPG_4.jpg,1620,480,640,30,282,312,166,220,False,28
S,49,kaist_dataset/Mixed/Digital_Camera/(C.S)D-indoor1/DSC03132.JPG,char_data/S/DSC03132.JPG_5.jpg,1421,480,640,29,313,342,243,292,False,28
S,61,kaist_dataset/Mixed/Digital_Camera/(C.S)D-indoor1/DSC03455.JPG,char_data/S/DSC03455.JPG_2.jpg,2806,480,640,46,129,175,387,448,False,28
S,109,kaist_dataset/Mixed/Digital_Camera/(C.S)D-indoor1/DSC03469.JPG,char_data/S/DSC03469.JPG_2.jpg,7521,480,640,69,32,101,316,425,False,28
S,67,kaist_dataset/Mixed/Digital_Camera/(C.S)D-indoor1/DSC03913.JPG,char_data/S/DSC03913.JPG_2.jpg,2814,480,640,42,356,398,101,168,False,28
S,65,kaist_dataset/Mixed/Digital_Camera/(C.S)D-indoor1/DSC03959.JPG,char_data/S/DSC03959.JPG_2.jpg,2340,480,640,36,411,447,103,168,False,28
S,37,kaist_dataset/Mixed/Digital_Camera/(C.S)D-indoor1/DSC03980.JPG,char_data/S/DSC03980.JPG_4.jpg,740,480,640,20,420,440,145,182,False,28
S,40,kaist_dataset/Mixed/Digital_Camera/(C.S)D-indoor1/DSC03980.JPG,char_data/S/DSC03980.JPG_5.jpg,760,480,640,19,440,459,144,184,False,28
S,41,kaist_dataset/Mixed/Digital_Camera/(C.S)D-indoor1/DSC04022.JPG,char_data/S/DSC04022.JPG_2.jpg,1189,480,640,29,286,315,160,201,False,28
S,161,kaist_dataset/Mixed/Digital_Camera/(C.S)D-indoor1/DSC04173.JPG,char_data/S/DSC04173.JPG_2.jpg,10626,480,640,66,177,243,313,474,False,28
S,175,kaist_dataset/Mixed/Digital_Camera/(C.S)D-indoor1/DSC04223.JPG,char_data/S/DSC04223.JPG_2.jpg,16275,480,640,93,498,591,7,182,False,28
S,41,kaist_dataset/Mixed/Digital_Camera/(C.S)D-indoor1/DSC04246.JPG,char_data/S/DSC04246.JPG_2.jpg,1107,480,640,27,295,322,243,284,False,28
S,83,kaist_dataset/Mixed/Digital_Camera/(C.S)D-indoor2/DSC04442.JPG,char_data/S/DSC04442.JPG_2.jpg,4482,480,640,54,201,255,286,369,False,28
S,53,kaist_dataset/Mixed/Digital_Camera/(C.S)D-indoor2/DSC04487.JPG,char_data/S/DSC04487.JPG_2.jpg,1431,480,640,27,154,181,161,214,False,28
S,30,kaist_dataset/Mixed/Digital_Camera/(C.S)E-night/DSC02569.JPG,char_data/S/DSC02569.JPG_4.jpg,780,480,640,26,210,236,278,308,False,28
S,116,kaist_dataset/Mixed/Digital_Camera/(C.S)E-night/DSC02571.JPG,char_data/S/DSC02571.JPG_2.jpg,4292,480,640,37,191,228,195,311,False,28
S,61,kaist_dataset/Mixed/Digital_Camera/(C.S)E-night/DSC02595.JPG,char_data/S/DSC02595.JPG_2.jpg,3050,480,640,50,130,180,356,417,False,28
S,55,kaist_dataset/Mixed/Digital_Camera/(C.S)E-night/DSC02672.JPG,char_data/S/DSC02672.JPG_6.jpg,2475,480,640,45,28,73,95,150,False,28
S,62,kaist_dataset/Mixed/Digital_Camera/(C.S)E-night/DSC02672.JPG,char_data/S/DSC02672.JPG_7.jpg,2480,480,640,40,161,201,93,155,False,28
S,48,kaist_dataset/Mixed/Digital_Camera/(C.S)E-night/DSC02672.JPG,char_data/S/DSC02672.JPG_8.jpg,912,480,640,19,409,428,169,217,False,28
S,51,kaist_dataset/Mixed/Digital_Camera/(C.S)E-night/DSC03517.JPG,char_data/S/DSC03517.JPG_2.jpg,1173,480,640,23,216,239,81,132,False,28
S,64,kaist_dataset/Mixed/Digital_Camera/(C.S)E-night/DSC03840.JPG,char_data/S/DSC03840.JPG_4.jpg,4096,480,640,64,34,98,99,163,False,28
S,39,kaist_dataset/Mixed/Digital_Camera/(C.S)E-night/DSC03871.JPG,char_data/S/DSC03871.JPG_2.jpg,741,480,640,19,362,381,186,225,False,28
S,28,kaist_dataset/Mixed/Digital_Camera/(C.S)E-night/P1010151.JPG,char_data/S/P1010151.JPG_2.jpg,616,480,640,22,466,488,201,229,False,28
S,44,kaist_dataset/Mixed/Digital_Camera/(C.S)E-night/사진9.jpg수정.jpg,char_data/S/사진9.jpg수정.jpg_2.jpg,1760,480,680,40,342,382,250,294,False,28
S,48,kaist_dataset/Mixed/Digital_Camera/(C.S)F-others/047.jpg,char_data/S/047.jpg_5.jpg,1248,252,339,26,275,301,114,162,False,28
S,39,kaist_dataset/Mixed/Digital_Camera/(C.S)F-others/085.jpg,char_data/S/085.jpg_2.jpg,1404,480,640,36,307,343,193,232,False,28
S,28,kaist_dataset/Mixed/Digital_Camera/(C.S)F-others/097.jpg,char_data/S/097.jpg_4.jpg,448,480,640,16,169,185,164,192,False,28
S,31,kaist_dataset/Mixed/Digital_Camera/(C.S)F-others/097.jpg,char_data/S/097.jpg_5.jpg,465,480,640,15,338,353,170,201,False,28
S,39,kaist_dataset/Mixed/Digital_Camera/(C.S)F-others/DSC02504.JPG,char_data/S/DSC02504.JPG_2.jpg,1170,480,640,30,319,349,312,351,False,28
S,104,kaist_dataset/Mixed/Digital_Camera/(C.S)F-others/DSC02609.JPG,char_data/S/DSC02609.JPG_10.jpg,7176,480,640,69,157,226,205,309,False,28
S,37,kaist_dataset/Mixed/Digital_Camera/(C.S)F-others/DSC02609.JPG,char_data/S/DSC02609.JPG_11.jpg,925,480,640,25,162,187,319,356,False,28
S,31,kaist_dataset/Mixed/Mobile_Phone/(C.M)A-outdoor/P090908006.jpg,char_data/S/P090908006.jpg_6.jpg,496,480,640,16,54,70,375,406,False,28
S,27,kaist_dataset/Mixed/Mobile_Phone/(C.M)A-outdoor/P090908006.jpg,char_data/S/P090908006.jpg_7.jpg,621,480,640,23,123,146,373,400,False,28
S,29,kaist_dataset/Mixed/Mobile_Phone/(C.M)A-outdoor/P090908006.jpg,char_data/S/P090908006.jpg_8.jpg,522,480,640,18,162,180,373,402,False,28
S,45,kaist_dataset/Mixed/Mobile_Phone/(C.M)A-outdoor/P090912078.jpg,char_data/S/P090912078.jpg_7.jpg,1125,480,640,25,230,255,301,346,False,28
S,39,kaist_dataset/Mixed/Mobile_Phone/(C.M)A-outdoor/P090912078.jpg,char_data/S/P090912078.jpg_8.jpg,1131,480,640,29,320,349,296,335,False,28
S,39,kaist_dataset/Mixed/Mobile_Phone/(C.M)B-indoor/P090831005.jpg,char_data/S/P090831005.jpg_2.jpg,1014,480,640,26,125,151,232,271,False,28
S,85,kaist_dataset/Mixed/Mobile_Phone/(C.M)B-indoor/P090831008.jpg,char_data/S/P090831008.jpg_2.jpg,5865,480,640,69,63,132,305,390,False,28
S,49,kaist_dataset/Mixed/Mobile_Phone/(C.M)B-indoor/P090831016.jpg,char_data/S/P090831016.jpg_4.jpg,2107,480,640,43,214,257,183,232,False,28
S,64,kaist_dataset/Mixed/Mobile_Phone/(C.M)B-indoor/P090831017.jpg,char_data/S/P090831017.jpg_2.jpg,2944,480,640,46,163,209,228,292,False,28
S,38,kaist_dataset/Mixed/Mobile_Phone/(C.M)B-indoor/P090831021.jpg,char_data/S/P090831021.jpg_4.jpg,874,480,640,23,291,314,42,80,False,28
S,40,kaist_dataset/Mixed/Mobile_Phone/(C.M)B-indoor/P090831021.jpg,char_data/S/P090831021.jpg_5.jpg,1200,480,640,30,345,375,380,420,False,28
S,38,kaist_dataset/Mixed/Mobile_Phone/(C.M)C-bookCover/P090831062.jpg,char_data/S/P090831062.jpg_2.jpg,1216,480,640,32,190,222,300,338,False,28
S,60,kaist_dataset/Mixed/Mobile_Phone/(C.M)C-bookCover/P090831118.jpg,char_data/S/P090831118.jpg_2.jpg,1440,480,640,24,222,246,203,263,False,28
S,101,kaist_dataset/Mixed/Mobile_Phone/(C.M)C-bookCover/P090831136.jpg,char_data/S/P090831136.jpg_2.jpg,7676,480,640,76,326,402,226,327,False,28
S,50,kaist_dataset/Mixed/Mobile_Phone/(C.M)C-bookCover/P090902016.jpg,char_data/S/P090902016.jpg_12.jpg,1100,480,640,22,39,61,197,247,False,28
S,38,kaist_dataset/Mixed/Mobile_Phone/(C.M)C-bookCover/P090902016.jpg,char_data/S/P090902016.jpg_14.jpg,836,480,640,22,441,463,274,312,False,28
S,73,kaist_dataset/Mixed/Mobile_Phone/(C.M)C-bookCover/P090902019.jpg,char_data/S/P090902019.jpg_2.jpg,2920,480,640,40,168,208,278,351,False,28
9,165,kaist_dataset/English/Digital_Camera/(E.S)C-outdoor1/2007-12-08-day-111.jpg,char_data/9/2007-12-08-day-111.jpg_2.jpg,22605,1200,1600,137,425,562,436,601,True,11
9,39,kaist_dataset/English/Digital_Camera/(E.S)C-outdoor1/DSC02415.JPG,char_data/9/DSC02415.JPG_2.jpg,858,480,640,22,577,599,250,289,True,11
9,51,kaist_dataset/English/Digital_Camera/(E.S)C-outdoor2/DSC03650.JPG,char_data/9/DSC03650.JPG_2.jpg,1377,480,640,27,393,420,293,344,True,11
9,25,kaist_dataset/English/Digital_Camera/(E.S)C-outdoor3/크기변환_P1010076.JPG,char_data/9/크기변환_P1010076.JPG_2.jpg,350,480,640,14,625,639,178,203,True,11
9,28,kaist_dataset/English/Digital_Camera/(E.S)E-night/크기변환_%BA%F7%BD%BA%BD%C5%B8%DE%B4%BA_01_tjtjdska2008.jpg,char_data/9/크기변환_%BA%F7%BD%BA%BD%C5%B8%DE%B4%BA_01_tjtjdska2008.jpg_4.jpg,392,480,640,14,354,368,277,305,True,11
9,28,kaist_dataset/English/Digital_Camera/(E.S)E-night/크기변환_%BA%F7%BD%BA%BD%C5%B8%DE%B4%BA_01_tjtjdska2008.jpg,char_data/9/크기변환_%BA%F7%BD%BA%BD%C5%B8%DE%B4%BA_01_tjtjdska2008.jpg_5.jpg,392,480,640,14,368,382,275,303,True,11
9,35,kaist_dataset/English/Digital_Camera/(E.S)F-others/DSC02923.JPG,char_data/9/DSC02923.JPG_2.jpg,700,480,640,20,307,327,398,433,True,11
9,36,kaist_dataset/English/Digital_Camera/(E.S)F-others/m.jpg,char_data/9/m.jpg_2.jpg,612,240,320,17,145,162,167,203,True,11
9,68,kaist_dataset/Korean/Digital_Camera/A-shadow/2007-12-09-day-exterior-026.jpg,char_data/9/2007-12-09-day-exterior-026.jpg_6.jpg,2584,1200,1600,38,1074,1112,759,827,True,11
9,68,kaist_dataset/Korean/Digital_Camera/A-shadow/2007-12-09-day-exterior-026.jpg,char_data/9/2007-12-09-day-exterior-026.jpg_7.jpg,2652,1200,1600,39,1109,1148,759,827,True,11
9,72,kaist_dataset/Korean/Digital_Camera/A-shadow/2007-12-09-day-exterior-026.jpg,char_data/9/2007-12-09-day-exterior-026.jpg_8.jpg,3528,1200,1600,49,1148,1197,759,831,True,11
9,46,kaist_dataset/Korean/Digital_Camera/A-shadow/DSC02598.JPG,char_data/9/DSC02598.JPG_4.jpg,782,480,640,17,612,629,416,462,True,11
9,74,kaist_dataset/Korean/Digital_Camera/A-shadow/DSC03535.JPG,char_data/9/DSC03535.JPG_4.jpg,3108,480,640,42,415,457,246,320,True,11
9,65,kaist_dataset/Korean/Digital_Camera/A-shadow/DSC03535.JPG,char_data/9/DSC03535.JPG_5.jpg,2470,480,640,38,489,527,247,312,True,11
9,37,kaist_dataset/Korean/Digital_Camera/A-shadow/DSC04297.JPG,char_data/9/DSC04297.JPG_4.jpg,555,480,640,15,360,375,206,243,True,11
9,36,kaist_dataset/Korean/Digital_Camera/A-shadow/DSC04297.JPG,char_data/9/DSC04297.JPG_5.jpg,504,480,640,14,478,492,207,243,True,11
9,121,kaist_dataset/Korean/Digital_Camera/A-shadow/DSC04300.JPG,char_data/9/DSC04300.JPG_2.jpg,6292,480,640,52,300,352,236,357,True,11
9,29,kaist_dataset/Korean/Digital_Camera/E-night/DSC02626.JPG,char_data/9/DSC02626.JPG_4.jpg,551,480,640,19,135,154,375,404,True,11
9,32,kaist_dataset/Korean/Digital_Camera/E-night/DSC02626.JPG,char_data/9/DSC02626.JPG_5.jpg,608,480,640,19,162,181,372,404,True,11
9,46,kaist_dataset/Korean/Digital_Camera/E-night/DSC02645.JPG,char_data/9/DSC02645.JPG_2.jpg,1242,480,640,27,394,421,333,379,True,11
9,44,kaist_dataset/Korean/Digital_Camera/E-night/DSC03515.JPG,char_data/9/DSC03515.JPG_2.jpg,792,480,640,18,544,562,270,314,True,11
9,24,kaist_dataset/Korean/Digital_Camera/E-night/P1010146.JPG,char_data/9/P1010146.JPG_2.jpg,504,480,640,21,241,262,252,276,True,11
9,43,kaist_dataset/Korean/Digital_Camera/G-others/005.JPG,char_data/9/005.JPG_2.jpg,903,768,576,21,330,351,411,454,True,11
9,48,kaist_dataset/Korean/Digital_Camera/G-others/2007-12-08-day-045.jpg,char_data/9/2007-12-08-day-045.jpg_4.jpg,672,1200,1600,14,176,190,790,838,True,11
9,47,kaist_dataset/Korean/Digital_Camera/G-others/2007-12-08-day-045.jpg,char_data/9/2007-12-08-day-045.jpg_5.jpg,658,1200,1600,14,211,225,789,836,True,11
9,92,kaist_dataset/Korean/Digital_Camera/G-others/2007-12-08-day-108.jpg,char_data/9/2007-12-08-day-108.jpg_2.jpg,3956,1200,1600,43,651,694,695,787,True,11
9,20,kaist_dataset/Korean/Digital_Camera/G-others/2007-12-08-day-112.jpg,char_data/9/2007-12-08-day-112.jpg_2.jpg,200,1200,1600,10,416,426,1178,1198,True,11
9,101,kaist_dataset/Korean/Digital_Camera/G-others/2007-12-09-day-exterior-062.jpg,char_data/9/2007-12-09-day-exterior-062.jpg_4.jpg,3232,1600,1200,32,665,697,1407,1508,True,11
9,104,kaist_dataset/Korean/Digital_Camera/G-others/2007-12-09-day-exterior-062.jpg,char_data/9/2007-12-09-day-exterior-062.jpg_5.jpg,4264,1600,1200,41,698,739,1406,1510,True,11
9,192,kaist_dataset/Korean/Digital_Camera/indoor1/DSC02699.JPG,char_data/9/DSC02699.JPG_2.jpg,23424,480,640,122,154,276,232,424,True,11
9,154,kaist_dataset/Korean/Digital_Camera/indoor1/DSC02700.JPG,char_data/9/DSC02700.JPG_6.jpg,15862,480,640,103,240,343,214,368,True,11
9,32,kaist_dataset/Korean/Digital_Camera/indoor1/DSC02700.JPG,char_data/9/DSC02700.JPG_7.jpg,544,480,640,17,128,145,420,452,True,11
9,30,kaist_dataset/Korean/Digital_Camera/indoor1/DSC02700.JPG,char_data/9/DSC02700.JPG_8.jpg,540,480,640,18,241,259,424,454,True,11
9,86,kaist_dataset/Korean/Digital_Camera/indoor1/DSC03364.JPG,char_data/9/DSC03364.JPG_2.jpg,5504,480,640,64,353,417,240,326,True,11
9,58,kaist_dataset/Korean/Digital_Camera/indoor2/DSC03474.JPG,char_data/9/DSC03474.JPG_2.jpg,2146,480,640,37,305,342,151,209,True,11
9,41,kaist_dataset/Korean/Digital_Camera/indoor2/DSC03530.JPG,char_data/9/DSC03530.JPG_2.jpg,779,480,640,19,271,290,218,259,True,11
9,33,kaist_dataset/Korean/Digital_Camera/indoor2/DSC03564.JPG,char_data/9/DSC03564.JPG_2.jpg,660,480,640,20,400,420,400,433,True,11
9,35,kaist_dataset/Korean/Digital_Camera/indoor2/DSC03975.JPG,char_data/9/DSC03975.JPG_2.jpg,525,480,640,15,243,258,289,324,True,11
9,79,kaist_dataset/Korean/Digital_Camera/indoor2/DSC04006.JPG,char_data/9/DSC04006.JPG_2.jpg,2370,480,640,30,338,368,144,223,True,11
9,23,kaist_dataset/Korean/Digital_Camera/outdoor1/011.JPG,char_data/9/011.JPG_4.jpg,529,480,640,23,426,449,258,281,True,11
9,22,kaist_dataset/Korean/Digital_Camera/outdoor1/011.JPG,char_data/9/011.JPG_5.jpg,484,480,640,22,467,489,258,280,True,11
9,25,kaist_dataset/Korean/Digital_Camera/outdoor1/017.JPG,char_data/9/017.JPG_2.jpg,475,480,640,19,485,504,268,293,True,11
9,29,kaist_dataset/Korean/Digital_Camera/outdoor1/035.JPG,char_data/9/035.JPG_2.jpg,551,480,640,19,339,358,288,317,True,11
9,27,kaist_dataset/Korean/Digital_Camera/outdoor1/040.JPG,char_data/9/040.JPG_2.jpg,891,480,640,33,386,419,301,328,True,11
9,34,kaist_dataset/Korean/Digital_Camera/outdoor1/069.JPG,char_data/9/069.JPG_2.jpg,476,480,640,14,352,366,266,300,True,11
9,26,kaist_dataset/Korean/Digital_Camera/outdoor1/071.JPG,char_data/9/071.JPG_2.jpg,546,480,640,21,334,355,259,285,True,11
9,51,kaist_dataset/Korean/Digital_Camera/outdoor1/098.JPG,char_data/9/098.JPG_4.jpg,1683,480,640,33,237,270,347,398,True,11
9,55,kaist_dataset/Korean/Digital_Camera/outdoor1/098.JPG,char_data/9/098.JPG_5.jpg,1925,480,640,35,269,304,345,400,True,11
9,33,kaist_dataset/Korean/Digital_Camera/outdoor1/102.JPG,char_data/9/102.JPG_2.jpg,594,480,640,18,428,446,307,340,True,11
9,41,kaist_dataset/Korean/Digital_Camera/outdoor1/123.JPG,char_data/9/123.JPG_4.jpg,861,480,640,21,288,309,273,314,True,11
9,36,kaist_dataset/Korean/Digital_Camera/outdoor1/123.JPG,char_data/9/123.JPG_5.jpg,756,480,640,21,267,288,275,311,True,11
9,29,kaist_dataset/Korean/Digital_Camera/outdoor1/126.JPG,char_data/9/126.JPG_2.jpg,435,480,640,15,539,554,256,285,True,11
9,45,kaist_dataset/Korean/Digital_Camera/outdoor1/2007-12-08-day-047.jpg,char_data/9/2007-12-08-day-047.jpg_4.jpg,1395,1200,1600,31,979,1010,714,759,True,11
9,46,kaist_dataset/Korean/Digital_Camera/outdoor1/2007-12-08-day-047.jpg,char_data/9/2007-12-08-day-047.jpg_5.jpg,1472,1200,1600,32,1039,1071,719,765,True,11
9,40,kaist_dataset/Korean/Digital_Camera/outdoor1/54.JPG,char_data/9/54.JPG_2.jpg,1000,523,767,25,549,574,366,406,True,11
9,40,kaist_dataset/Korean/Digital_Camera/outdoor2/2007-12-08-day-101.jpg,char_data/9/2007-12-08-day-101.jpg_4.jpg,680,1200,1600,17,861,878,744,784,True,11
9,38,kaist_dataset/Korean/Digital_Camera/outdoor2/2007-12-08-day-101.jpg,char_data/9/2007-12-08-day-101.jpg_5.jpg,722,1200,1600,19,878,897,745,783,True,11
9,71,kaist_dataset/Korean/Digital_Camera/outdoor2/2007-12-09-day-exterior-009.jpg,char_data/9/2007-12-09-day-exterior-009.jpg_2.jpg,2982,1200,1600,42,897,939,662,733,True,11
9,52,kaist_dataset/Korean/Digital_Camera/outdoor2/2007-12-09-day-exterior-016.jpg,char_data/9/2007-12-09-day-exterior-016.jpg_4.jpg,2080,1200,1600,40,691,731,750,802,True,11
9,45,kaist_dataset/Korean/Digital_Camera/outdoor2/2007-12-09-day-exterior-016.jpg,char_data/9/2007-12-09-day-exterior-016.jpg_5.jpg,1170,1200,1600,26,39,65,910,955,True,11
9,66,kaist_dataset/Korean/Digital_Camera/outdoor2/2007-12-09-day-exterior-033.jpg,char_data/9/2007-12-09-day-exterior-033.jpg_4.jpg,4686,1200,1600,71,754,825,726,792,True,11
9,71,kaist_dataset/Korean/Digital_Camera/outdoor2/2007-12-09-day-exterior-033.jpg,char_data/9/2007-12-09-day-exterior-033.jpg_5.jpg,5041,1200,1600,71,1055,1126,727,798,True,11
9,58,kaist_dataset/Korean/Digital_Camera/outdoor2/2007-12-09-day-exterior-035.jpg,char_data/9/2007-12-09-day-exterior-035.jpg_2.jpg,1740,1200,1600,30,710,740,708,766,True,11
9,53,kaist_dataset/Korean/Digital_Camera/outdoor2/DSC02305.JPG,char_data/9/DSC02305.JPG_2.jpg,1855,480,640,35,484,519,252,305,True,11
9,33,kaist_dataset/Korean/Digital_Camera/outdoor2/DSC02321.JPG,char_data/9/DSC02321.JPG_2.jpg,792,480,640,24,294,318,378,411,True,11
9,25,kaist_dataset/Korean/Digital_Camera/outdoor2/DSC02326.JPG,char_data/9/DSC02326.JPG_2.jpg,350,480,640,14,429,443,341,366,True,11
9,30,kaist_dataset/Korean/Digital_Camera/outdoor2/DSC02327.JPG,char_data/9/DSC02327.JPG_6.jpg,810,480,640,27,313,340,365,395,True,11
9,34,kaist_dataset/Korean/Digital_Camera/outdoor2/DSC02327.JPG,char_data/9/DSC02327.JPG_7.jpg,986,480,640,29,344,373,362,396,True,11
9,42,kaist_dataset/Korean/Digital_Camera/outdoor2/DSC02327.JPG,char_data/9/DSC02327.JPG_8.jpg,1092,480,640,26,376,402,358,400,True,11
9,48,kaist_dataset/Korean/Digital_Camera/outdoor2/DSC02366.JPG,char_data/9/DSC02366.JPG_4.jpg,1152,480,640,24,469,493,404,452,True,11
9,48,kaist_dataset/Korean/Digital_Camera/outdoor2/DSC02366.JPG,char_data/9/DSC02366.JPG_5.jpg,1296,480,640,27,495,522,404,452,True,11
9,35,kaist_dataset/Korean/Digital_Camera/outdoor2/DSC02371.JPG,char_data/9/DSC02371.JPG_4.jpg,770,480,640,22,215,237,241,276,True,11
9,31,kaist_dataset/Korean/Digital_Camera/outdoor2/DSC02371.JPG,char_data/9/DSC02371.JPG_5.jpg,682,480,640,22,237,259,242,273,True,11
9,43,kaist_dataset/Korean/Digital_Camera/outdoor2/DSC02381.JPG,char_data/9/DSC02381.JPG_2.jpg,1075,480,640,25,290,315,317,360,True,11
9,39,kaist_dataset/Korean/Digital_Camera/outdoor2/DSC02393.JPG,char_data/9/DSC02393.JPG_2.jpg,975,480,640,25,543,568,303,342,True,11
9,45,kaist_dataset/Korean/Digital_Camera/outdoor2/DSC02414.JPG,char_data/9/DSC02414.JPG_2.jpg,1800,480,640,40,443,483,242,287,True,11
9,29,kaist_dataset/Korean/Digital_Camera/outdoor2/DSC02435.JPG,char_data/9/DSC02435.JPG_2.jpg,464,480,640,16,545,561,246,275,True,11
9,82,kaist_dataset/Korean/Digital_Camera/outdoor2/DSC02451.JPG,char_data/9/DSC02451.JPG_2.jpg,4346,480,640,53,264,317,322,404,True,11
9,29,kaist_dataset/Korean/Digital_Camera/outdoor2/DSC02470.JPG,char_data/9/DSC02470.JPG_6.jpg,725,480,640,25,288,313,175,204,True,11
9,33,kaist_dataset/Korean/Digital_Camera/outdoor2/DSC02470.JPG,char_data/9/DSC02470.JPG_7.jpg,891,480,640,27,334,361,173,206,True,11
9,64,kaist_dataset/Korean/Digital_Camera/outdoor2/DSC02470.JPG,char_data/9/DSC02470.JPG_8.jpg,2496,480,640,39,457,496,373,437,True,11
9,54,kaist_dataset/Korean/Digital_Camera/outdoor2/DSC02515.JPG,char_data/9/DSC02515.JPG_2.jpg,2376,480,640,44,373,417,334,388,True,11
9,36,kaist_dataset/Korean/Digital_Camera/outdoor2/DSC02521.JPG,char_data/9/DSC02521.JPG_2.jpg,864,480,640,24,434,458,325,361,True,11
9,22,kaist_dataset/Korean/Digital_Camera/outdoor3/DSC02529.JPG,char_data/9/DSC02529.JPG_4.jpg,220,480,640,10,513,523,374,396,True,11
9,29,kaist_dataset/Korean/Digital_Camera/outdoor3/DSC02529.JPG,char_data/9/DSC02529.JPG_5.jpg,290,480,640,10,570,580,371,400,True,11
9,53,kaist_dataset/Korean/Digital_Camera/outdoor3/DSC02546.JPG,char_data/9/DSC02546.JPG_2.jpg,1908,480,640,36,374,410,118,171,True,11
9,40,kaist_dataset/Korean/Digital_Camera/outdoor3/DSC02561.JPG,char_data/9/DSC02561.JPG_2.jpg,1080,480,640,27,320,347,353,393,True,11
9,46,kaist_dataset/Korean/Digital_Camera/outdoor3/DSC02598.JPG,char_data/9/DSC02598.JPG_5.jpg,782,480,640,17,612,629,416,462,True,11
9,41,kaist_dataset/Korean/Digital_Camera/outdoor3/DSC02686.JPG,char_data/9/DSC02686.JPG_4.jpg,1066,480,640,26,520,546,225,266,True,11
9,45,kaist_dataset/Korean/Digital_Camera/outdoor3/DSC02686.JPG,char_data/9/DSC02686.JPG_5.jpg,1125,480,640,25,547,572,225,270,True,11
9,50,kaist_dataset/Korean/Digital_Camera/outdoor3/DSC02698.JPG,char_data/9/DSC02698.JPG_4.jpg,1200,480,640,24,188,212,394,444,True,11
9,44,kaist_dataset/Korean/Digital_Camera/outdoor3/DSC02698.JPG,char_data/9/DSC02698.JPG_5.jpg,924,480,640,21,315,336,395,439,True,11
9,39,kaist_dataset/Korean/Digital_Camera/outdoor3/DSC02888.JPG,char_data/9/DSC02888.JPG_2.jpg,1131,480,640,29,184,213,421,460,True,11
9,37,kaist_dataset/Korean/Digital_Camera/outdoor3/DSC02899.JPG,char_data/9/DSC02899.JPG_2.jpg,1295,480,640,35,552,587,225,262,True,11
9,33,kaist_dataset/Korean/Digital_Camera/outdoor3/DSC02975.JPG,char_data/9/DSC02975.JPG_4.jpg,891,480,640,27,386,413,246,279,True,11
9,36,kaist_dataset/Korean/Digital_Camera/outdoor3/DSC02975.JPG,char_data/9/DSC02975.JPG_5.jpg,936,480,640,26,413,439,242,278,True,11
9,30,kaist_dataset/Korean/Digital_Camera/outdoor3/DSC03219.JPG,char_data/9/DSC03219.JPG_2.jpg,660,480,640,22,369,391,414,444,True,11
9,35,kaist_dataset/Korean/Digital_Camera/outdoor3/DSC03232.JPG,char_data/9/DSC03232.JPG_2.jpg,805,480,640,23,247,270,288,323,True,11
9,32,kaist_dataset/Korean/Digital_Camera/outdoor4/DSC03293.JPG,char_data/9/DSC03293.JPG_2.jpg,768,480,640,24,387,411,289,321,True,11
9,54,kaist_dataset/Korean/Digital_Camera/outdoor4/DSC03319.JPG,char_data/9/DSC03319.JPG_4.jpg,1998,480,640,37,337,374,384,438,True,11
9,53,kaist_dataset/Korean/Digital_Camera/outdoor4/DSC03319.JPG,char_data/9/DSC03319.JPG_5.jpg,1802,480,640,34,375,409,384,437,True,11
9,104,kaist_dataset/Korean/Digital_Camera/outdoor4/DSC03542.JPG,char_data/9/DSC03542.JPG_4.jpg,5512,480,640,53,389,442,234,338,True,11
9,110,kaist_dataset/Korean/Digital_Camera/outdoor4/DSC03542.JPG,char_data/9/DSC03542.JPG_5.jpg,5060,480,640,46,489,535,230,340,True,11
9,39,kaist_dataset/Korean/Digital_Camera/outdoor4/DSC03545.JPG,char_data/9/DSC03545.JPG_2.jpg,858,480,640,22,213,235,41,80,True,11
9,30,kaist_dataset/Korean/Digital_Camera/outdoor4/DSC03555.JPG,char_data/9/DSC03555.JPG_2.jpg,780,480,640,26,343,369,428,458,True,11
9,59,kaist_dataset/Korean/Digital_Camera/outdoor4/DSC03580.JPG,char_data/9/DSC03580.JPG_2.jpg,1770,480,640,30,320,350,202,261,True,11
9,38,kaist_dataset/Korean/Digital_Camera/outdoor4/DSC03592.JPG,char_data/9/DSC03592.JPG_2.jpg,684,480,640,18,522,540,124,162,True,11
9,52,kaist_dataset/Korean/Digital_Camera/outdoor4/DSC03600.JPG,char_data/9/DSC03600.JPG_4.jpg,1976,480,640,38,328,366,270,322,True,11
9,29,kaist_dataset/Korean/Digital_Camera/outdoor4/DSC03600.JPG,char_data/9/DSC03600.JPG_5.jpg,638,480,640,22,343,365,329,358,True,11
9,51,kaist_dataset/Korean/Digital_Camera/outdoor4/DSC03605.JPG,char_data/9/DSC03605.JPG_4.jpg,1989,480,640,39,119,158,233,284,True,11
9,55,kaist_dataset/Korean/Digital_Camera/outdoor4/DSC03605.JPG,char_data/9/DSC03605.JPG_5.jpg,1980,480,640,36,92,128,145,200,True,11
9,51,kaist_dataset/Korean/Digital_Camera/outdoor4/DSC03608.JPG,char_data/9/DSC03608.JPG_2.jpg,1836,480,640,36,551,587,387,438,True,11
9,40,kaist_dataset/Korean/Digital_Camera/outdoor5/DSC03626.JPG,char_data/9/DSC03626.JPG_2.jpg,1120,480,640,28,185,213,296,336,True,11
9,34,kaist_dataset/Korean/Digital_Camera/outdoor5/DSC03671.JPG,char_data/9/DSC03671.JPG_10.jpg,544,480,640,16,307,323,412,446,True,11
9,35,kaist_dataset/Korean/Digital_Camera/outdoor5/DSC03671.JPG,char_data/9/DSC03671.JPG_11.jpg,630,480,640,18,337,355,409,444,True,11
9,33,kaist_dataset/Korean/Digital_Camera/outdoor5/DSC03671.JPG,char_data/9/DSC03671.JPG_12.jpg,495,480,640,15,428,443,413,446,True,11
9,36,kaist_dataset/Korean/Digital_Camera/outdoor5/DSC03671.JPG,char_data/9/DSC03671.JPG_13.jpg,756,480,640,21,521,542,411,447,True,11
9,35,kaist_dataset/Korean/Digital_Camera/outdoor5/DSC03671.JPG,char_data/9/DSC03671.JPG_14.jpg,665,480,640,19,560,579,409,444,True,11
9,36,kaist_dataset/Korean/Digital_Camera/outdoor5/DSC03685.JPG,char_data/9/DSC03685.JPG_2.jpg,720,480,640,20,486,506,184,220,True,11
9,39,kaist_dataset/Korean/Digital_Camera/outdoor5/DSC03709.JPG,char_data/9/DSC03709.JPG_4.jpg,663,480,640,17,499,516,365,404,True,11
9,44,kaist_dataset/Korean/Digital_Camera/outdoor5/DSC03709.JPG,char_data/9/DSC03709.JPG_5.jpg,836,480,640,19,530,549,361,405,True,11
9,32,kaist_dataset/Korean/Digital_Camera/outdoor5/DSC03710.JPG,char_data/9/DSC03710.JPG_4.jpg,896,480,640,28,367,395,410,442,True,11
9,34,kaist_dataset/Korean/Digital_Camera/outdoor5/DSC03710.JPG,char_data/9/DSC03710.JPG_5.jpg,1122,480,640,33,426,459,408,442,True,11
9,45,kaist_dataset/Korean/Digital_Camera/outdoor5/DSC03717.JPG,char_data/9/DSC03717.JPG_4.jpg,1530,480,640,34,294,328,351,396,True,11
9,43,kaist_dataset/Korean/Digital_Camera/outdoor5/DSC03717.JPG,char_data/9/DSC03717.JPG_5.jpg,1505,480,640,35,364,399,346,389,True,11
9,36,kaist_dataset/Korean/Digital_Camera/outdoor5/DSC03736.JPG,char_data/9/DSC03736.JPG_2.jpg,468,480,640,13,371,384,403,439,True,11
9,30,kaist_dataset/Korean/Digital_Camera/outdoor5/DSC03744.JPG,char_data/9/DSC03744.JPG_2.jpg,930,480,640,31,436,467,297,327,True,11
9,29,kaist_dataset/Korean/Digital_Camera/outdoor5/DSC03752.JPG,char_data/9/DSC03752.JPG_4.jpg,377,480,640,13,212,225,408,437,True,11
9,25,kaist_dataset/Korean/Digital_Camera/outdoor5/DSC03752.JPG,char_data/9/DSC03752.JPG_5.jpg,425,480,640,17,226,243,411,436,True,11
9,39,kaist_dataset/Korean/Digital_Camera/outdoor5/DSC03768.JPG,char_data/9/DSC03768.JPG_2.jpg,936,480,640,24,523,547,240,279,True,11
9,40,kaist_dataset/Korean/Digital_Camera/outdoor5/DSC03770.JPG,char_data/9/DSC03770.JPG_2.jpg,920,480,640,23,547,570,420,460,True,11
9,16,kaist_dataset/Korean/Digital_Camera/outdoor5/DSC03776.JPG,char_data/9/DSC03776.JPG_4.jpg,160,480,640,10,545,555,443,459,True,11
9,20,kaist_dataset/Korean/Digital_Camera/outdoor5/DSC03776.JPG,char_data/9/DSC03776.JPG_5.jpg,320,480,640,16,567,583,442,462,True,11
9,23,kaist_dataset/Korean/Digital_Camera/outdoor5/DSC03780.JPG,char_data/9/DSC03780.JPG_4.jpg,414,480,640,18,174,192,441,464,True,11
9,25,kaist_dataset/Korean/Digital_Camera/outdoor5/DSC03780.JPG,char_data/9/DSC03780.JPG_5.jpg,525,480,640,21,208,229,440,465,True,11
9,27,kaist_dataset/Korean/Digital_Camera/outdoor5/DSC04028.JPG,char_data/9/DSC04028.JPG_2.jpg,675,480,640,25,368,393,344,371,True,11
9,39,kaist_dataset/Korean/Digital_Camera/outdoor5/DSC04040.JPG,char_data/9/DSC04040.JPG_2.jpg,1365,480,640,35,511,546,340,379,True,11
9,35,kaist_dataset/Korean/Digital_Camera/outdoor6/DSC04041.JPG,char_data/9/DSC04041.JPG_2.jpg,455,480,640,13,533,546,136,171,True,11
9,31,kaist_dataset/Korean/Digital_Camera/outdoor6/DSC04046.JPG,char_data/9/DSC04046.JPG_2.jpg,372,480,640,12,363,375,260,291,True,11
9,38,kaist_dataset/Korean/Digital_Camera/outdoor6/DSC04081.JPG,char_data/9/DSC04081.JPG_2.jpg,1862,480,640,49,519,568,320,358,True,11
9,50,kaist_dataset/Korean/Digital_Camera/outdoor6/DSC04089.JPG,char_data/9/DSC04089.JPG_2.jpg,1250,480,640,25,351,376,275,325,True,11
9,42,kaist_dataset/Korean/Digital_Camera/outdoor6/DSC04099.JPG,char_data/9/DSC04099.JPG_2.jpg,966,480,640,23,507,530,411,453,True,11
9,32,kaist_dataset/Korean/Digital_Camera/outdoor6/DSC04112.JPG,char_data/9/DSC04112.JPG_4.jpg,512,480,640,16,389,405,275,307,True,11
9,36,kaist_dataset/Korean/Digital_Camera/outdoor6/DSC04112.JPG,char_data/9/DSC04112.JPG_5.jpg,648,480,640,18,468,486,272,308,True,11
9,30,kaist_dataset/Korean/Digital_Camera/outdoor6/DSC04132.JPG,char_data/9/DSC04132.JPG_2.jpg,570,480,640,19,351,370,150,180,True,11
9,80,kaist_dataset/Korean/Digital_Camera/outdoor6/DSC04147.JPG,char_data/9/DSC04147.JPG_2.jpg,3200,480,640,40,387,427,176,256,True,11
9,44,kaist_dataset/Korean/Digital_Camera/outdoor6/DSC04148.JPG,char_data/9/DSC04148.JPG_4.jpg,1012,480,640,23,448,471,303,347,True,11
9,46,kaist_dataset/Korean/Digital_Camera/outdoor6/DSC04148.JPG,char_data/9/DSC04148.JPG_5.jpg,1104,480,640,24,450,474,406,452,True,11
9,52,kaist_dataset/Korean/Digital_Camera/outdoor6/DSC04308.JPG,char_data/9/DSC04308.JPG_4.jpg,1508,480,640,29,384,413,387,439,True,11
9,51,kaist_dataset/Korean/Digital_Camera/outdoor6/DSC04308.JPG,char_data/9/DSC04308.JPG_5.jpg,1479,480,640,29,413,442,388,439,True,11
9,54,kaist_dataset/Korean/Digital_Camera/outdoor6/DSC04332.JPG,char_data/9/DSC04332.JPG_2.jpg,2538,480,640,47,325,372,351,405,True,11
9,28,kaist_dataset/Korean/Digital_Camera/outdoor6/DSC04341.JPG,char_data/9/DSC04341.JPG_2.jpg,672,480,640,24,598,622,223,251,True,11
9,82,kaist_dataset/Korean/Digital_Camera/outdoor6/DSC04359.JPG,char_data/9/DSC04359.JPG_2.jpg,3854,480,640,47,376,423,107,189,True,11
9,45,kaist_dataset/Korean/Digital_Camera/outdoor6/DSC04400.JPG,char_data/9/DSC04400.JPG_2.jpg,1035,480,640,23,353,376,396,441,True,11
9,132,kaist_dataset/Korean/Digital_Camera/outdoor6/DSC04445.JPG,char_data/9/DSC04445.JPG_2.jpg,13596,480,640,103,170,273,261,393,True,11
9,42,kaist_dataset/Korean/Digital_Camera/outdoor7/k.jpg,char_data/9/k.jpg_2.jpg,1344,240,320,32,155,187,147,189,True,11
9,45,kaist_dataset/Korean/Digital_Camera/outdoor7/P1010003.JPG,char_data/9/P1010003.JPG_2.jpg,1035,480,640,23,426,449,272,317,True,11
9,26,kaist_dataset/Korean/Digital_Camera/outdoor7/P1010005.JPG,char_data/9/P1010005.JPG_2.jpg,676,480,640,26,447,473,192,218,True,11
9,40,kaist_dataset/Korean/Digital_Camera/outdoor7/P1010009.JPG,char_data/9/P1010009.JPG_4.jpg,1280,480,640,32,487,519,267,307,True,11
9,53,kaist_dataset/Korean/Digital_Camera/outdoor7/P1010023.JPG,char_data/9/P1010023.JPG_6.jpg,1749,480,640,33,132,165,291,344,True,11
9,58,kaist_dataset/Korean/Digital_Camera/outdoor7/P1010023.JPG,char_data/9/P1010023.JPG_7.jpg,1798,480,640,31,196,227,288,346,True,11
9,55,kaist_dataset/Korean/Digital_Camera/outdoor7/P1010023.JPG,char_data/9/P1010023.JPG_8.jpg,1760,480,640,32,467,499,283,338,True,11
9,35,kaist_dataset/Korean/Digital_Camera/outdoor7/P1010035.JPG,char_data/9/P1010035.JPG_2.jpg,595,480,640,17,103,120,202,237,True,11
9,28,kaist_dataset/Korean/Digital_Camera/outdoor7/P1010054.JPG,char_data/9/P1010054.JPG_2.jpg,728,480,640,26,529,555,230,258,True,11
9,33,kaist_dataset/Korean/Digital_Camera/outdoor7/P1010057.JPG,char_data/9/P1010057.JPG_2.jpg,594,480,640,18,608,626,230,263,True,11
9,33,kaist_dataset/Korean/Digital_Camera/outdoor7/P1010078.JPG,char_data/9/P1010078.JPG_4.jpg,858,480,640,26,214,240,251,284,True,11
9,34,kaist_dataset/Korean/Digital_Camera/outdoor7/P1010078.JPG,char_data/9/P1010078.JPG_5.jpg,850,480,640,25,338,363,255,289,True,11
9,52,kaist_dataset/Korean/Digital_Camera/outdoor7/P1010085.JPG,char_data/9/P1010085.JPG_2.jpg,1664,480,640,32,383,415,267,319,True,11
9,76,kaist_dataset/Korean/Digital_Camera/outdoor7/P1010086.JPG,char_data/9/P1010086.JPG_2.jpg,5092,480,640,67,349,416,252,328,True,11
9,37,kaist_dataset/Korean/Digital_Camera/outdoor7/P1010101.JPG,char_data/9/P1010101.JPG_4.jpg,888,480,640,24,367,391,230,267,True,11
9,29,kaist_dataset/Korean/Digital_Camera/outdoor7/P1010101.JPG,char_data/9/P1010101.JPG_5.jpg,551,480,640,19,445,464,234,263,True,11
9,21,kaist_dataset/Korean/Digital_Camera/outdoor7/P1010124.JPG,char_data/9/P1010124.JPG_2.jpg,315,480,640,15,394,409,152,173,True,11
9,70,kaist_dataset/Korean/Digital_Camera/outdoor8/P1010160.JPG,char_data/9/P1010160.JPG_2.jpg,3640,480,640,52,245,297,226,296,True,11
9,41,kaist_dataset/Korean/Digital_Camera/outdoor8/P1011112.JPG,char_data/9/P1011112.JPG_2.jpg,984,480,640,24,319,343,207,248,True,11
9,28,kaist_dataset/Korean/Digital_Camera/outdoor8/크기변환_P1010033.JPG,char_data/9/크기변환_P1010033.JPG_2.jpg,336,480,640,12,488,500,174,202,True,11
9,52,"kaist_dataset/Korean/Mobile_Phone/(M,K)E-bookCover/P090912015.jpg",char_data/9/P090912015.jpg_2.jpg,1560,480,640,30,394,424,64,116,True,11
9,66,kaist_dataset/Mixed/Digital_Camera/(C.S)A-shadow/DSC04326.JPG,char_data/9/DSC04326.JPG_4.jpg,2244,480,640,34,443,477,17,83,True,11
9,69,kaist_dataset/Mixed/Digital_Camera/(C.S)A-shadow/DSC04326.JPG,char_data/9/DSC04326.JPG_5.jpg,2484,480,640,36,533,569,13,82,True,11
9,39,kaist_dataset/Mixed/Digital_Camera/(C.S)A-shadow/P1010017.JPG,char_data/9/P1010017.JPG_4.jpg,741,480,640,19,94,113,129,168,True,11
9,40,kaist_dataset/Mixed/Digital_Camera/(C.S)A-shadow/P1010019.JPG,char_data/9/P1010019.JPG_4.jpg,1040,480,640,26,382,408,201,241,True,11
9,36,kaist_dataset/Mixed/Digital_Camera/(C.S)A-shadow/P1010019.JPG,char_data/9/P1010019.JPG_5.jpg,720,480,640,20,409,429,204,240,True,11
9,34,kaist_dataset/Mixed/Digital_Camera/(C.S)B-light/DSC03298.JPG,char_data/9/DSC03298.JPG_2.jpg,374,480,640,11,441,452,290,324,True,11
9,26,kaist_dataset/Mixed/Digital_Camera/(C.S)C-outdoor1/008.JPG,char_data/9/008.JPG_2.jpg,390,480,640,15,520,535,268,294,True,11
9,33,kaist_dataset/Mixed/Digital_Camera/(C.S)C-outdoor1/009.JPG,char_data/9/009.JPG_2.jpg,726,480,640,22,365,387,320,353,True,11
9,19,kaist_dataset/Mixed/Digital_Camera/(C.S)C-outdoor1/014.JPG,char_data/9/014.JPG_2.jpg,285,480,640,15,260,275,279,298,True,11
9,22,kaist_dataset/Mixed/Digital_Camera/(C.S)C-outdoor1/054.JPG,char_data/9/054.JPG_2.jpg,418,480,640,19,514,533,305,327,True,11
9,45,kaist_dataset/Mixed/Digital_Camera/(C.S)C-outdoor1/081.JPG,char_data/9/081.JPG_4.jpg,1890,480,640,42,296,338,250,295,True,11
9,38,kaist_dataset/Mixed/Digital_Camera/(C.S)C-outdoor1/081.JPG,char_data/9/081.JPG_5.jpg,1748,480,640,46,413,459,255,293,True,11
9,38,kaist_dataset/Mixed/Digital_Camera/(C.S)C-outdoor1/090.JPG,char_data/9/090.JPG_2.jpg,836,480,640,22,449,471,389,427,True,11
9,33,kaist_dataset/Mixed/Digital_Camera/(C.S)C-outdoor1/118.JPG,char_data/9/118.JPG_2.jpg,825,480,640,25,483,508,360,393,True,11
9,31,kaist_dataset/Mixed/Digital_Camera/(C.S)C-outdoor1/121.JPG,char_data/9/121.JPG_6.jpg,558,480,640,18,352,370,274,305,True,11
9,33,kaist_dataset/Mixed/Digital_Camera/(C.S)C-outdoor1/121.JPG,char_data/9/121.JPG_7.jpg,594,480,640,18,368,386,274,307,True,11
9,28,kaist_dataset/Mixed/Digital_Camera/(C.S)C-outdoor1/121.JPG,char_data/9/121.JPG_8.jpg,448,480,640,16,521,537,274,302,True,11
9,43,kaist_dataset/Mixed/Digital_Camera/(C.S)C-outdoor1/2007-12-08-day-130.jpg,char_data/9/2007-12-08-day-130.jpg_2.jpg,1075,1200,1600,25,1046,1071,759,802,True,11
9,46,kaist_dataset/Mixed/Digital_Camera/(C.S)C-outdoor1/2007-12-09-day-exterior-037.jpg,char_data/9/2007-12-09-day-exterior-037.jpg_2.jpg,1564,1200,1600,34,809,843,704,750,True,11
9,35,kaist_dataset/Mixed/Digital_Camera/(C.S)C-outdoor1/2007-12-09-day-exterior-078.jpg,char_data/9/2007-12-09-day-exterior-078.jpg_2.jpg,1155,1200,1600,33,169,202,1009,1044,True,11
9,30,kaist_dataset/Mixed/Digital_Camera/(C.S)C-outdoor1/57.JPG,char_data/9/57.JPG_8.jpg,480,500,766,16,512,528,294,324,True,11
9,28,kaist_dataset/Mixed/Digital_Camera/(C.S)C-outdoor1/57.JPG,char_data/9/57.JPG_9.jpg,476,500,766,17,558,575,296,324,True,11
9,26,kaist_dataset/Mixed/Digital_Camera/(C.S)C-outdoor1/57.JPG,char_data/9/57.JPG_10.jpg,416,500,766,16,346,362,454,480,True,11
9,26,kaist_dataset/Mixed/Digital_Camera/(C.S)C-outdoor1/57.JPG,char_data/9/57.JPG_11.jpg,364,500,766,14,392,406,455,481,True,11
9,41,kaist_dataset/Mixed/Digital_Camera/(C.S)C-outdoor1/DSC02322.JPG,char_data/9/DSC02322.JPG_2.jpg,1148,480,640,28,296,324,364,405,True,11
9,40,kaist_dataset/Mixed/Digital_Camera/(C.S)C-outdoor1/DSC02325.JPG,char_data/9/DSC02325.JPG_2.jpg,880,480,640,22,347,369,312,352,True,11
9,40,kaist_dataset/Mixed/Digital_Camera/(C.S)C-outdoor1/P1010009.JPG,char_data/9/P1010009.JPG_5.jpg,1000,480,640,25,204,229,240,280,True,11
9,40,kaist_dataset/Mixed/Digital_Camera/(C.S)C-outdoor1/P1010011.JPG,char_data/9/P1010011.JPG_2.jpg,960,480,640,24,572,596,312,352,True,11
9,59,kaist_dataset/Mixed/Digital_Camera/(C.S)C-outdoor2/DSC02359.JPG,char_data/9/DSC02359.JPG_2.jpg,2419,480,640,41,403,444,410,469,True,11
9,33,kaist_dataset/Mixed/Digital_Camera/(C.S)C-outdoor2/DSC02361.JPG,char_data/9/DSC02361.JPG_4.jpg,462,480,640,14,560,574,379,412,True,11
9,33,kaist_dataset/Mixed/Digital_Camera/(C.S)C-outdoor2/DSC02361.JPG,char_data/9/DSC02361.JPG_5.jpg,528,480,640,16,592,608,377,410,True,11
9,39,kaist_dataset/Mixed/Digital_Camera/(C.S)C-outdoor2/DSC02368.JPG,char_data/9/DSC02368.JPG_2.jpg,663,480,640,17,212,229,382,421,True,11
9,44,kaist_dataset/Mixed/Digital_Camera/(C.S)C-outdoor2/DSC02389.JPG,char_data/9/DSC02389.JPG_2.jpg,1452,480,640,33,337,370,37,81,True,11
9,30,kaist_dataset/Mixed/Digital_Camera/(C.S)C-outdoor2/DSC02397.JPG,char_data/9/DSC02397.JPG_2.jpg,660,480,640,22,512,534,206,236,True,11
9,53,kaist_dataset/Mixed/Digital_Camera/(C.S)C-outdoor2/DSC02400.JPG,char_data/9/DSC02400.JPG_2.jpg,1696,480,640,32,375,407,397,450,True,11
9,43,kaist_dataset/Mixed/Digital_Camera/(C.S)C-outdoor2/DSC02411.JPG,char_data/9/DSC02411.JPG_2.jpg,946,480,640,22,484,506,348,391,True,11
9,40,kaist_dataset/Mixed/Digital_Camera/(C.S)C-outdoor2/DSC02413.JPG,char_data/9/DSC02413.JPG_2.jpg,880,480,640,22,448,470,207,247,True,11
9,31,kaist_dataset/Mixed/Digital_Camera/(C.S)C-outdoor2/DSC02422.JPG,char_data/9/DSC02422.JPG_2.jpg,806,480,640,26,503,529,226,257,True,11
9,118,kaist_dataset/Mixed/Digital_Camera/(C.S)C-outdoor2/DSC02430.JPG,char_data/9/DSC02430.JPG_12.jpg,14750,480,640,125,313,438,53,171,True,11
9,109,kaist_dataset/Mixed/Digital_Camera/(C.S)C-outdoor2/DSC02430.JPG,char_data/9/DSC02430.JPG_13.jpg,12317,480,640,113,395,508,106,215,True,11
9,21,kaist_dataset/Mixed/Digital_Camera/(C.S)C-outdoor2/DSC02430.JPG,char_data/9/DSC02430.JPG_14.jpg,168,480,640,8,47,55,29,50,True,11
9,24,kaist_dataset/Mixed/Digital_Camera/(C.S)C-outdoor2/DSC02430.JPG,char_data/9/DSC02430.JPG_15.jpg,312,480,640,13,54,67,27,51,True,11
9,35,kaist_dataset/Mixed/Digital_Camera/(C.S)C-outdoor2/DSC02430.JPG,char_data/9/DSC02430.JPG_16.jpg,595,480,640,17,550,567,306,341,True,11
9,28,kaist_dataset/Mixed/Digital_Camera/(C.S)C-outdoor2/DSC02430.JPG,char_data/9/DSC02430.JPG_17.jpg,420,480,640,15,563,578,323,351,True,11
9,31,kaist_dataset/Mixed/Digital_Camera/(C.S)C-outdoor2/DSC02447.JPG,char_data/9/DSC02447.JPG_2.jpg,527,480,640,17,570,587,228,259,True,11
9,24,kaist_dataset/Mixed/Digital_Camera/(C.S)C-outdoor2/DSC02477.JPG,char_data/9/DSC02477.JPG_2.jpg,480,480,640,20,154,174,253,277,True,11
9,36,kaist_dataset/Mixed/Digital_Camera/(C.S)C-outdoor2/DSC02479.JPG,char_data/9/DSC02479.JPG_2.jpg,576,480,640,16,526,542,219,255,True,11
9,65,kaist_dataset/Mixed/Digital_Camera/(C.S)C-outdoor2/DSC02502.JPG,char_data/9/DSC02502.JPG_2.jpg,2665,480,640,41,268,309,346,411,True,11
9,34,kaist_dataset/Mixed/Digital_Camera/(C.S)C-outdoor2/DSC02511.JPG,char_data/9/DSC02511.JPG_4.jpg,646,480,640,19,434,453,215,249,True,11
9,39,kaist_dataset/Mixed/Digital_Camera/(C.S)C-outdoor2/DSC02511.JPG,char_data/9/DSC02511.JPG_5.jpg,1209,480,640,31,452,483,215,254,True,11
9,74,kaist_dataset/Mixed/Digital_Camera/(C.S)C-outdoor2/DSC02513.JPG,char_data/9/DSC02513.JPG_4.jpg,3922,480,640,53,319,372,142,216,True,11
9,77,kaist_dataset/Mixed/Digital_Camera/(C.S)C-outdoor2/DSC02513.JPG,char_data/9/DSC02513.JPG_5.jpg,3773,480,640,49,419,468,145,222,True,11
9,30,kaist_dataset/Mixed/Digital_Camera/(C.S)C-outdoor2/DSC02555.JPG,char_data/9/DSC02555.JPG_2.jpg,660,480,640,22,176,198,248,278,True,11
9,33,kaist_dataset/Mixed/Digital_Camera/(C.S)C-outdoor2/DSC02560.JPG,char_data/9/DSC02560.JPG_2.jpg,594,480,640,18,597,615,305,338,True,11
9,32,kaist_dataset/Mixed/Digital_Camera/(C.S)C-outdoor2/DSC02887.JPG,char_data/9/DSC02887.JPG_2.jpg,736,480,640,23,355,378,118,150,True,11
9,35,kaist_dataset/Mixed/Digital_Camera/(C.S)C-outdoor2/DSC02894.JPG,char_data/9/DSC02894.JPG_2.jpg,840,480,640,24,311,335,253,288,True,11
9,36,kaist_dataset/Mixed/Digital_Camera/(C.S)C-outdoor2/DSC02912.JPG,char_data/9/DSC02912.JPG_2.jpg,1296,480,640,36,341,377,441,477,True,11
9,38,kaist_dataset/Mixed/Digital_Camera/(C.S)C-outdoor2/DSC02933.JPG,char_data/9/DSC02933.JPG_2.jpg,684,480,640,18,619,637,247,285,True,11
9,47,kaist_dataset/Mixed/Digital_Camera/(C.S)C-outdoor2/DSC02938.JPG,char_data/9/DSC02938.JPG_2.jpg,1128,480,640,24,563,587,241,288,True,11
9,39,kaist_dataset/Mixed/Digital_Camera/(C.S)C-outdoor2/DSC02954.JPG,char_data/9/DSC02954.JPG_4.jpg,1053,480,640,27,143,170,257,296,True,11
9,40,kaist_dataset/Mixed/Digital_Camera/(C.S)C-outdoor2/DSC02954.JPG,char_data/9/DSC02954.JPG_5.jpg,920,480,640,23,444,467,263,303,True,11
9,54,kaist_dataset/Mixed/Digital_Camera/(C.S)C-outdoor2/P1010013.JPG,char_data/9/P1010013.JPG_2.jpg,1566,480,640,29,281,310,365,419,True,11
9,39,kaist_dataset/Mixed/Digital_Camera/(C.S)C-outdoor3/DSC02970.JPG,char_data/9/DSC02970.JPG_2.jpg,1287,480,640,33,405,438,361,400,True,11
9,46,kaist_dataset/Mixed/Digital_Camera/(C.S)C-outdoor3/DSC02989.JPG,char_data/9/DSC02989.JPG_2.jpg,1012,480,640,22,598,620,350,396,True,11
9,59,kaist_dataset/Mixed/Digital_Camera/(C.S)C-outdoor3/DSC03177.JPG,char_data/9/DSC03177.JPG_4.jpg,1947,480,640,33,256,289,200,259,True,11
9,60,kaist_dataset/Mixed/Digital_Camera/(C.S)C-outdoor3/DSC03177.JPG,char_data/9/DSC03177.JPG_5.jpg,1860,480,640,31,291,322,201,261,True,11
9,35,kaist_dataset/Mixed/Digital_Camera/(C.S)C-outdoor3/DSC03301.JPG,char_data/9/DSC03301.JPG_2.jpg,630,480,640,18,461,479,140,175,True,11
9,41,kaist_dataset/Mixed/Digital_Camera/(C.S)C-outdoor3/DSC03312.JPG,char_data/9/DSC03312.JPG_4.jpg,1271,480,640,31,352,383,279,320,True,11
9,38,kaist_dataset/Mixed/Digital_Camera/(C.S)C-outdoor3/DSC03312.JPG,char_data/9/DSC03312.JPG_5.jpg,1330,480,640,35,390,425,282,320,True,11
9,35,kaist_dataset/Mixed/Digital_Camera/(C.S)C-outdoor3/DSC03316.JPG,char_data/9/DSC03316.JPG_4.jpg,595,480,640,17,264,281,86,121,True,11
9,34,kaist_dataset/Mixed/Digital_Camera/(C.S)C-outdoor3/DSC03316.JPG,char_data/9/DSC03316.JPG_5.jpg,578,480,640,17,420,437,84,118,True,11
9,64,kaist_dataset/Mixed/Digital_Camera/(C.S)C-outdoor3/DSC03332.JPG,char_data/9/DSC03332.JPG_2.jpg,2304,480,640,36,210,246,334,398,True,11
9,93,kaist_dataset/Mixed/Digital_Camera/(C.S)C-outdoor4/DSC03544.JPG,char_data/9/DSC03544.JPG_2.jpg,3720,480,640,40,298,338,166,259,True,11
9,48,kaist_dataset/Mixed/Digital_Camera/(C.S)C-outdoor4/DSC03548.JPG,char_data/9/DSC03548.JPG_2.jpg,2160,480,640,45,285,330,394,442,True,11
9,44,kaist_dataset/Mixed/Digital_Camera/(C.S)C-outdoor4/DSC03569.JPG,char_data/9/DSC03569.JPG_4.jpg,1452,480,640,33,427,460,168,212,True,11
9,53,kaist_dataset/Mixed/Digital_Camera/(C.S)C-outdoor4/DSC03569.JPG,char_data/9/DSC03569.JPG_5.jpg,1802,480,640,34,479,513,162,215,True,11
9,50,kaist_dataset/Mixed/Digital_Camera/(C.S)C-outdoor4/DSC03613.JPG,char_data/9/DSC03613.JPG_2.jpg,1050,480,640,21,554,575,28,78,True,11
9,48,kaist_dataset/Mixed/Digital_Camera/(C.S)C-outdoor4/DSC03621.JPG,char_data/9/DSC03621.JPG_4.jpg,1152,480,640,24,490,514,333,381,True,11
9,50,kaist_dataset/Mixed/Digital_Camera/(C.S)C-outdoor4/DSC03621.JPG,char_data/9/DSC03621.JPG_5.jpg,1450,480,640,29,539,568,335,385,True,11
9,48,kaist_dataset/Mixed/Digital_Camera/(C.S)C-outdoor4/DSC03655.JPG,char_data/9/DSC03655.JPG_2.jpg,1488,480,640,31,590,621,389,437,True,11
9,34,kaist_dataset/Mixed/Digital_Camera/(C.S)C-outdoor4/DSC03661.JPG,char_data/9/DSC03661.JPG_2.jpg,646,480,640,19,522,541,328,362,True,11
9,39,kaist_dataset/Mixed/Digital_Camera/(C.S)C-outdoor4/DSC03673.JPG,char_data/9/DSC03673.JPG_4.jpg,780,480,640,20,286,306,306,345,True,11
9,35,kaist_dataset/Mixed/Digital_Camera/(C.S)C-outdoor4/DSC03673.JPG,char_data/9/DSC03673.JPG_5.jpg,735,480,640,21,306,327,304,339,True,11
9,26,kaist_dataset/Mixed/Digital_Camera/(C.S)C-outdoor4/DSC03674.JPG,char_data/9/DSC03674.JPG_4.jpg,312,480,640,12,551,563,423,449,True,11
9,22,kaist_dataset/Mixed/Digital_Camera/(C.S)C-outdoor4/DSC03674.JPG,char_data/9/DSC03674.JPG_5.jpg,264,480,640,12,576,588,424,446,True,11
9,28,kaist_dataset/Mixed/Digital_Camera/(C.S)C-outdoor4/DSC03676.JPG,char_data/9/DSC03676.JPG_2.jpg,364,480,640,13,141,154,274,302,True,11
9,29,kaist_dataset/Mixed/Digital_Camera/(C.S)C-outdoor4/DSC03689.JPG,char_data/9/DSC03689.JPG_2.jpg,348,480,640,12,581,593,133,162,True,11
9,49,kaist_dataset/Mixed/Digital_Camera/(C.S)C-outdoor4/DSC03693.JPG,char_data/9/DSC03693.JPG_2.jpg,1029,480,640,21,529,550,349,398,True,11
9,66,kaist_dataset/Mixed/Digital_Camera/(C.S)C-outdoor4/DSC03702.JPG,char_data/9/DSC03702.JPG_2.jpg,2838,480,640,43,268,311,338,404,True,11
9,26,kaist_dataset/Mixed/Digital_Camera/(C.S)C-outdoor4/DSC03718.JPG,char_data/9/DSC03718.JPG_2.jpg,442,480,640,17,550,567,406,432,True,11
9,37,kaist_dataset/Mixed/Digital_Camera/(C.S)C-outdoor4/DSC03719.JPG,char_data/9/DSC03719.JPG_2.jpg,703,480,640,19,559,578,180,217,True,11
9,34,kaist_dataset/Mixed/Digital_Camera/(C.S)C-outdoor4/DSC03722.JPG,char_data/9/DSC03722.JPG_2.jpg,986,480,640,29,405,434,204,238,True,11
9,37,kaist_dataset/Mixed/Digital_Camera/(C.S)C-outdoor4/DSC03734.JPG,char_data/9/DSC03734.JPG_2.jpg,444,480,640,12,526,538,344,381,True,11
9,28,kaist_dataset/Mixed/Digital_Camera/(C.S)C-outdoor4/DSC03737.JPG,char_data/9/DSC03737.JPG_4.jpg,532,480,640,19,249,268,164,192,True,11
9,31,kaist_dataset/Mixed/Digital_Camera/(C.S)C-outdoor4/DSC03737.JPG,char_data/9/DSC03737.JPG_5.jpg,403,480,640,13,423,436,168,199,True,11
9,34,kaist_dataset/Mixed/Digital_Camera/(C.S)C-outdoor4/DSC03741.JPG,char_data/9/DSC03741.JPG_2.jpg,1088,480,640,32,509,541,370,404,True,11
9,38,kaist_dataset/Mixed/Digital_Camera/(C.S)C-outdoor4/DSC03745.JPG,char_data/9/DSC03745.JPG_4.jpg,608,480,640,16,561,577,268,306,True,11
9,31,kaist_dataset/Mixed/Digital_Camera/(C.S)C-outdoor4/DSC03745.JPG,char_data/9/DSC03745.JPG_5.jpg,589,480,640,19,593,612,274,305,True,11
9,26,kaist_dataset/Mixed/Digital_Camera/(C.S)C-outdoor4/DSC03757.JPG,char_data/9/DSC03757.JPG_4.jpg,338,480,640,13,340,353,340,366,True,11
9,35,kaist_dataset/Mixed/Digital_Camera/(C.S)C-outdoor4/DSC03757.JPG,char_data/9/DSC03757.JPG_5.jpg,420,480,640,12,514,526,339,374,True,11
9,28,kaist_dataset/Mixed/Digital_Camera/(C.S)C-outdoor4/DSC03769.JPG,char_data/9/DSC03769.JPG_2.jpg,392,480,640,14,216,230,419,447,True,11
9,42,kaist_dataset/Mixed/Digital_Camera/(C.S)C-outdoor5/DSC03821.JPG,char_data/9/DSC03821.JPG_2.jpg,1008,480,640,24,328,352,79,121,False,11
9,35,kaist_dataset/Mixed/Digital_Camera/(C.S)C-outdoor5/DSC03839.JPG,char_data/9/DSC03839.JPG_2.jpg,560,480,640,16,335,351,365,400,False,11
9,63,kaist_dataset/Mixed/Digital_Camera/(C.S)C-outdoor5/DSC03847.JPG,char_data/9/DSC03847.JPG_2.jpg,1512,480,640,24,571,595,10,73,False,11
9,76,kaist_dataset/Mixed/Digital_Camera/(C.S)C-outdoor5/DSC04016.JPG,char_data/9/DSC04016.JPG_4.jpg,3572,480,640,47,260,307,105,181,False,11
9,74,kaist_dataset/Mixed/Digital_Camera/(C.S)C-outdoor5/DSC04016.JPG,char_data/9/DSC04016.JPG_5.jpg,3700,480,640,50,474,524,325,399,False,11
9,32,kaist_dataset/Mixed/Digital_Camera/(C.S)C-outdoor5/DSC04056.JPG,char_data/9/DSC04056.JPG_4.jpg,736,480,640,23,497,520,261,293,False,11
9,28,kaist_dataset/Mixed/Digital_Camera/(C.S)C-outdoor5/DSC04056.JPG,char_data/9/DSC04056.JPG_5.jpg,560,480,640,20,526,546,301,329,False,11
9,85,kaist_dataset/Mixed/Digital_Camera/(C.S)C-outdoor5/DSC04063.JPG,char_data/9/DSC04063.JPG_2.jpg,1785,480,640,21,82,103,268,353,False,11
9,26,kaist_dataset/Mixed/Digital_Camera/(C.S)C-outdoor5/DSC04086.JPG,char_data/9/DSC04086.JPG_2.jpg,390,480,640,15,391,406,371,397,False,11
9,51,kaist_dataset/Mixed/Digital_Camera/(C.S)C-outdoor5/DSC04094.JPG,char_data/9/DSC04094.JPG_4.jpg,2142,480,640,42,407,449,387,438,False,11
9,52,kaist_dataset/Mixed/Digital_Camera/(C.S)C-outdoor5/DSC04094.JPG,char_data/9/DSC04094.JPG_5.jpg,2704,480,640,52,445,497,387,439,False,11
9,41,kaist_dataset/Mixed/Digital_Camera/(C.S)C-outdoor5/DSC04115.JPG,char_data/9/DSC04115.JPG_2.jpg,1189,480,640,29,397,426,352,393,False,11
9,38,kaist_dataset/Mixed/Digital_Camera/(C.S)C-outdoor5/DSC04122.JPG,char_data/9/DSC04122.JPG_2.jpg,494,480,640,13,413,426,410,448,False,11
9,30,kaist_dataset/Mixed/Digital_Camera/(C.S)C-outdoor5/DSC04124.JPG,char_data/9/DSC04124.JPG_4.jpg,360,480,640,12,436,448,308,338,False,11
9,33,kaist_dataset/Mixed/Digital_Camera/(C.S)C-outdoor5/DSC04124.JPG,char_data/9/DSC04124.JPG_5.jpg,561,480,640,17,462,479,307,340,False,11
9,43,kaist_dataset/Mixed/Digital_Camera/(C.S)C-outdoor5/DSC04125.JPG,char_data/9/DSC04125.JPG_6.jpg,903,480,640,21,185,206,179,222,False,11
9,40,kaist_dataset/Mixed/Digital_Camera/(C.S)C-outdoor5/DSC04125.JPG,char_data/9/DSC04125.JPG_7.jpg,1160,480,640,29,204,233,180,220,False,11
9,43,kaist_dataset/Mixed/Digital_Camera/(C.S)C-outdoor5/DSC04125.JPG,char_data/9/DSC04125.JPG_8.jpg,1075,480,640,25,508,533,413,456,False,11
9,44,kaist_dataset/Mixed/Digital_Camera/(C.S)C-outdoor5/DSC04337.JPG,char_data/9/DSC04337.JPG_2.jpg,968,480,640,22,423,445,319,363,False,11
9,58,kaist_dataset/Mixed/Digital_Camera/(C.S)C-outdoor5/DSC04401.JPG,char_data/9/DSC04401.JPG_2.jpg,2320,480,640,40,497,537,248,306,False,11
9,62,kaist_dataset/Mixed/Digital_Camera/(C.S)C-outdoor6/080116-0057.jpg,char_data/9/080116-0057.jpg_2.jpg,2356,1200,1600,38,617,655,820,882,False,11
9,31,kaist_dataset/Mixed/Digital_Camera/(C.S)C-outdoor6/DSC03324.JPG,char_data/9/DSC03324.JPG_2.jpg,465,480,640,15,463,478,153,184,False,11
9,64,kaist_dataset/Mixed/Digital_Camera/(C.S)C-outdoor6/P1010017.JPG,char_data/9/P1010017.JPG_5.jpg,1728,480,640,27,362,389,179,243,False,11
9,31,kaist_dataset/Mixed/Digital_Camera/(C.S)C-outdoor6/P1010020.JPG,char_data/9/P1010020.JPG_2.jpg,589,480,640,19,245,264,337,368,False,11
9,21,kaist_dataset/Mixed/Digital_Camera/(C.S)C-outdoor6/P1010063.JPG,char_data/9/P1010063.JPG_2.jpg,294,480,640,14,207,221,445,466,False,11
9,31,kaist_dataset/Mixed/Digital_Camera/(C.S)C-outdoor6/P1010065.JPG,char_data/9/P1010065.JPG_2.jpg,558,480,640,18,453,471,234,265,False,11
9,40,kaist_dataset/Mixed/Digital_Camera/(C.S)C-outdoor6/P1010074.JPG,char_data/9/P1010074.JPG_2.jpg,1720,480,640,43,384,427,303,343,False,11
9,32,kaist_dataset/Mixed/Digital_Camera/(C.S)C-outdoor6/P1010075.JPG,char_data/9/P1010075.JPG_2.jpg,512,480,640,16,517,533,307,339,False,11
9,37,kaist_dataset/Mixed/Digital_Camera/(C.S)C-outdoor6/P1010080.JPG,char_data/9/P1010080.JPG_2.jpg,1110,480,640,30,435,465,248,285,False,11
9,56,kaist_dataset/Mixed/Digital_Camera/(C.S)C-outdoor6/P1010087.JPG,char_data/9/P1010087.JPG_4.jpg,2520,480,640,45,392,437,178,234,False,11
9,53,kaist_dataset/Mixed/Digital_Camera/(C.S)C-outdoor6/P1010087.JPG,char_data/9/P1010087.JPG_5.jpg,2120,480,640,40,515,555,176,229,False,11
9,26,kaist_dataset/Mixed/Digital_Camera/(C.S)C-outdoor6/P1010094.JPG,char_data/9/P1010094.JPG_2.jpg,520,480,640,20,539,559,218,244,False,11
9,35,kaist_dataset/Mixed/Digital_Camera/(C.S)C-outdoor6/P1010103.JPG,char_data/9/P1010103.JPG_4.jpg,735,480,640,21,516,537,199,234,False,11
9,34,kaist_dataset/Mixed/Digital_Camera/(C.S)C-outdoor6/P1010103.JPG,char_data/9/P1010103.JPG_5.jpg,510,480,640,15,553,568,199,233,False,11
9,23,kaist_dataset/Mixed/Digital_Camera/(C.S)C-outdoor6/P1010129.JPG,char_data/9/P1010129.JPG_2.jpg,483,480,640,21,500,521,236,259,False,11
9,56,kaist_dataset/Mixed/Digital_Camera/(C.S)C-outdoor6/크기변환_P1010029.JPG,char_data/9/크기변환_P1010029.JPG_4.jpg,1960,480,640,35,147,182,259,315,False,11
9,58,kaist_dataset/Mixed/Digital_Camera/(C.S)C-outdoor6/크기변환_P1010029.JPG,char_data/9/크기변환_P1010029.JPG_5.jpg,2088,480,640,36,298,334,259,317,False,11
9,51,kaist_dataset/Mixed/Digital_Camera/(C.S)D-indoor1/DSC03980.JPG,char_data/9/DSC03980.JPG_4.jpg,1938,480,640,38,426,464,312,363,False,11
9,44,kaist_dataset/Mixed/Digital_Camera/(C.S)D-indoor1/DSC03980.JPG,char_data/9/DSC03980.JPG_5.jpg,1804,480,640,41,503,544,316,360,False,11
9,54,kaist_dataset/Mixed/Digital_Camera/(C.S)D-indoor1/DSC03986.JPG,char_data/9/DSC03986.JPG_4.jpg,864,480,640,16,145,161,158,212,False,11
9,50,kaist_dataset/Mixed/Digital_Camera/(C.S)D-indoor1/DSC03986.JPG,char_data/9/DSC03986.JPG_5.jpg,900,480,640,18,360,378,158,208,False,11
9,29,kaist_dataset/Mixed/Digital_Camera/(C.S)D-indoor1/DSC04005.JPG,char_data/9/DSC04005.JPG_4.jpg,493,480,640,17,504,521,437,466,False,11
9,28,kaist_dataset/Mixed/Digital_Camera/(C.S)D-indoor1/DSC04005.JPG,char_data/9/DSC04005.JPG_5.jpg,588,480,640,21,520,541,436,464,False,11
9,42,kaist_dataset/Mixed/Digital_Camera/(C.S)D-indoor2/DSC04256.JPG,char_data/9/DSC04256.JPG_2.jpg,924,480,640,22,566,588,147,189,False,11
9,65,kaist_dataset/Mixed/Digital_Camera/(C.S)E-night/DSC02574.JPG,char_data/9/DSC02574.JPG_4.jpg,2145,480,640,33,407,440,408,473,False,11
9,73,kaist_dataset/Mixed/Digital_Camera/(C.S)E-night/DSC02574.JPG,char_data/9/DSC02574.JPG_5.jpg,2263,480,640,31,476,507,408,479,False,11
9,48,kaist_dataset/Mixed/Digital_Camera/(C.S)E-night/DSC02575.JPG,char_data/9/DSC02575.JPG_2.jpg,1392,480,640,29,442,471,360,408,False,11
9,32,kaist_dataset/Mixed/Digital_Camera/(C.S)E-night/DSC02586.JPG,char_data/9/DSC02586.JPG_2.jpg,448,480,640,14,381,395,393,425,False,11
9,60,kaist_dataset/Mixed/Digital_Camera/(C.S)E-night/DSC02595.JPG,char_data/9/DSC02595.JPG_2.jpg,2520,480,640,42,408,450,345,405,False,11
9,72,kaist_dataset/Mixed/Digital_Camera/(C.S)E-night/DSC02600.JPG,char_data/9/DSC02600.JPG_2.jpg,5328,480,640,74,225,299,394,466,False,11
9,34,kaist_dataset/Mixed/Digital_Camera/(C.S)E-night/DSC02673.JPG,char_data/9/DSC02673.JPG_2.jpg,408,480,640,12,526,538,302,336,False,11
9,57,kaist_dataset/Mixed/Digital_Camera/(C.S)E-night/P1010147.JPG,char_data/9/P1010147.JPG_6.jpg,2679,480,640,47,343,390,254,311,False,11
9,50,kaist_dataset/Mixed/Digital_Camera/(C.S)E-night/P1010147.JPG,char_data/9/P1010147.JPG_7.jpg,2050,480,640,41,425,466,260,310,False,11
9,58,kaist_dataset/Mixed/Digital_Camera/(C.S)E-night/P1010147.JPG,char_data/9/P1010147.JPG_8.jpg,2552,480,640,44,466,510,258,316,False,11
9,27,kaist_dataset/Mixed/Digital_Camera/(C.S)E-night/P1010151.JPG,char_data/9/P1010151.JPG_6.jpg,324,480,640,12,543,555,202,229,False,11
9,17,kaist_dataset/Mixed/Digital_Camera/(C.S)E-night/P1010151.JPG,char_data/9/P1010151.JPG_7.jpg,187,480,640,11,555,566,209,226,False,11
9,27,kaist_dataset/Mixed/Digital_Camera/(C.S)E-night/P1010151.JPG,char_data/9/P1010151.JPG_8.jpg,459,480,640,17,565,582,201,228,False,11
9,77,kaist_dataset/Mixed/Digital_Camera/(C.S)E-night/P1010152.JPG,char_data/9/P1010152.JPG_2.jpg,4312,480,640,56,378,434,218,295,False,11
9,24,kaist_dataset/Mixed/Digital_Camera/(C.S)E-night/P1010155.JPG,char_data/9/P1010155.JPG_2.jpg,336,480,640,14,517,531,287,311,False,11
9,27,kaist_dataset/Mixed/Digital_Camera/(C.S)E-night/P1010156.JPG,char_data/9/P1010156.JPG_4.jpg,540,480,640,20,342,362,246,273,False,11
9,29,kaist_dataset/Mixed/Digital_Camera/(C.S)E-night/P1010156.JPG,char_data/9/P1010156.JPG_5.jpg,551,480,640,19,428,447,240,269,False,11
9,35,kaist_dataset/Mixed/Digital_Camera/(C.S)F-others/2007-12-08-day-044.jpg,char_data/9/2007-12-08-day-044.jpg_2.jpg,420,1200,1600,12,1079,1091,830,865,False,11
9,53,kaist_dataset/Mixed/Digital_Camera/(C.S)F-others/2007-12-08-day-113.jpg,char_data/9/2007-12-08-day-113.jpg_2.jpg,954,1200,1600,18,965,983,432,485,False,11
9,31,kaist_dataset/Mixed/Mobile_Phone/(C.M)A-outdoor/P090908006.jpg,char_data/9/P090908006.jpg_2.jpg,589,480,640,19,451,470,363,394,False,11
9,123,kaist_dataset/Mixed/Mobile_Phone/(C.M)A-outdoor/P090911087.jpg,char_data/9/P090911087.jpg_4.jpg,10701,480,640,87,61,148,41,164,False,11
9,110,kaist_dataset/Mixed/Mobile_Phone/(C.M)A-outdoor/P090911087.jpg,char_data/9/P090911087.jpg_5.jpg,8030,480,640,73,149,222,43,153,False,11
9,37,kaist_dataset/Mixed/Mobile_Phone/(C.M)A-outdoor/P090912038.jpg,char_data/9/P090912038.jpg_2.jpg,777,480,640,21,372,393,158,195,False,11
9,36,kaist_dataset/Mixed/Mobile_Phone/(C.M)A-outdoor/P090912047.jpg,char_data/9/P090912047.jpg_2.jpg,756,480,640,21,332,353,276,312,False,11
9,67,kaist_dataset/Mixed/Mobile_Phone/(C.M)B-indoor/P090831007.jpg,char_data/9/P090831007.jpg_2.jpg,2948,480,640,44,436,480,275,342,False,11
9,43,kaist_dataset/Mixed/Mobile_Phone/(C.M)C-bookCover/P090902016.jpg,char_data/9/P090902016.jpg_2.jpg,946,480,640,22,113,135,201,244,False,11
i,62,kaist_dataset/English/Digital_Camera/(E.S)A-shadow/DSC03075.JPG,char_data/i/DSC03075.JPG_4.jpg,930,480,640,15,146,161,340,402,True,37
i,51,kaist_dataset/English/Digital_Camera/(E.S)A-shadow/DSC03075.JPG,char_data/i/DSC03075.JPG_5.jpg,663,480,640,13,336,349,349,400,True,37
i,111,kaist_dataset/English/Digital_Camera/(E.S)A-shadow/DSC03077.JPG,char_data/i/DSC03077.JPG_2.jpg,5328,480,640,48,223,271,326,437,True,37
i,56,kaist_dataset/English/Digital_Camera/(E.S)A-shadow/DSC03081.JPG,char_data/i/DSC03081.JPG_2.jpg,672,480,640,12,282,294,400,456,True,37
i,77,kaist_dataset/English/Digital_Camera/(E.S)A-shadow/DSC03084.JPG,char_data/i/DSC03084.JPG_6.jpg,924,480,640,12,204,216,353,430,True,37
i,79,kaist_dataset/English/Digital_Camera/(E.S)A-shadow/DSC03084.JPG,char_data/i/DSC03084.JPG_7.jpg,1422,480,640,18,470,488,350,429,True,37
i,73,kaist_dataset/English/Digital_Camera/(E.S)A-shadow/DSC03084.JPG,char_data/i/DSC03084.JPG_8.jpg,1241,480,640,17,503,520,356,429,True,37
i,70,kaist_dataset/English/Digital_Camera/(E.S)A-shadow/IMG_2647.JPG,char_data/i/IMG_2647.JPG_4.jpg,1260,480,640,18,188,206,319,389,True,37
i,67,kaist_dataset/English/Digital_Camera/(E.S)A-shadow/IMG_2647.JPG,char_data/i/IMG_2647.JPG_5.jpg,1876,480,640,28,369,397,171,238,True,37
i,94,kaist_dataset/English/Digital_Camera/(E.S)B-light/DSC02587.JPG,char_data/i/DSC02587.JPG_4.jpg,2256,480,640,24,354,378,186,280,True,37
i,101,kaist_dataset/English/Digital_Camera/(E.S)B-light/DSC02587.JPG,char_data/i/DSC02587.JPG_5.jpg,2424,480,640,24,120,144,316,417,True,37
i,98,kaist_dataset/English/Digital_Camera/(E.S)B-light/DSC02980.JPG,char_data/i/DSC02980.JPG_2.jpg,3626,480,640,37,403,440,157,255,True,37
i,127,kaist_dataset/English/Digital_Camera/(E.S)B-light/크기변환_%B0%A3%C6%C7_ktimt007.jpg,char_data/i/크기변환_%B0%A3%C6%C7_ktimt007.jpg_4.jpg,4699,480,640,37,155,192,181,308,True,37
i,136,kaist_dataset/English/Digital_Camera/(E.S)B-light/크기변환_%B0%A3%C6%C7_ktimt007.jpg,char_data/i/크기변환_%B0%A3%C6%C7_ktimt007.jpg_5.jpg,5984,480,640,44,258,302,172,308,True,37
i,70,kaist_dataset/English/Digital_Camera/(E.S)C-outdoor1/001.jpg,char_data/i/001.jpg_9.jpg,1890,257,470,27,127,154,87,157,True,37
i,59,kaist_dataset/English/Digital_Camera/(E.S)C-outdoor1/033.jpg,char_data/i/033.jpg_2.jpg,1475,232,354,25,115,140,58,117,True,37
i,26,kaist_dataset/English/Digital_Camera/(E.S)C-outdoor1/056.JPG,char_data/i/056.JPG_6.jpg,156,480,640,6,101,107,241,267,True,37
i,24,kaist_dataset/English/Digital_Camera/(E.S)C-outdoor1/056.JPG,char_data/i/056.JPG_7.jpg,120,480,640,5,118,123,240,264,True,37
i,81,kaist_dataset/English/Digital_Camera/(E.S)C-outdoor1/056.JPG,char_data/i/056.JPG_8.jpg,2187,480,640,27,466,493,159,240,True,37
i,241,kaist_dataset/English/Digital_Camera/(E.S)C-outdoor1/080119-0004.jpg,char_data/i/080119-0004.jpg_2.jpg,23136,1200,1600,96,617,713,513,754,True,37
i,282,kaist_dataset/English/Digital_Camera/(E.S)C-outdoor1/080119-0035.jpg,char_data/i/080119-0035.jpg_2.jpg,25380,1200,1600,90,711,801,736,1018,True,37
i,221,kaist_dataset/English/Digital_Camera/(E.S)C-outdoor1/080119-0036.jpg,char_data/i/080119-0036.jpg_2.jpg,14144,1200,1600,64,1013,1077,319,540,True,37
i,65,kaist_dataset/English/Digital_Camera/(E.S)C-outdoor1/1.jpg,char_data/i/1.jpg_4.jpg,1495,480,640,23,328,351,123,188,True,37
i,154,kaist_dataset/English/Digital_Camera/(E.S)C-outdoor1/100.JPG,char_data/i/100.JPG_4.jpg,6160,480,640,40,205,245,36,190,True,37
i,149,kaist_dataset/English/Digital_Camera/(E.S)C-outdoor1/100.JPG,char_data/i/100.JPG_5.jpg,5215,480,640,35,362,397,40,189,True,37
i,109,kaist_dataset/English/Digital_Camera/(E.S)C-outdoor1/104.jpg,char_data/i/104.jpg_2.jpg,3815,480,640,35,252,287,86,195,True,37
i,70,kaist_dataset/English/Digital_Camera/(E.S)C-outdoor1/109.jpg,char_data/i/109.jpg_2.jpg,1470,480,640,21,354,375,167,237,True,37
i,148,kaist_dataset/English/Digital_Camera/(E.S)C-outdoor1/2007-12-08-day-015.jpg,char_data/i/2007-12-08-day-015.jpg_4.jpg,16872,1200,1600,114,816,930,627,775,True,37
i,43,kaist_dataset/English/Digital_Camera/(E.S)C-outdoor1/2007-12-08-day-015.jpg,char_data/i/2007-12-08-day-015.jpg_5.jpg,645,1200,1600,15,927,942,815,858,True,37
i,164,kaist_dataset/English/Digital_Camera/(E.S)C-outdoor1/2007-12-08-day-098.jpg,char_data/i/2007-12-08-day-098.jpg_4.jpg,7872,1200,1600,48,478,526,486,650,True,37
i,168,kaist_dataset/English/Digital_Camera/(E.S)C-outdoor1/2007-12-08-day-098.jpg,char_data/i/2007-12-08-day-098.jpg_5.jpg,11088,1200,1600,66,1361,1427,468,636,True,37
i,166,kaist_dataset/English/Digital_Camera/(E.S)C-outdoor1/DSC02354.JPG,char_data/i/DSC02354.JPG_2.jpg,8466,480,640,51,285,336,165,331,True,37
i,53,kaist_dataset/English/Digital_Camera/(E.S)C-outdoor1/DSC02355.JPG,char_data/i/DSC02355.JPG_2.jpg,530,480,640,10,130,140,294,347,True,37
i,59,kaist_dataset/English/Digital_Camera/(E.S)C-outdoor1/DSC02356.JPG,char_data/i/DSC02356.JPG_2.jpg,826,480,640,14,317,331,294,353,True,37
i,179,kaist_dataset/English/Digital_Camera/(E.S)C-outdoor1/DSC02387.JPG,char_data/i/DSC02387.JPG_4.jpg,9129,480,640,51,477,528,108,287,True,37
i,39,kaist_dataset/English/Digital_Camera/(E.S)C-outdoor1/DSC02387.JPG,char_data/i/DSC02387.JPG_5.jpg,312,480,640,8,421,429,292,331,True,37
i,150,kaist_dataset/English/Digital_Camera/(E.S)C-outdoor1/DSC02415.JPG,char_data/i/DSC02415.JPG_2.jpg,8700,480,640,58,351,409,43,193,True,37
i,52,kaist_dataset/English/Digital_Camera/(E.S)C-outdoor1/DSC02480.JPG,char_data/i/DSC02480.JPG_8.jpg,676,480,640,13,320,333,389,441,True,37
i,96,kaist_dataset/English/Digital_Camera/(E.S)C-outdoor1/DSC02491.JPG,char_data/i/DSC02491.JPG_6.jpg,1632,480,640,17,181,198,212,308,True,37
i,86,kaist_dataset/English/Digital_Camera/(E.S)C-outdoor1/DSC02491.JPG,char_data/i/DSC02491.JPG_7.jpg,1634,480,640,19,249,268,218,304,True,37
i,78,kaist_dataset/English/Digital_Camera/(E.S)C-outdoor1/DSC02491.JPG,char_data/i/DSC02491.JPG_8.jpg,1326,480,640,17,191,208,136,214,True,37
i,57,kaist_dataset/English/Digital_Camera/(E.S)C-outdoor1/DSC02500.JPG,char_data/i/DSC02500.JPG_11.jpg,1026,480,640,18,515,533,286,343,True,37
i,77,kaist_dataset/English/Digital_Camera/(E.S)C-outdoor1/DSC02514.JPG,char_data/i/DSC02514.JPG_4.jpg,1694,480,640,22,299,321,172,249,True,37
i,68,kaist_dataset/English/Digital_Camera/(E.S)C-outdoor1/DSC02514.JPG,char_data/i/DSC02514.JPG_5.jpg,816,480,640,12,344,356,179,247,True,37
i,51,kaist_dataset/English/Digital_Camera/(E.S)C-outdoor1/DSC02868.JPG,char_data/i/DSC02868.JPG_2.jpg,408,480,640,8,314,322,391,442,True,37
i,116,kaist_dataset/English/Digital_Camera/(E.S)C-outdoor1/DSC02914.JPG,char_data/i/DSC02914.JPG_2.jpg,4872,480,640,42,458,500,186,302,True,37
i,35,kaist_dataset/English/Digital_Camera/(E.S)C-outdoor1/DSC02918.JPG,char_data/i/DSC02918.JPG_6.jpg,350,480,640,10,312,322,232,267,True,37
i,37,kaist_dataset/English/Digital_Camera/(E.S)C-outdoor1/DSC02918.JPG,char_data/i/DSC02918.JPG_7.jpg,518,480,640,14,475,489,225,262,True,37
i,46,kaist_dataset/English/Digital_Camera/(E.S)C-outdoor1/DSC02918.JPG,char_data/i/DSC02918.JPG_8.jpg,1058,480,640,23,385,408,176,222,True,37
i,56,kaist_dataset/English/Digital_Camera/(E.S)C-outdoor2/DSC02998.JPG,char_data/i/DSC02998.JPG_2.jpg,784,480,640,14,337,351,413,469,True,37
i,62,kaist_dataset/English/Digital_Camera/(E.S)C-outdoor2/DSC03000.JPG,char_data/i/DSC03000.JPG_4.jpg,2046,480,640,33,158,191,287,349,True,37
i,53,kaist_dataset/English/Digital_Camera/(E.S)C-outdoor2/DSC03000.JPG,char_data/i/DSC03000.JPG_5.jpg,1378,480,640,26,265,291,290,343,True,37
i,40,kaist_dataset/English/Digital_Camera/(E.S)C-outdoor2/DSC03162.JPG,char_data/i/DSC03162.JPG_4.jpg,360,480,640,9,226,235,140,180,True,37
i,40,kaist_dataset/English/Digital_Camera/(E.S)C-outdoor2/DSC03162.JPG,char_data/i/DSC03162.JPG_5.jpg,400,480,640,10,244,254,138,178,True,37
i,51,kaist_dataset/English/Digital_Camera/(E.S)C-outdoor2/DSC03166.JPG,char_data/i/DSC03166.JPG_2.jpg,867,480,640,17,335,352,266,317,True,37
i,63,kaist_dataset/English/Digital_Camera/(E.S)C-outdoor2/DSC03170.JPG,char_data/i/DSC03170.JPG_2.jpg,1134,480,640,18,331,349,299,362,True,37
i,68,kaist_dataset/English/Digital_Camera/(E.S)C-outdoor2/DSC03192.JPG,char_data/i/DSC03192.JPG_2.jpg,1700,480,640,25,358,383,154,222,True,37
i,174,kaist_dataset/English/Digital_Camera/(E.S)C-outdoor2/DSC03197.JPG,char_data/i/DSC03197.JPG_4.jpg,10614,480,640,61,141,202,48,222,True,37
i,58,kaist_dataset/English/Digital_Camera/(E.S)C-outdoor2/DSC03201.JPG,char_data/i/DSC03201.JPG_2.jpg,754,480,640,13,408,421,78,136,True,37
i,46,kaist_dataset/English/Digital_Camera/(E.S)C-outdoor2/DSC03203.JPG,char_data/i/DSC03203.JPG_4.jpg,552,480,640,12,137,149,372,418,True,37
i,30,kaist_dataset/English/Digital_Camera/(E.S)C-outdoor2/DSC03208.JPG,char_data/i/DSC03208.JPG_5.jpg,360,480,640,12,268,280,164,194,True,37
i,40,kaist_dataset/English/Digital_Camera/(E.S)C-outdoor2/DSC03225.JPG,char_data/i/DSC03225.JPG_5.jpg,520,480,640,13,393,406,78,118,True,37
i,53,kaist_dataset/English/Digital_Camera/(E.S)C-outdoor2/DSC03262.JPG,char_data/i/DSC03262.JPG_2.jpg,1113,480,640,21,144,165,123,176,True,37
i,57,kaist_dataset/English/Digital_Camera/(E.S)C-outdoor2/DSC03290.JPG,char_data/i/DSC03290.JPG_6.jpg,912,480,640,16,358,374,87,144,True,37
i,55,kaist_dataset/English/Digital_Camera/(E.S)C-outdoor2/DSC03290.JPG,char_data/i/DSC03290.JPG_7.jpg,935,480,640,17,236,253,404,459,True,37
i,58,kaist_dataset/English/Digital_Camera/(E.S)C-outdoor2/DSC03290.JPG,char_data/i/DSC03290.JPG_8.jpg,870,480,640,15,257,272,193,251,True,37
i,89,kaist_dataset/English/Digital_Camera/(E.S)C-outdoor2/DSC03300.JPG,char_data/i/DSC03300.JPG_2.jpg,3026,480,640,34,303,337,141,230,True,37
i,139,kaist_dataset/English/Digital_Camera/(E.S)C-outdoor2/DSC03406.JPG,char_data/i/DSC03406.JPG_4.jpg,5977,480,640,43,69,112,19,158,True,37
i,170,kaist_dataset/English/Digital_Camera/(E.S)C-outdoor2/DSC03406.JPG,char_data/i/DSC03406.JPG_5.jpg,6970,480,640,41,195,236,16,186,True,37
i,92,kaist_dataset/English/Digital_Camera/(E.S)C-outdoor2/DSC03436.JPG,char_data/i/DSC03436.JPG_2.jpg,2576,480,640,28,371,399,24,116,True,37
i,51,kaist_dataset/English/Digital_Camera/(E.S)C-outdoor2/DSC03440.JPG,char_data/i/DSC03440.JPG_4.jpg,510,480,640,10,234,244,26,77,True,37
i,60,kaist_dataset/English/Digital_Camera/(E.S)C-outdoor2/DSC03440.JPG,char_data/i/DSC03440.JPG_5.jpg,960,480,640,16,295,311,135,195,True,37
i,46,kaist_dataset/English/Digital_Camera/(E.S)C-outdoor2/DSC03664.JPG,char_data/i/DSC03664.JPG_2.jpg,782,480,640,17,173,190,23,69,True,37
i,74,kaist_dataset/English/Digital_Camera/(E.S)C-outdoor2/DSC03731.JPG,char_data/i/DSC03731.JPG_2.jpg,2368,480,640,32,142,174,43,117,True,37
i,84,kaist_dataset/English/Digital_Camera/(E.S)C-outdoor2/DSC03761.JPG,char_data/i/DSC03761.JPG_2.jpg,1848,480,640,22,371,393,329,413,True,37
i,122,kaist_dataset/English/Digital_Camera/(E.S)C-outdoor2/DSC03786.JPG,char_data/i/DSC03786.JPG_4.jpg,4758,480,640,39,385,424,27,149,True,37
i,128,kaist_dataset/English/Digital_Camera/(E.S)C-outdoor2/DSC03786.JPG,char_data/i/DSC03786.JPG_5.jpg,3968,480,640,31,413,444,166,294,True,37
i,57,kaist_dataset/English/Digital_Camera/(E.S)C-outdoor2/DSC04035.JPG,char_data/i/DSC04035.JPG_2.jpg,741,480,640,13,480,493,190,247,True,37
i,47,kaist_dataset/English/Digital_Camera/(E.S)C-outdoor2/DSC04064.JPG,char_data/i/DSC04064.JPG_2.jpg,517,480,640,11,347,358,130,177,True,37
i,41,kaist_dataset/English/Digital_Camera/(E.S)C-outdoor2/DSC04079.JPG,char_data/i/DSC04079.JPG_4.jpg,656,480,640,16,65,81,113,154,True,37
i,36,kaist_dataset/English/Digital_Camera/(E.S)C-outdoor2/DSC04079.JPG,char_data/i/DSC04079.JPG_5.jpg,612,480,640,17,269,286,157,193,True,37
i,97,kaist_dataset/English/Digital_Camera/(E.S)C-outdoor2/DSC04160.JPG,char_data/i/DSC04160.JPG_2.jpg,3783,480,640,39,225,264,341,438,True,37
i,60,kaist_dataset/English/Digital_Camera/(E.S)C-outdoor2/DSC04163.JPG,char_data/i/DSC04163.JPG_5.jpg,1560,480,640,26,465,491,254,314,True,37
i,71,kaist_dataset/English/Digital_Camera/(E.S)C-outdoor2/DSC04397.JPG,char_data/i/DSC04397.JPG_2.jpg,1420,480,640,20,245,265,117,188,True,37
i,125,kaist_dataset/English/Digital_Camera/(E.S)C-outdoor2/DSC04430.JPG,char_data/i/DSC04430.JPG_2.jpg,6500,480,640,52,389,441,142,267,True,37
i,151,kaist_dataset/English/Digital_Camera/(E.S)C-outdoor2/DSC04433.JPG,char_data/i/DSC04433.JPG_2.jpg,8305,480,640,55,240,295,110,261,True,37
i,30,kaist_dataset/English/Digital_Camera/(E.S)C-outdoor2/DSC04437.JPG,char_data/i/DSC04437.JPG_4.jpg,330,480,640,11,204,215,40,70,True,37
i,26,kaist_dataset/English/Digital_Camera/(E.S)C-outdoor2/DSC04437.JPG,char_data/i/DSC04437.JPG_5.jpg,312,480,640,12,302,314,77,103,True,37
i,102,kaist_dataset/English/Digital_Camera/(E.S)C-outdoor2/IMG_2618.JPG,char_data/i/IMG_2618.JPG_2.jpg,3264,279,640,32,350,382,161,263,True,37
i,56,kaist_dataset/English/Digital_Camera/(E.S)C-outdoor2/P1010057.JPG,char_data/i/P1010057.JPG_2.jpg,1120,480,640,20,251,271,187,243,True,37
i,31,kaist_dataset/English/Digital_Camera/(E.S)C-outdoor3/P1010123.JPG,char_data/i/P1010123.JPG_4.jpg,217,480,640,7,524,531,65,96,True,37
i,28,kaist_dataset/English/Digital_Camera/(E.S)C-outdoor3/P1010123.JPG,char_data/i/P1010123.JPG_5.jpg,280,480,640,10,29,39,73,101,True,37
i,76,kaist_dataset/English/Digital_Camera/(E.S)C-outdoor3/크기변환_%B0%A3%C6%C71_fabdent.jpg,char_data/i/크기변환_%B0%A3%C6%C71_fabdent.jpg_2.jpg,1824,480,640,24,460,484,227,303,True,37
i,19,kaist_dataset/English/Digital_Camera/(E.S)C-outdoor3/크기변환_P1010076.JPG,char_data/i/크기변환_P1010076.JPG_5.jpg,76,480,640,4,232,236,105,124,True,37
i,35,kaist_dataset/English/Digital_Camera/(E.S)D-indoor/080119-0009.jpg,char_data/i/080119-0009.jpg_18.jpg,595,1200,1600,17,842,859,684,719,True,37
i,41,kaist_dataset/English/Digital_Camera/(E.S)D-indoor/080119-0009.jpg,char_data/i/080119-0009.jpg_19.jpg,451,1200,1600,11,786,797,1066,1107,True,37
i,48,kaist_dataset/English/Digital_Camera/(E.S)D-indoor/080119-0009.jpg,char_data/i/080119-0009.jpg_20.jpg,816,1200,1600,17,945,962,1079,1127,True,37
i,43,kaist_dataset/English/Digital_Camera/(E.S)D-indoor/080119-0009.jpg,char_data/i/080119-0009.jpg_21.jpg,430,1200,1600,10,760,770,1102,1145,True,37
i,48,kaist_dataset/English/Digital_Camera/(E.S)D-indoor/080119-0009.jpg,char_data/i/080119-0009.jpg_22.jpg,480,1200,1600,10,638,648,957,1005,True,37
i,43,kaist_dataset/English/Digital_Camera/(E.S)D-indoor/080119-0009.jpg,char_data/i/080119-0009.jpg_23.jpg,602,1200,1600,14,820,834,1001,1044,True,37
i,48,kaist_dataset/English/Digital_Camera/(E.S)D-indoor/DSC02859.JPG,char_data/i/DSC02859.JPG_2.jpg,912,480,640,19,463,482,343,391,True,37
i,78,kaist_dataset/English/Digital_Camera/(E.S)D-indoor/DSC02860.JPG,char_data/i/DSC02860.JPG_6.jpg,1560,480,640,20,330,350,61,139,True,37
i,72,kaist_dataset/English/Digital_Camera/(E.S)D-indoor/DSC02860.JPG,char_data/i/DSC02860.JPG_7.jpg,1512,480,640,21,394,415,65,137,True,37
i,81,kaist_dataset/English/Digital_Camera/(E.S)D-indoor/DSC02860.JPG,char_data/i/DSC02860.JPG_8.jpg,1944,480,640,24,453,477,63,144,True,37
i,75,kaist_dataset/English/Digital_Camera/(E.S)D-indoor/DSC03076.JPG,char_data/i/DSC03076.JPG_2.jpg,1575,480,640,21,233,254,288,363,True,37
i,61,kaist_dataset/English/Digital_Camera/(E.S)D-indoor/DSC03078.JPG,char_data/i/DSC03078.JPG_6.jpg,1037,480,640,17,135,152,222,283,True,37
i,62,kaist_dataset/English/Digital_Camera/(E.S)D-indoor/DSC03078.JPG,char_data/i/DSC03078.JPG_7.jpg,1054,480,640,17,431,448,224,286,True,37
i,61,kaist_dataset/English/Digital_Camera/(E.S)D-indoor/DSC03078.JPG,char_data/i/DSC03078.JPG_8.jpg,1098,480,640,18,395,413,299,360,True,37
i,99,kaist_dataset/English/Digital_Camera/(E.S)D-indoor/DSC03080.JPG,char_data/i/DSC03080.JPG_2.jpg,3267,480,640,33,180,213,342,441,True,37
i,65,kaist_dataset/English/Digital_Camera/(E.S)D-indoor/DSC03083.JPG,char_data/i/DSC03083.JPG_4.jpg,1040,480,640,16,253,269,386,451,True,37
i,66,kaist_dataset/English/Digital_Camera/(E.S)D-indoor/DSC03083.JPG,char_data/i/DSC03083.JPG_5.jpg,924,480,640,14,287,301,389,455,True,37
i,62,kaist_dataset/English/Digital_Camera/(E.S)D-indoor/DSC03085.JPG,char_data/i/DSC03085.JPG_5.jpg,1116,480,640,18,208,226,371,433,True,37
i,73,kaist_dataset/English/Digital_Camera/(E.S)D-indoor/DSC03093.JPG,char_data/i/DSC03093.JPG_6.jpg,1752,480,640,24,346,370,117,190,True,37
i,74,kaist_dataset/English/Digital_Camera/(E.S)D-indoor/DSC03093.JPG,char_data/i/DSC03093.JPG_7.jpg,1776,480,640,24,464,488,116,190,True,37
i,55,kaist_dataset/English/Digital_Camera/(E.S)D-indoor/DSC03093.JPG,char_data/i/DSC03093.JPG_8.jpg,1045,480,640,19,420,439,200,255,True,37
i,41,kaist_dataset/English/Digital_Camera/(E.S)D-indoor/DSC03112.JPG,char_data/i/DSC03112.JPG_2.jpg,328,480,640,8,413,421,208,249,True,37
i,33,kaist_dataset/English/Digital_Camera/(E.S)D-indoor/DSC03146.JPG,char_data/i/DSC03146.JPG_2.jpg,429,480,640,13,471,484,235,268,True,37
i,64,kaist_dataset/English/Digital_Camera/(E.S)D-indoor/DSC03345.JPG,char_data/i/DSC03345.JPG_2.jpg,1408,480,640,22,257,279,87,151,True,37
i,51,kaist_dataset/English/Digital_Camera/(E.S)D-indoor/DSC03396.JPG,char_data/i/DSC03396.JPG_2.jpg,561,480,640,11,479,490,337,388,True,37
i,119,kaist_dataset/English/Digital_Camera/(E.S)D-indoor/DSC03398.JPG,char_data/i/DSC03398.JPG_2.jpg,3570,480,640,30,304,334,304,423,True,37
i,28,kaist_dataset/English/Digital_Camera/(E.S)D-indoor/DSC03532.JPG,char_data/i/DSC03532.JPG_12.jpg,224,480,640,8,145,153,381,409,True,37
i,31,kaist_dataset/English/Digital_Camera/(E.S)D-indoor/DSC03532.JPG,char_data/i/DSC03532.JPG_13.jpg,217,480,640,7,315,322,379,410,True,37
i,33,kaist_dataset/English/Digital_Camera/(E.S)D-indoor/DSC03532.JPG,char_data/i/DSC03532.JPG_14.jpg,264,480,640,8,582,590,372,405,True,37
i,80,kaist_dataset/English/Digital_Camera/(E.S)D-indoor/DSC03883.JPG,char_data/i/DSC03883.JPG_2.jpg,3200,480,640,40,243,283,305,385,True,37
i,110,kaist_dataset/English/Digital_Camera/(E.S)D-indoor/DSC03918.JPG,char_data/i/DSC03918.JPG_6.jpg,2750,480,640,25,269,294,264,374,True,37
i,58,kaist_dataset/English/Digital_Camera/(E.S)D-indoor/DSC03936.JPG,char_data/i/DSC03936.JPG_2.jpg,1044,480,640,18,432,450,76,134,True,37
i,46,kaist_dataset/English/Digital_Camera/(E.S)D-indoor/DSC03947.JPG,char_data/i/DSC03947.JPG_5.jpg,460,480,640,10,506,516,410,456,True,37
i,38,kaist_dataset/English/Digital_Camera/(E.S)D-indoor/DSC04023.JPG,char_data/i/DSC04023.JPG_5.jpg,836,480,640,22,244,266,309,347,True,37
i,51,kaist_dataset/English/Digital_Camera/(E.S)D-indoor/크기변환_%B0%A3%C6%C76_fabdent.jpg,char_data/i/크기변환_%B0%A3%C6%C76_fabdent.jpg_2.jpg,408,480,640,8,190,198,187,238,True,37
i,67,kaist_dataset/English/Digital_Camera/(E.S)E-night/111.jpg,char_data/i/111.jpg_6.jpg,2077,480,640,31,236,267,187,254,True,37
i,102,kaist_dataset/English/Digital_Camera/(E.S)E-night/DSC02981.JPG,char_data/i/DSC02981.JPG_4.jpg,2652,480,640,26,264,290,6,108,True,37
i,128,kaist_dataset/English/Digital_Camera/(E.S)E-night/DSC02981.JPG,char_data/i/DSC02981.JPG_5.jpg,3968,480,640,31,288,319,163,291,True,37
i,96,kaist_dataset/English/Digital_Camera/(E.S)E-night/크기변환_P1010163.JPG,char_data/i/크기변환_P1010163.JPG_2.jpg,4128,480,640,43,349,392,79,175,True,37
i,62,kaist_dataset/English/Digital_Camera/(E.S)F-others/080119-0007.jpg,char_data/i/080119-0007.jpg_14.jpg,1240,1200,1600,20,954,974,793,855,True,37
i,40,kaist_dataset/English/Digital_Camera/(E.S)F-others/080119-0007.jpg,char_data/i/080119-0007.jpg_17.jpg,520,1200,1600,13,896,909,884,924,True,37
i,40,kaist_dataset/English/Digital_Camera/(E.S)F-others/080119-0007.jpg,char_data/i/080119-0007.jpg_18.jpg,480,1200,1600,12,930,942,877,917,True,37
i,65,kaist_dataset/English/Digital_Camera/(E.S)F-others/080119-0007.jpg,char_data/i/080119-0007.jpg_19.jpg,1430,1200,1600,22,822,844,749,814,True,37
i,66,kaist_dataset/English/Digital_Camera/(E.S)F-others/080119-0007.jpg,char_data/i/080119-0007.jpg_20.jpg,1518,1200,1600,23,1047,1070,705,771,True,37
i,40,kaist_dataset/English/Digital_Camera/(E.S)F-others/DSC03218.JPG,char_data/i/DSC03218.JPG_2.jpg,600,480,640,15,227,242,324,364,True,37
i,126,kaist_dataset/English/Mobile_Phone/(E.M)A-outdoor/P090911070.jpg,char_data/i/P090911070.jpg_4.jpg,6048,480,640,48,347,395,141,267,True,37
i,136,kaist_dataset/English/Mobile_Phone/(E.M)A-outdoor/P090911070.jpg,char_data/i/P090911070.jpg_5.jpg,7480,480,640,55,392,447,137,273,True,37
i,77,kaist_dataset/English/Mobile_Phone/(E.M)B-indoor/P090902018.jpg,char_data/i/P090902018.jpg_2.jpg,1463,480,640,19,301,320,175,252,True,37
i,109,kaist_dataset/English/Mobile_Phone/(E.M)B-indoor/P090903002.jpg,char_data/i/P090903002.jpg_4.jpg,4251,480,640,39,257,296,284,393,True,37
i,105,kaist_dataset/English/Mobile_Phone/(E.M)B-indoor/P090903002.jpg,char_data/i/P090903002.jpg_5.jpg,4935,480,640,47,380,427,290,395,True,37
i,112,kaist_dataset/English/Mobile_Phone/(E.M)B-indoor/P090903003.jpg,char_data/i/P090903003.jpg_2.jpg,4928,480,640,44,262,306,245,357,True,37
i,68,kaist_dataset/English/Mobile_Phone/(E.M)B-indoor/P090903008.jpg,char_data/i/P090903008.jpg_4.jpg,1768,480,640,26,128,154,27,95,True,37
i,81,kaist_dataset/English/Mobile_Phone/(E.M)B-indoor/P090911067.jpg,char_data/i/P090911067.jpg_2.jpg,2268,480,640,28,351,379,202,283,True,37
i,67,kaist_dataset/English/Mobile_Phone/(E.M)B-indoor/P090911080.jpg,char_data/i/P090911080.jpg_2.jpg,1139,480,640,17,357,374,227,294,True,37
i,64,kaist_dataset/English/Mobile_Phone/(E.M)B-indoor/P090911081.jpg,char_data/i/P090911081.jpg_2.jpg,1408,480,640,22,376,398,216,280,True,37
i,164,kaist_dataset/English/Mobile_Phone/(E.M)C-bookCover/P090831022.jpg,char_data/i/P090831022.jpg_2.jpg,8200,480,640,50,461,511,120,284,True,37
i,86,kaist_dataset/English/Mobile_Phone/(E.M)C-bookCover/P090831039.jpg,char_data/i/P090831039.jpg_5.jpg,2838,480,640,33,325,358,114,200,True,37
i,114,kaist_dataset/English/Mobile_Phone/(E.M)C-bookCover/P090831077.jpg,char_data/i/P090831077.jpg_6.jpg,4560,480,640,40,422,462,75,189,True,37
i,118,kaist_dataset/English/Mobile_Phone/(E.M)C-bookCover/P090831077.jpg,char_data/i/P090831077.jpg_7.jpg,4012,480,640,34,184,218,254,372,True,37
i,124,kaist_dataset/English/Mobile_Phone/(E.M)C-bookCover/P090831077.jpg,char_data/i/P090831077.jpg_8.jpg,4464,480,640,36,385,421,255,379,True,37
i,39,kaist_dataset/English/Mobile_Phone/(E.M)C-bookCover/P090903030.jpg,char_data/i/P090903030.jpg_2.jpg,546,480,640,14,353,367,74,113,True,37
i,39,kaist_dataset/Korean/Digital_Camera/G-others/080119-0005.jpg,char_data/i/080119-0005.jpg_4.jpg,546,1600,1200,14,561,575,581,620,True,37
i,36,kaist_dataset/Korean/Digital_Camera/G-others/080119-0005.jpg,char_data/i/080119-0005.jpg_5.jpg,288,1600,1200,8,749,757,609,645,True,37
i,55,kaist_dataset/Korean/Digital_Camera/G-others/2007-12-08-day-112.jpg,char_data/i/2007-12-08-day-112.jpg_2.jpg,660,1200,1600,12,855,867,487,542,True,37
i,25,kaist_dataset/Korean/Digital_Camera/indoor1/080119-0029.jpg,char_data/i/080119-0029.jpg_2.jpg,150,1200,1600,6,921,927,657,682,True,37
i,26,kaist_dataset/Korean/Digital_Camera/outdoor1/001.JPG,char_data/i/001.JPG_10.jpg,234,480,640,9,305,314,239,265,True,37
i,23,kaist_dataset/Korean/Digital_Camera/outdoor1/001.JPG,char_data/i/001.JPG_11.jpg,207,480,640,9,538,547,238,261,True,37
i,55,kaist_dataset/Korean/Digital_Camera/outdoor1/2007-12-08-day-087.jpg,char_data/i/2007-12-08-day-087.jpg_2.jpg,935,1200,1600,17,1281,1298,668,723,True,37
i,64,kaist_dataset/Korean/Digital_Camera/outdoor2/080118-0018.jpg,char_data/i/080118-0018.jpg_2.jpg,1472,1200,1600,23,1292,1315,680,744,True,37
i,75,kaist_dataset/Korean/Digital_Camera/outdoor2/2007-12-08-day-101.jpg,char_data/i/2007-12-08-day-101.jpg_8.jpg,1800,1200,1600,24,504,528,365,440,True,37
i,75,kaist_dataset/Korean/Digital_Camera/outdoor2/2007-12-08-day-101.jpg,char_data/i/2007-12-08-day-101.jpg_9.jpg,1725,1200,1600,23,878,901,382,457,True,37
i,39,kaist_dataset/Korean/Digital_Camera/outdoor2/2007-12-09-day-exterior-036.jpg,char_data/i/2007-12-09-day-exterior-036.jpg_2.jpg,702,1200,1600,18,1395,1413,548,587,True,37
i,58,kaist_dataset/Mixed/Digital_Camera/(C.S)A-shadow/DSC03207.JPG,char_data/i/DSC03207.JPG_2.jpg,696,480,640,12,313,325,201,259,True,37
i,44,kaist_dataset/Mixed/Digital_Camera/(C.S)B-light/134.JPG,char_data/i/134.JPG_2.jpg,352,480,640,8,404,412,288,332,True,37
i,52,kaist_dataset/Mixed/Digital_Camera/(C.S)C-outdoor1/003.JPG,char_data/i/003.JPG_14.jpg,1040,480,640,20,297,317,97,149,True,37
i,57,kaist_dataset/Mixed/Digital_Camera/(C.S)C-outdoor1/003.JPG,char_data/i/003.JPG_15.jpg,1140,480,640,20,376,396,94,151,True,37
i,31,kaist_dataset/Mixed/Digital_Camera/(C.S)C-outdoor1/003.JPG,char_data/i/003.JPG_16.jpg,279,480,640,9,538,547,247,278,True,37
i,27,kaist_dataset/Mixed/Digital_Camera/(C.S)C-outdoor1/003.JPG,char_data/i/003.JPG_18.jpg,162,480,640,6,261,267,259,286,True,37
i,22,kaist_dataset/Mixed/Digital_Camera/(C.S)C-outdoor1/003.JPG,char_data/i/003.JPG_20.jpg,132,480,640,6,166,172,264,286,True,37
i,30,kaist_dataset/Mixed/Digital_Camera/(C.S)C-outdoor1/021.JPG,char_data/i/021.JPG_2.jpg,240,480,640,8,492,500,136,166,True,37
i,29,kaist_dataset/Mixed/Digital_Camera/(C.S)C-outdoor1/080.JPG,char_data/i/080.JPG_10.jpg,609,480,640,21,162,183,80,109,True,37
i,38,kaist_dataset/Mixed/Digital_Camera/(C.S)C-outdoor1/080.JPG,char_data/i/080.JPG_11.jpg,836,480,640,22,145,167,109,147,True,37
i,180,kaist_dataset/Mixed/Digital_Camera/(C.S)C-outdoor1/080118-0014.jpg,char_data/i/080118-0014.jpg_2.jpg,7920,1200,1600,44,1192,1236,706,886,True,37
i,241,kaist_dataset/Mixed/Digital_Camera/(C.S)C-outdoor1/080119-0033.jpg,char_data/i/080119-0033.jpg_2.jpg,23618,1200,1600,98,745,843,453,694,True,37
i,37,kaist_dataset/Mixed/Digital_Camera/(C.S)C-outdoor1/1.JPG,char_data/i/1.JPG_5.jpg,370,576,768,10,476,486,5,42,True,37
i,38,kaist_dataset/Mixed/Digital_Camera/(C.S)C-outdoor1/115.JPG,char_data/i/115.JPG_2.jpg,342,480,640,9,331,340,272,310,True,37
i,78,kaist_dataset/Mixed/Digital_Camera/(C.S)C-outdoor1/2007-12-08-day-118.jpg,char_data/i/2007-12-08-day-118.jpg_2.jpg,2652,1200,1600,34,1284,1318,401,479,True,37
i,73,kaist_dataset/Mixed/Digital_Camera/(C.S)C-outdoor1/2007-12-09-day-exterior-044.jpg,char_data/i/2007-12-09-day-exterior-044.jpg_2.jpg,1752,1200,1600,24,801,825,817,890,True,37
i,32,kaist_dataset/Mixed/Digital_Camera/(C.S)C-outdoor1/DSC02318.JPG,char_data/i/DSC02318.JPG_2.jpg,256,480,640,8,454,462,317,349,True,37
i,34,kaist_dataset/Mixed/Digital_Camera/(C.S)C-outdoor1/DSC02325.JPG,char_data/i/DSC02325.JPG_5.jpg,544,480,640,16,243,259,319,353,True,37
i,30,kaist_dataset/Mixed/Digital_Camera/(C.S)C-outdoor2/DSC02385.JPG,char_data/i/DSC02385.JPG_5.jpg,210,480,640,7,453,460,139,169,True,37
i,63,kaist_dataset/Mixed/Digital_Camera/(C.S)C-outdoor2/DSC02407.JPG,char_data/i/DSC02407.JPG_4.jpg,1197,480,640,19,227,246,170,233,True,37
i,60,kaist_dataset/Mixed/Digital_Camera/(C.S)C-outdoor2/DSC02407.JPG,char_data/i/DSC02407.JPG_5.jpg,1140,480,640,19,282,301,171,231,True,37
i,69,kaist_dataset/Mixed/Digital_Camera/(C.S)C-outdoor2/DSC02416.JPG,char_data/i/DSC02416.JPG_2.jpg,2139,480,640,31,488,519,191,260,True,37
i,23,kaist_dataset/Mixed/Digital_Camera/(C.S)C-outdoor2/DSC02430.JPG,char_data/i/DSC02430.JPG_2.jpg,161,480,640,7,39,46,28,51,True,37
i,84,kaist_dataset/Mixed/Digital_Camera/(C.S)C-outdoor2/DSC02436.JPG,char_data/i/DSC02436.JPG_2.jpg,1512,480,640,18,120,138,171,255,True,37
i,26,kaist_dataset/Mixed/Digital_Camera/(C.S)C-outdoor2/DSC02439.JPG,char_data/i/DSC02439.JPG_5.jpg,234,480,640,9,392,401,108,134,True,37
i,25,kaist_dataset/Mixed/Digital_Camera/(C.S)C-outdoor2/DSC02483.JPG,char_data/i/DSC02483.JPG_2.jpg,175,480,640,7,335,342,151,176,True,37
i,99,kaist_dataset/Mixed/Digital_Camera/(C.S)C-outdoor2/DSC02493.JPG,char_data/i/DSC02493.JPG_2.jpg,2871,480,640,29,369,398,269,368,True,37
i,57,kaist_dataset/Mixed/Digital_Camera/(C.S)C-outdoor2/DSC02519.JPG,char_data/i/DSC02519.JPG_2.jpg,855,480,640,15,241,256,216,273,True,37
i,33,kaist_dataset/Mixed/Digital_Camera/(C.S)C-outdoor2/DSC02545.JPG,char_data/i/DSC02545.JPG_6.jpg,462,480,640,14,403,417,365,398,True,37
i,28,kaist_dataset/Mixed/Digital_Camera/(C.S)C-outdoor2/DSC02545.JPG,char_data/i/DSC02545.JPG_7.jpg,364,480,640,13,505,518,361,389,True,37
i,28,kaist_dataset/Mixed/Digital_Camera/(C.S)C-outdoor2/DSC02545.JPG,char_data/i/DSC02545.JPG_8.jpg,308,480,640,11,543,554,360,388,True,37
i,40,kaist_dataset/Mixed/Digital_Camera/(C.S)C-outdoor2/DSC02886.JPG,char_data/i/DSC02886.JPG_2.jpg,520,480,640,13,482,495,130,170,True,37
i,66,kaist_dataset/Mixed/Digital_Camera/(C.S)C-outdoor2/DSC02907.JPG,char_data/i/DSC02907.JPG_2.jpg,1584,480,640,24,275,299,91,157,True,37
i,36,kaist_dataset/Mixed/Digital_Camera/(C.S)C-outdoor2/DSC02912.JPG,char_data/i/DSC02912.JPG_2.jpg,432,480,640,12,243,255,9,45,True,37
i,68,kaist_dataset/Mixed/Digital_Camera/(C.S)C-outdoor2/DSC02936.JPG,char_data/i/DSC02936.JPG_8.jpg,2040,480,640,30,373,403,124,192,True,37
i,37,kaist_dataset/Mixed/Digital_Camera/(C.S)C-outdoor2/DSC02936.JPG,char_data/i/DSC02936.JPG_10.jpg,407,480,640,11,199,210,77,114,True,37
i,39,kaist_dataset/Mixed/Digital_Camera/(C.S)C-outdoor2/DSC02936.JPG,char_data/i/DSC02936.JPG_11.jpg,390,480,640,10,367,377,81,120,True,37
i,59,kaist_dataset/Mixed/Digital_Camera/(C.S)C-outdoor3/DSC02962.JPG,char_data/i/DSC02962.JPG_2.jpg,944,480,640,16,265,281,253,312,True,37
i,81,kaist_dataset/Mixed/Digital_Camera/(C.S)C-outdoor3/DSC02989.JPG,char_data/i/DSC02989.JPG_14.jpg,3564,480,640,44,312,356,168,249,True,37
i,54,kaist_dataset/Mixed/Digital_Camera/(C.S)C-outdoor3/DSC02989.JPG,char_data/i/DSC02989.JPG_15.jpg,864,480,640,16,541,557,202,256,True,37
i,45,kaist_dataset/Mixed/Digital_Camera/(C.S)C-outdoor3/DSC03063.JPG,char_data/i/DSC03063.JPG_4.jpg,720,480,640,16,297,313,287,332,True,37
i,49,kaist_dataset/Mixed/Digital_Camera/(C.S)C-outdoor3/DSC03063.JPG,char_data/i/DSC03063.JPG_5.jpg,686,480,640,14,463,477,294,343,True,37
i,43,kaist_dataset/Mixed/Digital_Camera/(C.S)C-outdoor3/DSC03177.JPG,char_data/i/DSC03177.JPG_2.jpg,860,480,640,20,235,255,138,181,True,37
i,55,kaist_dataset/Mixed/Digital_Camera/(C.S)C-outdoor3/DSC03310.JPG,char_data/i/DSC03310.JPG_2.jpg,770,480,640,14,289,303,113,168,True,37
i,31,kaist_dataset/Mixed/Digital_Camera/(C.S)C-outdoor3/DSC03328.JPG,char_data/i/DSC03328.JPG_2.jpg,248,480,640,8,484,492,229,260,True,37
i,120,kaist_dataset/Mixed/Digital_Camera/(C.S)C-outdoor3/DSC03421.JPG,char_data/i/DSC03421.JPG_2.jpg,4680,480,640,39,353,392,73,193,True,37
i,126,kaist_dataset/Mixed/Digital_Camera/(C.S)C-outdoor4/DSC03519.JPG,char_data/i/DSC03519.JPG_2.jpg,6552,480,640,52,251,303,122,248,True,37
i,29,kaist_dataset/Mixed/Digital_Camera/(C.S)C-outdoor4/DSC03556.JPG,char_data/i/DSC03556.JPG_2.jpg,174,480,640,6,336,342,324,353,True,37
i,42,kaist_dataset/Mixed/Digital_Camera/(C.S)C-outdoor4/DSC03586.JPG,char_data/i/DSC03586.JPG_2.jpg,420,480,640,10,468,478,158,200,True,37
i,93,kaist_dataset/Mixed/Digital_Camera/(C.S)C-outdoor4/DSC03630.JPG,char_data/i/DSC03630.JPG_2.jpg,2697,480,640,29,338,367,337,430,True,37
i,94,kaist_dataset/Mixed/Digital_Camera/(C.S)C-outdoor4/DSC03635.JPG,char_data/i/DSC03635.JPG_2.jpg,2256,480,640,24,189,213,146,240,True,37
i,91,kaist_dataset/Mixed/Digital_Camera/(C.S)C-outdoor4/DSC03638.JPG,char_data/i/DSC03638.JPG_2.jpg,1820,480,640,20,207,227,110,201,True,37
i,53,kaist_dataset/Mixed/Digital_Camera/(C.S)C-outdoor4/DSC03642.JPG,char_data/i/DSC03642.JPG_2.jpg,636,480,640,12,314,326,240,293,True,37
i,57,kaist_dataset/Mixed/Digital_Camera/(C.S)C-outdoor4/DSC03643.JPG,char_data/i/DSC03643.JPG_2.jpg,855,480,640,15,270,285,258,315,True,37
i,27,kaist_dataset/Mixed/Digital_Camera/(C.S)C-outdoor4/DSC03661.JPG,char_data/i/DSC03661.JPG_2.jpg,351,480,640,13,134,147,273,300,True,37
i,28,kaist_dataset/Mixed/Digital_Camera/(C.S)C-outdoor4/DSC03670.JPG,char_data/i/DSC03670.JPG_2.jpg,196,480,640,7,356,363,320,348,True,37
i,41,kaist_dataset/Mixed/Digital_Camera/(C.S)C-outdoor4/DSC03672.JPG,char_data/i/DSC03672.JPG_2.jpg,451,480,640,11,247,258,403,444,True,37
i,44,kaist_dataset/Mixed/Digital_Camera/(C.S)C-outdoor4/DSC03682.JPG,char_data/i/DSC03682.JPG_2.jpg,396,480,640,9,373,382,316,360,True,37
i,33,kaist_dataset/Mixed/Digital_Camera/(C.S)C-outdoor4/DSC03718.JPG,char_data/i/DSC03718.JPG_6.jpg,264,480,640,8,312,320,95,128,True,37
i,33,kaist_dataset/Mixed/Digital_Camera/(C.S)C-outdoor4/DSC03718.JPG,char_data/i/DSC03718.JPG_7.jpg,198,480,640,6,129,135,255,288,True,37
i,35,kaist_dataset/Mixed/Digital_Camera/(C.S)C-outdoor4/DSC03718.JPG,char_data/i/DSC03718.JPG_8.jpg,210,480,640,6,209,215,253,288,True,37
i,39,kaist_dataset/Mixed/Digital_Camera/(C.S)C-outdoor4/DSC03719.JPG,char_data/i/DSC03719.JPG_4.jpg,234,480,640,6,135,141,28,67,True,37
i,38,kaist_dataset/Mixed/Digital_Camera/(C.S)C-outdoor4/DSC03719.JPG,char_data/i/DSC03719.JPG_5.jpg,190,480,640,5,217,222,27,65,True,37
i,66,kaist_dataset/Mixed/Digital_Camera/(C.S)C-outdoor4/DSC03730.JPG,char_data/i/DSC03730.JPG_2.jpg,1518,480,640,23,164,187,340,406,True,37
i,89,kaist_dataset/Mixed/Digital_Camera/(C.S)C-outdoor4/DSC03733.JPG,char_data/i/DSC03733.JPG_2.jpg,2670,480,640,30,347,377,191,280,True,37
i,41,kaist_dataset/Mixed/Digital_Camera/(C.S)C-outdoor4/DSC03773.JPG,char_data/i/DSC03773.JPG_2.jpg,738,480,640,18,356,374,280,321,True,37
i,50,kaist_dataset/Mixed/Digital_Camera/(C.S)C-outdoor4/DSC03781.JPG,char_data/i/DSC03781.JPG_4.jpg,1000,480,640,20,346,366,262,312,True,37
i,47,kaist_dataset/Mixed/Digital_Camera/(C.S)C-outdoor4/DSC03781.JPG,char_data/i/DSC03781.JPG_5.jpg,1034,480,640,22,333,355,216,263,True,37
i,79,kaist_dataset/Mixed/Digital_Camera/(C.S)C-outdoor4/DSC03784.JPG,char_data/i/DSC03784.JPG_2.jpg,1422,480,640,18,122,140,303,382,True,37
i,82,kaist_dataset/Mixed/Digital_Camera/(C.S)C-outdoor5/DSC03820.JPG,char_data/i/DSC03820.JPG_2.jpg,1394,480,640,17,86,103,353,435,True,37
i,45,kaist_dataset/Mixed/Digital_Camera/(C.S)C-outdoor5/DSC03821.JPG,char_data/i/DSC03821.JPG_2.jpg,585,480,640,13,314,327,29,74,True,37
i,39,kaist_dataset/Mixed/Digital_Camera/(C.S)C-outdoor5/DSC03839.JPG,char_data/i/DSC03839.JPG_2.jpg,546,480,640,14,259,273,34,73,True,37
i,52,kaist_dataset/Mixed/Digital_Camera/(C.S)C-outdoor5/DSC04015.JPG,char_data/i/DSC04015.JPG_5.jpg,832,480,640,16,272,288,117,169,True,37
i,41,kaist_dataset/Mixed/Digital_Camera/(C.S)C-outdoor5/DSC04069.JPG,char_data/i/DSC04069.JPG_4.jpg,287,480,640,7,293,300,418,459,True,37
i,43,kaist_dataset/Mixed/Digital_Camera/(C.S)C-outdoor5/DSC04069.JPG,char_data/i/DSC04069.JPG_5.jpg,559,480,640,13,514,527,371,414,True,37
i,37,kaist_dataset/Mixed/Digital_Camera/(C.S)C-outdoor5/DSC04070.JPG,char_data/i/DSC04070.JPG_2.jpg,185,480,640,5,180,185,107,144,True,37
i,47,kaist_dataset/Mixed/Digital_Camera/(C.S)C-outdoor5/DSC04076.JPG,char_data/i/DSC04076.JPG_4.jpg,987,480,640,21,175,196,101,148,True,37
i,44,kaist_dataset/Mixed/Digital_Camera/(C.S)C-outdoor5/DSC04076.JPG,char_data/i/DSC04076.JPG_5.jpg,1100,480,640,25,222,247,101,145,True,37
i,34,kaist_dataset/Mixed/Digital_Camera/(C.S)C-outdoor5/DSC04091.JPG,char_data/i/DSC04091.JPG_2.jpg,238,480,640,7,280,287,426,460,True,37
i,63,kaist_dataset/Mixed/Digital_Camera/(C.S)C-outdoor5/DSC04097.JPG,char_data/i/DSC04097.JPG_2.jpg,1071,480,640,17,244,261,174,237,True,37
i,85,kaist_dataset/Mixed/Digital_Camera/(C.S)C-outdoor5/DSC04115.JPG,char_data/i/DSC04115.JPG_2.jpg,1870,480,640,22,243,265,193,278,True,37
i,33,kaist_dataset/Mixed/Digital_Camera/(C.S)C-outdoor5/DSC04125.JPG,char_data/i/DSC04125.JPG_2.jpg,264,480,640,8,170,178,425,458,True,37
i,42,kaist_dataset/Mixed/Digital_Camera/(C.S)C-outdoor5/DSC04154.JPG,char_data/i/DSC04154.JPG_2.jpg,546,480,640,13,541,554,237,279,True,37
i,33,kaist_dataset/Mixed/Digital_Camera/(C.S)C-outdoor5/DSC04312.JPG,char_data/i/DSC04312.JPG_4.jpg,297,480,640,9,420,429,145,178,True,37
i,34,kaist_dataset/Mixed/Digital_Camera/(C.S)C-outdoor5/DSC04312.JPG,char_data/i/DSC04312.JPG_5.jpg,272,480,640,8,443,451,142,176,True,37
i,43,kaist_dataset/Mixed/Digital_Camera/(C.S)C-outdoor5/DSC04321.JPG,char_data/i/DSC04321.JPG_6.jpg,430,480,640,10,540,550,202,245,True,37
i,43,kaist_dataset/Mixed/Digital_Camera/(C.S)C-outdoor5/DSC04321.JPG,char_data/i/DSC04321.JPG_7.jpg,430,480,640,10,302,312,195,238,True,37
i,39,kaist_dataset/Mixed/Digital_Camera/(C.S)C-outdoor5/DSC04321.JPG,char_data/i/DSC04321.JPG_8.jpg,390,480,640,10,451,461,200,239,True,37
i,40,kaist_dataset/Mixed/Digital_Camera/(C.S)C-outdoor5/DSC04323.JPG,char_data/i/DSC04323.JPG_6.jpg,480,480,640,12,377,389,201,241,True,37
i,45,kaist_dataset/Mixed/Digital_Camera/(C.S)C-outdoor5/DSC04323.JPG,char_data/i/DSC04323.JPG_8.jpg,450,480,640,10,544,554,200,245,True,37
i,39,kaist_dataset/Mixed/Digital_Camera/(C.S)C-outdoor5/DSC04338.JPG,char_data/i/DSC04338.JPG_8.jpg,312,480,640,8,581,589,194,233,True,37
i,98,kaist_dataset/Mixed/Digital_Camera/(C.S)C-outdoor5/DSC04349.JPG,char_data/i/DSC04349.JPG_4.jpg,3724,480,640,38,183,221,82,180,True,37
i,92,kaist_dataset/Mixed/Digital_Camera/(C.S)C-outdoor5/DSC04349.JPG,char_data/i/DSC04349.JPG_5.jpg,1196,480,640,13,429,442,280,372,True,37
i,25,kaist_dataset/Mixed/Digital_Camera/(C.S)C-outdoor5/DSC04357.JPG,char_data/i/DSC04357.JPG_8.jpg,200,480,640,8,362,370,380,405,True,37
i,25,kaist_dataset/Mixed/Digital_Camera/(C.S)C-outdoor5/DSC04357.JPG,char_data/i/DSC04357.JPG_9.jpg,125,480,640,5,219,224,353,378,True,37
i,28,kaist_dataset/Mixed/Digital_Camera/(C.S)C-outdoor5/DSC04357.JPG,char_data/i/DSC04357.JPG_10.jpg,308,480,640,11,307,318,350,378,True,37
i,27,kaist_dataset/Mixed/Digital_Camera/(C.S)C-outdoor5/DSC04357.JPG,char_data/i/DSC04357.JPG_11.jpg,216,480,640,8,380,388,352,379,True,37
i,116,kaist_dataset/Mixed/Digital_Camera/(C.S)C-outdoor5/DSC04395.JPG,char_data/i/DSC04395.JPG_2.jpg,4872,480,640,42,296,338,139,255,True,37
i,40,kaist_dataset/Mixed/Digital_Camera/(C.S)C-outdoor5/DSC04429.JPG,char_data/i/DSC04429.JPG_2.jpg,440,480,640,11,318,329,248,288,True,37
i,156,kaist_dataset/Mixed/Digital_Camera/(C.S)C-outdoor5/DSC04465.JPG,char_data/i/DSC04465.JPG_2.jpg,8580,480,640,55,66,121,261,417,True,37
i,207,kaist_dataset/Mixed/Digital_Camera/(C.S)C-outdoor6/080116-0057.jpg,char_data/i/080116-0057.jpg_2.jpg,10971,1200,1600,53,1102,1155,295,502,True,37
i,69,kaist_dataset/Mixed/Digital_Camera/(C.S)C-outdoor6/117.JPG,char_data/i/117.JPG_2.jpg,2622,480,640,38,428,466,178,247,False,37
i,52,kaist_dataset/Mixed/Digital_Camera/(C.S)C-outdoor6/P1010052.JPG,char_data/i/P1010052.JPG_2.jpg,1196,480,640,23,513,536,131,183,False,37
i,43,kaist_dataset/Mixed/Digital_Camera/(C.S)C-outdoor6/P1010085.JPG,char_data/i/P1010085.JPG_2.jpg,301,480,640,7,100,107,127,170,False,37
i,81,kaist_dataset/Mixed/Digital_Camera/(C.S)C-outdoor6/P1010116.JPG,char_data/i/P1010116.JPG_2.jpg,1296,480,640,16,321,337,182,263,False,37
i,34,kaist_dataset/Mixed/Digital_Camera/(C.S)C-outdoor6/크기변환_P1010029.JPG,char_data/i/크기변환_P1010029.JPG_2.jpg,238,480,640,7,310,317,13,47,False,37
i,51,kaist_dataset/Mixed/Digital_Camera/(C.S)D-indoor1/082.JPG,char_data/i/082.JPG_2.jpg,816,480,640,16,353,369,170,221,False,37
i,74,kaist_dataset/Mixed/Digital_Camera/(C.S)D-indoor1/DSC02770.JPG,char_data/i/DSC02770.JPG_2.jpg,1406,480,640,19,259,278,342,416,False,37
i,44,kaist_dataset/Mixed/Digital_Camera/(C.S)D-indoor1/DSC02787.JPG,char_data/i/DSC02787.JPG_4.jpg,352,480,640,8,306,314,367,411,False,37
i,42,kaist_dataset/Mixed/Digital_Camera/(C.S)D-indoor1/DSC02787.JPG,char_data/i/DSC02787.JPG_5.jpg,252,480,640,6,363,369,363,405,False,37
i,41,kaist_dataset/Mixed/Digital_Camera/(C.S)D-indoor1/DSC02804.JPG,char_data/i/DSC02804.JPG_2.jpg,533,480,640,13,433,446,346,387,False,37
i,43,kaist_dataset/Mixed/Digital_Camera/(C.S)D-indoor1/DSC03073.JPG,char_data/i/DSC03073.JPG_2.jpg,559,480,640,13,234,247,284,327,False,37
i,32,kaist_dataset/Mixed/Digital_Camera/(C.S)D-indoor1/DSC03096.JPG,char_data/i/DSC03096.JPG_10.jpg,256,480,640,8,176,184,423,455,False,37
i,32,kaist_dataset/Mixed/Digital_Camera/(C.S)D-indoor1/DSC03096.JPG,char_data/i/DSC03096.JPG_11.jpg,320,480,640,10,308,318,423,455,False,37
i,37,kaist_dataset/Mixed/Digital_Camera/(C.S)D-indoor1/DSC03096.JPG,char_data/i/DSC03096.JPG_12.jpg,333,480,640,9,357,366,419,456,False,37
i,35,kaist_dataset/Mixed/Digital_Camera/(C.S)D-indoor1/DSC03096.JPG,char_data/i/DSC03096.JPG_14.jpg,350,480,640,10,567,577,422,457,False,37
i,43,kaist_dataset/Mixed/Digital_Camera/(C.S)D-indoor1/DSC03118.JPG,char_data/i/DSC03118.JPG_6.jpg,344,480,640,8,384,392,151,194,False,37
i,53,kaist_dataset/Mixed/Digital_Camera/(C.S)D-indoor1/DSC03118.JPG,char_data/i/DSC03118.JPG_7.jpg,424,480,640,8,408,416,146,199,False,37
i,55,kaist_dataset/Mixed/Digital_Camera/(C.S)D-indoor1/DSC03118.JPG,char_data/i/DSC03118.JPG_8.jpg,495,480,640,9,321,330,219,274,False,37
i,42,kaist_dataset/Mixed/Digital_Camera/(C.S)D-indoor1/DSC03122.JPG,char_data/i/DSC03122.JPG_4.jpg,504,480,640,12,256,268,199,241,False,37
i,33,kaist_dataset/Mixed/Digital_Camera/(C.S)D-indoor1/DSC03122.JPG,char_data/i/DSC03122.JPG_5.jpg,429,480,640,13,379,392,200,233,False,37
i,44,kaist_dataset/Mixed/Digital_Camera/(C.S)D-indoor1/DSC03124.JPG,char_data/i/DSC03124.JPG_2.jpg,748,480,640,17,459,476,189,233,False,37
i,46,kaist_dataset/Mixed/Digital_Camera/(C.S)D-indoor1/DSC03126.JPG,char_data/i/DSC03126.JPG_2.jpg,598,480,640,13,296,309,220,266,False,37
i,44,kaist_dataset/Mixed/Digital_Camera/(C.S)D-indoor1/DSC03129.JPG,char_data/i/DSC03129.JPG_2.jpg,396,480,640,9,389,398,200,244,False,37
i,41,kaist_dataset/Mixed/Digital_Camera/(C.S)D-indoor1/DSC03132.JPG,char_data/i/DSC03132.JPG_2.jpg,451,480,640,11,337,348,175,216,False,37
i,52,kaist_dataset/Mixed/Digital_Camera/(C.S)D-indoor1/DSC03133.JPG,char_data/i/DSC03133.JPG_4.jpg,468,480,640,9,422,431,143,195,False,37
i,49,kaist_dataset/Mixed/Digital_Camera/(C.S)D-indoor1/DSC03133.JPG,char_data/i/DSC03133.JPG_5.jpg,784,480,640,16,476,492,147,196,False,37
i,67,kaist_dataset/Mixed/Digital_Camera/(C.S)D-indoor1/DSC03455.JPG,char_data/i/DSC03455.JPG_2.jpg,1072,480,640,16,270,286,387,454,False,37
i,66,kaist_dataset/Mixed/Digital_Camera/(C.S)D-indoor1/DSC03460.JPG,char_data/i/DSC03460.JPG_2.jpg,1122,480,640,17,288,305,381,447,False,37
i,98,kaist_dataset/Mixed/Digital_Camera/(C.S)D-indoor1/DSC03909.JPG,char_data/i/DSC03909.JPG_4.jpg,2548,480,640,26,455,481,82,180,False,37
i,102,kaist_dataset/Mixed/Digital_Camera/(C.S)D-indoor1/DSC03909.JPG,char_data/i/DSC03909.JPG_5.jpg,2244,480,640,22,515,537,176,278,False,37
i,52,kaist_dataset/Mixed/Digital_Camera/(C.S)D-indoor1/DSC03912.JPG,char_data/i/DSC03912.JPG_2.jpg,988,480,640,19,367,386,38,90,False,37
i,71,kaist_dataset/Mixed/Digital_Camera/(C.S)D-indoor1/DSC03913.JPG,char_data/i/DSC03913.JPG_2.jpg,1420,480,640,20,281,301,93,164,False,37
i,46,kaist_dataset/Mixed/Digital_Camera/(C.S)D-indoor1/DSC04183.JPG,char_data/i/DSC04183.JPG_4.jpg,598,480,640,13,167,180,245,291,False,37
i,48,kaist_dataset/Mixed/Digital_Camera/(C.S)D-indoor1/DSC04183.JPG,char_data/i/DSC04183.JPG_5.jpg,624,480,640,13,365,378,246,294,False,37
i,47,kaist_dataset/Mixed/Digital_Camera/(C.S)D-indoor1/DSC04206.JPG,char_data/i/DSC04206.JPG_2.jpg,611,480,640,13,395,408,285,332,False,37
i,45,kaist_dataset/Mixed/Digital_Camera/(C.S)D-indoor1/DSC04246.JPG,char_data/i/DSC04246.JPG_2.jpg,450,480,640,10,447,457,241,286,False,37
i,50,kaist_dataset/Mixed/Digital_Camera/(C.S)D-indoor2/DSC04249.JPG,char_data/i/DSC04249.JPG_2.jpg,650,480,640,13,255,268,208,258,False,37
i,35,kaist_dataset/Mixed/Digital_Camera/(C.S)D-indoor2/DSC04254.JPG,char_data/i/DSC04254.JPG_2.jpg,350,480,640,10,429,439,338,373,False,37
i,30,kaist_dataset/Mixed/Digital_Camera/(C.S)E-night/DSC02569.JPG,char_data/i/DSC02569.JPG_2.jpg,420,480,640,14,443,457,269,299,False,37
i,150,kaist_dataset/Mixed/Digital_Camera/(C.S)E-night/DSC02585.JPG,char_data/i/DSC02585.JPG_2.jpg,9450,480,640,63,268,331,227,377,False,37
i,52,kaist_dataset/Mixed/Digital_Camera/(C.S)E-night/DSC02623.JPG,char_data/i/DSC02623.JPG_2.jpg,624,480,640,12,298,310,384,436,False,37
i,35,kaist_dataset/Mixed/Digital_Camera/(C.S)E-night/DSC03031.JPG,char_data/i/DSC03031.JPG_2.jpg,350,480,640,10,211,221,22,57,False,37
i,33,kaist_dataset/Mixed/Digital_Camera/(C.S)E-night/DSC03516.JPG,char_data/i/DSC03516.JPG_5.jpg,528,480,640,16,92,108,112,145,False,37
i,70,kaist_dataset/Mixed/Digital_Camera/(C.S)E-night/DSC03840.JPG,char_data/i/DSC03840.JPG_2.jpg,2520,480,640,36,178,214,100,170,False,37
i,23,kaist_dataset/Mixed/Digital_Camera/(C.S)E-night/P1010151.JPG,char_data/i/P1010151.JPG_2.jpg,207,480,640,9,485,494,202,225,False,37
i,32,kaist_dataset/Mixed/Digital_Camera/(C.S)F-others/2007-12-09-day-exterior-032.jpg,char_data/i/2007-12-09-day-exterior-032.jpg_2.jpg,544,1600,1200,17,588,605,281,313,False,37
i,108,kaist_dataset/Mixed/Digital_Camera/(C.S)F-others/DSC03489.JPG,char_data/i/DSC03489.JPG_2.jpg,2808,480,640,26,333,359,315,423,False,37
i,39,kaist_dataset/Mixed/Mobile_Phone/(C.M)A-outdoor/P090912078.jpg,char_data/i/P090912078.jpg_4.jpg,468,480,640,12,410,422,292,331,False,37
i,34,kaist_dataset/Mixed/Mobile_Phone/(C.M)A-outdoor/P090912078.jpg,char_data/i/P090912078.jpg_5.jpg,374,480,640,11,538,549,289,323,False,37
i,46,kaist_dataset/Mixed/Mobile_Phone/(C.M)B-indoor/P090831014.jpg,char_data/i/P090831014.jpg_2.jpg,828,480,640,18,326,344,165,211,False,37
i,57,kaist_dataset/Mixed/Mobile_Phone/(C.M)B-indoor/P090831015.jpg,char_data/i/P090831015.jpg_2.jpg,855,480,640,15,386,401,207,264,False,37
i,49,kaist_dataset/Mixed/Mobile_Phone/(C.M)B-indoor/P090831017.jpg,char_data/i/P090831017.jpg_2.jpg,931,480,640,19,306,325,241,290,False,37
i,65,kaist_dataset/Mixed/Mobile_Phone/(C.M)B-indoor/P090831023.jpg,char_data/i/P090831023.jpg_4.jpg,1430,480,640,22,129,151,264,329,False,37
i,68,kaist_dataset/Mixed/Mobile_Phone/(C.M)B-indoor/P090831023.jpg,char_data/i/P090831023.jpg_5.jpg,1428,480,640,21,241,262,262,330,False,37
i,68,kaist_dataset/Mixed/Mobile_Phone/(C.M)C-bookCover/P090831062.jpg,char_data/i/P090831062.jpg_2.jpg,1904,480,640,28,474,502,270,338,False,37
i,50,kaist_dataset/Mixed/Mobile_Phone/(C.M)C-bookCover/P090831080.jpg,char_data/i/P090831080.jpg_2.jpg,700,480,640,14,287,301,401,451,False,37
i,66,kaist_dataset/Mixed/Mobile_Phone/(C.M)C-bookCover/P090831113.jpg,char_data/i/P090831113.jpg_2.jpg,1650,480,640,25,370,395,228,294,False,37
i,49,kaist_dataset/Mixed/Mobile_Phone/(C.M)C-bookCover/P090831115.jpg,char_data/i/P090831115.jpg_2.jpg,637,480,640,13,380,393,161,210,False,37
i,52,kaist_dataset/Mixed/Mobile_Phone/(C.M)C-bookCover/P090831118.jpg,char_data/i/P090831118.jpg_4.jpg,1040,480,640,20,267,287,211,263,False,37
i,49,kaist_dataset/Mixed/Mobile_Phone/(C.M)C-bookCover/P090831118.jpg,char_data/i/P090831118.jpg_5.jpg,980,480,640,20,393,413,213,262,False,37
i,50,kaist_dataset/Mixed/Mobile_Phone/(C.M)C-bookCover/P090831119.jpg,char_data/i/P090831119.jpg_2.jpg,1000,480,640,20,352,372,220,270,False,37
i,70,kaist_dataset/Mixed/Mobile_Phone/(C.M)C-bookCover/P090831122.jpg,char_data/i/P090831122.jpg_2.jpg,1470,480,640,21,315,336,252,322,False,37
i,35,kaist_dataset/Mixed/Mobile_Phone/(C.M)C-bookCover/P090902016.jpg,char_data/i/P090902016.jpg_2.jpg,385,480,640,11,124,135,270,305,False,37
i,55,kaist_dataset/Mixed/Mobile_Phone/(C.M)C-bookCover/P090902019.jpg,char_data/i/P090902019.jpg_2.jpg,1210,480,640,22,296,318,292,347,False,37
i,40,kaist_dataset/Mixed/Mobile_Phone/(C.M)C-bookCover/P090903024.jpg,char_data/i/P090903024.jpg_4.jpg,640,480,640,16,348,364,110,150,False,37
i,30,kaist_dataset/Mixed/Mobile_Phone/(C.M)C-bookCover/P090903024.jpg,char_data/i/P090903024.jpg_5.jpg,540,480,640,18,332,350,231,261,False,37
i,39,kaist_dataset/Mixed/Mobile_Phone/(C.M)C-bookCover/P090904005.jpg,char_data/i/P090904005.jpg_2.jpg,468,480,640,12,446,458,118,157,False,37
이,36,kaist_dataset/English/Digital_Camera/(E.S)B-light/080116-0059.jpg,char_data/이/080116-0059.jpg_4.jpg,756,1200,1600,21,848,869,902,938,True,75
이,34,kaist_dataset/English/Digital_Camera/(E.S)B-light/080116-0059.jpg,char_data/이/080116-0059.jpg_5.jpg,748,1200,1600,22,443,465,1042,1076,True,75
이,38,kaist_dataset/English/Digital_Camera/(E.S)C-outdoor1/080119-0020.jpg,char_data/이/080119-0020.jpg_2.jpg,1026,1200,1600,27,989,1016,644,682,True,75
이,83,kaist_dataset/Korean/Digital_Camera/A-shadow/DSC02599.JPG,char_data/이/DSC02599.JPG_2.jpg,6474,480,640,78,183,261,63,146,True,75
이,97,kaist_dataset/Korean/Digital_Camera/A-shadow/DSC02605.JPG,char_data/이/DSC02605.JPG_2.jpg,9312,480,640,96,174,270,212,309,True,75
이,63,kaist_dataset/Korean/Digital_Camera/A-shadow/DSC03463.JPG,char_data/이/DSC03463.JPG_2.jpg,4221,480,640,67,77,144,356,419,True,75
이,51,kaist_dataset/Korean/Digital_Camera/A-shadow/DSC03465.JPG,char_data/이/DSC03465.JPG_2.jpg,3876,480,640,76,261,337,256,307,True,75
이,56,kaist_dataset/Korean/Digital_Camera/A-shadow/DSC03535.JPG,char_data/이/DSC03535.JPG_2.jpg,2688,480,640,48,192,240,267,323,True,75
이,71,kaist_dataset/Korean/Digital_Camera/A-shadow/P090911038.jpg,char_data/이/P090911038.jpg_4.jpg,4828,480,640,68,94,162,143,214,True,75
이,63,kaist_dataset/Korean/Digital_Camera/A-shadow/P090911038.jpg,char_data/이/P090911038.jpg_5.jpg,3591,480,640,57,463,520,203,266,True,75
이,62,kaist_dataset/Korean/Digital_Camera/A-shadow/P1010064.JPG,char_data/이/P1010064.JPG_4.jpg,3286,480,640,53,407,460,207,269,True,75
이,38,kaist_dataset/Korean/Digital_Camera/A-shadow/P1010064.JPG,char_data/이/P1010064.JPG_5.jpg,1178,480,640,31,58,89,414,452,True,75
이,98,kaist_dataset/Korean/Digital_Camera/E-night/DSC02596.JPG,char_data/이/DSC02596.JPG_2.jpg,7938,480,640,81,278,359,154,252,True,75
이,55,kaist_dataset/Korean/Digital_Camera/E-night/DSC02597.JPG,char_data/이/DSC02597.JPG_2.jpg,2640,480,640,48,239,287,18,73,True,75
이,30,kaist_dataset/Korean/Digital_Camera/E-night/DSC02626.JPG,char_data/이/DSC02626.JPG_2.jpg,930,480,640,31,482,513,139,169,True,75
이,70,kaist_dataset/Korean/Digital_Camera/E-night/DSC02654.JPG,char_data/이/DSC02654.JPG_4.jpg,5250,480,640,75,163,238,312,382,True,75
이,99,kaist_dataset/Korean/Digital_Camera/E-night/DSC02654.JPG,char_data/이/DSC02654.JPG_5.jpg,11385,480,640,115,513,628,285,384,True,75
이,58,kaist_dataset/Korean/Digital_Camera/E-night/DSC03870.JPG,char_data/이/DSC03870.JPG_2.jpg,4350,480,640,75,338,413,146,204,True,75
이,53,kaist_dataset/Korean/Digital_Camera/E-night/P1010146.JPG,char_data/이/P1010146.JPG_2.jpg,2862,480,640,54,375,429,179,232,True,75
이,57,kaist_dataset/Korean/Digital_Camera/F-bookCover/DSC02806.JPG,char_data/이/DSC02806.JPG_2.jpg,2964,480,640,52,285,337,193,250,True,75
이,53,kaist_dataset/Korean/Digital_Camera/F-bookCover/DSC03933.JPG,char_data/이/DSC03933.JPG_2.jpg,1961,480,640,37,309,346,279,332,True,75
이,71,kaist_dataset/Korean/Digital_Camera/F-bookCover/DSC04219.JPG,char_data/이/DSC04219.JPG_2.jpg,4331,480,640,61,373,434,175,246,True,75
이,118,kaist_dataset/Korean/Digital_Camera/F-bookCover/DSC04229.JPG,char_data/이/DSC04229.JPG_2.jpg,11328,480,640,96,51,147,323,441,True,75
이,73,kaist_dataset/Korean/Digital_Camera/F-bookCover/DSC04241.JPG,char_data/이/DSC04241.JPG_2.jpg,4964,480,640,68,341,409,259,332,True,75
이,120,kaist_dataset/Korean/Digital_Camera/F-bookCover/P090911046.jpg,char_data/이/P090911046.jpg_2.jpg,10560,480,640,88,326,414,246,366,True,75
이,75,kaist_dataset/Korean/Digital_Camera/G-others/5.jpg,char_data/이/5.jpg_2.jpg,3075,553,798,41,437,478,262,337,True,75
이,44,kaist_dataset/Korean/Digital_Camera/G-others/DSC03065.JPG,char_data/이/DSC03065.JPG_2.jpg,3036,480,640,69,252,321,141,185,True,75
이,55,kaist_dataset/Korean/Digital_Camera/indoor1/080118-0017.jpg,char_data/이/080118-0017.jpg_2.jpg,2310,1200,1600,42,1078,1120,481,536,True,75
이,71,kaist_dataset/Korean/Digital_Camera/indoor1/080119-0018.jpg,char_data/이/080119-0018.jpg_2.jpg,4757,1200,1600,67,1013,1080,606,677,True,75
이,102,kaist_dataset/Korean/Digital_Camera/indoor1/080119-0029.jpg,char_data/이/080119-0029.jpg_2.jpg,6426,1200,1600,63,587,650,964,1066,True,75
이,55,kaist_dataset/Korean/Digital_Camera/indoor1/140.JPG,char_data/이/140.JPG_2.jpg,2145,480,640,39,350,389,258,313,True,75
이,39,kaist_dataset/Korean/Digital_Camera/indoor1/DSC02704.JPG,char_data/이/DSC02704.JPG_4.jpg,1287,480,640,33,323,356,326,365,True,75
이,45,kaist_dataset/Korean/Digital_Camera/indoor1/DSC02704.JPG,char_data/이/DSC02704.JPG_5.jpg,1440,480,640,32,509,541,325,370,True,75
이,96,kaist_dataset/Korean/Digital_Camera/indoor1/DSC02720.JPG,char_data/이/DSC02720.JPG_4.jpg,9504,480,640,99,331,430,292,388,True,75
이,40,kaist_dataset/Korean/Digital_Camera/indoor1/DSC02720.JPG,char_data/이/DSC02720.JPG_5.jpg,1440,480,640,36,378,414,206,246,True,75
이,116,kaist_dataset/Korean/Digital_Camera/indoor1/DSC02721.JPG,char_data/이/DSC02721.JPG_2.jpg,9512,480,640,82,260,342,140,256,True,75
이,39,kaist_dataset/Korean/Digital_Camera/indoor1/DSC02741.JPG,char_data/이/DSC02741.JPG_4.jpg,1443,480,640,37,288,325,199,238,True,75
이,39,kaist_dataset/Korean/Digital_Camera/indoor1/DSC02741.JPG,char_data/이/DSC02741.JPG_5.jpg,1287,480,640,33,462,495,198,237,True,75
이,33,kaist_dataset/Korean/Digital_Camera/indoor1/DSC02742.JPG,char_data/이/DSC02742.JPG_2.jpg,957,480,640,29,333,362,199,232,True,75
이,31,kaist_dataset/Korean/Digital_Camera/indoor1/DSC02759.JPG,char_data/이/DSC02759.JPG_2.jpg,868,480,640,28,464,492,125,156,True,75
이,155,kaist_dataset/Korean/Digital_Camera/indoor1/DSC02768.JPG,char_data/이/DSC02768.JPG_2.jpg,15345,480,640,99,106,205,153,308,True,75
이,55,kaist_dataset/Korean/Digital_Camera/indoor1/DSC03116.JPG,char_data/이/DSC03116.JPG_2.jpg,2585,480,640,47,360,407,182,237,True,75
이,134,kaist_dataset/Korean/Digital_Camera/indoor1/DSC03343.JPG,char_data/이/DSC03343.JPG_2.jpg,13132,480,640,98,289,387,187,321,True,75
이,84,kaist_dataset/Korean/Digital_Camera/indoor1/DSC03363.JPG,char_data/이/DSC03363.JPG_2.jpg,7140,480,640,85,315,400,68,152,True,75
이,47,kaist_dataset/Korean/Digital_Camera/indoor1/DSC03364.JPG,char_data/이/DSC03364.JPG_4.jpg,1316,480,640,28,174,202,161,208,True,75
이,41,kaist_dataset/Korean/Digital_Camera/indoor1/DSC03364.JPG,char_data/이/DSC03364.JPG_5.jpg,902,480,640,22,393,415,177,218,True,75
이,109,kaist_dataset/Korean/Digital_Camera/indoor2/DSC03386.JPG,char_data/이/DSC03386.JPG_2.jpg,11009,480,640,101,257,358,229,338,True,75
이,79,kaist_dataset/Korean/Digital_Camera/indoor2/DSC03390.JPG,char_data/이/DSC03390.JPG_2.jpg,5530,480,640,70,240,310,303,382,True,75
이,222,kaist_dataset/Korean/Digital_Camera/indoor2/DSC03470.JPG,char_data/이/DSC03470.JPG_4.jpg,42846,480,640,193,3,196,245,467,True,75
이,98,kaist_dataset/Korean/Digital_Camera/indoor2/DSC03470.JPG,char_data/이/DSC03470.JPG_5.jpg,5488,480,640,56,155,211,135,233,True,75
이,48,kaist_dataset/Korean/Digital_Camera/indoor2/DSC03474.JPG,char_data/이/DSC03474.JPG_2.jpg,2496,480,640,52,187,239,215,263,True,75
이,37,kaist_dataset/Korean/Digital_Camera/indoor2/DSC04001.JPG,char_data/이/DSC04001.JPG_2.jpg,740,480,640,20,177,197,124,161,True,75
이,51,kaist_dataset/Korean/Digital_Camera/indoor2/DSC04004.JPG,char_data/이/DSC04004.JPG_2.jpg,1989,480,640,39,399,438,156,207,True,75
이,74,kaist_dataset/Korean/Digital_Camera/outdoor1/011.JPG,char_data/이/011.JPG_2.jpg,5624,480,640,76,533,609,180,254,True,75
이,60,kaist_dataset/Korean/Digital_Camera/outdoor1/015.JPG,char_data/이/015.JPG_2.jpg,4860,480,640,81,496,577,196,256,True,75
이,88,kaist_dataset/Korean/Digital_Camera/outdoor1/029.JPG,char_data/이/029.JPG_2.jpg,5544,480,640,63,267,330,201,289,True,75
이,80,kaist_dataset/Korean/Digital_Camera/outdoor1/040.JPG,char_data/이/040.JPG_2.jpg,4080,480,640,51,300,351,214,294,True,75
이,138,kaist_dataset/Korean/Digital_Camera/outdoor1/059.JPG,char_data/이/059.JPG_2.jpg,10350,480,640,75,372,447,176,314,True,75
이,90,kaist_dataset/Korean/Digital_Camera/outdoor1/066.jpg,char_data/이/066.jpg_2.jpg,6390,270,468,71,315,386,55,145,True,75
이,90,kaist_dataset/Korean/Digital_Camera/outdoor1/069.JPG,char_data/이/069.JPG_2.jpg,8100,480,640,90,276,366,171,261,True,75
이,34,kaist_dataset/Korean/Digital_Camera/outdoor1/071.JPG,char_data/이/071.JPG_2.jpg,1394,480,640,41,216,257,108,142,True,75
이,125,kaist_dataset/Korean/Digital_Camera/outdoor1/092.JPG,char_data/이/092.JPG_2.jpg,20375,480,640,163,127,290,148,273,True,75
이,15,kaist_dataset/Korean/Digital_Camera/outdoor1/096.JPG,char_data/이/096.JPG_2.jpg,315,480,640,21,85,106,282,297,True,75
이,22,kaist_dataset/Korean/Digital_Camera/outdoor1/109.JPG,char_data/이/109.JPG_2.jpg,352,480,640,16,400,416,33,55,True,75
이,35,kaist_dataset/Korean/Digital_Camera/outdoor1/128.JPG,char_data/이/128.JPG_2.jpg,665,480,640,19,326,345,116,151,True,75
이,140,kaist_dataset/Korean/Digital_Camera/outdoor1/2007-12-08-day-050.jpg,char_data/이/2007-12-08-day-050.jpg_4.jpg,12180,1200,1600,87,936,1023,304,444,True,75
이,219,kaist_dataset/Korean/Digital_Camera/outdoor1/2007-12-08-day-050.jpg,char_data/이/2007-12-08-day-050.jpg_5.jpg,41172,1200,1600,188,1033,1221,485,704,True,75
이,119,kaist_dataset/Korean/Digital_Camera/outdoor1/2007-12-08-day-057.jpg,char_data/이/2007-12-08-day-057.jpg_2.jpg,11305,1200,1600,95,261,356,336,455,True,75
이,36,kaist_dataset/Korean/Digital_Camera/outdoor1/2007-12-08-day-087.jpg,char_data/이/2007-12-08-day-087.jpg_2.jpg,1116,1200,1600,31,39,70,469,505,True,75
이,92,kaist_dataset/Korean/Digital_Camera/outdoor1/53.JPG,char_data/이/53.JPG_4.jpg,6900,401,766,75,89,164,55,147,True,75
이,44,kaist_dataset/Korean/Digital_Camera/outdoor1/53.JPG,char_data/이/53.JPG_5.jpg,1012,401,766,23,657,680,233,277,True,75
이,263,kaist_dataset/Korean/Digital_Camera/outdoor2/2007-12-08-day-114.jpg,char_data/이/2007-12-08-day-114.jpg_2.jpg,64698,1200,1600,246,1014,1260,421,684,True,75
이,160,kaist_dataset/Korean/Digital_Camera/outdoor2/2007-12-09-day-exterior-009.jpg,char_data/이/2007-12-09-day-exterior-009.jpg_4.jpg,28160,1200,1600,176,638,814,1058,1199,True,75
이,186,kaist_dataset/Korean/Digital_Camera/outdoor2/2007-12-09-day-exterior-009.jpg,char_data/이/2007-12-09-day-exterior-009.jpg_5.jpg,26226,1200,1600,141,689,830,484,670,True,75
이,78,kaist_dataset/Korean/Digital_Camera/outdoor2/2007-12-09-day-exterior-012.jpg,char_data/이/2007-12-09-day-exterior-012.jpg_4.jpg,4368,1200,1600,56,609,665,626,704,True,75
이,48,kaist_dataset/Korean/Digital_Camera/outdoor2/2007-12-09-day-exterior-012.jpg,char_data/이/2007-12-09-day-exterior-012.jpg_5.jpg,2640,1200,1600,55,882,937,1118,1166,True,75
이,72,kaist_dataset/Korean/Digital_Camera/outdoor2/2007-12-09-day-exterior-016.jpg,char_data/이/2007-12-09-day-exterior-016.jpg_2.jpg,5688,1200,1600,79,491,570,417,489,True,75
이,229,kaist_dataset/Korean/Digital_Camera/outdoor2/2007-12-09-day-exterior-033.jpg,char_data/이/2007-12-09-day-exterior-033.jpg_2.jpg,58624,1200,1600,256,1242,1498,484,713,True,75
이,140,kaist_dataset/Korean/Digital_Camera/outdoor2/2007-12-09-day-exterior-068.jpg,char_data/이/2007-12-09-day-exterior-068.jpg_2.jpg,18480,1200,1600,132,630,762,535,675,True,75
이,110,kaist_dataset/Korean/Digital_Camera/outdoor2/DSC02307.JPG,char_data/이/DSC02307.JPG_2.jpg,13200,480,640,120,484,604,199,309,True,75
이,116,kaist_dataset/Korean/Digital_Camera/outdoor2/DSC02311.JPG,char_data/이/DSC02311.JPG_2.jpg,19024,480,640,164,233,397,85,201,True,75
이,31,kaist_dataset/Korean/Digital_Camera/outdoor2/DSC02373.JPG,char_data/이/DSC02373.JPG_2.jpg,713,480,640,23,113,136,328,359,True,75
이,27,kaist_dataset/Korean/Digital_Camera/outdoor2/DSC02386.JPG,char_data/이/DSC02386.JPG_2.jpg,432,480,640,16,66,82,133,160,True,75
이,117,kaist_dataset/Korean/Digital_Camera/outdoor2/DSC02388.JPG,char_data/이/DSC02388.JPG_2.jpg,15093,480,640,129,184,313,103,220,True,75
이,77,kaist_dataset/Korean/Digital_Camera/outdoor2/DSC02390.JPG,char_data/이/DSC02390.JPG_2.jpg,7700,480,640,100,341,441,186,263,True,75
이,38,kaist_dataset/Korean/Digital_Camera/outdoor2/DSC02396.JPG,char_data/이/DSC02396.JPG_2.jpg,1292,480,640,34,263,297,173,211,True,75
이,92,kaist_dataset/Korean/Digital_Camera/outdoor2/DSC02435.JPG,char_data/이/DSC02435.JPG_2.jpg,9384,480,640,102,510,612,139,231,True,75
이,47,kaist_dataset/Korean/Digital_Camera/outdoor2/DSC02481.JPG,char_data/이/DSC02481.JPG_2.jpg,2491,480,640,53,47,100,141,188,True,75
이,119,kaist_dataset/Korean/Digital_Camera/outdoor2/DSC02512.JPG,char_data/이/DSC02512.JPG_2.jpg,9401,480,640,79,100,179,45,164,True,75
이,50,kaist_dataset/Korean/Digital_Camera/outdoor3/DSC02529.JPG,char_data/이/DSC02529.JPG_2.jpg,2500,480,640,50,76,126,284,334,True,75
이,65,kaist_dataset/Korean/Digital_Camera/outdoor3/DSC02530.JPG,char_data/이/DSC02530.JPG_2.jpg,5460,480,640,84,199,283,162,227,True,75
이,23,kaist_dataset/Korean/Digital_Camera/outdoor3/DSC02562.JPG,char_data/이/DSC02562.JPG_2.jpg,759,480,640,33,399,432,158,181,True,75
이,101,kaist_dataset/Korean/Digital_Camera/outdoor3/DSC02876.JPG,char_data/이/DSC02876.JPG_2.jpg,7777,480,640,77,238,315,35,136,True,75
이,65,kaist_dataset/Korean/Digital_Camera/outdoor3/DSC02913.JPG,char_data/이/DSC02913.JPG_4.jpg,2665,480,640,41,171,212,325,390,True,75
이,90,kaist_dataset/Korean/Digital_Camera/outdoor3/DSC02913.JPG,char_data/이/DSC02913.JPG_5.jpg,7650,480,640,85,437,522,313,403,True,75
이,73,kaist_dataset/Korean/Digital_Camera/outdoor3/DSC02932.JPG,char_data/이/DSC02932.JPG_2.jpg,3942,480,640,54,249,303,132,205,True,75
이,65,kaist_dataset/Korean/Digital_Camera/outdoor3/DSC02934.JPG,char_data/이/DSC02934.JPG_2.jpg,4680,480,640,72,287,359,63,128,True,75
이,43,kaist_dataset/Korean/Digital_Camera/outdoor3/DSC02943.JPG,char_data/이/DSC02943.JPG_4.jpg,2021,480,640,47,99,146,380,423,True,75
이,69,kaist_dataset/Korean/Digital_Camera/outdoor3/DSC02943.JPG,char_data/이/DSC02943.JPG_5.jpg,5175,480,640,75,315,390,363,432,True,75
이,101,kaist_dataset/Korean/Digital_Camera/outdoor3/DSC02951.JPG,char_data/이/DSC02951.JPG_2.jpg,7777,480,640,77,91,168,281,382,True,75
이,99,kaist_dataset/Korean/Digital_Camera/outdoor3/DSC02991.JPG,char_data/이/DSC02991.JPG_2.jpg,10296,480,640,104,300,404,176,275,True,75
이,100,kaist_dataset/Korean/Digital_Camera/outdoor3/DSC02997.JPG,char_data/이/DSC02997.JPG_2.jpg,7300,480,640,73,371,444,150,250,True,75
이,79,kaist_dataset/Korean/Digital_Camera/outdoor3/DSC02999.JPG,char_data/이/DSC02999.JPG_2.jpg,4266,480,640,54,167,221,46,125,True,75
이,59,kaist_dataset/Korean/Digital_Camera/outdoor3/DSC03009.JPG,char_data/이/DSC03009.JPG_2.jpg,2832,480,640,48,426,474,93,152,True,75
이,86,kaist_dataset/Korean/Digital_Camera/outdoor3/DSC03158.JPG,char_data/이/DSC03158.JPG_2.jpg,5246,480,640,61,293,354,93,179,True,75
이,44,kaist_dataset/Korean/Digital_Camera/outdoor3/DSC03213.JPG,char_data/이/DSC03213.JPG_2.jpg,2200,480,640,50,424,474,53,97,True,75
이,44,kaist_dataset/Korean/Digital_Camera/outdoor3/DSC03220.JPG,char_data/이/DSC03220.JPG_2.jpg,2200,480,640,50,229,279,183,227,True,75
이,151,kaist_dataset/Korean/Digital_Camera/outdoor3/DSC03240.JPG,char_data/이/DSC03240.JPG_2.jpg,18724,480,640,124,458,582,99,250,True,75
이,93,kaist_dataset/Korean/Digital_Camera/outdoor4/DSC03287.JPG,char_data/이/DSC03287.JPG_2.jpg,9021,480,640,97,44,141,264,357,True,75
이,98,kaist_dataset/Korean/Digital_Camera/outdoor4/DSC03293.JPG,char_data/이/DSC03293.JPG_2.jpg,7840,480,640,80,82,162,174,272,True,75
이,102,kaist_dataset/Korean/Digital_Camera/outdoor4/DSC03296.JPG,char_data/이/DSC03296.JPG_2.jpg,9384,480,640,92,142,234,214,316,True,75
이,110,kaist_dataset/Korean/Digital_Camera/outdoor4/DSC03313.JPG,char_data/이/DSC03313.JPG_2.jpg,9240,480,640,84,258,342,177,287,True,75
이,49,kaist_dataset/Korean/Digital_Camera/outdoor4/DSC03443.JPG,char_data/이/DSC03443.JPG_4.jpg,1764,480,640,36,251,287,256,305,True,75
이,59,kaist_dataset/Korean/Digital_Camera/outdoor4/DSC03443.JPG,char_data/이/DSC03443.JPG_5.jpg,2655,480,640,45,326,371,404,463,True,75
이,55,kaist_dataset/Korean/Digital_Camera/outdoor4/DSC03540.JPG,char_data/이/DSC03540.JPG_2.jpg,2310,480,640,42,116,158,310,365,True,75
이,60,kaist_dataset/Korean/Digital_Camera/outdoor4/DSC03541.JPG,char_data/이/DSC03541.JPG_2.jpg,2700,480,640,45,115,160,372,432,True,75
이,73,kaist_dataset/Korean/Digital_Camera/outdoor4/DSC03567.JPG,char_data/이/DSC03567.JPG_2.jpg,4015,480,640,55,149,204,81,154,True,75
이,64,kaist_dataset/Korean/Digital_Camera/outdoor4/DSC03580.JPG,char_data/이/DSC03580.JPG_2.jpg,4288,480,640,67,360,427,128,192,True,75
이,77,kaist_dataset/Korean/Digital_Camera/outdoor4/DSC03585.JPG,char_data/이/DSC03585.JPG_2.jpg,5544,480,640,72,267,339,345,422,True,75
이,43,kaist_dataset/Korean/Digital_Camera/outdoor4/DSC03588.JPG,char_data/이/DSC03588.JPG_2.jpg,1720,480,640,40,338,378,7,50,True,75
이,76,kaist_dataset/Korean/Digital_Camera/outdoor4/DSC03606.JPG,char_data/이/DSC03606.JPG_2.jpg,5168,480,640,68,388,456,337,413,True,75
이,72,kaist_dataset/Korean/Digital_Camera/outdoor4/DSC03608.JPG,char_data/이/DSC03608.JPG_2.jpg,5184,480,640,72,362,434,45,117,True,75
이,85,kaist_dataset/Korean/Digital_Camera/outdoor4/DSC03614.JPG,char_data/이/DSC03614.JPG_2.jpg,6970,480,640,82,361,443,174,259,True,75
이,130,kaist_dataset/Korean/Digital_Camera/outdoor5/DSC03624.JPG,char_data/이/DSC03624.JPG_2.jpg,10270,480,640,79,346,425,282,412,True,75
이,139,kaist_dataset/Korean/Digital_Camera/outdoor5/DSC03625.JPG,char_data/이/DSC03625.JPG_2.jpg,10842,480,640,78,351,429,66,205,True,75
이,37,kaist_dataset/Korean/Digital_Camera/outdoor5/DSC03636.JPG,char_data/이/DSC03636.JPG_2.jpg,1110,480,640,30,191,221,398,435,True,75
이,90,kaist_dataset/Korean/Digital_Camera/outdoor5/DSC03641.JPG,char_data/이/DSC03641.JPG_4.jpg,7740,480,640,86,238,324,228,318,True,75
이,51,kaist_dataset/Korean/Digital_Camera/outdoor5/DSC03641.JPG,char_data/이/DSC03641.JPG_5.jpg,2448,480,640,48,162,210,333,384,True,75
이,33,kaist_dataset/Korean/Digital_Camera/outdoor5/DSC03751.JPG,char_data/이/DSC03751.JPG_2.jpg,891,480,640,27,527,554,338,371,True,75
이,76,kaist_dataset/Korean/Digital_Camera/outdoor5/DSC03789.JPG,char_data/이/DSC03789.JPG_2.jpg,4560,480,640,60,432,492,25,101,True,75
이,63,kaist_dataset/Korean/Digital_Camera/outdoor5/DSC03790.JPG,char_data/이/DSC03790.JPG_2.jpg,3024,480,640,48,345,393,157,220,True,75
이,50,kaist_dataset/Korean/Digital_Camera/outdoor5/DSC03791.JPG,char_data/이/DSC03791.JPG_2.jpg,2000,480,640,40,364,404,91,141,True,75
이,70,kaist_dataset/Korean/Digital_Camera/outdoor5/DSC03869.JPG,char_data/이/DSC03869.JPG_2.jpg,3850,480,640,55,11,66,262,332,True,75
이,56,kaist_dataset/Korean/Digital_Camera/outdoor5/DSC03979.JPG,char_data/이/DSC03979.JPG_2.jpg,3640,480,640,65,155,220,158,214,True,75
이,71,kaist_dataset/Korean/Digital_Camera/outdoor5/DSC03993.JPG,char_data/이/DSC03993.JPG_4.jpg,3976,480,640,56,68,124,179,250,True,75
이,62,kaist_dataset/Korean/Digital_Camera/outdoor5/DSC03993.JPG,char_data/이/DSC03993.JPG_5.jpg,3100,480,640,50,485,535,123,185,True,75
이,124,kaist_dataset/Korean/Digital_Camera/outdoor5/DSC03996.JPG,char_data/이/DSC03996.JPG_6.jpg,14012,480,640,113,194,307,152,276,True,75
이,67,kaist_dataset/Korean/Digital_Camera/outdoor5/DSC03996.JPG,char_data/이/DSC03996.JPG_7.jpg,2345,480,640,35,131,166,82,149,True,75
이,57,kaist_dataset/Korean/Digital_Camera/outdoor5/DSC03996.JPG,char_data/이/DSC03996.JPG_8.jpg,1881,480,640,33,437,470,83,140,True,75
이,98,kaist_dataset/Korean/Digital_Camera/outdoor5/DSC04027.JPG,char_data/이/DSC04027.JPG_2.jpg,8918,480,640,91,256,347,281,379,True,75
이,53,kaist_dataset/Korean/Digital_Camera/outdoor6/DSC04043.JPG,char_data/이/DSC04043.JPG_2.jpg,954,480,640,18,85,103,212,265,True,75
이,60,kaist_dataset/Korean/Digital_Camera/outdoor6/DSC04044.JPG,char_data/이/DSC04044.JPG_2.jpg,2760,480,640,46,157,203,350,410,True,75
이,66,kaist_dataset/Korean/Digital_Camera/outdoor6/DSC04045.JPG,char_data/이/DSC04045.JPG_2.jpg,3828,480,640,58,68,126,35,101,True,75
이,69,kaist_dataset/Korean/Digital_Camera/outdoor6/DSC04067.JPG,char_data/이/DSC04067.JPG_2.jpg,4071,480,640,59,405,464,179,248,True,75
이,95,kaist_dataset/Korean/Digital_Camera/outdoor6/DSC04085.JPG,char_data/이/DSC04085.JPG_2.jpg,8360,480,640,88,246,334,139,234,True,75
이,88,kaist_dataset/Korean/Digital_Camera/outdoor6/DSC04093.JPG,char_data/이/DSC04093.JPG_2.jpg,8800,480,640,100,524,624,342,430,True,75
이,92,kaist_dataset/Korean/Digital_Camera/outdoor6/DSC04096.JPG,char_data/이/DSC04096.JPG_2.jpg,5244,480,640,57,410,467,100,192,True,75
이,78,kaist_dataset/Korean/Digital_Camera/outdoor6/DSC04134.JPG,char_data/이/DSC04134.JPG_2.jpg,5226,480,640,67,184,251,393,471,True,75
이,87,kaist_dataset/Korean/Digital_Camera/outdoor6/DSC04138.JPG,char_data/이/DSC04138.JPG_4.jpg,7917,480,640,91,416,507,75,162,True,75
이,37,kaist_dataset/Korean/Digital_Camera/outdoor6/DSC04138.JPG,char_data/이/DSC04138.JPG_5.jpg,925,480,640,25,149,174,48,85,True,75
이,103,kaist_dataset/Korean/Digital_Camera/outdoor6/DSC04156.JPG,char_data/이/DSC04156.JPG_2.jpg,5974,480,640,58,561,619,164,267,True,75
이,105,kaist_dataset/Korean/Digital_Camera/outdoor6/DSC04158.JPG,char_data/이/DSC04158.JPG_4.jpg,10290,480,640,98,407,505,308,413,True,75
이,78,kaist_dataset/Korean/Digital_Camera/outdoor6/DSC04158.JPG,char_data/이/DSC04158.JPG_5.jpg,4290,480,640,55,136,191,229,307,True,75
이,42,kaist_dataset/Korean/Digital_Camera/outdoor6/DSC04161.JPG,char_data/이/DSC04161.JPG_2.jpg,2016,480,640,48,345,393,118,160,True,75
이,70,kaist_dataset/Korean/Digital_Camera/outdoor6/DSC04292.JPG,char_data/이/DSC04292.JPG_2.jpg,4690,480,640,67,195,262,22,92,True,75
이,84,kaist_dataset/Korean/Digital_Camera/outdoor6/DSC04303.JPG,char_data/이/DSC04303.JPG_2.jpg,7392,480,640,88,84,172,92,176,True,75
이,56,kaist_dataset/Korean/Digital_Camera/outdoor6/DSC04319.JPG,char_data/이/DSC04319.JPG_2.jpg,3248,480,640,58,194,252,116,172,True,75
이,101,kaist_dataset/Korean/Digital_Camera/outdoor6/DSC04341.JPG,char_data/이/DSC04341.JPG_2.jpg,14342,480,640,142,488,630,109,210,True,75
이,37,kaist_dataset/Korean/Digital_Camera/outdoor6/DSC04347.JPG,char_data/이/DSC04347.JPG_2.jpg,1184,480,640,32,78,110,347,384,True,75
이,104,kaist_dataset/Korean/Digital_Camera/outdoor6/DSC04350.JPG,char_data/이/DSC04350.JPG_2.jpg,4888,480,640,47,426,473,319,423,True,75
이,71,kaist_dataset/Korean/Digital_Camera/outdoor6/DSC04396.JPG,char_data/이/DSC04396.JPG_2.jpg,4047,480,640,57,340,397,78,149,True,75
이,88,kaist_dataset/Korean/Digital_Camera/outdoor6/DSC04440.JPG,char_data/이/DSC04440.JPG_2.jpg,7216,480,640,82,57,139,43,131,True,75
이,72,kaist_dataset/Korean/Digital_Camera/outdoor7/DSC04480.JPG,char_data/이/DSC04480.JPG_2.jpg,3384,480,640,47,239,286,106,178,True,75
이,86,kaist_dataset/Korean/Digital_Camera/outdoor7/P1010013.JPG,char_data/이/P1010013.JPG_2.jpg,3870,480,640,45,340,385,99,185,True,75
이,189,kaist_dataset/Korean/Digital_Camera/outdoor7/P1010014.JPG,char_data/이/P1010014.JPG_2.jpg,17577,480,640,93,430,523,122,311,True,75
이,115,kaist_dataset/Korean/Digital_Camera/outdoor7/P1010050.JPG,char_data/이/P1010050.JPG_2.jpg,12420,480,640,108,397,505,99,214,True,75
이,115,kaist_dataset/Korean/Digital_Camera/outdoor7/P1010054.JPG,char_data/이/P1010054.JPG_6.jpg,14145,480,640,123,109,232,104,219,True,75
이,33,kaist_dataset/Korean/Digital_Camera/outdoor7/P1010054.JPG,char_data/이/P1010054.JPG_7.jpg,1089,480,640,33,287,320,227,260,True,75
이,104,kaist_dataset/Korean/Digital_Camera/outdoor7/P1010056.JPG,char_data/이/P1010056.JPG_2.jpg,6344,480,640,61,491,552,135,239,True,75
이,74,kaist_dataset/Korean/Digital_Camera/outdoor7/P1010057.JPG,char_data/이/P1010057.JPG_2.jpg,6512,480,640,88,543,631,144,218,True,75
이,117,kaist_dataset/Korean/Digital_Camera/outdoor7/P1010073.JPG,char_data/이/P1010073.JPG_2.jpg,12402,480,640,106,243,349,180,297,True,75
이,95,kaist_dataset/Korean/Digital_Camera/outdoor7/P1010106.JPG,char_data/이/P1010106.JPG_2.jpg,8740,480,640,92,526,618,86,181,True,75
이,67,kaist_dataset/Korean/Digital_Camera/outdoor7/P1010112.JPG,char_data/이/P1010112.JPG_2.jpg,4556,480,640,68,511,579,278,345,True,75
이,88,kaist_dataset/Korean/Digital_Camera/outdoor7/P1010115.JPG,char_data/이/P1010115.JPG_2.jpg,7128,480,640,81,248,329,296,384,True,75
이,90,kaist_dataset/Korean/Digital_Camera/outdoor8/DSC02508.JPG,char_data/이/DSC02508.JPG_2.jpg,14760,480,640,164,228,392,125,215,True,75
이,90,kaist_dataset/Korean/Digital_Camera/outdoor8/DSC02880.JPG,char_data/이/DSC02880.JPG_2.jpg,6210,480,640,69,222,291,230,320,True,75
이,49,kaist_dataset/Korean/Digital_Camera/outdoor8/DSC02929.JPG,char_data/이/DSC02929.JPG_2.jpg,1960,480,640,40,254,294,206,255,True,75
이,81,"kaist_dataset/Korean/Mobile_Phone/(M,K)B-light/P090911072.jpg",char_data/이/P090911072.jpg_2.jpg,6156,480,640,76,48,124,212,293,True,75
이,79,"kaist_dataset/Korean/Mobile_Phone/(M,K)B-light/P090911073.jpg",char_data/이/P090911073.jpg_2.jpg,5688,480,640,72,434,506,303,382,True,75
이,149,"kaist_dataset/Korean/Mobile_Phone/(M,K)C-outdoor/P090912033.jpg",char_data/이/P090912033.jpg_2.jpg,16241,480,640,109,305,414,147,296,True,75
이,139,"kaist_dataset/Korean/Mobile_Phone/(M,K)E-bookCover/P090831030.jpg",char_data/이/P090831030.jpg_2.jpg,14873,480,640,107,161,268,209,348,True,75
이,96,"kaist_dataset/Korean/Mobile_Phone/(M,K)E-bookCover/P090831032.jpg",char_data/이/P090831032.jpg_2.jpg,9888,480,640,103,202,305,42,138,True,75
이,153,"kaist_dataset/Korean/Mobile_Phone/(M,K)E-bookCover/P090831033.jpg",char_data/이/P090831033.jpg_8.jpg,18819,480,640,123,463,586,13,166,True,75
이,138,"kaist_dataset/Korean/Mobile_Phone/(M,K)E-bookCover/P090831033.jpg",char_data/이/P090831033.jpg_9.jpg,14490,480,640,105,273,378,184,322,True,75
이,44,"kaist_dataset/Korean/Mobile_Phone/(M,K)E-bookCover/P090831033.jpg",char_data/이/P090831033.jpg_10.jpg,1716,480,640,39,399,438,357,401,True,75
이,51,"kaist_dataset/Korean/Mobile_Phone/(M,K)E-bookCover/P090831033.jpg",char_data/이/P090831033.jpg_11.jpg,1836,480,640,36,480,516,402,453,True,75
이,104,"kaist_dataset/Korean/Mobile_Phone/(M,K)E-bookCover/P090831034.jpg",char_data/이/P090831034.jpg_2.jpg,9152,480,640,88,319,407,166,270,True,75
이,45,"kaist_dataset/Korean/Mobile_Phone/(M,K)E-bookCover/P090831036.jpg",char_data/이/P090831036.jpg_2.jpg,1665,480,640,37,222,259,393,438,True,75
이,84,"kaist_dataset/Korean/Mobile_Phone/(M,K)E-bookCover/P090831050.jpg",char_data/이/P090831050.jpg_2.jpg,5040,480,640,60,494,554,282,366,True,75
이,147,"kaist_dataset/Korean/Mobile_Phone/(M,K)E-bookCover/P090831055.jpg",char_data/이/P090831055.jpg_2.jpg,15435,480,640,105,269,374,138,285,True,75
이,127,"kaist_dataset/Korean/Mobile_Phone/(M,K)E-bookCover/P090831056.jpg",char_data/이/P090831056.jpg_6.jpg,9652,480,640,76,339,415,162,289,True,75
이,50,"kaist_dataset/Korean/Mobile_Phone/(M,K)E-bookCover/P090831056.jpg",char_data/이/P090831056.jpg_7.jpg,2050,480,640,41,22,63,309,359,True,75
이,51,"kaist_dataset/Korean/Mobile_Phone/(M,K)E-bookCover/P090831056.jpg",char_data/이/P090831056.jpg_8.jpg,1836,480,640,36,141,177,309,360,True,75
이,59,"kaist_dataset/Korean/Mobile_Phone/(M,K)E-bookCover/P090831058.jpg",char_data/이/P090831058.jpg_2.jpg,3068,480,640,52,432,484,312,371,True,75
이,115,"kaist_dataset/Korean/Mobile_Phone/(M,K)E-bookCover/P090831063.jpg",char_data/이/P090831063.jpg_4.jpg,13570,480,640,118,153,271,63,178,True,75
이,113,"kaist_dataset/Korean/Mobile_Phone/(M,K)E-bookCover/P090831063.jpg",char_data/이/P090831063.jpg_5.jpg,12317,480,640,109,389,498,65,178,True,75
이,125,"kaist_dataset/Korean/Mobile_Phone/(M,K)E-bookCover/P090831070.jpg",char_data/이/P090831070.jpg_2.jpg,10875,480,640,87,325,412,64,189,True,75
이,130,"kaist_dataset/Korean/Mobile_Phone/(M,K)E-bookCover/P090831071.jpg",char_data/이/P090831071.jpg_2.jpg,11700,480,640,90,501,591,159,289,True,75
이,44,"kaist_dataset/Korean/Mobile_Phone/(M,K)E-bookCover/P090831104.jpg",char_data/이/P090831104.jpg_2.jpg,1364,480,640,31,451,482,281,325,True,75
이,44,"kaist_dataset/Korean/Mobile_Phone/(M,K)E-bookCover/P090831108.jpg",char_data/이/P090831108.jpg_2.jpg,1276,480,640,29,268,297,265,309,True,75
이,120,"kaist_dataset/Korean/Mobile_Phone/(M,K)E-bookCover/P090831127.jpg",char_data/이/P090831127.jpg_2.jpg,9360,480,640,78,199,277,78,198,True,75
이,123,"kaist_dataset/Korean/Mobile_Phone/(M,K)E-bookCover/P090831130.jpg",char_data/이/P090831130.jpg_2.jpg,9225,480,640,75,282,357,49,172,True,75
이,139,"kaist_dataset/Korean/Mobile_Phone/(M,K)E-bookCover/P090831131.jpg",char_data/이/P090831131.jpg_2.jpg,12232,480,640,88,102,190,248,387,True,75
이,91,"kaist_dataset/Korean/Mobile_Phone/(M,K)E-bookCover/P090903010.jpg",char_data/이/P090903010.jpg_2.jpg,8008,480,640,88,229,317,308,399,True,75
이,73,"kaist_dataset/Korean/Mobile_Phone/(M,K)E-bookCover/P090903026.jpg",char_data/이/P090903026.jpg_2.jpg,4599,480,640,63,251,314,99,172,True,75
이,44,"kaist_dataset/Korean/Mobile_Phone/(M,K)E-bookCover/P090903029.jpg",char_data/이/P090903029.jpg_2.jpg,1540,480,640,35,95,130,262,306,True,75
이,33,"kaist_dataset/Korean/Mobile_Phone/(M,K)E-bookCover/P090903032.jpg",char_data/이/P090903032.jpg_4.jpg,759,480,640,23,302,325,257,290,True,75
이,38,"kaist_dataset/Korean/Mobile_Phone/(M,K)E-bookCover/P090903032.jpg",char_data/이/P090903032.jpg_5.jpg,1026,480,640,27,415,442,248,286,True,75
이,86,"kaist_dataset/Korean/Mobile_Phone/(M,K)E-bookCover/P090903039.jpg",char_data/이/P090903039.jpg_2.jpg,4988,480,640,58,174,232,17,103,True,75
이,57,"kaist_dataset/Korean/Mobile_Phone/(M,K)E-bookCover/P090903057.jpg",char_data/이/P090903057.jpg_2.jpg,2337,480,640,41,574,615,46,103,True,75
이,131,"kaist_dataset/Korean/Mobile_Phone/(M,K)E-bookCover/P090903087.jpg",char_data/이/P090903087.jpg_2.jpg,16244,480,640,124,189,313,254,385,True,75
이,64,"kaist_dataset/Korean/Mobile_Phone/(M,K)E-bookCover/P090911001.jpg",char_data/이/P090911001.jpg_2.jpg,4864,480,640,76,506,582,38,102,True,75
이,141,"kaist_dataset/Korean/Mobile_Phone/(M,K)E-bookCover/P090911002.jpg",char_data/이/P090911002.jpg_2.jpg,15651,480,640,111,506,617,153,294,True,75
이,61,"kaist_dataset/Korean/Mobile_Phone/(M,K)E-bookCover/P090911006.jpg",char_data/이/P090911006.jpg_2.jpg,4148,480,640,68,464,532,41,102,True,75
이,61,"kaist_dataset/Korean/Mobile_Phone/(M,K)F-others/P090911041.jpg",char_data/이/P090911041.jpg_2.jpg,4270,480,640,70,353,423,210,271,True,75
이,72,kaist_dataset/Mixed/Digital_Camera/(C.S)A-shadow/DSC02902.JPG,char_data/이/DSC02902.JPG_2.jpg,2880,480,640,40,248,288,300,372,True,75
이,19,kaist_dataset/Mixed/Digital_Camera/(C.S)C-outdoor1/014.JPG,char_data/이/014.JPG_2.jpg,342,480,640,18,497,515,279,298,True,75
이,67,kaist_dataset/Mixed/Digital_Camera/(C.S)C-outdoor1/080.JPG,char_data/이/080.JPG_2.jpg,4623,480,640,69,353,422,200,267,True,75
이,104,kaist_dataset/Mixed/Digital_Camera/(C.S)C-outdoor1/080119-0033.jpg,char_data/이/080119-0033.jpg_4.jpg,10504,1200,1600,101,299,400,809,913,True,75
이,116,kaist_dataset/Mixed/Digital_Camera/(C.S)C-outdoor1/080119-0033.jpg,char_data/이/080119-0033.jpg_5.jpg,10440,1200,1600,90,1062,1152,823,939,True,75
이,60,kaist_dataset/Mixed/Digital_Camera/(C.S)C-outdoor1/1.JPG,char_data/이/1.JPG_2.jpg,1860,576,768,31,370,401,460,520,True,75
이,44,kaist_dataset/Mixed/Digital_Camera/(C.S)C-outdoor1/2007-12-08-day-103.jpg,char_data/이/2007-12-08-day-103.jpg_2.jpg,1452,1200,1600,33,53,86,457,501,True,75
이,233,kaist_dataset/Mixed/Digital_Camera/(C.S)C-outdoor1/2007-12-08-day-106.jpg,char_data/이/2007-12-08-day-106.jpg_2.jpg,65007,1200,1600,279,1092,1371,469,702,True,75
이,227,kaist_dataset/Mixed/Digital_Camera/(C.S)C-outdoor1/2007-12-09-day-exterior-086.jpg,char_data/이/2007-12-09-day-exterior-086.jpg_4.jpg,34277,1200,1600,151,1413,1564,479,706,True,75
이,82,kaist_dataset/Mixed/Digital_Camera/(C.S)C-outdoor1/2007-12-09-day-exterior-086.jpg,char_data/이/2007-12-09-day-exterior-086.jpg_5.jpg,3444,1200,1600,42,1539,1581,1082,1164,True,75
이,43,kaist_dataset/Mixed/Digital_Camera/(C.S)C-outdoor1/3.JPG,char_data/이/3.JPG_2.jpg,1419,576,768,33,146,179,410,453,True,75
이,97,kaist_dataset/Mixed/Digital_Camera/(C.S)C-outdoor1/51.JPG,char_data/이/51.JPG_2.jpg,8633,576,768,89,317,406,220,317,True,75
이,58,kaist_dataset/Mixed/Digital_Camera/(C.S)C-outdoor1/57.JPG,char_data/이/57.JPG_6.jpg,2494,500,766,43,396,439,385,443,True,75
이,104,kaist_dataset/Mixed/Digital_Camera/(C.S)C-outdoor1/57.JPG,char_data/이/57.JPG_7.jpg,8112,500,766,78,418,496,188,292,True,75
이,27,kaist_dataset/Mixed/Digital_Camera/(C.S)C-outdoor1/57.JPG,char_data/이/57.JPG_8.jpg,540,500,766,20,295,315,455,482,True,75
이,58,kaist_dataset/Mixed/Digital_Camera/(C.S)C-outdoor1/DSC02323.JPG,char_data/이/DSC02323.JPG_2.jpg,4408,480,640,76,467,543,260,318,True,75
이,49,kaist_dataset/Mixed/Digital_Camera/(C.S)C-outdoor2/DSC02377.JPG,char_data/이/DSC02377.JPG_2.jpg,3577,480,640,73,223,296,254,303,True,75
이,68,kaist_dataset/Mixed/Digital_Camera/(C.S)C-outdoor2/DSC02389.JPG,char_data/이/DSC02389.JPG_2.jpg,6324,480,640,93,76,169,317,385,True,75
이,38,kaist_dataset/Mixed/Digital_Camera/(C.S)C-outdoor2/DSC02434.JPG,char_data/이/DSC02434.JPG_2.jpg,2014,480,640,53,182,235,305,343,True,75
이,38,kaist_dataset/Mixed/Digital_Camera/(C.S)C-outdoor2/DSC02447.JPG,char_data/이/DSC02447.JPG_4.jpg,950,480,640,25,426,451,178,216,True,75
이,36,kaist_dataset/Mixed/Digital_Camera/(C.S)C-outdoor2/DSC02447.JPG,char_data/이/DSC02447.JPG_5.jpg,1044,480,640,29,472,501,182,218,True,75
이,68,kaist_dataset/Mixed/Digital_Camera/(C.S)C-outdoor2/DSC02471.JPG,char_data/이/DSC02471.JPG_2.jpg,4284,480,640,63,304,367,213,281,True,75
이,67,kaist_dataset/Mixed/Digital_Camera/(C.S)C-outdoor2/DSC02479.JPG,char_data/이/DSC02479.JPG_2.jpg,7102,480,640,106,198,304,159,226,True,75
이,60,kaist_dataset/Mixed/Digital_Camera/(C.S)C-outdoor2/DSC02493.JPG,char_data/이/DSC02493.JPG_2.jpg,2160,480,640,36,546,582,368,428,True,75
이,92,kaist_dataset/Mixed/Digital_Camera/(C.S)C-outdoor2/DSC02513.JPG,char_data/이/DSC02513.JPG_2.jpg,4508,480,640,49,587,636,236,328,True,75
이,44,kaist_dataset/Mixed/Digital_Camera/(C.S)C-outdoor2/DSC02519.JPG,char_data/이/DSC02519.JPG_2.jpg,2068,480,640,47,374,421,137,181,True,75
이,66,kaist_dataset/Mixed/Digital_Camera/(C.S)C-outdoor2/DSC02532.JPG,char_data/이/DSC02532.JPG_2.jpg,3168,480,640,48,396,444,136,202,True,75
이,96,kaist_dataset/Mixed/Digital_Camera/(C.S)C-outdoor2/DSC02874.JPG,char_data/이/DSC02874.JPG_2.jpg,7776,480,640,81,116,197,240,336,True,75
이,71,kaist_dataset/Mixed/Digital_Camera/(C.S)C-outdoor2/DSC02879.JPG,char_data/이/DSC02879.JPG_2.jpg,4757,480,640,67,186,253,213,284,True,75
이,60,kaist_dataset/Mixed/Digital_Camera/(C.S)C-outdoor2/DSC02886.JPG,char_data/이/DSC02886.JPG_2.jpg,3840,480,640,64,480,544,67,127,True,75
이,64,kaist_dataset/Mixed/Digital_Camera/(C.S)C-outdoor2/DSC02887.JPG,char_data/이/DSC02887.JPG_2.jpg,3584,480,640,56,34,90,54,118,True,75
이,50,kaist_dataset/Mixed/Digital_Camera/(C.S)C-outdoor2/DSC02890.JPG,char_data/이/DSC02890.JPG_2.jpg,2700,480,640,54,218,272,356,406,True,75
이,98,kaist_dataset/Mixed/Digital_Camera/(C.S)C-outdoor2/DSC02907.JPG,char_data/이/DSC02907.JPG_2.jpg,8526,480,640,87,260,347,203,301,True,75
이,25,kaist_dataset/Mixed/Digital_Camera/(C.S)C-outdoor2/DSC02940.JPG,char_data/이/DSC02940.JPG_2.jpg,825,480,640,33,285,318,315,340,True,75
이,82,kaist_dataset/Mixed/Digital_Camera/(C.S)C-outdoor2/DSC02947.JPG,char_data/이/DSC02947.JPG_2.jpg,6642,480,640,81,108,189,127,209,True,75
이,44,kaist_dataset/Mixed/Digital_Camera/(C.S)C-outdoor3/DSC02962.JPG,char_data/이/DSC02962.JPG_2.jpg,1716,480,640,39,143,182,359,403,True,75
이,94,kaist_dataset/Mixed/Digital_Camera/(C.S)C-outdoor3/DSC02970.JPG,char_data/이/DSC02970.JPG_2.jpg,8178,480,640,87,488,575,202,296,True,75
이,120,kaist_dataset/Mixed/Digital_Camera/(C.S)C-outdoor3/DSC02978.JPG,char_data/이/DSC02978.JPG_2.jpg,11760,480,640,98,527,625,97,217,True,75
이,47,kaist_dataset/Mixed/Digital_Camera/(C.S)C-outdoor3/DSC03033.JPG,char_data/이/DSC03033.JPG_2.jpg,3102,480,640,66,207,273,108,155,True,75
이,57,kaist_dataset/Mixed/Digital_Camera/(C.S)C-outdoor3/DSC03164.JPG,char_data/이/DSC03164.JPG_2.jpg,3078,480,640,54,305,359,206,263,True,75
이,46,kaist_dataset/Mixed/Digital_Camera/(C.S)C-outdoor3/DSC03186.JPG,char_data/이/DSC03186.JPG_2.jpg,2300,480,640,50,200,250,54,100,True,75
이,94,kaist_dataset/Mixed/Digital_Camera/(C.S)C-outdoor3/DSC03187.JPG,char_data/이/DSC03187.JPG_2.jpg,9024,480,640,96,331,427,277,371,True,75
이,43,kaist_dataset/Mixed/Digital_Camera/(C.S)C-outdoor3/DSC03196.JPG,char_data/이/DSC03196.JPG_2.jpg,1462,480,640,34,290,324,396,439,True,75
이,96,kaist_dataset/Mixed/Digital_Camera/(C.S)C-outdoor3/DSC03247.JPG,char_data/이/DSC03247.JPG_2.jpg,6240,480,640,65,151,216,231,327,True,75
이,82,kaist_dataset/Mixed/Digital_Camera/(C.S)C-outdoor3/DSC03275.JPG,char_data/이/DSC03275.JPG_2.jpg,7708,480,640,94,154,248,78,160,True,75
이,95,kaist_dataset/Mixed/Digital_Camera/(C.S)C-outdoor3/DSC03415.JPG,char_data/이/DSC03415.JPG_2.jpg,6365,480,640,67,36,103,144,239,True,75
이,42,kaist_dataset/Mixed/Digital_Camera/(C.S)C-outdoor4/DSC03439.JPG,char_data/이/DSC03439.JPG_2.jpg,1134,480,640,27,292,319,416,458,False,75
이,200,kaist_dataset/Mixed/Digital_Camera/(C.S)C-outdoor4/DSC03548.JPG,char_data/이/DSC03548.JPG_2.jpg,20600,480,640,103,255,358,174,374,False,75
이,63,kaist_dataset/Mixed/Digital_Camera/(C.S)C-outdoor4/DSC03579.JPG,char_data/이/DSC03579.JPG_2.jpg,4095,480,640,65,399,464,202,265,False,75
이,207,kaist_dataset/Mixed/Digital_Camera/(C.S)C-outdoor4/DSC03621.JPG,char_data/이/DSC03621.JPG_2.jpg,23391,480,640,113,501,614,115,322,False,75
이,118,kaist_dataset/Mixed/Digital_Camera/(C.S)C-outdoor4/DSC03635.JPG,char_data/이/DSC03635.JPG_2.jpg,13570,480,640,115,419,534,286,404,False,75
이,166,kaist_dataset/Mixed/Digital_Camera/(C.S)C-outdoor4/DSC03638.JPG,char_data/이/DSC03638.JPG_2.jpg,20086,480,640,121,404,525,257,423,False,75
이,55,kaist_dataset/Mixed/Digital_Camera/(C.S)C-outdoor4/DSC03651.JPG,char_data/이/DSC03651.JPG_2.jpg,2695,480,640,49,229,278,278,333,False,75
이,54,kaist_dataset/Mixed/Digital_Camera/(C.S)C-outdoor4/DSC03667.JPG,char_data/이/DSC03667.JPG_2.jpg,2538,480,640,47,64,111,280,334,False,75
이,39,kaist_dataset/Mixed/Digital_Camera/(C.S)C-outdoor4/DSC03672.JPG,char_data/이/DSC03672.JPG_4.jpg,1365,480,640,35,248,283,124,163,False,75
이,73,kaist_dataset/Mixed/Digital_Camera/(C.S)C-outdoor4/DSC03672.JPG,char_data/이/DSC03672.JPG_5.jpg,6205,480,640,85,185,270,213,286,False,75
이,58,kaist_dataset/Mixed/Digital_Camera/(C.S)C-outdoor4/DSC03707.JPG,char_data/이/DSC03707.JPG_2.jpg,2552,480,640,44,321,365,273,331,False,75
이,111,kaist_dataset/Mixed/Digital_Camera/(C.S)C-outdoor4/DSC03769.JPG,char_data/이/DSC03769.JPG_2.jpg,8436,480,640,76,336,412,298,409,False,75
이,39,kaist_dataset/Mixed/Digital_Camera/(C.S)C-outdoor5/DSC03819.JPG,char_data/이/DSC03819.JPG_2.jpg,858,480,640,22,547,569,365,404,False,75
이,80,kaist_dataset/Mixed/Digital_Camera/(C.S)C-outdoor5/DSC04048.JPG,char_data/이/DSC04048.JPG_2.jpg,5360,480,640,67,167,234,90,170,False,75
이,116,kaist_dataset/Mixed/Digital_Camera/(C.S)C-outdoor5/DSC04057.JPG,char_data/이/DSC04057.JPG_2.jpg,13340,480,640,115,470,585,160,276,False,75
이,38,kaist_dataset/Mixed/Digital_Camera/(C.S)C-outdoor5/DSC04070.JPG,char_data/이/DSC04070.JPG_2.jpg,1596,480,640,42,304,346,50,88,False,75
이,59,kaist_dataset/Mixed/Digital_Camera/(C.S)C-outdoor5/DSC04119.JPG,char_data/이/DSC04119.JPG_2.jpg,3127,480,640,53,215,268,120,179,False,75
이,111,kaist_dataset/Mixed/Digital_Camera/(C.S)C-outdoor5/DSC04144.JPG,char_data/이/DSC04144.JPG_2.jpg,17871,480,640,161,196,357,258,369,False,75
이,76,kaist_dataset/Mixed/Digital_Camera/(C.S)C-outdoor5/DSC04290.JPG,char_data/이/DSC04290.JPG_2.jpg,4940,480,640,65,195,260,345,421,False,75
이,51,kaist_dataset/Mixed/Digital_Camera/(C.S)C-outdoor5/DSC04395.JPG,char_data/이/DSC04395.JPG_2.jpg,1938,480,640,38,286,324,285,336,False,75
이,66,kaist_dataset/Mixed/Digital_Camera/(C.S)C-outdoor5/DSC04399.JPG,char_data/이/DSC04399.JPG_2.jpg,2904,480,640,44,129,173,204,270,False,75
이,80,kaist_dataset/Mixed/Digital_Camera/(C.S)C-outdoor5/DSC04450.JPG,char_data/이/DSC04450.JPG_2.jpg,4960,480,640,62,56,118,334,414,False,75
이,42,kaist_dataset/Mixed/Digital_Camera/(C.S)C-outdoor5/DSC04456.JPG,char_data/이/DSC04456.JPG_2.jpg,1512,480,640,36,458,494,226,268,False,75
이,39,kaist_dataset/Mixed/Digital_Camera/(C.S)C-outdoor6/025.jpg,char_data/이/025.jpg_2.jpg,2730,293,472,70,236,306,149,188,False,75
이,73,kaist_dataset/Mixed/Digital_Camera/(C.S)C-outdoor6/080116-0057.jpg,char_data/이/080116-0057.jpg_4.jpg,3796,1200,1600,52,412,464,820,893,False,75
이,64,kaist_dataset/Mixed/Digital_Camera/(C.S)C-outdoor6/080116-0057.jpg,char_data/이/080116-0057.jpg_5.jpg,3264,1200,1600,51,1051,1102,905,969,False,75
이,63,kaist_dataset/Mixed/Digital_Camera/(C.S)C-outdoor6/P1010020.JPG,char_data/이/P1010020.JPG_2.jpg,3591,480,640,57,285,342,272,335,False,75
이,35,kaist_dataset/Mixed/Digital_Camera/(C.S)C-outdoor6/P1010052.JPG,char_data/이/P1010052.JPG_2.jpg,980,480,640,28,481,509,340,375,False,75
이,57,kaist_dataset/Mixed/Digital_Camera/(C.S)C-outdoor6/P1010054.JPG,char_data/이/P1010054.JPG_8.jpg,2280,480,640,40,159,199,217,274,False,75
이,114,kaist_dataset/Mixed/Digital_Camera/(C.S)C-outdoor6/P1010055.JPG,char_data/이/P1010055.JPG_2.jpg,11286,480,640,99,72,171,114,228,False,75
이,60,kaist_dataset/Mixed/Digital_Camera/(C.S)C-outdoor6/P1010062.JPG,char_data/이/P1010062.JPG_2.jpg,5760,480,640,96,320,416,142,202,False,75
이,105,kaist_dataset/Mixed/Digital_Camera/(C.S)C-outdoor6/P1010063.JPG,char_data/이/P1010063.JPG_2.jpg,11655,480,640,111,181,292,3,108,False,75
이,59,kaist_dataset/Mixed/Digital_Camera/(C.S)C-outdoor6/P1010094.JPG,char_data/이/P1010094.JPG_2.jpg,5546,480,640,94,536,630,148,207,False,75
이,63,kaist_dataset/Mixed/Digital_Camera/(C.S)C-outdoor6/P1010097.JPG,char_data/이/P1010097.JPG_2.jpg,2898,480,640,46,458,504,105,168,False,75
이,90,kaist_dataset/Mixed/Digital_Camera/(C.S)C-outdoor6/P1010099.JPG,char_data/이/P1010099.JPG_2.jpg,5580,480,640,62,526,588,108,198,False,75
이,38,kaist_dataset/Mixed/Digital_Camera/(C.S)C-outdoor6/P1010137.JPG,char_data/이/P1010137.JPG_2.jpg,1064,480,640,28,383,411,177,215,False,75
이,63,kaist_dataset/Mixed/Digital_Camera/(C.S)D-indoor1/131.JPG,char_data/이/131.JPG_2.jpg,3780,480,640,60,301,361,209,272,False,75
이,38,kaist_dataset/Mixed/Digital_Camera/(C.S)D-indoor1/DSC02718.JPG,char_data/이/DSC02718.JPG_2.jpg,1064,480,640,28,164,192,126,164,False,75
이,44,kaist_dataset/Mixed/Digital_Camera/(C.S)D-indoor1/DSC02733.JPG,char_data/이/DSC02733.JPG_2.jpg,1540,480,640,35,197,232,65,109,False,75
이,60,kaist_dataset/Mixed/Digital_Camera/(C.S)D-indoor1/DSC02797.JPG,char_data/이/DSC02797.JPG_2.jpg,4260,480,640,71,413,484,220,280,False,75
이,69,kaist_dataset/Mixed/Digital_Camera/(C.S)D-indoor1/DSC03455.JPG,char_data/이/DSC03455.JPG_2.jpg,3450,480,640,50,352,402,384,453,False,75
이,66,kaist_dataset/Mixed/Digital_Camera/(C.S)D-indoor1/DSC03460.JPG,char_data/이/DSC03460.JPG_2.jpg,3036,480,640,46,407,453,385,451,False,75
이,70,kaist_dataset/Mixed/Digital_Camera/(C.S)D-indoor1/DSC03483.JPG,char_data/이/DSC03483.JPG_2.jpg,3080,480,640,44,501,545,114,184,False,75
이,96,kaist_dataset/Mixed/Digital_Camera/(C.S)D-indoor1/DSC03925.JPG,char_data/이/DSC03925.JPG_4.jpg,7296,480,640,76,459,535,251,347,False,75
이,35,kaist_dataset/Mixed/Digital_Camera/(C.S)D-indoor1/DSC03925.JPG,char_data/이/DSC03925.JPG_5.jpg,770,480,640,22,358,380,346,381,False,75
이,24,kaist_dataset/Mixed/Digital_Camera/(C.S)D-indoor1/DSC03959.JPG,char_data/이/DSC03959.JPG_2.jpg,576,480,640,24,362,386,393,417,False,75
이,31,kaist_dataset/Mixed/Digital_Camera/(C.S)D-indoor1/DSC03998.JPG,char_data/이/DSC03998.JPG_2.jpg,930,480,640,30,49,79,187,218,False,75
이,62,kaist_dataset/Mixed/Digital_Camera/(C.S)D-indoor1/DSC04019.JPG,char_data/이/DSC04019.JPG_2.jpg,3286,480,640,53,199,252,143,205,False,75
이,61,kaist_dataset/Mixed/Digital_Camera/(C.S)D-indoor2/DSC04487.JPG,char_data/이/DSC04487.JPG_2.jpg,2928,480,640,48,283,331,160,221,False,75
이,45,kaist_dataset/Mixed/Digital_Camera/(C.S)E-night/DSC03514.JPG,char_data/이/DSC03514.JPG_2.jpg,1935,480,640,43,303,346,107,152,False,75
이,43,kaist_dataset/Mixed/Digital_Camera/(C.S)F-others/085.jpg,char_data/이/085.jpg_2.jpg,1419,480,640,33,224,257,205,248,False,75
이,141,kaist_dataset/Mixed/Digital_Camera/(C.S)F-others/DSC02611.JPG,char_data/이/DSC02611.JPG_2.jpg,17766,480,640,126,205,331,164,305,False,75
이,63,kaist_dataset/Mixed/Digital_Camera/(C.S)F-others/DSC02799.JPG,char_data/이/DSC02799.JPG_2.jpg,3906,480,640,62,222,284,322,385,False,75
이,47,kaist_dataset/Mixed/Digital_Camera/(C.S)F-others/DSC02881.JPG,char_data/이/DSC02881.JPG_6.jpg,2256,480,640,48,73,121,181,228,False,75
이,31,kaist_dataset/Mixed/Digital_Camera/(C.S)F-others/DSC02881.JPG,char_data/이/DSC02881.JPG_7.jpg,682,480,640,22,156,178,309,340,False,75
이,35,kaist_dataset/Mixed/Digital_Camera/(C.S)F-others/DSC02881.JPG,char_data/이/DSC02881.JPG_8.jpg,875,480,640,25,509,534,221,256,False,75
이,91,kaist_dataset/Mixed/Mobile_Phone/(C.M)A-outdoor/P090912038.jpg,char_data/이/P090912038.jpg_2.jpg,8554,480,640,94,157,251,61,152,False,75
이,130,kaist_dataset/Mixed/Mobile_Phone/(C.M)A-outdoor/P090912047.jpg,char_data/이/P090912047.jpg_2.jpg,7670,480,640,59,305,364,143,273,False,75
이,77,kaist_dataset/Mixed/Mobile_Phone/(C.M)B-indoor/P090831018.jpg,char_data/이/P090831018.jpg_2.jpg,5698,480,640,74,74,148,152,229,False,75
이,53,kaist_dataset/Mixed/Mobile_Phone/(C.M)C-bookCover/P090831043.jpg,char_data/이/P090831043.jpg_2.jpg,1961,480,640,37,458,495,333,386,False,75
이,195,kaist_dataset/Mixed/Mobile_Phone/(C.M)C-bookCover/P090831125.jpg,char_data/이/P090831125.jpg_2.jpg,30810,480,640,158,405,563,41,236,False,75
이,167,kaist_dataset/Mixed/Mobile_Phone/(C.M)C-bookCover/P090903092.jpg,char_data/이/P090903092.jpg_2.jpg,20040,480,640,120,514,634,27,194,False,75
이,80,kaist_dataset/Mixed/Mobile_Phone/(C.M)C-bookCover/P090904004.jpg,char_data/이/P090904004.jpg_4.jpg,6880,480,640,86,109,195,58,138,False,75
이,83,kaist_dataset/Mixed/Mobile_Phone/(C.M)C-bookCover/P090904004.jpg,char_data/이/P090904004.jpg_5.jpg,6806,480,640,82,380,462,49,132,False,75
이,101,kaist_dataset/Mixed/Mobile_Phone/(C.M)C-bookCover/P090904005.jpg,char_data/이/P090904005.jpg_4.jpg,13635,480,640,135,229,364,163,264,False,75
이,87,kaist_dataset/Mixed/Mobile_Phone/(C.M)C-bookCover/P090904005.jpg,char_data/이/P090904005.jpg_5.jpg,10179,480,640,117,276,393,279,366,False,75
R,94,kaist_dataset/English/Digital_Camera/(E.S)A-shadow/DSC02317.JPG,char_data/R/DSC02317.JPG_2.jpg,5546,480,640,59,165,224,231,325,True,27
R,84,kaist_dataset/English/Digital_Camera/(E.S)A-shadow/DSC02423.JPG,char_data/R/DSC02423.JPG_4.jpg,5712,480,640,68,399,467,153,237,True,27
R,47,kaist_dataset/English/Digital_Camera/(E.S)A-shadow/DSC02423.JPG,char_data/R/DSC02423.JPG_5.jpg,1598,480,640,34,373,407,239,286,True,27
R,39,kaist_dataset/English/Digital_Camera/(E.S)A-shadow/P1010044.JPG,char_data/R/P1010044.JPG_6.jpg,1326,480,640,34,144,178,358,397,True,27
R,44,kaist_dataset/English/Digital_Camera/(E.S)A-shadow/P1010044.JPG,char_data/R/P1010044.JPG_7.jpg,1364,480,640,31,460,491,352,396,True,27
R,33,kaist_dataset/English/Digital_Camera/(E.S)A-shadow/P1010044.JPG,char_data/R/P1010044.JPG_8.jpg,891,480,640,27,250,277,152,185,True,27
R,30,kaist_dataset/English/Digital_Camera/(E.S)B-light/080116-0059.jpg,char_data/R/080116-0059.jpg_10.jpg,570,1200,1600,19,937,956,824,854,True,27
R,30,kaist_dataset/English/Digital_Camera/(E.S)B-light/080116-0059.jpg,char_data/R/080116-0059.jpg_11.jpg,540,1200,1600,18,640,658,826,856,True,27
R,25,kaist_dataset/English/Digital_Camera/(E.S)B-light/080116-0059.jpg,char_data/R/080116-0059.jpg_12.jpg,375,1200,1600,15,1120,1135,798,823,True,27
R,33,kaist_dataset/English/Digital_Camera/(E.S)B-light/080116-0059.jpg,char_data/R/080116-0059.jpg_13.jpg,528,1200,1600,16,710,726,770,803,True,27
R,31,kaist_dataset/English/Digital_Camera/(E.S)B-light/080116-0059.jpg,char_data/R/080116-0059.jpg_14.jpg,496,1200,1600,16,1104,1120,769,800,True,27
R,45,kaist_dataset/English/Digital_Camera/(E.S)B-light/DSC03007.JPG,char_data/R/DSC03007.JPG_4.jpg,1530,480,640,34,150,184,276,321,True,27
R,94,kaist_dataset/English/Digital_Camera/(E.S)B-light/DSC03007.JPG,char_data/R/DSC03007.JPG_5.jpg,4888,480,640,52,465,517,156,250,True,27
R,69,kaist_dataset/English/Digital_Camera/(E.S)B-light/DSC04200.JPG,char_data/R/DSC04200.JPG_4.jpg,3933,480,640,57,267,324,270,339,True,27
R,72,kaist_dataset/English/Digital_Camera/(E.S)B-light/DSC04200.JPG,char_data/R/DSC04200.JPG_5.jpg,4608,480,640,64,327,391,310,382,True,27
R,41,kaist_dataset/English/Digital_Camera/(E.S)B-light/x.jpg,char_data/R/x.jpg_4.jpg,1599,240,320,39,84,123,71,112,True,27
R,26,kaist_dataset/English/Digital_Camera/(E.S)B-light/x.jpg,char_data/R/x.jpg_5.jpg,468,240,320,18,168,186,104,130,True,27
R,36,kaist_dataset/English/Digital_Camera/(E.S)C-outdoor1/041.JPG,char_data/R/041.JPG_4.jpg,972,480,640,27,469,496,251,287,True,27
R,35,kaist_dataset/English/Digital_Camera/(E.S)C-outdoor1/041.JPG,char_data/R/041.JPG_5.jpg,875,480,640,25,587,612,251,286,True,27
R,71,kaist_dataset/English/Digital_Camera/(E.S)C-outdoor1/042.JPG,char_data/R/042.JPG_2.jpg,3195,480,640,45,566,611,214,285,True,27
R,54,kaist_dataset/English/Digital_Camera/(E.S)C-outdoor1/064.JPG,char_data/R/064.JPG_2.jpg,1944,480,640,36,209,245,178,232,True,27
R,20,kaist_dataset/English/Digital_Camera/(E.S)C-outdoor1/077.JPG,char_data/R/077.JPG_5.jpg,260,480,640,13,404,417,250,270,True,27
R,92,kaist_dataset/English/Digital_Camera/(E.S)C-outdoor1/080116-0065.jpg,char_data/R/080116-0065.jpg_2.jpg,4968,600,800,54,148,202,233,325,True,27
R,70,kaist_dataset/English/Digital_Camera/(E.S)C-outdoor1/080118-0011.jpg,char_data/R/080118-0011.jpg_6.jpg,4130,1200,1600,59,576,635,938,1008,True,27
R,71,kaist_dataset/English/Digital_Camera/(E.S)C-outdoor1/080118-0011.jpg,char_data/R/080118-0011.jpg_7.jpg,3408,1200,1600,48,1134,1182,928,999,True,27
R,64,kaist_dataset/English/Digital_Camera/(E.S)C-outdoor1/080118-0011.jpg,char_data/R/080118-0011.jpg_8.jpg,3520,1200,1600,55,752,807,531,595,True,27
R,196,kaist_dataset/English/Digital_Camera/(E.S)C-outdoor1/080119-0020.jpg,char_data/R/080119-0020.jpg_4.jpg,19208,1200,1600,98,335,433,462,658,True,27
R,181,kaist_dataset/English/Digital_Camera/(E.S)C-outdoor1/080119-0020.jpg,char_data/R/080119-0020.jpg_5.jpg,19186,1200,1600,106,659,765,464,645,True,27
R,41,kaist_dataset/English/Digital_Camera/(E.S)C-outdoor1/089.jpg,char_data/R/089.jpg_6.jpg,861,480,640,21,253,274,291,332,True,27
R,56,kaist_dataset/English/Digital_Camera/(E.S)C-outdoor1/089.jpg,char_data/R/089.jpg_7.jpg,1568,480,640,28,301,329,276,332,True,27
R,53,kaist_dataset/English/Digital_Camera/(E.S)C-outdoor1/089.jpg,char_data/R/089.jpg_8.jpg,1060,480,640,20,441,461,276,329,True,27
R,29,kaist_dataset/English/Digital_Camera/(E.S)C-outdoor1/113.jpg,char_data/R/113.jpg_4.jpg,580,480,640,20,409,429,227,256,True,27
R,37,kaist_dataset/English/Digital_Camera/(E.S)C-outdoor1/137.JPG,char_data/R/137.JPG_4.jpg,1147,480,640,31,222,253,263,300,True,27
R,34,kaist_dataset/English/Digital_Camera/(E.S)C-outdoor1/137.JPG,char_data/R/137.JPG_5.jpg,816,480,640,24,315,339,262,296,True,27
R,60,kaist_dataset/English/Digital_Camera/(E.S)C-outdoor1/139.JPG,char_data/R/139.JPG_4.jpg,2580,480,640,43,179,222,256,316,True,27
R,62,kaist_dataset/English/Digital_Camera/(E.S)C-outdoor1/139.JPG,char_data/R/139.JPG_5.jpg,2976,480,640,48,310,358,253,315,True,27
R,286,kaist_dataset/English/Digital_Camera/(E.S)C-outdoor1/2007-12-08-day-098.jpg,char_data/R/2007-12-08-day-098.jpg_4.jpg,47476,1200,1600,166,818,984,420,706,True,27
R,242,kaist_dataset/English/Digital_Camera/(E.S)C-outdoor1/2007-12-08-day-099.jpg,char_data/R/2007-12-08-day-099.jpg_2.jpg,37994,1200,1600,157,416,573,434,676,True,27
R,44,kaist_dataset/English/Digital_Camera/(E.S)C-outdoor1/6.jpg,char_data/R/6.jpg_2.jpg,1584,255,731,36,137,173,97,141,True,27
R,18,kaist_dataset/English/Digital_Camera/(E.S)C-outdoor1/7.jpg,char_data/R/7.jpg_4.jpg,252,574,680,14,145,159,105,123,True,27
R,71,kaist_dataset/English/Digital_Camera/(E.S)C-outdoor1/DSC02243.JPG,char_data/R/DSC02243.JPG_2.jpg,2343,480,640,33,340,373,205,276,True,27
R,36,kaist_dataset/English/Digital_Camera/(E.S)C-outdoor1/DSC02345.JPG,char_data/R/DSC02345.JPG_4.jpg,648,480,640,18,141,159,239,275,True,27
R,33,kaist_dataset/English/Digital_Camera/(E.S)C-outdoor1/DSC02345.JPG,char_data/R/DSC02345.JPG_5.jpg,660,480,640,20,352,372,237,270,True,27
R,78,kaist_dataset/English/Digital_Camera/(E.S)C-outdoor1/DSC02356.JPG,char_data/R/DSC02356.JPG_6.jpg,3978,480,640,51,401,452,164,242,True,27
R,68,kaist_dataset/English/Digital_Camera/(E.S)C-outdoor1/DSC02364.JPG,char_data/R/DSC02364.JPG_2.jpg,3740,480,640,55,508,563,248,316,True,27
R,84,kaist_dataset/English/Digital_Camera/(E.S)C-outdoor1/DSC02384.JPG,char_data/R/DSC02384.JPG_2.jpg,4452,480,640,53,288,341,227,311,True,27
R,79,kaist_dataset/English/Digital_Camera/(E.S)C-outdoor1/DSC02394.JPG,char_data/R/DSC02394.JPG_6.jpg,4424,480,640,56,263,319,252,331,True,27
R,69,kaist_dataset/English/Digital_Camera/(E.S)C-outdoor1/DSC02394.JPG,char_data/R/DSC02394.JPG_7.jpg,3795,480,640,55,420,475,260,329,True,27
R,69,kaist_dataset/English/Digital_Camera/(E.S)C-outdoor1/DSC02394.JPG,char_data/R/DSC02394.JPG_8.jpg,2760,480,640,40,475,515,261,330,True,27
R,69,kaist_dataset/English/Digital_Camera/(E.S)C-outdoor1/DSC02395.JPG,char_data/R/DSC02395.JPG_4.jpg,3519,480,640,51,438,489,296,365,True,27
R,88,kaist_dataset/English/Digital_Camera/(E.S)C-outdoor1/DSC02395.JPG,char_data/R/DSC02395.JPG_5.jpg,5456,480,640,62,193,255,216,304,True,27
R,92,kaist_dataset/English/Digital_Camera/(E.S)C-outdoor1/DSC02410.JPG,char_data/R/DSC02410.JPG_2.jpg,7820,480,640,85,113,198,120,212,True,27
R,133,kaist_dataset/English/Digital_Camera/(E.S)C-outdoor1/DSC02427.JPG,char_data/R/DSC02427.JPG_4.jpg,14098,480,640,106,31,137,97,230,True,27
R,51,kaist_dataset/English/Digital_Camera/(E.S)C-outdoor1/DSC02427.JPG,char_data/R/DSC02427.JPG_5.jpg,1479,480,640,29,335,364,235,286,True,27
R,130,kaist_dataset/English/Digital_Camera/(E.S)C-outdoor1/DSC02448.JPG,char_data/R/DSC02448.JPG_2.jpg,10660,480,640,82,264,346,195,325,True,27
R,58,kaist_dataset/English/Digital_Camera/(E.S)C-outdoor1/DSC02480.JPG,char_data/R/DSC02480.JPG_4.jpg,2494,480,640,43,270,313,192,250,True,27
R,114,kaist_dataset/English/Digital_Camera/(E.S)C-outdoor1/DSC02500.JPG,char_data/R/DSC02500.JPG_2.jpg,5130,480,640,45,477,522,169,283,True,27
R,72,kaist_dataset/English/Digital_Camera/(E.S)C-outdoor1/DSC02514.JPG,char_data/R/DSC02514.JPG_4.jpg,3096,480,640,43,200,243,169,241,True,27
R,114,kaist_dataset/English/Digital_Camera/(E.S)C-outdoor1/DSC02590.JPG,char_data/R/DSC02590.JPG_4.jpg,9348,480,640,82,303,385,131,245,True,27
R,124,kaist_dataset/English/Digital_Camera/(E.S)C-outdoor1/DSC02590.JPG,char_data/R/DSC02590.JPG_5.jpg,12152,480,640,98,494,592,124,248,True,27
R,139,kaist_dataset/English/Digital_Camera/(E.S)C-outdoor1/DSC02618.JPG,char_data/R/DSC02618.JPG_2.jpg,16680,480,640,120,377,497,212,351,True,27
R,77,kaist_dataset/English/Digital_Camera/(E.S)C-outdoor2/DSC02993.JPG,char_data/R/DSC02993.JPG_4.jpg,5082,480,640,66,117,183,228,305,True,27
R,81,kaist_dataset/English/Digital_Camera/(E.S)C-outdoor2/DSC02993.JPG,char_data/R/DSC02993.JPG_5.jpg,4860,480,640,60,388,448,123,204,True,27
R,72,kaist_dataset/English/Digital_Camera/(E.S)C-outdoor2/DSC03012.JPG,char_data/R/DSC03012.JPG_2.jpg,2664,480,640,37,129,166,211,283,True,27
R,55,kaist_dataset/English/Digital_Camera/(E.S)C-outdoor2/DSC03023.JPG,char_data/R/DSC03023.JPG_4.jpg,1210,480,640,22,170,192,298,353,True,27
R,55,kaist_dataset/English/Digital_Camera/(E.S)C-outdoor2/DSC03023.JPG,char_data/R/DSC03023.JPG_5.jpg,1265,480,640,23,217,240,299,354,True,27
R,47,kaist_dataset/English/Digital_Camera/(E.S)C-outdoor2/DSC03203.JPG,char_data/R/DSC03203.JPG_2.jpg,1692,480,640,36,505,541,317,364,True,27
R,71,kaist_dataset/English/Digital_Camera/(E.S)C-outdoor2/DSC03208.JPG,char_data/R/DSC03208.JPG_2.jpg,5751,480,640,81,131,212,196,267,True,27
R,68,kaist_dataset/English/Digital_Camera/(E.S)C-outdoor2/DSC03264.JPG,char_data/R/DSC03264.JPG_2.jpg,4284,480,640,63,231,294,160,228,True,27
R,55,kaist_dataset/English/Digital_Camera/(E.S)C-outdoor2/DSC03294.JPG,char_data/R/DSC03294.JPG_4.jpg,1650,480,640,30,255,285,292,347,True,27
R,58,kaist_dataset/English/Digital_Camera/(E.S)C-outdoor2/DSC03297.JPG,char_data/R/DSC03297.JPG_4.jpg,2088,480,640,36,147,183,258,316,True,27
R,62,kaist_dataset/English/Digital_Camera/(E.S)C-outdoor2/DSC03307.JPG,char_data/R/DSC03307.JPG_5.jpg,2604,480,640,42,306,348,229,291,True,27
R,43,kaist_dataset/English/Digital_Camera/(E.S)C-outdoor2/DSC03317.JPG,char_data/R/DSC03317.JPG_4.jpg,1204,480,640,28,350,378,196,239,True,27
R,40,kaist_dataset/English/Digital_Camera/(E.S)C-outdoor2/DSC03317.JPG,char_data/R/DSC03317.JPG_5.jpg,760,480,640,19,474,493,197,237,True,27
R,141,kaist_dataset/English/Digital_Camera/(E.S)C-outdoor2/DSC03410.JPG,char_data/R/DSC03410.JPG_2.jpg,21009,480,640,149,428,577,61,202,True,27
R,73,kaist_dataset/English/Digital_Camera/(E.S)C-outdoor2/DSC03411.JPG,char_data/R/DSC03411.JPG_2.jpg,6351,480,640,87,415,502,55,128,True,27
R,63,kaist_dataset/English/Digital_Camera/(E.S)C-outdoor2/DSC03412.JPG,char_data/R/DSC03412.JPG_2.jpg,4032,480,640,64,310,374,393,456,True,27
R,79,kaist_dataset/English/Digital_Camera/(E.S)C-outdoor2/DSC03432.JPG,char_data/R/DSC03432.JPG_2.jpg,4108,480,640,52,241,293,359,438,True,27
R,43,kaist_dataset/English/Digital_Camera/(E.S)C-outdoor2/DSC03575.JPG,char_data/R/DSC03575.JPG_6.jpg,1161,480,640,27,335,362,181,224,True,27
R,54,kaist_dataset/English/Digital_Camera/(E.S)C-outdoor2/DSC03575.JPG,char_data/R/DSC03575.JPG_7.jpg,1728,480,640,32,169,201,258,312,True,27
R,57,kaist_dataset/English/Digital_Camera/(E.S)C-outdoor2/DSC03575.JPG,char_data/R/DSC03575.JPG_8.jpg,2052,480,640,36,373,409,260,317,True,27
R,49,kaist_dataset/English/Digital_Camera/(E.S)C-outdoor2/DSC03650.JPG,char_data/R/DSC03650.JPG_2.jpg,1617,480,640,33,179,212,212,261,True,27
R,70,kaist_dataset/English/Digital_Camera/(E.S)C-outdoor2/DSC03684.JPG,char_data/R/DSC03684.JPG_4.jpg,3500,480,640,50,122,172,76,146,True,27
R,71,kaist_dataset/English/Digital_Camera/(E.S)C-outdoor2/DSC03684.JPG,char_data/R/DSC03684.JPG_5.jpg,3337,480,640,47,514,561,88,159,True,27
R,49,kaist_dataset/English/Digital_Camera/(E.S)C-outdoor2/DSC03865.JPG,char_data/R/DSC03865.JPG_6.jpg,1960,480,640,40,10,50,89,138,True,27
R,56,kaist_dataset/English/Digital_Camera/(E.S)C-outdoor2/DSC04120.JPG,char_data/R/DSC04120.JPG_2.jpg,2016,480,640,36,359,395,146,202,True,27
R,37,kaist_dataset/English/Digital_Camera/(E.S)C-outdoor2/DSC04361.JPG,char_data/R/DSC04361.JPG_2.jpg,851,480,640,23,363,386,241,278,True,27
R,73,kaist_dataset/English/Digital_Camera/(E.S)C-outdoor2/DSC04464.JPG,char_data/R/DSC04464.JPG_4.jpg,2920,480,640,40,68,108,317,390,True,27
R,69,kaist_dataset/English/Digital_Camera/(E.S)C-outdoor2/DSC04464.JPG,char_data/R/DSC04464.JPG_5.jpg,3105,480,640,45,478,523,328,397,True,27
R,81,kaist_dataset/English/Digital_Camera/(E.S)C-outdoor2/P1010015.JPG,char_data/R/P1010015.JPG_2.jpg,4941,480,640,61,268,329,138,219,True,27
R,64,kaist_dataset/English/Digital_Camera/(E.S)C-outdoor3/DSC02788.JPG,char_data/R/DSC02788.JPG_2.jpg,2624,480,640,41,483,524,289,353,True,27
R,81,kaist_dataset/English/Digital_Camera/(E.S)C-outdoor3/P1010064.JPG,char_data/R/P1010064.JPG_4.jpg,3888,480,640,48,140,188,308,389,True,27
R,97,kaist_dataset/English/Digital_Camera/(E.S)C-outdoor3/P1010133.JPG,char_data/R/P1010133.JPG_2.jpg,5529,480,640,57,276,333,59,156,True,27
R,83,kaist_dataset/English/Digital_Camera/(E.S)C-outdoor3/P1010138.JPG,char_data/R/P1010138.JPG_2.jpg,5063,480,640,61,391,452,76,159,True,27
R,33,kaist_dataset/English/Digital_Camera/(E.S)C-outdoor3/r.jpg,char_data/R/r.jpg_2.jpg,1056,240,320,32,254,286,58,91,True,27
R,61,kaist_dataset/English/Digital_Camera/(E.S)C-outdoor3/u.jpg,char_data/R/u.jpg_2.jpg,3111,240,320,51,107,158,75,136,True,27
R,42,kaist_dataset/English/Digital_Camera/(E.S)C-outdoor3/크기변환_%B0%A3%C6%C71_m_starfirm.jpg,char_data/R/크기변환_%B0%A3%C6%C71_m_starfirm.jpg_6.jpg,1512,480,640,36,121,157,278,320,True,27
R,35,kaist_dataset/English/Digital_Camera/(E.S)C-outdoor3/크기변환_%B0%A3%C6%C71_m_starfirm.jpg,char_data/R/크기변환_%B0%A3%C6%C71_m_starfirm.jpg_7.jpg,1085,480,640,31,364,395,280,315,True,27
R,67,kaist_dataset/English/Digital_Camera/(E.S)C-outdoor3/크기변환_P1010028.JPG,char_data/R/크기변환_P1010028.JPG_2.jpg,2680,480,640,40,247,287,164,231,True,27
R,53,kaist_dataset/English/Digital_Camera/(E.S)C-outdoor3/크기변환_P1010076.JPG,char_data/R/크기변환_P1010076.JPG_4.jpg,2120,480,640,40,390,430,119,172,True,27
R,33,kaist_dataset/English/Digital_Camera/(E.S)D-indoor/308.jpg,char_data/R/308.jpg_2.jpg,759,212,385,23,196,219,48,81,True,27
R,66,kaist_dataset/English/Digital_Camera/(E.S)D-indoor/DSC02769.JPG,char_data/R/DSC02769.JPG_2.jpg,3036,480,640,46,507,553,216,282,True,27
R,87,kaist_dataset/English/Digital_Camera/(E.S)D-indoor/DSC02850.JPG,char_data/R/DSC02850.JPG_2.jpg,6264,480,640,72,480,552,158,245,True,27
R,107,kaist_dataset/English/Digital_Camera/(E.S)D-indoor/DSC02862.JPG,char_data/R/DSC02862.JPG_4.jpg,10379,480,640,97,32,129,215,322,True,27
R,61,kaist_dataset/English/Digital_Camera/(E.S)D-indoor/DSC03071.JPG,char_data/R/DSC03071.JPG_4.jpg,2074,480,640,34,329,363,223,284,True,27
R,52,kaist_dataset/English/Digital_Camera/(E.S)D-indoor/DSC03071.JPG,char_data/R/DSC03071.JPG_5.jpg,1872,480,640,36,402,438,231,283,True,27
R,97,kaist_dataset/English/Digital_Camera/(E.S)D-indoor/DSC03085.JPG,char_data/R/DSC03085.JPG_6.jpg,8924,480,640,92,274,366,155,252,True,27
R,70,kaist_dataset/English/Digital_Camera/(E.S)D-indoor/DSC03085.JPG,char_data/R/DSC03085.JPG_7.jpg,2940,480,640,42,332,374,365,435,True,27
R,45,kaist_dataset/English/Digital_Camera/(E.S)D-indoor/DSC03090.JPG,char_data/R/DSC03090.JPG_9.jpg,1125,480,640,25,334,359,289,334,True,27
R,47,kaist_dataset/English/Digital_Camera/(E.S)D-indoor/DSC03090.JPG,char_data/R/DSC03090.JPG_11.jpg,1081,480,640,23,437,460,288,335,True,27
R,67,kaist_dataset/English/Digital_Camera/(E.S)D-indoor/DSC03091.JPG,char_data/R/DSC03091.JPG_2.jpg,3082,480,640,46,435,481,201,268,True,27
R,86,kaist_dataset/English/Digital_Camera/(E.S)D-indoor/DSC03365.JPG,char_data/R/DSC03365.JPG_2.jpg,6880,480,640,80,447,527,365,451,True,27
R,85,kaist_dataset/English/Digital_Camera/(E.S)D-indoor/DSC03367.JPG,char_data/R/DSC03367.JPG_2.jpg,6205,480,640,73,383,456,32,117,True,27
R,63,kaist_dataset/English/Digital_Camera/(E.S)D-indoor/DSC03396.JPG,char_data/R/DSC03396.JPG_4.jpg,3087,480,640,49,484,533,220,283,True,27
R,48,kaist_dataset/English/Digital_Camera/(E.S)D-indoor/DSC03401.JPG,char_data/R/DSC03401.JPG_2.jpg,1488,480,640,31,393,424,234,282,True,27
R,87,kaist_dataset/English/Digital_Camera/(E.S)D-indoor/DSC03402.JPG,char_data/R/DSC03402.JPG_2.jpg,7308,480,640,84,370,454,183,270,True,27
R,68,kaist_dataset/English/Digital_Camera/(E.S)D-indoor/DSC03403.JPG,char_data/R/DSC03403.JPG_2.jpg,4012,480,640,59,336,395,198,266,True,27
R,52,kaist_dataset/English/Digital_Camera/(E.S)D-indoor/DSC03467.JPG,char_data/R/DSC03467.JPG_4.jpg,2080,480,640,40,153,193,149,201,True,27
R,64,kaist_dataset/English/Digital_Camera/(E.S)D-indoor/DSC03467.JPG,char_data/R/DSC03467.JPG_5.jpg,2752,480,640,43,479,522,151,215,True,27
R,38,kaist_dataset/English/Digital_Camera/(E.S)D-indoor/DSC03532.JPG,char_data/R/DSC03532.JPG_9.jpg,988,480,640,26,200,226,374,412,True,27
R,65,kaist_dataset/English/Digital_Camera/(E.S)D-indoor/DSC03887.JPG,char_data/R/DSC03887.JPG_2.jpg,3640,480,640,56,211,267,168,233,True,27
R,37,kaist_dataset/English/Digital_Camera/(E.S)D-indoor/DSC03896.JPG,char_data/R/DSC03896.JPG_2.jpg,1221,480,640,33,418,451,354,391,True,27
R,38,kaist_dataset/English/Digital_Camera/(E.S)D-indoor/DSC03901.JPG,char_data/R/DSC03901.JPG_10.jpg,950,480,640,25,261,286,261,299,True,27
R,32,kaist_dataset/English/Digital_Camera/(E.S)D-indoor/DSC03901.JPG,char_data/R/DSC03901.JPG_11.jpg,768,480,640,24,435,459,259,291,True,27
R,60,kaist_dataset/English/Digital_Camera/(E.S)D-indoor/DSC03901.JPG,char_data/R/DSC03901.JPG_12.jpg,2160,480,640,36,254,290,171,231,True,27
R,74,kaist_dataset/English/Digital_Camera/(E.S)D-indoor/DSC03901.JPG,char_data/R/DSC03901.JPG_13.jpg,4736,480,640,64,319,383,164,238,True,27
R,34,kaist_dataset/English/Digital_Camera/(E.S)D-indoor/DSC03901.JPG,char_data/R/DSC03901.JPG_14.jpg,816,480,640,24,336,360,122,156,True,27
R,124,kaist_dataset/English/Digital_Camera/(E.S)D-indoor/DSC03911.JPG,char_data/R/DSC03911.JPG_2.jpg,11160,480,640,90,110,200,322,446,True,27
R,65,kaist_dataset/English/Digital_Camera/(E.S)D-indoor/DSC03918.JPG,char_data/R/DSC03918.JPG_2.jpg,2015,480,640,31,217,248,401,466,True,27
R,37,kaist_dataset/English/Digital_Camera/(E.S)D-indoor/DSC03935.JPG,char_data/R/DSC03935.JPG_4.jpg,777,480,640,21,158,179,39,76,True,27
R,39,kaist_dataset/English/Digital_Camera/(E.S)D-indoor/DSC03935.JPG,char_data/R/DSC03935.JPG_5.jpg,897,480,640,23,440,463,51,90,True,27
R,29,kaist_dataset/English/Digital_Camera/(E.S)D-indoor/DSC03943.JPG,char_data/R/DSC03943.JPG_2.jpg,522,480,640,18,241,259,315,344,True,27
R,20,kaist_dataset/English/Digital_Camera/(E.S)D-indoor/z.jpg,char_data/R/z.jpg_2.jpg,260,240,320,13,131,144,74,94,True,27
R,22,kaist_dataset/English/Digital_Camera/(E.S)E-night/111.jpg,char_data/R/111.jpg_4.jpg,176,480,640,8,294,302,284,306,True,27
R,16,kaist_dataset/English/Digital_Camera/(E.S)E-night/111.jpg,char_data/R/111.jpg_5.jpg,160,480,640,10,244,254,264,280,True,27
R,99,kaist_dataset/English/Digital_Camera/(E.S)E-night/DSC02641.JPG,char_data/R/DSC02641.JPG_4.jpg,5841,480,640,59,86,145,274,373,True,27
R,93,kaist_dataset/English/Digital_Camera/(E.S)E-night/DSC02641.JPG,char_data/R/DSC02641.JPG_5.jpg,4929,480,640,53,507,560,268,361,True,27
R,94,kaist_dataset/English/Digital_Camera/(E.S)E-night/DSC02674.JPG,char_data/R/DSC02674.JPG_2.jpg,8648,480,640,92,399,491,198,292,True,27
R,37,kaist_dataset/English/Digital_Camera/(E.S)E-night/t.jpg,char_data/R/t.jpg_2.jpg,740,240,320,20,88,108,70,107,True,27
R,50,kaist_dataset/English/Digital_Camera/(E.S)F-others/080119-0007.jpg,char_data/R/080119-0007.jpg_13.jpg,2500,1200,1600,50,1231,1281,843,893,True,27
R,31,kaist_dataset/English/Digital_Camera/(E.S)F-others/080119-0007.jpg,char_data/R/080119-0007.jpg_14.jpg,1054,1200,1600,34,220,254,473,504,True,27
R,51,kaist_dataset/English/Digital_Camera/(E.S)F-others/080119-0007.jpg,char_data/R/080119-0007.jpg_15.jpg,1173,1200,1600,23,248,271,600,651,True,27
R,144,kaist_dataset/English/Digital_Camera/(E.S)F-others/080119-0014.jpg,char_data/R/080119-0014.jpg_2.jpg,13680,1200,1600,95,1222,1317,706,850,True,27
R,236,kaist_dataset/English/Digital_Camera/(E.S)F-others/080119-0016.jpg,char_data/R/080119-0016.jpg_2.jpg,40120,1200,1600,170,990,1160,455,691,True,27
R,124,kaist_dataset/English/Digital_Camera/(E.S)F-others/2007-12-09-day-exterior-047.jpg,char_data/R/2007-12-09-day-exterior-047.jpg_2.jpg,14632,1200,1600,118,447,565,453,577,True,27
R,54,kaist_dataset/English/Digital_Camera/(E.S)F-others/DSC02884.JPG,char_data/R/DSC02884.JPG_2.jpg,1836,480,640,34,256,290,75,129,True,27
R,40,kaist_dataset/English/Digital_Camera/(E.S)F-others/DSC03218.JPG,char_data/R/DSC03218.JPG_2.jpg,1560,480,640,39,304,343,317,357,True,27
R,87,kaist_dataset/English/Digital_Camera/(E.S)F-others/DSC03291.JPG,char_data/R/DSC03291.JPG_2.jpg,5046,480,640,58,442,500,220,307,True,27
R,61,kaist_dataset/English/Digital_Camera/(E.S)F-others/크기변환_%B0%A3%C6%C77_m_starfirm.jpg,char_data/R/크기변환_%B0%A3%C6%C77_m_starfirm.jpg_2.jpg,2379,480,640,39,325,364,174,235,True,27
R,125,kaist_dataset/English/Mobile_Phone/(E.M)B-indoor/P090911080.jpg,char_data/R/P090911080.jpg_4.jpg,9875,480,640,79,105,184,181,306,True,27
R,121,kaist_dataset/English/Mobile_Phone/(E.M)B-indoor/P090911081.jpg,char_data/R/P090911081.jpg_2.jpg,10406,480,640,86,541,627,165,286,True,27
R,63,kaist_dataset/English/Mobile_Phone/(E.M)B-indoor/P090911084.jpg,char_data/R/P090911084.jpg_4.jpg,2835,480,640,45,37,82,148,211,True,27
R,129,kaist_dataset/English/Mobile_Phone/(E.M)C-bookCover/P090831037.jpg,char_data/R/P090831037.jpg_4.jpg,14061,480,640,109,492,601,62,191,True,27
R,133,kaist_dataset/English/Mobile_Phone/(E.M)C-bookCover/P090831037.jpg,char_data/R/P090831037.jpg_5.jpg,14497,480,640,109,188,297,189,322,True,27
R,83,kaist_dataset/English/Mobile_Phone/(E.M)C-bookCover/P090831042.jpg,char_data/R/P090831042.jpg_2.jpg,5478,480,640,66,276,342,194,277,True,27
R,75,kaist_dataset/English/Mobile_Phone/(E.M)C-bookCover/P090831075.jpg,char_data/R/P090831075.jpg_4.jpg,3375,480,640,45,133,178,149,224,True,27
R,63,kaist_dataset/English/Mobile_Phone/(E.M)C-bookCover/P090831075.jpg,char_data/R/P090831075.jpg_5.jpg,2646,480,640,42,270,312,280,343,True,27
R,48,kaist_dataset/English/Mobile_Phone/(E.M)C-bookCover/P090903015.jpg,char_data/R/P090903015.jpg_6.jpg,1392,480,640,29,456,485,76,124,True,27
R,45,kaist_dataset/English/Mobile_Phone/(E.M)C-bookCover/P090903015.jpg,char_data/R/P090903015.jpg_7.jpg,1665,480,640,37,195,232,150,195,True,27
R,45,kaist_dataset/English/Mobile_Phone/(E.M)C-bookCover/P090903015.jpg,char_data/R/P090903015.jpg_8.jpg,1260,480,640,28,373,401,146,191,True,27
R,64,kaist_dataset/English/Mobile_Phone/(E.M)C-bookCover/P090903041.jpg,char_data/R/P090903041.jpg_2.jpg,2624,480,640,41,347,388,24,88,True,27
R,59,kaist_dataset/English/Mobile_Phone/(E.M)C-bookCover/P090903054.jpg,char_data/R/P090903054.jpg_7.jpg,2183,480,640,37,172,209,352,411,True,27
R,68,kaist_dataset/English/Mobile_Phone/(E.M)C-bookCover/P090903054.jpg,char_data/R/P090903054.jpg_8.jpg,2448,480,640,36,419,455,343,411,True,27
R,40,kaist_dataset/English/Mobile_Phone/(E.M)C-bookCover/P090903055.jpg,char_data/R/P090903055.jpg_6.jpg,1240,480,640,31,247,278,71,111,True,27
R,87,kaist_dataset/English/Mobile_Phone/(E.M)C-bookCover/P090903055.jpg,char_data/R/P090903055.jpg_7.jpg,7482,480,640,86,116,202,159,246,True,27
R,34,kaist_dataset/English/Mobile_Phone/(E.M)C-bookCover/P090903055.jpg,char_data/R/P090903055.jpg_8.jpg,1428,480,640,42,474,516,408,442,True,27
R,53,kaist_dataset/English/Mobile_Phone/(E.M)C-bookCover/P090903056.jpg,char_data/R/P090903056.jpg_4.jpg,2597,480,640,49,227,276,195,248,True,27
R,92,kaist_dataset/English/Mobile_Phone/(E.M)C-bookCover/P090903056.jpg,char_data/R/P090903056.jpg_5.jpg,8004,480,640,87,100,187,301,393,True,27
R,66,kaist_dataset/English/Mobile_Phone/(E.M)C-bookCover/P090903071.jpg,char_data/R/P090903071.jpg_4.jpg,3960,480,640,60,213,273,224,290,True,27
R,37,kaist_dataset/English/Mobile_Phone/(E.M)C-bookCover/P090903071.jpg,char_data/R/P090903071.jpg_5.jpg,851,480,640,23,340,363,302,339,True,27
R,103,kaist_dataset/English/Mobile_Phone/(E.M)C-bookCover/P090903076.jpg,char_data/R/P090903076.jpg_4.jpg,7519,480,640,73,152,225,281,384,True,27
R,50,kaist_dataset/English/Mobile_Phone/(E.M)C-bookCover/P090903076.jpg,char_data/R/P090903076.jpg_5.jpg,1550,480,640,31,332,363,391,441,True,27
R,73,kaist_dataset/English/Mobile_Phone/(E.M)C-bookCover/P090905007.jpg,char_data/R/P090905007.jpg_2.jpg,5183,480,640,71,279,350,293,366,True,27
R,42,kaist_dataset/Korean/Digital_Camera/A-shadow/2007-12-09-day-exterior-031.jpg,char_data/R/2007-12-09-day-exterior-031.jpg_7.jpg,1092,1200,1600,26,428,454,606,648,True,27
R,20,kaist_dataset/Korean/Digital_Camera/E-night/103.jpg,char_data/R/103.jpg_2.jpg,180,480,640,9,337,346,153,173,True,27
R,33,kaist_dataset/Korean/Digital_Camera/indoor1/2007-12-08-day-139.jpg,char_data/R/2007-12-08-day-139.jpg_4.jpg,660,1200,1600,20,472,492,354,387,True,27
R,31,kaist_dataset/Korean/Digital_Camera/indoor1/2007-12-08-day-139.jpg,char_data/R/2007-12-08-day-139.jpg_5.jpg,744,1200,1600,24,534,558,355,386,True,27
R,31,kaist_dataset/Korean/Digital_Camera/outdoor2/2007-12-08-day-094.jpg,char_data/R/2007-12-08-day-094.jpg_2.jpg,713,1600,1200,23,625,648,1422,1453,True,27
R,67,kaist_dataset/Korean/Digital_Camera/outdoor2/2007-12-08-day-109.jpg,char_data/R/2007-12-08-day-109.jpg_2.jpg,3417,1200,1600,51,16,67,799,866,True,27
R,40,kaist_dataset/Mixed/Digital_Camera/(C.S)A-shadow/DSC02568.JPG,char_data/R/DSC02568.JPG_4.jpg,1560,480,640,39,169,208,144,184,True,27
R,110,kaist_dataset/Mixed/Digital_Camera/(C.S)C-outdoor1/027.JPG,char_data/R/027.JPG_2.jpg,7590,480,640,69,306,375,162,272,True,27
R,80,kaist_dataset/Mixed/Digital_Camera/(C.S)C-outdoor1/038.JPG,char_data/R/038.JPG_2.jpg,3440,480,640,43,547,590,214,294,True,27
R,40,kaist_dataset/Mixed/Digital_Camera/(C.S)C-outdoor1/080.JPG,char_data/R/080.JPG_2.jpg,1560,480,640,39,15,54,103,143,True,27
R,58,kaist_dataset/Mixed/Digital_Camera/(C.S)C-outdoor1/080119-0006.jpg,char_data/R/080119-0006.jpg_4.jpg,2378,1200,1600,41,692,733,736,794,True,27
R,61,kaist_dataset/Mixed/Digital_Camera/(C.S)C-outdoor1/080119-0006.jpg,char_data/R/080119-0006.jpg_5.jpg,2867,1200,1600,47,1010,1057,738,799,True,27
R,169,kaist_dataset/Mixed/Digital_Camera/(C.S)C-outdoor1/080119-0017.jpg,char_data/R/080119-0017.jpg_2.jpg,21970,1200,1600,130,595,725,559,728,True,27
R,75,kaist_dataset/Mixed/Digital_Camera/(C.S)C-outdoor1/080119-0027.jpg,char_data/R/080119-0027.jpg_4.jpg,3600,1200,1600,48,976,1024,720,795,True,27
R,85,kaist_dataset/Mixed/Digital_Camera/(C.S)C-outdoor1/080119-0027.jpg,char_data/R/080119-0027.jpg_5.jpg,4845,1200,1600,57,1118,1175,716,801,True,27
R,129,kaist_dataset/Mixed/Digital_Camera/(C.S)C-outdoor1/080119-0037.jpg,char_data/R/080119-0037.jpg_4.jpg,8514,1200,1600,66,729,795,852,981,True,27
R,107,kaist_dataset/Mixed/Digital_Camera/(C.S)C-outdoor1/080119-0037.jpg,char_data/R/080119-0037.jpg_5.jpg,6206,1200,1600,58,1373,1431,831,938,True,27
R,77,kaist_dataset/Mixed/Digital_Camera/(C.S)C-outdoor1/1.JPG,char_data/R/1.JPG_7.jpg,3234,576,768,42,216,258,196,273,True,27
R,63,kaist_dataset/Mixed/Digital_Camera/(C.S)C-outdoor1/1.JPG,char_data/R/1.JPG_8.jpg,2331,576,768,37,597,634,205,268,True,27
R,138,kaist_dataset/Mixed/Digital_Camera/(C.S)C-outdoor1/113.JPG,char_data/R/113.JPG_5.jpg,7176,480,640,52,260,312,76,214,True,27
R,34,kaist_dataset/Mixed/Digital_Camera/(C.S)C-outdoor1/114.jpg,char_data/R/114.jpg_2.jpg,1190,480,640,35,217,252,312,346,True,27
R,63,kaist_dataset/Mixed/Digital_Camera/(C.S)C-outdoor1/2.JPG,char_data/R/2.JPG_8.jpg,3276,576,768,52,557,609,208,271,True,27
R,21,kaist_dataset/Mixed/Digital_Camera/(C.S)C-outdoor1/2.JPG,char_data/R/2.JPG_10.jpg,294,576,768,14,568,582,372,393,True,27
R,23,kaist_dataset/Mixed/Digital_Camera/(C.S)C-outdoor1/2.JPG,char_data/R/2.JPG_11.jpg,368,576,768,16,632,648,371,394,True,27
R,67,kaist_dataset/Mixed/Digital_Camera/(C.S)C-outdoor1/2007-12-08-day-091.jpg,char_data/R/2007-12-08-day-091.jpg_2.jpg,3283,1200,1600,49,384,433,600,667,True,27
R,82,kaist_dataset/Mixed/Digital_Camera/(C.S)C-outdoor1/2007-12-09-day-exterior-051.jpg,char_data/R/2007-12-09-day-exterior-051.jpg_8.jpg,7298,1200,1600,89,589,678,375,457,True,27
R,83,kaist_dataset/Mixed/Digital_Camera/(C.S)C-outdoor1/2007-12-09-day-exterior-051.jpg,char_data/R/2007-12-09-day-exterior-051.jpg_9.jpg,7636,1200,1600,92,671,763,376,459,True,27
R,31,kaist_dataset/Mixed/Digital_Camera/(C.S)C-outdoor1/2007-12-09-day-exterior-051.jpg,char_data/R/2007-12-09-day-exterior-051.jpg_10.jpg,589,1200,1600,19,519,538,679,710,True,27
R,29,kaist_dataset/Mixed/Digital_Camera/(C.S)C-outdoor1/2007-12-09-day-exterior-051.jpg,char_data/R/2007-12-09-day-exterior-051.jpg_11.jpg,580,1200,1600,20,560,580,643,672,True,27
R,19,kaist_dataset/Mixed/Digital_Camera/(C.S)C-outdoor1/3.JPG,char_data/R/3.JPG_2.jpg,190,576,768,10,665,675,295,314,True,27
R,28,kaist_dataset/Mixed/Digital_Camera/(C.S)C-outdoor1/DSC02240.JPG,char_data/R/DSC02240.JPG_2.jpg,840,480,640,30,178,208,285,313,True,27
R,92,kaist_dataset/Mixed/Digital_Camera/(C.S)C-outdoor1/DSC02344.JPG,char_data/R/DSC02344.JPG_2.jpg,5060,480,640,55,73,128,134,226,True,27
R,56,kaist_dataset/Mixed/Digital_Camera/(C.S)C-outdoor1/P1010009.JPG,char_data/R/P1010009.JPG_2.jpg,2408,480,640,43,224,267,184,240,True,27
R,73,kaist_dataset/Mixed/Digital_Camera/(C.S)C-outdoor2/DSC02385.JPG,char_data/R/DSC02385.JPG_4.jpg,4234,480,640,58,513,571,164,237,True,27
R,30,kaist_dataset/Mixed/Digital_Camera/(C.S)C-outdoor2/DSC02391.JPG,char_data/R/DSC02391.JPG_2.jpg,690,480,640,23,392,415,334,364,True,27
R,22,kaist_dataset/Mixed/Digital_Camera/(C.S)C-outdoor2/DSC02397.JPG,char_data/R/DSC02397.JPG_2.jpg,396,480,640,18,61,79,142,164,True,27
R,37,kaist_dataset/Mixed/Digital_Camera/(C.S)C-outdoor2/DSC02429.JPG,char_data/R/DSC02429.JPG_2.jpg,999,480,640,27,428,455,115,152,True,27
R,57,kaist_dataset/Mixed/Digital_Camera/(C.S)C-outdoor2/DSC02439.JPG,char_data/R/DSC02439.JPG_4.jpg,3249,480,640,57,458,515,135,192,True,27
R,27,kaist_dataset/Mixed/Digital_Camera/(C.S)C-outdoor2/DSC02477.JPG,char_data/R/DSC02477.JPG_2.jpg,405,480,640,15,71,86,158,185,True,27
R,26,kaist_dataset/Mixed/Digital_Camera/(C.S)C-outdoor2/DSC02555.JPG,char_data/R/DSC02555.JPG_2.jpg,390,480,640,15,78,93,152,178,True,27
R,40,kaist_dataset/Mixed/Digital_Camera/(C.S)C-outdoor2/DSC02568.JPG,char_data/R/DSC02568.JPG_5.jpg,1560,480,640,39,169,208,144,184,True,27
R,48,kaist_dataset/Mixed/Digital_Camera/(C.S)C-outdoor2/DSC02872.JPG,char_data/R/DSC02872.JPG_2.jpg,1056,480,640,22,293,315,216,264,True,27
R,46,kaist_dataset/Mixed/Digital_Camera/(C.S)C-outdoor2/DSC02924.JPG,char_data/R/DSC02924.JPG_4.jpg,1702,480,640,37,388,425,320,366,True,27
R,43,kaist_dataset/Mixed/Digital_Camera/(C.S)C-outdoor2/DSC02924.JPG,char_data/R/DSC02924.JPG_5.jpg,1505,480,640,35,425,460,323,366,True,27
R,61,kaist_dataset/Mixed/Digital_Camera/(C.S)C-outdoor3/DSC02962.JPG,char_data/R/DSC02962.JPG_6.jpg,3172,480,640,52,212,264,256,317,True,27
R,31,kaist_dataset/Mixed/Digital_Camera/(C.S)C-outdoor3/DSC03020.JPG,char_data/R/DSC03020.JPG_2.jpg,713,480,640,23,367,390,268,299,True,27
R,24,kaist_dataset/Mixed/Digital_Camera/(C.S)C-outdoor3/DSC03033.JPG,char_data/R/DSC03033.JPG_4.jpg,288,480,640,12,104,116,129,153,True,27
R,24,kaist_dataset/Mixed/Digital_Camera/(C.S)C-outdoor3/DSC03033.JPG,char_data/R/DSC03033.JPG_5.jpg,312,480,640,13,98,111,152,176,True,27
R,39,kaist_dataset/Mixed/Digital_Camera/(C.S)C-outdoor3/DSC03035.JPG,char_data/R/DSC03035.JPG_2.jpg,897,480,640,23,395,418,403,442,True,27
R,77,kaist_dataset/Mixed/Digital_Camera/(C.S)C-outdoor3/DSC03055.JPG,char_data/R/DSC03055.JPG_2.jpg,5467,480,640,71,129,200,256,333,True,27
R,51,kaist_dataset/Mixed/Digital_Camera/(C.S)C-outdoor3/DSC03061.JPG,char_data/R/DSC03061.JPG_2.jpg,2346,480,640,46,250,296,150,201,True,27
R,83,kaist_dataset/Mixed/Digital_Camera/(C.S)C-outdoor3/DSC03164.JPG,char_data/R/DSC03164.JPG_2.jpg,6225,480,640,75,215,290,76,159,True,27
R,124,kaist_dataset/Mixed/Digital_Camera/(C.S)C-outdoor3/DSC03186.JPG,char_data/R/DSC03186.JPG_2.jpg,14880,480,640,120,486,606,34,158,True,27
R,33,kaist_dataset/Mixed/Digital_Camera/(C.S)C-outdoor3/DSC03209.JPG,char_data/R/DSC03209.JPG_6.jpg,858,480,640,26,205,231,417,450,True,27
R,31,kaist_dataset/Mixed/Digital_Camera/(C.S)C-outdoor3/DSC03209.JPG,char_data/R/DSC03209.JPG_7.jpg,899,480,640,29,271,300,421,452,True,27
R,41,kaist_dataset/Mixed/Digital_Camera/(C.S)C-outdoor3/DSC03210.JPG,char_data/R/DSC03210.JPG_4.jpg,984,480,640,24,173,197,143,184,True,27
R,23,kaist_dataset/Mixed/Digital_Camera/(C.S)C-outdoor3/DSC03255.JPG,char_data/R/DSC03255.JPG_2.jpg,345,480,640,15,538,553,178,201,True,27
R,66,kaist_dataset/Mixed/Digital_Camera/(C.S)C-outdoor3/DSC03306.JPG,char_data/R/DSC03306.JPG_2.jpg,2178,480,640,33,348,381,388,454,True,27
R,71,kaist_dataset/Mixed/Digital_Camera/(C.S)C-outdoor3/DSC03415.JPG,char_data/R/DSC03415.JPG_2.jpg,2911,480,640,41,399,440,165,236,True,27
R,87,kaist_dataset/Mixed/Digital_Camera/(C.S)C-outdoor4/DSC03571.JPG,char_data/R/DSC03571.JPG_2.jpg,4524,480,640,52,473,525,187,274,True,27
R,150,kaist_dataset/Mixed/Digital_Camera/(C.S)C-outdoor4/DSC03635.JPG,char_data/R/DSC03635.JPG_2.jpg,19950,480,640,133,57,190,97,247,True,27
R,159,kaist_dataset/Mixed/Digital_Camera/(C.S)C-outdoor4/DSC03638.JPG,char_data/R/DSC03638.JPG_2.jpg,16854,480,640,106,101,207,54,213,True,27
R,81,kaist_dataset/Mixed/Digital_Camera/(C.S)C-outdoor4/DSC03666.JPG,char_data/R/DSC03666.JPG_2.jpg,4779,480,640,59,413,472,161,242,True,27
R,29,kaist_dataset/Mixed/Digital_Camera/(C.S)C-outdoor4/DSC03670.JPG,char_data/R/DSC03670.JPG_4.jpg,667,480,640,23,400,423,321,350,True,27
R,39,kaist_dataset/Mixed/Digital_Camera/(C.S)C-outdoor4/DSC03679.JPG,char_data/R/DSC03679.JPG_2.jpg,975,480,640,25,94,119,99,138,True,27
R,25,kaist_dataset/Mixed/Digital_Camera/(C.S)C-outdoor4/DSC03687.JPG,char_data/R/DSC03687.JPG_4.jpg,475,480,640,19,114,133,296,321,True,27
R,28,kaist_dataset/Mixed/Digital_Camera/(C.S)C-outdoor4/DSC03687.JPG,char_data/R/DSC03687.JPG_5.jpg,448,480,640,16,204,220,294,322,True,27
R,55,kaist_dataset/Mixed/Digital_Camera/(C.S)C-outdoor4/DSC03707.JPG,char_data/R/DSC03707.JPG_2.jpg,2035,480,640,37,173,210,88,143,True,27
R,37,kaist_dataset/Mixed/Digital_Camera/(C.S)C-outdoor4/DSC03716.JPG,char_data/R/DSC03716.JPG_2.jpg,481,480,640,13,375,388,238,275,True,27
R,42,kaist_dataset/Mixed/Digital_Camera/(C.S)C-outdoor4/DSC03764.JPG,char_data/R/DSC03764.JPG_2.jpg,1092,480,640,26,372,398,226,268,True,27
R,76,kaist_dataset/Mixed/Digital_Camera/(C.S)C-outdoor4/DSC03784.JPG,char_data/R/DSC03784.JPG_4.jpg,4028,480,640,53,290,343,306,382,True,27
R,25,kaist_dataset/Mixed/Digital_Camera/(C.S)C-outdoor5/DSC03829.JPG,char_data/R/DSC03829.JPG_2.jpg,525,480,640,21,322,343,179,204,False,27
R,38,kaist_dataset/Mixed/Digital_Camera/(C.S)C-outdoor5/DSC04057.JPG,char_data/R/DSC04057.JPG_4.jpg,1102,480,640,29,193,222,114,152,False,27
R,59,kaist_dataset/Mixed/Digital_Camera/(C.S)C-outdoor5/DSC04059.JPG,char_data/R/DSC04059.JPG_4.jpg,1711,480,640,29,489,518,117,176,False,27
R,62,kaist_dataset/Mixed/Digital_Camera/(C.S)C-outdoor5/DSC04059.JPG,char_data/R/DSC04059.JPG_5.jpg,1922,480,640,31,571,602,115,177,False,27
R,58,kaist_dataset/Mixed/Digital_Camera/(C.S)C-outdoor5/DSC04060.JPG,char_data/R/DSC04060.JPG_4.jpg,1972,480,640,34,352,386,176,234,False,27
R,54,kaist_dataset/Mixed/Digital_Camera/(C.S)C-outdoor5/DSC04060.JPG,char_data/R/DSC04060.JPG_5.jpg,1890,480,640,35,451,486,174,228,False,27
R,48,kaist_dataset/Mixed/Digital_Camera/(C.S)C-outdoor5/DSC04119.JPG,char_data/R/DSC04119.JPG_2.jpg,1632,480,640,34,436,470,134,182,False,27
R,44,kaist_dataset/Mixed/Digital_Camera/(C.S)C-outdoor5/DSC04305.JPG,char_data/R/DSC04305.JPG_4.jpg,1408,480,640,32,406,438,84,128,False,27
R,43,kaist_dataset/Mixed/Digital_Camera/(C.S)C-outdoor5/DSC04305.JPG,char_data/R/DSC04305.JPG_5.jpg,1247,480,640,29,576,605,82,125,False,27
R,37,kaist_dataset/Mixed/Digital_Camera/(C.S)C-outdoor5/DSC04434.JPG,char_data/R/DSC04434.JPG_2.jpg,1221,480,640,33,366,399,389,426,False,27
R,35,kaist_dataset/Mixed/Digital_Camera/(C.S)C-outdoor5/P1010004.JPG,char_data/R/P1010004.JPG_2.jpg,1540,480,640,44,499,543,299,334,False,27
R,35,kaist_dataset/Mixed/Digital_Camera/(C.S)C-outdoor6/DSC03324.JPG,char_data/R/DSC03324.JPG_2.jpg,840,480,640,24,62,86,57,92,False,27
R,20,kaist_dataset/Mixed/Digital_Camera/(C.S)C-outdoor6/P1010063.JPG,char_data/R/P1010063.JPG_4.jpg,280,480,640,14,291,305,412,432,False,27
R,26,kaist_dataset/Mixed/Digital_Camera/(C.S)C-outdoor6/P1010063.JPG,char_data/R/P1010063.JPG_5.jpg,286,480,640,11,319,330,400,426,False,27
R,24,kaist_dataset/Mixed/Digital_Camera/(C.S)C-outdoor6/P1010065.JPG,char_data/R/P1010065.JPG_6.jpg,288,480,640,12,81,93,103,127,False,27
R,24,kaist_dataset/Mixed/Digital_Camera/(C.S)C-outdoor6/P1010065.JPG,char_data/R/P1010065.JPG_7.jpg,408,480,640,17,135,152,105,129,False,27
R,18,kaist_dataset/Mixed/Digital_Camera/(C.S)C-outdoor6/P1010065.JPG,char_data/R/P1010065.JPG_8.jpg,252,480,640,14,212,226,107,125,False,27
R,31,kaist_dataset/Mixed/Digital_Camera/(C.S)C-outdoor6/P1010088.JPG,char_data/R/P1010088.JPG_6.jpg,682,480,640,22,418,440,178,209,False,27
R,36,kaist_dataset/Mixed/Digital_Camera/(C.S)C-outdoor6/P1010088.JPG,char_data/R/P1010088.JPG_7.jpg,612,480,640,17,491,508,172,208,False,27
R,25,kaist_dataset/Mixed/Digital_Camera/(C.S)C-outdoor6/P1010088.JPG,char_data/R/P1010088.JPG_8.jpg,650,480,640,26,549,575,177,202,False,27
R,34,kaist_dataset/Mixed/Digital_Camera/(C.S)C-outdoor6/P1010090.JPG,char_data/R/P1010090.JPG_4.jpg,646,480,640,19,413,432,199,233,False,27
R,35,kaist_dataset/Mixed/Digital_Camera/(C.S)C-outdoor6/P1010090.JPG,char_data/R/P1010090.JPG_5.jpg,945,480,640,27,462,489,199,234,False,27
R,33,kaist_dataset/Mixed/Digital_Camera/(C.S)C-outdoor6/P1010095.JPG,char_data/R/P1010095.JPG_2.jpg,924,480,640,28,73,101,176,209,False,27
R,25,kaist_dataset/Mixed/Digital_Camera/(C.S)C-outdoor6/P1010114.JPG,char_data/R/P1010114.JPG_2.jpg,500,480,640,20,390,410,222,247,False,27
R,76,kaist_dataset/Mixed/Digital_Camera/(C.S)D-indoor1/DSC02714.JPG,char_data/R/DSC02714.JPG_2.jpg,5472,480,640,72,151,223,112,188,False,27
R,42,kaist_dataset/Mixed/Digital_Camera/(C.S)D-indoor1/DSC03073.JPG,char_data/R/DSC03073.JPG_10.jpg,1344,480,640,32,308,340,331,373,False,27
R,43,kaist_dataset/Mixed/Digital_Camera/(C.S)D-indoor1/DSC03372.JPG,char_data/R/DSC03372.JPG_2.jpg,2064,480,640,48,547,595,402,445,False,27
R,47,kaist_dataset/Mixed/Digital_Camera/(C.S)D-indoor1/DSC03479.JPG,char_data/R/DSC03479.JPG_2.jpg,1833,480,640,39,193,232,276,323,False,27
R,48,kaist_dataset/Mixed/Digital_Camera/(C.S)D-indoor1/DSC03483.JPG,char_data/R/DSC03483.JPG_2.jpg,1440,480,640,30,346,376,371,419,False,27
R,35,kaist_dataset/Mixed/Digital_Camera/(C.S)D-indoor1/DSC03904.JPG,char_data/R/DSC03904.JPG_2.jpg,665,480,640,19,271,290,214,249,False,27
R,42,kaist_dataset/Mixed/Digital_Camera/(C.S)D-indoor1/DSC03980.JPG,char_data/R/DSC03980.JPG_2.jpg,798,480,640,19,200,219,134,176,False,27
R,41,kaist_dataset/Mixed/Digital_Camera/(C.S)D-indoor1/DSC04183.JPG,char_data/R/DSC04183.JPG_2.jpg,1312,480,640,32,408,440,251,292,False,27
R,46,kaist_dataset/Mixed/Digital_Camera/(C.S)D-indoor1/DSC04206.JPG,char_data/R/DSC04206.JPG_8.jpg,1196,480,640,26,445,471,287,333,False,27
R,47,kaist_dataset/Mixed/Digital_Camera/(C.S)D-indoor1/DSC04244.JPG,char_data/R/DSC04244.JPG_4.jpg,1410,480,640,30,174,204,224,271,False,27
R,42,kaist_dataset/Mixed/Digital_Camera/(C.S)D-indoor1/DSC04244.JPG,char_data/R/DSC04244.JPG_5.jpg,1680,480,640,40,303,343,231,273,False,27
R,43,kaist_dataset/Mixed/Digital_Camera/(C.S)D-indoor2/DSC04248.JPG,char_data/R/DSC04248.JPG_5.jpg,1462,480,640,34,373,407,217,260,False,27
R,42,kaist_dataset/Mixed/Digital_Camera/(C.S)D-indoor2/DSC04249.JPG,char_data/R/DSC04249.JPG_4.jpg,1386,480,640,33,148,181,212,254,False,27
R,46,kaist_dataset/Mixed/Digital_Camera/(C.S)D-indoor2/DSC04249.JPG,char_data/R/DSC04249.JPG_5.jpg,1748,480,640,38,319,357,209,255,False,27
R,46,kaist_dataset/Mixed/Digital_Camera/(C.S)E-night/DSC02574.JPG,char_data/R/DSC02574.JPG_4.jpg,1518,480,640,33,347,380,149,195,False,27
R,67,kaist_dataset/Mixed/Digital_Camera/(C.S)E-night/DSC02660.JPG,char_data/R/DSC02660.JPG_6.jpg,4623,480,640,69,323,392,75,142,False,27
R,32,kaist_dataset/Mixed/Digital_Camera/(C.S)E-night/DSC02660.JPG,char_data/R/DSC02660.JPG_7.jpg,672,480,640,21,280,301,382,414,False,27
R,32,kaist_dataset/Mixed/Digital_Camera/(C.S)E-night/DSC02660.JPG,char_data/R/DSC02660.JPG_8.jpg,704,480,640,22,371,393,382,414,False,27
R,45,kaist_dataset/Mixed/Digital_Camera/(C.S)E-night/DSC02672.JPG,char_data/R/DSC02672.JPG_2.jpg,990,480,640,22,454,476,174,219,False,27
R,40,kaist_dataset/Mixed/Digital_Camera/(C.S)E-night/DSC03871.JPG,char_data/R/DSC03871.JPG_6.jpg,1200,480,640,30,188,218,182,222,False,27
R,39,kaist_dataset/Mixed/Digital_Camera/(C.S)E-night/DSC03871.JPG,char_data/R/DSC03871.JPG_7.jpg,936,480,640,24,316,340,184,223,False,27
R,26,kaist_dataset/Mixed/Digital_Camera/(C.S)E-night/DSC03871.JPG,char_data/R/DSC03871.JPG_8.jpg,650,480,640,25,451,476,196,222,False,27
R,64,kaist_dataset/Mixed/Digital_Camera/(C.S)F-others/2007-12-08-day-113.jpg,char_data/R/2007-12-08-day-113.jpg_2.jpg,2112,1200,1600,33,411,444,273,337,False,27
R,171,kaist_dataset/Mixed/Digital_Camera/(C.S)F-others/2007-12-09-day-exterior-032.jpg,char_data/R/2007-12-09-day-exterior-032.jpg_4.jpg,15219,1600,1200,89,628,717,971,1142,False,27
R,37,kaist_dataset/Mixed/Digital_Camera/(C.S)F-others/DSC02504.JPG,char_data/R/DSC02504.JPG_6.jpg,1221,480,640,33,160,193,271,308,False,27
R,33,kaist_dataset/Mixed/Digital_Camera/(C.S)F-others/DSC02504.JPG,char_data/R/DSC02504.JPG_7.jpg,1155,480,640,35,258,293,301,334,False,27
R,39,kaist_dataset/Mixed/Digital_Camera/(C.S)F-others/DSC02504.JPG,char_data/R/DSC02504.JPG_8.jpg,1092,480,640,28,423,451,333,372,False,27
R,73,kaist_dataset/Mixed/Digital_Camera/(C.S)F-others/DSC02611.JPG,char_data/R/DSC02611.JPG_2.jpg,2555,480,640,35,314,349,88,161,False,27
R,79,kaist_dataset/Mixed/Mobile_Phone/(C.M)B-indoor/P090831008.jpg,char_data/R/P090831008.jpg_2.jpg,5135,480,640,65,315,380,309,388,False,27
R,60,kaist_dataset/Mixed/Mobile_Phone/(C.M)B-indoor/P090831010.jpg,char_data/R/P090831010.jpg_6.jpg,3060,480,640,51,53,104,278,338,False,27
R,64,kaist_dataset/Mixed/Mobile_Phone/(C.M)B-indoor/P090831010.jpg,char_data/R/P090831010.jpg_8.jpg,3392,480,640,53,375,428,277,341,False,27
R,39,kaist_dataset/Mixed/Mobile_Phone/(C.M)B-indoor/P090831021.jpg,char_data/R/P090831021.jpg_4.jpg,1443,480,640,37,437,474,381,420,False,27
R,44,kaist_dataset/Mixed/Mobile_Phone/(C.M)B-indoor/P090831021.jpg,char_data/R/P090831021.jpg_5.jpg,1320,480,640,30,289,319,330,374,False,27
R,49,kaist_dataset/Mixed/Mobile_Phone/(C.M)C-bookCover/P090831124.jpg,char_data/R/P090831124.jpg_2.jpg,2058,480,640,42,213,255,395,444,False,27
R,112,kaist_dataset/Mixed/Mobile_Phone/(C.M)C-bookCover/P090831136.jpg,char_data/R/P090831136.jpg_2.jpg,9744,480,640,87,215,302,220,332,False,27
R,62,kaist_dataset/Mixed/Mobile_Phone/(C.M)C-bookCover/P090902019.jpg,char_data/R/P090902019.jpg_5.jpg,2604,480,640,42,429,471,280,342,False,27
R,99,kaist_dataset/Mixed/Mobile_Phone/(C.M)C-bookCover/P090905002.jpg,char_data/R/P090905002.jpg_2.jpg,7029,480,640,71,213,284,31,130,False,27
C,105,kaist_dataset/English/Digital_Camera/(E.S)A-shadow/DSC02317.JPG,char_data/C/DSC02317.JPG_2.jpg,7875,480,640,75,439,514,202,307,True,14
C,46,kaist_dataset/English/Digital_Camera/(E.S)A-shadow/DSC02423.JPG,char_data/C/DSC02423.JPG_2.jpg,1656,480,640,36,336,372,239,285,True,14
C,109,kaist_dataset/English/Digital_Camera/(E.S)A-shadow/DSC02629.JPG,char_data/C/DSC02629.JPG_4.jpg,7630,480,640,70,65,135,301,410,True,14
C,103,kaist_dataset/English/Digital_Camera/(E.S)A-shadow/DSC02629.JPG,char_data/C/DSC02629.JPG_5.jpg,6901,480,640,67,236,303,304,407,True,14
C,78,kaist_dataset/English/Digital_Camera/(E.S)A-shadow/DSC02857.JPG,char_data/C/DSC02857.JPG_2.jpg,4056,480,640,52,85,137,200,278,True,14
C,95,kaist_dataset/English/Digital_Camera/(E.S)A-shadow/DSC02858.JPG,char_data/C/DSC02858.JPG_2.jpg,5795,480,640,61,3,64,297,392,True,14
C,120,kaist_dataset/English/Digital_Camera/(E.S)A-shadow/P1010035.JPG,char_data/C/P1010035.JPG_2.jpg,14760,480,640,123,441,564,165,285,True,14
C,31,kaist_dataset/English/Digital_Camera/(E.S)A-shadow/P1010044.JPG,char_data/C/P1010044.JPG_2.jpg,775,480,640,25,282,307,186,217,True,14
C,22,kaist_dataset/English/Digital_Camera/(E.S)B-light/080116-0059.jpg,char_data/C/080116-0059.jpg_6.jpg,418,1200,1600,19,624,643,802,824,True,14
C,28,kaist_dataset/English/Digital_Camera/(E.S)B-light/080116-0059.jpg,char_data/C/080116-0059.jpg_7.jpg,504,1200,1600,18,805,823,771,799,True,14
C,32,kaist_dataset/English/Digital_Camera/(E.S)B-light/080116-0059.jpg,char_data/C/080116-0059.jpg_8.jpg,416,1200,1600,13,1160,1173,769,801,True,14
C,65,kaist_dataset/English/Digital_Camera/(E.S)B-light/DSC04200.JPG,char_data/C/DSC04200.JPG_2.jpg,3445,480,640,53,412,465,313,378,True,14
C,64,kaist_dataset/English/Digital_Camera/(E.S)C-outdoor1/035.jpg,char_data/C/035.jpg_2.jpg,2880,210,354,45,186,231,21,85,True,14
C,79,kaist_dataset/English/Digital_Camera/(E.S)C-outdoor1/041.JPG,char_data/C/041.JPG_2.jpg,5214,480,640,66,57,123,208,287,True,14
C,30,kaist_dataset/English/Digital_Camera/(E.S)C-outdoor1/056.JPG,char_data/C/056.JPG_6.jpg,450,480,640,15,226,241,238,268,True,14
C,38,kaist_dataset/English/Digital_Camera/(E.S)C-outdoor1/080116-0065.jpg,char_data/C/080116-0065.jpg_6.jpg,1178,600,800,31,288,319,328,366,True,14
C,41,kaist_dataset/English/Digital_Camera/(E.S)C-outdoor1/080116-0065.jpg,char_data/C/080116-0065.jpg_7.jpg,1025,600,800,25,434,459,338,379,True,14
C,94,kaist_dataset/English/Digital_Camera/(E.S)C-outdoor1/080116-0065.jpg,char_data/C/080116-0065.jpg_8.jpg,5452,600,800,58,455,513,246,340,True,14
C,64,kaist_dataset/English/Digital_Camera/(E.S)C-outdoor1/080118-0011.jpg,char_data/C/080118-0011.jpg_2.jpg,3968,1200,1600,62,803,865,597,661,True,14
C,91,kaist_dataset/English/Digital_Camera/(E.S)C-outdoor1/083.JPG,char_data/C/083.JPG_2.jpg,6370,480,640,70,80,150,180,271,True,14
C,49,kaist_dataset/English/Digital_Camera/(E.S)C-outdoor1/089.jpg,char_data/C/089.jpg_2.jpg,735,480,640,15,175,190,291,340,True,14
C,49,kaist_dataset/English/Digital_Camera/(E.S)C-outdoor1/113.jpg,char_data/C/113.jpg_6.jpg,1911,480,640,39,216,255,170,219,True,14
C,33,kaist_dataset/English/Digital_Camera/(E.S)C-outdoor1/113.jpg,char_data/C/113.jpg_7.jpg,825,480,640,25,288,313,268,301,True,14
C,32,kaist_dataset/English/Digital_Camera/(E.S)C-outdoor1/113.jpg,char_data/C/113.jpg_8.jpg,640,480,640,20,345,365,268,300,True,14
C,44,kaist_dataset/English/Digital_Camera/(E.S)C-outdoor1/2007-12-09-day-exterior-063.jpg,char_data/C/2007-12-09-day-exterior-063.jpg_4.jpg,1408,1200,1600,32,135,167,533,577,True,14
C,150,kaist_dataset/English/Digital_Camera/(E.S)C-outdoor1/2007-12-09-day-exterior-063.jpg,char_data/C/2007-12-09-day-exterior-063.jpg_5.jpg,15900,1200,1600,106,361,467,373,523,True,14
C,71,kaist_dataset/English/Digital_Camera/(E.S)C-outdoor1/DSC02243.JPG,char_data/C/DSC02243.JPG_2.jpg,2485,480,640,35,399,434,216,287,True,14
C,94,kaist_dataset/English/Digital_Camera/(E.S)C-outdoor1/DSC02306.JPG,char_data/C/DSC02306.JPG_2.jpg,7050,480,640,75,61,136,147,241,True,14
C,86,kaist_dataset/English/Digital_Camera/(E.S)C-outdoor1/DSC02345.JPG,char_data/C/DSC02345.JPG_4.jpg,7654,480,640,89,300,389,138,224,True,14
C,32,kaist_dataset/English/Digital_Camera/(E.S)C-outdoor1/DSC02345.JPG,char_data/C/DSC02345.JPG_5.jpg,736,480,640,23,282,305,237,269,True,14
C,45,kaist_dataset/English/Digital_Camera/(E.S)C-outdoor1/DSC02352.JPG,char_data/C/DSC02352.JPG_2.jpg,1575,480,640,35,406,441,315,360,True,14
C,93,kaist_dataset/English/Digital_Camera/(E.S)C-outdoor1/DSC02356.JPG,char_data/C/DSC02356.JPG_4.jpg,6696,480,640,72,27,99,145,238,True,14
C,84,kaist_dataset/English/Digital_Camera/(E.S)C-outdoor1/DSC02395.JPG,char_data/C/DSC02395.JPG_2.jpg,6552,480,640,78,101,179,216,300,True,14
C,37,kaist_dataset/English/Digital_Camera/(E.S)C-outdoor1/DSC02417.JPG,char_data/C/DSC02417.JPG_2.jpg,999,480,640,27,455,482,131,168,True,14
C,56,kaist_dataset/English/Digital_Camera/(E.S)C-outdoor1/DSC02427.JPG,char_data/C/DSC02427.JPG_4.jpg,1792,480,640,32,495,527,237,293,True,14
C,39,kaist_dataset/English/Digital_Camera/(E.S)C-outdoor1/DSC02427.JPG,char_data/C/DSC02427.JPG_5.jpg,936,480,640,24,514,538,360,399,True,14
C,126,kaist_dataset/English/Digital_Camera/(E.S)C-outdoor1/DSC02448.JPG,char_data/C/DSC02448.JPG_2.jpg,10332,480,640,82,299,381,35,161,True,14
C,61,kaist_dataset/English/Digital_Camera/(E.S)C-outdoor1/DSC02480.JPG,char_data/C/DSC02480.JPG_2.jpg,3111,480,640,51,182,233,109,170,True,14
C,84,kaist_dataset/English/Digital_Camera/(E.S)C-outdoor1/DSC02491.JPG,char_data/C/DSC02491.JPG_4.jpg,6804,480,640,81,81,162,216,300,True,14
C,56,kaist_dataset/English/Digital_Camera/(E.S)C-outdoor1/DSC02501.JPG,char_data/C/DSC02501.JPG_2.jpg,3024,480,640,54,222,276,298,354,True,14
C,94,kaist_dataset/English/Digital_Camera/(E.S)C-outdoor1/DSC02514.JPG,char_data/C/DSC02514.JPG_4.jpg,4230,480,640,45,112,157,149,243,True,14
C,97,kaist_dataset/English/Digital_Camera/(E.S)C-outdoor1/DSC02524.JPG,char_data/C/DSC02524.JPG_2.jpg,6693,480,640,69,337,406,303,400,True,14
C,66,kaist_dataset/English/Digital_Camera/(E.S)C-outdoor1/DSC02619.JPG,char_data/C/DSC02619.JPG_2.jpg,4158,480,640,63,385,448,211,277,True,14
C,84,kaist_dataset/English/Digital_Camera/(E.S)C-outdoor1/DSC02897.JPG,char_data/C/DSC02897.JPG_4.jpg,4872,480,640,58,86,144,296,380,True,14
C,84,kaist_dataset/English/Digital_Camera/(E.S)C-outdoor1/DSC02897.JPG,char_data/C/DSC02897.JPG_5.jpg,6384,480,640,76,354,430,277,361,True,14
C,35,kaist_dataset/English/Digital_Camera/(E.S)C-outdoor1/DSC02918.JPG,char_data/C/DSC02918.JPG_2.jpg,1365,480,640,39,246,285,233,268,True,14
C,94,kaist_dataset/English/Digital_Camera/(E.S)C-outdoor2/DSC02990.JPG,char_data/C/DSC02990.JPG_2.jpg,7332,480,640,78,386,464,158,252,True,14
C,85,kaist_dataset/English/Digital_Camera/(E.S)C-outdoor2/DSC02993.JPG,char_data/C/DSC02993.JPG_2.jpg,5440,480,640,64,475,539,226,311,True,14
C,59,kaist_dataset/English/Digital_Camera/(E.S)C-outdoor2/DSC03001.JPG,char_data/C/DSC03001.JPG_2.jpg,2832,480,640,48,411,459,180,239,True,14
C,67,kaist_dataset/English/Digital_Camera/(E.S)C-outdoor2/DSC03012.JPG,char_data/C/DSC03012.JPG_2.jpg,3618,480,640,54,73,127,212,279,True,14
C,52,kaist_dataset/English/Digital_Camera/(E.S)C-outdoor2/DSC03023.JPG,char_data/C/DSC03023.JPG_2.jpg,1560,480,640,30,329,359,300,352,True,14
C,67,kaist_dataset/English/Digital_Camera/(E.S)C-outdoor2/DSC03191.JPG,char_data/C/DSC03191.JPG_4.jpg,4020,480,640,60,408,468,133,200,True,14
C,70,kaist_dataset/English/Digital_Camera/(E.S)C-outdoor2/DSC03191.JPG,char_data/C/DSC03191.JPG_5.jpg,4620,480,640,66,85,151,229,299,True,14
C,66,kaist_dataset/English/Digital_Camera/(E.S)C-outdoor2/DSC03264.JPG,char_data/C/DSC03264.JPG_2.jpg,3828,480,640,58,294,352,230,296,True,14
C,94,kaist_dataset/English/Digital_Camera/(E.S)C-outdoor2/DSC03276.JPG,char_data/C/DSC03276.JPG_2.jpg,8742,480,640,93,85,178,327,421,True,14
C,87,kaist_dataset/English/Digital_Camera/(E.S)C-outdoor2/DSC03281.JPG,char_data/C/DSC03281.JPG_2.jpg,5655,480,640,65,319,384,203,290,True,14
C,68,kaist_dataset/English/Digital_Camera/(E.S)C-outdoor2/DSC03290.JPG,char_data/C/DSC03290.JPG_8.jpg,2992,480,640,44,167,211,86,154,True,14
C,68,kaist_dataset/English/Digital_Camera/(E.S)C-outdoor2/DSC03290.JPG,char_data/C/DSC03290.JPG_10.jpg,3332,480,640,49,169,218,294,362,True,14
C,43,kaist_dataset/English/Digital_Camera/(E.S)C-outdoor2/DSC03317.JPG,char_data/C/DSC03317.JPG_2.jpg,1290,480,640,30,409,439,260,303,True,14
C,69,kaist_dataset/English/Digital_Camera/(E.S)C-outdoor2/DSC03412.JPG,char_data/C/DSC03412.JPG_5.jpg,3933,480,640,57,254,311,263,332,True,14
C,49,kaist_dataset/English/Digital_Camera/(E.S)C-outdoor2/DSC03650.JPG,char_data/C/DSC03650.JPG_2.jpg,1617,480,640,33,281,314,212,261,True,14
C,57,kaist_dataset/English/Digital_Camera/(E.S)C-outdoor2/DSC04035.JPG,char_data/C/DSC04035.JPG_2.jpg,2280,480,640,40,53,93,189,246,True,14
C,46,kaist_dataset/English/Digital_Camera/(E.S)C-outdoor2/DSC04064.JPG,char_data/C/DSC04064.JPG_4.jpg,1748,480,640,38,33,71,120,166,True,14
C,78,kaist_dataset/English/Digital_Camera/(E.S)C-outdoor2/DSC04079.JPG,char_data/C/DSC04079.JPG_2.jpg,4290,480,640,55,96,151,262,340,True,14
C,32,kaist_dataset/English/Digital_Camera/(E.S)C-outdoor2/DSC04080.JPG,char_data/C/DSC04080.JPG_2.jpg,1248,480,640,39,214,253,363,395,True,14
C,114,kaist_dataset/English/Digital_Camera/(E.S)C-outdoor2/DSC04160.JPG,char_data/C/DSC04160.JPG_2.jpg,11970,480,640,105,12,117,347,461,True,14
C,71,kaist_dataset/English/Digital_Camera/(E.S)C-outdoor2/DSC04251.JPG,char_data/C/DSC04251.JPG_2.jpg,3905,480,640,55,354,409,67,138,True,14
C,75,kaist_dataset/English/Digital_Camera/(E.S)C-outdoor2/DSC04313.JPG,char_data/C/DSC04313.JPG_2.jpg,3675,480,640,49,469,518,112,187,True,14
C,41,kaist_dataset/English/Digital_Camera/(E.S)C-outdoor2/DSC04361.JPG,char_data/C/DSC04361.JPG_2.jpg,1066,480,640,26,241,267,238,279,True,14
C,56,kaist_dataset/English/Digital_Camera/(E.S)C-outdoor2/DSC04464.JPG,char_data/C/DSC04464.JPG_2.jpg,2576,480,640,46,263,309,332,388,True,14
C,63,kaist_dataset/English/Digital_Camera/(E.S)C-outdoor2/IMG_2481.JPG,char_data/C/IMG_2481.JPG_2.jpg,3024,480,640,48,373,421,254,317,True,14
C,91,kaist_dataset/English/Digital_Camera/(E.S)C-outdoor2/P1010015.JPG,char_data/C/P1010015.JPG_2.jpg,5915,480,640,65,439,504,130,221,True,14
C,64,kaist_dataset/English/Digital_Camera/(E.S)C-outdoor3/DSC02788.JPG,char_data/C/DSC02788.JPG_2.jpg,2240,480,640,35,315,350,304,368,True,14
C,86,kaist_dataset/English/Digital_Camera/(E.S)C-outdoor3/P1010133.JPG,char_data/C/P1010133.JPG_2.jpg,8084,480,640,94,212,306,159,245,True,14
C,68,kaist_dataset/English/Digital_Camera/(E.S)D-indoor/DSC02719.JPG,char_data/C/DSC02719.JPG_4.jpg,3536,480,640,52,348,400,276,344,True,14
C,153,kaist_dataset/English/Digital_Camera/(E.S)D-indoor/DSC02719.JPG,char_data/C/DSC02719.JPG_5.jpg,19890,480,640,130,298,428,107,260,True,14
C,60,kaist_dataset/English/Digital_Camera/(E.S)D-indoor/DSC02769.JPG,char_data/C/DSC02769.JPG_2.jpg,2880,480,640,48,288,336,218,278,True,14
C,127,kaist_dataset/English/Digital_Camera/(E.S)D-indoor/DSC02842.JPG,char_data/C/DSC02842.JPG_2.jpg,13970,480,640,110,349,459,341,468,True,14
C,51,kaist_dataset/English/Digital_Camera/(E.S)D-indoor/DSC03112.JPG,char_data/C/DSC03112.JPG_2.jpg,2142,480,640,42,173,215,201,252,True,14
C,43,kaist_dataset/English/Digital_Camera/(E.S)D-indoor/DSC03144.JPG,char_data/C/DSC03144.JPG_8.jpg,1419,480,640,33,108,141,229,272,True,14
C,38,kaist_dataset/English/Digital_Camera/(E.S)D-indoor/DSC03144.JPG,char_data/C/DSC03144.JPG_9.jpg,1102,480,640,29,233,262,233,271,True,14
C,40,kaist_dataset/English/Digital_Camera/(E.S)D-indoor/DSC03144.JPG,char_data/C/DSC03144.JPG_10.jpg,1280,480,640,32,102,134,285,325,True,14
C,37,kaist_dataset/English/Digital_Camera/(E.S)D-indoor/DSC03144.JPG,char_data/C/DSC03144.JPG_11.jpg,999,480,640,27,229,256,286,323,True,14
C,54,kaist_dataset/English/Digital_Camera/(E.S)D-indoor/DSC03467.JPG,char_data/C/DSC03467.JPG_2.jpg,2376,480,640,44,290,334,155,209,True,14
C,56,kaist_dataset/English/Digital_Camera/(E.S)D-indoor/DSC03883.JPG,char_data/C/DSC03883.JPG_2.jpg,2688,480,640,48,467,515,312,368,True,14
C,104,kaist_dataset/English/Digital_Camera/(E.S)D-indoor/DSC03911.JPG,char_data/C/DSC03911.JPG_2.jpg,5824,480,640,56,397,453,322,426,True,14
C,55,kaist_dataset/English/Digital_Camera/(E.S)D-indoor/DSC03936.JPG,char_data/C/DSC03936.JPG_5.jpg,2970,480,640,54,338,392,165,220,True,14
C,31,kaist_dataset/English/Digital_Camera/(E.S)D-indoor/DSC03943.JPG,char_data/C/DSC03943.JPG_2.jpg,589,480,640,19,313,332,311,342,True,14
C,82,kaist_dataset/English/Digital_Camera/(E.S)D-indoor/DSC04255.JPG,char_data/C/DSC04255.JPG_2.jpg,5822,480,640,71,302,373,298,380,True,14
C,123,kaist_dataset/English/Digital_Camera/(E.S)E-night/080116-0056.jpg,char_data/C/080116-0056.jpg_2.jpg,12300,1200,1600,100,749,849,524,647,True,14
C,98,kaist_dataset/English/Digital_Camera/(E.S)E-night/DSC02641.JPG,char_data/C/DSC02641.JPG_2.jpg,5782,480,640,59,30,89,272,370,True,14
C,105,kaist_dataset/English/Digital_Camera/(E.S)E-night/DSC02676.JPG,char_data/C/DSC02676.JPG_2.jpg,5880,480,640,56,10,66,188,293,True,14
C,26,kaist_dataset/English/Digital_Camera/(E.S)E-night/크기변환_%BA%F7%BD%BA%BD%C5%B8%DE%B4%BA_01_tjtjdska2008.jpg,char_data/C/크기변환_%BA%F7%BD%BA%BD%C5%B8%DE%B4%BA_01_tjtjdska2008.jpg_2.jpg,494,480,640,19,290,309,275,301,True,14
C,135,kaist_dataset/English/Digital_Camera/(E.S)F-others/080116-0060.jpg,char_data/C/080116-0060.jpg_2.jpg,17145,1200,1600,127,1058,1185,398,533,True,14
C,30,kaist_dataset/English/Digital_Camera/(E.S)F-others/080119-0007.jpg,char_data/C/080119-0007.jpg_11.jpg,1590,1200,1600,53,1258,1311,1031,1061,True,14
C,43,kaist_dataset/English/Digital_Camera/(E.S)F-others/080119-0007.jpg,char_data/C/080119-0007.jpg_12.jpg,2322,1200,1600,54,1244,1298,937,980,True,14
C,44,kaist_dataset/English/Digital_Camera/(E.S)F-others/080119-0007.jpg,char_data/C/080119-0007.jpg_13.jpg,1144,1200,1600,26,737,763,911,955,True,14
C,291,kaist_dataset/English/Digital_Camera/(E.S)F-others/080119-0014.jpg,char_data/C/080119-0014.jpg_2.jpg,61983,1200,1600,213,139,352,246,537,True,14
C,45,kaist_dataset/English/Digital_Camera/(E.S)F-others/086.jpg,char_data/C/086.jpg_2.jpg,1125,480,640,25,310,335,315,360,True,14
C,177,kaist_dataset/English/Digital_Camera/(E.S)F-others/2007-12-09-day-exterior-047.jpg,char_data/C/2007-12-09-day-exterior-047.jpg_4.jpg,21063,1200,1600,119,1048,1167,490,667,True,14
C,41,kaist_dataset/English/Digital_Camera/(E.S)F-others/2007-12-09-day-exterior-047.jpg,char_data/C/2007-12-09-day-exterior-047.jpg_5.jpg,779,1200,1600,19,713,732,1070,1111,True,14
C,95,kaist_dataset/English/Digital_Camera/(E.S)F-others/DSC02646.JPG,char_data/C/DSC02646.JPG_2.jpg,5890,480,640,62,175,237,264,359,True,14
C,49,kaist_dataset/English/Digital_Camera/(E.S)F-others/DSC02884.JPG,char_data/C/DSC02884.JPG_2.jpg,2303,480,640,47,458,505,34,83,True,14
C,96,kaist_dataset/English/Digital_Camera/(E.S)F-others/DSC02925.JPG,char_data/C/DSC02925.JPG_2.jpg,5856,480,640,61,178,239,257,353,True,14
C,96,kaist_dataset/English/Digital_Camera/(E.S)F-others/크기변환_%C4%BF%C7%C7%B5%B9%C3%E2%B0%A3%C6%C7_%281%29_alto99kr.jpg,char_data/C/크기변환_%C4%BF%C7%C7%B5%B9%C3%E2%B0%A3%C6%C7_%281%29_alto99kr.jpg_5.jpg,8928,480,640,93,101,194,282,378,True,14
C,78,kaist_dataset/English/Mobile_Phone/(E.M)B-indoor/P090902018.jpg,char_data/C/P090902018.jpg_4.jpg,3666,480,640,47,284,331,55,133,True,14
C,74,kaist_dataset/English/Mobile_Phone/(E.M)B-indoor/P090902018.jpg,char_data/C/P090902018.jpg_5.jpg,3404,480,640,46,12,58,169,243,True,14
C,93,kaist_dataset/English/Mobile_Phone/(E.M)B-indoor/P090911083.jpg,char_data/C/P090911083.jpg_2.jpg,7347,480,640,79,314,393,195,288,True,14
C,57,kaist_dataset/English/Mobile_Phone/(E.M)B-indoor/P090911084.jpg,char_data/C/P090911084.jpg_2.jpg,2565,480,640,45,426,471,146,203,True,14
C,69,kaist_dataset/English/Mobile_Phone/(E.M)C-bookCover/P090831075.jpg,char_data/C/P090831075.jpg_2.jpg,3933,480,640,57,214,271,279,348,True,14
C,132,kaist_dataset/English/Mobile_Phone/(E.M)C-bookCover/P090831077.jpg,char_data/C/P090831077.jpg_2.jpg,12672,480,640,96,3,99,54,186,True,14
C,105,kaist_dataset/English/Mobile_Phone/(E.M)C-bookCover/P090903050.jpg,char_data/C/P090903050.jpg_2.jpg,8820,480,640,84,336,420,78,183,True,14
C,62,kaist_dataset/English/Mobile_Phone/(E.M)C-bookCover/P090903054.jpg,char_data/C/P090903054.jpg_2.jpg,2976,480,640,48,52,100,352,414,True,14
C,37,kaist_dataset/English/Mobile_Phone/(E.M)C-bookCover/P090903055.jpg,char_data/C/P090903055.jpg_2.jpg,1221,480,640,33,285,318,408,445,True,14
C,36,kaist_dataset/English/Mobile_Phone/(E.M)C-bookCover/P090903071.jpg,char_data/C/P090903071.jpg_2.jpg,1188,480,640,33,211,244,298,334,True,14
C,60,kaist_dataset/English/Mobile_Phone/(E.M)C-bookCover/P090903076.jpg,char_data/C/P090903076.jpg_2.jpg,2400,480,640,40,155,195,384,444,True,14
C,114,kaist_dataset/Korean/Digital_Camera/E-night/DSC02631.JPG,char_data/C/DSC02631.JPG_2.jpg,11286,480,640,99,430,529,197,311,True,14
C,21,kaist_dataset/Korean/Digital_Camera/G-others/5.jpg,char_data/C/5.jpg_2.jpg,231,553,798,11,33,44,38,59,True,14
C,52,kaist_dataset/Korean/Digital_Camera/indoor1/DSC03092.JPG,char_data/C/DSC03092.JPG_2.jpg,2392,480,640,46,32,78,78,130,True,14
C,50,kaist_dataset/Korean/Digital_Camera/outdoor1/023.JPG,char_data/C/023.JPG_2.jpg,2150,480,640,43,411,454,38,88,True,14
C,25,kaist_dataset/Korean/Digital_Camera/outdoor2/2007-12-08-day-094.jpg,char_data/C/2007-12-08-day-094.jpg_2.jpg,775,1600,1200,31,592,623,1425,1450,True,14
C,79,kaist_dataset/Korean/Digital_Camera/outdoor2/2007-12-08-day-101.jpg,char_data/C/2007-12-08-day-101.jpg_8.jpg,4819,1200,1600,61,388,449,354,433,True,14
C,37,kaist_dataset/Korean/Digital_Camera/outdoor2/2007-12-08-day-101.jpg,char_data/C/2007-12-08-day-101.jpg_10.jpg,851,1200,1600,23,99,122,1053,1090,True,14
C,27,kaist_dataset/Korean/Digital_Camera/outdoor2/2007-12-08-day-101.jpg,char_data/C/2007-12-08-day-101.jpg_11.jpg,432,1200,1600,16,149,165,1060,1087,True,14
C,45,kaist_dataset/Mixed/Digital_Camera/(C.S)A-shadow/DSC02609.JPG,char_data/C/DSC02609.JPG_9.jpg,1215,480,640,27,315,342,301,346,True,14
C,49,kaist_dataset/Mixed/Digital_Camera/(C.S)A-shadow/DSC02902.JPG,char_data/C/DSC02902.JPG_2.jpg,1078,480,640,22,201,223,386,435,True,14
C,33,kaist_dataset/Mixed/Digital_Camera/(C.S)A-shadow/P1010017.JPG,char_data/C/P1010017.JPG_2.jpg,891,480,640,27,20,47,129,162,True,14
C,59,kaist_dataset/Mixed/Digital_Camera/(C.S)C-outdoor1/014.JPG,char_data/C/014.JPG_2.jpg,2065,480,640,35,205,240,197,256,True,14
C,110,kaist_dataset/Mixed/Digital_Camera/(C.S)C-outdoor1/027.JPG,char_data/C/027.JPG_2.jpg,9790,480,640,89,143,232,158,268,True,14
C,68,kaist_dataset/Mixed/Digital_Camera/(C.S)C-outdoor1/046.JPG,char_data/C/046.JPG_2.jpg,3808,480,640,56,40,96,207,275,True,14
C,32,kaist_dataset/Mixed/Digital_Camera/(C.S)C-outdoor1/054.JPG,char_data/C/054.JPG_4.jpg,928,480,640,29,416,445,272,304,True,14
C,32,kaist_dataset/Mixed/Digital_Camera/(C.S)C-outdoor1/054.JPG,char_data/C/054.JPG_5.jpg,704,480,640,22,491,513,273,305,True,14
C,49,kaist_dataset/Mixed/Digital_Camera/(C.S)C-outdoor1/078.JPG,char_data/C/078.JPG_2.jpg,2058,480,640,42,335,377,42,91,True,14
C,239,kaist_dataset/Mixed/Digital_Camera/(C.S)C-outdoor1/080119-0006.jpg,char_data/C/080119-0006.jpg_2.jpg,51624,1200,1600,216,639,855,490,729,True,14
C,80,kaist_dataset/Mixed/Digital_Camera/(C.S)C-outdoor1/080119-0027.jpg,char_data/C/080119-0027.jpg_6.jpg,4560,1200,1600,57,640,697,720,800,True,14
C,75,kaist_dataset/Mixed/Digital_Camera/(C.S)C-outdoor1/080119-0027.jpg,char_data/C/080119-0027.jpg_7.jpg,3975,1200,1600,53,868,921,720,795,True,14
C,49,kaist_dataset/Mixed/Digital_Camera/(C.S)C-outdoor1/080119-0027.jpg,char_data/C/080119-0027.jpg_8.jpg,1666,1200,1600,34,1005,1039,1051,1100,True,14
C,57,kaist_dataset/Mixed/Digital_Camera/(C.S)C-outdoor1/1.JPG,char_data/C/1.JPG_2.jpg,2052,576,768,36,598,634,281,338,True,14
C,37,kaist_dataset/Mixed/Digital_Camera/(C.S)C-outdoor1/114.jpg,char_data/C/114.jpg_2.jpg,1147,480,640,31,169,200,262,299,True,14
C,61,kaist_dataset/Mixed/Digital_Camera/(C.S)C-outdoor1/2007-12-08-day-091.jpg,char_data/C/2007-12-08-day-091.jpg_2.jpg,3416,1200,1600,56,685,741,594,655,True,14
C,49,kaist_dataset/Mixed/Digital_Camera/(C.S)C-outdoor1/2007-12-08-day-130.jpg,char_data/C/2007-12-08-day-130.jpg_4.jpg,2303,1200,1600,47,886,933,700,749,True,14
C,49,kaist_dataset/Mixed/Digital_Camera/(C.S)C-outdoor1/2007-12-08-day-130.jpg,char_data/C/2007-12-08-day-130.jpg_5.jpg,1813,1200,1600,37,1005,1042,706,755,True,14
C,82,kaist_dataset/Mixed/Digital_Camera/(C.S)C-outdoor1/2007-12-09-day-exterior-051.jpg,char_data/C/2007-12-09-day-exterior-051.jpg_4.jpg,6806,1200,1600,83,845,928,375,457,True,14
C,29,kaist_dataset/Mixed/Digital_Camera/(C.S)C-outdoor1/2007-12-09-day-exterior-051.jpg,char_data/C/2007-12-09-day-exterior-051.jpg_5.jpg,725,1200,1600,25,501,526,609,638,True,14
C,23,kaist_dataset/Mixed/Digital_Camera/(C.S)C-outdoor1/3.JPG,char_data/C/3.JPG_2.jpg,230,576,768,10,627,637,293,316,True,14
C,48,kaist_dataset/Mixed/Digital_Camera/(C.S)C-outdoor1/47.JPG,char_data/C/47.JPG_2.jpg,1728,576,768,36,308,344,172,220,True,14
C,31,kaist_dataset/Mixed/Digital_Camera/(C.S)C-outdoor1/48.JPG,char_data/C/48.JPG_2.jpg,837,576,768,27,299,326,188,219,True,14
C,25,kaist_dataset/Mixed/Digital_Camera/(C.S)C-outdoor1/DSC02240.JPG,char_data/C/DSC02240.JPG_2.jpg,550,480,640,22,371,393,288,313,True,14
C,152,kaist_dataset/Mixed/Digital_Camera/(C.S)C-outdoor2/DSC02365.JPG,char_data/C/DSC02365.JPG_2.jpg,23560,480,640,155,287,442,309,461,True,14
C,69,kaist_dataset/Mixed/Digital_Camera/(C.S)C-outdoor2/DSC02382.JPG,char_data/C/DSC02382.JPG_2.jpg,3519,480,640,51,1,51,251,320,True,14
C,138,kaist_dataset/Mixed/Digital_Camera/(C.S)C-outdoor2/DSC02397.JPG,char_data/C/DSC02397.JPG_2.jpg,17112,480,640,124,294,418,292,430,True,14
C,17,kaist_dataset/Mixed/Digital_Camera/(C.S)C-outdoor2/DSC02411.JPG,char_data/C/DSC02411.JPG_10.jpg,272,480,640,16,533,549,273,290,True,14
C,22,kaist_dataset/Mixed/Digital_Camera/(C.S)C-outdoor2/DSC02411.JPG,char_data/C/DSC02411.JPG_11.jpg,264,480,640,12,558,570,271,293,True,14
C,40,kaist_dataset/Mixed/Digital_Camera/(C.S)C-outdoor2/DSC02419.JPG,char_data/C/DSC02419.JPG_2.jpg,960,480,640,24,94,118,200,240,True,14
C,26,kaist_dataset/Mixed/Digital_Camera/(C.S)C-outdoor2/DSC02477.JPG,char_data/C/DSC02477.JPG_2.jpg,442,480,640,17,55,72,160,186,True,14
C,199,kaist_dataset/Mixed/Digital_Camera/(C.S)C-outdoor2/DSC02505.JPG,char_data/C/DSC02505.JPG_2.jpg,28855,480,640,145,252,397,211,410,True,14
C,61,kaist_dataset/Mixed/Digital_Camera/(C.S)C-outdoor2/DSC02519.JPG,char_data/C/DSC02519.JPG_5.jpg,2501,480,640,41,323,364,204,265,True,14
C,68,kaist_dataset/Mixed/Digital_Camera/(C.S)C-outdoor2/DSC02527.JPG,char_data/C/DSC02527.JPG_4.jpg,3468,480,640,51,97,148,296,364,True,14
C,69,kaist_dataset/Mixed/Digital_Camera/(C.S)C-outdoor2/DSC02527.JPG,char_data/C/DSC02527.JPG_5.jpg,3036,480,640,44,148,192,296,365,True,14
C,32,kaist_dataset/Mixed/Digital_Camera/(C.S)C-outdoor2/DSC02545.JPG,char_data/C/DSC02545.JPG_7.jpg,896,480,640,28,465,493,359,391,True,14
C,26,kaist_dataset/Mixed/Digital_Camera/(C.S)C-outdoor2/DSC02555.JPG,char_data/C/DSC02555.JPG_2.jpg,572,480,640,22,56,78,152,178,True,14
C,37,kaist_dataset/Mixed/Digital_Camera/(C.S)C-outdoor2/DSC02557.JPG,char_data/C/DSC02557.JPG_2.jpg,962,480,640,26,94,120,223,260,True,14
C,35,kaist_dataset/Mixed/Digital_Camera/(C.S)C-outdoor2/DSC02917.JPG,char_data/C/DSC02917.JPG_2.jpg,1050,480,640,30,148,178,222,257,True,14
C,59,kaist_dataset/Mixed/Digital_Camera/(C.S)C-outdoor2/DSC02926.JPG,char_data/C/DSC02926.JPG_2.jpg,2065,480,640,35,72,107,130,189,True,14
C,37,kaist_dataset/Mixed/Digital_Camera/(C.S)C-outdoor2/DSC02927.JPG,char_data/C/DSC02927.JPG_2.jpg,703,480,640,19,215,234,366,403,True,14
C,45,kaist_dataset/Mixed/Digital_Camera/(C.S)C-outdoor2/DSC02928.JPG,char_data/C/DSC02928.JPG_2.jpg,1035,480,640,23,363,386,385,430,True,14
C,72,kaist_dataset/Mixed/Digital_Camera/(C.S)C-outdoor2/DSC02936.JPG,char_data/C/DSC02936.JPG_6.jpg,5256,480,640,73,54,127,112,184,True,14
C,41,kaist_dataset/Mixed/Digital_Camera/(C.S)C-outdoor2/DSC02936.JPG,char_data/C/DSC02936.JPG_7.jpg,1066,480,640,26,255,281,77,118,True,14
C,64,kaist_dataset/Mixed/Digital_Camera/(C.S)C-outdoor3/DSC02962.JPG,char_data/C/DSC02962.JPG_5.jpg,3904,480,640,61,378,439,229,293,True,14
C,163,kaist_dataset/Mixed/Digital_Camera/(C.S)C-outdoor3/DSC03006.JPG,char_data/C/DSC03006.JPG_2.jpg,12877,480,640,79,489,568,102,265,True,14
C,32,kaist_dataset/Mixed/Digital_Camera/(C.S)C-outdoor3/DSC03035.JPG,char_data/C/DSC03035.JPG_2.jpg,576,480,640,18,303,321,371,403,True,14
C,74,kaist_dataset/Mixed/Digital_Camera/(C.S)C-outdoor3/DSC03067.JPG,char_data/C/DSC03067.JPG_4.jpg,4070,480,640,55,61,116,103,177,True,14
C,73,kaist_dataset/Mixed/Digital_Camera/(C.S)C-outdoor3/DSC03067.JPG,char_data/C/DSC03067.JPG_5.jpg,4891,480,640,67,115,182,103,176,True,14
C,46,kaist_dataset/Mixed/Digital_Camera/(C.S)C-outdoor3/DSC03223.JPG,char_data/C/DSC03223.JPG_2.jpg,1932,480,640,42,160,202,429,475,True,14
C,63,kaist_dataset/Mixed/Digital_Camera/(C.S)C-outdoor3/DSC03242.JPG,char_data/C/DSC03242.JPG_2.jpg,3654,480,640,58,160,218,167,230,True,14
C,59,kaist_dataset/Mixed/Digital_Camera/(C.S)C-outdoor3/DSC03283.JPG,char_data/C/DSC03283.JPG_2.jpg,2537,480,640,43,239,282,70,129,True,14
C,84,kaist_dataset/Mixed/Digital_Camera/(C.S)C-outdoor3/DSC03409.JPG,char_data/C/DSC03409.JPG_2.jpg,5544,480,640,66,413,479,122,206,True,14
C,83,kaist_dataset/Mixed/Digital_Camera/(C.S)C-outdoor3/DSC03422.JPG,char_data/C/DSC03422.JPG_4.jpg,3901,480,640,47,104,151,219,302,True,14
C,37,kaist_dataset/Mixed/Digital_Camera/(C.S)C-outdoor3/DSC03429.JPG,char_data/C/DSC03429.JPG_2.jpg,888,480,640,24,459,483,200,237,True,14
C,46,kaist_dataset/Mixed/Digital_Camera/(C.S)C-outdoor4/DSC03581.JPG,char_data/C/DSC03581.JPG_4.jpg,1334,480,640,29,264,293,129,175,True,14
C,44,kaist_dataset/Mixed/Digital_Camera/(C.S)C-outdoor4/DSC03581.JPG,char_data/C/DSC03581.JPG_5.jpg,1056,480,640,24,293,317,129,173,True,14
C,77,kaist_dataset/Mixed/Digital_Camera/(C.S)C-outdoor4/DSC03582.JPG,char_data/C/DSC03582.JPG_4.jpg,3773,480,640,49,257,306,149,226,True,14
C,75,kaist_dataset/Mixed/Digital_Camera/(C.S)C-outdoor4/DSC03582.JPG,char_data/C/DSC03582.JPG_5.jpg,3375,480,640,45,306,351,148,223,True,14
C,84,kaist_dataset/Mixed/Digital_Camera/(C.S)C-outdoor4/DSC03609.JPG,char_data/C/DSC03609.JPG_4.jpg,4032,480,640,48,31,79,367,451,True,14
C,83,kaist_dataset/Mixed/Digital_Camera/(C.S)C-outdoor4/DSC03609.JPG,char_data/C/DSC03609.JPG_5.jpg,3984,480,640,48,80,128,373,456,True,14
C,128,kaist_dataset/Mixed/Digital_Camera/(C.S)C-outdoor4/DSC03628.JPG,char_data/C/DSC03628.JPG_2.jpg,10752,480,640,84,330,414,23,151,True,14
C,27,kaist_dataset/Mixed/Digital_Camera/(C.S)C-outdoor4/DSC03634.JPG,char_data/C/DSC03634.JPG_6.jpg,783,480,640,29,351,380,247,274,True,14
C,95,kaist_dataset/Mixed/Digital_Camera/(C.S)C-outdoor4/DSC03666.JPG,char_data/C/DSC03666.JPG_2.jpg,6745,480,640,71,92,163,160,255,True,14
C,34,kaist_dataset/Mixed/Digital_Camera/(C.S)C-outdoor4/DSC03682.JPG,char_data/C/DSC03682.JPG_6.jpg,986,480,640,29,324,353,323,357,True,14
C,32,kaist_dataset/Mixed/Digital_Camera/(C.S)C-outdoor4/DSC03682.JPG,char_data/C/DSC03682.JPG_8.jpg,768,480,640,24,466,490,323,355,True,14
C,40,kaist_dataset/Mixed/Digital_Camera/(C.S)C-outdoor4/DSC03711.JPG,char_data/C/DSC03711.JPG_2.jpg,1160,480,640,29,465,494,384,424,True,14
C,33,kaist_dataset/Mixed/Digital_Camera/(C.S)C-outdoor4/DSC03716.JPG,char_data/C/DSC03716.JPG_2.jpg,627,480,640,19,345,364,238,271,True,14
C,30,kaist_dataset/Mixed/Digital_Camera/(C.S)C-outdoor4/DSC03758.JPG,char_data/C/DSC03758.JPG_2.jpg,570,480,640,19,168,187,228,258,True,14
C,47,kaist_dataset/Mixed/Digital_Camera/(C.S)C-outdoor4/DSC03764.JPG,char_data/C/DSC03764.JPG_2.jpg,1128,480,640,24,133,157,229,276,True,14
C,72,kaist_dataset/Mixed/Digital_Camera/(C.S)C-outdoor4/DSC03784.JPG,char_data/C/DSC03784.JPG_2.jpg,4032,480,640,56,25,81,307,379,True,14
C,75,kaist_dataset/Mixed/Digital_Camera/(C.S)C-outdoor5/DSC03820.JPG,char_data/C/DSC03820.JPG_2.jpg,4200,480,640,56,176,232,359,434,True,14
C,30,kaist_dataset/Mixed/Digital_Camera/(C.S)C-outdoor5/DSC03829.JPG,char_data/C/DSC03829.JPG_2.jpg,780,480,640,26,251,277,178,208,True,14
C,68,kaist_dataset/Mixed/Digital_Camera/(C.S)C-outdoor5/DSC03867.JPG,char_data/C/DSC03867.JPG_4.jpg,3468,480,640,51,254,305,302,370,True,14
C,69,kaist_dataset/Mixed/Digital_Camera/(C.S)C-outdoor5/DSC03867.JPG,char_data/C/DSC03867.JPG_5.jpg,2829,480,640,41,303,344,300,369,True,14
C,54,kaist_dataset/Mixed/Digital_Camera/(C.S)C-outdoor5/DSC04014.JPG,char_data/C/DSC04014.JPG_2.jpg,2214,480,640,41,308,349,99,153,True,14
C,40,kaist_dataset/Mixed/Digital_Camera/(C.S)C-outdoor5/DSC04048.JPG,char_data/C/DSC04048.JPG_2.jpg,1360,480,640,34,124,158,142,182,True,14
C,53,kaist_dataset/Mixed/Digital_Camera/(C.S)C-outdoor5/DSC04055.JPG,char_data/C/DSC04055.JPG_6.jpg,2014,480,640,38,265,303,178,231,True,14
C,108,kaist_dataset/Mixed/Digital_Camera/(C.S)C-outdoor5/DSC04055.JPG,char_data/C/DSC04055.JPG_7.jpg,10152,480,640,94,91,185,247,355,True,14
C,36,kaist_dataset/Mixed/Digital_Camera/(C.S)C-outdoor5/DSC04055.JPG,char_data/C/DSC04055.JPG_8.jpg,720,480,640,20,209,229,373,409,True,14
C,41,kaist_dataset/Mixed/Digital_Camera/(C.S)C-outdoor5/DSC04057.JPG,char_data/C/DSC04057.JPG_2.jpg,1312,480,640,32,47,79,118,159,True,14
C,55,kaist_dataset/Mixed/Digital_Camera/(C.S)C-outdoor5/DSC04059.JPG,char_data/C/DSC04059.JPG_2.jpg,1650,480,640,30,343,373,122,177,True,14
C,58,kaist_dataset/Mixed/Digital_Camera/(C.S)C-outdoor5/DSC04060.JPG,char_data/C/DSC04060.JPG_4.jpg,1856,480,640,32,343,375,96,154,True,14
C,53,kaist_dataset/Mixed/Digital_Camera/(C.S)C-outdoor5/DSC04060.JPG,char_data/C/DSC04060.JPG_5.jpg,1749,480,640,33,440,473,97,150,True,14
C,33,kaist_dataset/Mixed/Digital_Camera/(C.S)C-outdoor5/DSC04069.JPG,char_data/C/DSC04069.JPG_6.jpg,825,480,640,25,161,186,425,458,True,14
C,32,kaist_dataset/Mixed/Digital_Camera/(C.S)C-outdoor5/DSC04069.JPG,char_data/C/DSC04069.JPG_7.jpg,864,480,640,27,345,372,380,412,True,14
C,64,kaist_dataset/Mixed/Digital_Camera/(C.S)C-outdoor5/DSC04076.JPG,char_data/C/DSC04076.JPG_2.jpg,3008,480,640,47,324,371,77,141,True,14
C,82,kaist_dataset/Mixed/Digital_Camera/(C.S)C-outdoor5/DSC04078.JPG,char_data/C/DSC04078.JPG_2.jpg,5166,480,640,63,464,527,281,363,True,14
C,64,kaist_dataset/Mixed/Digital_Camera/(C.S)C-outdoor5/DSC04097.JPG,char_data/C/DSC04097.JPG_4.jpg,3328,480,640,52,158,210,173,237,True,14
C,127,kaist_dataset/Mixed/Digital_Camera/(C.S)C-outdoor5/DSC04128.JPG,char_data/C/DSC04128.JPG_2.jpg,11938,480,640,94,125,219,161,288,True,14
C,40,kaist_dataset/Mixed/Digital_Camera/(C.S)C-outdoor5/DSC04129.JPG,char_data/C/DSC04129.JPG_5.jpg,1320,480,640,33,346,379,379,419,True,14
C,37,kaist_dataset/Mixed/Digital_Camera/(C.S)C-outdoor5/DSC04151.JPG,char_data/C/DSC04151.JPG_2.jpg,1110,480,640,30,61,91,332,369,True,14
C,77,kaist_dataset/Mixed/Digital_Camera/(C.S)C-outdoor5/DSC04153.JPG,char_data/C/DSC04153.JPG_2.jpg,5467,480,640,71,206,277,193,270,True,14
C,60,kaist_dataset/Mixed/Digital_Camera/(C.S)C-outdoor5/DSC04162.JPG,char_data/C/DSC04162.JPG_4.jpg,2400,480,640,40,143,183,313,373,True,14
C,39,kaist_dataset/Mixed/Digital_Camera/(C.S)C-outdoor5/DSC04314.JPG,char_data/C/DSC04314.JPG_2.jpg,1131,480,640,29,497,526,167,206,True,14
C,45,kaist_dataset/Mixed/Digital_Camera/(C.S)C-outdoor5/DSC04321.JPG,char_data/C/DSC04321.JPG_2.jpg,1440,480,640,32,24,56,184,229,True,14
C,101,kaist_dataset/Mixed/Digital_Camera/(C.S)C-outdoor5/DSC04349.JPG,char_data/C/DSC04349.JPG_4.jpg,6565,480,640,65,51,116,82,183,True,14
C,57,kaist_dataset/Mixed/Digital_Camera/(C.S)C-outdoor5/DSC04349.JPG,char_data/C/DSC04349.JPG_5.jpg,1539,480,640,27,443,470,306,363,True,14
C,30,kaist_dataset/Mixed/Digital_Camera/(C.S)C-outdoor5/DSC04360.JPG,char_data/C/DSC04360.JPG_2.jpg,420,480,640,14,73,87,382,412,True,14
C,45,kaist_dataset/Mixed/Digital_Camera/(C.S)C-outdoor5/DSC04429.JPG,char_data/C/DSC04429.JPG_2.jpg,1485,480,640,33,171,204,247,292,True,14
C,246,kaist_dataset/Mixed/Digital_Camera/(C.S)C-outdoor5/DSC04444.JPG,char_data/C/DSC04444.JPG_2.jpg,47724,480,640,194,233,427,179,425,True,14
C,56,kaist_dataset/Mixed/Digital_Camera/(C.S)C-outdoor6/080116-0057.jpg,char_data/C/080116-0057.jpg_8.jpg,2408,1200,1600,43,1062,1105,817,873,True,14
C,35,kaist_dataset/Mixed/Digital_Camera/(C.S)C-outdoor6/090.jpg,char_data/C/090.jpg_4.jpg,1225,480,640,35,199,234,151,186,True,14
C,154,kaist_dataset/Mixed/Digital_Camera/(C.S)C-outdoor6/P1010052.JPG,char_data/C/P1010052.JPG_2.jpg,13090,480,640,85,450,535,182,336,True,14
C,23,kaist_dataset/Mixed/Digital_Camera/(C.S)C-outdoor6/P1010063.JPG,char_data/C/P1010063.JPG_8.jpg,230,480,640,10,402,412,364,387,True,14
C,26,kaist_dataset/Mixed/Digital_Camera/(C.S)C-outdoor6/P1010063.JPG,char_data/C/P1010063.JPG_9.jpg,416,480,640,16,424,440,349,375,True,14
C,58,kaist_dataset/Mixed/Digital_Camera/(C.S)C-outdoor6/P1010063.JPG,char_data/C/P1010063.JPG_10.jpg,2378,480,640,41,175,216,385,443,True,14
C,51,kaist_dataset/Mixed/Digital_Camera/(C.S)C-outdoor6/P1010063.JPG,char_data/C/P1010063.JPG_11.jpg,2601,480,640,51,256,307,351,402,True,14
C,42,kaist_dataset/Mixed/Digital_Camera/(C.S)C-outdoor6/P1010085.JPG,char_data/C/P1010085.JPG_4.jpg,1596,480,640,38,40,78,125,167,True,14
C,32,kaist_dataset/Mixed/Digital_Camera/(C.S)C-outdoor6/P1010088.JPG,char_data/C/P1010088.JPG_4.jpg,960,480,640,30,443,473,173,205,True,14
C,28,kaist_dataset/Mixed/Digital_Camera/(C.S)C-outdoor6/P1010088.JPG,char_data/C/P1010088.JPG_5.jpg,616,480,640,22,509,531,175,203,True,14
C,31,kaist_dataset/Mixed/Digital_Camera/(C.S)C-outdoor6/P1010095.JPG,char_data/C/P1010095.JPG_2.jpg,341,480,640,11,109,120,182,213,True,14
C,37,kaist_dataset/Mixed/Digital_Camera/(C.S)C-outdoor6/P1010132.JPG,char_data/C/P1010132.JPG_2.jpg,1110,480,640,30,112,142,98,135,True,14
C,84,kaist_dataset/Mixed/Digital_Camera/(C.S)D-indoor1/DSC02714.JPG,char_data/C/DSC02714.JPG_2.jpg,7476,480,640,89,60,149,105,189,True,14
C,43,kaist_dataset/Mixed/Digital_Camera/(C.S)D-indoor1/DSC02718.JPG,char_data/C/DSC02718.JPG_4.jpg,817,480,640,19,141,160,229,272,True,14
C,47,kaist_dataset/Mixed/Digital_Camera/(C.S)D-indoor1/DSC02718.JPG,char_data/C/DSC02718.JPG_5.jpg,1457,480,640,31,117,148,184,231,True,14
C,54,kaist_dataset/Mixed/Digital_Camera/(C.S)D-indoor1/DSC02771.JPG,char_data/C/DSC02771.JPG_2.jpg,3564,480,640,66,68,134,198,252,True,14
C,49,kaist_dataset/Mixed/Digital_Camera/(C.S)D-indoor1/DSC02772.JPG,char_data/C/DSC02772.JPG_2.jpg,3332,480,640,68,144,212,269,318,True,14
C,53,kaist_dataset/Mixed/Digital_Camera/(C.S)D-indoor1/DSC02775.JPG,char_data/C/DSC02775.JPG_2.jpg,4081,480,640,77,48,125,173,226,False,14
C,49,kaist_dataset/Mixed/Digital_Camera/(C.S)D-indoor1/DSC02776.JPG,char_data/C/DSC02776.JPG_2.jpg,3479,480,640,71,87,158,205,254,False,14
C,41,kaist_dataset/Mixed/Digital_Camera/(C.S)D-indoor1/DSC02780.JPG,char_data/C/DSC02780.JPG_2.jpg,3198,480,640,78,108,186,226,267,False,14
C,41,kaist_dataset/Mixed/Digital_Camera/(C.S)D-indoor1/DSC02787.JPG,char_data/C/DSC02787.JPG_5.jpg,1107,480,640,27,421,448,361,402,False,14
C,49,kaist_dataset/Mixed/Digital_Camera/(C.S)D-indoor1/DSC02797.JPG,char_data/C/DSC02797.JPG_2.jpg,3430,480,640,70,107,177,218,267,False,14
C,46,kaist_dataset/Mixed/Digital_Camera/(C.S)D-indoor1/DSC02801.JPG,char_data/C/DSC02801.JPG_2.jpg,3266,480,640,71,63,134,215,261,False,14
C,50,kaist_dataset/Mixed/Digital_Camera/(C.S)D-indoor1/DSC02802.JPG,char_data/C/DSC02802.JPG_2.jpg,3100,480,640,62,65,127,207,257,False,14
C,108,kaist_dataset/Mixed/Digital_Camera/(C.S)D-indoor1/DSC02840.JPG,char_data/C/DSC02840.JPG_4.jpg,12204,480,640,113,416,529,123,231,False,14
C,115,kaist_dataset/Mixed/Digital_Camera/(C.S)D-indoor1/DSC02840.JPG,char_data/C/DSC02840.JPG_5.jpg,12765,480,640,111,297,408,240,355,False,14
C,38,kaist_dataset/Mixed/Digital_Camera/(C.S)D-indoor1/DSC03096.JPG,char_data/C/DSC03096.JPG_6.jpg,1292,480,640,34,49,83,417,455,False,14
C,41,kaist_dataset/Mixed/Digital_Camera/(C.S)D-indoor1/DSC03129.JPG,char_data/C/DSC03129.JPG_2.jpg,1681,480,640,41,246,287,204,245,False,14
C,51,kaist_dataset/Mixed/Digital_Camera/(C.S)D-indoor1/DSC03131.JPG,char_data/C/DSC03131.JPG_2.jpg,2499,480,640,49,206,255,125,176,False,14
C,47,kaist_dataset/Mixed/Digital_Camera/(C.S)D-indoor1/DSC03133.JPG,char_data/C/DSC03133.JPG_2.jpg,2115,480,640,45,340,385,148,195,False,14
C,55,kaist_dataset/Mixed/Digital_Camera/(C.S)D-indoor1/DSC03135.JPG,char_data/C/DSC03135.JPG_2.jpg,2310,480,640,42,170,212,169,224,False,14
C,49,kaist_dataset/Mixed/Digital_Camera/(C.S)D-indoor1/DSC03372.JPG,char_data/C/DSC03372.JPG_2.jpg,1960,480,640,40,412,452,393,442,False,14
C,36,kaist_dataset/Mixed/Digital_Camera/(C.S)D-indoor1/DSC03904.JPG,char_data/C/DSC03904.JPG_2.jpg,648,480,640,18,389,407,214,250,False,14
C,28,kaist_dataset/Mixed/Digital_Camera/(C.S)D-indoor1/DSC03959.JPG,char_data/C/DSC03959.JPG_2.jpg,728,480,640,26,254,280,187,215,False,14
C,35,kaist_dataset/Mixed/Digital_Camera/(C.S)D-indoor1/DSC03980.JPG,char_data/C/DSC03980.JPG_2.jpg,735,480,640,21,479,500,147,182,False,14
C,57,kaist_dataset/Mixed/Digital_Camera/(C.S)D-indoor1/DSC04198.JPG,char_data/C/DSC04198.JPG_4.jpg,2964,480,640,52,214,266,84,141,False,14
C,56,kaist_dataset/Mixed/Digital_Camera/(C.S)D-indoor1/DSC04198.JPG,char_data/C/DSC04198.JPG_5.jpg,2072,480,640,37,266,303,82,138,False,14
C,41,kaist_dataset/Mixed/Digital_Camera/(C.S)D-indoor1/DSC04206.JPG,char_data/C/DSC04206.JPG_4.jpg,861,480,640,21,296,317,285,326,False,14
C,136,kaist_dataset/Mixed/Digital_Camera/(C.S)D-indoor1/DSC04233.JPG,char_data/C/DSC04233.JPG_2.jpg,16320,480,640,120,95,215,21,157,False,14
C,47,kaist_dataset/Mixed/Digital_Camera/(C.S)D-indoor1/DSC04246.JPG,char_data/C/DSC04246.JPG_4.jpg,1504,480,640,32,109,141,238,285,False,14
C,48,kaist_dataset/Mixed/Digital_Camera/(C.S)D-indoor2/DSC04248.JPG,char_data/C/DSC04248.JPG_4.jpg,1776,480,640,37,138,175,217,265,False,14
C,39,kaist_dataset/Mixed/Digital_Camera/(C.S)D-indoor2/DSC04254.JPG,char_data/C/DSC04254.JPG_6.jpg,1014,480,640,26,84,110,339,378,False,14
C,39,kaist_dataset/Mixed/Digital_Camera/(C.S)D-indoor2/DSC04254.JPG,char_data/C/DSC04254.JPG_8.jpg,1014,480,640,26,476,502,334,373,False,14
C,94,kaist_dataset/Mixed/Digital_Camera/(C.S)D-indoor2/DSC04443.JPG,char_data/C/DSC04443.JPG_2.jpg,5452,480,640,58,460,518,298,392,False,14
C,132,kaist_dataset/Mixed/Digital_Camera/(C.S)E-night/DSC02571.JPG,char_data/C/DSC02571.JPG_2.jpg,5808,480,640,44,109,153,197,329,False,14
C,43,kaist_dataset/Mixed/Digital_Camera/(C.S)E-night/DSC02574.JPG,char_data/C/DSC02574.JPG_2.jpg,1333,480,640,31,198,229,148,191,False,14
C,49,kaist_dataset/Mixed/Digital_Camera/(C.S)E-night/DSC02595.JPG,char_data/C/DSC02595.JPG_2.jpg,2254,480,640,46,258,304,356,405,False,14
C,105,kaist_dataset/Mixed/Digital_Camera/(C.S)E-night/DSC02664.JPG,char_data/C/DSC02664.JPG_2.jpg,10080,480,640,96,444,540,145,250,False,14
C,51,kaist_dataset/Mixed/Digital_Camera/(C.S)E-night/DSC02672.JPG,char_data/C/DSC02672.JPG_2.jpg,1122,480,640,22,523,545,173,224,False,14
C,107,kaist_dataset/Mixed/Digital_Camera/(C.S)E-night/P1010164.JPG,char_data/C/P1010164.JPG_2.jpg,9630,480,640,90,88,178,84,191,False,14
C,44,kaist_dataset/Mixed/Digital_Camera/(C.S)F-others/047.jpg,char_data/C/047.jpg_2.jpg,1364,252,339,31,242,273,119,163,False,14
C,42,kaist_dataset/Mixed/Digital_Camera/(C.S)F-others/2007-12-08-day-067.jpg,char_data/C/2007-12-08-day-067.jpg_4.jpg,2394,1600,1200,57,445,502,764,806,False,14
C,48,kaist_dataset/Mixed/Digital_Camera/(C.S)F-others/2007-12-08-day-067.jpg,char_data/C/2007-12-08-day-067.jpg_5.jpg,2880,1600,1200,60,436,496,1032,1080,False,14
C,76,kaist_dataset/Mixed/Digital_Camera/(C.S)F-others/2007-12-08-day-113.jpg,char_data/C/2007-12-08-day-113.jpg_2.jpg,3648,1200,1600,48,959,1007,663,739,False,14
C,45,kaist_dataset/Mixed/Digital_Camera/(C.S)F-others/DSC02609.JPG,char_data/C/DSC02609.JPG_11.jpg,1215,480,640,27,315,342,301,346,False,14
C,42,kaist_dataset/Mixed/Digital_Camera/(C.S)F-others/DSC02777.JPG,char_data/C/DSC02777.JPG_2.jpg,3696,480,640,88,94,182,258,300,False,14
C,48,kaist_dataset/Mixed/Digital_Camera/(C.S)F-others/DSC02799.JPG,char_data/C/DSC02799.JPG_2.jpg,2592,480,640,54,77,131,335,383,False,14
C,47,kaist_dataset/Mixed/Digital_Camera/(C.S)F-others/DSC02800.JPG,char_data/C/DSC02800.JPG_2.jpg,2773,480,640,59,78,137,207,254,False,14
C,152,kaist_dataset/Mixed/Digital_Camera/(C.S)F-others/DSC02881.JPG,char_data/C/DSC02881.JPG_8.jpg,22496,480,640,148,335,483,49,201,False,14
C,63,kaist_dataset/Mixed/Digital_Camera/(C.S)F-others/DSC02881.JPG,char_data/C/DSC02881.JPG_9.jpg,5166,480,640,82,121,203,404,467,False,14
C,74,kaist_dataset/Mixed/Digital_Camera/(C.S)F-others/DSC02881.JPG,char_data/C/DSC02881.JPG_10.jpg,5698,480,640,77,214,291,377,451,False,14
C,71,kaist_dataset/Mixed/Digital_Camera/(C.S)F-others/DSC02881.JPG,char_data/C/DSC02881.JPG_11.jpg,7313,480,640,103,494,597,319,390,False,14
C,27,kaist_dataset/Mixed/Mobile_Phone/(C.M)A-outdoor/P090908006.jpg,char_data/C/P090908006.jpg_2.jpg,459,480,640,17,108,125,376,403,False,14
C,84,kaist_dataset/Mixed/Mobile_Phone/(C.M)A-outdoor/P090912037.jpg,char_data/C/P090912037.jpg_2.jpg,5460,480,640,65,91,156,152,236,False,14
C,34,kaist_dataset/Mixed/Mobile_Phone/(C.M)A-outdoor/P090912062.jpg,char_data/C/P090912062.jpg_2.jpg,884,480,640,26,472,498,126,160,False,14
C,53,kaist_dataset/Mixed/Mobile_Phone/(C.M)B-indoor/P090831016.jpg,char_data/C/P090831016.jpg_2.jpg,2332,480,640,44,168,212,182,235,False,14
C,72,kaist_dataset/Mixed/Mobile_Phone/(C.M)B-indoor/P090831019.jpg,char_data/C/P090831019.jpg_2.jpg,5472,480,640,76,80,156,148,220,False,14
C,54,kaist_dataset/Mixed/Mobile_Phone/(C.M)C-bookCover/P090831080.jpg,char_data/C/P090831080.jpg_4.jpg,2106,480,640,39,145,184,399,453,False,14
C,74,kaist_dataset/Mixed/Mobile_Phone/(C.M)C-bookCover/P090831121.jpg,char_data/C/P090831121.jpg_2.jpg,4440,480,640,60,246,306,301,375,False,14
C,70,kaist_dataset/Mixed/Mobile_Phone/(C.M)C-bookCover/P090831122.jpg,char_data/C/P090831122.jpg_2.jpg,3920,480,640,56,259,315,250,320,False,14
C,57,kaist_dataset/Mixed/Mobile_Phone/(C.M)C-bookCover/P090831124.jpg,char_data/C/P090831124.jpg_2.jpg,2394,480,640,42,381,423,116,173,False,14
C,72,kaist_dataset/Mixed/Mobile_Phone/(C.M)C-bookCover/P090831125.jpg,char_data/C/P090831125.jpg_2.jpg,4104,480,640,57,215,272,256,328,False,14
C,68,kaist_dataset/Mixed/Mobile_Phone/(C.M)C-bookCover/P090831126.jpg,char_data/C/P090831126.jpg_2.jpg,3944,480,640,58,174,232,273,341,False,14
C,103,kaist_dataset/Mixed/Mobile_Phone/(C.M)C-bookCover/P090831136.jpg,char_data/C/P090831136.jpg_2.jpg,9579,480,640,93,31,124,225,328,False,14
C,48,kaist_dataset/Mixed/Mobile_Phone/(C.M)C-bookCover/P090902016.jpg,char_data/C/P090902016.jpg_5.jpg,1440,480,640,30,8,38,197,245,False,14
C,36,kaist_dataset/Mixed/Mobile_Phone/(C.M)C-bookCover/P090903063.jpg,char_data/C/P090903063.jpg_2.jpg,1188,480,640,33,226,259,294,330,False,14
C,47,kaist_dataset/Mixed/Mobile_Phone/(C.M)C-bookCover/P090903068.jpg,char_data/C/P090903068.jpg_2.jpg,1786,480,640,38,249,287,345,392,False,14
C,36,kaist_dataset/Mixed/Mobile_Phone/(C.M)C-bookCover/P090903072.jpg,char_data/C/P090903072.jpg_2.jpg,756,480,640,21,155,176,348,384,False,14
r,70,kaist_dataset/English/Digital_Camera/(E.S)A-shadow/DSC02857.JPG,char_data/r/DSC02857.JPG_4.jpg,2940,480,640,42,329,371,211,281,True,42
r,66,kaist_dataset/English/Digital_Camera/(E.S)A-shadow/DSC02857.JPG,char_data/r/DSC02857.JPG_5.jpg,2706,480,640,41,583,624,209,275,True,42
r,77,kaist_dataset/English/Digital_Camera/(E.S)A-shadow/DSC02858.JPG,char_data/r/DSC02858.JPG_4.jpg,3234,480,640,42,285,327,316,393,True,42
r,85,kaist_dataset/English/Digital_Camera/(E.S)A-shadow/DSC02858.JPG,char_data/r/DSC02858.JPG_5.jpg,3400,480,640,40,570,610,315,400,True,42
r,44,kaist_dataset/English/Digital_Camera/(E.S)A-shadow/DSC03075.JPG,char_data/r/DSC03075.JPG_4.jpg,880,480,640,20,391,411,358,402,True,42
r,40,kaist_dataset/English/Digital_Camera/(E.S)A-shadow/DSC03075.JPG,char_data/r/DSC03075.JPG_5.jpg,640,480,640,16,478,494,356,396,True,42
r,41,kaist_dataset/English/Digital_Camera/(E.S)A-shadow/DSC03081.JPG,char_data/r/DSC03081.JPG_2.jpg,984,480,640,24,352,376,413,454,True,42
r,44,kaist_dataset/English/Digital_Camera/(E.S)A-shadow/DSC03082.JPG,char_data/r/DSC03082.JPG_2.jpg,880,480,640,20,233,253,382,426,True,42
r,59,kaist_dataset/English/Digital_Camera/(E.S)A-shadow/DSC03084.JPG,char_data/r/DSC03084.JPG_2.jpg,1298,480,640,22,319,341,369,428,True,42
r,59,kaist_dataset/English/Digital_Camera/(E.S)A-shadow/IMG_2647.JPG,char_data/r/IMG_2647.JPG_4.jpg,1357,480,640,23,207,230,328,387,True,42
r,58,kaist_dataset/English/Digital_Camera/(E.S)A-shadow/IMG_2647.JPG,char_data/r/IMG_2647.JPG_5.jpg,1450,480,640,25,217,242,102,160,True,42
r,82,kaist_dataset/English/Digital_Camera/(E.S)B-light/DSC02587.JPG,char_data/r/DSC02587.JPG_2.jpg,2624,480,640,32,258,290,199,281,True,42
r,26,kaist_dataset/English/Digital_Camera/(E.S)B-light/크기변환_%B0%A3%C6%C74_fabdent.jpg,char_data/r/크기변환_%B0%A3%C6%C74_fabdent.jpg_4.jpg,390,480,640,15,257,272,263,289,True,42
r,28,kaist_dataset/English/Digital_Camera/(E.S)B-light/크기변환_%B0%A3%C6%C74_fabdent.jpg,char_data/r/크기변환_%B0%A3%C6%C74_fabdent.jpg_5.jpg,476,480,640,17,355,372,258,286,True,42
r,62,kaist_dataset/English/Digital_Camera/(E.S)C-outdoor1/001.jpg,char_data/r/001.jpg_6.jpg,1798,257,470,29,354,383,94,156,True,42
r,38,kaist_dataset/English/Digital_Camera/(E.S)C-outdoor1/031.JPG,char_data/r/031.JPG_2.jpg,874,480,640,23,473,496,207,245,True,42
r,29,kaist_dataset/English/Digital_Camera/(E.S)C-outdoor1/036.jpg,char_data/r/036.jpg_2.jpg,638,197,354,22,181,203,79,108,True,42
r,22,kaist_dataset/English/Digital_Camera/(E.S)C-outdoor1/056.JPG,char_data/r/056.JPG_4.jpg,198,480,640,9,267,276,241,263,True,42
r,16,kaist_dataset/English/Digital_Camera/(E.S)C-outdoor1/056.JPG,char_data/r/056.JPG_5.jpg,160,480,640,10,325,335,247,263,True,42
r,26,kaist_dataset/English/Digital_Camera/(E.S)C-outdoor1/065.jpg,char_data/r/065.jpg_4.jpg,364,374,515,14,169,183,172,198,True,42
r,34,kaist_dataset/English/Digital_Camera/(E.S)C-outdoor1/065.jpg,char_data/r/065.jpg_5.jpg,476,374,515,14,442,456,156,190,True,42
r,41,kaist_dataset/English/Digital_Camera/(E.S)C-outdoor1/077.JPG,char_data/r/077.JPG_4.jpg,984,480,640,24,416,440,201,242,True,42
r,230,kaist_dataset/English/Digital_Camera/(E.S)C-outdoor1/080119-0035.jpg,char_data/r/080119-0035.jpg_2.jpg,28980,1200,1600,126,800,926,776,1006,True,42
r,212,kaist_dataset/English/Digital_Camera/(E.S)C-outdoor1/080119-0036.jpg,char_data/r/080119-0036.jpg_2.jpg,20988,1200,1600,99,1078,1177,354,566,True,42
r,78,kaist_dataset/English/Digital_Camera/(E.S)C-outdoor1/107.jpg,char_data/r/107.jpg_2.jpg,4212,480,640,54,427,481,243,321,True,42
r,54,kaist_dataset/English/Digital_Camera/(E.S)C-outdoor1/138.JPG,char_data/r/138.JPG_2.jpg,1458,480,640,27,253,280,257,311,True,42
r,172,kaist_dataset/English/Digital_Camera/(E.S)C-outdoor1/2007-12-08-day-098.jpg,char_data/r/2007-12-08-day-098.jpg_5.jpg,17200,1200,1600,100,986,1086,484,656,True,42
r,13,kaist_dataset/English/Digital_Camera/(E.S)C-outdoor1/7.jpg,char_data/r/7.jpg_5.jpg,91,574,680,7,225,232,107,120,True,42
r,35,kaist_dataset/English/Digital_Camera/(E.S)C-outdoor1/DSC02355.JPG,char_data/r/DSC02355.JPG_2.jpg,840,480,640,24,292,316,305,340,True,42
r,31,kaist_dataset/English/Digital_Camera/(E.S)C-outdoor1/DSC02356.JPG,char_data/r/DSC02356.JPG_7.jpg,434,480,640,14,201,215,313,344,True,42
r,33,kaist_dataset/English/Digital_Camera/(E.S)C-outdoor1/DSC02356.JPG,char_data/r/DSC02356.JPG_8.jpg,495,480,640,15,523,538,314,347,True,42
r,30,kaist_dataset/English/Digital_Camera/(E.S)C-outdoor1/DSC02387.JPG,char_data/r/DSC02387.JPG_2.jpg,450,480,640,15,499,514,297,327,True,42
r,27,kaist_dataset/English/Digital_Camera/(E.S)C-outdoor1/DSC02417.JPG,char_data/r/DSC02417.JPG_2.jpg,351,480,640,13,539,552,181,208,True,42
r,38,kaist_dataset/English/Digital_Camera/(E.S)C-outdoor1/DSC02480.JPG,char_data/r/DSC02480.JPG_5.jpg,988,480,640,26,296,322,405,443,True,42
r,72,kaist_dataset/English/Digital_Camera/(E.S)C-outdoor1/DSC02491.JPG,char_data/r/DSC02491.JPG_2.jpg,2376,480,640,33,158,191,137,209,True,42
r,64,kaist_dataset/English/Digital_Camera/(E.S)C-outdoor1/DSC02514.JPG,char_data/r/DSC02514.JPG_5.jpg,1472,480,640,23,388,411,185,249,True,42
r,41,kaist_dataset/English/Digital_Camera/(E.S)C-outdoor1/DSC02868.JPG,char_data/r/DSC02868.JPG_2.jpg,410,480,640,10,290,300,400,441,True,42
r,33,kaist_dataset/English/Digital_Camera/(E.S)C-outdoor1/DSC02918.JPG,char_data/r/DSC02918.JPG_4.jpg,660,480,640,20,352,372,235,268,True,42
r,35,kaist_dataset/English/Digital_Camera/(E.S)C-outdoor1/DSC02918.JPG,char_data/r/DSC02918.JPG_5.jpg,875,480,640,25,226,251,188,223,True,42
r,46,kaist_dataset/English/Digital_Camera/(E.S)C-outdoor2/DSC03000.JPG,char_data/r/DSC03000.JPG_2.jpg,1334,480,640,29,351,380,293,339,True,42
r,56,kaist_dataset/English/Digital_Camera/(E.S)C-outdoor2/DSC03001.JPG,char_data/r/DSC03001.JPG_4.jpg,1848,480,640,33,45,78,203,259,True,42
r,52,kaist_dataset/English/Digital_Camera/(E.S)C-outdoor2/DSC03001.JPG,char_data/r/DSC03001.JPG_5.jpg,1664,480,640,32,373,405,191,243,True,42
r,38,kaist_dataset/English/Digital_Camera/(E.S)C-outdoor2/DSC03053.JPG,char_data/r/DSC03053.JPG_2.jpg,760,480,640,20,77,97,139,177,True,42
r,41,kaist_dataset/English/Digital_Camera/(E.S)C-outdoor2/DSC03166.JPG,char_data/r/DSC03166.JPG_2.jpg,943,480,640,23,311,334,271,312,True,42
r,41,kaist_dataset/English/Digital_Camera/(E.S)C-outdoor2/DSC03169.JPG,char_data/r/DSC03169.JPG_2.jpg,1148,480,640,28,400,428,298,339,True,42
r,60,kaist_dataset/English/Digital_Camera/(E.S)C-outdoor2/DSC03192.JPG,char_data/r/DSC03192.JPG_2.jpg,3240,480,640,54,429,483,159,219,True,42
r,75,kaist_dataset/English/Digital_Camera/(E.S)C-outdoor2/DSC03229.JPG,char_data/r/DSC03229.JPG_2.jpg,2700,480,640,36,601,637,140,215,True,42
r,71,kaist_dataset/English/Digital_Camera/(E.S)C-outdoor2/DSC03276.JPG,char_data/r/DSC03276.JPG_2.jpg,3550,480,640,50,234,284,347,418,True,42
r,44,kaist_dataset/English/Digital_Camera/(E.S)C-outdoor2/DSC03290.JPG,char_data/r/DSC03290.JPG_2.jpg,968,480,640,22,215,237,416,460,True,42
r,43,kaist_dataset/English/Digital_Camera/(E.S)C-outdoor2/DSC03294.JPG,char_data/r/DSC03294.JPG_5.jpg,946,480,640,22,419,441,303,346,True,42
r,45,kaist_dataset/English/Digital_Camera/(E.S)C-outdoor2/DSC03297.JPG,char_data/r/DSC03297.JPG_5.jpg,1125,480,640,25,470,495,259,304,True,42
r,37,kaist_dataset/English/Digital_Camera/(E.S)C-outdoor2/DSC03307.JPG,char_data/r/DSC03307.JPG_4.jpg,703,480,640,19,299,318,172,209,True,42
r,152,kaist_dataset/English/Digital_Camera/(E.S)C-outdoor2/DSC03406.JPG,char_data/r/DSC03406.JPG_4.jpg,8968,480,640,59,130,189,41,193,True,42
r,127,kaist_dataset/English/Digital_Camera/(E.S)C-outdoor2/DSC03406.JPG,char_data/r/DSC03406.JPG_5.jpg,8509,480,640,67,444,511,44,171,True,42
r,66,kaist_dataset/English/Digital_Camera/(E.S)C-outdoor2/DSC03413.JPG,char_data/r/DSC03413.JPG_2.jpg,2640,480,640,40,370,410,128,194,True,42
r,60,kaist_dataset/English/Digital_Camera/(E.S)C-outdoor2/DSC03436.JPG,char_data/r/DSC03436.JPG_2.jpg,2520,480,640,42,329,371,44,104,True,42
r,104,kaist_dataset/English/Digital_Camera/(E.S)C-outdoor2/DSC03663.JPG,char_data/r/DSC03663.JPG_2.jpg,4992,480,640,48,134,182,170,274,True,42
r,43,kaist_dataset/English/Digital_Camera/(E.S)C-outdoor2/DSC03664.JPG,char_data/r/DSC03664.JPG_2.jpg,1161,480,640,27,459,486,26,69,True,42
r,37,kaist_dataset/English/Digital_Camera/(E.S)C-outdoor2/DSC03865.JPG,char_data/r/DSC03865.JPG_7.jpg,629,480,640,17,173,190,101,138,True,42
r,36,kaist_dataset/English/Digital_Camera/(E.S)C-outdoor2/DSC03865.JPG,char_data/r/DSC03865.JPG_8.jpg,792,480,640,22,73,95,56,92,True,42
r,60,kaist_dataset/English/Digital_Camera/(E.S)C-outdoor2/DSC04047.JPG,char_data/r/DSC04047.JPG_2.jpg,2580,480,640,43,97,140,228,288,True,42
r,49,kaist_dataset/English/Digital_Camera/(E.S)C-outdoor2/DSC04066.JPG,char_data/r/DSC04066.JPG_4.jpg,1127,480,640,23,269,292,349,398,True,42
r,68,kaist_dataset/English/Digital_Camera/(E.S)C-outdoor2/DSC04066.JPG,char_data/r/DSC04066.JPG_5.jpg,2244,480,640,33,565,598,332,400,True,42
r,32,kaist_dataset/English/Digital_Camera/(E.S)C-outdoor2/DSC04079.JPG,char_data/r/DSC04079.JPG_6.jpg,544,480,640,17,281,298,119,151,True,42
r,36,kaist_dataset/English/Digital_Camera/(E.S)C-outdoor2/DSC04079.JPG,char_data/r/DSC04079.JPG_7.jpg,612,480,640,17,215,232,159,195,True,42
r,40,kaist_dataset/English/Digital_Camera/(E.S)C-outdoor2/DSC04079.JPG,char_data/r/DSC04079.JPG_8.jpg,840,480,640,21,291,312,198,238,True,42
r,75,kaist_dataset/English/Digital_Camera/(E.S)C-outdoor2/DSC04160.JPG,char_data/r/DSC04160.JPG_6.jpg,3750,480,640,50,175,225,364,439,True,42
r,68,kaist_dataset/English/Digital_Camera/(E.S)C-outdoor2/DSC04160.JPG,char_data/r/DSC04160.JPG_7.jpg,3740,480,640,55,197,252,266,334,True,42
r,73,kaist_dataset/English/Digital_Camera/(E.S)C-outdoor2/DSC04160.JPG,char_data/r/DSC04160.JPG_8.jpg,4453,480,640,61,248,309,256,329,True,42
r,52,kaist_dataset/English/Digital_Camera/(E.S)C-outdoor2/DSC04163.JPG,char_data/r/DSC04163.JPG_2.jpg,1456,480,640,28,277,305,261,313,True,42
r,59,kaist_dataset/English/Digital_Camera/(E.S)C-outdoor2/DSC04251.JPG,char_data/r/DSC04251.JPG_2.jpg,2065,480,640,35,164,199,77,136,True,42
r,54,kaist_dataset/English/Digital_Camera/(E.S)C-outdoor2/DSC04397.JPG,char_data/r/DSC04397.JPG_2.jpg,1620,480,640,30,216,246,135,189,True,42
r,127,kaist_dataset/English/Digital_Camera/(E.S)C-outdoor2/DSC04433.JPG,char_data/r/DSC04433.JPG_2.jpg,10160,480,640,80,163,243,126,253,True,42
r,27,kaist_dataset/English/Digital_Camera/(E.S)C-outdoor2/DSC04437.JPG,char_data/r/DSC04437.JPG_6.jpg,324,480,640,12,307,319,47,74,True,42
r,23,kaist_dataset/English/Digital_Camera/(E.S)C-outdoor2/DSC04437.JPG,char_data/r/DSC04437.JPG_7.jpg,207,480,640,9,281,290,79,102,True,42
r,21,kaist_dataset/English/Digital_Camera/(E.S)C-outdoor2/DSC04437.JPG,char_data/r/DSC04437.JPG_8.jpg,315,480,640,15,433,448,83,104,True,42
r,114,kaist_dataset/English/Digital_Camera/(E.S)C-outdoor2/DSC04458.JPG,char_data/r/DSC04458.JPG_4.jpg,6612,480,640,58,404,462,297,411,True,42
r,119,kaist_dataset/English/Digital_Camera/(E.S)C-outdoor2/DSC04458.JPG,char_data/r/DSC04458.JPG_5.jpg,6664,480,640,56,132,188,144,263,True,42
r,45,kaist_dataset/English/Digital_Camera/(E.S)C-outdoor2/P1010057.JPG,char_data/r/P1010057.JPG_2.jpg,1080,480,640,24,380,404,203,248,True,42
r,38,kaist_dataset/English/Digital_Camera/(E.S)C-outdoor3/DSC03038.JPG,char_data/r/DSC03038.JPG_6.jpg,532,480,640,14,131,145,333,371,True,42
r,36,kaist_dataset/English/Digital_Camera/(E.S)C-outdoor3/DSC03038.JPG,char_data/r/DSC03038.JPG_7.jpg,756,480,640,21,281,302,320,356,True,42
r,36,kaist_dataset/English/Digital_Camera/(E.S)C-outdoor3/DSC03038.JPG,char_data/r/DSC03038.JPG_8.jpg,684,480,640,19,355,374,313,349,True,42
r,69,kaist_dataset/English/Digital_Camera/(E.S)C-outdoor3/P1010064.JPG,char_data/r/P1010064.JPG_5.jpg,2484,480,640,36,401,437,324,393,True,42
r,66,kaist_dataset/English/Digital_Camera/(E.S)C-outdoor3/P1010086.JPG,char_data/r/P1010086.JPG_2.jpg,2442,480,640,37,234,271,88,154,True,42
r,21,kaist_dataset/English/Digital_Camera/(E.S)C-outdoor3/P1010123.JPG,char_data/r/P1010123.JPG_8.jpg,168,480,640,8,516,524,75,96,True,42
r,19,kaist_dataset/English/Digital_Camera/(E.S)C-outdoor3/P1010123.JPG,char_data/r/P1010123.JPG_9.jpg,228,480,640,12,529,541,109,128,True,42
r,20,kaist_dataset/English/Digital_Camera/(E.S)C-outdoor3/P1010123.JPG,char_data/r/P1010123.JPG_10.jpg,200,480,640,10,20,30,81,101,True,42
r,23,kaist_dataset/English/Digital_Camera/(E.S)C-outdoor3/P1010123.JPG,char_data/r/P1010123.JPG_11.jpg,276,480,640,12,29,41,114,137,True,42
r,25,kaist_dataset/English/Digital_Camera/(E.S)C-outdoor3/크기변환_%B0%A3%C6%C71_m_starfirm.jpg,char_data/r/크기변환_%B0%A3%C6%C71_m_starfirm.jpg_8.jpg,575,480,640,23,528,551,290,315,True,42
r,15,kaist_dataset/English/Digital_Camera/(E.S)C-outdoor3/크기변환_P1010076.JPG,char_data/r/크기변환_P1010076.JPG_5.jpg,135,480,640,9,260,269,108,123,True,42
r,50,kaist_dataset/English/Digital_Camera/(E.S)D-indoor/080119-0009.jpg,char_data/r/080119-0009.jpg_8.jpg,1050,1200,1600,21,1552,1573,170,220,True,42
r,35,kaist_dataset/English/Digital_Camera/(E.S)D-indoor/080119-0009.jpg,char_data/r/080119-0009.jpg_9.jpg,630,1200,1600,18,1007,1025,694,729,True,42
r,33,kaist_dataset/English/Digital_Camera/(E.S)D-indoor/080119-0009.jpg,char_data/r/080119-0009.jpg_10.jpg,528,1200,1600,16,770,786,1071,1104,True,42
r,53,kaist_dataset/English/Digital_Camera/(E.S)D-indoor/080119-0009.jpg,char_data/r/080119-0009.jpg_11.jpg,1007,1200,1600,19,1501,1520,94,147,True,42
r,59,kaist_dataset/English/Digital_Camera/(E.S)D-indoor/DSC02719.JPG,char_data/r/DSC02719.JPG_2.jpg,1239,480,640,21,401,422,284,343,True,42
r,76,kaist_dataset/English/Digital_Camera/(E.S)D-indoor/DSC02853.JPG,char_data/r/DSC02853.JPG_2.jpg,3192,480,640,42,365,407,136,212,True,42
r,56,kaist_dataset/English/Digital_Camera/(E.S)D-indoor/DSC02854.JPG,char_data/r/DSC02854.JPG_2.jpg,1456,480,640,26,396,422,150,206,True,42
r,49,kaist_dataset/English/Digital_Camera/(E.S)D-indoor/DSC02862.JPG,char_data/r/DSC02862.JPG_5.jpg,1911,480,640,39,345,384,254,303,True,42
r,45,kaist_dataset/English/Digital_Camera/(E.S)D-indoor/DSC03078.JPG,char_data/r/DSC03078.JPG_2.jpg,855,480,640,19,532,551,238,283,True,42
r,63,kaist_dataset/English/Digital_Camera/(E.S)D-indoor/DSC03085.JPG,char_data/r/DSC03085.JPG_8.jpg,1323,480,640,21,467,488,375,438,True,42
r,36,kaist_dataset/English/Digital_Camera/(E.S)D-indoor/DSC03090.JPG,char_data/r/DSC03090.JPG_8.jpg,900,480,640,25,505,530,244,280,True,42
r,44,kaist_dataset/English/Digital_Camera/(E.S)D-indoor/DSC03090.JPG,char_data/r/DSC03090.JPG_10.jpg,484,480,640,11,410,421,289,333,True,42
r,52,kaist_dataset/English/Digital_Camera/(E.S)D-indoor/DSC03093.JPG,char_data/r/DSC03093.JPG_2.jpg,1768,480,640,34,313,347,138,190,True,42
r,34,kaist_dataset/English/Digital_Camera/(E.S)D-indoor/DSC03112.JPG,char_data/r/DSC03112.JPG_2.jpg,510,480,640,15,291,306,210,244,True,42
r,58,kaist_dataset/English/Digital_Camera/(E.S)D-indoor/DSC03136.JPG,char_data/r/DSC03136.JPG_2.jpg,1624,480,640,28,444,472,263,321,True,42
r,40,kaist_dataset/English/Digital_Camera/(E.S)D-indoor/DSC03149.JPG,char_data/r/DSC03149.JPG_2.jpg,1040,480,640,26,509,535,396,436,True,42
r,41,kaist_dataset/English/Digital_Camera/(E.S)D-indoor/DSC03150.JPG,char_data/r/DSC03150.JPG_2.jpg,1189,480,640,29,120,149,41,82,True,42
r,48,kaist_dataset/English/Digital_Camera/(E.S)D-indoor/DSC03151.JPG,char_data/r/DSC03151.JPG_2.jpg,1296,480,640,27,149,176,111,159,True,42
r,45,kaist_dataset/English/Digital_Camera/(E.S)D-indoor/DSC03345.JPG,char_data/r/DSC03345.JPG_2.jpg,1080,480,640,24,417,441,100,145,True,42
r,46,kaist_dataset/English/Digital_Camera/(E.S)D-indoor/DSC03376.JPG,char_data/r/DSC03376.JPG_2.jpg,1288,480,640,28,302,330,402,448,True,42
r,41,kaist_dataset/English/Digital_Camera/(E.S)D-indoor/DSC03396.JPG,char_data/r/DSC03396.JPG_5.jpg,779,480,640,19,395,414,344,385,True,42
r,49,kaist_dataset/English/Digital_Camera/(E.S)D-indoor/DSC03441.JPG,char_data/r/DSC03441.JPG_2.jpg,1519,480,640,31,246,277,392,441,True,42
r,30,kaist_dataset/English/Digital_Camera/(E.S)D-indoor/DSC03532.JPG,char_data/r/DSC03532.JPG_8.jpg,330,480,640,11,79,90,374,404,True,42
r,26,kaist_dataset/English/Digital_Camera/(E.S)D-indoor/DSC03532.JPG,char_data/r/DSC03532.JPG_10.jpg,234,480,640,9,285,294,384,410,True,42
r,21,kaist_dataset/English/Digital_Camera/(E.S)D-indoor/DSC03532.JPG,char_data/r/DSC03532.JPG_11.jpg,210,480,640,10,473,483,386,407,True,42
r,50,kaist_dataset/English/Digital_Camera/(E.S)D-indoor/DSC03936.JPG,char_data/r/DSC03936.JPG_6.jpg,1050,480,640,21,308,329,87,137,True,42
r,50,kaist_dataset/English/Digital_Camera/(E.S)D-indoor/DSC03936.JPG,char_data/r/DSC03936.JPG_7.jpg,1000,480,640,20,561,581,88,138,True,42
r,49,kaist_dataset/English/Digital_Camera/(E.S)D-indoor/DSC03936.JPG,char_data/r/DSC03936.JPG_8.jpg,1127,480,640,23,426,449,166,215,True,42
r,32,kaist_dataset/English/Digital_Camera/(E.S)D-indoor/DSC04023.JPG,char_data/r/DSC04023.JPG_2.jpg,704,480,640,22,557,579,335,367,True,42
r,48,kaist_dataset/English/Digital_Camera/(E.S)D-indoor/크기변환_%B0%A3%C6%C76_fabdent.jpg,char_data/r/크기변환_%B0%A3%C6%C76_fabdent.jpg_2.jpg,1008,480,640,21,301,322,186,234,True,42
r,77,kaist_dataset/English/Digital_Camera/(E.S)E-night/DSC02570.JPG,char_data/r/DSC02570.JPG_2.jpg,2849,480,640,37,448,485,253,330,True,42
r,114,kaist_dataset/English/Digital_Camera/(E.S)E-night/DSC02639.JPG,char_data/r/DSC02639.JPG_2.jpg,6840,480,640,60,361,421,223,337,True,42
r,51,kaist_dataset/English/Digital_Camera/(E.S)F-others/080119-0007.jpg,char_data/r/080119-0007.jpg_12.jpg,1428,1200,1600,28,764,792,842,893,True,42
r,31,kaist_dataset/English/Digital_Camera/(E.S)F-others/080119-0007.jpg,char_data/r/080119-0007.jpg_16.jpg,465,1200,1600,15,820,835,907,938,True,42
r,52,kaist_dataset/English/Digital_Camera/(E.S)F-others/080119-0007.jpg,char_data/r/080119-0007.jpg_17.jpg,1456,1200,1600,28,1019,1047,723,775,True,42
r,84,kaist_dataset/English/Mobile_Phone/(E.M)A-outdoor/P090912059.jpg,char_data/r/P090912059.jpg_2.jpg,6048,480,640,72,450,522,163,247,True,42
r,56,kaist_dataset/English/Mobile_Phone/(E.M)A-outdoor/P090912072.jpg,char_data/r/P090912072.jpg_4.jpg,2240,480,640,40,295,335,43,99,True,42
r,45,kaist_dataset/English/Mobile_Phone/(E.M)A-outdoor/P090912072.jpg,char_data/r/P090912072.jpg_5.jpg,1935,480,640,43,161,204,196,241,True,42
r,64,kaist_dataset/English/Mobile_Phone/(E.M)B-indoor/P090831011.jpg,char_data/r/P090831011.jpg_4.jpg,1920,480,640,30,164,194,133,197,True,42
r,79,kaist_dataset/English/Mobile_Phone/(E.M)B-indoor/P090831011.jpg,char_data/r/P090831011.jpg_5.jpg,2686,480,640,34,398,432,125,204,True,42
r,57,kaist_dataset/English/Mobile_Phone/(E.M)B-indoor/P090902018.jpg,char_data/r/P090902018.jpg_4.jpg,1539,480,640,27,461,488,192,249,True,42
r,54,kaist_dataset/English/Mobile_Phone/(E.M)B-indoor/P090902018.jpg,char_data/r/P090902018.jpg_5.jpg,1404,480,640,26,290,316,299,353,True,42
r,119,kaist_dataset/English/Mobile_Phone/(E.M)B-indoor/P090903001.jpg,char_data/r/P090903001.jpg_2.jpg,11543,480,640,97,502,599,140,259,True,42
r,86,kaist_dataset/English/Mobile_Phone/(E.M)B-indoor/P090903004.jpg,char_data/r/P090903004.jpg_2.jpg,5676,480,640,66,274,340,256,342,True,42
r,54,kaist_dataset/English/Mobile_Phone/(E.M)B-indoor/P090903007.jpg,char_data/r/P090903007.jpg_2.jpg,2106,480,640,39,536,575,260,314,True,42
r,55,kaist_dataset/English/Mobile_Phone/(E.M)B-indoor/P090903008.jpg,char_data/r/P090903008.jpg_2.jpg,2420,480,640,44,419,463,40,95,True,42
r,77,kaist_dataset/English/Mobile_Phone/(E.M)B-indoor/P090911080.jpg,char_data/r/P090911080.jpg_5.jpg,3465,480,640,45,185,230,217,294,True,42
r,74,kaist_dataset/English/Mobile_Phone/(E.M)B-indoor/P090911083.jpg,char_data/r/P090911083.jpg_2.jpg,2294,480,640,31,504,535,221,295,True,42
r,56,kaist_dataset/English/Mobile_Phone/(E.M)B-indoor/P090911084.jpg,char_data/r/P090911084.jpg_5.jpg,1624,480,640,29,569,598,156,212,True,42
r,98,kaist_dataset/English/Mobile_Phone/(E.M)C-bookCover/P090831077.jpg,char_data/r/P090831077.jpg_2.jpg,5586,480,640,57,100,157,70,168,True,42
r,40,kaist_dataset/English/Mobile_Phone/(E.M)C-bookCover/P090903030.jpg,char_data/r/P090903030.jpg_2.jpg,1000,480,640,25,155,180,78,118,True,42
r,78,kaist_dataset/English/Mobile_Phone/(E.M)C-bookCover/P090903054.jpg,char_data/r/P090903054.jpg_6.jpg,4134,480,640,53,487,540,231,309,True,42
r,23,kaist_dataset/Korean/Digital_Camera/A-shadow/2007-12-09-day-exterior-031.jpg,char_data/r/2007-12-09-day-exterior-031.jpg_6.jpg,299,1200,1600,13,356,369,623,646,True,42
r,23,kaist_dataset/Korean/Digital_Camera/A-shadow/2007-12-09-day-exterior-031.jpg,char_data/r/2007-12-09-day-exterior-031.jpg_8.jpg,345,1200,1600,15,530,545,617,640,True,42
r,42,kaist_dataset/Korean/Digital_Camera/G-others/080119-0005.jpg,char_data/r/080119-0005.jpg_4.jpg,966,1600,1200,23,643,666,1156,1198,True,42
r,28,kaist_dataset/Korean/Digital_Camera/G-others/080119-0005.jpg,char_data/r/080119-0005.jpg_5.jpg,420,1600,1200,15,657,672,605,633,True,42
r,22,kaist_dataset/Korean/Digital_Camera/indoor1/145.JPG,char_data/r/145.JPG_4.jpg,242,480,640,11,231,242,306,328,True,42
r,15,kaist_dataset/Korean/Digital_Camera/indoor1/145.JPG,char_data/r/145.JPG_5.jpg,270,480,640,18,301,319,308,323,True,42
r,12,kaist_dataset/Korean/Digital_Camera/outdoor1/001.JPG,char_data/r/001.JPG_7.jpg,108,480,640,9,259,268,247,259,True,42
r,13,kaist_dataset/Korean/Digital_Camera/outdoor1/001.JPG,char_data/r/001.JPG_8.jpg,117,480,640,9,508,517,244,257,True,42
r,40,kaist_dataset/Korean/Digital_Camera/outdoor1/2007-12-08-day-056.jpg,char_data/r/2007-12-08-day-056.jpg_2.jpg,1000,1200,1600,25,932,957,401,441,True,42
r,32,kaist_dataset/Korean/Digital_Camera/outdoor1/2007-12-08-day-087.jpg,char_data/r/2007-12-08-day-087.jpg_4.jpg,704,1200,1600,22,5,27,516,548,True,42
r,64,kaist_dataset/Korean/Digital_Camera/outdoor1/2007-12-08-day-087.jpg,char_data/r/2007-12-08-day-087.jpg_5.jpg,2432,1200,1600,38,1488,1526,667,731,True,42
r,41,kaist_dataset/Korean/Digital_Camera/outdoor2/080118-0018.jpg,char_data/r/080118-0018.jpg_4.jpg,1681,1200,1600,41,642,683,684,725,True,42
r,51,kaist_dataset/Korean/Digital_Camera/outdoor2/080118-0018.jpg,char_data/r/080118-0018.jpg_5.jpg,2040,1200,1600,40,1252,1292,691,742,True,42
r,38,kaist_dataset/Korean/Digital_Camera/outdoor2/2007-12-09-day-exterior-036.jpg,char_data/r/2007-12-09-day-exterior-036.jpg_2.jpg,684,1200,1600,18,1542,1560,554,592,True,42
r,24,kaist_dataset/Mixed/Digital_Camera/(C.S)C-outdoor1/003.JPG,char_data/r/003.JPG_2.jpg,192,480,640,8,498,506,252,276,True,42
r,30,kaist_dataset/Mixed/Digital_Camera/(C.S)C-outdoor1/062.JPG,char_data/r/062.JPG_2.jpg,390,480,640,13,373,386,170,200,True,42
r,222,kaist_dataset/Mixed/Digital_Camera/(C.S)C-outdoor1/080119-0008.jpg,char_data/r/080119-0008.jpg_2.jpg,35964,1200,1600,162,960,1122,577,799,True,42
r,35,kaist_dataset/Mixed/Digital_Camera/(C.S)C-outdoor1/1.JPG,char_data/r/1.JPG_6.jpg,455,576,768,13,486,499,13,48,True,42
r,40,kaist_dataset/Mixed/Digital_Camera/(C.S)C-outdoor1/101.JPG,char_data/r/101.JPG_2.jpg,1360,480,640,34,525,559,248,288,True,42
r,29,kaist_dataset/Mixed/Digital_Camera/(C.S)C-outdoor1/115.JPG,char_data/r/115.JPG_2.jpg,435,480,640,15,403,418,278,307,True,42
r,23,kaist_dataset/Mixed/Digital_Camera/(C.S)C-outdoor1/2.JPG,char_data/r/2.JPG_9.jpg,161,576,768,7,114,121,384,407,True,42
r,46,kaist_dataset/Mixed/Digital_Camera/(C.S)C-outdoor1/2007-12-09-day-exterior-004.jpg,char_data/r/2007-12-09-day-exterior-004.jpg_2.jpg,1288,1200,1600,28,482,510,674,720,True,42
r,55,kaist_dataset/Mixed/Digital_Camera/(C.S)C-outdoor1/2007-12-09-day-exterior-044.jpg,char_data/r/2007-12-09-day-exterior-044.jpg_2.jpg,1650,1200,1600,30,770,800,835,890,True,42
r,29,kaist_dataset/Mixed/Digital_Camera/(C.S)C-outdoor1/DSC02242.JPG,char_data/r/DSC02242.JPG_2.jpg,232,480,640,8,301,309,164,193,True,42
r,25,kaist_dataset/Mixed/Digital_Camera/(C.S)C-outdoor1/DSC02319.JPG,char_data/r/DSC02319.JPG_4.jpg,400,480,640,16,134,150,278,303,True,42
r,19,kaist_dataset/Mixed/Digital_Camera/(C.S)C-outdoor1/DSC02319.JPG,char_data/r/DSC02319.JPG_5.jpg,361,480,640,19,126,145,254,273,True,42
r,34,kaist_dataset/Mixed/Digital_Camera/(C.S)C-outdoor1/DSC02320.JPG,char_data/r/DSC02320.JPG_2.jpg,578,480,640,17,366,383,231,265,True,42
r,87,kaist_dataset/Mixed/Digital_Camera/(C.S)C-outdoor1/P1010008.JPG,char_data/r/P1010008.JPG_2.jpg,4698,480,640,54,323,377,237,324,True,42
r,26,kaist_dataset/Mixed/Digital_Camera/(C.S)C-outdoor2/DSC02385.JPG,char_data/r/DSC02385.JPG_5.jpg,364,480,640,14,515,529,136,162,True,42
r,51,kaist_dataset/Mixed/Digital_Camera/(C.S)C-outdoor2/DSC02400.JPG,char_data/r/DSC02400.JPG_2.jpg,1581,480,640,31,348,379,319,370,True,42
r,50,kaist_dataset/Mixed/Digital_Camera/(C.S)C-outdoor2/DSC02407.JPG,char_data/r/DSC02407.JPG_2.jpg,1900,480,640,38,574,612,182,232,True,42
r,37,kaist_dataset/Mixed/Digital_Camera/(C.S)C-outdoor2/DSC02411.JPG,char_data/r/DSC02411.JPG_2.jpg,740,480,640,20,347,367,352,389,True,42
r,52,kaist_dataset/Mixed/Digital_Camera/(C.S)C-outdoor2/DSC02418.JPG,char_data/r/DSC02418.JPG_4.jpg,2132,480,640,41,191,232,171,223,True,42
r,64,kaist_dataset/Mixed/Digital_Camera/(C.S)C-outdoor2/DSC02418.JPG,char_data/r/DSC02418.JPG_5.jpg,3328,480,640,52,504,556,162,226,True,42
r,54,kaist_dataset/Mixed/Digital_Camera/(C.S)C-outdoor2/DSC02433.JPG,char_data/r/DSC02433.JPG_2.jpg,1512,480,640,28,276,304,194,248,True,42
r,19,kaist_dataset/Mixed/Digital_Camera/(C.S)C-outdoor2/DSC02439.JPG,char_data/r/DSC02439.JPG_5.jpg,171,480,640,9,460,469,113,132,True,42
r,31,kaist_dataset/Mixed/Digital_Camera/(C.S)C-outdoor2/DSC02482.JPG,char_data/r/DSC02482.JPG_2.jpg,899,480,640,29,262,291,267,298,True,42
r,79,kaist_dataset/Mixed/Digital_Camera/(C.S)C-outdoor2/DSC02493.JPG,char_data/r/DSC02493.JPG_2.jpg,3713,480,640,47,321,368,290,369,True,42
r,34,kaist_dataset/Mixed/Digital_Camera/(C.S)C-outdoor2/DSC02532.JPG,char_data/r/DSC02532.JPG_2.jpg,578,480,640,17,515,532,89,123,True,42
r,23,kaist_dataset/Mixed/Digital_Camera/(C.S)C-outdoor2/DSC02545.JPG,char_data/r/DSC02545.JPG_2.jpg,506,480,640,22,210,232,374,397,True,42
r,27,kaist_dataset/Mixed/Digital_Camera/(C.S)C-outdoor2/DSC02560.JPG,char_data/r/DSC02560.JPG_2.jpg,540,480,640,20,425,445,305,332,True,42
r,33,kaist_dataset/Mixed/Digital_Camera/(C.S)C-outdoor2/DSC02864.JPG,char_data/r/DSC02864.JPG_2.jpg,627,480,640,19,609,628,265,298,True,42
r,37,kaist_dataset/Mixed/Digital_Camera/(C.S)C-outdoor2/DSC02867.JPG,char_data/r/DSC02867.JPG_2.jpg,740,480,640,20,400,420,406,443,True,42
r,29,kaist_dataset/Mixed/Digital_Camera/(C.S)C-outdoor2/DSC02886.JPG,char_data/r/DSC02886.JPG_2.jpg,493,480,640,17,495,512,133,162,True,42
r,43,kaist_dataset/Mixed/Digital_Camera/(C.S)C-outdoor2/DSC02907.JPG,char_data/r/DSC02907.JPG_2.jpg,1075,480,640,25,403,428,97,140,True,42
r,49,kaist_dataset/Mixed/Digital_Camera/(C.S)C-outdoor3/DSC02962.JPG,char_data/r/DSC02962.JPG_7.jpg,931,480,640,19,82,101,228,277,True,42
r,42,kaist_dataset/Mixed/Digital_Camera/(C.S)C-outdoor3/DSC02962.JPG,char_data/r/DSC02962.JPG_8.jpg,1092,480,640,26,391,417,174,216,True,42
r,22,kaist_dataset/Mixed/Digital_Camera/(C.S)C-outdoor3/DSC02970.JPG,char_data/r/DSC02970.JPG_2.jpg,374,480,640,17,275,292,311,333,True,42
r,93,kaist_dataset/Mixed/Digital_Camera/(C.S)C-outdoor3/DSC03017.JPG,char_data/r/DSC03017.JPG_2.jpg,6324,480,640,68,283,351,149,242,True,42
r,31,kaist_dataset/Mixed/Digital_Camera/(C.S)C-outdoor3/DSC03209.JPG,char_data/r/DSC03209.JPG_8.jpg,465,480,640,15,419,434,419,450,True,42
r,101,kaist_dataset/Mixed/Digital_Camera/(C.S)C-outdoor3/DSC03210.JPG,char_data/r/DSC03210.JPG_5.jpg,5656,480,640,56,463,519,238,339,True,42
r,24,kaist_dataset/Mixed/Digital_Camera/(C.S)C-outdoor3/DSC03271.JPG,char_data/r/DSC03271.JPG_2.jpg,336,480,640,14,275,289,85,109,True,42
r,61,kaist_dataset/Mixed/Digital_Camera/(C.S)C-outdoor3/DSC03310.JPG,char_data/r/DSC03310.JPG_4.jpg,2318,480,640,38,174,212,92,153,True,42
r,39,kaist_dataset/Mixed/Digital_Camera/(C.S)C-outdoor3/DSC03310.JPG,char_data/r/DSC03310.JPG_5.jpg,858,480,640,22,575,597,128,167,True,42
r,25,kaist_dataset/Mixed/Digital_Camera/(C.S)C-outdoor3/DSC03328.JPG,char_data/r/DSC03328.JPG_2.jpg,450,480,640,18,372,390,242,267,True,42
r,52,kaist_dataset/Mixed/Digital_Camera/(C.S)C-outdoor3/DSC03332.JPG,char_data/r/DSC03332.JPG_2.jpg,1976,480,640,38,543,581,214,266,True,42
r,66,kaist_dataset/Mixed/Digital_Camera/(C.S)C-outdoor3/DSC03422.JPG,char_data/r/DSC03422.JPG_2.jpg,1650,480,640,25,179,204,239,305,True,42
r,70,kaist_dataset/Mixed/Digital_Camera/(C.S)C-outdoor3/P1010016.JPG,char_data/r/P1010016.JPG_2.jpg,3080,480,640,44,431,475,180,250,True,42
r,20,kaist_dataset/Mixed/Digital_Camera/(C.S)C-outdoor4/DSC03556.JPG,char_data/r/DSC03556.JPG_2.jpg,180,480,640,9,591,600,328,348,True,42
r,45,kaist_dataset/Mixed/Digital_Camera/(C.S)C-outdoor4/DSC03642.JPG,char_data/r/DSC03642.JPG_2.jpg,1080,480,640,24,557,581,244,289,True,42
r,47,kaist_dataset/Mixed/Digital_Camera/(C.S)C-outdoor4/DSC03643.JPG,char_data/r/DSC03643.JPG_2.jpg,1034,480,640,22,563,585,281,328,True,42
r,25,kaist_dataset/Mixed/Digital_Camera/(C.S)C-outdoor4/DSC03667.JPG,char_data/r/DSC03667.JPG_2.jpg,350,480,640,14,324,338,383,408,True,42
r,22,kaist_dataset/Mixed/Digital_Camera/(C.S)C-outdoor4/DSC03670.JPG,char_data/r/DSC03670.JPG_5.jpg,242,480,640,11,492,503,323,345,True,42
r,38,kaist_dataset/Mixed/Digital_Camera/(C.S)C-outdoor4/DSC03672.JPG,char_data/r/DSC03672.JPG_2.jpg,798,480,640,21,431,452,411,449,True,42
r,32,kaist_dataset/Mixed/Digital_Camera/(C.S)C-outdoor4/DSC03718.JPG,char_data/r/DSC03718.JPG_4.jpg,480,480,640,15,320,335,97,129,True,42
r,28,kaist_dataset/Mixed/Digital_Camera/(C.S)C-outdoor4/DSC03718.JPG,char_data/r/DSC03718.JPG_5.jpg,224,480,640,8,135,143,260,288,True,42
r,32,kaist_dataset/Mixed/Digital_Camera/(C.S)C-outdoor4/DSC03719.JPG,char_data/r/DSC03719.JPG_2.jpg,384,480,640,12,141,153,34,66,True,42
r,20,kaist_dataset/Mixed/Digital_Camera/(C.S)C-outdoor4/DSC03758.JPG,char_data/r/DSC03758.JPG_2.jpg,240,480,640,12,230,242,282,302,True,42
r,38,kaist_dataset/Mixed/Digital_Camera/(C.S)C-outdoor4/DSC03773.JPG,char_data/r/DSC03773.JPG_2.jpg,760,480,640,20,335,355,280,318,True,42
r,58,kaist_dataset/Mixed/Digital_Camera/(C.S)C-outdoor4/DSC03784.JPG,char_data/r/DSC03784.JPG_5.jpg,1566,480,640,27,491,518,319,377,True,42
r,32,kaist_dataset/Mixed/Digital_Camera/(C.S)C-outdoor5/DSC03821.JPG,char_data/r/DSC03821.JPG_4.jpg,768,480,640,24,293,317,41,73,True,42
r,36,kaist_dataset/Mixed/Digital_Camera/(C.S)C-outdoor5/DSC03821.JPG,char_data/r/DSC03821.JPG_5.jpg,468,480,640,13,494,507,47,83,True,42
r,37,kaist_dataset/Mixed/Digital_Camera/(C.S)C-outdoor5/DSC03839.JPG,char_data/r/DSC03839.JPG_2.jpg,444,480,640,12,248,260,37,74,True,42
r,29,kaist_dataset/Mixed/Digital_Camera/(C.S)C-outdoor5/DSC04057.JPG,char_data/r/DSC04057.JPG_5.jpg,406,480,640,14,304,318,116,145,True,42
r,35,kaist_dataset/Mixed/Digital_Camera/(C.S)C-outdoor5/DSC04069.JPG,char_data/r/DSC04069.JPG_4.jpg,665,480,640,19,384,403,418,453,True,42
r,30,kaist_dataset/Mixed/Digital_Camera/(C.S)C-outdoor5/DSC04069.JPG,char_data/r/DSC04069.JPG_5.jpg,480,480,640,16,447,463,381,411,True,42
r,41,kaist_dataset/Mixed/Digital_Camera/(C.S)C-outdoor5/DSC04076.JPG,char_data/r/DSC04076.JPG_6.jpg,1394,480,640,34,497,531,96,137,True,42
r,27,kaist_dataset/Mixed/Digital_Camera/(C.S)C-outdoor5/DSC04076.JPG,char_data/r/DSC04076.JPG_7.jpg,432,480,640,16,515,531,400,427,True,42
r,27,kaist_dataset/Mixed/Digital_Camera/(C.S)C-outdoor5/DSC04076.JPG,char_data/r/DSC04076.JPG_8.jpg,486,480,640,18,554,572,402,429,True,42
r,29,kaist_dataset/Mixed/Digital_Camera/(C.S)C-outdoor5/DSC04091.JPG,char_data/r/DSC04091.JPG_2.jpg,493,480,640,17,422,439,427,456,True,42
r,49,kaist_dataset/Mixed/Digital_Camera/(C.S)C-outdoor5/DSC04097.JPG,char_data/r/DSC04097.JPG_4.jpg,2401,480,640,49,111,160,190,239,True,42
r,47,kaist_dataset/Mixed/Digital_Camera/(C.S)C-outdoor5/DSC04097.JPG,char_data/r/DSC04097.JPG_5.jpg,1786,480,640,38,586,624,202,249,True,42
r,34,kaist_dataset/Mixed/Digital_Camera/(C.S)C-outdoor5/DSC04104.JPG,char_data/r/DSC04104.JPG_6.jpg,782,480,640,23,316,339,47,81,True,42
r,34,kaist_dataset/Mixed/Digital_Camera/(C.S)C-outdoor5/DSC04104.JPG,char_data/r/DSC04104.JPG_7.jpg,612,480,640,18,486,504,48,82,True,42
r,34,kaist_dataset/Mixed/Digital_Camera/(C.S)C-outdoor5/DSC04104.JPG,char_data/r/DSC04104.JPG_8.jpg,578,480,640,17,504,521,47,81,True,42
r,73,kaist_dataset/Mixed/Digital_Camera/(C.S)C-outdoor5/DSC04115.JPG,char_data/r/DSC04115.JPG_2.jpg,4015,480,640,55,559,614,199,272,True,42
r,43,kaist_dataset/Mixed/Digital_Camera/(C.S)C-outdoor5/DSC04162.JPG,char_data/r/DSC04162.JPG_2.jpg,1075,480,640,25,308,333,328,371,True,42
r,37,kaist_dataset/Mixed/Digital_Camera/(C.S)C-outdoor5/DSC04321.JPG,char_data/r/DSC04321.JPG_2.jpg,555,480,640,15,504,519,205,242,True,42
r,43,kaist_dataset/Mixed/Digital_Camera/(C.S)C-outdoor5/DSC04322.JPG,char_data/r/DSC04322.JPG_2.jpg,817,480,640,19,385,404,219,262,True,42
r,38,kaist_dataset/Mixed/Digital_Camera/(C.S)C-outdoor5/DSC04323.JPG,char_data/r/DSC04323.JPG_4.jpg,532,480,640,14,363,377,205,243,True,42
r,37,kaist_dataset/Mixed/Digital_Camera/(C.S)C-outdoor5/DSC04323.JPG,char_data/r/DSC04323.JPG_5.jpg,518,480,640,14,459,473,205,242,True,42
r,40,kaist_dataset/Mixed/Digital_Camera/(C.S)C-outdoor5/DSC04338.JPG,char_data/r/DSC04338.JPG_4.jpg,400,480,640,10,328,338,199,239,True,42
r,29,kaist_dataset/Mixed/Digital_Camera/(C.S)C-outdoor5/DSC04338.JPG,char_data/r/DSC04338.JPG_5.jpg,348,480,640,12,508,520,204,233,True,42
r,52,kaist_dataset/Mixed/Digital_Camera/(C.S)C-outdoor5/DSC04395.JPG,char_data/r/DSC04395.JPG_2.jpg,1404,480,640,27,486,513,350,402,True,42
r,49,kaist_dataset/Mixed/Digital_Camera/(C.S)C-outdoor5/DSC04456.JPG,char_data/r/DSC04456.JPG_2.jpg,980,480,640,20,306,326,165,214,True,42
r,71,kaist_dataset/Mixed/Digital_Camera/(C.S)C-outdoor5/P1010006.JPG,char_data/r/P1010006.JPG_2.jpg,3266,480,640,46,491,537,224,295,True,42
r,143,kaist_dataset/Mixed/Digital_Camera/(C.S)C-outdoor6/080116-0057.jpg,char_data/r/080116-0057.jpg_8.jpg,14300,1200,1600,100,1001,1101,357,500,True,42
r,145,kaist_dataset/Mixed/Digital_Camera/(C.S)C-outdoor6/080116-0057.jpg,char_data/r/080116-0057.jpg_9.jpg,13775,1200,1600,95,314,409,576,721,True,42
r,149,kaist_dataset/Mixed/Digital_Camera/(C.S)C-outdoor6/080116-0057.jpg,char_data/r/080116-0057.jpg_10.jpg,12814,1200,1600,86,1210,1296,577,726,True,42
r,44,kaist_dataset/Mixed/Digital_Camera/(C.S)C-outdoor6/080116-0057.jpg,char_data/r/080116-0057.jpg_11.jpg,880,1200,1600,20,274,294,920,964,False,42
r,34,kaist_dataset/Mixed/Digital_Camera/(C.S)C-outdoor6/090.jpg,char_data/r/090.jpg_2.jpg,578,480,640,17,398,415,160,194,False,42
r,31,kaist_dataset/Mixed/Digital_Camera/(C.S)C-outdoor6/P1010069.JPG,char_data/r/P1010069.JPG_2.jpg,465,480,640,15,340,355,304,335,False,42
r,92,kaist_dataset/Mixed/Digital_Camera/(C.S)C-outdoor6/P1010093.JPG,char_data/r/P1010093.JPG_2.jpg,5336,480,640,58,373,431,136,228,False,42
r,29,kaist_dataset/Mixed/Digital_Camera/(C.S)C-outdoor6/크기변환_P1010029.JPG,char_data/r/크기변환_P1010029.JPG_2.jpg,464,480,640,16,97,113,16,45,False,42
r,27,kaist_dataset/Mixed/Digital_Camera/(C.S)D-indoor1/DSC02718.JPG,char_data/r/DSC02718.JPG_2.jpg,324,480,640,12,159,171,241,268,False,42
r,48,kaist_dataset/Mixed/Digital_Camera/(C.S)D-indoor1/DSC02770.JPG,char_data/r/DSC02770.JPG_4.jpg,1248,480,640,26,346,372,358,406,False,42
r,53,kaist_dataset/Mixed/Digital_Camera/(C.S)D-indoor1/DSC02770.JPG,char_data/r/DSC02770.JPG_5.jpg,1325,480,640,25,473,498,357,410,False,42
r,38,kaist_dataset/Mixed/Digital_Camera/(C.S)D-indoor1/DSC02787.JPG,char_data/r/DSC02787.JPG_2.jpg,570,480,640,15,563,578,357,395,False,42
r,38,kaist_dataset/Mixed/Digital_Camera/(C.S)D-indoor1/DSC02804.JPG,char_data/r/DSC02804.JPG_2.jpg,532,480,640,14,403,417,352,390,False,42
r,39,kaist_dataset/Mixed/Digital_Camera/(C.S)D-indoor1/DSC03073.JPG,char_data/r/DSC03073.JPG_8.jpg,702,480,640,18,267,285,287,326,False,42
r,37,kaist_dataset/Mixed/Digital_Camera/(C.S)D-indoor1/DSC03073.JPG,char_data/r/DSC03073.JPG_9.jpg,518,480,640,14,307,321,288,325,False,42
r,36,kaist_dataset/Mixed/Digital_Camera/(C.S)D-indoor1/DSC03073.JPG,char_data/r/DSC03073.JPG_11.jpg,576,480,640,16,406,422,335,371,False,42
r,29,kaist_dataset/Mixed/Digital_Camera/(C.S)D-indoor1/DSC03096.JPG,char_data/r/DSC03096.JPG_2.jpg,406,480,640,14,294,308,427,456,False,42
r,35,kaist_dataset/Mixed/Digital_Camera/(C.S)D-indoor1/DSC03118.JPG,char_data/r/DSC03118.JPG_6.jpg,595,480,640,17,184,201,155,190,False,42
r,39,kaist_dataset/Mixed/Digital_Camera/(C.S)D-indoor1/DSC03118.JPG,char_data/r/DSC03118.JPG_7.jpg,546,480,640,14,317,331,153,192,False,42
r,41,kaist_dataset/Mixed/Digital_Camera/(C.S)D-indoor1/DSC03118.JPG,char_data/r/DSC03118.JPG_8.jpg,738,480,640,18,253,271,231,272,False,42
r,42,kaist_dataset/Mixed/Digital_Camera/(C.S)D-indoor1/DSC03119.JPG,char_data/r/DSC03119.JPG_2.jpg,630,480,640,15,289,304,167,209,False,42
r,36,kaist_dataset/Mixed/Digital_Camera/(C.S)D-indoor1/DSC03122.JPG,char_data/r/DSC03122.JPG_2.jpg,396,480,640,11,370,381,200,236,False,42
r,35,kaist_dataset/Mixed/Digital_Camera/(C.S)D-indoor1/DSC03126.JPG,char_data/r/DSC03126.JPG_2.jpg,525,480,640,15,281,296,227,262,False,42
r,38,kaist_dataset/Mixed/Digital_Camera/(C.S)D-indoor1/DSC03132.JPG,char_data/r/DSC03132.JPG_2.jpg,494,480,640,13,198,211,178,216,False,42
r,58,kaist_dataset/Mixed/Digital_Camera/(C.S)D-indoor1/DSC03460.JPG,char_data/r/DSC03460.JPG_2.jpg,1740,480,640,30,180,210,386,444,False,42
r,29,kaist_dataset/Mixed/Digital_Camera/(C.S)D-indoor1/DSC03466.JPG,char_data/r/DSC03466.JPG_4.jpg,348,480,640,12,363,375,235,264,False,42
r,32,kaist_dataset/Mixed/Digital_Camera/(C.S)D-indoor1/DSC03466.JPG,char_data/r/DSC03466.JPG_5.jpg,640,480,640,20,479,499,231,263,False,42
r,80,kaist_dataset/Mixed/Digital_Camera/(C.S)D-indoor1/DSC03469.JPG,char_data/r/DSC03469.JPG_2.jpg,3520,480,640,44,245,289,353,433,False,42
r,83,kaist_dataset/Mixed/Digital_Camera/(C.S)D-indoor1/DSC03909.JPG,char_data/r/DSC03909.JPG_2.jpg,2988,480,640,36,291,327,198,281,False,42
r,53,kaist_dataset/Mixed/Digital_Camera/(C.S)D-indoor1/DSC03925.JPG,char_data/r/DSC03925.JPG_2.jpg,1272,480,640,24,393,417,382,435,False,42
r,36,kaist_dataset/Mixed/Digital_Camera/(C.S)D-indoor1/DSC04206.JPG,char_data/r/DSC04206.JPG_6.jpg,540,480,640,15,230,245,287,323,False,42
r,37,kaist_dataset/Mixed/Digital_Camera/(C.S)D-indoor1/DSC04206.JPG,char_data/r/DSC04206.JPG_7.jpg,481,480,640,13,259,272,286,323,False,42
r,36,kaist_dataset/Mixed/Digital_Camera/(C.S)D-indoor1/DSC04246.JPG,char_data/r/DSC04246.JPG_6.jpg,576,480,640,16,353,369,250,286,False,42
r,33,kaist_dataset/Mixed/Digital_Camera/(C.S)D-indoor1/DSC04246.JPG,char_data/r/DSC04246.JPG_7.jpg,495,480,640,15,475,490,246,279,False,42
r,31,kaist_dataset/Mixed/Digital_Camera/(C.S)D-indoor1/DSC04246.JPG,char_data/r/DSC04246.JPG_8.jpg,403,480,640,13,502,515,249,280,False,42
r,34,kaist_dataset/Mixed/Digital_Camera/(C.S)D-indoor2/DSC04248.JPG,char_data/r/DSC04248.JPG_4.jpg,680,480,640,20,259,279,223,257,False,42
r,30,kaist_dataset/Mixed/Digital_Camera/(C.S)D-indoor2/DSC04254.JPG,char_data/r/DSC04254.JPG_2.jpg,660,480,640,22,563,585,339,369,False,42
r,43,kaist_dataset/Mixed/Digital_Camera/(C.S)D-indoor2/DSC04421.JPG,char_data/r/DSC04421.JPG_4.jpg,731,480,640,17,125,142,213,256,False,42
r,41,kaist_dataset/Mixed/Digital_Camera/(C.S)D-indoor2/DSC04421.JPG,char_data/r/DSC04421.JPG_5.jpg,902,480,640,22,246,268,215,256,False,42
r,39,kaist_dataset/Mixed/Digital_Camera/(C.S)E-night/DSC02574.JPG,char_data/r/DSC02574.JPG_5.jpg,702,480,640,18,503,521,151,190,False,42
r,106,kaist_dataset/Mixed/Digital_Camera/(C.S)E-night/DSC02585.JPG,char_data/r/DSC02585.JPG_2.jpg,8904,480,640,84,454,538,274,380,False,42
r,101,kaist_dataset/Mixed/Digital_Camera/(C.S)E-night/DSC02586.JPG,char_data/r/DSC02586.JPG_2.jpg,8080,480,640,80,279,359,261,362,False,42
r,34,kaist_dataset/Mixed/Digital_Camera/(C.S)E-night/DSC02623.JPG,char_data/r/DSC02623.JPG_2.jpg,782,480,640,23,517,540,402,436,False,42
r,33,kaist_dataset/Mixed/Digital_Camera/(C.S)E-night/DSC03031.JPG,char_data/r/DSC03031.JPG_4.jpg,396,480,640,12,158,170,23,56,False,42
r,27,kaist_dataset/Mixed/Digital_Camera/(C.S)E-night/DSC03031.JPG,char_data/r/DSC03031.JPG_5.jpg,405,480,640,15,325,340,28,55,False,42
r,32,kaist_dataset/Mixed/Digital_Camera/(C.S)F-others/2007-12-08-day-044.jpg,char_data/r/2007-12-08-day-044.jpg_2.jpg,416,1200,1600,13,1010,1023,825,857,False,42
r,25,kaist_dataset/Mixed/Digital_Camera/(C.S)F-others/2007-12-08-day-067.jpg,char_data/r/2007-12-08-day-067.jpg_4.jpg,1275,1600,1200,51,438,489,928,953,False,42
r,25,kaist_dataset/Mixed/Digital_Camera/(C.S)F-others/2007-12-08-day-067.jpg,char_data/r/2007-12-08-day-067.jpg_5.jpg,1425,1600,1200,57,428,485,1226,1251,False,42
r,32,kaist_dataset/Mixed/Digital_Camera/(C.S)F-others/2007-12-09-day-exterior-032.jpg,char_data/r/2007-12-09-day-exterior-032.jpg_5.jpg,800,1600,1200,25,713,738,350,382,False,42
r,77,kaist_dataset/Mixed/Digital_Camera/(C.S)F-others/DSC03489.JPG,char_data/r/DSC03489.JPG_2.jpg,3003,480,640,39,493,532,363,440,False,42
r,46,kaist_dataset/Mixed/Mobile_Phone/(C.M)B-indoor/P090831010.jpg,char_data/r/P090831010.jpg_7.jpg,1104,480,640,24,198,222,290,336,False,42
r,49,kaist_dataset/Mixed/Mobile_Phone/(C.M)B-indoor/P090831012.jpg,char_data/r/P090831012.jpg_2.jpg,1470,480,640,30,212,242,177,226,False,42
r,48,kaist_dataset/Mixed/Mobile_Phone/(C.M)B-indoor/P090831013.jpg,char_data/r/P090831013.jpg_4.jpg,960,480,640,20,258,278,195,243,False,42
r,45,kaist_dataset/Mixed/Mobile_Phone/(C.M)B-indoor/P090831013.jpg,char_data/r/P090831013.jpg_5.jpg,1215,480,640,27,319,346,192,237,False,42
r,41,kaist_dataset/Mixed/Mobile_Phone/(C.M)B-indoor/P090831017.jpg,char_data/r/P090831017.jpg_2.jpg,1271,480,640,31,396,427,251,292,False,42
r,56,kaist_dataset/Mixed/Mobile_Phone/(C.M)B-indoor/P090831023.jpg,char_data/r/P090831023.jpg_2.jpg,1792,480,640,32,98,130,278,334,False,42
r,33,kaist_dataset/Mixed/Mobile_Phone/(C.M)C-bookCover/P090831080.jpg,char_data/r/P090831080.jpg_2.jpg,726,480,640,22,370,392,339,372,False,42
r,31,kaist_dataset/Mixed/Mobile_Phone/(C.M)C-bookCover/P090831115.jpg,char_data/r/P090831115.jpg_2.jpg,465,480,640,15,367,382,175,206,False,42
r,48,kaist_dataset/Mixed/Mobile_Phone/(C.M)C-bookCover/P090831122.jpg,char_data/r/P090831122.jpg_2.jpg,1248,480,640,26,400,426,266,314,False,42
r,50,kaist_dataset/Mixed/Mobile_Phone/(C.M)C-bookCover/P090831125.jpg,char_data/r/P090831125.jpg_2.jpg,1150,480,640,23,273,296,279,329,False,42
r,32,kaist_dataset/Mixed/Mobile_Phone/(C.M)C-bookCover/P090902016.jpg,char_data/r/P090902016.jpg_4.jpg,544,480,640,17,228,245,276,308,False,42
r,21,kaist_dataset/Mixed/Mobile_Phone/(C.M)C-bookCover/P090902016.jpg,char_data/r/P090902016.jpg_5.jpg,357,480,640,17,289,306,281,302,False,42
r,53,kaist_dataset/Mixed/Mobile_Phone/(C.M)C-bookCover/P090902019.jpg,char_data/r/P090902019.jpg_4.jpg,1484,480,640,28,388,416,296,349,False,42
r,34,kaist_dataset/Mixed/Mobile_Phone/(C.M)C-bookCover/P090904005.jpg,char_data/r/P090904005.jpg_2.jpg,646,480,640,19,320,339,117,151,False,42
전,37,kaist_dataset/English/Digital_Camera/(E.S)C-outdoor1/2007-12-09-day-exterior-063.jpg,char_data/전/2007-12-09-day-exterior-063.jpg_2.jpg,999,1200,1600,27,1017,1044,627,664,True,79
전,55,kaist_dataset/Korean/Digital_Camera/A-shadow/2007-12-09-day-exterior-025.jpg,char_data/전/2007-12-09-day-exterior-025.jpg_2.jpg,2805,1200,1600,51,94,145,831,886,True,79
전,42,kaist_dataset/Korean/Digital_Camera/A-shadow/2007-12-09-day-exterior-031.jpg,char_data/전/2007-12-09-day-exterior-031.jpg_6.jpg,1008,1200,1600,24,324,348,943,985,True,79
전,53,kaist_dataset/Korean/Digital_Camera/A-shadow/2007-12-09-day-exterior-031.jpg,char_data/전/2007-12-09-day-exterior-031.jpg_7.jpg,1696,1200,1600,32,559,591,942,995,True,79
전,50,kaist_dataset/Korean/Digital_Camera/A-shadow/2007-12-09-day-exterior-031.jpg,char_data/전/2007-12-09-day-exterior-031.jpg_8.jpg,1500,1200,1600,30,104,134,922,972,True,79
전,43,kaist_dataset/Korean/Digital_Camera/A-shadow/DSC02598.JPG,char_data/전/DSC02598.JPG_4.jpg,1204,480,640,28,418,446,414,457,True,79
전,110,kaist_dataset/Korean/Digital_Camera/A-shadow/DSC02670.JPG,char_data/전/DSC02670.JPG_2.jpg,11220,480,640,102,80,182,207,317,True,79
전,38,kaist_dataset/Korean/Digital_Camera/A-shadow/DSC03536.JPG,char_data/전/DSC03536.JPG_4.jpg,1938,480,640,51,100,151,176,214,True,79
전,37,kaist_dataset/Korean/Digital_Camera/A-shadow/DSC03536.JPG,char_data/전/DSC03536.JPG_5.jpg,1665,480,640,45,153,198,133,170,True,79
전,47,kaist_dataset/Korean/Digital_Camera/A-shadow/DSC03755.JPG,char_data/전/DSC03755.JPG_2.jpg,2209,480,640,47,42,89,247,294,True,79
전,98,kaist_dataset/Korean/Digital_Camera/A-shadow/DSC03792.JPG,char_data/전/DSC03792.JPG_2.jpg,5684,480,640,58,71,129,257,355,True,79
전,108,kaist_dataset/Korean/Digital_Camera/A-shadow/DSC03793.JPG,char_data/전/DSC03793.JPG_2.jpg,8100,480,640,75,494,569,146,254,True,79
전,31,kaist_dataset/Korean/Digital_Camera/A-shadow/DSC04297.JPG,char_data/전/DSC04297.JPG_2.jpg,744,480,640,24,301,325,209,240,True,79
전,97,kaist_dataset/Korean/Digital_Camera/A-shadow/DSC04311.JPG,char_data/전/DSC04311.JPG_2.jpg,5044,480,640,52,145,197,134,231,True,79
전,79,kaist_dataset/Korean/Digital_Camera/A-shadow/P1010034.JPG,char_data/전/P1010034.JPG_2.jpg,6083,480,640,77,195,272,306,385,True,79
전,51,kaist_dataset/Korean/Digital_Camera/A-shadow/P1010128.JPG,char_data/전/P1010128.JPG_2.jpg,2448,480,640,48,325,373,62,113,True,79
전,44,kaist_dataset/Korean/Digital_Camera/B-light/DSC02987.JPG,char_data/전/DSC02987.JPG_2.jpg,1584,480,640,36,491,527,124,168,True,79
전,98,kaist_dataset/Korean/Digital_Camera/B-light/DSC03494.JPG,char_data/전/DSC03494.JPG_2.jpg,6566,480,640,67,93,160,310,408,True,79
전,48,kaist_dataset/Korean/Digital_Camera/E-night/096.jpg,char_data/전/096.jpg_2.jpg,1392,480,640,29,209,238,331,379,True,79
전,123,kaist_dataset/Korean/Digital_Camera/E-night/DSC02565.JPG,char_data/전/DSC02565.JPG_2.jpg,9348,480,640,76,29,105,96,219,True,79
전,46,kaist_dataset/Korean/Digital_Camera/E-night/DSC02593.JPG,char_data/전/DSC02593.JPG_2.jpg,1380,480,640,30,58,88,384,430,True,79
전,75,kaist_dataset/Korean/Digital_Camera/E-night/DSC02594.JPG,char_data/전/DSC02594.JPG_2.jpg,4500,480,640,60,101,161,298,373,True,79
전,49,kaist_dataset/Korean/Digital_Camera/E-night/DSC02597.JPG,char_data/전/DSC02597.JPG_4.jpg,2156,480,640,44,250,294,289,338,True,79
전,50,kaist_dataset/Korean/Digital_Camera/E-night/DSC02597.JPG,char_data/전/DSC02597.JPG_5.jpg,2750,480,640,55,430,485,28,78,True,79
전,27,kaist_dataset/Korean/Digital_Camera/E-night/DSC02626.JPG,char_data/전/DSC02626.JPG_2.jpg,783,480,640,29,514,543,140,167,True,79
전,45,kaist_dataset/Korean/Digital_Camera/E-night/DSC02645.JPG,char_data/전/DSC02645.JPG_2.jpg,1350,480,640,30,200,230,338,383,True,79
전,159,kaist_dataset/Korean/Digital_Camera/E-night/DSC02651.JPG,char_data/전/DSC02651.JPG_2.jpg,23850,480,640,150,452,602,40,199,True,79
전,81,kaist_dataset/Korean/Digital_Camera/E-night/DSC02652.JPG,char_data/전/DSC02652.JPG_2.jpg,6156,480,640,76,388,464,104,185,True,79
전,35,kaist_dataset/Korean/Digital_Camera/E-night/DSC03850.JPG,char_data/전/DSC03850.JPG_2.jpg,980,480,640,28,311,339,389,424,True,79
전,66,kaist_dataset/Korean/Digital_Camera/E-night/사진14.jpg 수정.jpg,char_data/전/사진14.jpg 수정.jpg_2.jpg,4356,300,400,66,108,174,160,226,True,79
전,38,kaist_dataset/Korean/Digital_Camera/G-others/003.jpg,char_data/전/003.jpg_2.jpg,1330,286,413,35,298,333,153,191,True,79
전,180,kaist_dataset/Korean/Digital_Camera/G-others/2007-12-08-day-012.jpg,char_data/전/2007-12-08-day-012.jpg_2.jpg,29880,1600,1200,166,505,671,560,740,True,79
전,66,kaist_dataset/Korean/Digital_Camera/G-others/5.jpg,char_data/전/5.jpg_2.jpg,2706,553,798,41,150,191,227,293,True,79
전,126,kaist_dataset/Korean/Digital_Camera/G-others/DSC02904.JPG,char_data/전/DSC02904.JPG_2.jpg,13734,480,640,109,44,153,14,140,True,79
전,74,kaist_dataset/Korean/Digital_Camera/G-others/DSC03226.JPG,char_data/전/DSC03226.JPG_2.jpg,6290,480,640,85,119,204,7,81,True,79
전,24,kaist_dataset/Korean/Digital_Camera/G-others/DSC03863.JPG,char_data/전/DSC03863.JPG_2.jpg,672,480,640,28,277,305,451,475,True,79
전,103,kaist_dataset/Korean/Digital_Camera/indoor1/DSC02699.JPG,char_data/전/DSC02699.JPG_2.jpg,9064,480,640,88,70,158,96,199,True,79
전,65,kaist_dataset/Korean/Digital_Camera/indoor1/DSC02706.JPG,char_data/전/DSC02706.JPG_2.jpg,4420,480,640,68,117,185,234,299,True,79
전,57,kaist_dataset/Korean/Digital_Camera/indoor1/DSC02715.JPG,char_data/전/DSC02715.JPG_2.jpg,2394,480,640,42,431,473,242,299,True,79
전,99,kaist_dataset/Korean/Digital_Camera/indoor1/DSC03363.JPG,char_data/전/DSC03363.JPG_2.jpg,9009,480,640,91,485,576,251,350,True,79
전,65,kaist_dataset/Korean/Digital_Camera/indoor2/DSC03399.JPG,char_data/전/DSC03399.JPG_2.jpg,2795,480,640,43,292,335,252,317,True,79
전,169,kaist_dataset/Korean/Digital_Camera/indoor2/DSC03471.JPG,char_data/전/DSC03471.JPG_2.jpg,12675,480,640,75,442,517,235,404,True,79
전,87,kaist_dataset/Korean/Digital_Camera/indoor2/DSC03530.JPG,char_data/전/DSC03530.JPG_2.jpg,9048,480,640,104,296,400,368,455,True,79
전,73,kaist_dataset/Korean/Digital_Camera/indoor2/DSC03975.JPG,char_data/전/DSC03975.JPG_2.jpg,4818,480,640,66,75,141,205,278,True,79
전,46,kaist_dataset/Korean/Digital_Camera/indoor2/DSC04004.JPG,char_data/전/DSC04004.JPG_2.jpg,1518,480,640,33,293,326,156,202,True,79
전,41,kaist_dataset/Korean/Digital_Camera/indoor2/DSC04012.JPG,char_data/전/DSC04012.JPG_2.jpg,1763,480,640,43,301,344,191,232,True,79
전,53,kaist_dataset/Korean/Digital_Camera/outdoor1/001.JPG,char_data/전/001.JPG_2.jpg,3180,480,640,60,216,276,187,240,True,79
전,22,kaist_dataset/Korean/Digital_Camera/outdoor1/011.JPG,char_data/전/011.JPG_2.jpg,462,480,640,21,164,185,261,283,True,79
전,42,kaist_dataset/Korean/Digital_Camera/outdoor1/018.JPG,char_data/전/018.JPG_4.jpg,966,480,640,23,88,111,174,216,True,79
전,43,kaist_dataset/Korean/Digital_Camera/outdoor1/018.JPG,char_data/전/018.JPG_5.jpg,1161,480,640,27,130,157,171,214,True,79
전,32,kaist_dataset/Korean/Digital_Camera/outdoor1/026.jpg,char_data/전/026.jpg_2.jpg,768,480,640,24,406,430,257,289,True,79
전,38,kaist_dataset/Korean/Digital_Camera/outdoor1/029.JPG,char_data/전/029.JPG_2.jpg,1254,480,640,33,286,319,148,186,True,79
전,86,kaist_dataset/Korean/Digital_Camera/outdoor1/039.JPG,char_data/전/039.JPG_4.jpg,5848,480,640,68,310,378,210,296,True,79
전,91,kaist_dataset/Korean/Digital_Camera/outdoor1/039.JPG,char_data/전/039.JPG_5.jpg,5733,480,640,63,435,498,209,300,True,79
전,34,kaist_dataset/Korean/Digital_Camera/outdoor1/040.JPG,char_data/전/040.JPG_2.jpg,1122,480,640,33,379,412,145,179,True,79
전,52,kaist_dataset/Korean/Digital_Camera/outdoor1/061.JPG,char_data/전/061.JPG_2.jpg,1924,480,640,37,269,306,204,256,True,79
전,258,kaist_dataset/Korean/Digital_Camera/outdoor1/097.JPG,char_data/전/097.JPG_4.jpg,40248,480,640,156,23,179,136,394,True,79
전,23,kaist_dataset/Korean/Digital_Camera/outdoor1/109.JPG,char_data/전/109.JPG_4.jpg,368,480,640,16,425,441,1,24,True,79
전,33,kaist_dataset/Korean/Digital_Camera/outdoor1/109.JPG,char_data/전/109.JPG_5.jpg,990,480,640,30,199,229,109,142,True,79
전,24,kaist_dataset/Korean/Digital_Camera/outdoor1/115.jpg,char_data/전/115.jpg_2.jpg,528,480,640,22,259,281,87,111,True,79
전,23,kaist_dataset/Korean/Digital_Camera/outdoor1/125.JPG,char_data/전/125.JPG_2.jpg,552,480,640,24,108,132,257,280,True,79
전,50,kaist_dataset/Korean/Digital_Camera/outdoor1/2007-12-08-day-056.jpg,char_data/전/2007-12-08-day-056.jpg_2.jpg,2550,1200,1600,51,450,501,418,468,True,79
전,36,kaist_dataset/Korean/Digital_Camera/outdoor1/2007-12-08-day-087.jpg,char_data/전/2007-12-08-day-087.jpg_2.jpg,1332,1200,1600,37,78,115,465,501,True,79
전,30,kaist_dataset/Korean/Digital_Camera/outdoor1/39.jpg,char_data/전/39.jpg_2.jpg,750,197,320,25,186,211,39,69,True,79
전,111,kaist_dataset/Korean/Digital_Camera/outdoor1/54.JPG,char_data/전/54.JPG_2.jpg,11322,523,767,102,258,360,245,356,True,79
전,155,kaist_dataset/Korean/Digital_Camera/outdoor2/2007-12-08-day-125.jpg,char_data/전/2007-12-08-day-125.jpg_2.jpg,37820,1200,1600,244,517,761,501,656,True,79
전,67,kaist_dataset/Korean/Digital_Camera/outdoor2/2007-12-09-day-exterior-006.jpg,char_data/전/2007-12-09-day-exterior-006.jpg_2.jpg,3886,1200,1600,58,795,853,604,671,True,79
전,37,kaist_dataset/Korean/Digital_Camera/outdoor2/2007-12-09-day-exterior-007.jpg,char_data/전/2007-12-09-day-exterior-007.jpg_2.jpg,1702,1200,1600,46,25,71,337,374,True,79
전,70,kaist_dataset/Korean/Digital_Camera/outdoor2/2007-12-09-day-exterior-009.jpg,char_data/전/2007-12-09-day-exterior-009.jpg_2.jpg,4060,1200,1600,58,529,587,702,772,True,79
전,73,kaist_dataset/Korean/Digital_Camera/outdoor2/2007-12-09-day-exterior-012.jpg,char_data/전/2007-12-09-day-exterior-012.jpg_2.jpg,4380,1200,1600,60,673,733,630,703,True,79
전,74,kaist_dataset/Korean/Digital_Camera/outdoor2/2007-12-09-day-exterior-035.jpg,char_data/전/2007-12-09-day-exterior-035.jpg_4.jpg,6660,1200,1600,90,1230,1320,552,626,True,79
전,38,kaist_dataset/Korean/Digital_Camera/outdoor2/2007-12-09-day-exterior-035.jpg,char_data/전/2007-12-09-day-exterior-035.jpg_5.jpg,1634,1200,1600,43,780,823,506,544,True,79
전,68,kaist_dataset/Korean/Digital_Camera/outdoor2/DSC02304.JPG,char_data/전/DSC02304.JPG_2.jpg,5644,480,640,83,546,629,99,167,True,79
전,28,kaist_dataset/Korean/Digital_Camera/outdoor2/DSC02326.JPG,char_data/전/DSC02326.JPG_2.jpg,756,480,640,27,105,132,154,182,True,79
전,40,kaist_dataset/Korean/Digital_Camera/outdoor2/DSC02366.JPG,char_data/전/DSC02366.JPG_2.jpg,1360,480,640,34,272,306,177,217,True,79
전,40,kaist_dataset/Korean/Digital_Camera/outdoor2/DSC02396.JPG,char_data/전/DSC02396.JPG_4.jpg,1360,480,640,34,302,336,171,211,True,79
전,43,kaist_dataset/Korean/Digital_Camera/outdoor2/DSC02396.JPG,char_data/전/DSC02396.JPG_5.jpg,1204,480,640,28,30,58,373,416,True,79
전,30,kaist_dataset/Korean/Digital_Camera/outdoor2/DSC02420.JPG,char_data/전/DSC02420.JPG_2.jpg,1110,480,640,37,132,169,87,117,True,79
전,104,kaist_dataset/Korean/Digital_Camera/outdoor2/DSC02453.JPG,char_data/전/DSC02453.JPG_2.jpg,8216,480,640,79,275,354,112,216,True,79
전,81,kaist_dataset/Korean/Digital_Camera/outdoor2/DSC02463.JPG,char_data/전/DSC02463.JPG_2.jpg,4860,480,640,60,11,71,200,281,True,79
전,113,kaist_dataset/Korean/Digital_Camera/outdoor2/DSC02464.JPG,char_data/전/DSC02464.JPG_2.jpg,9831,480,640,87,123,210,197,310,True,79
전,37,kaist_dataset/Korean/Digital_Camera/outdoor2/DSC02485.JPG,char_data/전/DSC02485.JPG_2.jpg,1591,480,640,43,258,301,278,315,True,79
전,43,kaist_dataset/Korean/Digital_Camera/outdoor2/DSC02506.JPG,char_data/전/DSC02506.JPG_2.jpg,1419,480,640,33,97,130,57,100,True,79
전,58,kaist_dataset/Korean/Digital_Camera/outdoor3/DSC02546.JPG,char_data/전/DSC02546.JPG_6.jpg,2320,480,640,40,156,196,122,180,True,79
전,50,kaist_dataset/Korean/Digital_Camera/outdoor3/DSC02546.JPG,char_data/전/DSC02546.JPG_7.jpg,2400,480,640,48,143,191,232,282,True,79
전,57,kaist_dataset/Korean/Digital_Camera/outdoor3/DSC02546.JPG,char_data/전/DSC02546.JPG_8.jpg,2337,480,640,41,144,185,355,412,True,79
전,43,kaist_dataset/Korean/Digital_Camera/outdoor3/DSC02598.JPG,char_data/전/DSC02598.JPG_5.jpg,1204,480,640,28,418,446,414,457,True,79
전,55,kaist_dataset/Korean/Digital_Camera/outdoor3/DSC02686.JPG,char_data/전/DSC02686.JPG_2.jpg,1760,480,640,32,43,75,59,114,True,79
전,73,kaist_dataset/Korean/Digital_Camera/outdoor3/DSC02693.JPG,char_data/전/DSC02693.JPG_4.jpg,3796,480,640,52,123,175,284,357,True,79
전,89,kaist_dataset/Korean/Digital_Camera/outdoor3/DSC02693.JPG,char_data/전/DSC02693.JPG_5.jpg,7921,480,640,89,492,581,277,366,True,79
전,67,kaist_dataset/Korean/Digital_Camera/outdoor3/DSC02871.JPG,char_data/전/DSC02871.JPG_2.jpg,6767,480,640,101,139,240,149,216,True,79
전,58,kaist_dataset/Korean/Digital_Camera/outdoor3/DSC02891.JPG,char_data/전/DSC02891.JPG_2.jpg,2552,480,640,44,471,515,348,406,True,79
전,73,kaist_dataset/Korean/Digital_Camera/outdoor3/DSC02934.JPG,char_data/전/DSC02934.JPG_2.jpg,5110,480,640,70,290,360,136,209,True,79
전,70,kaist_dataset/Korean/Digital_Camera/outdoor3/DSC03064.JPG,char_data/전/DSC03064.JPG_2.jpg,5460,480,640,78,356,434,277,347,True,79
전,69,kaist_dataset/Korean/Digital_Camera/outdoor3/DSC03066.JPG,char_data/전/DSC03066.JPG_2.jpg,5037,480,640,73,267,340,171,240,True,79
전,59,kaist_dataset/Korean/Digital_Camera/outdoor3/DSC03220.JPG,char_data/전/DSC03220.JPG_2.jpg,3304,480,640,56,429,485,53,112,True,79
전,77,kaist_dataset/Korean/Digital_Camera/outdoor3/DSC03251.JPG,char_data/전/DSC03251.JPG_2.jpg,4620,480,640,60,350,410,274,351,True,79
전,87,kaist_dataset/Korean/Digital_Camera/outdoor4/DSC03321.JPG,char_data/전/DSC03321.JPG_4.jpg,6786,480,640,78,22,100,99,186,True,79
전,78,kaist_dataset/Korean/Digital_Camera/outdoor4/DSC03321.JPG,char_data/전/DSC03321.JPG_5.jpg,5850,480,640,75,296,371,108,186,True,79
전,138,kaist_dataset/Korean/Digital_Camera/outdoor4/DSC03322.JPG,char_data/전/DSC03322.JPG_2.jpg,21252,480,640,154,48,202,208,346,True,79
전,70,kaist_dataset/Korean/Digital_Camera/outdoor4/DSC03325.JPG,char_data/전/DSC03325.JPG_2.jpg,5320,480,640,76,314,390,130,200,True,79
전,33,kaist_dataset/Korean/Digital_Camera/outdoor4/DSC03326.JPG,char_data/전/DSC03326.JPG_2.jpg,957,480,640,29,520,549,221,254,True,79
전,49,kaist_dataset/Korean/Digital_Camera/outdoor4/DSC03419.JPG,char_data/전/DSC03419.JPG_2.jpg,2499,480,640,51,80,131,214,263,True,79
전,49,kaist_dataset/Korean/Digital_Camera/outdoor4/DSC03437.JPG,char_data/전/DSC03437.JPG_2.jpg,2646,480,640,54,201,255,33,82,True,79
전,53,kaist_dataset/Korean/Digital_Camera/outdoor4/DSC03443.JPG,char_data/전/DSC03443.JPG_2.jpg,2226,480,640,42,330,372,332,385,True,79
전,76,kaist_dataset/Korean/Digital_Camera/outdoor4/DSC03449.JPG,char_data/전/DSC03449.JPG_2.jpg,2964,480,640,39,241,280,291,367,True,79
전,83,kaist_dataset/Korean/Digital_Camera/outdoor4/DSC03452.JPG,char_data/전/DSC03452.JPG_4.jpg,3320,480,640,40,405,445,108,191,True,79
전,82,kaist_dataset/Korean/Digital_Camera/outdoor4/DSC03452.JPG,char_data/전/DSC03452.JPG_5.jpg,3936,480,640,48,360,408,187,269,True,79
전,105,kaist_dataset/Korean/Digital_Camera/outdoor4/DSC03507.JPG,char_data/전/DSC03507.JPG_2.jpg,9240,480,640,88,312,400,46,151,True,79
전,95,kaist_dataset/Korean/Digital_Camera/outdoor4/DSC03537.JPG,char_data/전/DSC03537.JPG_2.jpg,7030,480,640,74,281,355,25,120,True,79
전,90,kaist_dataset/Korean/Digital_Camera/outdoor4/DSC03542.JPG,char_data/전/DSC03542.JPG_2.jpg,5760,480,640,64,103,167,122,212,True,79
전,43,kaist_dataset/Korean/Digital_Camera/outdoor4/DSC03545.JPG,char_data/전/DSC03545.JPG_2.jpg,2150,480,640,50,448,498,1,43,True,79
전,41,kaist_dataset/Korean/Digital_Camera/outdoor4/DSC03576.JPG,char_data/전/DSC03576.JPG_2.jpg,1066,480,640,26,285,311,319,360,True,79
전,74,kaist_dataset/Korean/Digital_Camera/outdoor4/DSC03577.JPG,char_data/전/DSC03577.JPG_2.jpg,3774,480,640,51,236,287,262,336,True,79
전,52,kaist_dataset/Korean/Digital_Camera/outdoor4/DSC03578.JPG,char_data/전/DSC03578.JPG_4.jpg,1092,480,640,21,270,291,143,195,True,79
전,50,kaist_dataset/Korean/Digital_Camera/outdoor4/DSC03578.JPG,char_data/전/DSC03578.JPG_5.jpg,2300,480,640,46,183,229,227,277,True,79
전,84,kaist_dataset/Korean/Digital_Camera/outdoor4/DSC03590.JPG,char_data/전/DSC03590.JPG_2.jpg,5040,480,640,60,16,76,110,194,True,79
전,62,kaist_dataset/Korean/Digital_Camera/outdoor4/DSC03596.JPG,char_data/전/DSC03596.JPG_4.jpg,3100,480,640,50,145,195,135,197,True,79
전,56,kaist_dataset/Korean/Digital_Camera/outdoor4/DSC03596.JPG,char_data/전/DSC03596.JPG_5.jpg,2856,480,640,51,442,493,144,200,True,79
전,60,kaist_dataset/Korean/Digital_Camera/outdoor4/DSC03605.JPG,char_data/전/DSC03605.JPG_2.jpg,3000,480,640,50,371,421,310,370,True,79
전,85,kaist_dataset/Korean/Digital_Camera/outdoor4/DSC03610.JPG,char_data/전/DSC03610.JPG_2.jpg,5950,480,640,70,125,195,13,98,True,79
전,67,kaist_dataset/Korean/Digital_Camera/outdoor4/DSC03612.JPG,char_data/전/DSC03612.JPG_2.jpg,3752,480,640,56,103,159,33,100,True,79
전,44,kaist_dataset/Korean/Digital_Camera/outdoor5/DSC03671.JPG,char_data/전/DSC03671.JPG_2.jpg,1188,480,640,27,408,435,262,306,True,79
전,84,kaist_dataset/Korean/Digital_Camera/outdoor5/DSC03710.JPG,char_data/전/DSC03710.JPG_2.jpg,4452,480,640,53,444,497,328,412,True,79
전,70,kaist_dataset/Korean/Digital_Camera/outdoor5/DSC03712.JPG,char_data/전/DSC03712.JPG_2.jpg,2450,480,640,35,536,571,46,116,True,79
전,124,kaist_dataset/Korean/Digital_Camera/outdoor5/DSC03717.JPG,char_data/전/DSC03717.JPG_2.jpg,5580,480,640,45,468,513,217,341,True,79
전,65,kaist_dataset/Korean/Digital_Camera/outdoor5/DSC03736.JPG,char_data/전/DSC03736.JPG_2.jpg,3055,480,640,47,342,389,337,402,True,79
전,53,kaist_dataset/Korean/Digital_Camera/outdoor5/DSC03740.JPG,char_data/전/DSC03740.JPG_2.jpg,2650,480,640,50,136,186,214,267,True,79
전,71,kaist_dataset/Korean/Digital_Camera/outdoor5/DSC03754.JPG,char_data/전/DSC03754.JPG_2.jpg,6035,480,640,85,206,291,380,451,True,79
전,32,kaist_dataset/Korean/Digital_Camera/outdoor5/DSC03777.JPG,char_data/전/DSC03777.JPG_2.jpg,736,480,640,23,180,203,277,309,True,79
전,134,kaist_dataset/Korean/Digital_Camera/outdoor5/DSC03782.JPG,char_data/전/DSC03782.JPG_2.jpg,15812,480,640,118,350,468,100,234,True,79
전,129,kaist_dataset/Korean/Digital_Camera/outdoor5/DSC03788.JPG,char_data/전/DSC03788.JPG_2.jpg,14319,480,640,111,118,229,22,151,True,79
전,90,kaist_dataset/Korean/Digital_Camera/outdoor5/DSC03789.JPG,char_data/전/DSC03789.JPG_2.jpg,6570,480,640,73,254,327,1,90,True,79
전,69,kaist_dataset/Korean/Digital_Camera/outdoor5/DSC03790.JPG,char_data/전/DSC03790.JPG_2.jpg,4278,480,640,62,262,324,74,143,True,79
전,74,kaist_dataset/Korean/Digital_Camera/outdoor5/DSC03791.JPG,char_data/전/DSC03791.JPG_2.jpg,4958,480,640,67,33,100,74,148,True,79
전,27,kaist_dataset/Korean/Digital_Camera/outdoor5/DSC03832.JPG,char_data/전/DSC03832.JPG_2.jpg,837,480,640,31,252,283,62,89,True,79
전,41,kaist_dataset/Korean/Digital_Camera/outdoor5/DSC03838.JPG,char_data/전/DSC03838.JPG_2.jpg,1476,480,640,36,285,321,140,181,True,79
전,59,kaist_dataset/Korean/Digital_Camera/outdoor5/DSC03844.JPG,char_data/전/DSC03844.JPG_2.jpg,3127,480,640,53,305,358,158,217,True,79
전,49,kaist_dataset/Korean/Digital_Camera/outdoor5/DSC03993.JPG,char_data/전/DSC03993.JPG_2.jpg,2156,480,640,44,142,186,427,476,True,79
전,31,kaist_dataset/Korean/Digital_Camera/outdoor5/DSC04028.JPG,char_data/전/DSC04028.JPG_2.jpg,1302,480,640,42,387,429,244,275,True,79
전,78,kaist_dataset/Korean/Digital_Camera/outdoor5/DSC04037.JPG,char_data/전/DSC04037.JPG_2.jpg,5928,480,640,76,75,151,129,207,True,79
전,48,kaist_dataset/Korean/Digital_Camera/outdoor6/DSC04043.JPG,char_data/전/DSC04043.JPG_4.jpg,960,480,640,20,212,232,219,267,True,79
전,51,kaist_dataset/Korean/Digital_Camera/outdoor6/DSC04043.JPG,char_data/전/DSC04043.JPG_5.jpg,1020,480,640,20,562,582,225,276,True,79
전,65,kaist_dataset/Korean/Digital_Camera/outdoor6/DSC04050.JPG,char_data/전/DSC04050.JPG_2.jpg,4615,480,640,71,405,476,151,216,True,79
전,69,kaist_dataset/Korean/Digital_Camera/outdoor6/DSC04074.JPG,char_data/전/DSC04074.JPG_2.jpg,3381,480,640,49,79,128,24,93,True,79
전,80,kaist_dataset/Korean/Digital_Camera/outdoor6/DSC04085.JPG,char_data/전/DSC04085.JPG_2.jpg,5840,480,640,73,212,285,249,329,True,79
전,64,kaist_dataset/Korean/Digital_Camera/outdoor6/DSC04118.JPG,char_data/전/DSC04118.JPG_2.jpg,2816,480,640,44,260,304,187,251,True,79
전,53,kaist_dataset/Korean/Digital_Camera/outdoor6/DSC04141.JPG,char_data/전/DSC04141.JPG_2.jpg,2279,480,640,43,204,247,356,409,True,79
전,46,kaist_dataset/Korean/Digital_Camera/outdoor6/DSC04148.JPG,char_data/전/DSC04148.JPG_2.jpg,1840,480,640,40,355,395,202,248,True,79
전,151,kaist_dataset/Korean/Digital_Camera/outdoor6/DSC04301.JPG,char_data/전/DSC04301.JPG_2.jpg,11325,480,640,75,276,351,169,320,True,79
전,78,kaist_dataset/Korean/Digital_Camera/outdoor6/DSC04328.JPG,char_data/전/DSC04328.JPG_2.jpg,3354,480,640,43,446,489,21,99,True,79
전,134,kaist_dataset/Korean/Digital_Camera/outdoor6/DSC04352.JPG,char_data/전/DSC04352.JPG_2.jpg,15410,480,640,115,103,218,130,264,True,79
전,76,kaist_dataset/Korean/Digital_Camera/outdoor6/DSC04363.JPG,char_data/전/DSC04363.JPG_2.jpg,5016,480,640,66,110,176,179,255,True,79
전,126,kaist_dataset/Korean/Digital_Camera/outdoor6/DSC04370.JPG,char_data/전/DSC04370.JPG_2.jpg,8190,480,640,65,298,363,163,289,True,79
전,72,kaist_dataset/Korean/Digital_Camera/outdoor6/DSC04446.JPG,char_data/전/DSC04446.JPG_2.jpg,4176,480,640,58,260,318,123,195,True,79
전,88,kaist_dataset/Korean/Digital_Camera/outdoor7/DSC04457.JPG,char_data/전/DSC04457.JPG_2.jpg,4576,480,640,52,111,163,206,294,True,79
전,79,kaist_dataset/Korean/Digital_Camera/outdoor7/DSC04481.JPG,char_data/전/DSC04481.JPG_2.jpg,3871,480,640,49,513,562,225,304,True,79
전,47,kaist_dataset/Korean/Digital_Camera/outdoor7/P1010019.JPG,char_data/전/P1010019.JPG_2.jpg,2632,480,640,56,90,146,247,294,True,79
전,124,kaist_dataset/Korean/Digital_Camera/outdoor7/P1010021.JPG,char_data/전/P1010021.JPG_2.jpg,19840,480,640,160,55,215,125,249,True,79
전,134,kaist_dataset/Korean/Digital_Camera/outdoor7/P1010031.JPG,char_data/전/P1010031.JPG_2.jpg,12328,480,640,92,95,187,77,211,True,79
전,73,kaist_dataset/Korean/Digital_Camera/outdoor7/P1010032.JPG,char_data/전/P1010032.JPG_2.jpg,4380,480,640,60,84,144,220,293,True,79
전,85,kaist_dataset/Korean/Digital_Camera/outdoor7/P1010055.JPG,char_data/전/P1010055.JPG_2.jpg,9435,480,640,111,278,389,108,193,True,79
전,80,kaist_dataset/Korean/Digital_Camera/outdoor7/P1010072.JPG,char_data/전/P1010072.JPG_2.jpg,4880,480,640,61,436,497,123,203,True,79
전,109,kaist_dataset/Korean/Digital_Camera/outdoor7/P1010080.JPG,char_data/전/P1010080.JPG_2.jpg,11663,480,640,107,321,428,58,167,True,79
전,29,kaist_dataset/Korean/Digital_Camera/outdoor7/P1010121.JPG,char_data/전/P1010121.JPG_2.jpg,754,480,640,26,352,378,211,240,True,79
전,64,kaist_dataset/Korean/Digital_Camera/outdoor7/P1010126.JPG,char_data/전/P1010126.JPG_2.jpg,4928,480,640,77,188,265,152,216,True,79
전,29,kaist_dataset/Korean/Digital_Camera/outdoor7/P1010135.JPG,char_data/전/P1010135.JPG_2.jpg,986,480,640,34,424,458,86,115,True,79
전,52,kaist_dataset/Korean/Digital_Camera/outdoor7/P1010138.JPG,char_data/전/P1010138.JPG_2.jpg,2548,480,640,49,421,470,219,271,True,79
전,87,kaist_dataset/Korean/Digital_Camera/outdoor8/DSC02929.JPG,char_data/전/DSC02929.JPG_2.jpg,7482,480,640,86,103,189,101,188,True,79
전,64,kaist_dataset/Korean/Digital_Camera/outdoor8/P090912069.jpg,char_data/전/P090912069.jpg_2.jpg,4928,480,640,77,356,433,150,214,True,79
전,87,kaist_dataset/Korean/Digital_Camera/outdoor8/P1010142.JPG,char_data/전/P1010142.JPG_2.jpg,7134,480,640,82,347,429,172,259,True,79
전,45,kaist_dataset/Korean/Digital_Camera/outdoor8/sharp2번_039.jpg,char_data/전/sharp2번_039.jpg_4.jpg,1440,240,320,32,156,188,105,150,True,79
전,50,kaist_dataset/Korean/Digital_Camera/outdoor8/sharp2번_039.jpg,char_data/전/sharp2번_039.jpg_5.jpg,1600,240,320,32,217,249,103,153,True,79
전,46,"kaist_dataset/Korean/Mobile_Phone/(M,K)C-outdoor/P090912033.jpg",char_data/전/P090912033.jpg_2.jpg,966,480,640,21,107,128,304,350,True,79
전,104,"kaist_dataset/Korean/Mobile_Phone/(M,K)D-indoor/P090831009.jpg",char_data/전/P090831009.jpg_2.jpg,9256,480,640,89,11,100,199,303,True,79
전,78,"kaist_dataset/Korean/Mobile_Phone/(M,K)E-bookCover/P090831047.jpg",char_data/전/P090831047.jpg_4.jpg,4212,480,640,54,336,390,145,223,True,79
전,74,"kaist_dataset/Korean/Mobile_Phone/(M,K)E-bookCover/P090831047.jpg",char_data/전/P090831047.jpg_5.jpg,4144,480,640,56,475,531,145,219,True,79
전,98,"kaist_dataset/Korean/Mobile_Phone/(M,K)E-bookCover/P090831148.jpg",char_data/전/P090831148.jpg_2.jpg,8428,480,640,86,482,568,115,213,True,79
전,122,"kaist_dataset/Korean/Mobile_Phone/(M,K)E-bookCover/P090903017.jpg",char_data/전/P090903017.jpg_2.jpg,9760,480,640,80,399,479,312,434,True,79
전,116,"kaist_dataset/Korean/Mobile_Phone/(M,K)E-bookCover/P090903097.jpg",char_data/전/P090903097.jpg_2.jpg,10324,480,640,89,471,560,183,299,True,79
전,35,kaist_dataset/Mixed/Digital_Camera/(C.S)A-shadow/DSC02624.JPG,char_data/전/DSC02624.JPG_4.jpg,1050,480,640,30,315,345,396,431,True,79
전,70,kaist_dataset/Mixed/Digital_Camera/(C.S)A-shadow/P090912075.jpg,char_data/전/P090912075.jpg_2.jpg,4690,480,640,67,239,306,62,132,True,79
전,58,kaist_dataset/Mixed/Digital_Camera/(C.S)C-outdoor1/014.JPG,char_data/전/014.JPG_2.jpg,2204,480,640,38,522,560,195,253,True,79
전,48,kaist_dataset/Mixed/Digital_Camera/(C.S)C-outdoor1/025.JPG,char_data/전/025.JPG_2.jpg,1824,480,640,38,433,471,85,133,True,79
전,30,kaist_dataset/Mixed/Digital_Camera/(C.S)C-outdoor1/027.JPG,char_data/전/027.JPG_2.jpg,600,480,640,20,234,254,271,301,True,79
전,21,kaist_dataset/Mixed/Digital_Camera/(C.S)C-outdoor1/048.JPG,char_data/전/048.JPG_2.jpg,273,480,640,13,130,143,155,176,True,79
전,119,kaist_dataset/Mixed/Digital_Camera/(C.S)C-outdoor1/080118-0014.jpg,char_data/전/080118-0014.jpg_2.jpg,13090,1200,1600,110,114,224,76,195,True,79
전,121,kaist_dataset/Mixed/Digital_Camera/(C.S)C-outdoor1/080119-0033.jpg,char_data/전/080119-0033.jpg_2.jpg,12584,1200,1600,104,938,1042,141,262,True,79
전,95,kaist_dataset/Mixed/Digital_Camera/(C.S)C-outdoor1/101.JPG,char_data/전/101.JPG_2.jpg,11875,480,640,125,302,427,140,235,True,79
전,76,kaist_dataset/Mixed/Digital_Camera/(C.S)C-outdoor1/121.JPG,char_data/전/121.JPG_2.jpg,5700,480,640,75,393,468,189,265,True,79
전,47,kaist_dataset/Mixed/Digital_Camera/(C.S)C-outdoor1/3.JPG,char_data/전/3.JPG_2.jpg,1410,576,768,30,345,375,417,464,True,79
전,66,kaist_dataset/Mixed/Digital_Camera/(C.S)C-outdoor2/DSC02361.JPG,char_data/전/DSC02361.JPG_2.jpg,6402,480,640,97,549,639,221,287,True,79
전,109,kaist_dataset/Mixed/Digital_Camera/(C.S)C-outdoor2/DSC02374.JPG,char_data/전/DSC02374.JPG_2.jpg,12862,480,640,118,14,132,207,316,True,79
전,43,kaist_dataset/Mixed/Digital_Camera/(C.S)C-outdoor2/DSC02376.JPG,char_data/전/DSC02376.JPG_2.jpg,1462,480,640,34,163,197,139,182,True,79
전,30,kaist_dataset/Mixed/Digital_Camera/(C.S)C-outdoor2/DSC02411.JPG,char_data/전/DSC02411.JPG_2.jpg,1200,480,640,40,178,218,159,189,True,79
전,56,kaist_dataset/Mixed/Digital_Camera/(C.S)C-outdoor2/DSC02483.JPG,char_data/전/DSC02483.JPG_2.jpg,3360,480,640,60,213,273,287,343,True,79
전,36,kaist_dataset/Mixed/Digital_Camera/(C.S)C-outdoor2/DSC02490.JPG,char_data/전/DSC02490.JPG_2.jpg,1188,480,640,33,236,269,44,80,True,79
전,172,kaist_dataset/Mixed/Digital_Camera/(C.S)C-outdoor2/DSC02503.JPG,char_data/전/DSC02503.JPG_2.jpg,20640,480,640,120,192,312,133,305,True,79
전,65,kaist_dataset/Mixed/Digital_Camera/(C.S)C-outdoor2/DSC02557.JPG,char_data/전/DSC02557.JPG_2.jpg,5915,480,640,91,99,190,82,147,True,79
전,35,kaist_dataset/Mixed/Digital_Camera/(C.S)C-outdoor2/DSC02624.JPG,char_data/전/DSC02624.JPG_5.jpg,1050,480,640,30,315,345,396,431,True,79
전,39,kaist_dataset/Mixed/Digital_Camera/(C.S)C-outdoor2/DSC02864.JPG,char_data/전/DSC02864.JPG_2.jpg,1677,480,640,43,216,259,86,125,True,79
전,62,kaist_dataset/Mixed/Digital_Camera/(C.S)C-outdoor2/DSC02869.JPG,char_data/전/DSC02869.JPG_4.jpg,2480,480,640,40,125,165,223,285,True,79
전,78,kaist_dataset/Mixed/Digital_Camera/(C.S)C-outdoor2/DSC02869.JPG,char_data/전/DSC02869.JPG_5.jpg,2340,480,640,30,186,216,59,137,True,79
전,89,kaist_dataset/Mixed/Digital_Camera/(C.S)C-outdoor2/DSC02877.JPG,char_data/전/DSC02877.JPG_2.jpg,5251,480,640,59,99,158,139,228,True,79
전,56,kaist_dataset/Mixed/Digital_Camera/(C.S)C-outdoor2/DSC02912.JPG,char_data/전/DSC02912.JPG_2.jpg,2296,480,640,41,387,428,61,117,True,79
전,36,kaist_dataset/Mixed/Digital_Camera/(C.S)C-outdoor2/DSC02917.JPG,char_data/전/DSC02917.JPG_2.jpg,972,480,640,27,425,452,224,260,True,79
전,32,kaist_dataset/Mixed/Digital_Camera/(C.S)C-outdoor2/DSC02936.JPG,char_data/전/DSC02936.JPG_2.jpg,704,480,640,22,436,458,224,256,True,79
전,47,kaist_dataset/Mixed/Digital_Camera/(C.S)C-outdoor2/DSC02937.JPG,char_data/전/DSC02937.JPG_2.jpg,1645,480,640,35,472,507,187,234,True,79
전,36,kaist_dataset/Mixed/Digital_Camera/(C.S)C-outdoor2/DSC02954.JPG,char_data/전/DSC02954.JPG_2.jpg,1332,480,640,37,129,166,97,133,True,79
전,88,kaist_dataset/Mixed/Digital_Camera/(C.S)C-outdoor3/DSC03054.JPG,char_data/전/DSC03054.JPG_2.jpg,6600,480,640,75,410,485,233,321,True,79
전,31,kaist_dataset/Mixed/Digital_Camera/(C.S)C-outdoor3/DSC03062.JPG,char_data/전/DSC03062.JPG_2.jpg,1116,480,640,36,278,314,105,136,True,79
전,75,kaist_dataset/Mixed/Digital_Camera/(C.S)C-outdoor3/DSC03063.JPG,char_data/전/DSC03063.JPG_2.jpg,7350,480,640,98,112,210,198,273,True,79
전,50,kaist_dataset/Mixed/Digital_Camera/(C.S)C-outdoor3/DSC03177.JPG,char_data/전/DSC03177.JPG_2.jpg,1500,480,640,30,447,477,207,257,True,79
전,46,kaist_dataset/Mixed/Digital_Camera/(C.S)C-outdoor3/DSC03196.JPG,char_data/전/DSC03196.JPG_2.jpg,1840,480,640,40,490,530,394,440,True,79
전,47,kaist_dataset/Mixed/Digital_Camera/(C.S)C-outdoor3/DSC03212.JPG,char_data/전/DSC03212.JPG_2.jpg,1598,480,640,34,162,196,252,299,True,79
전,49,kaist_dataset/Mixed/Digital_Camera/(C.S)C-outdoor3/DSC03223.JPG,char_data/전/DSC03223.JPG_2.jpg,1813,480,640,37,405,442,423,472,True,79
전,66,kaist_dataset/Mixed/Digital_Camera/(C.S)C-outdoor3/DSC03227.JPG,char_data/전/DSC03227.JPG_2.jpg,2640,480,640,40,336,376,388,454,True,79
전,45,kaist_dataset/Mixed/Digital_Camera/(C.S)C-outdoor3/DSC03249.JPG,char_data/전/DSC03249.JPG_2.jpg,1710,480,640,38,313,351,239,284,True,79
전,43,kaist_dataset/Mixed/Digital_Camera/(C.S)C-outdoor3/DSC03259.JPG,char_data/전/DSC03259.JPG_2.jpg,1032,480,640,24,138,162,344,387,True,79
전,45,kaist_dataset/Mixed/Digital_Camera/(C.S)C-outdoor3/DSC03283.JPG,char_data/전/DSC03283.JPG_2.jpg,1350,480,640,30,352,382,152,197,True,79
전,35,kaist_dataset/Mixed/Digital_Camera/(C.S)C-outdoor3/DSC03301.JPG,char_data/전/DSC03301.JPG_2.jpg,1085,480,640,31,234,265,150,185,True,79
전,92,kaist_dataset/Mixed/Digital_Camera/(C.S)C-outdoor3/DSC03314.JPG,char_data/전/DSC03314.JPG_4.jpg,4784,480,640,52,173,225,171,263,True,79
전,56,kaist_dataset/Mixed/Digital_Camera/(C.S)C-outdoor3/DSC03314.JPG,char_data/전/DSC03314.JPG_5.jpg,2576,480,640,46,183,229,104,160,True,79
전,69,kaist_dataset/Mixed/Digital_Camera/(C.S)C-outdoor3/DSC03316.JPG,char_data/전/DSC03316.JPG_2.jpg,4554,480,640,66,146,212,13,82,True,79
전,52,kaist_dataset/Mixed/Digital_Camera/(C.S)C-outdoor3/DSC03332.JPG,char_data/전/DSC03332.JPG_2.jpg,2288,480,640,44,434,478,109,161,True,79
전,72,kaist_dataset/Mixed/Digital_Camera/(C.S)C-outdoor3/DSC03340.JPG,char_data/전/DSC03340.JPG_2.jpg,5328,480,640,74,72,146,273,345,True,79
전,35,kaist_dataset/Mixed/Digital_Camera/(C.S)C-outdoor4/DSC03435.JPG,char_data/전/DSC03435.JPG_4.jpg,875,480,640,25,158,183,236,271,True,79
전,35,kaist_dataset/Mixed/Digital_Camera/(C.S)C-outdoor4/DSC03435.JPG,char_data/전/DSC03435.JPG_5.jpg,945,480,640,27,332,359,239,274,True,79
전,46,kaist_dataset/Mixed/Digital_Camera/(C.S)C-outdoor4/DSC03556.JPG,char_data/전/DSC03556.JPG_2.jpg,1748,480,640,38,71,109,252,298,True,79
전,64,kaist_dataset/Mixed/Digital_Camera/(C.S)C-outdoor4/DSC03604.JPG,char_data/전/DSC03604.JPG_2.jpg,3008,480,640,47,401,448,269,333,True,79
전,82,kaist_dataset/Mixed/Digital_Camera/(C.S)C-outdoor4/DSC03618.JPG,char_data/전/DSC03618.JPG_2.jpg,5904,480,640,72,456,528,339,421,True,79
전,48,kaist_dataset/Mixed/Digital_Camera/(C.S)C-outdoor4/DSC03620.JPG,char_data/전/DSC03620.JPG_2.jpg,3024,480,640,63,260,323,84,132,True,79
전,98,kaist_dataset/Mixed/Digital_Camera/(C.S)C-outdoor4/DSC03633.JPG,char_data/전/DSC03633.JPG_2.jpg,6468,480,640,66,96,162,151,249,True,79
전,43,kaist_dataset/Mixed/Digital_Camera/(C.S)C-outdoor4/DSC03634.JPG,char_data/전/DSC03634.JPG_2.jpg,1978,480,640,46,460,506,371,414,True,79
전,41,kaist_dataset/Mixed/Digital_Camera/(C.S)C-outdoor4/DSC03642.JPG,char_data/전/DSC03642.JPG_2.jpg,1107,480,640,27,386,413,352,393,True,79
전,39,kaist_dataset/Mixed/Digital_Camera/(C.S)C-outdoor4/DSC03672.JPG,char_data/전/DSC03672.JPG_2.jpg,1443,480,640,37,281,318,123,162,False,79
전,35,kaist_dataset/Mixed/Digital_Camera/(C.S)C-outdoor4/DSC03677.JPG,char_data/전/DSC03677.JPG_2.jpg,630,480,640,18,494,512,282,317,False,79
전,50,kaist_dataset/Mixed/Digital_Camera/(C.S)C-outdoor4/DSC03678.JPG,char_data/전/DSC03678.JPG_2.jpg,1750,480,640,35,389,424,183,233,False,79
전,58,kaist_dataset/Mixed/Digital_Camera/(C.S)C-outdoor4/DSC03707.JPG,char_data/전/DSC03707.JPG_2.jpg,2668,480,640,46,255,301,336,394,False,79
전,40,kaist_dataset/Mixed/Digital_Camera/(C.S)C-outdoor4/DSC03730.JPG,char_data/전/DSC03730.JPG_2.jpg,1320,480,640,33,91,124,261,301,False,79
전,39,kaist_dataset/Mixed/Digital_Camera/(C.S)C-outdoor4/DSC03732.JPG,char_data/전/DSC03732.JPG_2.jpg,1794,480,640,46,27,73,401,440,False,79
전,34,kaist_dataset/Mixed/Digital_Camera/(C.S)C-outdoor4/DSC03735.JPG,char_data/전/DSC03735.JPG_2.jpg,578,480,640,17,313,330,191,225,False,79
전,33,kaist_dataset/Mixed/Digital_Camera/(C.S)C-outdoor4/DSC03745.JPG,char_data/전/DSC03745.JPG_2.jpg,660,480,640,20,336,356,223,256,False,79
전,52,kaist_dataset/Mixed/Digital_Camera/(C.S)C-outdoor4/DSC03773.JPG,char_data/전/DSC03773.JPG_2.jpg,2080,480,640,40,172,212,107,159,False,79
전,68,kaist_dataset/Mixed/Digital_Camera/(C.S)C-outdoor5/DSC03830.JPG,char_data/전/DSC03830.JPG_2.jpg,2856,480,640,42,496,538,28,96,False,79
전,45,kaist_dataset/Mixed/Digital_Camera/(C.S)C-outdoor5/DSC03839.JPG,char_data/전/DSC03839.JPG_2.jpg,1710,480,640,38,161,199,147,192,False,79
전,59,kaist_dataset/Mixed/Digital_Camera/(C.S)C-outdoor5/DSC03847.JPG,char_data/전/DSC03847.JPG_2.jpg,2006,480,640,34,223,257,17,76,False,79
전,109,kaist_dataset/Mixed/Digital_Camera/(C.S)C-outdoor5/DSC04013.JPG,char_data/전/DSC04013.JPG_2.jpg,4578,480,640,42,450,492,319,428,False,79
전,46,kaist_dataset/Mixed/Digital_Camera/(C.S)C-outdoor5/DSC04014.JPG,char_data/전/DSC04014.JPG_4.jpg,3404,480,640,74,93,167,181,227,False,79
전,51,kaist_dataset/Mixed/Digital_Camera/(C.S)C-outdoor5/DSC04014.JPG,char_data/전/DSC04014.JPG_5.jpg,2244,480,640,44,301,345,240,291,False,79
전,60,kaist_dataset/Mixed/Digital_Camera/(C.S)C-outdoor5/DSC04015.JPG,char_data/전/DSC04015.JPG_2.jpg,2820,480,640,47,315,362,171,231,False,79
전,118,kaist_dataset/Mixed/Digital_Camera/(C.S)C-outdoor5/DSC04029.JPG,char_data/전/DSC04029.JPG_4.jpg,9204,480,640,78,320,398,46,164,False,79
전,36,kaist_dataset/Mixed/Digital_Camera/(C.S)C-outdoor5/DSC04029.JPG,char_data/전/DSC04029.JPG_5.jpg,1404,480,640,39,182,221,249,285,False,79
전,73,kaist_dataset/Mixed/Digital_Camera/(C.S)C-outdoor5/DSC04059.JPG,char_data/전/DSC04059.JPG_2.jpg,5110,480,640,70,146,216,31,104,False,79
전,72,kaist_dataset/Mixed/Digital_Camera/(C.S)C-outdoor5/DSC04091.JPG,char_data/전/DSC04091.JPG_4.jpg,3960,480,640,55,230,285,328,400,False,79
전,76,kaist_dataset/Mixed/Digital_Camera/(C.S)C-outdoor5/DSC04091.JPG,char_data/전/DSC04091.JPG_5.jpg,3952,480,640,52,115,167,243,319,False,79
전,33,kaist_dataset/Mixed/Digital_Camera/(C.S)C-outdoor5/DSC04124.JPG,char_data/전/DSC04124.JPG_2.jpg,561,480,640,17,156,173,151,184,False,79
전,64,kaist_dataset/Mixed/Digital_Camera/(C.S)C-outdoor5/DSC04139.JPG,char_data/전/DSC04139.JPG_2.jpg,960,480,640,15,371,386,321,385,False,79
전,38,kaist_dataset/Mixed/Digital_Camera/(C.S)C-outdoor5/DSC04150.JPG,char_data/전/DSC04150.JPG_2.jpg,1254,480,640,33,538,571,310,348,False,79
전,56,kaist_dataset/Mixed/Digital_Camera/(C.S)C-outdoor5/DSC04337.JPG,char_data/전/DSC04337.JPG_2.jpg,2016,480,640,36,403,439,107,163,False,79
전,38,kaist_dataset/Mixed/Digital_Camera/(C.S)C-outdoor5/DSC04434.JPG,char_data/전/DSC04434.JPG_2.jpg,1102,480,640,29,235,264,434,472,False,79
전,62,kaist_dataset/Mixed/Digital_Camera/(C.S)C-outdoor6/080116-0057.jpg,char_data/전/080116-0057.jpg_2.jpg,3596,1200,1600,58,378,436,1082,1144,False,79
전,26,kaist_dataset/Mixed/Digital_Camera/(C.S)C-outdoor6/P1010075.JPG,char_data/전/P1010075.JPG_2.jpg,442,480,640,17,483,500,137,163,False,79
전,36,kaist_dataset/Mixed/Digital_Camera/(C.S)C-outdoor6/P1010093.JPG,char_data/전/P1010093.JPG_2.jpg,1368,480,640,38,312,350,240,276,False,79
전,33,kaist_dataset/Mixed/Digital_Camera/(C.S)C-outdoor6/P1010097.JPG,char_data/전/P1010097.JPG_2.jpg,957,480,640,29,140,169,49,82,False,79
전,71,kaist_dataset/Mixed/Digital_Camera/(C.S)C-outdoor6/P1010098.JPG,char_data/전/P1010098.JPG_4.jpg,5112,480,640,72,168,240,307,378,False,79
전,43,kaist_dataset/Mixed/Digital_Camera/(C.S)C-outdoor6/P1010098.JPG,char_data/전/P1010098.JPG_5.jpg,1118,480,640,26,136,162,435,478,False,79
전,47,kaist_dataset/Mixed/Digital_Camera/(C.S)C-outdoor6/P1010114.JPG,char_data/전/P1010114.JPG_2.jpg,2350,480,640,50,348,398,16,63,False,79
전,48,kaist_dataset/Mixed/Digital_Camera/(C.S)C-outdoor6/P1010129.JPG,char_data/전/P1010129.JPG_2.jpg,2016,480,640,42,375,417,428,476,False,79
전,33,kaist_dataset/Mixed/Digital_Camera/(C.S)C-outdoor6/P1010137.JPG,char_data/전/P1010137.JPG_2.jpg,957,480,640,29,323,352,176,209,False,79
전,92,kaist_dataset/Mixed/Digital_Camera/(C.S)D-indoor1/DSC02711.JPG,char_data/전/DSC02711.JPG_2.jpg,6164,480,640,67,490,557,232,324,False,79
전,59,kaist_dataset/Mixed/Digital_Camera/(C.S)D-indoor1/DSC02726.JPG,char_data/전/DSC02726.JPG_2.jpg,2655,480,640,45,331,376,386,445,False,79
전,58,kaist_dataset/Mixed/Digital_Camera/(C.S)D-indoor1/DSC03133.JPG,char_data/전/DSC03133.JPG_2.jpg,2668,480,640,46,264,310,224,282,False,79
전,67,kaist_dataset/Mixed/Digital_Camera/(C.S)D-indoor1/DSC03483.JPG,char_data/전/DSC03483.JPG_2.jpg,3082,480,640,46,469,515,38,105,False,79
전,90,kaist_dataset/Mixed/Digital_Camera/(C.S)D-indoor1/DSC03980.JPG,char_data/전/DSC03980.JPG_2.jpg,9000,480,640,100,9,109,203,293,False,79
전,78,kaist_dataset/Mixed/Digital_Camera/(C.S)D-indoor1/DSC03998.JPG,char_data/전/DSC03998.JPG_2.jpg,1872,480,640,24,514,538,309,387,False,79
전,145,kaist_dataset/Mixed/Digital_Camera/(C.S)D-indoor1/DSC04002.JPG,char_data/전/DSC04002.JPG_2.jpg,6235,480,640,43,357,400,135,280,False,79
전,56,kaist_dataset/Mixed/Digital_Camera/(C.S)D-indoor1/DSC04223.JPG,char_data/전/DSC04223.JPG_2.jpg,3472,480,640,62,305,367,343,399,False,79
전,89,kaist_dataset/Mixed/Digital_Camera/(C.S)D-indoor2/DSC04409.JPG,char_data/전/DSC04409.JPG_2.jpg,4094,480,640,46,182,228,147,236,False,79
전,42,kaist_dataset/Mixed/Digital_Camera/(C.S)E-night/DSC02569.JPG,char_data/전/DSC02569.JPG_2.jpg,1512,480,640,36,369,405,366,408,False,79
전,32,kaist_dataset/Mixed/Digital_Camera/(C.S)E-night/DSC02586.JPG,char_data/전/DSC02586.JPG_4.jpg,1088,480,640,34,208,242,398,430,False,79
전,40,kaist_dataset/Mixed/Digital_Camera/(C.S)E-night/DSC02586.JPG,char_data/전/DSC02586.JPG_5.jpg,1320,480,640,33,307,340,174,214,False,79
전,54,kaist_dataset/Mixed/Digital_Camera/(C.S)E-night/DSC02602.JPG,char_data/전/DSC02602.JPG_2.jpg,2484,480,640,46,303,349,310,364,False,79
전,37,kaist_dataset/Mixed/Digital_Camera/(C.S)E-night/DSC02644.JPG,char_data/전/DSC02644.JPG_2.jpg,999,480,640,27,165,192,399,436,False,79
전,68,kaist_dataset/Mixed/Digital_Camera/(C.S)E-night/DSC03516.JPG,char_data/전/DSC03516.JPG_2.jpg,3264,480,640,48,352,400,94,162,False,79
전,43,kaist_dataset/Mixed/Digital_Camera/(C.S)E-night/DSC03561.JPG,char_data/전/DSC03561.JPG_2.jpg,1419,480,640,33,325,358,27,70,False,79
전,86,kaist_dataset/Mixed/Digital_Camera/(C.S)E-night/DSC03871.JPG,char_data/전/DSC03871.JPG_2.jpg,7138,480,640,83,362,445,100,186,False,79
전,24,kaist_dataset/Mixed/Digital_Camera/(C.S)F-others/085.jpg,char_data/전/085.jpg_2.jpg,456,480,640,19,410,429,242,266,False,79
전,40,kaist_dataset/Mixed/Digital_Camera/(C.S)F-others/097.jpg,char_data/전/097.jpg_5.jpg,1000,480,640,25,440,465,306,346,False,79
전,77,kaist_dataset/Mixed/Digital_Camera/(C.S)F-others/DSC02803.JPG,char_data/전/DSC02803.JPG_2.jpg,8008,480,640,104,486,590,259,336,False,79
전,69,kaist_dataset/Mixed/Mobile_Phone/(C.M)B-indoor/P090831016.jpg,char_data/전/P090831016.jpg_2.jpg,4968,480,640,72,76,148,107,176,False,79
전,84,kaist_dataset/Mixed/Mobile_Phone/(C.M)B-indoor/P090831019.jpg,char_data/전/P090831019.jpg_2.jpg,10164,480,640,121,402,523,68,152,False,79
전,45,kaist_dataset/Mixed/Mobile_Phone/(C.M)C-bookCover/P090904004.jpg,char_data/전/P090904004.jpg_2.jpg,1305,480,640,29,446,475,143,188,False,79
전,122,kaist_dataset/Mixed/Mobile_Phone/(C.M)C-bookCover/P090905002.jpg,char_data/전/P090905002.jpg_2.jpg,12566,480,640,103,184,287,159,281,False,79
N,97,kaist_dataset/English/Digital_Camera/(E.S)A-shadow/DSC02317.JPG,char_data/N/DSC02317.JPG_2.jpg,6208,480,640,64,271,335,227,324,True,24
N,81,kaist_dataset/English/Digital_Camera/(E.S)A-shadow/DSC02423.JPG,char_data/N/DSC02423.JPG_4.jpg,5832,480,640,72,175,247,149,230,True,24
N,49,kaist_dataset/English/Digital_Camera/(E.S)A-shadow/DSC02423.JPG,char_data/N/DSC02423.JPG_5.jpg,2303,480,640,47,225,272,238,287,True,24
N,45,kaist_dataset/English/Digital_Camera/(E.S)A-shadow/P1010044.JPG,char_data/N/P1010044.JPG_6.jpg,1620,480,640,36,19,55,354,399,True,24
N,40,kaist_dataset/English/Digital_Camera/(E.S)A-shadow/P1010044.JPG,char_data/N/P1010044.JPG_7.jpg,1160,480,640,29,509,538,353,393,True,24
N,37,kaist_dataset/English/Digital_Camera/(E.S)A-shadow/P1010044.JPG,char_data/N/P1010044.JPG_8.jpg,1184,480,640,32,185,217,149,186,True,24
N,137,kaist_dataset/English/Digital_Camera/(E.S)B-light/080116-0053.jpg,char_data/N/080116-0053.jpg_2.jpg,12878,600,800,94,289,383,212,349,True,24
N,222,kaist_dataset/English/Digital_Camera/(E.S)B-light/080116-0059.jpg,char_data/N/080116-0059.jpg_16.jpg,26418,1200,1600,119,1102,1221,511,733,True,24
N,33,kaist_dataset/English/Digital_Camera/(E.S)B-light/080116-0059.jpg,char_data/N/080116-0059.jpg_17.jpg,561,1200,1600,17,523,540,826,859,True,24
N,23,kaist_dataset/English/Digital_Camera/(E.S)B-light/080116-0059.jpg,char_data/N/080116-0059.jpg_18.jpg,368,1200,1600,16,1128,1144,826,849,True,24
N,30,kaist_dataset/English/Digital_Camera/(E.S)B-light/080116-0059.jpg,char_data/N/080116-0059.jpg_19.jpg,480,1200,1600,16,476,492,801,831,True,24
N,27,kaist_dataset/English/Digital_Camera/(E.S)B-light/080116-0059.jpg,char_data/N/080116-0059.jpg_20.jpg,405,1200,1600,15,712,727,802,829,True,24
N,26,kaist_dataset/English/Digital_Camera/(E.S)B-light/080116-0059.jpg,char_data/N/080116-0059.jpg_21.jpg,442,1200,1600,17,1006,1023,800,826,True,24
N,34,kaist_dataset/English/Digital_Camera/(E.S)B-light/080116-0059.jpg,char_data/N/080116-0059.jpg_22.jpg,544,1200,1600,16,524,540,771,805,True,24
N,28,kaist_dataset/English/Digital_Camera/(E.S)B-light/080116-0059.jpg,char_data/N/080116-0059.jpg_23.jpg,448,1200,1600,16,999,1015,772,800,True,24
N,99,kaist_dataset/English/Digital_Camera/(E.S)B-light/080119-0038.jpg,char_data/N/080119-0038.jpg_2.jpg,8514,1200,1600,86,737,823,681,780,True,24
N,52,kaist_dataset/English/Digital_Camera/(E.S)B-light/DSC02712.JPG,char_data/N/DSC02712.JPG_2.jpg,1404,480,640,27,218,245,216,268,True,24
N,88,kaist_dataset/English/Digital_Camera/(E.S)B-light/DSC03007.JPG,char_data/N/DSC03007.JPG_4.jpg,5544,480,640,63,280,343,164,252,True,24
N,87,kaist_dataset/English/Digital_Camera/(E.S)B-light/DSC03007.JPG,char_data/N/DSC03007.JPG_5.jpg,5133,480,640,59,342,401,164,251,True,24
N,20,kaist_dataset/English/Digital_Camera/(E.S)B-light/x.jpg,char_data/N/x.jpg_2.jpg,360,240,320,18,223,241,103,123,True,24
N,80,kaist_dataset/English/Digital_Camera/(E.S)B-light/크기변환_%B0%A3%C6%C74_fabdent.jpg,char_data/N/크기변환_%B0%A3%C6%C74_fabdent.jpg_2.jpg,4720,480,640,59,159,218,155,235,True,24
N,62,kaist_dataset/English/Digital_Camera/(E.S)C-outdoor1/026.JPG,char_data/N/026.JPG_2.jpg,3038,480,640,49,401,450,202,264,True,24
N,66,kaist_dataset/English/Digital_Camera/(E.S)C-outdoor1/035.jpg,char_data/N/035.jpg_4.jpg,1914,210,354,29,156,185,22,88,True,24
N,66,kaist_dataset/English/Digital_Camera/(E.S)C-outdoor1/035.jpg,char_data/N/035.jpg_5.jpg,2310,210,354,35,178,213,82,148,True,24
N,90,kaist_dataset/English/Digital_Camera/(E.S)C-outdoor1/041.JPG,char_data/N/041.JPG_4.jpg,6300,480,640,70,207,277,206,296,True,24
N,39,kaist_dataset/English/Digital_Camera/(E.S)C-outdoor1/041.JPG,char_data/N/041.JPG_5.jpg,936,480,640,24,498,522,250,289,True,24
N,24,kaist_dataset/English/Digital_Camera/(E.S)C-outdoor1/061.jpg,char_data/N/061.jpg_4.jpg,576,219,323,24,177,201,90,114,True,24
N,30,kaist_dataset/English/Digital_Camera/(E.S)C-outdoor1/061.jpg,char_data/N/061.jpg_5.jpg,720,219,323,24,177,201,64,94,True,24
N,70,kaist_dataset/English/Digital_Camera/(E.S)C-outdoor1/080.jpg,char_data/N/080.jpg_6.jpg,2800,253,350,40,200,240,81,151,True,24
N,48,kaist_dataset/English/Digital_Camera/(E.S)C-outdoor1/080116-0065.jpg,char_data/N/080116-0065.jpg_2.jpg,1632,600,800,34,537,571,341,389,True,24
N,70,kaist_dataset/English/Digital_Camera/(E.S)C-outdoor1/080118-0011.jpg,char_data/N/080118-0011.jpg_6.jpg,3570,1200,1600,51,375,426,943,1013,True,24
N,73,kaist_dataset/English/Digital_Camera/(E.S)C-outdoor1/080118-0011.jpg,char_data/N/080118-0011.jpg_7.jpg,3504,1200,1600,48,1213,1261,920,993,True,24
N,73,kaist_dataset/English/Digital_Camera/(E.S)C-outdoor1/080118-0011.jpg,char_data/N/080118-0011.jpg_8.jpg,4161,1200,1600,57,631,688,526,599,True,24
N,101,kaist_dataset/English/Digital_Camera/(E.S)C-outdoor1/083.JPG,char_data/N/083.JPG_2.jpg,7575,480,640,75,316,391,172,273,True,24
N,45,kaist_dataset/English/Digital_Camera/(E.S)C-outdoor1/089.jpg,char_data/N/089.jpg_4.jpg,810,480,640,18,192,210,294,339,True,24
N,43,kaist_dataset/English/Digital_Camera/(E.S)C-outdoor1/089.jpg,char_data/N/089.jpg_5.jpg,817,480,640,19,488,507,282,325,True,24
N,81,kaist_dataset/English/Digital_Camera/(E.S)C-outdoor1/110.jpg,char_data/N/110.jpg_2.jpg,4212,480,640,52,209,261,191,272,True,24
N,33,kaist_dataset/English/Digital_Camera/(E.S)C-outdoor1/113.jpg,char_data/N/113.jpg_2.jpg,759,480,640,23,438,461,226,259,True,24
N,69,kaist_dataset/English/Digital_Camera/(E.S)C-outdoor1/139.JPG,char_data/N/139.JPG_2.jpg,3519,480,640,51,436,487,249,318,True,24
N,196,kaist_dataset/English/Digital_Camera/(E.S)C-outdoor1/2007-12-08-day-098.jpg,char_data/N/2007-12-08-day-098.jpg_4.jpg,22344,1200,1600,114,526,640,485,681,True,24
N,222,kaist_dataset/English/Digital_Camera/(E.S)C-outdoor1/2007-12-08-day-098.jpg,char_data/N/2007-12-08-day-098.jpg_5.jpg,29748,1200,1600,134,1409,1543,453,675,True,24
N,196,kaist_dataset/English/Digital_Camera/(E.S)C-outdoor1/2007-12-08-day-099.jpg,char_data/N/2007-12-08-day-099.jpg_2.jpg,24500,1200,1600,125,1142,1267,459,655,True,24
N,213,kaist_dataset/English/Digital_Camera/(E.S)C-outdoor1/2007-12-08-day-117.jpg,char_data/N/2007-12-08-day-117.jpg_2.jpg,36636,1200,1600,172,932,1104,505,718,True,24
N,31,kaist_dataset/English/Digital_Camera/(E.S)C-outdoor1/DSC02345.JPG,char_data/N/DSC02345.JPG_4.jpg,651,480,640,21,403,424,237,268,True,24
N,40,kaist_dataset/English/Digital_Camera/(E.S)C-outdoor1/DSC02345.JPG,char_data/N/DSC02345.JPG_5.jpg,1360,480,640,34,490,524,231,271,True,24
N,108,kaist_dataset/English/Digital_Camera/(E.S)C-outdoor1/DSC02352.JPG,char_data/N/DSC02352.JPG_2.jpg,11880,480,640,110,147,257,208,316,True,24
N,97,kaist_dataset/English/Digital_Camera/(E.S)C-outdoor1/DSC02364.JPG,char_data/N/DSC02364.JPG_2.jpg,9118,480,640,94,82,176,229,326,True,24
N,92,kaist_dataset/English/Digital_Camera/(E.S)C-outdoor1/DSC02384.JPG,char_data/N/DSC02384.JPG_2.jpg,7728,480,640,84,144,228,223,315,True,24
N,97,kaist_dataset/English/Digital_Camera/(E.S)C-outdoor1/DSC02395.JPG,char_data/N/DSC02395.JPG_2.jpg,9603,480,640,99,470,569,210,307,True,24
N,143,kaist_dataset/English/Digital_Camera/(E.S)C-outdoor1/DSC02406.JPG,char_data/N/DSC02406.JPG_2.jpg,17446,480,640,122,300,422,117,260,True,24
N,82,kaist_dataset/English/Digital_Camera/(E.S)C-outdoor1/DSC02408.JPG,char_data/N/DSC02408.JPG_2.jpg,5986,480,640,73,185,258,265,347,True,24
N,24,kaist_dataset/English/Digital_Camera/(E.S)C-outdoor1/DSC02500.JPG,char_data/N/DSC02500.JPG_12.jpg,480,480,640,20,1,20,82,106,True,24
N,19,kaist_dataset/English/Digital_Camera/(E.S)C-outdoor1/DSC02500.JPG,char_data/N/DSC02500.JPG_13.jpg,323,480,640,17,53,70,106,125,True,24
N,25,kaist_dataset/English/Digital_Camera/(E.S)C-outdoor1/DSC02500.JPG,char_data/N/DSC02500.JPG_14.jpg,475,480,640,19,78,97,103,128,True,24
N,21,kaist_dataset/English/Digital_Camera/(E.S)C-outdoor1/DSC02500.JPG,char_data/N/DSC02500.JPG_15.jpg,420,480,640,20,48,68,85,106,True,24
N,124,kaist_dataset/English/Digital_Camera/(E.S)C-outdoor1/DSC02500.JPG,char_data/N/DSC02500.JPG_17.jpg,8928,480,640,72,178,250,166,290,True,24
N,53,kaist_dataset/English/Digital_Camera/(E.S)C-outdoor1/DSC02501.JPG,char_data/N/DSC02501.JPG_2.jpg,3233,480,640,61,528,589,300,353,True,24
N,107,kaist_dataset/English/Digital_Camera/(E.S)C-outdoor1/DSC02590.JPG,char_data/N/DSC02590.JPG_2.jpg,9523,480,640,89,94,183,125,232,True,24
N,35,kaist_dataset/English/Digital_Camera/(E.S)C-outdoor1/DSC02618.JPG,char_data/N/DSC02618.JPG_2.jpg,1155,480,640,33,232,265,173,208,True,24
N,61,kaist_dataset/English/Digital_Camera/(E.S)C-outdoor1/DSC02619.JPG,char_data/N/DSC02619.JPG_2.jpg,3050,480,640,50,182,232,219,280,True,24
N,49,kaist_dataset/English/Digital_Camera/(E.S)C-outdoor1/DSC02918.JPG,char_data/N/DSC02918.JPG_8.jpg,2793,480,640,57,299,356,178,227,True,24
N,89,kaist_dataset/English/Digital_Camera/(E.S)C-outdoor2/DSC02993.JPG,char_data/N/DSC02993.JPG_2.jpg,6675,480,640,75,144,219,117,206,True,24
N,73,kaist_dataset/English/Digital_Camera/(E.S)C-outdoor2/DSC03012.JPG,char_data/N/DSC03012.JPG_4.jpg,3431,480,640,47,236,283,209,282,True,24
N,70,kaist_dataset/English/Digital_Camera/(E.S)C-outdoor2/DSC03012.JPG,char_data/N/DSC03012.JPG_5.jpg,3290,480,640,47,539,586,212,282,True,24
N,63,kaist_dataset/English/Digital_Camera/(E.S)C-outdoor2/DSC03161.JPG,char_data/N/DSC03161.JPG_2.jpg,1449,480,640,23,520,543,204,267,True,24
N,61,kaist_dataset/English/Digital_Camera/(E.S)C-outdoor2/DSC03169.JPG,char_data/N/DSC03169.JPG_2.jpg,3721,480,640,61,151,212,277,338,True,24
N,69,kaist_dataset/English/Digital_Camera/(E.S)C-outdoor2/DSC03191.JPG,char_data/N/DSC03191.JPG_2.jpg,4278,480,640,62,188,250,139,208,True,24
N,71,kaist_dataset/English/Digital_Camera/(E.S)C-outdoor2/DSC03192.JPG,char_data/N/DSC03192.JPG_2.jpg,5254,480,640,74,211,285,158,229,True,24
N,129,kaist_dataset/English/Digital_Camera/(E.S)C-outdoor2/DSC03197.JPG,char_data/N/DSC03197.JPG_2.jpg,14190,480,640,110,402,512,79,208,True,24
N,45,kaist_dataset/English/Digital_Camera/(E.S)C-outdoor2/DSC03203.JPG,char_data/N/DSC03203.JPG_5.jpg,1710,480,640,38,120,158,313,358,True,24
N,76,kaist_dataset/English/Digital_Camera/(E.S)C-outdoor2/DSC03264.JPG,char_data/N/DSC03264.JPG_2.jpg,4560,480,640,60,107,167,154,230,True,24
N,44,kaist_dataset/English/Digital_Camera/(E.S)C-outdoor2/DSC03279.JPG,char_data/N/DSC03279.JPG_2.jpg,1408,480,640,32,297,329,216,260,True,24
N,114,kaist_dataset/English/Digital_Camera/(E.S)C-outdoor2/DSC03317.JPG,char_data/N/DSC03317.JPG_4.jpg,8436,480,640,74,484,558,57,171,True,24
N,41,kaist_dataset/English/Digital_Camera/(E.S)C-outdoor2/DSC03317.JPG,char_data/N/DSC03317.JPG_5.jpg,861,480,640,21,515,536,197,238,True,24
N,74,kaist_dataset/English/Digital_Camera/(E.S)C-outdoor2/DSC03412.JPG,char_data/N/DSC03412.JPG_5.jpg,4144,480,640,56,428,484,264,338,True,24
N,67,kaist_dataset/English/Digital_Camera/(E.S)C-outdoor2/DSC03414.JPG,char_data/N/DSC03414.JPG_2.jpg,5494,480,640,82,338,420,263,330,True,24
N,82,kaist_dataset/English/Digital_Camera/(E.S)C-outdoor2/DSC03432.JPG,char_data/N/DSC03432.JPG_4.jpg,4264,480,640,52,84,136,359,441,True,24
N,81,kaist_dataset/English/Digital_Camera/(E.S)C-outdoor2/DSC03432.JPG,char_data/N/DSC03432.JPG_5.jpg,3564,480,640,44,536,580,355,436,True,24
N,85,kaist_dataset/English/Digital_Camera/(E.S)C-outdoor2/DSC03705.JPG,char_data/N/DSC03705.JPG_2.jpg,5270,480,640,62,200,262,192,277,True,24
N,99,kaist_dataset/English/Digital_Camera/(E.S)C-outdoor2/DSC03831.JPG,char_data/N/DSC03831.JPG_2.jpg,6930,480,640,70,473,543,22,121,True,24
N,64,kaist_dataset/English/Digital_Camera/(E.S)C-outdoor2/DSC04079.JPG,char_data/N/DSC04079.JPG_6.jpg,3072,480,640,48,141,189,36,100,True,24
N,66,kaist_dataset/English/Digital_Camera/(E.S)C-outdoor2/DSC04079.JPG,char_data/N/DSC04079.JPG_7.jpg,2904,480,640,44,189,233,36,102,True,24
N,44,kaist_dataset/English/Digital_Camera/(E.S)C-outdoor2/DSC04080.JPG,char_data/N/DSC04080.JPG_6.jpg,2024,480,640,46,418,464,301,345,True,24
N,38,kaist_dataset/English/Digital_Camera/(E.S)C-outdoor2/DSC04080.JPG,char_data/N/DSC04080.JPG_7.jpg,1520,480,640,40,326,366,355,393,True,24
N,37,kaist_dataset/English/Digital_Camera/(E.S)C-outdoor2/DSC04080.JPG,char_data/N/DSC04080.JPG_8.jpg,1443,480,640,39,365,404,353,390,True,24
N,72,kaist_dataset/English/Digital_Camera/(E.S)C-outdoor2/DSC04131.JPG,char_data/N/DSC04131.JPG_2.jpg,6552,480,640,91,396,487,130,202,True,24
N,70,kaist_dataset/English/Digital_Camera/(E.S)C-outdoor2/DSC04251.JPG,char_data/N/DSC04251.JPG_2.jpg,3780,480,640,54,408,462,66,136,True,24
N,69,kaist_dataset/English/Digital_Camera/(E.S)C-outdoor2/DSC04313.JPG,char_data/N/DSC04313.JPG_2.jpg,3381,480,640,49,142,191,113,182,True,24
N,42,kaist_dataset/English/Digital_Camera/(E.S)C-outdoor2/DSC04361.JPG,char_data/N/DSC04361.JPG_2.jpg,1050,480,640,25,289,314,238,280,True,24
N,69,kaist_dataset/English/Digital_Camera/(E.S)C-outdoor2/DSC04410.JPG,char_data/N/DSC04410.JPG_2.jpg,4278,480,640,62,335,397,144,213,True,24
N,32,kaist_dataset/English/Digital_Camera/(E.S)C-outdoor2/DSC04437.JPG,char_data/N/DSC04437.JPG_14.jpg,608,480,640,19,107,126,39,71,True,24
N,31,kaist_dataset/English/Digital_Camera/(E.S)C-outdoor2/DSC04437.JPG,char_data/N/DSC04437.JPG_15.jpg,558,480,640,18,124,142,39,70,True,24
N,28,kaist_dataset/English/Digital_Camera/(E.S)C-outdoor2/DSC04437.JPG,char_data/N/DSC04437.JPG_16.jpg,504,480,640,18,108,126,75,103,True,24
N,31,kaist_dataset/English/Digital_Camera/(E.S)C-outdoor2/DSC04437.JPG,char_data/N/DSC04437.JPG_17.jpg,496,480,640,16,126,142,73,104,True,24
N,89,kaist_dataset/English/Digital_Camera/(E.S)C-outdoor2/P1010015.JPG,char_data/N/P1010015.JPG_2.jpg,5251,480,640,59,155,214,129,218,True,24
N,59,kaist_dataset/English/Digital_Camera/(E.S)C-outdoor3/DSC02690.JPG,char_data/N/DSC02690.JPG_6.jpg,2832,480,640,48,281,329,164,223,True,24
N,56,kaist_dataset/English/Digital_Camera/(E.S)C-outdoor3/DSC02690.JPG,char_data/N/DSC02690.JPG_7.jpg,2856,480,640,51,397,448,153,209,True,24
N,55,kaist_dataset/English/Digital_Camera/(E.S)C-outdoor3/DSC02690.JPG,char_data/N/DSC02690.JPG_8.jpg,2420,480,640,44,283,327,219,274,True,24
N,64,kaist_dataset/English/Digital_Camera/(E.S)C-outdoor3/DSC02788.JPG,char_data/N/DSC02788.JPG_4.jpg,2688,480,640,42,380,422,299,363,True,24
N,60,kaist_dataset/English/Digital_Camera/(E.S)C-outdoor3/DSC02788.JPG,char_data/N/DSC02788.JPG_5.jpg,2820,480,640,47,377,424,212,272,True,24
N,74,kaist_dataset/English/Digital_Camera/(E.S)C-outdoor3/크기변환_P1010028.JPG,char_data/N/크기변환_P1010028.JPG_4.jpg,3774,480,640,51,105,156,162,236,True,24
N,67,kaist_dataset/English/Digital_Camera/(E.S)C-outdoor3/크기변환_P1010028.JPG,char_data/N/크기변환_P1010028.JPG_5.jpg,4288,480,640,64,506,570,172,239,True,24
N,50,kaist_dataset/English/Digital_Camera/(E.S)C-outdoor3/크기변환_P1010076.JPG,char_data/N/크기변환_P1010076.JPG_4.jpg,2250,480,640,45,200,245,126,176,True,24
N,98,kaist_dataset/English/Digital_Camera/(E.S)D-indoor/080119-0009.jpg,char_data/N/080119-0009.jpg_12.jpg,8526,1200,1600,87,925,1012,574,672,True,24
N,68,kaist_dataset/English/Digital_Camera/(E.S)D-indoor/DSC02769.JPG,char_data/N/DSC02769.JPG_4.jpg,3128,480,640,46,381,427,217,285,True,24
N,57,kaist_dataset/English/Digital_Camera/(E.S)D-indoor/DSC02769.JPG,char_data/N/DSC02769.JPG_5.jpg,2964,480,640,52,365,417,134,191,True,24
N,68,kaist_dataset/English/Digital_Camera/(E.S)D-indoor/DSC02850.JPG,char_data/N/DSC02850.JPG_2.jpg,4148,480,640,61,391,452,240,308,True,24
N,65,kaist_dataset/English/Digital_Camera/(E.S)D-indoor/DSC02854.JPG,char_data/N/DSC02854.JPG_2.jpg,3900,480,640,60,151,211,137,202,True,24
N,78,kaist_dataset/English/Digital_Camera/(E.S)D-indoor/DSC02859.JPG,char_data/N/DSC02859.JPG_4.jpg,5070,480,640,65,80,145,312,390,True,24
N,70,kaist_dataset/English/Digital_Camera/(E.S)D-indoor/DSC02859.JPG,char_data/N/DSC02859.JPG_5.jpg,5180,480,640,74,329,403,329,399,True,24
N,96,kaist_dataset/English/Digital_Camera/(E.S)D-indoor/DSC03365.JPG,char_data/N/DSC03365.JPG_2.jpg,7680,480,640,80,528,608,356,452,True,24
N,111,kaist_dataset/English/Digital_Camera/(E.S)D-indoor/DSC03366.JPG,char_data/N/DSC03366.JPG_2.jpg,10656,480,640,96,477,573,346,457,True,24
N,88,kaist_dataset/English/Digital_Camera/(E.S)D-indoor/DSC03367.JPG,char_data/N/DSC03367.JPG_2.jpg,6248,480,640,71,100,171,28,116,True,24
N,56,kaist_dataset/English/Digital_Camera/(E.S)D-indoor/DSC03396.JPG,char_data/N/DSC03396.JPG_4.jpg,2464,480,640,44,247,291,326,382,True,24
N,64,kaist_dataset/English/Digital_Camera/(E.S)D-indoor/DSC03396.JPG,char_data/N/DSC03396.JPG_5.jpg,3584,480,640,56,427,483,150,214,True,24
N,59,kaist_dataset/English/Digital_Camera/(E.S)D-indoor/DSC03467.JPG,char_data/N/DSC03467.JPG_4.jpg,2301,480,640,39,209,248,147,206,True,24
N,55,kaist_dataset/English/Digital_Camera/(E.S)D-indoor/DSC03467.JPG,char_data/N/DSC03467.JPG_5.jpg,2420,480,640,44,367,411,152,207,True,24
N,57,kaist_dataset/English/Digital_Camera/(E.S)D-indoor/DSC03532.JPG,char_data/N/DSC03532.JPG_14.jpg,3021,480,640,53,111,164,419,476,True,24
N,81,kaist_dataset/English/Digital_Camera/(E.S)D-indoor/DSC03896.JPG,char_data/N/DSC03896.JPG_4.jpg,5508,480,640,68,237,305,268,349,True,24
N,66,kaist_dataset/English/Digital_Camera/(E.S)D-indoor/DSC03896.JPG,char_data/N/DSC03896.JPG_5.jpg,4026,480,640,61,432,493,279,345,True,24
N,54,kaist_dataset/English/Digital_Camera/(E.S)D-indoor/DSC03918.JPG,char_data/N/DSC03918.JPG_2.jpg,2106,480,640,39,309,348,408,462,True,24
N,35,kaist_dataset/English/Digital_Camera/(E.S)D-indoor/DSC03935.JPG,char_data/N/DSC03935.JPG_4.jpg,980,480,640,28,407,435,47,82,True,24
N,41,kaist_dataset/English/Digital_Camera/(E.S)D-indoor/DSC03935.JPG,char_data/N/DSC03935.JPG_5.jpg,1107,480,640,27,485,512,50,91,True,24
N,79,kaist_dataset/English/Digital_Camera/(E.S)D-indoor/DSC03943.JPG,char_data/N/DSC03943.JPG_2.jpg,5135,480,640,65,185,250,208,287,True,24
N,72,kaist_dataset/English/Digital_Camera/(E.S)D-indoor/DSC03947.JPG,char_data/N/DSC03947.JPG_2.jpg,4104,480,640,57,285,342,183,255,True,24
N,18,kaist_dataset/English/Digital_Camera/(E.S)E-night/111.jpg,char_data/N/111.jpg_2.jpg,270,480,640,15,186,201,264,282,True,24
N,101,kaist_dataset/English/Digital_Camera/(E.S)E-night/DSC02613.JPG,char_data/N/DSC02613.JPG_2.jpg,12120,480,640,120,394,514,167,268,True,24
N,28,kaist_dataset/English/Digital_Camera/(E.S)E-night/크기변환_%BA%F7%BD%BA%BD%C5%B8%DE%B4%BA_01_tjtjdska2008.jpg,char_data/N/크기변환_%BA%F7%BD%BA%BD%C5%B8%DE%B4%BA_01_tjtjdska2008.jpg_2.jpg,420,480,640,15,277,292,274,302,True,24
N,134,kaist_dataset/English/Digital_Camera/(E.S)F-others/080116-0058.jpg,char_data/N/080116-0058.jpg_2.jpg,4958,1200,1600,37,994,1031,746,880,True,24
N,42,kaist_dataset/English/Digital_Camera/(E.S)F-others/080119-0007.jpg,char_data/N/080119-0007.jpg_11.jpg,840,1200,1600,20,199,219,599,641,True,24
N,354,kaist_dataset/English/Digital_Camera/(E.S)F-others/080119-0011.jpg,char_data/N/080119-0011.jpg_2.jpg,66198,1200,1600,187,816,1003,415,769,True,24
N,47,kaist_dataset/English/Digital_Camera/(E.S)F-others/086.jpg,char_data/N/086.jpg_6.jpg,987,480,640,21,223,244,297,344,True,24
N,79,kaist_dataset/English/Digital_Camera/(E.S)F-others/2007-12-09-day-exterior-047.jpg,char_data/N/2007-12-09-day-exterior-047.jpg_4.jpg,2686,1200,1600,34,52,86,477,556,True,24
N,54,kaist_dataset/English/Digital_Camera/(E.S)F-others/2007-12-09-day-exterior-047.jpg,char_data/N/2007-12-09-day-exterior-047.jpg_5.jpg,2754,1200,1600,51,1408,1459,537,591,True,24
N,47,kaist_dataset/English/Digital_Camera/(E.S)F-others/크기변환_%B0%A3%C6%C716_m_starfirm.jpg,char_data/N/크기변환_%B0%A3%C6%C716_m_starfirm.jpg_2.jpg,1504,480,640,32,390,422,222,269,True,24
N,87,kaist_dataset/English/Mobile_Phone/(E.M)B-indoor/P090902018.jpg,char_data/N/P090902018.jpg_4.jpg,5220,480,640,60,150,210,44,131,True,24
N,75,kaist_dataset/English/Mobile_Phone/(E.M)C-bookCover/P090831042.jpg,char_data/N/P090831042.jpg_2.jpg,5700,480,640,76,170,246,201,276,True,24
N,65,kaist_dataset/English/Mobile_Phone/(E.M)C-bookCover/P090831075.jpg,char_data/N/P090831075.jpg_2.jpg,3770,480,640,58,452,510,160,225,True,24
N,44,kaist_dataset/English/Mobile_Phone/(E.M)C-bookCover/P090903015.jpg,char_data/N/P090903015.jpg_4.jpg,1760,480,640,40,401,441,144,188,True,24
N,50,kaist_dataset/English/Mobile_Phone/(E.M)C-bookCover/P090903015.jpg,char_data/N/P090903015.jpg_5.jpg,2150,480,640,43,479,522,138,188,True,24
N,51,kaist_dataset/English/Mobile_Phone/(E.M)C-bookCover/P090903054.jpg,char_data/N/P090903054.jpg_5.jpg,1683,480,640,33,492,525,353,404,True,24
N,76,kaist_dataset/English/Mobile_Phone/(E.M)C-bookCover/P090903055.jpg,char_data/N/P090903055.jpg_2.jpg,6308,480,640,83,530,613,165,241,True,24
N,78,kaist_dataset/English/Mobile_Phone/(E.M)C-bookCover/P090903056.jpg,char_data/N/P090903056.jpg_2.jpg,6864,480,640,88,535,623,301,379,True,24
N,37,kaist_dataset/English/Mobile_Phone/(E.M)C-bookCover/P090903071.jpg,char_data/N/P090903071.jpg_2.jpg,1073,480,640,29,281,310,298,335,True,24
N,54,kaist_dataset/English/Mobile_Phone/(E.M)C-bookCover/P090903076.jpg,char_data/N/P090903076.jpg_2.jpg,1944,480,640,36,253,289,389,443,True,24
N,83,kaist_dataset/English/Mobile_Phone/(E.M)C-bookCover/P090905007.jpg,char_data/N/P090905007.jpg_6.jpg,5893,480,640,71,290,361,171,254,True,24
N,84,kaist_dataset/English/Mobile_Phone/(E.M)C-bookCover/P090905007.jpg,char_data/N/P090905007.jpg_7.jpg,5796,480,640,69,490,559,172,256,True,24
N,75,kaist_dataset/English/Mobile_Phone/(E.M)C-bookCover/P090905007.jpg,char_data/N/P090905007.jpg_8.jpg,5625,480,640,75,74,149,291,366,True,24
N,19,kaist_dataset/Korean/Digital_Camera/G-others/5.jpg,char_data/N/5.jpg_6.jpg,266,553,798,14,56,70,39,58,True,24
N,19,kaist_dataset/Korean/Digital_Camera/G-others/5.jpg,char_data/N/5.jpg_7.jpg,247,553,798,13,94,107,38,57,True,24
N,17,kaist_dataset/Korean/Digital_Camera/G-others/5.jpg,char_data/N/5.jpg_8.jpg,255,553,798,15,152,167,40,57,True,24
N,84,kaist_dataset/Korean/Digital_Camera/indoor1/080118-0017.jpg,char_data/N/080118-0017.jpg_2.jpg,5544,1200,1600,66,25,91,342,426,True,24
N,19,kaist_dataset/Korean/Digital_Camera/indoor1/146.JPG,char_data/N/146.JPG_4.jpg,323,480,640,17,274,291,267,286,True,24
N,18,kaist_dataset/Korean/Digital_Camera/indoor1/146.JPG,char_data/N/146.JPG_5.jpg,198,480,640,11,366,377,270,288,True,24
N,39,kaist_dataset/Korean/Digital_Camera/indoor1/2007-12-08-day-139.jpg,char_data/N/2007-12-08-day-139.jpg_2.jpg,975,1200,1600,25,595,620,350,389,True,24
N,94,kaist_dataset/Korean/Digital_Camera/outdoor2/080118-0018.jpg,char_data/N/080118-0018.jpg_2.jpg,10810,1200,1600,115,495,610,651,745,True,24
N,28,kaist_dataset/Korean/Digital_Camera/outdoor2/2007-12-08-day-101.jpg,char_data/N/2007-12-08-day-101.jpg_5.jpg,672,1200,1600,24,198,222,1057,1085,True,24
N,82,kaist_dataset/Korean/Digital_Camera/outdoor2/2007-12-09-day-exterior-068.jpg,char_data/N/2007-12-09-day-exterior-068.jpg_2.jpg,5002,1200,1600,61,671,732,918,1000,True,24
N,37,kaist_dataset/Korean/Digital_Camera/outdoor6/DSC04292.JPG,char_data/N/DSC04292.JPG_2.jpg,851,480,640,23,76,99,52,89,True,24
N,45,kaist_dataset/Mixed/Digital_Camera/(C.S)A-shadow/DSC02902.JPG,char_data/N/DSC02902.JPG_2.jpg,1215,480,640,27,380,407,368,413,True,24
N,65,kaist_dataset/Mixed/Digital_Camera/(C.S)A-shadow/DSC03522.JPG,char_data/N/DSC03522.JPG_2.jpg,3055,480,640,47,304,351,21,86,True,24
N,143,kaist_dataset/Mixed/Digital_Camera/(C.S)C-outdoor1/049.JPG,char_data/N/049.JPG_2.jpg,8866,480,640,62,467,529,177,320,True,24
N,27,kaist_dataset/Mixed/Digital_Camera/(C.S)C-outdoor1/054.JPG,char_data/N/054.JPG_4.jpg,702,480,640,26,301,327,277,304,True,24
N,28,kaist_dataset/Mixed/Digital_Camera/(C.S)C-outdoor1/054.JPG,char_data/N/054.JPG_5.jpg,924,480,640,33,570,603,275,303,True,24
N,174,kaist_dataset/Mixed/Digital_Camera/(C.S)C-outdoor1/080119-0017.jpg,char_data/N/080119-0017.jpg_4.jpg,23142,1200,1600,133,186,319,560,734,True,24
N,169,kaist_dataset/Mixed/Digital_Camera/(C.S)C-outdoor1/080119-0017.jpg,char_data/N/080119-0017.jpg_5.jpg,19942,1200,1600,118,1263,1381,547,716,True,24
N,79,kaist_dataset/Mixed/Digital_Camera/(C.S)C-outdoor1/080119-0027.jpg,char_data/N/080119-0027.jpg_2.jpg,3713,1200,1600,47,1025,1072,718,797,True,24
N,113,kaist_dataset/Mixed/Digital_Camera/(C.S)C-outdoor1/080119-0037.jpg,char_data/N/080119-0037.jpg_2.jpg,8362,1200,1600,74,1031,1105,848,961,True,24
N,45,kaist_dataset/Mixed/Digital_Camera/(C.S)C-outdoor1/1.JPG,char_data/N/1.JPG_6.jpg,2565,576,768,57,269,326,1,46,True,24
N,48,kaist_dataset/Mixed/Digital_Camera/(C.S)C-outdoor1/1.JPG,char_data/N/1.JPG_7.jpg,2544,576,768,53,560,613,1,48,True,24
N,75,kaist_dataset/Mixed/Digital_Camera/(C.S)C-outdoor1/1.JPG,char_data/N/1.JPG_8.jpg,4425,576,768,59,331,390,198,273,True,24
N,44,kaist_dataset/Mixed/Digital_Camera/(C.S)C-outdoor1/114.jpg,char_data/N/114.jpg_4.jpg,1276,480,640,29,300,329,315,359,True,24
N,24,kaist_dataset/Mixed/Digital_Camera/(C.S)C-outdoor1/114.jpg,char_data/N/114.jpg_5.jpg,456,480,640,19,234,253,367,391,True,24
N,30,kaist_dataset/Mixed/Digital_Camera/(C.S)C-outdoor1/121.JPG,char_data/N/121.JPG_2.jpg,660,480,640,22,153,175,215,245,True,24
N,16,kaist_dataset/Mixed/Digital_Camera/(C.S)C-outdoor1/135.JPG,char_data/N/135.JPG_4.jpg,304,480,640,19,296,315,177,193,True,24
N,18,kaist_dataset/Mixed/Digital_Camera/(C.S)C-outdoor1/135.JPG,char_data/N/135.JPG_5.jpg,342,480,640,19,315,334,178,196,True,24
N,66,kaist_dataset/Mixed/Digital_Camera/(C.S)C-outdoor1/2.JPG,char_data/N/2.JPG_6.jpg,2904,576,768,44,342,386,208,274,True,24
N,31,kaist_dataset/Mixed/Digital_Camera/(C.S)C-outdoor1/2.JPG,char_data/N/2.JPG_8.jpg,651,576,768,21,517,538,365,396,True,24
N,46,kaist_dataset/Mixed/Digital_Camera/(C.S)C-outdoor1/2007-12-08-day-103.jpg,char_data/N/2007-12-08-day-103.jpg_2.jpg,1518,1200,1600,33,691,724,617,663,True,24
N,53,kaist_dataset/Mixed/Digital_Camera/(C.S)C-outdoor1/2007-12-08-day-130.jpg,char_data/N/2007-12-08-day-130.jpg_4.jpg,2491,1200,1600,47,682,729,691,744,True,24
N,49,kaist_dataset/Mixed/Digital_Camera/(C.S)C-outdoor1/2007-12-08-day-130.jpg,char_data/N/2007-12-08-day-130.jpg_5.jpg,2205,1200,1600,45,1121,1166,712,761,True,24
N,85,kaist_dataset/Mixed/Digital_Camera/(C.S)C-outdoor1/2007-12-09-day-exterior-051.jpg,char_data/N/2007-12-09-day-exterior-051.jpg_4.jpg,8670,1200,1600,102,1003,1105,370,455,True,24
N,31,kaist_dataset/Mixed/Digital_Camera/(C.S)C-outdoor1/2007-12-09-day-exterior-051.jpg,char_data/N/2007-12-09-day-exterior-051.jpg_5.jpg,589,1200,1600,19,547,566,680,711,True,24
N,51,kaist_dataset/Mixed/Digital_Camera/(C.S)C-outdoor1/3.JPG,char_data/N/3.JPG_6.jpg,2142,576,768,42,354,396,229,280,True,24
N,21,kaist_dataset/Mixed/Digital_Camera/(C.S)C-outdoor1/3.JPG,char_data/N/3.JPG_7.jpg,231,576,768,11,590,601,295,316,True,24
N,20,kaist_dataset/Mixed/Digital_Camera/(C.S)C-outdoor1/3.JPG,char_data/N/3.JPG_8.jpg,220,576,768,11,114,125,291,311,True,24
N,34,kaist_dataset/Mixed/Digital_Camera/(C.S)C-outdoor1/DSC02240.JPG,char_data/N/DSC02240.JPG_2.jpg,816,480,640,24,292,316,280,314,True,24
N,30,kaist_dataset/Mixed/Digital_Camera/(C.S)C-outdoor1/DSC02318.JPG,char_data/N/DSC02318.JPG_2.jpg,1020,480,640,34,164,198,318,348,True,24
N,79,kaist_dataset/Mixed/Digital_Camera/(C.S)C-outdoor1/DSC02325.JPG,char_data/N/DSC02325.JPG_4.jpg,4582,480,640,58,309,367,160,239,True,24
N,133,kaist_dataset/Mixed/Digital_Camera/(C.S)C-outdoor1/P1010008.JPG,char_data/N/P1010008.JPG_2.jpg,16492,480,640,124,96,220,82,215,True,24
N,44,kaist_dataset/Mixed/Digital_Camera/(C.S)C-outdoor1/P1010009.JPG,char_data/N/P1010009.JPG_2.jpg,1980,480,640,45,438,483,196,240,True,24
N,76,kaist_dataset/Mixed/Digital_Camera/(C.S)C-outdoor2/DSC02385.JPG,char_data/N/DSC02385.JPG_6.jpg,4560,480,640,60,325,385,180,256,True,24
N,29,kaist_dataset/Mixed/Digital_Camera/(C.S)C-outdoor2/DSC02385.JPG,char_data/N/DSC02385.JPG_7.jpg,609,480,640,21,344,365,153,182,True,24
N,26,kaist_dataset/Mixed/Digital_Camera/(C.S)C-outdoor2/DSC02418.JPG,char_data/N/DSC02418.JPG_2.jpg,624,480,640,24,103,127,92,118,True,24
N,36,kaist_dataset/Mixed/Digital_Camera/(C.S)C-outdoor2/DSC02419.JPG,char_data/N/DSC02419.JPG_2.jpg,1224,480,640,34,147,181,208,244,True,24
N,69,kaist_dataset/Mixed/Digital_Camera/(C.S)C-outdoor2/DSC02439.JPG,char_data/N/DSC02439.JPG_6.jpg,4347,480,640,63,255,318,133,202,True,24
N,29,kaist_dataset/Mixed/Digital_Camera/(C.S)C-outdoor2/DSC02439.JPG,char_data/N/DSC02439.JPG_7.jpg,812,480,640,28,269,297,107,136,True,24
N,25,kaist_dataset/Mixed/Digital_Camera/(C.S)C-outdoor2/DSC02477.JPG,char_data/N/DSC02477.JPG_2.jpg,600,480,640,24,149,173,153,178,True,24
N,26,kaist_dataset/Mixed/Digital_Camera/(C.S)C-outdoor2/DSC02555.JPG,char_data/N/DSC02555.JPG_2.jpg,546,480,640,21,168,189,149,175,True,24
N,44,kaist_dataset/Mixed/Digital_Camera/(C.S)C-outdoor2/DSC02872.JPG,char_data/N/DSC02872.JPG_2.jpg,1100,480,640,25,345,370,216,260,True,24
N,49,kaist_dataset/Mixed/Digital_Camera/(C.S)C-outdoor2/DSC02924.JPG,char_data/N/DSC02924.JPG_2.jpg,1911,480,640,39,250,289,318,367,True,24
N,39,kaist_dataset/Mixed/Digital_Camera/(C.S)C-outdoor3/DSC02986.JPG,char_data/N/DSC02986.JPG_2.jpg,1443,480,640,37,581,618,278,317,True,24
N,51,kaist_dataset/Mixed/Digital_Camera/(C.S)C-outdoor3/DSC03010.JPG,char_data/N/DSC03010.JPG_4.jpg,1377,480,640,27,327,354,94,145,True,24
N,47,kaist_dataset/Mixed/Digital_Camera/(C.S)C-outdoor3/DSC03010.JPG,char_data/N/DSC03010.JPG_5.jpg,1316,480,640,28,444,472,74,121,True,24
N,23,kaist_dataset/Mixed/Digital_Camera/(C.S)C-outdoor3/DSC03033.JPG,char_data/N/DSC03033.JPG_2.jpg,345,480,640,15,129,144,128,151,True,24
N,87,kaist_dataset/Mixed/Digital_Camera/(C.S)C-outdoor3/DSC03164.JPG,char_data/N/DSC03164.JPG_2.jpg,6960,480,640,80,400,480,78,165,True,24
N,94,kaist_dataset/Mixed/Digital_Camera/(C.S)C-outdoor3/DSC03176.JPG,char_data/N/DSC03176.JPG_2.jpg,8648,480,640,92,372,464,272,366,True,24
N,36,kaist_dataset/Mixed/Digital_Camera/(C.S)C-outdoor3/DSC03233.JPG,char_data/N/DSC03233.JPG_2.jpg,1512,480,640,42,42,84,247,283,True,24
N,40,kaist_dataset/Mixed/Digital_Camera/(C.S)C-outdoor3/DSC03242.JPG,char_data/N/DSC03242.JPG_2.jpg,1120,480,640,28,254,282,315,355,True,24
N,29,kaist_dataset/Mixed/Digital_Camera/(C.S)C-outdoor3/DSC03250.JPG,char_data/N/DSC03250.JPG_2.jpg,696,480,640,24,487,511,371,400,True,24
N,38,kaist_dataset/Mixed/Digital_Camera/(C.S)C-outdoor3/DSC03254.JPG,char_data/N/DSC03254.JPG_2.jpg,1748,480,640,46,518,564,213,251,True,24
N,21,kaist_dataset/Mixed/Digital_Camera/(C.S)C-outdoor3/DSC03255.JPG,char_data/N/DSC03255.JPG_2.jpg,357,480,640,17,574,591,180,201,True,24
N,64,kaist_dataset/Mixed/Digital_Camera/(C.S)C-outdoor3/DSC03306.JPG,char_data/N/DSC03306.JPG_4.jpg,2496,480,640,39,245,284,393,457,True,24
N,59,kaist_dataset/Mixed/Digital_Camera/(C.S)C-outdoor3/DSC03306.JPG,char_data/N/DSC03306.JPG_5.jpg,2301,480,640,39,545,584,393,452,True,24
N,73,kaist_dataset/Mixed/Digital_Camera/(C.S)C-outdoor4/DSC03439.JPG,char_data/N/DSC03439.JPG_2.jpg,4745,480,640,65,515,580,322,395,True,24
N,52,kaist_dataset/Mixed/Digital_Camera/(C.S)C-outdoor4/DSC03531.JPG,char_data/N/DSC03531.JPG_2.jpg,2236,480,640,43,560,603,343,395,True,24
N,48,kaist_dataset/Mixed/Digital_Camera/(C.S)C-outdoor4/DSC03581.JPG,char_data/N/DSC03581.JPG_2.jpg,2400,480,640,50,547,597,196,244,True,24
N,89,kaist_dataset/Mixed/Digital_Camera/(C.S)C-outdoor4/DSC03652.JPG,char_data/N/DSC03652.JPG_2.jpg,5162,480,640,58,394,452,174,263,True,24
N,82,kaist_dataset/Mixed/Digital_Camera/(C.S)C-outdoor4/DSC03666.JPG,char_data/N/DSC03666.JPG_6.jpg,5166,480,640,63,290,353,156,238,True,24
N,35,kaist_dataset/Mixed/Digital_Camera/(C.S)C-outdoor4/DSC03666.JPG,char_data/N/DSC03666.JPG_7.jpg,945,480,640,27,58,85,140,175,True,24
N,31,kaist_dataset/Mixed/Digital_Camera/(C.S)C-outdoor4/DSC03666.JPG,char_data/N/DSC03666.JPG_8.jpg,930,480,640,30,83,113,134,165,True,24
N,60,kaist_dataset/Mixed/Digital_Camera/(C.S)C-outdoor4/DSC03673.JPG,char_data/N/DSC03673.JPG_2.jpg,2700,480,640,45,369,414,179,239,True,24
N,76,kaist_dataset/Mixed/Digital_Camera/(C.S)C-outdoor4/DSC03687.JPG,char_data/N/DSC03687.JPG_4.jpg,3800,480,640,50,442,492,319,395,True,24
N,31,kaist_dataset/Mixed/Digital_Camera/(C.S)C-outdoor4/DSC03687.JPG,char_data/N/DSC03687.JPG_5.jpg,589,480,640,19,235,254,294,325,True,24
N,47,kaist_dataset/Mixed/Digital_Camera/(C.S)C-outdoor4/DSC03707.JPG,char_data/N/DSC03707.JPG_4.jpg,1739,480,640,37,274,311,93,140,True,24
N,48,kaist_dataset/Mixed/Digital_Camera/(C.S)C-outdoor4/DSC03707.JPG,char_data/N/DSC03707.JPG_5.jpg,1728,480,640,36,298,334,146,194,True,24
N,40,kaist_dataset/Mixed/Digital_Camera/(C.S)C-outdoor4/DSC03711.JPG,char_data/N/DSC03711.JPG_6.jpg,1080,480,640,27,63,90,390,430,True,24
N,44,kaist_dataset/Mixed/Digital_Camera/(C.S)C-outdoor4/DSC03711.JPG,char_data/N/DSC03711.JPG_7.jpg,1276,480,640,29,90,119,392,436,True,24
N,34,kaist_dataset/Mixed/Digital_Camera/(C.S)C-outdoor4/DSC03711.JPG,char_data/N/DSC03711.JPG_8.jpg,850,480,640,25,226,251,391,425,True,24
N,35,kaist_dataset/Mixed/Digital_Camera/(C.S)C-outdoor4/DSC03716.JPG,char_data/N/DSC03716.JPG_2.jpg,490,480,640,14,289,303,238,273,True,24
N,145,kaist_dataset/Mixed/Digital_Camera/(C.S)C-outdoor5/DSC03830.JPG,char_data/N/DSC03830.JPG_2.jpg,17400,480,640,120,502,622,107,252,True,24
N,92,kaist_dataset/Mixed/Digital_Camera/(C.S)C-outdoor5/DSC03839.JPG,char_data/N/DSC03839.JPG_2.jpg,9660,480,640,105,150,255,201,293,False,24
N,32,kaist_dataset/Mixed/Digital_Camera/(C.S)C-outdoor5/DSC04056.JPG,char_data/N/DSC04056.JPG_2.jpg,864,480,640,27,106,133,279,311,False,24
N,66,kaist_dataset/Mixed/Digital_Camera/(C.S)C-outdoor5/DSC04059.JPG,char_data/N/DSC04059.JPG_2.jpg,1650,480,640,25,406,431,115,181,False,24
N,56,kaist_dataset/Mixed/Digital_Camera/(C.S)C-outdoor5/DSC04060.JPG,char_data/N/DSC04060.JPG_4.jpg,1848,480,640,33,235,268,97,153,False,24
N,59,kaist_dataset/Mixed/Digital_Camera/(C.S)C-outdoor5/DSC04060.JPG,char_data/N/DSC04060.JPG_5.jpg,1770,480,640,30,568,598,91,150,False,24
N,34,kaist_dataset/Mixed/Digital_Camera/(C.S)C-outdoor5/DSC04290.JPG,char_data/N/DSC04290.JPG_2.jpg,884,480,640,26,71,97,377,411,False,24
N,34,kaist_dataset/Mixed/Digital_Camera/(C.S)C-outdoor5/DSC04314.JPG,char_data/N/DSC04314.JPG_2.jpg,952,480,640,28,299,327,172,206,False,24
N,42,kaist_dataset/Mixed/Digital_Camera/(C.S)C-outdoor5/DSC04321.JPG,char_data/N/DSC04321.JPG_12.jpg,1134,480,640,27,236,263,194,236,False,24
N,44,kaist_dataset/Mixed/Digital_Camera/(C.S)C-outdoor5/DSC04323.JPG,char_data/N/DSC04323.JPG_10.jpg,1188,480,640,27,258,285,199,243,False,24
N,23,kaist_dataset/Mixed/Digital_Camera/(C.S)C-outdoor5/DSC04360.JPG,char_data/N/DSC04360.JPG_4.jpg,391,480,640,17,104,121,318,341,False,24
N,31,kaist_dataset/Mixed/Digital_Camera/(C.S)C-outdoor5/DSC04360.JPG,char_data/N/DSC04360.JPG_5.jpg,496,480,640,16,77,93,348,379,False,24
N,36,kaist_dataset/Mixed/Digital_Camera/(C.S)C-outdoor5/DSC04434.JPG,char_data/N/DSC04434.JPG_4.jpg,756,480,640,21,193,214,270,306,False,24
N,38,kaist_dataset/Mixed/Digital_Camera/(C.S)C-outdoor5/DSC04434.JPG,char_data/N/DSC04434.JPG_5.jpg,1102,480,640,29,238,267,387,425,False,24
N,58,kaist_dataset/Mixed/Digital_Camera/(C.S)C-outdoor5/DSC04447.JPG,char_data/N/DSC04447.JPG_4.jpg,2726,480,640,47,267,314,348,406,False,24
N,55,kaist_dataset/Mixed/Digital_Camera/(C.S)C-outdoor5/DSC04447.JPG,char_data/N/DSC04447.JPG_5.jpg,2420,480,640,44,313,357,347,402,False,24
N,68,kaist_dataset/Mixed/Digital_Camera/(C.S)C-outdoor5/DSC04450.JPG,char_data/N/DSC04450.JPG_4.jpg,2312,480,640,34,189,223,49,117,False,24
N,64,kaist_dataset/Mixed/Digital_Camera/(C.S)C-outdoor5/DSC04450.JPG,char_data/N/DSC04450.JPG_5.jpg,2112,480,640,33,186,219,262,326,False,24
N,22,kaist_dataset/Mixed/Digital_Camera/(C.S)C-outdoor6/P1010065.JPG,char_data/N/P1010065.JPG_7.jpg,308,480,640,14,118,132,108,130,False,24
N,17,kaist_dataset/Mixed/Digital_Camera/(C.S)C-outdoor6/P1010065.JPG,char_data/N/P1010065.JPG_8.jpg,204,480,640,12,239,251,107,124,False,24
N,28,kaist_dataset/Mixed/Digital_Camera/(C.S)C-outdoor6/P1010088.JPG,char_data/N/P1010088.JPG_2.jpg,532,480,640,19,308,327,180,208,False,24
N,32,kaist_dataset/Mixed/Digital_Camera/(C.S)C-outdoor6/P1010090.JPG,char_data/N/P1010090.JPG_4.jpg,736,480,640,23,243,266,202,234,False,24
N,35,kaist_dataset/Mixed/Digital_Camera/(C.S)C-outdoor6/P1010090.JPG,char_data/N/P1010090.JPG_5.jpg,875,480,640,25,353,378,197,232,False,24
N,33,kaist_dataset/Mixed/Digital_Camera/(C.S)C-outdoor6/P1010095.JPG,char_data/N/P1010095.JPG_2.jpg,528,480,640,16,158,174,180,213,False,24
N,27,kaist_dataset/Mixed/Digital_Camera/(C.S)C-outdoor6/P1010114.JPG,char_data/N/P1010114.JPG_2.jpg,540,480,640,20,252,272,216,243,False,24
N,45,kaist_dataset/Mixed/Digital_Camera/(C.S)C-outdoor6/P1010132.JPG,char_data/N/P1010132.JPG_6.jpg,1575,480,640,35,134,169,159,204,False,24
N,50,kaist_dataset/Mixed/Digital_Camera/(C.S)C-outdoor6/P1010132.JPG,char_data/N/P1010132.JPG_7.jpg,1900,480,640,38,219,257,154,204,False,24
N,49,kaist_dataset/Mixed/Digital_Camera/(C.S)C-outdoor6/P1010132.JPG,char_data/N/P1010132.JPG_8.jpg,1960,480,640,40,420,460,152,201,False,24
N,54,kaist_dataset/Mixed/Digital_Camera/(C.S)D-indoor1/DSC02711.JPG,char_data/N/DSC02711.JPG_2.jpg,2970,480,640,55,112,167,237,291,False,24
N,53,kaist_dataset/Mixed/Digital_Camera/(C.S)D-indoor1/DSC02713.JPG,char_data/N/DSC02713.JPG_2.jpg,2067,480,640,39,217,256,149,202,False,24
N,94,kaist_dataset/Mixed/Digital_Camera/(C.S)D-indoor1/DSC02732.JPG,char_data/N/DSC02732.JPG_2.jpg,9212,480,640,98,513,611,118,212,False,24
N,158,kaist_dataset/Mixed/Digital_Camera/(C.S)D-indoor1/DSC02739.JPG,char_data/N/DSC02739.JPG_2.jpg,17538,480,640,111,98,209,313,471,False,24
N,59,kaist_dataset/Mixed/Digital_Camera/(C.S)D-indoor1/DSC03126.JPG,char_data/N/DSC03126.JPG_2.jpg,2301,480,640,39,212,251,215,274,False,24
N,64,kaist_dataset/Mixed/Digital_Camera/(C.S)D-indoor1/DSC03133.JPG,char_data/N/DSC03133.JPG_4.jpg,3200,480,640,50,134,184,136,200,False,24
N,43,kaist_dataset/Mixed/Digital_Camera/(C.S)D-indoor1/DSC03980.JPG,char_data/N/DSC03980.JPG_2.jpg,903,480,640,21,583,604,148,191,False,24
N,169,kaist_dataset/Mixed/Digital_Camera/(C.S)D-indoor1/DSC04223.JPG,char_data/N/DSC04223.JPG_2.jpg,15548,480,640,92,406,498,9,178,False,24
N,39,kaist_dataset/Mixed/Digital_Camera/(C.S)D-indoor2/DSC04254.JPG,char_data/N/DSC04254.JPG_8.jpg,975,480,640,25,110,135,341,380,False,24
N,74,kaist_dataset/Mixed/Digital_Camera/(C.S)D-indoor2/크기변환_P1010030.JPG,char_data/N/크기변환_P1010030.JPG_2.jpg,3700,480,640,50,463,513,131,205,False,24
N,42,kaist_dataset/Mixed/Digital_Camera/(C.S)E-night/DSC02574.JPG,char_data/N/DSC02574.JPG_4.jpg,1050,480,640,25,273,298,148,190,False,24
N,52,kaist_dataset/Mixed/Digital_Camera/(C.S)E-night/DSC02595.JPG,char_data/N/DSC02595.JPG_2.jpg,2652,480,640,51,208,259,357,409,False,24
N,34,kaist_dataset/Mixed/Digital_Camera/(C.S)E-night/DSC02660.JPG,char_data/N/DSC02660.JPG_2.jpg,646,480,640,19,301,320,380,414,False,24
N,64,kaist_dataset/Mixed/Digital_Camera/(C.S)E-night/DSC02672.JPG,char_data/N/DSC02672.JPG_6.jpg,2816,480,640,44,247,291,92,156,False,24
N,52,kaist_dataset/Mixed/Digital_Camera/(C.S)E-night/DSC02672.JPG,char_data/N/DSC02672.JPG_7.jpg,1300,480,640,25,385,410,165,217,False,24
N,47,kaist_dataset/Mixed/Digital_Camera/(C.S)E-night/DSC02672.JPG,char_data/N/DSC02672.JPG_8.jpg,1175,480,640,25,499,524,173,220,False,24
N,60,kaist_dataset/Mixed/Digital_Camera/(C.S)E-night/DSC03516.JPG,char_data/N/DSC03516.JPG_2.jpg,1920,480,640,32,373,405,214,274,False,24
N,31,kaist_dataset/Mixed/Digital_Camera/(C.S)E-night/DSC03871.JPG,char_data/N/DSC03871.JPG_4.jpg,1085,480,640,35,268,303,190,221,False,24
N,30,kaist_dataset/Mixed/Digital_Camera/(C.S)E-night/DSC03871.JPG,char_data/N/DSC03871.JPG_5.jpg,810,480,640,27,497,524,197,227,False,24
N,47,kaist_dataset/Mixed/Digital_Camera/(C.S)E-night/사진9.jpg수정.jpg,char_data/N/사진9.jpg수정.jpg_6.jpg,2021,480,680,43,215,258,203,250,False,24
N,43,kaist_dataset/Mixed/Digital_Camera/(C.S)E-night/사진9.jpg수정.jpg,char_data/N/사진9.jpg수정.jpg_7.jpg,1892,480,680,44,321,365,201,244,False,24
N,46,kaist_dataset/Mixed/Digital_Camera/(C.S)E-night/사진9.jpg수정.jpg,char_data/N/사진9.jpg수정.jpg_8.jpg,1978,480,680,43,215,258,255,301,False,24
N,68,kaist_dataset/Mixed/Digital_Camera/(C.S)F-others/2007-12-08-day-113.jpg,char_data/N/2007-12-08-day-113.jpg_4.jpg,2448,1200,1600,36,299,335,240,308,False,24
N,57,kaist_dataset/Mixed/Digital_Camera/(C.S)F-others/2007-12-08-day-113.jpg,char_data/N/2007-12-08-day-113.jpg_5.jpg,1995,1200,1600,35,445,480,289,346,False,24
N,41,kaist_dataset/Mixed/Digital_Camera/(C.S)F-others/DSC02504.JPG,char_data/N/DSC02504.JPG_2.jpg,1189,480,640,29,476,505,343,384,False,24
N,53,kaist_dataset/Mixed/Mobile_Phone/(C.M)B-indoor/P090831014.jpg,char_data/N/P090831014.jpg_2.jpg,2968,480,640,56,209,265,161,214,False,24
N,67,kaist_dataset/Mixed/Mobile_Phone/(C.M)B-indoor/P090831015.jpg,char_data/N/P090831015.jpg_2.jpg,3149,480,640,47,280,327,203,270,False,24
N,56,kaist_dataset/Mixed/Mobile_Phone/(C.M)B-indoor/P090831016.jpg,char_data/N/P090831016.jpg_2.jpg,2800,480,640,50,272,322,181,237,False,24
N,46,kaist_dataset/Mixed/Mobile_Phone/(C.M)B-indoor/P090831021.jpg,char_data/N/P090831021.jpg_2.jpg,1472,480,640,32,228,260,376,422,False,24
N,47,kaist_dataset/Mixed/Mobile_Phone/(C.M)C-bookCover/P090902016.jpg,char_data/N/P090902016.jpg_2.jpg,1880,480,640,40,218,258,126,173,False,24
N,51,kaist_dataset/Mixed/Mobile_Phone/(C.M)C-bookCover/P090904005.jpg,char_data/N/P090904005.jpg_2.jpg,1785,480,640,35,261,296,106,157,False,24
I,93,kaist_dataset/English/Digital_Camera/(E.S)A-shadow/DSC02317.JPG,char_data/I/DSC02317.JPG_2.jpg,3255,480,640,35,405,440,224,317,True,20
I,47,kaist_dataset/English/Digital_Camera/(E.S)A-shadow/DSC02423.JPG,char_data/I/DSC02423.JPG_2.jpg,846,480,640,18,316,334,239,286,True,20
I,107,kaist_dataset/English/Digital_Camera/(E.S)A-shadow/DSC02629.JPG,char_data/I/DSC02629.JPG_2.jpg,3745,480,640,35,32,67,306,413,True,20
I,71,kaist_dataset/English/Digital_Camera/(E.S)A-shadow/P090912074.jpg,char_data/I/P090912074.jpg_2.jpg,3195,480,640,45,248,293,72,143,True,20
I,45,kaist_dataset/English/Digital_Camera/(E.S)A-shadow/P1010044.JPG,char_data/I/P1010044.JPG_2.jpg,720,480,640,16,491,507,348,393,True,20
I,172,kaist_dataset/English/Digital_Camera/(E.S)B-light/080116-0059.jpg,char_data/I/080116-0059.jpg_14.jpg,4644,1200,1600,27,1031,1058,328,500,True,20
I,35,kaist_dataset/English/Digital_Camera/(E.S)B-light/080116-0059.jpg,char_data/I/080116-0059.jpg_15.jpg,175,1200,1600,5,517,522,828,863,True,20
I,29,kaist_dataset/English/Digital_Camera/(E.S)B-light/080116-0059.jpg,char_data/I/080116-0059.jpg_16.jpg,174,1200,1600,6,956,962,823,852,True,20
I,30,kaist_dataset/English/Digital_Camera/(E.S)B-light/080116-0059.jpg,char_data/I/080116-0059.jpg_17.jpg,270,1200,1600,9,491,500,801,831,True,20
I,26,kaist_dataset/English/Digital_Camera/(E.S)B-light/080116-0059.jpg,char_data/I/080116-0059.jpg_18.jpg,156,1200,1600,6,727,733,802,828,True,20
I,34,kaist_dataset/English/Digital_Camera/(E.S)B-light/080116-0059.jpg,char_data/I/080116-0059.jpg_19.jpg,272,1200,1600,8,514,522,769,803,True,20
I,31,kaist_dataset/English/Digital_Camera/(E.S)B-light/080116-0059.jpg,char_data/I/080116-0059.jpg_20.jpg,279,1200,1600,9,834,843,770,801,True,20
I,85,kaist_dataset/English/Digital_Camera/(E.S)B-light/DSC03007.JPG,char_data/I/DSC03007.JPG_2.jpg,2805,480,640,33,516,549,157,242,True,20
I,74,kaist_dataset/English/Digital_Camera/(E.S)B-light/DSC04200.JPG,char_data/I/DSC04200.JPG_2.jpg,1480,480,640,20,392,412,311,385,True,20
I,17,kaist_dataset/English/Digital_Camera/(E.S)B-light/x.jpg,char_data/I/x.jpg_2.jpg,153,240,320,9,115,124,115,132,True,20
I,43,kaist_dataset/English/Digital_Camera/(E.S)C-outdoor1/001.jpg,char_data/I/001.jpg_8.jpg,602,257,470,14,240,254,16,59,True,20
I,87,kaist_dataset/English/Digital_Camera/(E.S)C-outdoor1/041.JPG,char_data/I/041.JPG_2.jpg,3132,480,640,36,172,208,208,295,True,20
I,74,kaist_dataset/English/Digital_Camera/(E.S)C-outdoor1/055.JPG,char_data/I/055.JPG_4.jpg,2072,480,640,28,225,253,183,257,True,20
I,75,kaist_dataset/English/Digital_Camera/(E.S)C-outdoor1/055.JPG,char_data/I/055.JPG_5.jpg,2250,480,640,30,304,334,183,258,True,20
I,50,kaist_dataset/English/Digital_Camera/(E.S)C-outdoor1/064.JPG,char_data/I/064.JPG_2.jpg,950,480,640,19,245,264,185,235,True,20
I,70,kaist_dataset/English/Digital_Camera/(E.S)C-outdoor1/080.jpg,char_data/I/080.jpg_8.jpg,1540,253,350,22,119,141,77,147,True,20
I,72,kaist_dataset/English/Digital_Camera/(E.S)C-outdoor1/080.jpg,char_data/I/080.jpg_9.jpg,1296,253,350,18,184,202,79,151,True,20
I,44,kaist_dataset/English/Digital_Camera/(E.S)C-outdoor1/080116-0065.jpg,char_data/I/080116-0065.jpg_2.jpg,572,600,800,13,489,502,341,385,True,20
I,69,kaist_dataset/English/Digital_Camera/(E.S)C-outdoor1/080118-0011.jpg,char_data/I/080118-0011.jpg_2.jpg,2208,1200,1600,32,1182,1214,925,994,True,20
I,59,kaist_dataset/English/Digital_Camera/(E.S)C-outdoor1/080119-0012.jpg,char_data/I/080119-0012.jpg_4.jpg,1062,1200,1600,18,611,629,581,640,True,20
I,56,kaist_dataset/English/Digital_Camera/(E.S)C-outdoor1/080119-0012.jpg,char_data/I/080119-0012.jpg_5.jpg,672,1200,1600,12,655,667,581,637,True,20
I,163,kaist_dataset/English/Digital_Camera/(E.S)C-outdoor1/080119-0020.jpg,char_data/I/080119-0020.jpg_2.jpg,12714,1200,1600,78,980,1058,471,634,True,20
I,29,kaist_dataset/English/Digital_Camera/(E.S)C-outdoor1/113.jpg,char_data/I/113.jpg_4.jpg,319,480,640,11,429,440,228,257,True,20
I,70,kaist_dataset/English/Digital_Camera/(E.S)C-outdoor1/139.JPG,char_data/I/139.JPG_2.jpg,1260,480,640,18,415,433,245,315,True,20
I,135,kaist_dataset/English/Digital_Camera/(E.S)C-outdoor1/2007-12-09-day-exterior-063.jpg,char_data/I/2007-12-09-day-exterior-063.jpg_2.jpg,7560,1200,1600,56,466,522,387,522,True,20
I,50,kaist_dataset/English/Digital_Camera/(E.S)C-outdoor1/6.jpg,char_data/I/6.jpg_2.jpg,700,255,731,14,173,187,95,145,True,20
I,76,kaist_dataset/English/Digital_Camera/(E.S)C-outdoor1/DSC02243.JPG,char_data/I/DSC02243.JPG_2.jpg,1140,480,640,15,324,339,201,277,True,20
I,105,kaist_dataset/English/Digital_Camera/(E.S)C-outdoor1/DSC02306.JPG,char_data/I/DSC02306.JPG_2.jpg,5460,480,640,52,409,461,140,245,True,20
I,40,kaist_dataset/English/Digital_Camera/(E.S)C-outdoor1/DSC02345.JPG,char_data/I/DSC02345.JPG_8.jpg,400,480,640,10,130,140,237,277,True,20
I,32,kaist_dataset/English/Digital_Camera/(E.S)C-outdoor1/DSC02345.JPG,char_data/I/DSC02345.JPG_9.jpg,288,480,640,9,248,257,241,273,True,20
I,30,kaist_dataset/English/Digital_Camera/(E.S)C-outdoor1/DSC02345.JPG,char_data/I/DSC02345.JPG_10.jpg,330,480,640,11,391,402,238,268,True,20
I,33,kaist_dataset/English/Digital_Camera/(E.S)C-outdoor1/DSC02345.JPG,char_data/I/DSC02345.JPG_11.jpg,297,480,640,9,459,468,237,270,True,20
I,109,kaist_dataset/English/Digital_Camera/(E.S)C-outdoor1/DSC02352.JPG,char_data/I/DSC02352.JPG_2.jpg,6867,480,640,63,78,141,210,319,True,20
I,95,kaist_dataset/English/Digital_Camera/(E.S)C-outdoor1/DSC02364.JPG,char_data/I/DSC02364.JPG_2.jpg,3325,480,640,35,51,86,232,327,True,20
I,66,kaist_dataset/English/Digital_Camera/(E.S)C-outdoor1/DSC02398.JPG,char_data/I/DSC02398.JPG_2.jpg,2442,480,640,37,350,387,237,303,True,20
I,151,kaist_dataset/English/Digital_Camera/(E.S)C-outdoor1/DSC02406.JPG,char_data/I/DSC02406.JPG_4.jpg,9060,480,640,60,238,298,116,267,True,20
I,143,kaist_dataset/English/Digital_Camera/(E.S)C-outdoor1/DSC02406.JPG,char_data/I/DSC02406.JPG_5.jpg,8151,480,640,57,428,485,120,263,True,20
I,78,kaist_dataset/English/Digital_Camera/(E.S)C-outdoor1/DSC02408.JPG,char_data/I/DSC02408.JPG_4.jpg,3120,480,640,40,145,185,264,342,True,20
I,87,kaist_dataset/English/Digital_Camera/(E.S)C-outdoor1/DSC02408.JPG,char_data/I/DSC02408.JPG_5.jpg,3654,480,640,42,257,299,261,348,True,20
I,92,kaist_dataset/English/Digital_Camera/(E.S)C-outdoor1/DSC02410.JPG,char_data/I/DSC02410.JPG_2.jpg,2484,480,640,27,203,230,122,214,True,20
I,130,kaist_dataset/English/Digital_Camera/(E.S)C-outdoor1/DSC02448.JPG,char_data/I/DSC02448.JPG_2.jpg,5070,480,640,39,351,390,196,326,True,20
I,72,kaist_dataset/English/Digital_Camera/(E.S)C-outdoor1/DSC02480.JPG,char_data/I/DSC02480.JPG_6.jpg,2736,480,640,38,229,267,189,261,True,20
I,66,kaist_dataset/English/Digital_Camera/(E.S)C-outdoor1/DSC02480.JPG,char_data/I/DSC02480.JPG_7.jpg,2706,480,640,41,314,355,187,253,True,20
I,18,kaist_dataset/English/Digital_Camera/(E.S)C-outdoor1/DSC02500.JPG,char_data/I/DSC02500.JPG_8.jpg,108,480,640,6,1,7,105,123,True,20
I,23,kaist_dataset/English/Digital_Camera/(E.S)C-outdoor1/DSC02500.JPG,char_data/I/DSC02500.JPG_9.jpg,207,480,640,9,68,77,104,127,True,20
I,24,kaist_dataset/English/Digital_Camera/(E.S)C-outdoor1/DSC02500.JPG,char_data/I/DSC02500.JPG_10.jpg,192,480,640,8,81,89,84,108,True,20
I,48,kaist_dataset/English/Digital_Camera/(E.S)C-outdoor1/DSC02501.JPG,char_data/I/DSC02501.JPG_2.jpg,1632,480,640,34,410,444,299,347,True,20
I,110,kaist_dataset/English/Digital_Camera/(E.S)C-outdoor1/DSC02590.JPG,char_data/I/DSC02590.JPG_4.jpg,6930,480,640,63,32,95,122,232,True,20
I,105,kaist_dataset/English/Digital_Camera/(E.S)C-outdoor1/DSC02590.JPG,char_data/I/DSC02590.JPG_5.jpg,3885,480,640,37,387,424,128,233,True,20
I,67,kaist_dataset/English/Digital_Camera/(E.S)C-outdoor1/DSC02619.JPG,char_data/I/DSC02619.JPG_2.jpg,1608,480,640,24,157,181,219,286,True,20
I,88,kaist_dataset/English/Digital_Camera/(E.S)C-outdoor2/DSC02984.JPG,char_data/I/DSC02984.JPG_2.jpg,3608,480,640,41,347,388,100,188,True,20
I,77,kaist_dataset/English/Digital_Camera/(E.S)C-outdoor2/DSC02993.JPG,char_data/I/DSC02993.JPG_2.jpg,1463,480,640,19,455,474,225,302,True,20
I,66,kaist_dataset/English/Digital_Camera/(E.S)C-outdoor2/DSC03012.JPG,char_data/I/DSC03012.JPG_2.jpg,1188,480,640,18,521,539,214,280,True,20
I,69,kaist_dataset/English/Digital_Camera/(E.S)C-outdoor2/DSC03025.JPG,char_data/I/DSC03025.JPG_2.jpg,1173,480,640,17,325,342,127,196,True,20
I,67,kaist_dataset/English/Digital_Camera/(E.S)C-outdoor2/DSC03191.JPG,char_data/I/DSC03191.JPG_2.jpg,1541,480,640,23,384,407,136,203,True,20
I,121,kaist_dataset/English/Digital_Camera/(E.S)C-outdoor2/DSC03197.JPG,char_data/I/DSC03197.JPG_5.jpg,4477,480,640,37,351,388,84,205,True,20
I,45,kaist_dataset/English/Digital_Camera/(E.S)C-outdoor2/DSC03203.JPG,char_data/I/DSC03203.JPG_5.jpg,675,480,640,15,105,120,313,358,True,20
I,76,kaist_dataset/English/Digital_Camera/(E.S)C-outdoor2/DSC03208.JPG,char_data/I/DSC03208.JPG_4.jpg,4484,480,640,59,550,609,187,263,True,20
I,73,kaist_dataset/English/Digital_Camera/(E.S)C-outdoor2/DSC03225.JPG,char_data/I/DSC03225.JPG_4.jpg,2044,480,640,28,213,241,46,119,True,20
I,71,kaist_dataset/English/Digital_Camera/(E.S)C-outdoor2/DSC03413.JPG,char_data/I/DSC03413.JPG_6.jpg,1420,480,640,20,95,115,188,259,True,20
I,79,kaist_dataset/English/Digital_Camera/(E.S)C-outdoor2/DSC03413.JPG,char_data/I/DSC03413.JPG_7.jpg,2054,480,640,26,168,194,183,262,True,20
I,72,kaist_dataset/English/Digital_Camera/(E.S)C-outdoor2/DSC03413.JPG,char_data/I/DSC03413.JPG_8.jpg,1944,480,640,27,180,207,110,182,True,20
I,79,kaist_dataset/English/Digital_Camera/(E.S)C-outdoor2/DSC03432.JPG,char_data/I/DSC03432.JPG_4.jpg,2686,480,640,34,55,89,360,439,True,20
I,84,kaist_dataset/English/Digital_Camera/(E.S)C-outdoor2/DSC03432.JPG,char_data/I/DSC03432.JPG_5.jpg,2016,480,640,24,459,483,360,444,True,20
I,49,kaist_dataset/English/Digital_Camera/(E.S)C-outdoor2/DSC03575.JPG,char_data/I/DSC03575.JPG_2.jpg,441,480,640,9,326,335,175,224,True,20
I,53,kaist_dataset/English/Digital_Camera/(E.S)C-outdoor2/DSC03650.JPG,char_data/I/DSC03650.JPG_4.jpg,954,480,640,18,313,331,209,262,True,20
I,48,kaist_dataset/English/Digital_Camera/(E.S)C-outdoor2/DSC03650.JPG,char_data/I/DSC03650.JPG_5.jpg,864,480,640,18,436,454,214,262,True,20
I,77,kaist_dataset/English/Digital_Camera/(E.S)C-outdoor2/DSC03705.JPG,char_data/I/DSC03705.JPG_4.jpg,1848,480,640,24,320,344,198,275,True,20
I,52,kaist_dataset/English/Digital_Camera/(E.S)C-outdoor2/DSC03705.JPG,char_data/I/DSC03705.JPG_5.jpg,884,480,640,17,204,221,313,365,True,20
I,68,kaist_dataset/English/Digital_Camera/(E.S)C-outdoor2/DSC03759.JPG,char_data/I/DSC03759.JPG_2.jpg,4488,480,640,66,147,213,112,180,True,20
I,61,kaist_dataset/English/Digital_Camera/(E.S)C-outdoor2/DSC04080.JPG,char_data/I/DSC04080.JPG_2.jpg,1403,480,640,23,276,299,299,360,True,20
I,75,kaist_dataset/English/Digital_Camera/(E.S)C-outdoor2/DSC04087.JPG,char_data/I/DSC04087.JPG_4.jpg,1650,480,640,22,261,283,120,195,True,20
I,61,kaist_dataset/English/Digital_Camera/(E.S)C-outdoor2/DSC04087.JPG,char_data/I/DSC04087.JPG_5.jpg,1586,480,640,26,446,472,133,194,True,20
I,57,kaist_dataset/English/Digital_Camera/(E.S)C-outdoor2/DSC04120.JPG,char_data/I/DSC04120.JPG_2.jpg,1140,480,640,20,338,358,145,202,True,20
I,83,kaist_dataset/English/Digital_Camera/(E.S)C-outdoor2/DSC04131.JPG,char_data/I/DSC04131.JPG_2.jpg,3818,480,640,46,286,332,127,210,True,20
I,130,kaist_dataset/English/Digital_Camera/(E.S)C-outdoor2/DSC04163.JPG,char_data/I/DSC04163.JPG_4.jpg,9490,480,640,73,230,303,112,242,True,20
I,66,kaist_dataset/English/Digital_Camera/(E.S)C-outdoor2/DSC04313.JPG,char_data/I/DSC04313.JPG_4.jpg,1518,480,640,23,118,141,112,178,True,20
I,66,kaist_dataset/English/Digital_Camera/(E.S)C-outdoor2/DSC04313.JPG,char_data/I/DSC04313.JPG_5.jpg,1716,480,640,26,355,381,115,181,True,20
I,60,kaist_dataset/English/Digital_Camera/(E.S)C-outdoor2/IMG_2481.JPG,char_data/I/IMG_2481.JPG_2.jpg,1200,480,640,20,354,374,255,315,True,20
I,51,kaist_dataset/English/Digital_Camera/(E.S)C-outdoor3/DSC02690.JPG,char_data/I/DSC02690.JPG_4.jpg,1326,480,640,26,372,398,162,213,True,20
I,54,kaist_dataset/English/Digital_Camera/(E.S)C-outdoor3/DSC02690.JPG,char_data/I/DSC02690.JPG_5.jpg,1782,480,640,33,378,411,212,266,True,20
I,80,kaist_dataset/English/Digital_Camera/(E.S)C-outdoor3/P1010138.JPG,char_data/I/P1010138.JPG_2.jpg,3520,480,640,44,442,486,74,154,True,20
I,61,kaist_dataset/English/Digital_Camera/(E.S)C-outdoor3/크기변환_%C8%AD%C0%CC%C6%AE%C4%FE%C6%AE%B0%A3%C6%C7_%BA%B9%BB%E7_1-bona0007.jpg,char_data/I/크기변환_%C8%AD%C0%CC%C6%AE%C4%FE%C6%AE%B0%A3%C6%C7_%BA%B9%BB%E7_1-bona0007.jpg_4.jpg,1952,480,640,32,380,412,199,260,True,20
I,65,kaist_dataset/English/Digital_Camera/(E.S)C-outdoor3/크기변환_%C8%AD%C0%CC%C6%AE%C4%FE%C6%AE%B0%A3%C6%C7_%BA%B9%BB%E7_1-bona0007.jpg,char_data/I/크기변환_%C8%AD%C0%CC%C6%AE%C4%FE%C6%AE%B0%A3%C6%C7_%BA%B9%BB%E7_1-bona0007.jpg_5.jpg,2080,480,640,32,427,459,277,342,True,20
I,67,kaist_dataset/English/Digital_Camera/(E.S)C-outdoor3/크기변환_P1010028.JPG,char_data/I/크기변환_P1010028.JPG_4.jpg,1876,480,640,28,77,105,165,232,True,20
I,70,kaist_dataset/English/Digital_Camera/(E.S)C-outdoor3/크기변환_P1010028.JPG,char_data/I/크기변환_P1010028.JPG_5.jpg,1260,480,640,18,432,450,171,241,True,20
I,49,kaist_dataset/English/Digital_Camera/(E.S)C-outdoor3/크기변환_P1010076.JPG,char_data/I/크기변환_P1010076.JPG_4.jpg,882,480,640,18,285,303,125,174,True,20
I,101,kaist_dataset/English/Digital_Camera/(E.S)D-indoor/080119-0009.jpg,char_data/I/080119-0009.jpg_16.jpg,3232,1200,1600,32,752,784,560,661,True,20
I,94,kaist_dataset/English/Digital_Camera/(E.S)D-indoor/080119-0009.jpg,char_data/I/080119-0009.jpg_17.jpg,3478,1200,1600,37,1012,1049,581,675,True,20
I,93,kaist_dataset/English/Digital_Camera/(E.S)D-indoor/DSC02850.JPG,char_data/I/DSC02850.JPG_6.jpg,3162,480,640,34,168,202,150,243,True,20
I,87,kaist_dataset/English/Digital_Camera/(E.S)D-indoor/DSC02850.JPG,char_data/I/DSC02850.JPG_7.jpg,2349,480,640,27,320,347,152,239,True,20
I,63,kaist_dataset/English/Digital_Camera/(E.S)D-indoor/DSC02850.JPG,char_data/I/DSC02850.JPG_8.jpg,1449,480,640,23,452,475,244,307,True,20
I,59,kaist_dataset/English/Digital_Camera/(E.S)D-indoor/DSC03071.JPG,char_data/I/DSC03071.JPG_2.jpg,1003,480,640,17,276,293,219,278,True,20
I,74,kaist_dataset/English/Digital_Camera/(E.S)D-indoor/DSC03085.JPG,char_data/I/DSC03085.JPG_4.jpg,2072,480,640,28,112,140,358,432,True,20
I,107,kaist_dataset/English/Digital_Camera/(E.S)D-indoor/DSC03366.JPG,char_data/I/DSC03366.JPG_2.jpg,3959,480,640,37,361,398,343,450,True,20
I,59,kaist_dataset/English/Digital_Camera/(E.S)D-indoor/DSC03395.JPG,char_data/I/DSC03395.JPG_2.jpg,1416,480,640,24,125,149,408,467,True,20
I,57,kaist_dataset/English/Digital_Camera/(E.S)D-indoor/DSC03467.JPG,char_data/I/DSC03467.JPG_2.jpg,969,480,640,17,193,210,147,204,True,20
I,51,kaist_dataset/English/Digital_Camera/(E.S)D-indoor/DSC03532.JPG,char_data/I/DSC03532.JPG_10.jpg,918,480,640,18,220,238,425,476,True,20
I,34,kaist_dataset/English/Digital_Camera/(E.S)D-indoor/DSC03532.JPG,char_data/I/DSC03532.JPG_11.jpg,510,480,640,15,19,34,370,404,True,20
I,60,kaist_dataset/English/Digital_Camera/(E.S)D-indoor/DSC03881.JPG,char_data/I/DSC03881.JPG_2.jpg,1260,480,640,21,441,462,297,357,True,20
I,69,kaist_dataset/English/Digital_Camera/(E.S)D-indoor/DSC03887.JPG,char_data/I/DSC03887.JPG_2.jpg,1311,480,640,19,440,459,164,233,True,20
I,39,kaist_dataset/English/Digital_Camera/(E.S)D-indoor/DSC03901.JPG,char_data/I/DSC03901.JPG_4.jpg,468,480,640,12,285,297,258,297,True,20
I,61,kaist_dataset/English/Digital_Camera/(E.S)D-indoor/DSC03901.JPG,char_data/I/DSC03901.JPG_5.jpg,1464,480,640,24,486,510,167,228,True,20
I,56,kaist_dataset/English/Digital_Camera/(E.S)D-indoor/DSC03918.JPG,char_data/I/DSC03918.JPG_7.jpg,952,480,640,17,248,265,408,464,True,20
I,54,kaist_dataset/English/Digital_Camera/(E.S)D-indoor/DSC03918.JPG,char_data/I/DSC03918.JPG_8.jpg,648,480,640,12,297,309,406,460,True,20
I,33,kaist_dataset/English/Digital_Camera/(E.S)D-indoor/DSC03935.JPG,char_data/I/DSC03935.JPG_2.jpg,297,480,640,9,271,280,45,78,True,20
I,71,kaist_dataset/English/Digital_Camera/(E.S)D-indoor/DSC03941.JPG,char_data/I/DSC03941.JPG_4.jpg,1633,480,640,23,263,286,226,297,True,20
I,66,kaist_dataset/English/Digital_Camera/(E.S)D-indoor/DSC03941.JPG,char_data/I/DSC03941.JPG_5.jpg,1584,480,640,24,316,340,235,301,True,20
I,77,kaist_dataset/English/Digital_Camera/(E.S)D-indoor/DSC03943.JPG,char_data/I/DSC03943.JPG_2.jpg,2464,480,640,32,153,185,210,287,True,20
I,68,kaist_dataset/English/Digital_Camera/(E.S)D-indoor/DSC03947.JPG,char_data/I/DSC03947.JPG_4.jpg,1972,480,640,29,340,369,182,250,True,20
I,114,kaist_dataset/English/Digital_Camera/(E.S)D-indoor/DSC04023.JPG,char_data/I/DSC04023.JPG_4.jpg,5472,480,640,48,136,184,176,290,True,20
I,24,kaist_dataset/English/Digital_Camera/(E.S)D-indoor/z.jpg,char_data/I/z.jpg_2.jpg,216,240,320,9,159,168,74,98,True,20
I,26,kaist_dataset/English/Digital_Camera/(E.S)E-night/111.jpg,char_data/I/111.jpg_7.jpg,234,480,640,9,251,260,281,307,True,20
I,20,kaist_dataset/English/Digital_Camera/(E.S)E-night/111.jpg,char_data/I/111.jpg_8.jpg,120,480,640,6,303,309,286,306,True,20
I,110,kaist_dataset/English/Digital_Camera/(E.S)E-night/DSC02606.JPG,char_data/I/DSC02606.JPG_2.jpg,5720,480,640,52,170,222,199,309,True,20
I,46,kaist_dataset/English/Digital_Camera/(E.S)E-night/DSC02610.JPG,char_data/I/DSC02610.JPG_2.jpg,1472,480,640,32,43,75,274,320,True,20
I,89,kaist_dataset/English/Digital_Camera/(E.S)E-night/DSC02674.JPG,char_data/I/DSC02674.JPG_2.jpg,3204,480,640,36,491,527,199,288,True,20
I,140,kaist_dataset/English/Digital_Camera/(E.S)E-night/DSC03003.JPG,char_data/I/DSC03003.JPG_2.jpg,13020,480,640,93,295,388,159,299,True,20
I,107,kaist_dataset/English/Digital_Camera/(E.S)E-night/크기변환_%BA%F7%BD%BA%BD%C5%B8%DE%B4%BA_01_tjtjdska2008.jpg,char_data/I/크기변환_%BA%F7%BD%BA%BD%C5%B8%DE%B4%BA_01_tjtjdska2008.jpg_4.jpg,5243,480,640,49,262,311,154,261,True,20
I,27,kaist_dataset/English/Digital_Camera/(E.S)E-night/크기변환_%BA%F7%BD%BA%BD%C5%B8%DE%B4%BA_01_tjtjdska2008.jpg,char_data/I/크기변환_%BA%F7%BD%BA%BD%C5%B8%DE%B4%BA_01_tjtjdska2008.jpg_5.jpg,351,480,640,13,263,276,274,301,True,20
I,105,kaist_dataset/English/Digital_Camera/(E.S)F-others/080116-0058.jpg,char_data/I/080116-0058.jpg_2.jpg,945,1200,1600,9,973,982,630,735,True,20
I,146,kaist_dataset/English/Digital_Camera/(E.S)F-others/080116-0060.jpg,char_data/I/080116-0060.jpg_2.jpg,8176,1200,1600,56,918,974,406,552,True,20
I,23,kaist_dataset/English/Digital_Camera/(E.S)F-others/080119-0007.jpg,char_data/I/080119-0007.jpg_15.jpg,1265,1200,1600,55,1246,1301,975,998,True,20
I,27,kaist_dataset/English/Digital_Camera/(E.S)F-others/080119-0007.jpg,char_data/I/080119-0007.jpg_16.jpg,1377,1200,1600,51,1210,1261,757,784,True,20
I,47,kaist_dataset/English/Digital_Camera/(E.S)F-others/DSC02884.JPG,char_data/I/DSC02884.JPG_2.jpg,1175,480,640,25,208,233,90,137,True,20
I,58,kaist_dataset/English/Digital_Camera/(E.S)F-others/크기변환_%B0%A3%C6%C77_m_starfirm.jpg,char_data/I/크기변환_%B0%A3%C6%C77_m_starfirm.jpg_2.jpg,1218,480,640,21,459,480,145,203,True,20
I,100,kaist_dataset/English/Mobile_Phone/(E.M)B-indoor/P090903004.jpg,char_data/I/P090903004.jpg_2.jpg,4500,480,640,45,23,68,230,330,True,20
I,64,kaist_dataset/English/Mobile_Phone/(E.M)B-indoor/P090903008.jpg,char_data/I/P090903008.jpg_5.jpg,2304,480,640,36,259,295,31,95,True,20
I,132,kaist_dataset/English/Mobile_Phone/(E.M)C-bookCover/P090831037.jpg,char_data/I/P090831037.jpg_2.jpg,9372,480,640,71,120,191,194,326,True,20
I,97,kaist_dataset/English/Mobile_Phone/(E.M)C-bookCover/P090831039.jpg,char_data/I/P090831039.jpg_4.jpg,4559,480,640,47,8,55,108,205,True,20
I,64,kaist_dataset/English/Mobile_Phone/(E.M)C-bookCover/P090831075.jpg,char_data/I/P090831075.jpg_6.jpg,1152,480,640,18,374,392,161,225,True,20
I,65,kaist_dataset/English/Mobile_Phone/(E.M)C-bookCover/P090831075.jpg,char_data/I/P090831075.jpg_7.jpg,1560,480,640,24,434,458,279,344,True,20
I,60,kaist_dataset/English/Mobile_Phone/(E.M)C-bookCover/P090831075.jpg,char_data/I/P090831075.jpg_8.jpg,1260,480,640,21,507,528,280,340,True,20
I,48,kaist_dataset/English/Mobile_Phone/(E.M)C-bookCover/P090903041.jpg,char_data/I/P090903041.jpg_2.jpg,1392,480,640,29,464,493,32,80,True,20
I,63,kaist_dataset/English/Mobile_Phone/(E.M)C-bookCover/P090903055.jpg,char_data/I/P090903055.jpg_2.jpg,1449,480,640,23,493,516,174,237,True,20
I,80,kaist_dataset/English/Mobile_Phone/(E.M)C-bookCover/P090903056.jpg,char_data/I/P090903056.jpg_2.jpg,3040,480,640,38,491,529,302,382,True,20
I,65,kaist_dataset/English/Mobile_Phone/(E.M)C-bookCover/P090903071.jpg,char_data/I/P090903071.jpg_2.jpg,1755,480,640,27,394,421,226,291,True,20
I,93,kaist_dataset/English/Mobile_Phone/(E.M)C-bookCover/P090905007.jpg,char_data/I/P090905007.jpg_6.jpg,3813,480,640,41,151,192,35,128,True,20
I,91,kaist_dataset/English/Mobile_Phone/(E.M)C-bookCover/P090905007.jpg,char_data/I/P090905007.jpg_7.jpg,4095,480,640,45,29,74,270,361,True,20
I,77,kaist_dataset/English/Mobile_Phone/(E.M)C-bookCover/P090905007.jpg,char_data/I/P090905007.jpg_8.jpg,3003,480,640,39,408,447,294,371,True,20
I,18,kaist_dataset/Korean/Digital_Camera/G-others/5.jpg,char_data/I/5.jpg_4.jpg,144,553,798,8,85,93,37,55,True,20
I,18,kaist_dataset/Korean/Digital_Camera/G-others/5.jpg,char_data/I/5.jpg_5.jpg,108,553,798,6,132,138,39,57,True,20
I,25,kaist_dataset/Korean/Digital_Camera/indoor1/136.JPG,char_data/I/136.JPG_2.jpg,225,480,640,9,314,323,287,312,True,20
I,17,kaist_dataset/Korean/Digital_Camera/indoor1/146.JPG,char_data/I/146.JPG_2.jpg,85,480,640,5,360,365,271,288,True,20
I,33,kaist_dataset/Korean/Digital_Camera/indoor1/2007-12-08-day-139.jpg,char_data/I/2007-12-08-day-139.jpg_2.jpg,330,1200,1600,10,586,596,354,387,True,20
I,50,kaist_dataset/Korean/Digital_Camera/indoor1/DSC03092.JPG,char_data/I/DSC03092.JPG_2.jpg,1150,480,640,23,13,36,78,128,True,20
I,22,kaist_dataset/Korean/Digital_Camera/outdoor2/2007-12-08-day-094.jpg,char_data/I/2007-12-08-day-094.jpg_2.jpg,198,1600,1200,9,698,707,1423,1445,True,20
I,28,kaist_dataset/Korean/Digital_Camera/outdoor2/2007-12-08-day-101.jpg,char_data/I/2007-12-08-day-101.jpg_10.jpg,168,1200,1600,6,142,148,1058,1086,True,20
I,28,kaist_dataset/Korean/Digital_Camera/outdoor2/2007-12-08-day-101.jpg,char_data/I/2007-12-08-day-101.jpg_11.jpg,168,1200,1600,6,255,261,1054,1082,True,20
I,68,kaist_dataset/Korean/Digital_Camera/outdoor5/DSC03869.JPG,char_data/I/DSC03869.JPG_2.jpg,2448,480,640,36,128,164,265,333,True,20
I,32,kaist_dataset/Mixed/Digital_Camera/(C.S)A-shadow/DSC02568.JPG,char_data/I/DSC02568.JPG_4.jpg,480,480,640,15,154,169,145,177,True,20
I,108,kaist_dataset/Mixed/Digital_Camera/(C.S)A-shadow/DSC02609.JPG,char_data/I/DSC02609.JPG_8.jpg,4536,480,640,42,230,272,199,307,True,20
I,36,kaist_dataset/Mixed/Digital_Camera/(C.S)A-shadow/DSC02609.JPG,char_data/I/DSC02609.JPG_9.jpg,432,480,640,12,187,199,318,354,True,20
I,27,kaist_dataset/Mixed/Digital_Camera/(C.S)A-shadow/DSC02624.JPG,char_data/I/DSC02624.JPG_4.jpg,378,480,640,14,242,256,401,428,True,20
I,61,kaist_dataset/Mixed/Digital_Camera/(C.S)A-shadow/DSC03522.JPG,char_data/I/DSC03522.JPG_2.jpg,1281,480,640,21,281,302,22,83,True,20
I,27,kaist_dataset/Mixed/Digital_Camera/(C.S)C-outdoor1/003.JPG,char_data/I/003.JPG_17.jpg,270,480,640,10,127,137,261,288,True,20
I,26,kaist_dataset/Mixed/Digital_Camera/(C.S)C-outdoor1/003.JPG,char_data/I/003.JPG_19.jpg,182,480,640,7,463,470,252,278,True,20
I,28,kaist_dataset/Mixed/Digital_Camera/(C.S)C-outdoor1/054.JPG,char_data/I/054.JPG_2.jpg,364,480,640,13,475,488,274,302,True,20
I,55,kaist_dataset/Mixed/Digital_Camera/(C.S)C-outdoor1/080119-0006.jpg,char_data/I/080119-0006.jpg_4.jpg,2200,1200,1600,40,959,999,735,790,True,20
I,232,kaist_dataset/Mixed/Digital_Camera/(C.S)C-outdoor1/080119-0006.jpg,char_data/I/080119-0006.jpg_5.jpg,16008,1200,1600,69,562,631,496,728,True,20
I,178,kaist_dataset/Mixed/Digital_Camera/(C.S)C-outdoor1/080119-0017.jpg,char_data/I/080119-0017.jpg_4.jpg,8544,1200,1600,48,131,179,565,743,True,20
I,151,kaist_dataset/Mixed/Digital_Camera/(C.S)C-outdoor1/080119-0017.jpg,char_data/I/080119-0017.jpg_5.jpg,5134,1200,1600,34,1093,1127,559,710,True,20
I,135,kaist_dataset/Mixed/Digital_Camera/(C.S)C-outdoor1/113.JPG,char_data/I/113.JPG_5.jpg,2700,480,640,20,459,479,80,215,True,20
I,30,kaist_dataset/Mixed/Digital_Camera/(C.S)C-outdoor1/114.jpg,char_data/I/114.jpg_2.jpg,660,480,640,22,260,282,318,348,True,20
I,28,kaist_dataset/Mixed/Digital_Camera/(C.S)C-outdoor1/135.JPG,char_data/I/135.JPG_4.jpg,224,480,640,8,253,261,171,199,True,20
I,18,kaist_dataset/Mixed/Digital_Camera/(C.S)C-outdoor1/135.JPG,char_data/I/135.JPG_5.jpg,162,480,640,9,334,343,178,196,True,20
I,19,kaist_dataset/Mixed/Digital_Camera/(C.S)C-outdoor1/2.JPG,char_data/I/2.JPG_2.jpg,76,576,768,4,582,586,373,392,True,20
I,43,kaist_dataset/Mixed/Digital_Camera/(C.S)C-outdoor1/2007-12-08-day-130.jpg,char_data/I/2007-12-08-day-130.jpg_2.jpg,1032,1200,1600,24,979,1003,709,752,True,20
I,31,kaist_dataset/Mixed/Digital_Camera/(C.S)C-outdoor1/2007-12-09-day-exterior-051.jpg,char_data/I/2007-12-09-day-exterior-051.jpg_2.jpg,279,1200,1600,9,538,547,678,709,True,20
I,24,kaist_dataset/Mixed/Digital_Camera/(C.S)C-outdoor1/DSC02240.JPG,char_data/I/DSC02240.JPG_2.jpg,528,480,640,22,205,227,288,312,True,20
I,70,kaist_dataset/Mixed/Digital_Camera/(C.S)C-outdoor1/DSC02325.JPG,char_data/I/DSC02325.JPG_4.jpg,2660,480,640,38,271,309,181,251,True,20
I,52,kaist_dataset/Mixed/Digital_Camera/(C.S)C-outdoor1/P1010009.JPG,char_data/I/P1010009.JPG_2.jpg,1144,480,640,22,379,401,189,241,True,20
I,62,kaist_dataset/Mixed/Digital_Camera/(C.S)C-outdoor2/DSC02365.JPG,char_data/I/DSC02365.JPG_2.jpg,682,480,640,11,280,291,91,153,True,20
I,82,kaist_dataset/Mixed/Digital_Camera/(C.S)C-outdoor2/DSC02385.JPG,char_data/I/DSC02385.JPG_4.jpg,3362,480,640,41,281,322,182,264,True,20
I,38,kaist_dataset/Mixed/Digital_Camera/(C.S)C-outdoor2/DSC02419.JPG,char_data/I/DSC02419.JPG_2.jpg,418,480,640,11,83,94,202,240,True,20
I,62,kaist_dataset/Mixed/Digital_Camera/(C.S)C-outdoor2/DSC02439.JPG,char_data/I/DSC02439.JPG_4.jpg,1364,480,640,22,222,244,134,196,True,20
I,25,kaist_dataset/Mixed/Digital_Camera/(C.S)C-outdoor2/DSC02477.JPG,char_data/I/DSC02477.JPG_2.jpg,150,480,640,6,129,135,158,183,True,20
I,25,kaist_dataset/Mixed/Digital_Camera/(C.S)C-outdoor2/DSC02555.JPG,char_data/I/DSC02555.JPG_2.jpg,175,480,640,7,144,151,152,177,True,20
I,37,kaist_dataset/Mixed/Digital_Camera/(C.S)C-outdoor2/DSC02557.JPG,char_data/I/DSC02557.JPG_2.jpg,518,480,640,14,78,92,224,261,True,20
I,32,kaist_dataset/Mixed/Digital_Camera/(C.S)C-outdoor2/DSC02568.JPG,char_data/I/DSC02568.JPG_5.jpg,480,480,640,15,154,169,145,177,True,20
I,27,kaist_dataset/Mixed/Digital_Camera/(C.S)C-outdoor2/DSC02624.JPG,char_data/I/DSC02624.JPG_5.jpg,378,480,640,14,242,256,401,428,True,20
I,46,kaist_dataset/Mixed/Digital_Camera/(C.S)C-outdoor2/DSC02872.JPG,char_data/I/DSC02872.JPG_2.jpg,460,480,640,10,337,347,218,264,True,20
I,54,kaist_dataset/Mixed/Digital_Camera/(C.S)C-outdoor2/DSC02924.JPG,char_data/I/DSC02924.JPG_2.jpg,1188,480,640,22,338,360,316,370,True,20
I,42,kaist_dataset/Mixed/Digital_Camera/(C.S)C-outdoor2/DSC02936.JPG,char_data/I/DSC02936.JPG_9.jpg,840,480,640,20,144,164,74,116,True,20
I,48,kaist_dataset/Mixed/Digital_Camera/(C.S)C-outdoor3/DSC02964.JPG,char_data/I/DSC02964.JPG_2.jpg,816,480,640,17,577,594,103,151,True,20
I,33,kaist_dataset/Mixed/Digital_Camera/(C.S)C-outdoor3/DSC02986.JPG,char_data/I/DSC02986.JPG_4.jpg,594,480,640,18,446,464,283,316,True,20
I,38,kaist_dataset/Mixed/Digital_Camera/(C.S)C-outdoor3/DSC02986.JPG,char_data/I/DSC02986.JPG_5.jpg,570,480,640,15,569,584,280,318,True,20
I,38,kaist_dataset/Mixed/Digital_Camera/(C.S)C-outdoor3/DSC02989.JPG,char_data/I/DSC02989.JPG_12.jpg,418,480,640,11,69,80,167,205,True,20
I,31,kaist_dataset/Mixed/Digital_Camera/(C.S)C-outdoor3/DSC02989.JPG,char_data/I/DSC02989.JPG_13.jpg,372,480,640,12,98,110,173,204,True,20
I,41,kaist_dataset/Mixed/Digital_Camera/(C.S)C-outdoor3/DSC02989.JPG,char_data/I/DSC02989.JPG_16.jpg,943,480,640,23,168,191,260,301,True,20
I,44,kaist_dataset/Mixed/Digital_Camera/(C.S)C-outdoor3/DSC02989.JPG,char_data/I/DSC02989.JPG_17.jpg,880,480,640,20,220,240,261,305,True,20
I,163,kaist_dataset/Mixed/Digital_Camera/(C.S)C-outdoor3/DSC03006.JPG,char_data/I/DSC03006.JPG_2.jpg,7498,480,640,46,109,155,96,259,True,20
I,38,kaist_dataset/Mixed/Digital_Camera/(C.S)C-outdoor3/DSC03020.JPG,char_data/I/DSC03020.JPG_2.jpg,494,480,640,13,390,403,261,299,True,20
I,25,kaist_dataset/Mixed/Digital_Camera/(C.S)C-outdoor3/DSC03033.JPG,char_data/I/DSC03033.JPG_2.jpg,175,480,640,7,91,98,130,155,True,20
I,51,kaist_dataset/Mixed/Digital_Camera/(C.S)C-outdoor3/DSC03061.JPG,char_data/I/DSC03061.JPG_2.jpg,1224,480,640,24,295,319,149,200,True,20
I,78,kaist_dataset/Mixed/Digital_Camera/(C.S)C-outdoor3/DSC03164.JPG,char_data/I/DSC03164.JPG_2.jpg,2964,480,640,38,361,399,81,159,True,20
I,132,kaist_dataset/Mixed/Digital_Camera/(C.S)C-outdoor3/DSC03196.JPG,char_data/I/DSC03196.JPG_2.jpg,9768,480,640,74,215,289,261,393,True,20
I,34,kaist_dataset/Mixed/Digital_Camera/(C.S)C-outdoor3/DSC03242.JPG,char_data/I/DSC03242.JPG_2.jpg,510,480,640,15,354,369,315,349,True,20
I,99,kaist_dataset/Mixed/Digital_Camera/(C.S)C-outdoor3/DSC03247.JPG,char_data/I/DSC03247.JPG_2.jpg,2970,480,640,30,195,225,133,232,True,20
I,24,kaist_dataset/Mixed/Digital_Camera/(C.S)C-outdoor3/DSC03250.JPG,char_data/I/DSC03250.JPG_2.jpg,288,480,640,12,563,575,378,402,True,20
I,41,kaist_dataset/Mixed/Digital_Camera/(C.S)C-outdoor3/DSC03254.JPG,char_data/I/DSC03254.JPG_2.jpg,902,480,640,22,495,517,208,249,True,20
I,26,kaist_dataset/Mixed/Digital_Camera/(C.S)C-outdoor3/DSC03255.JPG,char_data/I/DSC03255.JPG_2.jpg,208,480,640,8,566,574,176,202,True,20
I,128,kaist_dataset/Mixed/Digital_Camera/(C.S)C-outdoor3/DSC03259.JPG,char_data/I/DSC03259.JPG_2.jpg,5760,480,640,45,351,396,69,197,True,20
I,63,kaist_dataset/Mixed/Digital_Camera/(C.S)C-outdoor3/DSC03306.JPG,char_data/I/DSC03306.JPG_4.jpg,1008,480,640,16,231,247,392,455,True,20
I,62,kaist_dataset/Mixed/Digital_Camera/(C.S)C-outdoor3/DSC03306.JPG,char_data/I/DSC03306.JPG_5.jpg,930,480,640,15,492,507,392,454,True,20
I,26,kaist_dataset/Mixed/Digital_Camera/(C.S)C-outdoor3/DSC03329.JPG,char_data/I/DSC03329.JPG_2.jpg,312,480,640,12,591,603,451,477,True,20
I,37,kaist_dataset/Mixed/Digital_Camera/(C.S)C-outdoor3/DSC03330.JPG,char_data/I/DSC03330.JPG_2.jpg,481,480,640,13,256,269,400,437,True,20
I,34,kaist_dataset/Mixed/Digital_Camera/(C.S)C-outdoor3/DSC03331.JPG,char_data/I/DSC03331.JPG_2.jpg,374,480,640,11,246,257,388,422,True,20
I,74,kaist_dataset/Mixed/Digital_Camera/(C.S)C-outdoor4/DSC03439.JPG,char_data/I/DSC03439.JPG_2.jpg,1850,480,640,25,488,513,323,397,True,20
I,90,kaist_dataset/Mixed/Digital_Camera/(C.S)C-outdoor4/DSC03534.JPG,char_data/I/DSC03534.JPG_2.jpg,1980,480,640,22,75,97,133,223,True,20
I,45,kaist_dataset/Mixed/Digital_Camera/(C.S)C-outdoor4/DSC03581.JPG,char_data/I/DSC03581.JPG_2.jpg,675,480,640,15,521,536,197,242,True,20
I,100,kaist_dataset/Mixed/Digital_Camera/(C.S)C-outdoor4/DSC03652.JPG,char_data/I/DSC03652.JPG_2.jpg,2600,480,640,26,151,177,173,273,True,20
I,54,kaist_dataset/Mixed/Digital_Camera/(C.S)C-outdoor4/DSC03678.JPG,char_data/I/DSC03678.JPG_2.jpg,1134,480,640,21,35,56,228,282,True,20
I,34,kaist_dataset/Mixed/Digital_Camera/(C.S)C-outdoor4/DSC03679.JPG,char_data/I/DSC03679.JPG_2.jpg,612,480,640,18,76,94,99,133,True,20
I,35,kaist_dataset/Mixed/Digital_Camera/(C.S)C-outdoor4/DSC03711.JPG,char_data/I/DSC03711.JPG_2.jpg,385,480,640,11,298,309,390,425,True,20
I,36,kaist_dataset/Mixed/Digital_Camera/(C.S)C-outdoor4/DSC03716.JPG,char_data/I/DSC03716.JPG_2.jpg,324,480,640,9,321,330,235,271,True,20
I,71,kaist_dataset/Mixed/Digital_Camera/(C.S)C-outdoor4/DSC03756.JPG,char_data/I/DSC03756.JPG_2.jpg,1917,480,640,27,125,152,384,455,True,20
I,79,kaist_dataset/Mixed/Digital_Camera/(C.S)C-outdoor5/DSC03822.JPG,char_data/I/DSC03822.JPG_2.jpg,2528,480,640,32,312,344,83,162,True,20
I,106,kaist_dataset/Mixed/Digital_Camera/(C.S)C-outdoor5/DSC03823.JPG,char_data/I/DSC03823.JPG_2.jpg,5088,480,640,48,192,240,73,179,True,20
I,35,kaist_dataset/Mixed/Digital_Camera/(C.S)C-outdoor5/DSC03829.JPG,char_data/I/DSC03829.JPG_2.jpg,245,480,640,7,278,285,174,209,True,20
I,47,kaist_dataset/Mixed/Digital_Camera/(C.S)C-outdoor5/DSC04015.JPG,char_data/I/DSC04015.JPG_4.jpg,1363,480,640,29,173,202,120,167,True,20
I,60,kaist_dataset/Mixed/Digital_Camera/(C.S)C-outdoor5/DSC04054.JPG,char_data/I/DSC04054.JPG_2.jpg,1800,480,640,30,102,132,63,123,True,20
I,38,kaist_dataset/Mixed/Digital_Camera/(C.S)C-outdoor5/DSC04056.JPG,char_data/I/DSC04056.JPG_4.jpg,304,480,640,8,99,107,275,313,True,20
I,38,kaist_dataset/Mixed/Digital_Camera/(C.S)C-outdoor5/DSC04056.JPG,char_data/I/DSC04056.JPG_5.jpg,532,480,640,14,133,147,278,316,False,20
I,58,kaist_dataset/Mixed/Digital_Camera/(C.S)C-outdoor5/DSC04059.JPG,char_data/I/DSC04059.JPG_2.jpg,1218,480,640,21,384,405,118,176,False,20
I,61,kaist_dataset/Mixed/Digital_Camera/(C.S)C-outdoor5/DSC04060.JPG,char_data/I/DSC04060.JPG_6.jpg,2257,480,640,37,153,190,96,157,False,20
I,56,kaist_dataset/Mixed/Digital_Camera/(C.S)C-outdoor5/DSC04060.JPG,char_data/I/DSC04060.JPG_7.jpg,1344,480,640,24,212,236,99,155,False,20
I,54,kaist_dataset/Mixed/Digital_Camera/(C.S)C-outdoor5/DSC04060.JPG,char_data/I/DSC04060.JPG_8.jpg,1026,480,640,19,475,494,96,150,False,20
I,40,kaist_dataset/Mixed/Digital_Camera/(C.S)C-outdoor5/DSC04098.JPG,char_data/I/DSC04098.JPG_2.jpg,920,480,640,23,367,390,71,111,False,20
I,52,kaist_dataset/Mixed/Digital_Camera/(C.S)C-outdoor5/DSC04119.JPG,char_data/I/DSC04119.JPG_2.jpg,936,480,640,18,418,436,128,180,False,20
I,50,kaist_dataset/Mixed/Digital_Camera/(C.S)C-outdoor5/DSC04305.JPG,char_data/I/DSC04305.JPG_2.jpg,600,480,640,12,395,407,81,131,False,20
I,31,kaist_dataset/Mixed/Digital_Camera/(C.S)C-outdoor5/DSC04314.JPG,char_data/I/DSC04314.JPG_4.jpg,527,480,640,17,284,301,170,201,False,20
I,38,kaist_dataset/Mixed/Digital_Camera/(C.S)C-outdoor5/DSC04314.JPG,char_data/I/DSC04314.JPG_5.jpg,646,480,640,17,432,449,169,207,False,20
I,44,kaist_dataset/Mixed/Digital_Camera/(C.S)C-outdoor5/DSC04323.JPG,char_data/I/DSC04323.JPG_7.jpg,748,480,640,17,397,414,200,244,False,20
I,42,kaist_dataset/Mixed/Digital_Camera/(C.S)C-outdoor5/DSC04338.JPG,char_data/I/DSC04338.JPG_6.jpg,630,480,640,15,17,32,193,235,False,20
I,38,kaist_dataset/Mixed/Digital_Camera/(C.S)C-outdoor5/DSC04338.JPG,char_data/I/DSC04338.JPG_7.jpg,380,480,640,10,445,455,198,236,False,20
I,30,kaist_dataset/Mixed/Digital_Camera/(C.S)C-outdoor5/DSC04360.JPG,char_data/I/DSC04360.JPG_2.jpg,210,480,640,7,119,126,344,374,False,20
I,24,kaist_dataset/Mixed/Digital_Camera/(C.S)C-outdoor5/P1010004.JPG,char_data/I/P1010004.JPG_2.jpg,1080,480,640,45,498,543,281,305,False,20
I,117,kaist_dataset/Mixed/Digital_Camera/(C.S)C-outdoor6/P1010054.JPG,char_data/I/P1010054.JPG_2.jpg,5148,480,640,44,48,92,98,215,False,20
I,29,kaist_dataset/Mixed/Digital_Camera/(C.S)C-outdoor6/P1010063.JPG,char_data/I/P1010063.JPG_6.jpg,174,480,640,6,356,362,383,412,False,20
I,24,kaist_dataset/Mixed/Digital_Camera/(C.S)C-outdoor6/P1010063.JPG,char_data/I/P1010063.JPG_7.jpg,216,480,640,9,391,400,365,389,False,20
I,54,kaist_dataset/Mixed/Digital_Camera/(C.S)C-outdoor6/P1010063.JPG,char_data/I/P1010063.JPG_8.jpg,2052,480,640,38,138,176,399,453,False,20
I,26,kaist_dataset/Mixed/Digital_Camera/(C.S)C-outdoor6/P1010088.JPG,char_data/I/P1010088.JPG_2.jpg,286,480,640,11,406,417,178,204,False,20
I,30,kaist_dataset/Mixed/Digital_Camera/(C.S)C-outdoor6/P1010090.JPG,char_data/I/P1010090.JPG_6.jpg,510,480,640,17,319,336,199,229,False,20
I,34,kaist_dataset/Mixed/Digital_Camera/(C.S)C-outdoor6/P1010090.JPG,char_data/I/P1010090.JPG_7.jpg,510,480,640,15,339,354,198,232,False,20
I,33,kaist_dataset/Mixed/Digital_Camera/(C.S)C-outdoor6/P1010090.JPG,char_data/I/P1010090.JPG_8.jpg,297,480,640,9,432,441,197,230,False,20
I,30,kaist_dataset/Mixed/Digital_Camera/(C.S)C-outdoor6/P1010095.JPG,char_data/I/P1010095.JPG_2.jpg,240,480,640,8,101,109,182,212,False,20
I,46,kaist_dataset/Mixed/Digital_Camera/(C.S)C-outdoor6/P1010132.JPG,char_data/I/P1010132.JPG_2.jpg,782,480,640,17,201,218,157,203,False,20
I,75,kaist_dataset/Mixed/Digital_Camera/(C.S)D-indoor1/DSC02714.JPG,char_data/I/DSC02714.JPG_2.jpg,2025,480,640,27,374,401,119,194,False,20
I,86,kaist_dataset/Mixed/Digital_Camera/(C.S)D-indoor1/DSC02732.JPG,char_data/I/DSC02732.JPG_2.jpg,3440,480,640,40,472,512,123,209,False,20
I,106,kaist_dataset/Mixed/Digital_Camera/(C.S)D-indoor1/DSC02739.JPG,char_data/I/DSC02739.JPG_2.jpg,4028,480,640,38,87,125,42,148,False,20
I,112,kaist_dataset/Mixed/Digital_Camera/(C.S)D-indoor1/DSC02840.JPG,char_data/I/DSC02840.JPG_2.jpg,4592,480,640,41,374,415,121,233,False,20
I,31,kaist_dataset/Mixed/Digital_Camera/(C.S)D-indoor1/DSC03096.JPG,char_data/I/DSC03096.JPG_13.jpg,403,480,640,13,454,467,423,454,False,20
I,35,kaist_dataset/Mixed/Digital_Camera/(C.S)D-indoor1/DSC03904.JPG,char_data/I/DSC03904.JPG_2.jpg,350,480,640,10,379,389,216,251,False,20
I,41,kaist_dataset/Mixed/Digital_Camera/(C.S)D-indoor1/DSC03980.JPG,char_data/I/DSC03980.JPG_4.jpg,533,480,640,13,500,513,146,187,False,20
I,44,kaist_dataset/Mixed/Digital_Camera/(C.S)D-indoor1/DSC03980.JPG,char_data/I/DSC03980.JPG_5.jpg,396,480,640,9,554,563,145,189,False,20
I,52,kaist_dataset/Mixed/Digital_Camera/(C.S)D-indoor1/DSC04009.JPG,char_data/I/DSC04009.JPG_2.jpg,1040,480,640,20,143,163,401,453,False,20
I,64,kaist_dataset/Mixed/Digital_Camera/(C.S)D-indoor1/DSC04019.JPG,char_data/I/DSC04019.JPG_2.jpg,1024,480,640,16,344,360,141,205,False,20
I,173,kaist_dataset/Mixed/Digital_Camera/(C.S)D-indoor1/DSC04223.JPG,char_data/I/DSC04223.JPG_2.jpg,6574,480,640,38,275,313,11,184,False,20
I,79,kaist_dataset/Mixed/Digital_Camera/(C.S)D-indoor2/DSC04442.JPG,char_data/I/DSC04442.JPG_2.jpg,1817,480,640,23,177,200,287,366,False,20
I,48,kaist_dataset/Mixed/Digital_Camera/(C.S)E-night/DSC02574.JPG,char_data/I/DSC02574.JPG_2.jpg,576,480,640,12,261,273,149,197,False,20
I,50,kaist_dataset/Mixed/Digital_Camera/(C.S)E-night/DSC02595.JPG,char_data/I/DSC02595.JPG_2.jpg,1550,480,640,31,178,209,357,407,False,20
I,166,kaist_dataset/Mixed/Digital_Camera/(C.S)E-night/DSC02602.JPG,char_data/I/DSC02602.JPG_2.jpg,8798,480,640,53,422,475,147,313,False,20
I,48,kaist_dataset/Mixed/Digital_Camera/(C.S)E-night/DSC02672.JPG,char_data/I/DSC02672.JPG_4.jpg,768,480,640,16,299,315,169,217,False,20
I,46,kaist_dataset/Mixed/Digital_Camera/(C.S)E-night/DSC02672.JPG,char_data/I/DSC02672.JPG_5.jpg,690,480,640,15,371,386,170,216,False,20
I,56,kaist_dataset/Mixed/Digital_Camera/(C.S)E-night/DSC03516.JPG,char_data/I/DSC03516.JPG_4.jpg,1232,480,640,22,349,371,214,270,False,20
I,51,kaist_dataset/Mixed/Digital_Camera/(C.S)E-night/DSC03517.JPG,char_data/I/DSC03517.JPG_2.jpg,612,480,640,12,179,191,84,135,False,20
I,49,kaist_dataset/Mixed/Digital_Camera/(C.S)E-night/사진9.jpg수정.jpg,char_data/I/사진9.jpg수정.jpg_2.jpg,980,480,680,20,303,323,201,250,False,20
I,28,kaist_dataset/Mixed/Digital_Camera/(C.S)F-others/097.jpg,char_data/I/097.jpg_2.jpg,336,480,640,12,274,286,164,192,False,20
I,60,kaist_dataset/Mixed/Digital_Camera/(C.S)F-others/2007-12-08-day-113.jpg,char_data/I/2007-12-08-day-113.jpg_2.jpg,1140,1200,1600,19,279,298,234,294,False,20
I,108,kaist_dataset/Mixed/Digital_Camera/(C.S)F-others/DSC02609.JPG,char_data/I/DSC02609.JPG_10.jpg,4536,480,640,42,230,272,199,307,False,20
I,36,kaist_dataset/Mixed/Digital_Camera/(C.S)F-others/DSC02609.JPG,char_data/I/DSC02609.JPG_11.jpg,432,480,640,12,187,199,318,354,False,20
I,74,kaist_dataset/Mixed/Mobile_Phone/(C.M)A-outdoor/P090903099.jpg,char_data/I/P090903099.jpg_2.jpg,1702,480,640,23,77,100,159,233,False,20
I,37,kaist_dataset/Mixed/Mobile_Phone/(C.M)B-indoor/P090831021.jpg,char_data/I/P090831021.jpg_8.jpg,333,480,640,9,283,292,44,81,False,20
I,45,kaist_dataset/Mixed/Mobile_Phone/(C.M)B-indoor/P090831021.jpg,char_data/I/P090831021.jpg_9.jpg,675,480,640,15,211,226,378,423,False,20
I,45,kaist_dataset/Mixed/Mobile_Phone/(C.M)B-indoor/P090831021.jpg,char_data/I/P090831021.jpg_10.jpg,675,480,640,15,330,345,374,419,False,20
I,48,kaist_dataset/Mixed/Mobile_Phone/(C.M)B-indoor/P090831021.jpg,char_data/I/P090831021.jpg_11.jpg,720,480,640,15,272,287,332,380,False,20
I,101,kaist_dataset/Mixed/Mobile_Phone/(C.M)C-bookCover/P090831136.jpg,char_data/I/P090831136.jpg_4.jpg,2626,480,640,26,302,328,225,326,False,20
I,102,kaist_dataset/Mixed/Mobile_Phone/(C.M)C-bookCover/P090831136.jpg,char_data/I/P090831136.jpg_5.jpg,4182,480,640,41,472,513,226,328,False,20
I,56,kaist_dataset/Mixed/Mobile_Phone/(C.M)C-bookCover/P090903092.jpg,char_data/I/P090903092.jpg_2.jpg,896,480,640,16,571,587,196,252,False,20
t,54,kaist_dataset/English/Digital_Camera/(E.S)A-shadow/DSC03075.JPG,char_data/t/DSC03075.JPG_4.jpg,810,480,640,15,350,365,347,401,True,44
t,49,kaist_dataset/English/Digital_Camera/(E.S)A-shadow/DSC03075.JPG,char_data/t/DSC03075.JPG_5.jpg,1078,480,640,22,433,455,348,397,True,44
t,52,kaist_dataset/English/Digital_Camera/(E.S)A-shadow/DSC03081.JPG,char_data/t/DSC03081.JPG_2.jpg,884,480,640,17,314,331,405,457,True,44
t,67,kaist_dataset/English/Digital_Camera/(E.S)A-shadow/DSC03084.JPG,char_data/t/DSC03084.JPG_4.jpg,1206,480,640,18,185,203,362,429,True,44
t,70,kaist_dataset/English/Digital_Camera/(E.S)A-shadow/DSC03084.JPG,char_data/t/DSC03084.JPG_5.jpg,1120,480,640,16,343,359,361,431,True,44
t,59,kaist_dataset/English/Digital_Camera/(E.S)A-shadow/P090912074.jpg,char_data/t/P090912074.jpg_2.jpg,2183,480,640,37,292,329,81,140,True,44
t,83,kaist_dataset/English/Digital_Camera/(E.S)B-light/DSC02980.JPG,char_data/t/DSC02980.JPG_2.jpg,3735,480,640,45,429,474,76,159,True,44
t,39,kaist_dataset/English/Digital_Camera/(E.S)B-light/크기변환_%B0%A3%C6%C74_fabdent.jpg,char_data/t/크기변환_%B0%A3%C6%C74_fabdent.jpg_2.jpg,741,480,640,19,374,393,247,286,True,44
t,35,kaist_dataset/English/Digital_Camera/(E.S)C-outdoor1/033.jpg,char_data/t/033.jpg_2.jpg,1155,232,354,33,221,254,118,153,True,44
t,22,kaist_dataset/English/Digital_Camera/(E.S)C-outdoor1/056.JPG,char_data/t/056.JPG_6.jpg,110,480,640,5,124,129,243,265,True,44
t,20,kaist_dataset/English/Digital_Camera/(E.S)C-outdoor1/056.JPG,char_data/t/056.JPG_7.jpg,120,480,640,6,309,315,244,264,True,44
t,59,kaist_dataset/English/Digital_Camera/(E.S)C-outdoor1/076.JPG,char_data/t/076.JPG_4.jpg,2183,480,640,37,346,383,207,266,True,44
t,16,kaist_dataset/English/Digital_Camera/(E.S)C-outdoor1/076.JPG,char_data/t/076.JPG_5.jpg,96,480,640,6,584,590,320,336,True,44
t,51,kaist_dataset/English/Digital_Camera/(E.S)C-outdoor1/077.JPG,char_data/t/077.JPG_2.jpg,2652,480,640,52,364,416,194,245,True,44
t,50,kaist_dataset/English/Digital_Camera/(E.S)C-outdoor1/080116-0066.jpg,char_data/t/080116-0066.jpg_2.jpg,1250,600,800,25,588,613,350,400,True,44
t,243,kaist_dataset/English/Digital_Camera/(E.S)C-outdoor1/080119-0035.jpg,char_data/t/080119-0035.jpg_2.jpg,25029,1200,1600,103,1046,1149,739,982,True,44
t,198,kaist_dataset/English/Digital_Camera/(E.S)C-outdoor1/080119-0036.jpg,char_data/t/080119-0036.jpg_2.jpg,16632,1200,1600,84,1280,1364,345,543,True,44
t,80,kaist_dataset/English/Digital_Camera/(E.S)C-outdoor1/1.jpg,char_data/t/1.jpg_4.jpg,3280,480,640,41,531,572,122,202,True,44
t,152,kaist_dataset/English/Digital_Camera/(E.S)C-outdoor1/100.JPG,char_data/t/100.JPG_2.jpg,8664,480,640,57,405,462,41,193,True,44
t,63,kaist_dataset/English/Digital_Camera/(E.S)C-outdoor1/109.jpg,char_data/t/109.jpg_4.jpg,1575,480,640,25,330,355,172,235,True,44
t,58,kaist_dataset/English/Digital_Camera/(E.S)C-outdoor1/109.jpg,char_data/t/109.jpg_5.jpg,2378,480,640,41,358,399,238,296,True,44
t,34,kaist_dataset/English/Digital_Camera/(E.S)C-outdoor1/137.JPG,char_data/t/137.JPG_2.jpg,510,480,640,15,289,304,264,298,True,44
t,96,kaist_dataset/English/Digital_Camera/(E.S)C-outdoor1/2007-12-08-day-111.jpg,char_data/t/2007-12-08-day-111.jpg_2.jpg,7008,1200,1600,73,1097,1170,492,588,True,44
t,45,kaist_dataset/English/Digital_Camera/(E.S)C-outdoor1/2007-12-09-day-exterior-063.jpg,char_data/t/2007-12-09-day-exterior-063.jpg_4.jpg,675,1200,1600,15,37,52,525,570,True,44
t,86,kaist_dataset/English/Digital_Camera/(E.S)C-outdoor1/7.jpg,char_data/t/7.jpg_2.jpg,3182,574,680,37,510,547,255,341,True,44
t,37,kaist_dataset/English/Digital_Camera/(E.S)C-outdoor1/DSC02356.JPG,char_data/t/DSC02356.JPG_5.jpg,407,480,640,11,333,344,310,347,True,44
t,36,kaist_dataset/English/Digital_Camera/(E.S)C-outdoor1/DSC02427.JPG,char_data/t/DSC02427.JPG_5.jpg,720,480,640,20,487,507,366,402,True,44
t,54,kaist_dataset/English/Digital_Camera/(E.S)C-outdoor1/DSC02442.JPG,char_data/t/DSC02442.JPG_2.jpg,1836,480,640,34,185,219,170,224,True,44
t,85,kaist_dataset/English/Digital_Camera/(E.S)C-outdoor1/DSC02491.JPG,char_data/t/DSC02491.JPG_5.jpg,3060,480,640,36,310,346,125,210,True,44
t,96,kaist_dataset/English/Digital_Camera/(E.S)C-outdoor1/DSC02914.JPG,char_data/t/DSC02914.JPG_2.jpg,4032,480,640,42,491,533,192,288,True,44
t,36,kaist_dataset/English/Digital_Camera/(E.S)C-outdoor1/DSC02918.JPG,char_data/t/DSC02918.JPG_7.jpg,720,480,640,20,188,208,232,268,True,44
t,36,kaist_dataset/English/Digital_Camera/(E.S)C-outdoor1/DSC02918.JPG,char_data/t/DSC02918.JPG_8.jpg,720,480,640,20,251,271,187,223,True,44
t,55,kaist_dataset/English/Digital_Camera/(E.S)C-outdoor2/DSC02998.JPG,char_data/t/DSC02998.JPG_2.jpg,1210,480,640,22,314,336,414,469,True,44
t,40,kaist_dataset/English/Digital_Camera/(E.S)C-outdoor2/DSC03053.JPG,char_data/t/DSC03053.JPG_4.jpg,760,480,640,19,97,116,133,173,True,44
t,37,kaist_dataset/English/Digital_Camera/(E.S)C-outdoor2/DSC03160.JPG,char_data/t/DSC03160.JPG_4.jpg,814,480,640,22,216,238,155,192,True,44
t,53,kaist_dataset/English/Digital_Camera/(E.S)C-outdoor2/DSC03277.JPG,char_data/t/DSC03277.JPG_2.jpg,1855,480,640,35,524,559,193,246,True,44
t,56,kaist_dataset/English/Digital_Camera/(E.S)C-outdoor2/DSC03290.JPG,char_data/t/DSC03290.JPG_2.jpg,1288,480,640,23,304,327,90,146,True,44
t,91,kaist_dataset/English/Digital_Camera/(E.S)C-outdoor2/DSC03300.JPG,char_data/t/DSC03300.JPG_2.jpg,6552,480,640,72,335,407,135,226,True,44
t,40,kaist_dataset/English/Digital_Camera/(E.S)C-outdoor2/DSC03307.JPG,char_data/t/DSC03307.JPG_4.jpg,680,480,640,17,251,268,168,208,True,44
t,45,kaist_dataset/English/Digital_Camera/(E.S)C-outdoor2/DSC03307.JPG,char_data/t/DSC03307.JPG_5.jpg,585,480,640,13,268,281,166,211,True,44
t,97,kaist_dataset/English/Digital_Camera/(E.S)C-outdoor2/DSC03408.JPG,char_data/t/DSC03408.JPG_2.jpg,4171,480,640,43,243,286,333,430,True,44
t,66,kaist_dataset/English/Digital_Camera/(E.S)C-outdoor2/DSC03413.JPG,char_data/t/DSC03413.JPG_5.jpg,2508,480,640,38,411,449,127,193,True,44
t,85,kaist_dataset/English/Digital_Camera/(E.S)C-outdoor2/DSC03436.JPG,char_data/t/DSC03436.JPG_4.jpg,3145,480,640,37,400,437,27,112,True,44
t,67,kaist_dataset/English/Digital_Camera/(E.S)C-outdoor2/DSC03761.JPG,char_data/t/DSC03761.JPG_2.jpg,2345,480,640,35,433,468,342,409,True,44
t,60,kaist_dataset/English/Digital_Camera/(E.S)C-outdoor2/DSC03765.JPG,char_data/t/DSC03765.JPG_2.jpg,1440,480,640,24,295,319,83,143,True,44
t,44,kaist_dataset/English/Digital_Camera/(E.S)C-outdoor2/DSC03865.JPG,char_data/t/DSC03865.JPG_6.jpg,704,480,640,16,103,119,95,139,True,44
t,43,kaist_dataset/English/Digital_Camera/(E.S)C-outdoor2/DSC03865.JPG,char_data/t/DSC03865.JPG_7.jpg,946,480,640,22,245,267,100,143,True,44
t,57,kaist_dataset/English/Digital_Camera/(E.S)C-outdoor2/DSC04035.JPG,char_data/t/DSC04035.JPG_6.jpg,1311,480,640,23,457,480,192,249,True,44
t,56,kaist_dataset/English/Digital_Camera/(E.S)C-outdoor2/DSC04035.JPG,char_data/t/DSC04035.JPG_7.jpg,1400,480,640,25,496,521,193,249,True,44
t,53,kaist_dataset/English/Digital_Camera/(E.S)C-outdoor2/DSC04035.JPG,char_data/t/DSC04035.JPG_8.jpg,1325,480,640,25,554,579,196,249,True,44
t,44,kaist_dataset/English/Digital_Camera/(E.S)C-outdoor2/DSC04064.JPG,char_data/t/DSC04064.JPG_2.jpg,924,480,640,21,358,379,132,176,True,44
t,38,kaist_dataset/English/Digital_Camera/(E.S)C-outdoor2/DSC04079.JPG,char_data/t/DSC04079.JPG_8.jpg,722,480,640,19,92,111,158,196,True,44
t,39,kaist_dataset/English/Digital_Camera/(E.S)C-outdoor2/DSC04079.JPG,char_data/t/DSC04079.JPG_9.jpg,585,480,640,15,150,165,156,195,True,44
t,38,kaist_dataset/English/Digital_Camera/(E.S)C-outdoor2/DSC04079.JPG,char_data/t/DSC04079.JPG_10.jpg,608,480,640,16,236,252,196,234,True,44
t,38,kaist_dataset/English/Digital_Camera/(E.S)C-outdoor2/DSC04079.JPG,char_data/t/DSC04079.JPG_11.jpg,570,480,640,15,251,266,195,233,True,44
t,79,kaist_dataset/English/Digital_Camera/(E.S)C-outdoor2/DSC04160.JPG,char_data/t/DSC04160.JPG_2.jpg,4266,480,640,54,308,362,343,422,True,44
t,125,kaist_dataset/English/Digital_Camera/(E.S)C-outdoor2/DSC04397.JPG,char_data/t/DSC04397.JPG_4.jpg,9500,480,640,76,253,329,189,314,True,44
t,70,kaist_dataset/English/Digital_Camera/(E.S)C-outdoor2/DSC04397.JPG,char_data/t/DSC04397.JPG_5.jpg,1820,480,640,26,294,320,120,190,True,44
t,22,kaist_dataset/English/Digital_Camera/(E.S)C-outdoor2/DSC04437.JPG,char_data/t/DSC04437.JPG_8.jpg,264,480,640,12,221,233,81,103,True,44
t,23,kaist_dataset/English/Digital_Camera/(E.S)C-outdoor2/DSC04437.JPG,char_data/t/DSC04437.JPG_9.jpg,207,480,640,9,245,254,80,103,True,44
t,25,kaist_dataset/English/Digital_Camera/(E.S)C-outdoor2/DSC04437.JPG,char_data/t/DSC04437.JPG_10.jpg,175,480,640,7,408,415,79,104,True,44
t,27,kaist_dataset/English/Digital_Camera/(E.S)C-outdoor2/DSC04437.JPG,char_data/t/DSC04437.JPG_11.jpg,270,480,640,10,414,424,78,105,True,44
t,43,kaist_dataset/English/Digital_Camera/(E.S)C-outdoor2/P1010057.JPG,char_data/t/P1010057.JPG_2.jpg,1290,480,640,30,404,434,199,242,True,44
t,28,kaist_dataset/English/Digital_Camera/(E.S)C-outdoor3/크기변환_P1010076.JPG,char_data/t/크기변환_P1010076.JPG_5.jpg,196,480,640,7,271,278,96,124,True,44
t,48,kaist_dataset/English/Digital_Camera/(E.S)D-indoor/080119-0009.jpg,char_data/t/080119-0009.jpg_12.jpg,1056,1200,1600,22,856,878,1073,1121,True,44
t,46,kaist_dataset/English/Digital_Camera/(E.S)D-indoor/080119-0009.jpg,char_data/t/080119-0009.jpg_13.jpg,736,1200,1600,16,928,944,1075,1121,True,44
t,55,kaist_dataset/English/Digital_Camera/(E.S)D-indoor/DSC02719.JPG,char_data/t/DSC02719.JPG_4.jpg,1815,480,640,33,268,301,289,344,True,44
t,61,kaist_dataset/English/Digital_Camera/(E.S)D-indoor/DSC02719.JPG,char_data/t/DSC02719.JPG_5.jpg,1525,480,640,25,493,518,285,346,True,44
t,89,kaist_dataset/English/Digital_Camera/(E.S)D-indoor/DSC02842.JPG,char_data/t/DSC02842.JPG_4.jpg,4005,480,640,45,400,445,71,160,True,44
t,48,kaist_dataset/English/Digital_Camera/(E.S)D-indoor/DSC02859.JPG,char_data/t/DSC02859.JPG_2.jpg,1248,480,640,26,437,463,345,393,True,44
t,70,kaist_dataset/English/Digital_Camera/(E.S)D-indoor/DSC02860.JPG,char_data/t/DSC02860.JPG_4.jpg,2590,480,640,37,294,331,67,137,True,44
t,68,kaist_dataset/English/Digital_Camera/(E.S)D-indoor/DSC02860.JPG,char_data/t/DSC02860.JPG_5.jpg,2720,480,640,40,415,455,71,139,True,44
t,71,kaist_dataset/English/Digital_Camera/(E.S)D-indoor/DSC03074.JPG,char_data/t/DSC03074.JPG_2.jpg,1775,480,640,25,492,517,249,320,True,44
t,58,kaist_dataset/English/Digital_Camera/(E.S)D-indoor/DSC03078.JPG,char_data/t/DSC03078.JPG_4.jpg,1508,480,640,26,474,500,228,286,True,44
t,59,kaist_dataset/English/Digital_Camera/(E.S)D-indoor/DSC03078.JPG,char_data/t/DSC03078.JPG_5.jpg,1298,480,640,22,375,397,299,358,True,44
t,53,kaist_dataset/English/Digital_Camera/(E.S)D-indoor/DSC03083.JPG,char_data/t/DSC03083.JPG_2.jpg,901,480,640,17,269,286,392,445,True,44
t,53,kaist_dataset/English/Digital_Camera/(E.S)D-indoor/DSC03085.JPG,char_data/t/DSC03085.JPG_8.jpg,848,480,640,16,193,209,380,433,True,44
t,60,kaist_dataset/English/Digital_Camera/(E.S)D-indoor/DSC03085.JPG,char_data/t/DSC03085.JPG_9.jpg,1020,480,640,17,227,244,372,432,True,44
t,68,kaist_dataset/English/Digital_Camera/(E.S)D-indoor/DSC03085.JPG,char_data/t/DSC03085.JPG_10.jpg,1360,480,640,20,272,292,373,441,True,44
t,58,kaist_dataset/English/Digital_Camera/(E.S)D-indoor/DSC03085.JPG,char_data/t/DSC03085.JPG_11.jpg,1218,480,640,21,490,511,374,432,True,44
t,48,kaist_dataset/English/Digital_Camera/(E.S)D-indoor/DSC03090.JPG,char_data/t/DSC03090.JPG_6.jpg,912,480,640,19,161,180,237,285,True,44
t,40,kaist_dataset/English/Digital_Camera/(E.S)D-indoor/DSC03090.JPG,char_data/t/DSC03090.JPG_7.jpg,920,480,640,23,205,228,238,278,True,44
t,44,kaist_dataset/English/Digital_Camera/(E.S)D-indoor/DSC03090.JPG,char_data/t/DSC03090.JPG_8.jpg,616,480,640,14,421,435,289,333,True,44
t,59,kaist_dataset/English/Digital_Camera/(E.S)D-indoor/DSC03091.JPG,char_data/t/DSC03091.JPG_5.jpg,2124,480,640,36,396,432,125,184,True,44
t,42,kaist_dataset/English/Digital_Camera/(E.S)D-indoor/DSC03112.JPG,char_data/t/DSC03112.JPG_2.jpg,714,480,640,17,248,265,203,245,True,44
t,60,kaist_dataset/English/Digital_Camera/(E.S)D-indoor/DSC03150.JPG,char_data/t/DSC03150.JPG_2.jpg,1920,480,640,32,430,462,17,77,True,44
t,50,kaist_dataset/English/Digital_Camera/(E.S)D-indoor/DSC03396.JPG,char_data/t/DSC03396.JPG_2.jpg,950,480,640,19,490,509,337,387,True,44
t,30,kaist_dataset/English/Digital_Camera/(E.S)D-indoor/DSC03532.JPG,char_data/t/DSC03532.JPG_4.jpg,210,480,640,7,137,144,379,409,True,44
t,29,kaist_dataset/English/Digital_Camera/(E.S)D-indoor/DSC03532.JPG,char_data/t/DSC03532.JPG_5.jpg,290,480,640,10,621,631,376,405,True,44
t,54,kaist_dataset/English/Digital_Camera/(E.S)D-indoor/DSC03936.JPG,char_data/t/DSC03936.JPG_2.jpg,972,480,640,18,519,537,85,139,True,44
t,65,kaist_dataset/English/Digital_Camera/(E.S)D-indoor/DSC04023.JPG,char_data/t/DSC04023.JPG_11.jpg,2535,480,640,39,578,617,251,316,True,44
t,34,kaist_dataset/English/Digital_Camera/(E.S)D-indoor/DSC04023.JPG,char_data/t/DSC04023.JPG_12.jpg,1122,480,640,33,34,67,302,336,True,44
t,33,kaist_dataset/English/Digital_Camera/(E.S)D-indoor/DSC04023.JPG,char_data/t/DSC04023.JPG_13.jpg,891,480,640,27,388,415,324,357,True,44
t,31,kaist_dataset/English/Digital_Camera/(E.S)D-indoor/DSC04023.JPG,char_data/t/DSC04023.JPG_14.jpg,682,480,640,22,485,507,327,358,True,44
t,123,kaist_dataset/English/Digital_Camera/(E.S)E-night/DSC02570.JPG,char_data/t/DSC02570.JPG_2.jpg,5658,480,640,46,482,528,221,344,True,44
t,53,kaist_dataset/English/Digital_Camera/(E.S)F-others/080119-0007.jpg,char_data/t/080119-0007.jpg_12.jpg,1537,1200,1600,29,833,862,824,877,True,44
t,56,kaist_dataset/English/Digital_Camera/(E.S)F-others/080119-0007.jpg,char_data/t/080119-0007.jpg_13.jpg,1624,1200,1600,29,925,954,802,858,True,44
t,39,kaist_dataset/English/Digital_Camera/(E.S)F-others/080119-0007.jpg,char_data/t/080119-0007.jpg_14.jpg,351,1200,1600,9,1425,1434,493,532,True,44
t,46,kaist_dataset/English/Digital_Camera/(E.S)F-others/080119-0007.jpg,char_data/t/080119-0007.jpg_15.jpg,828,1200,1600,18,1522,1540,488,534,True,44
t,56,kaist_dataset/English/Digital_Camera/(E.S)F-others/080119-0007.jpg,char_data/t/080119-0007.jpg_16.jpg,1680,1200,1600,30,794,824,766,822,True,44
t,58,kaist_dataset/English/Digital_Camera/(E.S)F-others/080119-0007.jpg,char_data/t/080119-0007.jpg_17.jpg,1972,1200,1600,34,955,989,729,787,True,44
t,91,kaist_dataset/English/Digital_Camera/(E.S)F-others/DSC02923.JPG,char_data/t/DSC02923.JPG_6.jpg,4186,480,640,46,398,444,275,366,True,44
t,103,kaist_dataset/English/Digital_Camera/(E.S)F-others/DSC02923.JPG,char_data/t/DSC02923.JPG_7.jpg,4841,480,640,47,575,622,245,348,True,44
t,65,kaist_dataset/English/Mobile_Phone/(E.M)A-outdoor/P090911071.jpg,char_data/t/P090911071.jpg_2.jpg,2795,480,640,43,441,484,121,186,True,44
t,61,kaist_dataset/English/Mobile_Phone/(E.M)B-indoor/P090902018.jpg,char_data/t/P090902018.jpg_6.jpg,1891,480,640,31,402,433,188,249,True,44
t,60,kaist_dataset/English/Mobile_Phone/(E.M)B-indoor/P090902018.jpg,char_data/t/P090902018.jpg_7.jpg,1680,480,640,28,489,517,190,250,True,44
t,104,kaist_dataset/English/Mobile_Phone/(E.M)B-indoor/P090903002.jpg,char_data/t/P090903002.jpg_4.jpg,6032,480,640,58,200,258,287,391,True,44
t,104,kaist_dataset/English/Mobile_Phone/(E.M)B-indoor/P090903002.jpg,char_data/t/P090903002.jpg_5.jpg,6968,480,640,67,426,493,286,390,True,44
t,105,kaist_dataset/English/Mobile_Phone/(E.M)B-indoor/P090903004.jpg,char_data/t/P090903004.jpg_2.jpg,5355,480,640,51,155,206,230,335,True,44
t,65,kaist_dataset/English/Mobile_Phone/(E.M)B-indoor/P090903008.jpg,char_data/t/P090903008.jpg_2.jpg,1950,480,640,30,349,379,32,97,True,44
t,79,kaist_dataset/English/Mobile_Phone/(E.M)B-indoor/P090911083.jpg,char_data/t/P090911083.jpg_2.jpg,3634,480,640,46,539,585,211,290,True,44
t,50,kaist_dataset/English/Mobile_Phone/(E.M)B-indoor/P090911084.jpg,char_data/t/P090911084.jpg_2.jpg,850,480,640,17,525,542,154,204,True,44
t,74,kaist_dataset/English/Mobile_Phone/(E.M)C-bookCover/P090831039.jpg,char_data/t/P090831039.jpg_7.jpg,2886,480,640,39,284,323,128,202,True,44
t,65,kaist_dataset/English/Mobile_Phone/(E.M)C-bookCover/P090831039.jpg,char_data/t/P090831039.jpg_8.jpg,2340,480,640,36,192,228,233,298,True,44
t,110,kaist_dataset/English/Mobile_Phone/(E.M)C-bookCover/P090831077.jpg,char_data/t/P090831077.jpg_4.jpg,9570,480,640,87,333,420,80,190,True,44
t,51,kaist_dataset/English/Mobile_Phone/(E.M)C-bookCover/P090903030.jpg,char_data/t/P090903030.jpg_2.jpg,1428,480,640,28,107,135,70,121,True,44
t,29,kaist_dataset/Korean/Digital_Camera/A-shadow/2007-12-09-day-exterior-031.jpg,char_data/t/2007-12-09-day-exterior-031.jpg_4.jpg,348,1200,1600,12,483,495,613,642,True,44
t,35,kaist_dataset/Korean/Digital_Camera/A-shadow/2007-12-09-day-exterior-031.jpg,char_data/t/2007-12-09-day-exterior-031.jpg_5.jpg,595,1200,1600,17,581,598,607,642,True,44
t,32,kaist_dataset/Korean/Digital_Camera/B-light/DSC02987.JPG,char_data/t/DSC02987.JPG_2.jpg,544,480,640,17,351,368,277,309,True,44
t,32,kaist_dataset/Korean/Digital_Camera/G-others/080119-0005.jpg,char_data/t/080119-0005.jpg_2.jpg,480,1600,1200,15,591,606,589,621,True,44
t,21,kaist_dataset/Korean/Digital_Camera/outdoor1/001.JPG,char_data/t/001.JPG_4.jpg,147,480,640,7,297,304,241,262,True,44
t,19,kaist_dataset/Korean/Digital_Camera/outdoor1/001.JPG,char_data/t/001.JPG_5.jpg,152,480,640,8,499,507,240,259,True,44
t,51,kaist_dataset/Korean/Digital_Camera/outdoor2/080118-0018.jpg,char_data/t/080118-0018.jpg_2.jpg,969,1200,1600,19,622,641,674,725,True,44
t,45,kaist_dataset/Mixed/Digital_Camera/(C.S)A-shadow/DSC02609.JPG,char_data/t/DSC02609.JPG_9.jpg,810,480,640,18,416,434,292,337,True,44
t,32,kaist_dataset/Mixed/Digital_Camera/(C.S)B-light/134.JPG,char_data/t/134.JPG_4.jpg,416,480,640,13,353,366,292,324,True,44
t,37,kaist_dataset/Mixed/Digital_Camera/(C.S)B-light/134.JPG,char_data/t/134.JPG_5.jpg,629,480,640,17,385,402,291,328,True,44
t,29,kaist_dataset/Mixed/Digital_Camera/(C.S)C-outdoor1/003.JPG,char_data/t/003.JPG_13.jpg,174,480,640,6,533,539,244,273,True,44
t,24,kaist_dataset/Mixed/Digital_Camera/(C.S)C-outdoor1/003.JPG,char_data/t/003.JPG_14.jpg,192,480,640,8,190,198,262,286,True,44
t,28,kaist_dataset/Mixed/Digital_Camera/(C.S)C-outdoor1/003.JPG,char_data/t/003.JPG_15.jpg,308,480,640,11,352,363,253,281,True,44
t,24,kaist_dataset/Mixed/Digital_Camera/(C.S)C-outdoor1/003.JPG,char_data/t/003.JPG_16.jpg,168,480,640,7,158,165,264,288,True,44
t,22,kaist_dataset/Mixed/Digital_Camera/(C.S)C-outdoor1/003.JPG,char_data/t/003.JPG_17.jpg,154,480,640,7,173,180,264,286,True,44
t,61,kaist_dataset/Mixed/Digital_Camera/(C.S)C-outdoor1/080116-0084.jpg,char_data/t/080116-0084.jpg_2.jpg,3294,600,800,54,351,405,199,260,True,44
t,225,kaist_dataset/Mixed/Digital_Camera/(C.S)C-outdoor1/080119-0033.jpg,char_data/t/080119-0033.jpg_2.jpg,28575,1200,1600,127,959,1086,473,698,True,44
t,33,kaist_dataset/Mixed/Digital_Camera/(C.S)C-outdoor1/118.JPG,char_data/t/118.JPG_2.jpg,924,480,640,28,296,324,359,392,True,44
t,48,kaist_dataset/Mixed/Digital_Camera/(C.S)C-outdoor1/130.JPG,char_data/t/130.JPG_2.jpg,1104,480,640,23,289,312,290,338,True,44
t,44,kaist_dataset/Mixed/Digital_Camera/(C.S)C-outdoor1/133.JPG,char_data/t/133.JPG_2.jpg,704,480,640,16,627,639,337,381,True,44
t,30,kaist_dataset/Mixed/Digital_Camera/(C.S)C-outdoor1/2.JPG,char_data/t/2.JPG_9.jpg,150,576,768,5,93,98,378,408,True,44
t,30,kaist_dataset/Mixed/Digital_Camera/(C.S)C-outdoor1/DSC02318.JPG,char_data/t/DSC02318.JPG_2.jpg,420,480,640,14,440,454,321,351,True,44
t,19,kaist_dataset/Mixed/Digital_Camera/(C.S)C-outdoor1/DSC02320.JPG,char_data/t/DSC02320.JPG_5.jpg,285,480,640,15,535,550,254,273,True,44
t,81,kaist_dataset/Mixed/Digital_Camera/(C.S)C-outdoor1/DSC02344.JPG,char_data/t/DSC02344.JPG_2.jpg,2268,480,640,28,234,262,143,224,True,44
t,52,kaist_dataset/Mixed/Digital_Camera/(C.S)C-outdoor2/DSC02407.JPG,char_data/t/DSC02407.JPG_2.jpg,1404,480,640,27,333,360,175,227,True,44
t,68,kaist_dataset/Mixed/Digital_Camera/(C.S)C-outdoor2/DSC02418.JPG,char_data/t/DSC02418.JPG_2.jpg,2448,480,640,36,230,266,156,224,True,44
t,85,kaist_dataset/Mixed/Digital_Camera/(C.S)C-outdoor2/DSC02425.JPG,char_data/t/DSC02425.JPG_2.jpg,4420,480,640,52,566,618,150,235,True,44
t,26,kaist_dataset/Mixed/Digital_Camera/(C.S)C-outdoor2/DSC02430.JPG,char_data/t/DSC02430.JPG_5.jpg,468,480,640,18,215,233,190,216,True,44
t,60,kaist_dataset/Mixed/Digital_Camera/(C.S)C-outdoor2/DSC02433.JPG,char_data/t/DSC02433.JPG_2.jpg,1380,480,640,23,308,331,186,246,True,44
t,93,kaist_dataset/Mixed/Digital_Camera/(C.S)C-outdoor2/DSC02434.JPG,char_data/t/DSC02434.JPG_2.jpg,3534,480,640,38,416,454,181,274,True,44
t,33,kaist_dataset/Mixed/Digital_Camera/(C.S)C-outdoor2/DSC02545.JPG,char_data/t/DSC02545.JPG_2.jpg,594,480,640,18,231,249,367,400,True,44
t,49,kaist_dataset/Mixed/Digital_Camera/(C.S)C-outdoor2/DSC02869.JPG,char_data/t/DSC02869.JPG_4.jpg,490,480,640,10,131,141,134,183,True,44
t,45,kaist_dataset/Mixed/Digital_Camera/(C.S)C-outdoor2/DSC02869.JPG,char_data/t/DSC02869.JPG_5.jpg,495,480,640,11,224,235,140,185,True,44
t,33,kaist_dataset/Mixed/Digital_Camera/(C.S)C-outdoor2/DSC02894.JPG,char_data/t/DSC02894.JPG_2.jpg,759,480,640,23,173,196,273,306,True,44
t,47,kaist_dataset/Mixed/Digital_Camera/(C.S)C-outdoor2/DSC02907.JPG,char_data/t/DSC02907.JPG_2.jpg,1504,480,640,32,428,460,95,142,True,44
t,36,kaist_dataset/Mixed/Digital_Camera/(C.S)C-outdoor2/DSC02936.JPG,char_data/t/DSC02936.JPG_2.jpg,360,480,640,10,357,367,85,121,True,44
t,50,kaist_dataset/Mixed/Digital_Camera/(C.S)C-outdoor3/DSC02989.JPG,char_data/t/DSC02989.JPG_10.jpg,1550,480,640,31,450,481,201,251,True,44
t,45,kaist_dataset/Mixed/Digital_Camera/(C.S)C-outdoor3/DSC02989.JPG,char_data/t/DSC02989.JPG_11.jpg,1440,480,640,32,510,542,205,250,True,44
t,96,kaist_dataset/Mixed/Digital_Camera/(C.S)C-outdoor3/DSC03017.JPG,char_data/t/DSC03017.JPG_2.jpg,4800,480,640,50,351,401,141,237,True,44
t,65,kaist_dataset/Mixed/Digital_Camera/(C.S)C-outdoor3/DSC03048.JPG,char_data/t/DSC03048.JPG_2.jpg,1885,480,640,29,451,480,127,192,True,44
t,36,kaist_dataset/Mixed/Digital_Camera/(C.S)C-outdoor3/DSC03209.JPG,char_data/t/DSC03209.JPG_4.jpg,612,480,640,17,345,362,415,451,True,44
t,40,kaist_dataset/Mixed/Digital_Camera/(C.S)C-outdoor3/DSC03209.JPG,char_data/t/DSC03209.JPG_5.jpg,640,480,640,16,492,508,413,453,True,44
t,34,kaist_dataset/Mixed/Digital_Camera/(C.S)C-outdoor3/DSC03227.JPG,char_data/t/DSC03227.JPG_2.jpg,476,480,640,14,163,177,104,138,True,44
t,91,kaist_dataset/Mixed/Digital_Camera/(C.S)C-outdoor3/DSC03260.JPG,char_data/t/DSC03260.JPG_5.jpg,3458,480,640,38,403,441,77,168,True,44
t,35,kaist_dataset/Mixed/Digital_Camera/(C.S)C-outdoor3/DSC03328.JPG,char_data/t/DSC03328.JPG_4.jpg,490,480,640,14,436,450,230,265,True,44
t,83,kaist_dataset/Mixed/Digital_Camera/(C.S)C-outdoor3/DSC03421.JPG,char_data/t/DSC03421.JPG_4.jpg,1992,480,640,24,218,242,227,310,True,44
t,81,kaist_dataset/Mixed/Digital_Camera/(C.S)C-outdoor3/DSC03421.JPG,char_data/t/DSC03421.JPG_5.jpg,1944,480,640,24,490,514,242,323,True,44
t,94,kaist_dataset/Mixed/Digital_Camera/(C.S)C-outdoor4/DSC03519.JPG,char_data/t/DSC03519.JPG_2.jpg,10152,480,640,108,409,517,213,307,True,44
t,45,kaist_dataset/Mixed/Digital_Camera/(C.S)C-outdoor4/DSC03642.JPG,char_data/t/DSC03642.JPG_6.jpg,630,480,640,14,300,314,244,289,True,44
t,49,kaist_dataset/Mixed/Digital_Camera/(C.S)C-outdoor4/DSC03642.JPG,char_data/t/DSC03642.JPG_7.jpg,735,480,640,15,514,529,238,287,True,44
t,56,kaist_dataset/Mixed/Digital_Camera/(C.S)C-outdoor4/DSC03643.JPG,char_data/t/DSC03643.JPG_4.jpg,1344,480,640,24,245,269,257,313,True,44
t,47,kaist_dataset/Mixed/Digital_Camera/(C.S)C-outdoor4/DSC03643.JPG,char_data/t/DSC03643.JPG_5.jpg,1128,480,640,24,504,528,279,326,True,44
t,89,kaist_dataset/Mixed/Digital_Camera/(C.S)C-outdoor4/DSC03651.JPG,char_data/t/DSC03651.JPG_4.jpg,4005,480,640,45,346,391,164,253,True,44
t,37,kaist_dataset/Mixed/Digital_Camera/(C.S)C-outdoor4/DSC03667.JPG,char_data/t/DSC03667.JPG_2.jpg,370,480,640,10,201,211,377,414,True,44
t,24,kaist_dataset/Mixed/Digital_Camera/(C.S)C-outdoor4/DSC03670.JPG,char_data/t/DSC03670.JPG_6.jpg,312,480,640,13,450,463,322,346,True,44
t,28,kaist_dataset/Mixed/Digital_Camera/(C.S)C-outdoor4/DSC03670.JPG,char_data/t/DSC03670.JPG_7.jpg,392,480,640,14,534,548,322,350,True,44
t,32,kaist_dataset/Mixed/Digital_Camera/(C.S)C-outdoor4/DSC03682.JPG,char_data/t/DSC03682.JPG_2.jpg,352,480,640,11,530,541,324,356,True,44
t,37,kaist_dataset/Mixed/Digital_Camera/(C.S)C-outdoor4/DSC03718.JPG,char_data/t/DSC03718.JPG_7.jpg,518,480,640,14,52,66,252,289,True,44
t,40,kaist_dataset/Mixed/Digital_Camera/(C.S)C-outdoor4/DSC03719.JPG,char_data/t/DSC03719.JPG_7.jpg,360,480,640,9,62,71,26,66,True,44
t,62,kaist_dataset/Mixed/Digital_Camera/(C.S)C-outdoor4/DSC03784.JPG,char_data/t/DSC03784.JPG_4.jpg,1240,480,640,20,407,427,318,380,True,44
t,66,kaist_dataset/Mixed/Digital_Camera/(C.S)C-outdoor4/DSC03784.JPG,char_data/t/DSC03784.JPG_5.jpg,1584,480,640,24,586,610,312,378,True,44
t,44,kaist_dataset/Mixed/Digital_Camera/(C.S)C-outdoor5/DSC03821.JPG,char_data/t/DSC03821.JPG_6.jpg,572,480,640,13,269,282,30,74,True,44
t,44,kaist_dataset/Mixed/Digital_Camera/(C.S)C-outdoor5/DSC03821.JPG,char_data/t/DSC03821.JPG_7.jpg,528,480,640,12,372,384,33,77,True,44
t,43,kaist_dataset/Mixed/Digital_Camera/(C.S)C-outdoor5/DSC03821.JPG,char_data/t/DSC03821.JPG_8.jpg,774,480,640,18,505,523,44,87,True,44
t,33,kaist_dataset/Mixed/Digital_Camera/(C.S)C-outdoor5/DSC03839.JPG,char_data/t/DSC03839.JPG_6.jpg,297,480,640,9,275,284,35,68,True,44
t,39,kaist_dataset/Mixed/Digital_Camera/(C.S)C-outdoor5/DSC03839.JPG,char_data/t/DSC03839.JPG_7.jpg,507,480,640,13,410,423,35,74,True,44
t,39,kaist_dataset/Mixed/Digital_Camera/(C.S)C-outdoor5/DSC04015.JPG,char_data/t/DSC04015.JPG_2.jpg,819,480,640,21,197,218,125,164,True,44
t,91,kaist_dataset/Mixed/Digital_Camera/(C.S)C-outdoor5/DSC04030.JPG,char_data/t/DSC04030.JPG_2.jpg,4277,480,640,47,43,90,170,261,True,44
t,34,kaist_dataset/Mixed/Digital_Camera/(C.S)C-outdoor5/DSC04057.JPG,char_data/t/DSC04057.JPG_4.jpg,510,480,640,15,251,266,117,151,True,44
t,33,kaist_dataset/Mixed/Digital_Camera/(C.S)C-outdoor5/DSC04057.JPG,char_data/t/DSC04057.JPG_5.jpg,627,480,640,19,355,374,114,147,True,44
t,39,kaist_dataset/Mixed/Digital_Camera/(C.S)C-outdoor5/DSC04069.JPG,char_data/t/DSC04069.JPG_8.jpg,429,480,640,11,281,292,418,457,True,44
t,37,kaist_dataset/Mixed/Digital_Camera/(C.S)C-outdoor5/DSC04069.JPG,char_data/t/DSC04069.JPG_9.jpg,555,480,640,15,501,516,372,409,True,44
t,30,kaist_dataset/Mixed/Digital_Camera/(C.S)C-outdoor5/DSC04069.JPG,char_data/t/DSC04069.JPG_10.jpg,570,480,640,19,274,293,383,413,True,44
t,31,kaist_dataset/Mixed/Digital_Camera/(C.S)C-outdoor5/DSC04069.JPG,char_data/t/DSC04069.JPG_11.jpg,527,480,640,17,430,447,376,407,True,44
t,36,kaist_dataset/Mixed/Digital_Camera/(C.S)C-outdoor5/DSC04070.JPG,char_data/t/DSC04070.JPG_4.jpg,648,480,640,18,248,266,108,144,True,44
t,54,kaist_dataset/Mixed/Digital_Camera/(C.S)C-outdoor5/DSC04076.JPG,char_data/t/DSC04076.JPG_4.jpg,1944,480,640,36,432,468,86,140,True,44
t,27,kaist_dataset/Mixed/Digital_Camera/(C.S)C-outdoor5/DSC04076.JPG,char_data/t/DSC04076.JPG_5.jpg,324,480,640,12,476,488,399,426,True,44
t,42,kaist_dataset/Mixed/Digital_Camera/(C.S)C-outdoor5/DSC04104.JPG,char_data/t/DSC04104.JPG_6.jpg,630,480,640,15,260,275,42,84,True,44
t,41,kaist_dataset/Mixed/Digital_Camera/(C.S)C-outdoor5/DSC04104.JPG,char_data/t/DSC04104.JPG_7.jpg,615,480,640,15,277,292,41,82,True,44
t,44,kaist_dataset/Mixed/Digital_Camera/(C.S)C-outdoor5/DSC04162.JPG,char_data/t/DSC04162.JPG_2.jpg,1232,480,640,28,332,360,327,371,True,44
t,37,kaist_dataset/Mixed/Digital_Camera/(C.S)C-outdoor5/DSC04321.JPG,char_data/t/DSC04321.JPG_4.jpg,481,480,640,13,550,563,203,240,True,44
t,36,kaist_dataset/Mixed/Digital_Camera/(C.S)C-outdoor5/DSC04321.JPG,char_data/t/DSC04321.JPG_5.jpg,504,480,640,14,288,302,198,234,True,44
t,44,kaist_dataset/Mixed/Digital_Camera/(C.S)C-outdoor5/DSC04322.JPG,char_data/t/DSC04322.JPG_2.jpg,528,480,640,12,351,363,217,261,True,44
t,41,kaist_dataset/Mixed/Digital_Camera/(C.S)C-outdoor5/DSC04323.JPG,char_data/t/DSC04323.JPG_4.jpg,533,480,640,13,429,442,200,241,True,44
t,41,kaist_dataset/Mixed/Digital_Camera/(C.S)C-outdoor5/DSC04323.JPG,char_data/t/DSC04323.JPG_5.jpg,533,480,640,13,530,543,201,242,True,44
t,36,kaist_dataset/Mixed/Digital_Camera/(C.S)C-outdoor5/DSC04338.JPG,char_data/t/DSC04338.JPG_6.jpg,432,480,640,12,338,350,197,233,True,44
t,40,kaist_dataset/Mixed/Digital_Camera/(C.S)C-outdoor5/DSC04338.JPG,char_data/t/DSC04338.JPG_7.jpg,680,480,640,17,427,444,197,237,True,44
t,38,kaist_dataset/Mixed/Digital_Camera/(C.S)C-outdoor5/DSC04338.JPG,char_data/t/DSC04338.JPG_8.jpg,494,480,640,13,568,581,198,236,True,44
t,25,kaist_dataset/Mixed/Digital_Camera/(C.S)C-outdoor5/DSC04357.JPG,char_data/t/DSC04357.JPG_6.jpg,450,480,640,18,184,202,352,377,True,44
t,26,kaist_dataset/Mixed/Digital_Camera/(C.S)C-outdoor5/DSC04357.JPG,char_data/t/DSC04357.JPG_8.jpg,312,480,640,12,452,464,354,380,True,44
t,114,kaist_dataset/Mixed/Digital_Camera/(C.S)C-outdoor5/DSC04395.JPG,char_data/t/DSC04395.JPG_2.jpg,8208,480,640,72,379,451,150,264,True,44
t,57,kaist_dataset/Mixed/Digital_Camera/(C.S)C-outdoor5/DSC04399.JPG,char_data/t/DSC04399.JPG_2.jpg,1881,480,640,33,585,618,275,332,True,44
t,170,kaist_dataset/Mixed/Digital_Camera/(C.S)C-outdoor6/080116-0057.jpg,char_data/t/080116-0057.jpg_4.jpg,12920,1200,1600,76,1005,1081,543,713,True,44
t,68,kaist_dataset/Mixed/Digital_Camera/(C.S)C-outdoor6/080116-0057.jpg,char_data/t/080116-0057.jpg_5.jpg,2108,1200,1600,31,1231,1262,814,882,True,44
t,37,kaist_dataset/Mixed/Digital_Camera/(C.S)C-outdoor6/P1010048.JPG,char_data/t/P1010048.JPG_2.jpg,703,480,640,19,520,539,169,206,True,44
t,53,kaist_dataset/Mixed/Digital_Camera/(C.S)C-outdoor6/P1010052.JPG,char_data/t/P1010052.JPG_2.jpg,1219,480,640,23,489,512,131,184,True,44
t,115,kaist_dataset/Mixed/Digital_Camera/(C.S)C-outdoor6/P1010093.JPG,char_data/t/P1010093.JPG_4.jpg,8280,480,640,72,430,502,115,230,True,44
t,23,kaist_dataset/Mixed/Digital_Camera/(C.S)C-outdoor6/P1010138.JPG,char_data/t/P1010138.JPG_8.jpg,368,480,640,16,171,187,181,204,True,44
t,35,kaist_dataset/Mixed/Digital_Camera/(C.S)C-outdoor6/크기변환_P1010029.JPG,char_data/t/크기변환_P1010029.JPG_4.jpg,315,480,640,9,143,152,17,52,True,44
t,37,kaist_dataset/Mixed/Digital_Camera/(C.S)C-outdoor6/크기변환_P1010029.JPG,char_data/t/크기변환_P1010029.JPG_5.jpg,333,480,640,9,300,309,13,50,True,44
t,39,kaist_dataset/Mixed/Digital_Camera/(C.S)D-indoor1/082.JPG,char_data/t/082.JPG_2.jpg,585,480,640,15,370,385,182,221,True,44
t,40,kaist_dataset/Mixed/Digital_Camera/(C.S)D-indoor1/DSC02718.JPG,char_data/t/DSC02718.JPG_4.jpg,400,480,640,10,115,125,226,266,True,44
t,37,kaist_dataset/Mixed/Digital_Camera/(C.S)D-indoor1/DSC02718.JPG,char_data/t/DSC02718.JPG_5.jpg,296,480,640,8,195,203,241,278,True,44
t,62,kaist_dataset/Mixed/Digital_Camera/(C.S)D-indoor1/DSC02770.JPG,char_data/t/DSC02770.JPG_4.jpg,1302,480,640,21,281,302,342,404,True,44
t,57,kaist_dataset/Mixed/Digital_Camera/(C.S)D-indoor1/DSC02770.JPG,char_data/t/DSC02770.JPG_5.jpg,1311,480,640,23,414,437,356,413,True,44
t,40,kaist_dataset/Mixed/Digital_Camera/(C.S)D-indoor1/DSC02787.JPG,char_data/t/DSC02787.JPG_7.jpg,280,480,640,7,354,361,364,404,True,44
t,41,kaist_dataset/Mixed/Digital_Camera/(C.S)D-indoor1/DSC02787.JPG,char_data/t/DSC02787.JPG_8.jpg,410,480,640,10,535,545,355,396,True,44
t,39,kaist_dataset/Mixed/Digital_Camera/(C.S)D-indoor1/DSC02804.JPG,char_data/t/DSC02804.JPG_2.jpg,390,480,640,10,289,299,350,389,True,44
t,38,kaist_dataset/Mixed/Digital_Camera/(C.S)D-indoor1/DSC03073.JPG,char_data/t/DSC03073.JPG_2.jpg,684,480,640,18,422,440,335,373,False,44
t,38,kaist_dataset/Mixed/Digital_Camera/(C.S)D-indoor1/DSC03096.JPG,char_data/t/DSC03096.JPG_4.jpg,456,480,640,12,99,111,420,458,False,44
t,34,kaist_dataset/Mixed/Digital_Camera/(C.S)D-indoor1/DSC03096.JPG,char_data/t/DSC03096.JPG_5.jpg,306,480,640,9,557,566,425,459,False,44
t,37,kaist_dataset/Mixed/Digital_Camera/(C.S)D-indoor1/DSC03118.JPG,char_data/t/DSC03118.JPG_7.jpg,555,480,640,15,392,407,152,189,False,44
t,48,kaist_dataset/Mixed/Digital_Camera/(C.S)D-indoor1/DSC03118.JPG,char_data/t/DSC03118.JPG_8.jpg,720,480,640,15,213,228,221,269,False,44
t,51,kaist_dataset/Mixed/Digital_Camera/(C.S)D-indoor1/DSC03123.JPG,char_data/t/DSC03123.JPG_2.jpg,1173,480,640,23,375,398,173,224,False,44
t,45,kaist_dataset/Mixed/Digital_Camera/(C.S)D-indoor1/DSC03132.JPG,char_data/t/DSC03132.JPG_5.jpg,855,480,640,19,211,230,174,219,False,44
t,31,kaist_dataset/Mixed/Digital_Camera/(C.S)D-indoor1/DSC03466.JPG,char_data/t/DSC03466.JPG_2.jpg,465,480,640,15,375,390,235,266,False,44
t,94,kaist_dataset/Mixed/Digital_Camera/(C.S)D-indoor1/DSC03909.JPG,char_data/t/DSC03909.JPG_4.jpg,3572,480,640,38,252,290,187,281,False,44
t,90,kaist_dataset/Mixed/Digital_Camera/(C.S)D-indoor1/DSC03909.JPG,char_data/t/DSC03909.JPG_5.jpg,3420,480,640,38,374,412,189,279,False,44
t,53,kaist_dataset/Mixed/Digital_Camera/(C.S)D-indoor1/DSC03913.JPG,char_data/t/DSC03913.JPG_4.jpg,954,480,640,18,331,349,107,160,False,44
t,54,kaist_dataset/Mixed/Digital_Camera/(C.S)D-indoor1/DSC03913.JPG,char_data/t/DSC03913.JPG_5.jpg,1404,480,640,26,433,459,114,168,False,44
t,36,kaist_dataset/Mixed/Digital_Camera/(C.S)D-indoor1/DSC03953.JPG,char_data/t/DSC03953.JPG_4.jpg,576,480,640,16,267,283,387,423,False,44
t,37,kaist_dataset/Mixed/Digital_Camera/(C.S)D-indoor1/DSC03953.JPG,char_data/t/DSC03953.JPG_5.jpg,444,480,640,12,283,295,386,423,False,44
t,44,kaist_dataset/Mixed/Digital_Camera/(C.S)D-indoor1/DSC04206.JPG,char_data/t/DSC04206.JPG_5.jpg,440,480,640,10,387,397,287,331,False,44
t,42,kaist_dataset/Mixed/Digital_Camera/(C.S)D-indoor1/DSC04244.JPG,char_data/t/DSC04244.JPG_2.jpg,630,480,640,15,249,264,230,272,False,44
t,42,kaist_dataset/Mixed/Digital_Camera/(C.S)D-indoor1/DSC04246.JPG,char_data/t/DSC04246.JPG_4.jpg,546,480,640,13,242,255,245,287,False,44
t,43,kaist_dataset/Mixed/Digital_Camera/(C.S)D-indoor1/DSC04246.JPG,char_data/t/DSC04246.JPG_5.jpg,645,480,640,15,321,336,242,285,False,44
t,35,kaist_dataset/Mixed/Digital_Camera/(C.S)D-indoor2/DSC04254.JPG,char_data/t/DSC04254.JPG_4.jpg,490,480,640,14,416,430,340,375,False,44
t,34,kaist_dataset/Mixed/Digital_Camera/(C.S)D-indoor2/DSC04254.JPG,char_data/t/DSC04254.JPG_5.jpg,510,480,640,15,534,549,338,372,False,44
t,48,kaist_dataset/Mixed/Digital_Camera/(C.S)D-indoor2/DSC04421.JPG,char_data/t/DSC04421.JPG_2.jpg,1200,480,640,25,140,165,211,259,False,44
t,27,kaist_dataset/Mixed/Digital_Camera/(C.S)E-night/DSC02569.JPG,char_data/t/DSC02569.JPG_6.jpg,405,480,640,15,373,388,276,303,False,44
t,31,kaist_dataset/Mixed/Digital_Camera/(C.S)E-night/DSC02569.JPG,char_data/t/DSC02569.JPG_7.jpg,434,480,640,14,429,443,272,303,False,44
t,48,kaist_dataset/Mixed/Digital_Camera/(C.S)E-night/DSC02574.JPG,char_data/t/DSC02574.JPG_4.jpg,864,480,640,18,431,449,148,196,False,44
t,40,kaist_dataset/Mixed/Digital_Camera/(C.S)E-night/DSC02574.JPG,char_data/t/DSC02574.JPG_5.jpg,920,480,640,23,575,598,148,188,False,44
t,123,kaist_dataset/Mixed/Digital_Camera/(C.S)E-night/DSC02586.JPG,char_data/t/DSC02586.JPG_2.jpg,6888,480,640,56,360,416,240,363,False,44
t,20,kaist_dataset/Mixed/Digital_Camera/(C.S)E-night/DSC03516.JPG,char_data/t/DSC03516.JPG_2.jpg,420,480,640,21,124,145,138,158,False,44
t,21,kaist_dataset/Mixed/Digital_Camera/(C.S)F-others/2007-12-08-day-067.jpg,char_data/t/2007-12-08-day-067.jpg_4.jpg,1239,1600,1200,59,440,499,866,887,False,44
t,27,kaist_dataset/Mixed/Digital_Camera/(C.S)F-others/2007-12-08-day-067.jpg,char_data/t/2007-12-08-day-067.jpg_5.jpg,1593,1600,1200,59,430,489,1160,1187,False,44
t,45,kaist_dataset/Mixed/Digital_Camera/(C.S)F-others/DSC02609.JPG,char_data/t/DSC02609.JPG_11.jpg,810,480,640,18,416,434,292,337,False,44
t,74,kaist_dataset/Mixed/Digital_Camera/(C.S)F-others/DSC03489.JPG,char_data/t/DSC03489.JPG_2.jpg,3182,480,640,43,405,448,353,427,False,44
t,81,kaist_dataset/Mixed/Mobile_Phone/(C.M)A-outdoor/P090912037.jpg,char_data/t/P090912037.jpg_2.jpg,3321,480,640,41,274,315,151,232,False,44
t,35,kaist_dataset/Mixed/Mobile_Phone/(C.M)A-outdoor/P090912078.jpg,char_data/t/P090912078.jpg_6.jpg,735,480,640,21,549,570,288,323,False,44
t,39,kaist_dataset/Mixed/Mobile_Phone/(C.M)A-outdoor/P090912078.jpg,char_data/t/P090912078.jpg_7.jpg,741,480,640,19,348,367,296,335,False,44
t,39,kaist_dataset/Mixed/Mobile_Phone/(C.M)A-outdoor/P090912078.jpg,char_data/t/P090912078.jpg_8.jpg,819,480,640,21,390,411,293,332,False,44
t,36,kaist_dataset/Mixed/Mobile_Phone/(C.M)B-indoor/P090831005.jpg,char_data/t/P090831005.jpg_4.jpg,396,480,640,11,152,163,235,271,False,44
t,34,kaist_dataset/Mixed/Mobile_Phone/(C.M)B-indoor/P090831005.jpg,char_data/t/P090831005.jpg_5.jpg,442,480,640,13,232,245,238,272,False,44
t,92,kaist_dataset/Mixed/Mobile_Phone/(C.M)B-indoor/P090831008.jpg,char_data/t/P090831008.jpg_2.jpg,2852,480,640,31,132,163,299,391,False,44
t,45,kaist_dataset/Mixed/Mobile_Phone/(C.M)B-indoor/P090831012.jpg,char_data/t/P090831012.jpg_2.jpg,990,480,640,22,387,409,179,224,False,44
t,56,kaist_dataset/Mixed/Mobile_Phone/(C.M)B-indoor/P090831013.jpg,char_data/t/P090831013.jpg_2.jpg,1064,480,640,19,492,511,190,246,False,44
t,48,kaist_dataset/Mixed/Mobile_Phone/(C.M)B-indoor/P090831014.jpg,char_data/t/P090831014.jpg_2.jpg,912,480,640,19,305,324,166,214,False,44
t,49,kaist_dataset/Mixed/Mobile_Phone/(C.M)B-indoor/P090831015.jpg,char_data/t/P090831015.jpg_5.jpg,1176,480,640,24,363,387,208,257,False,44
t,61,kaist_dataset/Mixed/Mobile_Phone/(C.M)B-indoor/P090831018.jpg,char_data/t/P090831018.jpg_4.jpg,1830,480,640,30,294,324,229,290,False,44
t,56,kaist_dataset/Mixed/Mobile_Phone/(C.M)B-indoor/P090831018.jpg,char_data/t/P090831018.jpg_5.jpg,1568,480,640,28,409,437,231,287,False,44
t,68,kaist_dataset/Mixed/Mobile_Phone/(C.M)B-indoor/P090831019.jpg,char_data/t/P090831019.jpg_4.jpg,2584,480,640,38,277,315,154,222,False,44
t,66,kaist_dataset/Mixed/Mobile_Phone/(C.M)B-indoor/P090831019.jpg,char_data/t/P090831019.jpg_5.jpg,3696,480,640,56,430,486,156,222,False,44
t,45,kaist_dataset/Mixed/Mobile_Phone/(C.M)C-bookCover/P090831080.jpg,char_data/t/P090831080.jpg_4.jpg,1125,480,640,25,303,328,334,379,False,44
t,46,kaist_dataset/Mixed/Mobile_Phone/(C.M)C-bookCover/P090831080.jpg,char_data/t/P090831080.jpg_5.jpg,828,480,640,18,327,345,331,377,False,44
t,35,kaist_dataset/Mixed/Mobile_Phone/(C.M)C-bookCover/P090831118.jpg,char_data/t/P090831118.jpg_4.jpg,595,480,640,17,183,200,220,255,False,44
t,41,kaist_dataset/Mixed/Mobile_Phone/(C.M)C-bookCover/P090831118.jpg,char_data/t/P090831118.jpg_5.jpg,738,480,640,18,313,331,217,258,False,44
t,45,kaist_dataset/Mixed/Mobile_Phone/(C.M)C-bookCover/P090831125.jpg,char_data/t/P090831125.jpg_2.jpg,945,480,640,21,391,412,277,322,False,44
t,35,kaist_dataset/Mixed/Mobile_Phone/(C.M)C-bookCover/P090902016.jpg,char_data/t/P090902016.jpg_4.jpg,525,480,640,15,191,206,273,308,False,44
t,38,kaist_dataset/Mixed/Mobile_Phone/(C.M)C-bookCover/P090902016.jpg,char_data/t/P090902016.jpg_5.jpg,646,480,640,17,246,263,272,310,False,44
t,46,kaist_dataset/Mixed/Mobile_Phone/(C.M)C-bookCover/P090903024.jpg,char_data/t/P090903024.jpg_4.jpg,2070,480,640,45,314,359,50,96,False,44
t,25,kaist_dataset/Mixed/Mobile_Phone/(C.M)C-bookCover/P090903024.jpg,char_data/t/P090903024.jpg_5.jpg,500,480,640,20,544,564,173,198,False,44
t,49,kaist_dataset/Mixed/Mobile_Phone/(C.M)C-bookCover/P090903083.jpg,char_data/t/P090903083.jpg_2.jpg,1568,480,640,32,392,424,171,220,False,44
스,25,kaist_dataset/English/Digital_Camera/(E.S)C-outdoor1/064.JPG,char_data/스/064.JPG_2.jpg,275,480,640,11,89,100,266,291,True,69
스,36,kaist_dataset/English/Digital_Camera/(E.S)C-outdoor1/080119-0020.jpg,char_data/스/080119-0020.jpg_2.jpg,1116,1200,1600,31,1052,1083,645,681,True,69
스,65,kaist_dataset/English/Digital_Camera/(E.S)C-outdoor1/080120-0001.jpg,char_data/스/080120-0001.jpg_2.jpg,4030,1200,1600,62,891,953,348,413,True,69
스,66,kaist_dataset/English/Digital_Camera/(E.S)C-outdoor1/2007-12-09-day-exterior-063.jpg,char_data/스/2007-12-09-day-exterior-063.jpg_2.jpg,2970,1200,1600,45,1111,1156,210,276,True,69
스,83,kaist_dataset/Korean/Digital_Camera/A-shadow/DSC02599.JPG,char_data/스/DSC02599.JPG_2.jpg,6391,480,640,77,22,99,63,146,True,69
스,76,kaist_dataset/Korean/Digital_Camera/A-shadow/DSC03792.JPG,char_data/스/DSC03792.JPG_2.jpg,4332,480,640,57,509,566,262,338,True,69
스,107,kaist_dataset/Korean/Digital_Camera/A-shadow/DSC04298.JPG,char_data/스/DSC04298.JPG_2.jpg,13696,480,640,128,417,545,124,231,True,69
스,63,kaist_dataset/Korean/Digital_Camera/A-shadow/P090911038.jpg,char_data/스/P090911038.jpg_2.jpg,4347,480,640,69,237,306,138,201,True,69
스,110,kaist_dataset/Korean/Digital_Camera/A-shadow/P1010003.JPG,char_data/스/P1010003.JPG_4.jpg,9020,480,640,82,9,91,129,239,True,69
스,103,kaist_dataset/Korean/Digital_Camera/A-shadow/P1010003.JPG,char_data/스/P1010003.JPG_5.jpg,8961,480,640,87,542,629,148,251,True,69
스,44,kaist_dataset/Korean/Digital_Camera/E-night/096.jpg,char_data/스/096.jpg_2.jpg,1320,480,640,30,297,327,330,374,True,69
스,102,kaist_dataset/Korean/Digital_Camera/E-night/DSC02565.JPG,char_data/스/DSC02565.JPG_2.jpg,10506,480,640,103,131,234,322,424,True,69
스,64,kaist_dataset/Korean/Digital_Camera/E-night/DSC02582.JPG,char_data/스/DSC02582.JPG_2.jpg,4224,480,640,66,100,166,152,216,True,69
스,63,kaist_dataset/Korean/Digital_Camera/E-night/DSC02615.JPG,char_data/스/DSC02615.JPG_2.jpg,6111,480,640,97,239,336,399,462,True,69
스,95,kaist_dataset/Korean/Digital_Camera/E-night/DSC02649.JPG,char_data/스/DSC02649.JPG_2.jpg,6745,480,640,71,152,223,294,389,True,69
스,74,kaist_dataset/Korean/Digital_Camera/F-bookCover/DSC02807.JPG,char_data/스/DSC02807.JPG_2.jpg,6438,480,640,87,438,525,352,426,True,69
스,152,kaist_dataset/Korean/Digital_Camera/F-bookCover/DSC02838.JPG,char_data/스/DSC02838.JPG_2.jpg,23864,480,640,157,290,447,27,179,True,69
스,80,kaist_dataset/Korean/Digital_Camera/F-bookCover/DSC04225.JPG,char_data/스/DSC04225.JPG_2.jpg,8160,480,640,102,409,511,83,163,True,69
스,170,kaist_dataset/Korean/Digital_Camera/G-others/2007-12-08-day-112.jpg,char_data/스/2007-12-08-day-112.jpg_4.jpg,38080,1200,1600,224,1010,1234,684,854,True,69
스,146,kaist_dataset/Korean/Digital_Camera/G-others/2007-12-08-day-112.jpg,char_data/스/2007-12-08-day-112.jpg_5.jpg,9198,1200,1600,63,929,992,1048,1194,True,69
스,130,kaist_dataset/Korean/Digital_Camera/G-others/DSC02584.JPG,char_data/스/DSC02584.JPG_2.jpg,27560,480,640,212,181,393,238,368,True,69
스,56,kaist_dataset/Korean/Digital_Camera/indoor1/140.JPG,char_data/스/140.JPG_2.jpg,2240,480,640,40,228,268,261,317,True,69
스,84,kaist_dataset/Korean/Digital_Camera/indoor1/DSC02700.JPG,char_data/스/DSC02700.JPG_2.jpg,5544,480,640,66,202,268,77,161,True,69
스,44,kaist_dataset/Korean/Digital_Camera/indoor1/DSC02704.JPG,char_data/스/DSC02704.JPG_2.jpg,1496,480,640,34,474,508,325,369,True,69
스,56,kaist_dataset/Korean/Digital_Camera/indoor1/DSC02710.JPG,char_data/스/DSC02710.JPG_2.jpg,2856,480,640,51,168,219,400,456,True,69
스,63,kaist_dataset/Korean/Digital_Camera/indoor1/DSC02716.JPG,char_data/스/DSC02716.JPG_2.jpg,3087,480,640,49,232,281,146,209,True,69
스,98,kaist_dataset/Korean/Digital_Camera/indoor1/DSC02720.JPG,char_data/스/DSC02720.JPG_6.jpg,8330,480,640,85,548,633,272,370,True,69
스,63,kaist_dataset/Korean/Digital_Camera/indoor1/DSC02720.JPG,char_data/스/DSC02720.JPG_7.jpg,3402,480,640,54,452,506,78,141,True,69
스,50,kaist_dataset/Korean/Digital_Camera/indoor1/DSC02720.JPG,char_data/스/DSC02720.JPG_8.jpg,1950,480,640,39,260,299,202,252,True,69
스,85,kaist_dataset/Korean/Digital_Camera/indoor1/DSC02723.JPG,char_data/스/DSC02723.JPG_2.jpg,6205,480,640,73,230,303,321,406,True,69
스,97,kaist_dataset/Korean/Digital_Camera/indoor1/DSC02734.JPG,char_data/스/DSC02734.JPG_2.jpg,9215,480,640,95,172,267,238,335,True,69
스,108,kaist_dataset/Korean/Digital_Camera/indoor1/DSC02741.JPG,char_data/스/DSC02741.JPG_2.jpg,11988,480,640,111,430,541,281,389,True,69
스,103,kaist_dataset/Korean/Digital_Camera/indoor1/DSC02757.JPG,char_data/스/DSC02757.JPG_2.jpg,8858,480,640,86,373,459,186,289,True,69
스,81,kaist_dataset/Korean/Digital_Camera/indoor1/DSC02760.JPG,char_data/스/DSC02760.JPG_2.jpg,7695,480,640,95,364,459,202,283,True,69
스,113,kaist_dataset/Korean/Digital_Camera/indoor1/DSC02774.JPG,char_data/스/DSC02774.JPG_2.jpg,12317,480,640,109,430,539,275,388,True,69
스,48,kaist_dataset/Korean/Digital_Camera/indoor1/DSC03113.JPG,char_data/스/DSC03113.JPG_2.jpg,1440,480,640,30,210,240,284,332,True,69
스,62,kaist_dataset/Korean/Digital_Camera/indoor2/DSC03384.JPG,char_data/스/DSC03384.JPG_2.jpg,3534,480,640,57,257,314,311,373,True,69
스,66,kaist_dataset/Korean/Digital_Camera/indoor2/DSC03400.JPG,char_data/스/DSC03400.JPG_2.jpg,4224,480,640,64,208,272,123,189,True,69
스,75,kaist_dataset/Korean/Digital_Camera/indoor2/DSC03473.JPG,char_data/스/DSC03473.JPG_2.jpg,5250,480,640,70,266,336,276,351,True,69
스,80,kaist_dataset/Korean/Digital_Camera/indoor2/DSC03704.JPG,char_data/스/DSC03704.JPG_2.jpg,6320,480,640,79,480,559,224,304,True,69
스,70,kaist_dataset/Korean/Digital_Camera/indoor2/DSC03983.JPG,char_data/스/DSC03983.JPG_2.jpg,4270,480,640,61,290,351,201,271,True,69
스,100,kaist_dataset/Korean/Digital_Camera/indoor2/DSC04001.JPG,char_data/스/DSC04001.JPG_2.jpg,11000,480,640,110,492,602,363,463,True,69
스,53,kaist_dataset/Korean/Digital_Camera/indoor2/DSC04020.JPG,char_data/스/DSC04020.JPG_2.jpg,2332,480,640,44,368,412,191,244,True,69
스,66,kaist_dataset/Korean/Digital_Camera/indoor2/DSC04021.JPG,char_data/스/DSC04021.JPG_2.jpg,3432,480,640,52,372,424,107,173,True,69
스,107,kaist_dataset/Korean/Digital_Camera/indoor2/DSC04178.JPG,char_data/스/DSC04178.JPG_2.jpg,10914,480,640,102,281,383,98,205,True,69
스,78,kaist_dataset/Korean/Digital_Camera/indoor2/DSC04179.JPG,char_data/스/DSC04179.JPG_2.jpg,4134,480,640,53,458,511,141,219,True,69
스,107,kaist_dataset/Korean/Digital_Camera/indoor2/DSC04190.JPG,char_data/스/DSC04190.JPG_2.jpg,11770,480,640,110,256,366,205,312,True,69
스,54,kaist_dataset/Korean/Digital_Camera/indoor2/DSC04204.JPG,char_data/스/DSC04204.JPG_2.jpg,3024,480,640,56,147,203,202,256,True,69
스,90,kaist_dataset/Korean/Digital_Camera/outdoor1/004.JPG,char_data/스/004.JPG_2.jpg,5760,480,640,64,131,195,150,240,True,69
스,30,kaist_dataset/Korean/Digital_Camera/outdoor1/018.JPG,char_data/스/018.JPG_2.jpg,630,480,640,21,514,535,222,252,True,69
스,28,kaist_dataset/Korean/Digital_Camera/outdoor1/019.JPG,char_data/스/019.JPG_2.jpg,560,480,640,20,319,339,261,289,True,69
스,122,kaist_dataset/Korean/Digital_Camera/outdoor1/059.JPG,char_data/스/059.JPG_2.jpg,13664,480,640,112,452,564,176,298,True,69
스,121,kaist_dataset/Korean/Digital_Camera/outdoor1/098.JPG,char_data/스/098.JPG_2.jpg,19118,480,640,158,466,624,193,314,True,69
스,87,kaist_dataset/Korean/Digital_Camera/outdoor1/123.JPG,char_data/스/123.JPG_2.jpg,7047,480,640,81,251,332,163,250,True,69
스,19,kaist_dataset/Korean/Digital_Camera/outdoor1/45.jpg,char_data/스/45.jpg_2.jpg,456,253,373,24,246,270,58,77,True,69
스,304,kaist_dataset/Korean/Digital_Camera/outdoor2/2007-12-08-day-114.jpg,char_data/스/2007-12-08-day-114.jpg_2.jpg,60192,1200,1600,198,1320,1518,376,680,True,69
스,50,kaist_dataset/Korean/Digital_Camera/outdoor2/2007-12-09-day-exterior-006.jpg,char_data/스/2007-12-09-day-exterior-006.jpg_4.jpg,2000,1200,1600,40,84,124,577,627,True,69
스,264,kaist_dataset/Korean/Digital_Camera/outdoor2/2007-12-09-day-exterior-006.jpg,char_data/스/2007-12-09-day-exterior-006.jpg_5.jpg,88968,1200,1600,337,677,1014,343,607,True,69
스,85,kaist_dataset/Korean/Digital_Camera/outdoor2/DSC02300.JPG,char_data/스/DSC02300.JPG_2.jpg,9180,480,640,108,289,397,283,368,True,69
스,24,kaist_dataset/Korean/Digital_Camera/outdoor2/DSC02302.JPG,char_data/스/DSC02302.JPG_4.jpg,600,480,640,25,67,92,358,382,True,69
스,97,kaist_dataset/Korean/Digital_Camera/outdoor2/DSC02302.JPG,char_data/스/DSC02302.JPG_5.jpg,9215,480,640,95,348,443,281,378,True,69
스,65,kaist_dataset/Korean/Digital_Camera/outdoor2/DSC02386.JPG,char_data/스/DSC02386.JPG_4.jpg,3575,480,640,55,65,120,175,240,True,69
스,69,kaist_dataset/Korean/Digital_Camera/outdoor2/DSC02386.JPG,char_data/스/DSC02386.JPG_5.jpg,4347,480,640,63,569,632,139,208,True,69
스,88,kaist_dataset/Korean/Digital_Camera/outdoor2/DSC02390.JPG,char_data/스/DSC02390.JPG_2.jpg,12584,480,640,143,325,468,253,341,True,69
스,40,kaist_dataset/Korean/Digital_Camera/outdoor2/DSC02396.JPG,char_data/스/DSC02396.JPG_2.jpg,1080,480,640,27,206,233,368,408,True,69
스,115,kaist_dataset/Korean/Digital_Camera/outdoor2/DSC02420.JPG,char_data/스/DSC02420.JPG_2.jpg,14145,480,640,123,237,360,117,232,True,69
스,56,kaist_dataset/Korean/Digital_Camera/outdoor2/DSC02441.JPG,char_data/스/DSC02441.JPG_4.jpg,2744,480,640,49,109,158,109,165,True,69
스,53,kaist_dataset/Korean/Digital_Camera/outdoor2/DSC02441.JPG,char_data/스/DSC02441.JPG_5.jpg,2120,480,640,40,535,575,117,170,True,69
스,35,kaist_dataset/Korean/Digital_Camera/outdoor2/DSC02453.JPG,char_data/스/DSC02453.JPG_2.jpg,1155,480,640,33,507,540,235,270,True,69
스,68,kaist_dataset/Korean/Digital_Camera/outdoor2/DSC02463.JPG,char_data/스/DSC02463.JPG_2.jpg,3604,480,640,53,428,481,205,273,True,69
스,53,kaist_dataset/Korean/Digital_Camera/outdoor2/DSC02506.JPG,char_data/스/DSC02506.JPG_2.jpg,2120,480,640,40,223,263,95,148,True,69
스,65,kaist_dataset/Korean/Digital_Camera/outdoor2/DSC02515.JPG,char_data/스/DSC02515.JPG_2.jpg,5395,480,640,83,277,360,99,164,True,69
스,123,kaist_dataset/Korean/Digital_Camera/outdoor2/DSC02522.JPG,char_data/스/DSC02522.JPG_2.jpg,13530,480,640,110,207,317,293,416,True,69
스,114,kaist_dataset/Korean/Digital_Camera/outdoor2/DSC02523.JPG,char_data/스/DSC02523.JPG_2.jpg,14934,480,640,131,92,223,220,334,True,69
스,24,kaist_dataset/Korean/Digital_Camera/outdoor3/DSC02562.JPG,char_data/스/DSC02562.JPG_2.jpg,864,480,640,36,432,468,159,183,True,69
스,78,kaist_dataset/Korean/Digital_Camera/outdoor3/DSC02686.JPG,char_data/스/DSC02686.JPG_4.jpg,5226,480,640,67,360,427,107,185,True,69
스,44,kaist_dataset/Korean/Digital_Camera/outdoor3/DSC02686.JPG,char_data/스/DSC02686.JPG_5.jpg,1760,480,640,40,313,353,50,94,True,69
스,83,kaist_dataset/Korean/Digital_Camera/outdoor3/DSC02702.JPG,char_data/스/DSC02702.JPG_2.jpg,6806,480,640,82,272,354,348,431,True,69
스,82,kaist_dataset/Korean/Digital_Camera/outdoor3/DSC02891.JPG,char_data/스/DSC02891.JPG_2.jpg,6642,480,640,81,142,223,208,290,True,69
스,85,kaist_dataset/Korean/Digital_Camera/outdoor3/DSC02908.JPG,char_data/스/DSC02908.JPG_2.jpg,8670,480,640,102,393,495,219,304,True,69
스,61,kaist_dataset/Korean/Digital_Camera/outdoor3/DSC02934.JPG,char_data/스/DSC02934.JPG_2.jpg,4148,480,640,68,360,428,61,122,True,69
스,68,kaist_dataset/Korean/Digital_Camera/outdoor3/DSC02939.JPG,char_data/스/DSC02939.JPG_2.jpg,5848,480,640,86,381,467,291,359,True,69
스,94,kaist_dataset/Korean/Digital_Camera/outdoor3/DSC02991.JPG,char_data/스/DSC02991.JPG_2.jpg,7708,480,640,82,559,639,182,276,True,69
스,75,kaist_dataset/Korean/Digital_Camera/outdoor3/DSC02999.JPG,char_data/스/DSC02999.JPG_2.jpg,4725,480,640,63,267,330,46,121,True,69
스,41,kaist_dataset/Korean/Digital_Camera/outdoor3/DSC03059.JPG,char_data/스/DSC03059.JPG_2.jpg,1353,480,640,33,461,494,165,206,True,69
스,84,kaist_dataset/Korean/Digital_Camera/outdoor3/DSC03158.JPG,char_data/스/DSC03158.JPG_2.jpg,5376,480,640,64,415,479,90,174,True,69
스,68,kaist_dataset/Korean/Digital_Camera/outdoor3/DSC03195.JPG,char_data/스/DSC03195.JPG_2.jpg,4488,480,640,66,428,494,175,243,True,69
스,31,kaist_dataset/Korean/Digital_Camera/outdoor3/DSC03232.JPG,char_data/스/DSC03232.JPG_2.jpg,899,480,640,29,467,496,274,305,True,69
스,51,kaist_dataset/Korean/Digital_Camera/outdoor4/DSC03325.JPG,char_data/스/DSC03325.JPG_2.jpg,3162,480,640,62,526,588,213,264,True,69
스,66,kaist_dataset/Korean/Digital_Camera/outdoor4/DSC03326.JPG,char_data/스/DSC03326.JPG_2.jpg,5214,480,640,79,262,341,190,256,True,69
스,119,kaist_dataset/Korean/Digital_Camera/outdoor4/DSC03404.JPG,char_data/스/DSC03404.JPG_2.jpg,13685,480,640,115,237,352,124,243,True,69
스,87,kaist_dataset/Korean/Digital_Camera/outdoor4/DSC03448.JPG,char_data/스/DSC03448.JPG_2.jpg,8613,480,640,99,159,258,327,414,True,69
스,37,kaist_dataset/Korean/Digital_Camera/outdoor4/DSC03573.JPG,char_data/스/DSC03573.JPG_2.jpg,2109,480,640,57,318,375,155,192,True,69
스,150,kaist_dataset/Korean/Digital_Camera/outdoor5/DSC03671.JPG,char_data/스/DSC03671.JPG_2.jpg,13500,480,640,90,254,344,255,405,True,69
스,101,kaist_dataset/Korean/Digital_Camera/outdoor5/DSC03680.JPG,char_data/스/DSC03680.JPG_2.jpg,12120,480,640,120,23,143,169,270,True,69
스,61,kaist_dataset/Korean/Digital_Camera/outdoor5/DSC03690.JPG,char_data/스/DSC03690.JPG_2.jpg,3355,480,640,55,425,480,178,239,True,69
스,79,kaist_dataset/Korean/Digital_Camera/outdoor5/DSC03708.JPG,char_data/스/DSC03708.JPG_2.jpg,7031,480,640,89,466,555,154,233,True,69
스,66,kaist_dataset/Korean/Digital_Camera/outdoor5/DSC03736.JPG,char_data/스/DSC03736.JPG_2.jpg,3828,480,640,58,300,358,251,317,True,69
스,152,kaist_dataset/Korean/Digital_Camera/outdoor5/DSC03742.JPG,char_data/스/DSC03742.JPG_2.jpg,19760,480,640,130,302,432,181,333,True,69
스,86,kaist_dataset/Korean/Digital_Camera/outdoor5/DSC03760.JPG,char_data/스/DSC03760.JPG_2.jpg,6536,480,640,76,385,461,179,265,True,69
스,74,kaist_dataset/Korean/Digital_Camera/outdoor5/DSC03854.JPG,char_data/스/DSC03854.JPG_2.jpg,6068,480,640,82,456,538,67,141,True,69
스,66,kaist_dataset/Korean/Digital_Camera/outdoor5/DSC03856.JPG,char_data/스/DSC03856.JPG_2.jpg,7326,480,640,111,460,571,77,143,True,69
스,57,kaist_dataset/Korean/Digital_Camera/outdoor5/DSC03979.JPG,char_data/스/DSC03979.JPG_2.jpg,4845,480,640,85,212,297,317,374,True,69
스,116,kaist_dataset/Korean/Digital_Camera/outdoor6/DSC04043.JPG,char_data/스/DSC04043.JPG_4.jpg,11252,480,640,97,222,319,86,202,True,69
스,54,kaist_dataset/Korean/Digital_Camera/outdoor6/DSC04043.JPG,char_data/스/DSC04043.JPG_5.jpg,1242,480,640,23,101,124,212,266,True,69
스,70,kaist_dataset/Korean/Digital_Camera/outdoor6/DSC04049.JPG,char_data/스/DSC04049.JPG_2.jpg,4760,480,640,68,433,501,121,191,True,69
스,67,kaist_dataset/Korean/Digital_Camera/outdoor6/DSC04084.JPG,char_data/스/DSC04084.JPG_2.jpg,5025,480,640,75,449,524,190,257,True,69
스,47,kaist_dataset/Korean/Digital_Camera/outdoor6/DSC04137.JPG,char_data/스/DSC04137.JPG_2.jpg,3055,480,640,65,214,279,403,450,True,69
스,152,kaist_dataset/Korean/Digital_Camera/outdoor6/DSC04301.JPG,char_data/스/DSC04301.JPG_2.jpg,11400,480,640,75,435,510,168,320,True,69
스,77,kaist_dataset/Korean/Digital_Camera/outdoor6/DSC04317.JPG,char_data/스/DSC04317.JPG_2.jpg,5544,480,640,72,413,485,166,243,True,69
스,104,kaist_dataset/Korean/Digital_Camera/outdoor6/DSC04350.JPG,char_data/스/DSC04350.JPG_2.jpg,4992,480,640,48,138,186,310,414,True,69
스,130,kaist_dataset/Korean/Digital_Camera/outdoor6/DSC04370.JPG,char_data/스/DSC04370.JPG_2.jpg,8060,480,640,62,422,484,159,289,True,69
스,102,kaist_dataset/Korean/Digital_Camera/outdoor6/DSC04441.JPG,char_data/스/DSC04441.JPG_2.jpg,8874,480,640,87,430,517,41,143,True,69
스,77,kaist_dataset/Korean/Digital_Camera/outdoor7/DSC04454.JPG,char_data/스/DSC04454.JPG_4.jpg,4004,480,640,52,245,297,392,469,True,69
스,71,kaist_dataset/Korean/Digital_Camera/outdoor7/DSC04454.JPG,char_data/스/DSC04454.JPG_5.jpg,5325,480,640,75,165,240,301,372,True,69
스,75,kaist_dataset/Korean/Digital_Camera/outdoor7/P1010013.JPG,char_data/스/P1010013.JPG_2.jpg,3600,480,640,48,509,557,107,182,True,69
스,28,kaist_dataset/Korean/Digital_Camera/outdoor7/P1010045.JPG,char_data/스/P1010045.JPG_4.jpg,1064,480,640,38,253,291,31,59,True,69
스,88,kaist_dataset/Korean/Digital_Camera/outdoor7/P1010050.JPG,char_data/스/P1010050.JPG_2.jpg,8800,480,640,100,181,281,107,195,True,69
스,131,kaist_dataset/Korean/Digital_Camera/outdoor7/P1010079.JPG,char_data/스/P1010079.JPG_2.jpg,17423,480,640,133,482,615,51,182,True,69
스,93,"kaist_dataset/Korean/Mobile_Phone/(M,K)B-light/P090911072.jpg",char_data/스/P090911072.jpg_2.jpg,7440,480,640,80,309,389,214,307,True,69
스,77,"kaist_dataset/Korean/Mobile_Phone/(M,K)D-indoor/P090911062.jpg",char_data/스/P090911062.jpg_2.jpg,6314,480,640,82,33,115,211,288,True,69
스,47,"kaist_dataset/Korean/Mobile_Phone/(M,K)D-indoor/P090911068.jpg",char_data/스/P090911068.jpg_2.jpg,2162,480,640,46,36,82,146,193,True,69
스,46,"kaist_dataset/Korean/Mobile_Phone/(M,K)E-bookCover/P090831056.jpg",char_data/스/P090831056.jpg_2.jpg,1518,480,640,33,174,207,308,354,True,69
스,51,"kaist_dataset/Korean/Mobile_Phone/(M,K)E-bookCover/P090831103.jpg",char_data/스/P090831103.jpg_8.jpg,1428,480,640,28,72,100,186,237,True,69
스,47,"kaist_dataset/Korean/Mobile_Phone/(M,K)E-bookCover/P090831103.jpg",char_data/스/P090831103.jpg_9.jpg,1034,480,640,22,126,148,190,237,True,69
스,72,"kaist_dataset/Korean/Mobile_Phone/(M,K)E-bookCover/P090831103.jpg",char_data/스/P090831103.jpg_10.jpg,5616,480,640,78,181,259,51,123,True,69
스,80,"kaist_dataset/Korean/Mobile_Phone/(M,K)E-bookCover/P090831103.jpg",char_data/스/P090831103.jpg_11.jpg,5760,480,640,72,323,395,41,121,True,69
스,107,"kaist_dataset/Korean/Mobile_Phone/(M,K)E-bookCover/P090903014.jpg",char_data/스/P090903014.jpg_2.jpg,10165,480,640,95,407,502,183,290,True,69
스,99,"kaist_dataset/Korean/Mobile_Phone/(M,K)E-bookCover/P090903020.jpg",char_data/스/P090903020.jpg_2.jpg,9207,480,640,93,357,450,188,287,True,69
스,158,"kaist_dataset/Korean/Mobile_Phone/(M,K)E-bookCover/P090903021.jpg",char_data/스/P090903021.jpg_2.jpg,26228,480,640,166,374,540,115,273,True,69
스,91,"kaist_dataset/Korean/Mobile_Phone/(M,K)E-bookCover/P090903025.jpg",char_data/스/P090903025.jpg_2.jpg,9555,480,640,105,295,400,65,156,True,69
스,100,"kaist_dataset/Korean/Mobile_Phone/(M,K)E-bookCover/P090903084.jpg",char_data/스/P090903084.jpg_2.jpg,14200,480,640,142,419,561,231,331,True,69
스,94,"kaist_dataset/Korean/Mobile_Phone/(M,K)E-bookCover/P090903085.jpg",char_data/스/P090903085.jpg_2.jpg,10246,480,640,109,466,575,230,324,True,69
스,126,"kaist_dataset/Korean/Mobile_Phone/(M,K)E-bookCover/P090903087.jpg",char_data/스/P090903087.jpg_2.jpg,15624,480,640,124,86,210,64,190,True,69
스,63,"kaist_dataset/Korean/Mobile_Phone/(M,K)E-bookCover/P090911001.jpg",char_data/스/P090911001.jpg_2.jpg,3654,480,640,58,268,326,34,97,True,69
스,67,"kaist_dataset/Korean/Mobile_Phone/(M,K)E-bookCover/P090911006.jpg",char_data/스/P090911006.jpg_2.jpg,4623,480,640,69,216,285,36,103,True,69
스,130,"kaist_dataset/Korean/Mobile_Phone/(M,K)E-bookCover/P090911052.jpg",char_data/스/P090911052.jpg_2.jpg,13650,480,640,105,522,627,101,231,True,69
스,89,"kaist_dataset/Korean/Mobile_Phone/(M,K)E-bookCover/P090911059.jpg",char_data/스/P090911059.jpg_2.jpg,9078,480,640,102,418,520,124,213,True,69
스,50,kaist_dataset/Mixed/Digital_Camera/(C.S)A-shadow/DSC03845.JPG,char_data/스/DSC03845.JPG_2.jpg,1900,480,640,38,413,451,145,195,True,69
스,69,kaist_dataset/Mixed/Digital_Camera/(C.S)A-shadow/DSC04326.JPG,char_data/스/DSC04326.JPG_2.jpg,4071,480,640,59,207,266,14,83,True,69
스,66,kaist_dataset/Mixed/Digital_Camera/(C.S)B-light/P090911079.jpg,char_data/스/P090911079.jpg_2.jpg,4422,480,640,67,348,415,272,338,True,69
스,24,kaist_dataset/Mixed/Digital_Camera/(C.S)C-outdoor1/014.JPG,char_data/스/014.JPG_2.jpg,504,480,640,21,513,534,278,302,True,69
스,30,kaist_dataset/Mixed/Digital_Camera/(C.S)C-outdoor1/027.JPG,char_data/스/027.JPG_2.jpg,450,480,640,15,202,217,270,300,True,69
스,33,kaist_dataset/Mixed/Digital_Camera/(C.S)C-outdoor1/038.JPG,char_data/스/038.JPG_2.jpg,891,480,640,27,315,342,312,345,True,69
스,82,kaist_dataset/Mixed/Digital_Camera/(C.S)C-outdoor1/048.JPG,char_data/스/048.JPG_2.jpg,5904,480,640,72,522,594,164,246,True,69
스,34,kaist_dataset/Mixed/Digital_Camera/(C.S)C-outdoor1/080.JPG,char_data/스/080.JPG_6.jpg,1632,480,640,48,484,532,88,122,True,69
스,30,kaist_dataset/Mixed/Digital_Camera/(C.S)C-outdoor1/080.JPG,char_data/스/080.JPG_7.jpg,1320,480,640,44,554,598,128,158,True,69
스,71,kaist_dataset/Mixed/Digital_Camera/(C.S)C-outdoor1/080.JPG,char_data/스/080.JPG_8.jpg,4615,480,640,65,425,490,200,271,True,69
스,125,kaist_dataset/Mixed/Digital_Camera/(C.S)C-outdoor1/080118-0014.jpg,char_data/스/080118-0014.jpg_4.jpg,15125,1200,1600,121,414,535,1017,1142,True,69
스,126,kaist_dataset/Mixed/Digital_Camera/(C.S)C-outdoor1/080118-0014.jpg,char_data/스/080118-0014.jpg_5.jpg,13104,1200,1600,104,671,775,1019,1145,True,69
스,23,kaist_dataset/Mixed/Digital_Camera/(C.S)C-outdoor1/090.JPG,char_data/스/090.JPG_4.jpg,368,480,640,16,74,90,316,339,True,69
스,127,kaist_dataset/Mixed/Digital_Camera/(C.S)C-outdoor1/090.JPG,char_data/스/090.JPG_5.jpg,11303,480,640,89,254,343,175,302,True,69
스,78,kaist_dataset/Mixed/Digital_Camera/(C.S)C-outdoor1/112.JPG,char_data/스/112.JPG_2.jpg,5772,480,640,74,306,380,169,247,True,69
스,50,kaist_dataset/Mixed/Digital_Camera/(C.S)C-outdoor1/119.JPG,char_data/스/119.JPG_2.jpg,1800,480,640,36,307,343,191,241,True,69
스,81,kaist_dataset/Mixed/Digital_Camera/(C.S)C-outdoor1/133.JPG,char_data/스/133.JPG_2.jpg,5508,480,640,68,420,488,201,282,True,69
스,115,kaist_dataset/Mixed/Digital_Camera/(C.S)C-outdoor1/2007-12-08-day-118.jpg,char_data/스/2007-12-08-day-118.jpg_2.jpg,11155,1200,1600,97,502,599,700,815,True,69
스,257,kaist_dataset/Mixed/Digital_Camera/(C.S)C-outdoor1/2007-12-09-day-exterior-044.jpg,char_data/스/2007-12-09-day-exterior-044.jpg_2.jpg,76329,1200,1600,297,676,973,465,722,True,69
스,33,kaist_dataset/Mixed/Digital_Camera/(C.S)C-outdoor1/3.JPG,char_data/스/3.JPG_4.jpg,858,576,768,26,5,31,82,115,True,69
스,25,kaist_dataset/Mixed/Digital_Camera/(C.S)C-outdoor1/3.JPG,char_data/스/3.JPG_5.jpg,450,576,768,18,381,399,292,317,True,69
스,15,kaist_dataset/Mixed/Digital_Camera/(C.S)C-outdoor1/55.JPG,char_data/스/55.JPG_2.jpg,315,576,768,21,504,525,231,246,True,69
스,42,kaist_dataset/Mixed/Digital_Camera/(C.S)C-outdoor1/DSC02240.JPG,char_data/스/DSC02240.JPG_2.jpg,882,480,640,21,493,514,290,332,True,69
스,33,kaist_dataset/Mixed/Digital_Camera/(C.S)C-outdoor1/DSC02242.JPG,char_data/스/DSC02242.JPG_2.jpg,693,480,640,21,450,471,263,296,True,69
스,38,kaist_dataset/Mixed/Digital_Camera/(C.S)C-outdoor1/DSC02344.JPG,char_data/스/DSC02344.JPG_2.jpg,1520,480,640,40,315,355,247,285,True,69
스,39,kaist_dataset/Mixed/Digital_Camera/(C.S)C-outdoor1/P1010009.JPG,char_data/스/P1010009.JPG_2.jpg,1443,480,640,37,571,608,247,286,True,69
스,80,kaist_dataset/Mixed/Digital_Camera/(C.S)C-outdoor2/DSC02382.JPG,char_data/스/DSC02382.JPG_2.jpg,4880,480,640,61,201,262,238,318,True,69
스,93,kaist_dataset/Mixed/Digital_Camera/(C.S)C-outdoor2/DSC02416.JPG,char_data/스/DSC02416.JPG_2.jpg,12834,480,640,138,463,601,98,191,True,69
스,45,kaist_dataset/Mixed/Digital_Camera/(C.S)C-outdoor2/DSC02418.JPG,char_data/스/DSC02418.JPG_2.jpg,1665,480,640,37,219,256,272,317,True,69
스,69,kaist_dataset/Mixed/Digital_Camera/(C.S)C-outdoor2/DSC02421.JPG,char_data/스/DSC02421.JPG_2.jpg,6486,480,640,94,502,596,124,193,True,69
스,109,kaist_dataset/Mixed/Digital_Camera/(C.S)C-outdoor2/DSC02430.JPG,char_data/스/DSC02430.JPG_6.jpg,17440,480,640,160,21,181,54,163,True,69
스,33,kaist_dataset/Mixed/Digital_Camera/(C.S)C-outdoor2/DSC02430.JPG,char_data/스/DSC02430.JPG_7.jpg,990,480,640,30,236,266,182,215,True,69
스,36,kaist_dataset/Mixed/Digital_Camera/(C.S)C-outdoor2/DSC02430.JPG,char_data/스/DSC02430.JPG_8.jpg,1080,480,640,30,497,527,307,343,True,69
스,60,kaist_dataset/Mixed/Digital_Camera/(C.S)C-outdoor2/DSC02479.JPG,char_data/스/DSC02479.JPG_2.jpg,6780,480,640,113,432,545,161,221,True,69
스,76,kaist_dataset/Mixed/Digital_Camera/(C.S)C-outdoor2/DSC02527.JPG,char_data/스/DSC02527.JPG_2.jpg,4484,480,640,59,326,385,137,213,True,69
스,131,kaist_dataset/Mixed/Digital_Camera/(C.S)C-outdoor2/DSC02532.JPG,char_data/스/DSC02532.JPG_2.jpg,17030,480,640,130,195,325,199,330,True,69
스,66,kaist_dataset/Mixed/Digital_Camera/(C.S)C-outdoor2/DSC02545.JPG,char_data/스/DSC02545.JPG_2.jpg,3762,480,640,57,93,150,301,367,True,69
스,82,kaist_dataset/Mixed/Digital_Camera/(C.S)C-outdoor2/DSC02701.JPG,char_data/스/DSC02701.JPG_2.jpg,6150,480,640,75,504,579,202,284,True,69
스,61,kaist_dataset/Mixed/Digital_Camera/(C.S)C-outdoor2/DSC02886.JPG,char_data/스/DSC02886.JPG_2.jpg,3233,480,640,53,547,600,63,124,True,69
스,69,kaist_dataset/Mixed/Digital_Camera/(C.S)C-outdoor2/DSC02919.JPG,char_data/스/DSC02919.JPG_2.jpg,5934,480,640,86,348,434,74,143,True,69
스,45,kaist_dataset/Mixed/Digital_Camera/(C.S)C-outdoor2/DSC02930.JPG,char_data/스/DSC02930.JPG_2.jpg,1980,480,640,44,153,197,138,183,True,69
스,36,kaist_dataset/Mixed/Digital_Camera/(C.S)C-outdoor2/DSC02954.JPG,char_data/스/DSC02954.JPG_2.jpg,1152,480,640,32,366,398,111,147,True,69
스,50,kaist_dataset/Mixed/Digital_Camera/(C.S)C-outdoor3/DSC02958.JPG,char_data/스/DSC02958.JPG_2.jpg,2350,480,640,47,104,151,320,370,True,69
스,63,kaist_dataset/Mixed/Digital_Camera/(C.S)C-outdoor3/DSC02964.JPG,char_data/스/DSC02964.JPG_2.jpg,3150,480,640,50,403,453,84,147,True,69
스,63,kaist_dataset/Mixed/Digital_Camera/(C.S)C-outdoor3/DSC02989.JPG,char_data/스/DSC02989.JPG_2.jpg,1827,480,640,29,235,264,332,395,True,69
스,96,kaist_dataset/Mixed/Digital_Camera/(C.S)C-outdoor3/DSC03048.JPG,char_data/스/DSC03048.JPG_2.jpg,8160,480,640,85,185,270,31,127,True,69
스,42,kaist_dataset/Mixed/Digital_Camera/(C.S)C-outdoor3/DSC03051.JPG,char_data/스/DSC03051.JPG_2.jpg,1554,480,640,37,331,368,70,112,True,69
스,52,kaist_dataset/Mixed/Digital_Camera/(C.S)C-outdoor3/DSC03196.JPG,char_data/스/DSC03196.JPG_2.jpg,1768,480,640,34,399,433,390,442,True,69
스,50,kaist_dataset/Mixed/Digital_Camera/(C.S)C-outdoor3/DSC03233.JPG,char_data/스/DSC03233.JPG_2.jpg,3200,480,640,64,254,318,272,322,True,69
스,78,kaist_dataset/Mixed/Digital_Camera/(C.S)C-outdoor3/DSC03245.JPG,char_data/스/DSC03245.JPG_2.jpg,5850,480,640,75,251,326,362,440,True,69
스,91,kaist_dataset/Mixed/Digital_Camera/(C.S)C-outdoor3/DSC03247.JPG,char_data/스/DSC03247.JPG_4.jpg,6097,480,640,67,214,281,233,324,True,69
스,83,kaist_dataset/Mixed/Digital_Camera/(C.S)C-outdoor3/DSC03247.JPG,char_data/스/DSC03247.JPG_5.jpg,6142,480,640,74,532,606,271,354,True,69
스,38,kaist_dataset/Mixed/Digital_Camera/(C.S)C-outdoor3/DSC03259.JPG,char_data/스/DSC03259.JPG_2.jpg,988,480,640,26,208,234,352,390,True,69
스,86,kaist_dataset/Mixed/Digital_Camera/(C.S)C-outdoor3/DSC03271.JPG,char_data/스/DSC03271.JPG_2.jpg,7482,480,640,87,386,473,206,292,True,69
스,96,kaist_dataset/Mixed/Digital_Camera/(C.S)C-outdoor3/DSC03274.JPG,char_data/스/DSC03274.JPG_2.jpg,7776,480,640,81,189,270,256,352,True,69
스,120,kaist_dataset/Mixed/Digital_Camera/(C.S)C-outdoor3/DSC03421.JPG,char_data/스/DSC03421.JPG_2.jpg,11400,480,640,95,306,401,341,461,True,69
스,38,kaist_dataset/Mixed/Digital_Camera/(C.S)C-outdoor4/DSC03519.JPG,char_data/스/DSC03519.JPG_2.jpg,1672,480,640,44,392,436,425,463,True,69
스,47,kaist_dataset/Mixed/Digital_Camera/(C.S)C-outdoor4/DSC03571.JPG,char_data/스/DSC03571.JPG_2.jpg,1645,480,640,35,242,277,305,352,True,69
스,58,kaist_dataset/Mixed/Digital_Camera/(C.S)C-outdoor4/DSC03651.JPG,char_data/스/DSC03651.JPG_2.jpg,3248,480,640,56,278,334,276,334,True,69
스,43,kaist_dataset/Mixed/Digital_Camera/(C.S)C-outdoor4/DSC03678.JPG,char_data/스/DSC03678.JPG_2.jpg,1462,480,640,34,92,126,185,228,True,69
스,106,kaist_dataset/Mixed/Digital_Camera/(C.S)C-outdoor4/DSC03711.JPG,char_data/스/DSC03711.JPG_2.jpg,6996,480,640,66,443,509,234,340,True,69
스,90,kaist_dataset/Mixed/Digital_Camera/(C.S)C-outdoor4/DSC03716.JPG,char_data/스/DSC03716.JPG_2.jpg,7740,480,640,86,487,573,127,217,True,69
스,36,kaist_dataset/Mixed/Digital_Camera/(C.S)C-outdoor4/DSC03733.JPG,char_data/스/DSC03733.JPG_4.jpg,936,480,640,26,400,426,284,320,True,69
스,38,kaist_dataset/Mixed/Digital_Camera/(C.S)C-outdoor4/DSC03733.JPG,char_data/스/DSC03733.JPG_5.jpg,1140,480,640,30,478,508,282,320,True,69
스,67,kaist_dataset/Mixed/Digital_Camera/(C.S)C-outdoor4/DSC03741.JPG,char_data/스/DSC03741.JPG_2.jpg,3551,480,640,53,169,222,289,356,True,69
스,114,kaist_dataset/Mixed/Digital_Camera/(C.S)C-outdoor4/DSC03785.JPG,char_data/스/DSC03785.JPG_2.jpg,7866,480,640,69,349,418,239,353,True,69
스,45,kaist_dataset/Mixed/Digital_Camera/(C.S)C-outdoor5/DSC03837.JPG,char_data/스/DSC03837.JPG_6.jpg,1395,480,640,31,138,169,370,415,True,69
스,64,kaist_dataset/Mixed/Digital_Camera/(C.S)C-outdoor5/DSC03837.JPG,char_data/스/DSC03837.JPG_7.jpg,3968,480,640,62,177,239,77,141,True,69
스,63,kaist_dataset/Mixed/Digital_Camera/(C.S)C-outdoor5/DSC03837.JPG,char_data/스/DSC03837.JPG_8.jpg,3969,480,640,63,242,305,82,145,True,69
스,47,kaist_dataset/Mixed/Digital_Camera/(C.S)C-outdoor5/DSC03842.JPG,char_data/스/DSC03842.JPG_4.jpg,1269,480,640,27,270,297,137,184,True,69
스,41,kaist_dataset/Mixed/Digital_Camera/(C.S)C-outdoor5/DSC03842.JPG,char_data/스/DSC03842.JPG_5.jpg,1148,480,640,28,301,329,142,183,True,69
스,49,kaist_dataset/Mixed/Digital_Camera/(C.S)C-outdoor5/DSC04014.JPG,char_data/스/DSC04014.JPG_2.jpg,2058,480,640,42,394,436,240,289,True,69
스,85,kaist_dataset/Mixed/Digital_Camera/(C.S)C-outdoor5/DSC04056.JPG,char_data/스/DSC04056.JPG_2.jpg,5015,480,640,59,356,415,327,412,True,69
스,82,kaist_dataset/Mixed/Digital_Camera/(C.S)C-outdoor5/DSC04063.JPG,char_data/스/DSC04063.JPG_4.jpg,2378,480,640,29,230,259,259,341,True,69
스,53,kaist_dataset/Mixed/Digital_Camera/(C.S)C-outdoor5/DSC04063.JPG,char_data/스/DSC04063.JPG_5.jpg,1113,480,640,21,549,570,297,350,True,69
스,68,kaist_dataset/Mixed/Digital_Camera/(C.S)C-outdoor5/DSC04065.JPG,char_data/스/DSC04065.JPG_2.jpg,4216,480,640,62,363,425,120,188,True,69
스,72,kaist_dataset/Mixed/Digital_Camera/(C.S)C-outdoor5/DSC04072.JPG,char_data/스/DSC04072.JPG_2.jpg,4032,480,640,56,118,174,224,296,True,69
스,82,kaist_dataset/Mixed/Digital_Camera/(C.S)C-outdoor5/DSC04078.JPG,char_data/스/DSC04078.JPG_2.jpg,6888,480,640,84,334,418,282,364,True,69
스,40,kaist_dataset/Mixed/Digital_Camera/(C.S)C-outdoor5/DSC04109.JPG,char_data/스/DSC04109.JPG_2.jpg,1600,480,640,40,395,435,130,170,False,69
스,108,kaist_dataset/Mixed/Digital_Camera/(C.S)C-outdoor5/DSC04135.JPG,char_data/스/DSC04135.JPG_2.jpg,3672,480,640,34,518,552,271,379,False,69
스,34,kaist_dataset/Mixed/Digital_Camera/(C.S)C-outdoor5/DSC04151.JPG,char_data/스/DSC04151.JPG_2.jpg,850,480,640,25,524,549,210,244,False,69
스,51,kaist_dataset/Mixed/Digital_Camera/(C.S)C-outdoor5/DSC04349.JPG,char_data/스/DSC04349.JPG_2.jpg,1938,480,640,38,562,600,314,365,False,69
스,55,kaist_dataset/Mixed/Digital_Camera/(C.S)C-outdoor5/DSC04395.JPG,char_data/스/DSC04395.JPG_2.jpg,2750,480,640,50,124,174,416,471,False,69
스,75,kaist_dataset/Mixed/Digital_Camera/(C.S)C-outdoor5/DSC04429.JPG,char_data/스/DSC04429.JPG_2.jpg,6975,480,640,93,267,360,293,368,False,69
스,131,kaist_dataset/Mixed/Digital_Camera/(C.S)C-outdoor5/DSC04444.JPG,char_data/스/DSC04444.JPG_2.jpg,18602,480,640,142,462,604,14,145,False,69
스,78,kaist_dataset/Mixed/Digital_Camera/(C.S)C-outdoor5/DSC04447.JPG,char_data/스/DSC04447.JPG_2.jpg,4836,480,640,62,377,439,192,270,False,69
스,92,kaist_dataset/Mixed/Digital_Camera/(C.S)C-outdoor5/DSC04461.JPG,char_data/스/DSC04461.JPG_2.jpg,8924,480,640,97,459,556,107,199,False,69
스,69,kaist_dataset/Mixed/Digital_Camera/(C.S)C-outdoor5/P1010004.JPG,char_data/스/P1010004.JPG_2.jpg,4140,480,640,60,421,481,175,244,False,69
스,43,kaist_dataset/Mixed/Digital_Camera/(C.S)C-outdoor6/025.jpg,char_data/스/025.jpg_2.jpg,3913,293,472,91,306,397,156,199,False,69
스,66,kaist_dataset/Mixed/Digital_Camera/(C.S)C-outdoor6/080116-0057.jpg,char_data/스/080116-0057.jpg_2.jpg,3564,1200,1600,54,643,697,906,972,False,69
스,68,kaist_dataset/Mixed/Digital_Camera/(C.S)C-outdoor6/P1010025.JPG,char_data/스/P1010025.JPG_2.jpg,7208,480,640,106,155,261,86,154,False,69
스,70,kaist_dataset/Mixed/Digital_Camera/(C.S)C-outdoor6/P1010027.JPG,char_data/스/P1010027.JPG_2.jpg,5740,480,640,82,170,252,76,146,False,69
스,38,kaist_dataset/Mixed/Digital_Camera/(C.S)C-outdoor6/P1010045.JPG,char_data/스/P1010045.JPG_5.jpg,1102,480,640,29,377,406,407,445,False,69
스,117,kaist_dataset/Mixed/Digital_Camera/(C.S)C-outdoor6/P1010063.JPG,char_data/스/P1010063.JPG_2.jpg,10881,480,640,93,293,386,10,127,False,69
스,119,kaist_dataset/Mixed/Digital_Camera/(C.S)C-outdoor6/P1010067.JPG,char_data/스/P1010067.JPG_2.jpg,17493,480,640,147,489,636,175,294,False,69
스,96,kaist_dataset/Mixed/Digital_Camera/(C.S)C-outdoor6/P1010073.JPG,char_data/스/P1010073.JPG_2.jpg,8832,480,640,92,215,307,113,209,False,69
스,60,kaist_dataset/Mixed/Digital_Camera/(C.S)C-outdoor6/P1010080.JPG,char_data/스/P1010080.JPG_2.jpg,4320,480,640,72,306,378,171,231,False,69
스,33,kaist_dataset/Mixed/Digital_Camera/(C.S)C-outdoor6/P1010097.JPG,char_data/스/P1010097.JPG_2.jpg,957,480,640,29,223,252,50,83,False,69
스,38,kaist_dataset/Mixed/Digital_Camera/(C.S)C-outdoor6/P1010098.JPG,char_data/스/P1010098.JPG_2.jpg,836,480,640,22,220,242,437,475,False,69
스,75,kaist_dataset/Mixed/Digital_Camera/(C.S)C-outdoor6/P1010114.JPG,char_data/스/P1010114.JPG_2.jpg,5100,480,640,68,280,348,103,178,False,69
스,57,kaist_dataset/Mixed/Digital_Camera/(C.S)C-outdoor6/크기변환_20040626112330924_im_orz6564_netdkwk.jpg,char_data/스/크기변환_20040626112330924_im_orz6564_netdkwk.jpg_2.jpg,3021,480,640,53,424,477,237,294,False,69
스,94,kaist_dataset/Mixed/Digital_Camera/(C.S)C-outdoor6/크기변환_fadscf0009_creawell.jpg,char_data/스/크기변환_fadscf0009_creawell.jpg_2.jpg,7144,480,640,76,400,476,61,155,False,69
스,38,kaist_dataset/Mixed/Digital_Camera/(C.S)D-indoor1/DSC02718.JPG,char_data/스/DSC02718.JPG_2.jpg,874,480,640,23,227,250,136,174,False,69
스,61,kaist_dataset/Mixed/Digital_Camera/(C.S)D-indoor1/DSC02726.JPG,char_data/스/DSC02726.JPG_2.jpg,2806,480,640,46,271,317,385,446,False,69
스,45,kaist_dataset/Mixed/Digital_Camera/(C.S)D-indoor1/DSC02840.JPG,char_data/스/DSC02840.JPG_2.jpg,1530,480,640,34,112,146,367,412,False,69
스,61,kaist_dataset/Mixed/Digital_Camera/(C.S)D-indoor1/DSC03469.JPG,char_data/스/DSC03469.JPG_2.jpg,2806,480,640,46,438,484,243,304,False,69
스,42,kaist_dataset/Mixed/Digital_Camera/(C.S)D-indoor1/DSC03909.JPG,char_data/스/DSC03909.JPG_2.jpg,1050,480,640,25,531,556,297,339,False,69
스,62,kaist_dataset/Mixed/Digital_Camera/(C.S)D-indoor1/DSC03998.JPG,char_data/스/DSC03998.JPG_2.jpg,3658,480,640,59,256,315,412,474,False,69
스,59,kaist_dataset/Mixed/Digital_Camera/(C.S)D-indoor1/DSC04019.JPG,char_data/스/DSC04019.JPG_4.jpg,3658,480,640,62,86,148,145,204,False,69
스,59,kaist_dataset/Mixed/Digital_Camera/(C.S)D-indoor1/DSC04019.JPG,char_data/스/DSC04019.JPG_5.jpg,3422,480,640,58,442,500,140,199,False,69
스,81,kaist_dataset/Mixed/Digital_Camera/(C.S)D-indoor2/DSC04443.JPG,char_data/스/DSC04443.JPG_4.jpg,6723,480,640,83,322,405,305,386,False,69
스,92,kaist_dataset/Mixed/Digital_Camera/(C.S)D-indoor2/DSC04443.JPG,char_data/스/DSC04443.JPG_5.jpg,8188,480,640,89,233,322,164,256,False,69
스,63,kaist_dataset/Mixed/Digital_Camera/(C.S)D-indoor2/DSC04487.JPG,char_data/스/DSC04487.JPG_2.jpg,3843,480,640,61,381,442,158,221,False,69
스,101,kaist_dataset/Mixed/Digital_Camera/(C.S)E-night/DSC02673.JPG,char_data/스/DSC02673.JPG_2.jpg,6565,480,640,65,270,335,148,249,False,69
스,56,kaist_dataset/Mixed/Digital_Camera/(C.S)E-night/DSC03517.JPG,char_data/스/DSC03517.JPG_2.jpg,2744,480,640,49,330,379,81,137,False,69
스,32,kaist_dataset/Mixed/Digital_Camera/(C.S)E-night/DSC03840.JPG,char_data/스/DSC03840.JPG_2.jpg,864,480,640,27,275,302,192,224,False,69
스,27,kaist_dataset/Mixed/Digital_Camera/(C.S)F-others/097.jpg,char_data/스/097.jpg_2.jpg,648,480,640,24,349,373,303,330,False,69
스,194,kaist_dataset/Mixed/Digital_Camera/(C.S)F-others/2007-12-09-day-exterior-032.jpg,char_data/스/2007-12-09-day-exterior-032.jpg_2.jpg,42874,1600,1200,221,491,712,734,928,False,69
스,39,kaist_dataset/Mixed/Digital_Camera/(C.S)F-others/DSC02881.JPG,char_data/스/DSC02881.JPG_6.jpg,1872,480,640,48,165,213,162,201,False,69
스,28,kaist_dataset/Mixed/Digital_Camera/(C.S)F-others/DSC02881.JPG,char_data/스/DSC02881.JPG_7.jpg,616,480,640,22,198,220,324,352,False,69
스,31,kaist_dataset/Mixed/Digital_Camera/(C.S)F-others/DSC02881.JPG,char_data/스/DSC02881.JPG_8.jpg,961,480,640,31,554,585,218,249,False,69
스,69,kaist_dataset/Mixed/Mobile_Phone/(C.M)A-outdoor/P090908005.jpg,char_data/스/P090908005.jpg_2.jpg,7452,480,640,108,491,599,143,212,False,69
스,78,kaist_dataset/Mixed/Mobile_Phone/(C.M)A-outdoor/P090908006.jpg,char_data/스/P090908006.jpg_2.jpg,7566,480,640,97,487,584,268,346,False,69
스,52,kaist_dataset/Mixed/Mobile_Phone/(C.M)A-outdoor/P090912037.jpg,char_data/스/P090912037.jpg_2.jpg,2496,480,640,48,401,449,183,235,False,69
스,55,kaist_dataset/Mixed/Mobile_Phone/(C.M)A-outdoor/P090912066.jpg,char_data/스/P090912066.jpg_2.jpg,1815,480,640,33,325,358,203,258,False,69
스,58,kaist_dataset/Mixed/Mobile_Phone/(C.M)C-bookCover/P090831043.jpg,char_data/스/P090831043.jpg_2.jpg,2262,480,640,39,80,119,330,388,False,69
스,48,kaist_dataset/Mixed/Mobile_Phone/(C.M)C-bookCover/P090831045.jpg,char_data/스/P090831045.jpg_2.jpg,1776,480,640,37,83,120,304,352,False,69
스,129,kaist_dataset/Mixed/Mobile_Phone/(C.M)C-bookCover/P090831124.jpg,char_data/스/P090831124.jpg_2.jpg,17415,480,640,135,270,405,234,363,False,69
스,35,kaist_dataset/Mixed/Mobile_Phone/(C.M)C-bookCover/P090903063.jpg,char_data/스/P090903063.jpg_2.jpg,1155,480,640,33,356,389,294,329,False,69
스,54,kaist_dataset/Mixed/Mobile_Phone/(C.M)C-bookCover/P090903068.jpg,char_data/스/P090903068.jpg_2.jpg,1836,480,640,34,388,422,340,394,False,69
스,39,kaist_dataset/Mixed/Mobile_Phone/(C.M)C-bookCover/P090903072.jpg,char_data/스/P090903072.jpg_2.jpg,1326,480,640,34,280,314,350,389,False,69
스,109,kaist_dataset/Mixed/Mobile_Phone/(C.M)C-bookCover/P090903083.jpg,char_data/스/P090903083.jpg_2.jpg,11445,480,640,105,368,473,34,143,False,69
s,51,kaist_dataset/English/Digital_Camera/(E.S)A-shadow/DSC03026.JPG,char_data/s/DSC03026.JPG_2.jpg,2397,480,640,47,173,220,162,213,True,43
s,42,kaist_dataset/English/Digital_Camera/(E.S)A-shadow/DSC03081.JPG,char_data/s/DSC03081.JPG_2.jpg,882,480,640,21,293,314,412,454,True,43
s,42,kaist_dataset/English/Digital_Camera/(E.S)A-shadow/DSC03082.JPG,char_data/s/DSC03082.JPG_2.jpg,882,480,640,21,451,472,382,424,True,43
s,52,kaist_dataset/English/Digital_Camera/(E.S)A-shadow/IMG_2647.JPG,char_data/s/IMG_2647.JPG_6.jpg,1924,480,640,37,254,291,260,312,True,43
s,50,kaist_dataset/English/Digital_Camera/(E.S)A-shadow/IMG_2647.JPG,char_data/s/IMG_2647.JPG_7.jpg,2300,480,640,46,265,311,190,240,True,43
s,53,kaist_dataset/English/Digital_Camera/(E.S)A-shadow/IMG_2647.JPG,char_data/s/IMG_2647.JPG_8.jpg,2226,480,640,42,313,355,186,239,True,43
s,75,kaist_dataset/English/Digital_Camera/(E.S)A-shadow/P090912074.jpg,char_data/s/P090912074.jpg_2.jpg,2775,480,640,37,341,378,78,153,True,43
s,76,kaist_dataset/English/Digital_Camera/(E.S)B-light/DSC02980.JPG,char_data/s/DSC02980.JPG_2.jpg,4256,480,640,56,372,428,77,153,True,43
s,63,kaist_dataset/English/Digital_Camera/(E.S)C-outdoor1/001.jpg,char_data/s/001.jpg_6.jpg,2583,257,470,41,207,248,100,163,True,43
s,31,kaist_dataset/English/Digital_Camera/(E.S)C-outdoor1/033.jpg,char_data/s/033.jpg_2.jpg,868,232,354,28,184,212,120,151,True,43
s,65,kaist_dataset/English/Digital_Camera/(E.S)C-outdoor1/056.JPG,char_data/s/056.JPG_2.jpg,3315,480,640,51,315,366,177,242,True,43
s,219,kaist_dataset/English/Digital_Camera/(E.S)C-outdoor1/080119-0035.jpg,char_data/s/080119-0035.jpg_2.jpg,22119,1200,1600,101,1267,1368,749,968,True,43
s,173,kaist_dataset/English/Digital_Camera/(E.S)C-outdoor1/080119-0036.jpg,char_data/s/080119-0036.jpg_2.jpg,17473,1200,1600,101,1462,1563,367,540,True,43
s,36,kaist_dataset/English/Digital_Camera/(E.S)C-outdoor1/137.JPG,char_data/s/137.JPG_2.jpg,612,480,640,17,272,289,263,299,True,43
s,40,kaist_dataset/English/Digital_Camera/(E.S)C-outdoor1/138.JPG,char_data/s/138.JPG_2.jpg,1440,480,640,36,411,447,264,304,True,43
s,129,kaist_dataset/English/Digital_Camera/(E.S)C-outdoor1/2007-12-08-day-015.jpg,char_data/s/2007-12-08-day-015.jpg_7.jpg,18705,1200,1600,145,670,815,647,776,True,43
s,40,kaist_dataset/English/Digital_Camera/(E.S)C-outdoor1/2007-12-08-day-015.jpg,char_data/s/2007-12-08-day-015.jpg_8.jpg,1120,1200,1600,28,899,927,820,860,True,43
s,164,kaist_dataset/English/Digital_Camera/(E.S)C-outdoor1/2007-12-08-day-098.jpg,char_data/s/2007-12-08-day-098.jpg_4.jpg,8364,1200,1600,51,329,380,505,669,True,43
s,193,kaist_dataset/English/Digital_Camera/(E.S)C-outdoor1/2007-12-08-day-098.jpg,char_data/s/2007-12-08-day-098.jpg_5.jpg,12738,1200,1600,66,1533,1599,487,680,True,43
s,33,kaist_dataset/English/Digital_Camera/(E.S)C-outdoor1/DSC02352.JPG,char_data/s/DSC02352.JPG_2.jpg,561,480,640,17,464,481,325,358,True,43
s,123,kaist_dataset/English/Digital_Camera/(E.S)C-outdoor1/DSC02354.JPG,char_data/s/DSC02354.JPG_2.jpg,11562,480,640,94,433,527,201,324,True,43
s,45,kaist_dataset/English/Digital_Camera/(E.S)C-outdoor1/DSC02355.JPG,char_data/s/DSC02355.JPG_2.jpg,810,480,640,18,91,109,304,349,True,43
s,126,kaist_dataset/English/Digital_Camera/(E.S)C-outdoor1/DSC02415.JPG,char_data/s/DSC02415.JPG_2.jpg,10836,480,640,86,260,346,73,199,True,43
s,29,kaist_dataset/English/Digital_Camera/(E.S)C-outdoor1/DSC02417.JPG,char_data/s/DSC02417.JPG_2.jpg,522,480,640,18,499,517,144,173,True,43
s,73,kaist_dataset/English/Digital_Camera/(E.S)C-outdoor1/DSC02442.JPG,char_data/s/DSC02442.JPG_2.jpg,3431,480,640,47,51,98,153,226,True,43
s,37,kaist_dataset/English/Digital_Camera/(E.S)C-outdoor1/DSC02480.JPG,char_data/s/DSC02480.JPG_7.jpg,1184,480,640,32,177,209,414,451,True,43
s,54,kaist_dataset/English/Digital_Camera/(E.S)C-outdoor1/DSC02480.JPG,char_data/s/DSC02480.JPG_8.jpg,1350,480,640,25,388,413,393,447,True,43
s,51,kaist_dataset/English/Digital_Camera/(E.S)C-outdoor1/DSC02500.JPG,char_data/s/DSC02500.JPG_8.jpg,1173,480,640,23,533,556,292,343,True,43
s,100,kaist_dataset/English/Digital_Camera/(E.S)C-outdoor1/DSC02914.JPG,char_data/s/DSC02914.JPG_4.jpg,5000,480,640,50,179,229,178,278,True,43
s,99,kaist_dataset/English/Digital_Camera/(E.S)C-outdoor1/DSC02914.JPG,char_data/s/DSC02914.JPG_5.jpg,5940,480,640,60,229,289,174,273,True,43
s,34,kaist_dataset/English/Digital_Camera/(E.S)C-outdoor1/DSC02918.JPG,char_data/s/DSC02918.JPG_2.jpg,646,480,640,19,456,475,229,263,True,43
s,99,kaist_dataset/English/Digital_Camera/(E.S)C-outdoor2/DSC02990.JPG,char_data/s/DSC02990.JPG_4.jpg,7128,480,640,72,53,125,136,235,True,43
s,73,kaist_dataset/English/Digital_Camera/(E.S)C-outdoor2/DSC02990.JPG,char_data/s/DSC02990.JPG_5.jpg,3504,480,640,48,327,375,179,252,True,43
s,48,kaist_dataset/English/Digital_Camera/(E.S)C-outdoor2/DSC02998.JPG,char_data/s/DSC02998.JPG_2.jpg,1152,480,640,24,290,314,422,470,True,43
s,48,kaist_dataset/English/Digital_Camera/(E.S)C-outdoor2/DSC03000.JPG,char_data/s/DSC03000.JPG_2.jpg,1296,480,640,27,291,318,296,344,True,43
s,38,kaist_dataset/English/Digital_Camera/(E.S)C-outdoor2/DSC03160.JPG,char_data/s/DSC03160.JPG_4.jpg,1216,480,640,32,104,136,156,194,True,43
s,49,kaist_dataset/English/Digital_Camera/(E.S)C-outdoor2/DSC03166.JPG,char_data/s/DSC03166.JPG_2.jpg,1862,480,640,38,354,392,271,320,True,43
s,66,kaist_dataset/English/Digital_Camera/(E.S)C-outdoor2/DSC03200.JPG,char_data/s/DSC03200.JPG_4.jpg,2970,480,640,45,276,321,249,315,True,43
s,64,kaist_dataset/English/Digital_Camera/(E.S)C-outdoor2/DSC03200.JPG,char_data/s/DSC03200.JPG_5.jpg,2880,480,640,45,320,365,247,311,True,43
s,61,kaist_dataset/English/Digital_Camera/(E.S)C-outdoor2/DSC03201.JPG,char_data/s/DSC03201.JPG_2.jpg,2257,480,640,37,418,455,83,144,True,43
s,46,kaist_dataset/English/Digital_Camera/(E.S)C-outdoor2/DSC03203.JPG,char_data/s/DSC03203.JPG_5.jpg,1242,480,640,27,228,255,426,472,True,43
s,26,kaist_dataset/English/Digital_Camera/(E.S)C-outdoor2/DSC03208.JPG,char_data/s/DSC03208.JPG_2.jpg,364,480,640,14,252,266,169,195,True,43
s,30,kaist_dataset/English/Digital_Camera/(E.S)C-outdoor2/DSC03225.JPG,char_data/s/DSC03225.JPG_2.jpg,630,480,640,21,406,427,89,119,True,43
s,53,kaist_dataset/English/Digital_Camera/(E.S)C-outdoor2/DSC03262.JPG,char_data/s/DSC03262.JPG_2.jpg,1484,480,640,28,164,192,134,187,True,43
s,69,kaist_dataset/English/Digital_Camera/(E.S)C-outdoor2/DSC03276.JPG,char_data/s/DSC03276.JPG_2.jpg,3864,480,640,56,455,511,341,410,True,43
s,45,kaist_dataset/English/Digital_Camera/(E.S)C-outdoor2/DSC03290.JPG,char_data/s/DSC03290.JPG_2.jpg,1350,480,640,30,271,301,209,254,True,43
s,47,kaist_dataset/English/Digital_Camera/(E.S)C-outdoor2/DSC03294.JPG,char_data/s/DSC03294.JPG_6.jpg,1222,480,640,26,366,392,303,350,True,43
s,39,kaist_dataset/English/Digital_Camera/(E.S)C-outdoor2/DSC03294.JPG,char_data/s/DSC03294.JPG_7.jpg,858,480,640,22,470,492,312,351,True,43
s,37,kaist_dataset/English/Digital_Camera/(E.S)C-outdoor2/DSC03294.JPG,char_data/s/DSC03294.JPG_8.jpg,777,480,640,21,492,513,311,348,True,43
s,50,kaist_dataset/English/Digital_Camera/(E.S)C-outdoor2/DSC03297.JPG,char_data/s/DSC03297.JPG_6.jpg,1600,480,640,32,401,433,262,312,True,43
s,46,kaist_dataset/English/Digital_Camera/(E.S)C-outdoor2/DSC03297.JPG,char_data/s/DSC03297.JPG_7.jpg,1334,480,640,29,529,558,259,305,True,43
s,50,kaist_dataset/English/Digital_Camera/(E.S)C-outdoor2/DSC03297.JPG,char_data/s/DSC03297.JPG_8.jpg,1450,480,640,29,558,587,256,306,True,43
s,72,kaist_dataset/English/Digital_Camera/(E.S)C-outdoor2/DSC03436.JPG,char_data/s/DSC03436.JPG_2.jpg,3744,480,640,52,498,550,40,112,True,43
s,35,kaist_dataset/English/Digital_Camera/(E.S)C-outdoor2/DSC03664.JPG,char_data/s/DSC03664.JPG_2.jpg,875,480,640,25,189,214,32,67,True,43
s,66,kaist_dataset/English/Digital_Camera/(E.S)C-outdoor2/DSC03761.JPG,char_data/s/DSC03761.JPG_5.jpg,2640,480,640,40,393,433,343,409,True,43
s,106,kaist_dataset/English/Digital_Camera/(E.S)C-outdoor2/DSC03786.JPG,char_data/s/DSC03786.JPG_6.jpg,8798,480,640,83,390,473,329,435,True,43
s,95,kaist_dataset/English/Digital_Camera/(E.S)C-outdoor2/DSC03786.JPG,char_data/s/DSC03786.JPG_7.jpg,7505,480,640,79,528,607,57,152,True,43
s,113,kaist_dataset/English/Digital_Camera/(E.S)C-outdoor2/DSC03786.JPG,char_data/s/DSC03786.JPG_8.jpg,8701,480,640,77,448,525,188,301,True,43
s,35,kaist_dataset/English/Digital_Camera/(E.S)C-outdoor2/DSC03865.JPG,char_data/s/DSC03865.JPG_4.jpg,945,480,640,27,77,104,100,135,True,43
s,44,kaist_dataset/English/Digital_Camera/(E.S)C-outdoor2/DSC04035.JPG,char_data/s/DSC04035.JPG_2.jpg,1188,480,640,27,430,457,200,244,True,43
s,54,kaist_dataset/English/Digital_Camera/(E.S)C-outdoor2/DSC04047.JPG,char_data/s/DSC04047.JPG_2.jpg,2538,480,640,47,490,537,237,291,True,43
s,43,kaist_dataset/English/Digital_Camera/(E.S)C-outdoor2/DSC04064.JPG,char_data/s/DSC04064.JPG_6.jpg,989,480,640,23,462,485,139,182,True,43
s,57,kaist_dataset/English/Digital_Camera/(E.S)C-outdoor2/DSC04066.JPG,char_data/s/DSC04066.JPG_2.jpg,1881,480,640,33,320,353,344,401,True,43
s,36,kaist_dataset/English/Digital_Camera/(E.S)C-outdoor2/DSC04079.JPG,char_data/s/DSC04079.JPG_9.jpg,864,480,640,24,81,105,120,156,True,43
s,34,kaist_dataset/English/Digital_Camera/(E.S)C-outdoor2/DSC04079.JPG,char_data/s/DSC04079.JPG_10.jpg,850,480,640,25,231,256,159,193,True,43
s,43,kaist_dataset/English/Digital_Camera/(E.S)C-outdoor2/DSC04079.JPG,char_data/s/DSC04079.JPG_11.jpg,1247,480,640,29,283,312,154,197,True,43
s,83,kaist_dataset/English/Digital_Camera/(E.S)C-outdoor2/DSC04160.JPG,char_data/s/DSC04160.JPG_4.jpg,3818,480,640,46,262,308,347,430,True,43
s,70,kaist_dataset/English/Digital_Camera/(E.S)C-outdoor2/DSC04160.JPG,char_data/s/DSC04160.JPG_5.jpg,3010,480,640,43,484,527,320,390,True,43
s,117,kaist_dataset/English/Digital_Camera/(E.S)C-outdoor2/DSC04397.JPG,char_data/s/DSC04397.JPG_6.jpg,6552,480,640,56,389,445,212,329,True,43
s,57,kaist_dataset/English/Digital_Camera/(E.S)C-outdoor2/DSC04397.JPG,char_data/s/DSC04397.JPG_7.jpg,1653,480,640,29,265,294,132,189,True,43
s,57,kaist_dataset/English/Digital_Camera/(E.S)C-outdoor2/DSC04397.JPG,char_data/s/DSC04397.JPG_8.jpg,2451,480,640,43,402,445,139,196,True,43
s,99,kaist_dataset/English/Digital_Camera/(E.S)C-outdoor2/DSC04430.JPG,char_data/s/DSC04430.JPG_7.jpg,9603,480,640,97,359,456,297,396,True,43
s,101,kaist_dataset/English/Digital_Camera/(E.S)C-outdoor2/DSC04430.JPG,char_data/s/DSC04430.JPG_8.jpg,10100,480,640,100,288,388,167,268,True,43
s,109,kaist_dataset/English/Digital_Camera/(E.S)C-outdoor2/DSC04431.JPG,char_data/s/DSC04431.JPG_8.jpg,10028,480,640,92,378,470,283,392,True,43
s,27,kaist_dataset/English/Digital_Camera/(E.S)C-outdoor2/DSC04437.JPG,char_data/s/DSC04437.JPG_6.jpg,378,480,640,14,214,228,44,71,True,43
s,25,kaist_dataset/English/Digital_Camera/(E.S)C-outdoor2/DSC04437.JPG,char_data/s/DSC04437.JPG_7.jpg,275,480,640,11,290,301,79,104,True,43
s,24,kaist_dataset/English/Digital_Camera/(E.S)C-outdoor2/DSC04437.JPG,char_data/s/DSC04437.JPG_8.jpg,312,480,640,13,314,327,80,104,True,43
s,132,kaist_dataset/English/Digital_Camera/(E.S)C-outdoor2/DSC04458.JPG,char_data/s/DSC04458.JPG_2.jpg,10428,480,640,79,269,348,138,270,True,43
s,74,kaist_dataset/English/Digital_Camera/(E.S)C-outdoor2/IMG_2618.JPG,char_data/s/IMG_2618.JPG_4.jpg,2368,279,640,32,15,47,183,257,True,43
s,81,kaist_dataset/English/Digital_Camera/(E.S)C-outdoor2/IMG_2618.JPG,char_data/s/IMG_2618.JPG_5.jpg,4212,279,640,52,238,290,180,261,True,43
s,136,kaist_dataset/English/Digital_Camera/(E.S)C-outdoor2/P1010024.JPG,char_data/s/P1010024.JPG_2.jpg,12376,480,640,91,401,492,224,360,True,43
s,106,kaist_dataset/English/Digital_Camera/(E.S)C-outdoor2/P1010060.JPG,char_data/s/P1010060.JPG_2.jpg,11130,480,640,105,454,559,131,237,True,43
s,41,kaist_dataset/English/Digital_Camera/(E.S)C-outdoor3/DSC03038.JPG,char_data/s/DSC03038.JPG_2.jpg,1066,480,640,26,374,400,310,351,True,43
s,63,kaist_dataset/English/Digital_Camera/(E.S)C-outdoor3/P1010064.JPG,char_data/s/P1010064.JPG_6.jpg,2205,480,640,35,319,354,329,392,True,43
s,62,kaist_dataset/English/Digital_Camera/(E.S)C-outdoor3/P1010064.JPG,char_data/s/P1010064.JPG_7.jpg,2294,480,640,37,480,517,333,395,True,43
s,59,kaist_dataset/English/Digital_Camera/(E.S)C-outdoor3/P1010064.JPG,char_data/s/P1010064.JPG_8.jpg,2301,480,640,39,512,551,331,390,True,43
s,24,kaist_dataset/English/Digital_Camera/(E.S)C-outdoor3/P1010123.JPG,char_data/s/P1010123.JPG_7.jpg,192,480,640,8,556,564,102,126,True,43
s,25,kaist_dataset/English/Digital_Camera/(E.S)C-outdoor3/P1010123.JPG,char_data/s/P1010123.JPG_8.jpg,350,480,640,14,54,68,111,136,True,43
s,18,kaist_dataset/English/Digital_Camera/(E.S)C-outdoor3/크기변환_P1010076.JPG,char_data/s/크기변환_P1010076.JPG_2.jpg,216,480,640,12,280,292,104,122,True,43
s,31,kaist_dataset/English/Digital_Camera/(E.S)D-indoor/080119-0009.jpg,char_data/s/080119-0009.jpg_19.jpg,527,1200,1600,17,693,710,1053,1084,True,43
s,31,kaist_dataset/English/Digital_Camera/(E.S)D-indoor/080119-0009.jpg,char_data/s/080119-0009.jpg_20.jpg,496,1200,1600,16,799,815,1074,1105,True,43
s,35,kaist_dataset/English/Digital_Camera/(E.S)D-indoor/080119-0009.jpg,char_data/s/080119-0009.jpg_21.jpg,560,1200,1600,16,632,648,1074,1109,True,43
s,37,kaist_dataset/English/Digital_Camera/(E.S)D-indoor/080119-0009.jpg,char_data/s/080119-0009.jpg_22.jpg,666,1200,1600,18,665,683,1085,1122,True,43
s,37,kaist_dataset/English/Digital_Camera/(E.S)D-indoor/080119-0009.jpg,char_data/s/080119-0009.jpg_24.jpg,444,1200,1600,12,598,610,948,985,True,43
s,36,kaist_dataset/English/Digital_Camera/(E.S)D-indoor/080119-0009.jpg,char_data/s/080119-0009.jpg_25.jpg,504,1200,1600,14,609,623,951,987,True,43
s,39,kaist_dataset/English/Digital_Camera/(E.S)D-indoor/080119-0009.jpg,char_data/s/080119-0009.jpg_26.jpg,585,1200,1600,15,785,800,1001,1040,True,43
s,73,kaist_dataset/English/Digital_Camera/(E.S)D-indoor/DSC02853.JPG,char_data/s/DSC02853.JPG_2.jpg,3285,480,640,45,456,501,144,217,True,43
s,55,kaist_dataset/English/Digital_Camera/(E.S)D-indoor/DSC02854.JPG,char_data/s/DSC02854.JPG_6.jpg,1870,480,640,34,296,330,151,206,True,43
s,61,kaist_dataset/English/Digital_Camera/(E.S)D-indoor/DSC02854.JPG,char_data/s/DSC02854.JPG_7.jpg,1830,480,640,30,456,486,145,206,True,43
s,59,kaist_dataset/English/Digital_Camera/(E.S)D-indoor/DSC02854.JPG,char_data/s/DSC02854.JPG_8.jpg,2006,480,640,34,486,520,154,213,True,43
s,50,kaist_dataset/English/Digital_Camera/(E.S)D-indoor/DSC02859.JPG,char_data/s/DSC02859.JPG_2.jpg,1750,480,640,35,227,262,340,390,True,43
s,62,kaist_dataset/English/Digital_Camera/(E.S)D-indoor/DSC02860.JPG,char_data/s/DSC02860.JPG_2.jpg,3038,480,640,49,534,583,84,146,True,43
s,60,kaist_dataset/English/Digital_Camera/(E.S)D-indoor/DSC02862.JPG,char_data/s/DSC02862.JPG_2.jpg,3120,480,640,52,191,243,249,309,True,43
s,42,kaist_dataset/English/Digital_Camera/(E.S)D-indoor/DSC03078.JPG,char_data/s/DSC03078.JPG_4.jpg,1344,480,640,32,198,230,238,280,True,43
s,50,kaist_dataset/English/Digital_Camera/(E.S)D-indoor/DSC03078.JPG,char_data/s/DSC03078.JPG_5.jpg,1400,480,640,28,449,477,237,287,True,43
s,69,kaist_dataset/English/Digital_Camera/(E.S)D-indoor/DSC03080.JPG,char_data/s/DSC03080.JPG_2.jpg,3105,480,640,45,291,336,369,438,True,43
s,53,kaist_dataset/English/Digital_Camera/(E.S)D-indoor/DSC03083.JPG,char_data/s/DSC03083.JPG_2.jpg,1378,480,640,26,322,348,400,453,True,43
s,53,kaist_dataset/English/Digital_Camera/(E.S)D-indoor/DSC03085.JPG,char_data/s/DSC03085.JPG_4.jpg,1325,480,640,25,168,193,382,435,True,43
s,57,kaist_dataset/English/Digital_Camera/(E.S)D-indoor/DSC03085.JPG,char_data/s/DSC03085.JPG_5.jpg,1368,480,640,24,514,538,374,431,True,43
s,47,kaist_dataset/English/Digital_Camera/(E.S)D-indoor/DSC03090.JPG,char_data/s/DSC03090.JPG_2.jpg,1457,480,640,31,276,307,235,282,True,43
s,66,kaist_dataset/English/Digital_Camera/(E.S)D-indoor/DSC03093.JPG,char_data/s/DSC03093.JPG_6.jpg,2442,480,640,37,586,623,128,194,True,43
s,46,kaist_dataset/English/Digital_Camera/(E.S)D-indoor/DSC03093.JPG,char_data/s/DSC03093.JPG_7.jpg,1104,480,640,24,439,463,209,255,True,43
s,50,kaist_dataset/English/Digital_Camera/(E.S)D-indoor/DSC03093.JPG,char_data/s/DSC03093.JPG_8.jpg,1200,480,640,24,460,484,207,257,True,43
s,57,kaist_dataset/English/Digital_Camera/(E.S)D-indoor/DSC03136.JPG,char_data/s/DSC03136.JPG_2.jpg,1710,480,640,30,243,273,263,320,True,43
s,33,kaist_dataset/English/Digital_Camera/(E.S)D-indoor/DSC03142.JPG,char_data/s/DSC03142.JPG_5.jpg,561,480,640,17,373,390,371,404,True,43
s,65,kaist_dataset/English/Digital_Camera/(E.S)D-indoor/DSC03150.JPG,char_data/s/DSC03150.JPG_2.jpg,2470,480,640,38,558,596,15,80,True,43
s,44,kaist_dataset/English/Digital_Camera/(E.S)D-indoor/DSC03151.JPG,char_data/s/DSC03151.JPG_2.jpg,1276,480,640,29,373,402,110,154,True,43
s,45,kaist_dataset/English/Digital_Camera/(E.S)D-indoor/DSC03396.JPG,char_data/s/DSC03396.JPG_2.jpg,1350,480,640,30,506,536,345,390,True,43
s,89,kaist_dataset/English/Digital_Camera/(E.S)D-indoor/DSC03398.JPG,char_data/s/DSC03398.JPG_2.jpg,6853,480,640,77,510,587,336,425,True,43
s,58,kaist_dataset/English/Digital_Camera/(E.S)D-indoor/DSC03441.JPG,char_data/s/DSC03441.JPG_2.jpg,2378,480,640,41,330,371,387,445,True,43
s,28,kaist_dataset/English/Digital_Camera/(E.S)D-indoor/DSC03532.JPG,char_data/s/DSC03532.JPG_6.jpg,448,480,640,16,437,453,383,411,True,43
s,27,kaist_dataset/English/Digital_Camera/(E.S)D-indoor/DSC03532.JPG,char_data/s/DSC03532.JPG_7.jpg,432,480,640,16,499,515,380,407,True,43
s,27,kaist_dataset/English/Digital_Camera/(E.S)D-indoor/DSC03532.JPG,char_data/s/DSC03532.JPG_8.jpg,405,480,640,15,604,619,380,407,True,43
s,76,kaist_dataset/English/Digital_Camera/(E.S)D-indoor/DSC03918.JPG,char_data/s/DSC03918.JPG_4.jpg,4712,480,640,62,417,479,287,363,True,43
s,48,kaist_dataset/English/Digital_Camera/(E.S)D-indoor/DSC03936.JPG,char_data/s/DSC03936.JPG_2.jpg,1152,480,640,24,493,517,90,138,True,43
s,79,kaist_dataset/English/Digital_Camera/(E.S)D-indoor/DSC04023.JPG,char_data/s/DSC04023.JPG_8.jpg,3002,480,640,38,184,222,211,290,True,43
s,51,kaist_dataset/English/Digital_Camera/(E.S)D-indoor/DSC04023.JPG,char_data/s/DSC04023.JPG_9.jpg,2295,480,640,45,531,576,261,312,True,43
s,26,kaist_dataset/English/Digital_Camera/(E.S)D-indoor/DSC04023.JPG,char_data/s/DSC04023.JPG_10.jpg,520,480,640,20,320,340,323,349,True,43
s,27,kaist_dataset/English/Digital_Camera/(E.S)D-indoor/DSC04023.JPG,char_data/s/DSC04023.JPG_11.jpg,702,480,640,26,342,368,323,350,True,43
s,46,kaist_dataset/English/Digital_Camera/(E.S)D-indoor/크기변환_%B0%A3%C6%C76_fabdent.jpg,char_data/s/크기변환_%B0%A3%C6%C76_fabdent.jpg_2.jpg,1656,480,640,36,347,383,192,238,True,43
s,37,kaist_dataset/English/Digital_Camera/(E.S)E-night/DSC02610.JPG,char_data/s/DSC02610.JPG_9.jpg,999,480,640,27,202,229,272,309,True,43
s,37,kaist_dataset/English/Digital_Camera/(E.S)E-night/DSC02610.JPG,char_data/s/DSC02610.JPG_10.jpg,1184,480,640,32,395,427,269,306,True,43
s,38,kaist_dataset/English/Digital_Camera/(E.S)E-night/DSC02610.JPG,char_data/s/DSC02610.JPG_11.jpg,1064,480,640,28,500,528,266,304,True,43
s,85,kaist_dataset/English/Digital_Camera/(E.S)E-night/크기변환_P1010163.JPG,char_data/s/크기변환_P1010163.JPG_2.jpg,5865,480,640,69,564,633,95,180,True,43
s,119,kaist_dataset/English/Digital_Camera/(E.S)F-others/080119-0014.jpg,char_data/s/080119-0014.jpg_4.jpg,7021,1200,1600,59,925,984,613,732,True,43
s,83,kaist_dataset/English/Digital_Camera/(E.S)F-others/DSC02925.JPG,char_data/s/DSC02925.JPG_2.jpg,4233,480,640,51,311,362,251,334,True,43
s,30,kaist_dataset/English/Digital_Camera/(E.S)F-others/DSC03218.JPG,char_data/s/DSC03218.JPG_5.jpg,660,480,640,22,177,199,332,362,True,43
s,63,kaist_dataset/English/Mobile_Phone/(E.M)A-outdoor/P090912072.jpg,char_data/s/P090912072.jpg_2.jpg,3150,480,640,50,21,71,27,90,True,43
s,56,kaist_dataset/English/Mobile_Phone/(E.M)B-indoor/P090831011.jpg,char_data/s/P090831011.jpg_2.jpg,2408,480,640,43,281,324,144,200,True,43
s,64,kaist_dataset/English/Mobile_Phone/(E.M)B-indoor/P090902018.jpg,char_data/s/P090902018.jpg_13.jpg,1920,480,640,30,376,406,187,251,True,43
s,59,kaist_dataset/English/Mobile_Phone/(E.M)B-indoor/P090903007.jpg,char_data/s/P090903007.jpg_2.jpg,2655,480,640,45,576,621,259,318,True,43
s,52,kaist_dataset/English/Mobile_Phone/(E.M)B-indoor/P090911067.jpg,char_data/s/P090911067.jpg_2.jpg,1976,480,640,38,276,314,225,277,True,43
s,72,kaist_dataset/English/Mobile_Phone/(E.M)B-indoor/P090911080.jpg,char_data/s/P090911080.jpg_2.jpg,2376,480,640,33,410,443,237,309,True,43
s,58,kaist_dataset/English/Mobile_Phone/(E.M)B-indoor/P090911081.jpg,char_data/s/P090911081.jpg_2.jpg,1276,480,640,22,311,333,229,287,True,43
s,50,kaist_dataset/English/Mobile_Phone/(E.M)B-indoor/P090911084.jpg,char_data/s/P090911084.jpg_4.jpg,1050,480,640,21,374,395,155,205,True,43
s,50,kaist_dataset/English/Mobile_Phone/(E.M)B-indoor/P090911084.jpg,char_data/s/P090911084.jpg_5.jpg,1050,480,640,21,395,416,154,204,True,43
s,85,kaist_dataset/English/Mobile_Phone/(E.M)B-indoor/P090911086.jpg,char_data/s/P090911086.jpg_2.jpg,3740,480,640,44,111,155,243,328,True,43
s,128,kaist_dataset/English/Mobile_Phone/(E.M)C-bookCover/P090831022.jpg,char_data/s/P090831022.jpg_2.jpg,12416,480,640,97,258,355,158,286,True,43
s,39,kaist_dataset/English/Mobile_Phone/(E.M)C-bookCover/P090903030.jpg,char_data/s/P090903030.jpg_8.jpg,936,480,640,24,408,432,75,114,True,43
s,30,kaist_dataset/English/Mobile_Phone/(E.M)C-bookCover/P090903030.jpg,char_data/s/P090903030.jpg_9.jpg,630,480,640,21,494,515,77,107,True,43
s,31,kaist_dataset/English/Mobile_Phone/(E.M)C-bookCover/P090903030.jpg,char_data/s/P090903030.jpg_10.jpg,713,480,640,23,515,538,77,108,True,43
s,29,kaist_dataset/English/Mobile_Phone/(E.M)C-bookCover/P090903030.jpg,char_data/s/P090903030.jpg_11.jpg,638,480,640,22,612,634,74,103,True,43
s,32,kaist_dataset/Korean/Digital_Camera/A-shadow/2007-12-09-day-exterior-031.jpg,char_data/s/2007-12-09-day-exterior-031.jpg_2.jpg,512,1200,1600,16,466,482,614,646,True,43
s,26,kaist_dataset/Korean/Digital_Camera/indoor1/145.JPG,char_data/s/145.JPG_2.jpg,286,480,640,11,269,280,303,329,True,43
s,21,kaist_dataset/Korean/Digital_Camera/outdoor1/001.JPG,char_data/s/001.JPG_8.jpg,252,480,640,12,561,573,242,263,True,43
s,53,kaist_dataset/Korean/Digital_Camera/outdoor2/080118-0018.jpg,char_data/s/080118-0018.jpg_2.jpg,2120,1200,1600,40,1317,1357,696,749,True,43
s,24,kaist_dataset/Mixed/Digital_Camera/(C.S)C-outdoor1/003.JPG,char_data/s/003.JPG_8.jpg,288,480,640,12,146,158,266,290,True,43
s,29,kaist_dataset/Mixed/Digital_Camera/(C.S)C-outdoor1/080.JPG,char_data/s/080.JPG_4.jpg,783,480,640,27,105,132,78,107,True,43
s,27,kaist_dataset/Mixed/Digital_Camera/(C.S)C-outdoor1/080.JPG,char_data/s/080.JPG_5.jpg,783,480,640,29,199,228,119,146,True,43
s,39,kaist_dataset/Mixed/Digital_Camera/(C.S)C-outdoor1/1.JPG,char_data/s/1.JPG_4.jpg,546,576,768,14,401,415,6,45,True,43
s,34,kaist_dataset/Mixed/Digital_Camera/(C.S)C-outdoor1/1.JPG,char_data/s/1.JPG_5.jpg,748,576,768,22,691,713,14,48,True,43
s,29,kaist_dataset/Mixed/Digital_Camera/(C.S)C-outdoor1/115.JPG,char_data/s/115.JPG_4.jpg,493,480,640,17,440,457,274,303,True,43
s,25,kaist_dataset/Mixed/Digital_Camera/(C.S)C-outdoor1/115.JPG,char_data/s/115.JPG_5.jpg,475,480,640,19,457,476,276,301,True,43
s,63,kaist_dataset/Mixed/Digital_Camera/(C.S)C-outdoor1/2007-12-08-day-106.jpg,char_data/s/2007-12-08-day-106.jpg_2.jpg,2331,1200,1600,37,889,926,744,807,True,43
s,64,kaist_dataset/Mixed/Digital_Camera/(C.S)C-outdoor1/2007-12-08-day-118.jpg,char_data/s/2007-12-08-day-118.jpg_2.jpg,5056,1200,1600,79,1204,1283,414,478,True,43
s,35,kaist_dataset/Mixed/Digital_Camera/(C.S)C-outdoor1/DSC02325.JPG,char_data/s/DSC02325.JPG_5.jpg,595,480,640,17,223,240,325,360,True,43
s,70,kaist_dataset/Mixed/Digital_Camera/(C.S)C-outdoor1/DSC02344.JPG,char_data/s/DSC02344.JPG_2.jpg,2870,480,640,41,512,553,164,234,True,43
s,51,kaist_dataset/Mixed/Digital_Camera/(C.S)C-outdoor2/DSC02407.JPG,char_data/s/DSC02407.JPG_2.jpg,1479,480,640,29,302,331,175,226,True,43
s,50,kaist_dataset/Mixed/Digital_Camera/(C.S)C-outdoor2/DSC02416.JPG,char_data/s/DSC02416.JPG_2.jpg,2650,480,640,53,522,575,208,258,True,43
s,62,kaist_dataset/Mixed/Digital_Camera/(C.S)C-outdoor2/DSC02418.JPG,char_data/s/DSC02418.JPG_5.jpg,2728,480,640,44,265,309,169,231,True,43
s,67,kaist_dataset/Mixed/Digital_Camera/(C.S)C-outdoor2/DSC02425.JPG,char_data/s/DSC02425.JPG_2.jpg,3886,480,640,58,449,507,167,234,True,43
s,20,kaist_dataset/Mixed/Digital_Camera/(C.S)C-outdoor2/DSC02430.JPG,char_data/s/DSC02430.JPG_2.jpg,180,480,640,9,15,24,29,49,True,43
s,22,kaist_dataset/Mixed/Digital_Camera/(C.S)C-outdoor2/DSC02483.JPG,char_data/s/DSC02483.JPG_4.jpg,264,480,640,12,343,355,152,174,True,43
s,74,kaist_dataset/Mixed/Digital_Camera/(C.S)C-outdoor2/DSC02493.JPG,char_data/s/DSC02493.JPG_2.jpg,4144,480,640,56,463,519,300,374,True,43
s,48,kaist_dataset/Mixed/Digital_Camera/(C.S)C-outdoor2/DSC02519.JPG,char_data/s/DSC02519.JPG_2.jpg,1488,480,640,31,210,241,224,272,True,43
s,35,kaist_dataset/Mixed/Digital_Camera/(C.S)C-outdoor2/DSC02532.JPG,char_data/s/DSC02532.JPG_2.jpg,525,480,640,15,471,486,88,123,True,43
s,54,kaist_dataset/Mixed/Digital_Camera/(C.S)C-outdoor2/DSC02701.JPG,char_data/s/DSC02701.JPG_2.jpg,2970,480,640,55,500,555,114,168,True,43
s,44,kaist_dataset/Mixed/Digital_Camera/(C.S)C-outdoor2/DSC02869.JPG,char_data/s/DSC02869.JPG_5.jpg,528,480,640,12,236,248,140,184,True,43
s,49,kaist_dataset/Mixed/Digital_Camera/(C.S)C-outdoor2/DSC02926.JPG,char_data/s/DSC02926.JPG_2.jpg,1225,480,640,25,138,163,137,186,True,43
s,36,kaist_dataset/Mixed/Digital_Camera/(C.S)C-outdoor2/DSC02927.JPG,char_data/s/DSC02927.JPG_2.jpg,540,480,640,15,255,270,369,405,True,43
s,38,kaist_dataset/Mixed/Digital_Camera/(C.S)C-outdoor2/DSC02928.JPG,char_data/s/DSC02928.JPG_2.jpg,836,480,640,22,408,430,390,428,True,43
s,35,kaist_dataset/Mixed/Digital_Camera/(C.S)C-outdoor2/DSC02936.JPG,char_data/s/DSC02936.JPG_6.jpg,455,480,640,13,184,197,80,115,True,43
s,32,kaist_dataset/Mixed/Digital_Camera/(C.S)C-outdoor2/DSC02936.JPG,char_data/s/DSC02936.JPG_7.jpg,544,480,640,17,296,313,86,118,True,43
s,30,kaist_dataset/Mixed/Digital_Camera/(C.S)C-outdoor2/DSC02936.JPG,char_data/s/DSC02936.JPG_8.jpg,540,480,640,18,391,409,92,122,True,43
s,44,kaist_dataset/Mixed/Digital_Camera/(C.S)C-outdoor3/DSC02962.JPG,char_data/s/DSC02962.JPG_2.jpg,1540,480,640,35,136,171,217,261,True,43
s,24,kaist_dataset/Mixed/Digital_Camera/(C.S)C-outdoor3/DSC03020.JPG,char_data/s/DSC03020.JPG_5.jpg,264,480,640,11,437,448,306,330,True,43
s,29,kaist_dataset/Mixed/Digital_Camera/(C.S)C-outdoor3/DSC03186.JPG,char_data/s/DSC03186.JPG_4.jpg,580,480,640,20,151,171,112,141,True,43
s,29,kaist_dataset/Mixed/Digital_Camera/(C.S)C-outdoor3/DSC03186.JPG,char_data/s/DSC03186.JPG_5.jpg,522,480,640,18,171,189,114,143,True,43
s,103,kaist_dataset/Mixed/Digital_Camera/(C.S)C-outdoor3/DSC03196.JPG,char_data/s/DSC03196.JPG_2.jpg,7210,480,640,70,288,358,290,393,True,43
s,27,kaist_dataset/Mixed/Digital_Camera/(C.S)C-outdoor3/DSC03209.JPG,char_data/s/DSC03209.JPG_2.jpg,540,480,640,20,326,346,423,450,True,43
s,43,kaist_dataset/Mixed/Digital_Camera/(C.S)C-outdoor3/DSC03310.JPG,char_data/s/DSC03310.JPG_2.jpg,602,480,640,14,304,318,124,167,True,43
s,34,kaist_dataset/Mixed/Digital_Camera/(C.S)C-outdoor4/DSC03556.JPG,char_data/s/DSC03556.JPG_2.jpg,680,480,640,20,379,399,316,350,True,43
s,65,kaist_dataset/Mixed/Digital_Camera/(C.S)C-outdoor4/DSC03630.JPG,char_data/s/DSC03630.JPG_2.jpg,2860,480,640,44,468,512,365,430,True,43
s,23,kaist_dataset/Mixed/Digital_Camera/(C.S)C-outdoor4/DSC03670.JPG,char_data/s/DSC03670.JPG_4.jpg,345,480,640,15,341,356,323,346,True,43
s,19,kaist_dataset/Mixed/Digital_Camera/(C.S)C-outdoor4/DSC03670.JPG,char_data/s/DSC03670.JPG_5.jpg,285,480,640,15,438,453,325,344,True,43
s,31,kaist_dataset/Mixed/Digital_Camera/(C.S)C-outdoor4/DSC03682.JPG,char_data/s/DSC03682.JPG_2.jpg,558,480,640,18,509,527,326,357,True,43
s,32,kaist_dataset/Mixed/Digital_Camera/(C.S)C-outdoor4/DSC03718.JPG,char_data/s/DSC03718.JPG_5.jpg,256,480,640,8,184,192,257,289,True,43
s,30,kaist_dataset/Mixed/Digital_Camera/(C.S)C-outdoor4/DSC03719.JPG,char_data/s/DSC03719.JPG_2.jpg,330,480,640,11,189,200,34,64,True,43
s,36,kaist_dataset/Mixed/Digital_Camera/(C.S)C-outdoor4/DSC03781.JPG,char_data/s/DSC03781.JPG_6.jpg,1404,480,640,39,344,383,318,354,True,43
s,38,kaist_dataset/Mixed/Digital_Camera/(C.S)C-outdoor4/DSC03781.JPG,char_data/s/DSC03781.JPG_7.jpg,1596,480,640,42,366,408,272,310,True,43
s,39,kaist_dataset/Mixed/Digital_Camera/(C.S)C-outdoor4/DSC03781.JPG,char_data/s/DSC03781.JPG_8.jpg,1560,480,640,40,409,449,227,266,True,43
s,59,kaist_dataset/Mixed/Digital_Camera/(C.S)C-outdoor4/DSC03784.JPG,char_data/s/DSC03784.JPG_4.jpg,1652,480,640,28,216,244,320,379,True,43
s,59,kaist_dataset/Mixed/Digital_Camera/(C.S)C-outdoor4/DSC03784.JPG,char_data/s/DSC03784.JPG_5.jpg,1770,480,640,30,377,407,322,381,True,43
s,50,kaist_dataset/Mixed/Digital_Camera/(C.S)C-outdoor5/DSC04015.JPG,char_data/s/DSC04015.JPG_2.jpg,1250,480,640,25,221,246,122,172,True,43
s,31,kaist_dataset/Mixed/Digital_Camera/(C.S)C-outdoor5/DSC04057.JPG,char_data/s/DSC04057.JPG_2.jpg,341,480,640,11,240,251,122,153,True,43
s,32,kaist_dataset/Mixed/Digital_Camera/(C.S)C-outdoor5/DSC04069.JPG,char_data/s/DSC04069.JPG_4.jpg,544,480,640,17,232,249,424,456,True,43
s,35,kaist_dataset/Mixed/Digital_Camera/(C.S)C-outdoor5/DSC04069.JPG,char_data/s/DSC04069.JPG_5.jpg,525,480,640,15,416,431,379,414,True,43
s,42,kaist_dataset/Mixed/Digital_Camera/(C.S)C-outdoor5/DSC04076.JPG,char_data/s/DSC04076.JPG_2.jpg,1050,480,640,25,197,222,103,145,True,43
s,78,kaist_dataset/Mixed/Digital_Camera/(C.S)C-outdoor5/DSC04128.JPG,char_data/s/DSC04128.JPG_2.jpg,4914,480,640,63,411,474,208,286,True,43
s,25,kaist_dataset/Mixed/Digital_Camera/(C.S)C-outdoor5/DSC04312.JPG,char_data/s/DSC04312.JPG_2.jpg,350,480,640,14,429,443,149,174,True,43
s,39,kaist_dataset/Mixed/Digital_Camera/(C.S)C-outdoor5/DSC04321.JPG,char_data/s/DSC04321.JPG_2.jpg,741,480,640,19,519,538,203,242,True,43
s,37,kaist_dataset/Mixed/Digital_Camera/(C.S)C-outdoor5/DSC04323.JPG,char_data/s/DSC04323.JPG_2.jpg,814,480,640,22,472,494,208,245,True,43
s,26,kaist_dataset/Mixed/Digital_Camera/(C.S)C-outdoor5/DSC04357.JPG,char_data/s/DSC04357.JPG_6.jpg,442,480,640,17,222,239,354,380,False,43
s,24,kaist_dataset/Mixed/Digital_Camera/(C.S)C-outdoor5/DSC04357.JPG,char_data/s/DSC04357.JPG_7.jpg,240,480,640,10,319,329,354,378,False,43
s,28,kaist_dataset/Mixed/Digital_Camera/(C.S)C-outdoor5/DSC04357.JPG,char_data/s/DSC04357.JPG_8.jpg,336,480,640,12,501,513,353,381,False,43
s,49,kaist_dataset/Mixed/Digital_Camera/(C.S)C-outdoor5/DSC04399.JPG,char_data/s/DSC04399.JPG_8.jpg,1323,480,640,27,411,438,215,264,False,43
s,50,kaist_dataset/Mixed/Digital_Camera/(C.S)C-outdoor5/DSC04399.JPG,char_data/s/DSC04399.JPG_9.jpg,1800,480,640,36,435,471,211,261,False,43
s,50,kaist_dataset/Mixed/Digital_Camera/(C.S)C-outdoor5/DSC04399.JPG,char_data/s/DSC04399.JPG_10.jpg,1700,480,640,34,421,455,282,332,False,43
s,57,kaist_dataset/Mixed/Digital_Camera/(C.S)C-outdoor5/DSC04399.JPG,char_data/s/DSC04399.JPG_11.jpg,1938,480,640,34,454,488,279,336,False,43
s,35,kaist_dataset/Mixed/Digital_Camera/(C.S)C-outdoor5/DSC04429.JPG,char_data/s/DSC04429.JPG_2.jpg,560,480,640,16,283,299,257,292,False,43
s,76,kaist_dataset/Mixed/Digital_Camera/(C.S)C-outdoor6/025.jpg,char_data/s/025.jpg_2.jpg,4940,293,472,65,390,455,76,152,False,43
s,151,kaist_dataset/Mixed/Digital_Camera/(C.S)C-outdoor6/080116-0057.jpg,char_data/s/080116-0057.jpg_6.jpg,15553,1200,1600,103,660,763,352,503,False,43
s,146,kaist_dataset/Mixed/Digital_Camera/(C.S)C-outdoor6/080116-0057.jpg,char_data/s/080116-0057.jpg_7.jpg,15914,1200,1600,109,760,869,356,502,False,43
s,36,kaist_dataset/Mixed/Digital_Camera/(C.S)C-outdoor6/P1010069.JPG,char_data/s/P1010069.JPG_2.jpg,576,480,640,16,190,206,293,329,False,43
s,28,kaist_dataset/Mixed/Digital_Camera/(C.S)C-outdoor6/P1010138.JPG,char_data/s/P1010138.JPG_2.jpg,504,480,640,18,207,225,179,207,False,43
s,20,kaist_dataset/Mixed/Digital_Camera/(C.S)C-outdoor6/크기변환_P1010029.JPG,char_data/s/크기변환_P1010029.JPG_2.jpg,320,480,640,16,284,300,24,44,False,43
s,42,kaist_dataset/Mixed/Digital_Camera/(C.S)D-indoor1/082.JPG,char_data/s/082.JPG_2.jpg,966,480,640,23,277,300,182,224,False,43
s,34,kaist_dataset/Mixed/Digital_Camera/(C.S)D-indoor1/DSC03073.JPG,char_data/s/DSC03073.JPG_2.jpg,714,480,640,21,439,460,338,372,False,43
s,40,kaist_dataset/Mixed/Digital_Camera/(C.S)D-indoor1/DSC03094.JPG,char_data/s/DSC03094.JPG_2.jpg,960,480,640,24,298,322,150,190,False,43
s,32,kaist_dataset/Mixed/Digital_Camera/(C.S)D-indoor1/DSC03096.JPG,char_data/s/DSC03096.JPG_4.jpg,448,480,640,14,410,424,427,459,False,43
s,32,kaist_dataset/Mixed/Digital_Camera/(C.S)D-indoor1/DSC03096.JPG,char_data/s/DSC03096.JPG_5.jpg,480,480,640,15,486,501,429,461,False,43
s,33,kaist_dataset/Mixed/Digital_Camera/(C.S)D-indoor1/DSC03118.JPG,char_data/s/DSC03118.JPG_2.jpg,528,480,640,16,441,457,230,263,False,43
s,30,kaist_dataset/Mixed/Digital_Camera/(C.S)D-indoor1/DSC03122.JPG,char_data/s/DSC03122.JPG_2.jpg,480,480,640,16,289,305,206,236,False,43
s,38,kaist_dataset/Mixed/Digital_Camera/(C.S)D-indoor1/DSC03134.JPG,char_data/s/DSC03134.JPG_2.jpg,722,480,640,19,261,280,169,207,False,43
s,82,kaist_dataset/Mixed/Digital_Camera/(C.S)D-indoor1/DSC03909.JPG,char_data/s/DSC03909.JPG_2.jpg,7216,480,640,88,166,254,200,282,False,43
s,42,kaist_dataset/Mixed/Digital_Camera/(C.S)D-indoor1/DSC04244.JPG,char_data/s/DSC04244.JPG_6.jpg,840,480,640,20,227,247,230,272,False,43
s,33,kaist_dataset/Mixed/Digital_Camera/(C.S)D-indoor1/DSC04244.JPG,char_data/s/DSC04244.JPG_7.jpg,825,480,640,25,409,434,239,272,False,43
s,34,kaist_dataset/Mixed/Digital_Camera/(C.S)D-indoor1/DSC04244.JPG,char_data/s/DSC04244.JPG_8.jpg,918,480,640,27,433,460,240,274,False,43
s,43,kaist_dataset/Mixed/Digital_Camera/(C.S)D-indoor2/DSC04421.JPG,char_data/s/DSC04421.JPG_6.jpg,860,480,640,20,201,221,218,261,False,43
s,46,kaist_dataset/Mixed/Digital_Camera/(C.S)D-indoor2/DSC04421.JPG,char_data/s/DSC04421.JPG_7.jpg,1104,480,640,24,288,312,214,260,False,43
s,47,kaist_dataset/Mixed/Digital_Camera/(C.S)D-indoor2/DSC04421.JPG,char_data/s/DSC04421.JPG_8.jpg,1034,480,640,22,312,334,216,263,False,43
s,26,kaist_dataset/Mixed/Digital_Camera/(C.S)E-night/DSC02569.JPG,char_data/s/DSC02569.JPG_5.jpg,546,480,640,21,352,373,277,303,False,43
s,42,kaist_dataset/Mixed/Digital_Camera/(C.S)E-night/DSC02574.JPG,char_data/s/DSC02574.JPG_2.jpg,1218,480,640,29,402,431,151,193,False,43
s,48,kaist_dataset/Mixed/Digital_Camera/(C.S)E-night/DSC02600.JPG,char_data/s/DSC02600.JPG_2.jpg,2256,480,640,47,192,239,29,77,False,43
s,35,kaist_dataset/Mixed/Digital_Camera/(C.S)E-night/DSC02623.JPG,char_data/s/DSC02623.JPG_2.jpg,910,480,640,26,307,333,397,432,False,43
s,53,kaist_dataset/Mixed/Digital_Camera/(C.S)E-night/DSC02647.JPG,char_data/s/DSC02647.JPG_2.jpg,2279,480,640,43,119,162,216,269,False,43
s,56,kaist_dataset/Mixed/Digital_Camera/(C.S)E-night/DSC03840.JPG,char_data/s/DSC03840.JPG_5.jpg,2520,480,640,45,252,297,125,181,False,43
s,54,kaist_dataset/Mixed/Digital_Camera/(C.S)F-others/047.jpg,char_data/s/047.jpg_4.jpg,1836,252,339,34,201,235,53,107,False,43
s,32,kaist_dataset/Mixed/Digital_Camera/(C.S)F-others/2007-12-09-day-exterior-032.jpg,char_data/s/2007-12-09-day-exterior-032.jpg_2.jpg,576,1600,1200,18,606,624,283,315,False,43
s,67,kaist_dataset/Mixed/Digital_Camera/(C.S)F-others/DSC02696.JPG,char_data/s/DSC02696.JPG_2.jpg,2881,480,640,43,456,499,307,374,False,43
s,30,kaist_dataset/Mixed/Mobile_Phone/(C.M)A-outdoor/P090912078.jpg,char_data/s/P090912078.jpg_6.jpg,630,480,640,21,87,108,318,348,False,43
s,53,kaist_dataset/Mixed/Mobile_Phone/(C.M)B-indoor/P090831015.jpg,char_data/s/P090831015.jpg_2.jpg,2014,480,640,38,190,228,208,261,False,43
s,38,kaist_dataset/Mixed/Mobile_Phone/(C.M)B-indoor/P090831016.jpg,char_data/s/P090831016.jpg_5.jpg,1558,480,640,41,402,443,201,239,False,43
s,68,kaist_dataset/Mixed/Mobile_Phone/(C.M)B-indoor/P090831019.jpg,char_data/s/P090831019.jpg_2.jpg,3400,480,640,50,381,431,157,225,False,43
s,53,kaist_dataset/Mixed/Mobile_Phone/(C.M)B-indoor/P090831023.jpg,char_data/s/P090831023.jpg_2.jpg,2173,480,640,41,365,406,276,329,False,43
s,38,kaist_dataset/Mixed/Mobile_Phone/(C.M)C-bookCover/P090831080.jpg,char_data/s/P090831080.jpg_8.jpg,760,480,640,20,246,266,410,448,False,43
s,30,kaist_dataset/Mixed/Mobile_Phone/(C.M)C-bookCover/P090831080.jpg,char_data/s/P090831080.jpg_9.jpg,660,480,640,22,365,387,414,444,False,43
s,37,kaist_dataset/Mixed/Mobile_Phone/(C.M)C-bookCover/P090831080.jpg,char_data/s/P090831080.jpg_10.jpg,777,480,640,21,441,462,406,443,False,43
s,38,kaist_dataset/Mixed/Mobile_Phone/(C.M)C-bookCover/P090831080.jpg,char_data/s/P090831080.jpg_11.jpg,1292,480,640,34,460,494,407,445,False,43
s,38,kaist_dataset/Mixed/Mobile_Phone/(C.M)C-bookCover/P090831124.jpg,char_data/s/P090831124.jpg_4.jpg,684,480,640,18,316,334,404,442,False,43
s,32,kaist_dataset/Mixed/Mobile_Phone/(C.M)C-bookCover/P090831124.jpg,char_data/s/P090831124.jpg_5.jpg,640,480,640,20,354,374,409,441,False,43
s,36,kaist_dataset/Mixed/Mobile_Phone/(C.M)C-bookCover/P090902016.jpg,char_data/s/P090902016.jpg_10.jpg,648,480,640,18,357,375,139,175,False,43
s,38,kaist_dataset/Mixed/Mobile_Phone/(C.M)C-bookCover/P090902016.jpg,char_data/s/P090902016.jpg_11.jpg,874,480,640,23,375,398,141,179,False,43
s,31,kaist_dataset/Mixed/Mobile_Phone/(C.M)C-bookCover/P090902016.jpg,char_data/s/P090902016.jpg_13.jpg,682,480,640,22,169,191,273,304,False,43
s,44,kaist_dataset/Mixed/Mobile_Phone/(C.M)C-bookCover/P090903083.jpg,char_data/s/P090903083.jpg_2.jpg,1320,480,640,30,359,389,177,221,False,43
s,35,kaist_dataset/Mixed/Mobile_Phone/(C.M)C-bookCover/P090904005.jpg,char_data/s/P090904005.jpg_2.jpg,1050,480,640,30,384,414,121,156,False,43
리,31,kaist_dataset/English/Digital_Camera/(E.S)B-light/080116-0059.jpg,char_data/리/080116-0059.jpg_10.jpg,620,1200,1600,20,469,489,912,943,True,59
리,29,kaist_dataset/English/Digital_Camera/(E.S)B-light/080116-0059.jpg,char_data/리/080116-0059.jpg_11.jpg,551,1200,1600,19,819,838,948,977,True,59
리,28,kaist_dataset/English/Digital_Camera/(E.S)B-light/080116-0059.jpg,char_data/리/080116-0059.jpg_12.jpg,476,1200,1600,17,1123,1140,939,967,True,59
리,31,kaist_dataset/English/Digital_Camera/(E.S)B-light/080116-0059.jpg,char_data/리/080116-0059.jpg_13.jpg,558,1200,1600,18,804,822,989,1020,True,59
리,30,kaist_dataset/English/Digital_Camera/(E.S)B-light/080116-0059.jpg,char_data/리/080116-0059.jpg_14.jpg,450,1200,1600,15,1012,1027,1064,1094,True,59
리,41,kaist_dataset/English/Digital_Camera/(E.S)C-outdoor1/034.JPG,char_data/리/034.JPG_2.jpg,574,480,640,14,147,161,105,146,True,59
리,25,kaist_dataset/English/Digital_Camera/(E.S)C-outdoor1/6.jpg,char_data/리/6.jpg_2.jpg,375,255,731,15,61,76,185,210,True,59
리,101,kaist_dataset/Korean/Digital_Camera/A-shadow/DSC02688.JPG,char_data/리/DSC02688.JPG_2.jpg,11716,480,640,116,353,469,256,357,True,59
리,76,kaist_dataset/Korean/Digital_Camera/A-shadow/P090911055.jpg,char_data/리/P090911055.jpg_2.jpg,3420,480,640,45,58,103,104,180,True,59
리,126,kaist_dataset/Korean/Digital_Camera/A-shadow/P090911056.jpg,char_data/리/P090911056.jpg_2.jpg,19026,480,640,151,147,298,48,174,True,59
리,44,kaist_dataset/Korean/Digital_Camera/A-shadow/P1010036.JPG,char_data/리/P1010036.JPG_2.jpg,1144,480,640,26,262,288,97,141,True,59
리,88,kaist_dataset/Korean/Digital_Camera/A-shadow/P1010128.JPG,char_data/리/P1010128.JPG_2.jpg,9944,480,640,113,451,564,123,211,True,59
리,63,kaist_dataset/Korean/Digital_Camera/E-night/103.jpg,char_data/리/103.jpg_2.jpg,3528,480,640,56,379,435,176,239,True,59
리,23,kaist_dataset/Korean/Digital_Camera/E-night/106.jpg,char_data/리/106.jpg_6.jpg,552,480,640,24,286,310,112,135,True,59
리,22,kaist_dataset/Korean/Digital_Camera/E-night/106.jpg,char_data/리/106.jpg_7.jpg,484,480,640,22,328,350,110,132,True,59
리,77,kaist_dataset/Korean/Digital_Camera/E-night/106.jpg,char_data/리/106.jpg_8.jpg,5852,480,640,76,237,313,228,305,True,59
리,94,kaist_dataset/Korean/Digital_Camera/E-night/DSC02588.JPG,char_data/리/DSC02588.JPG_2.jpg,9306,480,640,99,276,375,96,190,True,59
리,157,kaist_dataset/Korean/Digital_Camera/E-night/DSC02597.JPG,char_data/리/DSC02597.JPG_2.jpg,24963,480,640,159,437,596,100,257,True,59
리,67,kaist_dataset/Korean/Digital_Camera/E-night/DSC02608.JPG,char_data/리/DSC02608.JPG_2.jpg,4288,480,640,64,40,104,300,367,True,59
리,136,kaist_dataset/Korean/Digital_Camera/E-night/DSC02614.JPG,char_data/리/DSC02614.JPG_2.jpg,13736,480,640,101,374,475,278,414,True,59
리,141,kaist_dataset/Korean/Digital_Camera/E-night/DSC02621.JPG,char_data/리/DSC02621.JPG_2.jpg,24534,480,640,174,220,394,255,396,True,59
리,162,kaist_dataset/Korean/Digital_Camera/E-night/DSC02638.JPG,char_data/리/DSC02638.JPG_2.jpg,26892,480,640,166,241,407,117,279,True,59
리,98,kaist_dataset/Korean/Digital_Camera/E-night/DSC03021.JPG,char_data/리/DSC03021.JPG_2.jpg,12446,480,640,127,172,299,36,134,True,59
리,65,kaist_dataset/Korean/Digital_Camera/E-night/DSC03861.JPG,char_data/리/DSC03861.JPG_2.jpg,4030,480,640,62,251,313,302,367,True,59
리,47,kaist_dataset/Korean/Digital_Camera/E-night/P1010146.JPG,char_data/리/P1010146.JPG_2.jpg,2444,480,640,52,223,275,187,234,True,59
리,103,kaist_dataset/Korean/Digital_Camera/F-bookCover/DSC02806.JPG,char_data/리/DSC02806.JPG_2.jpg,8961,480,640,87,340,427,57,160,True,59
리,53,kaist_dataset/Korean/Digital_Camera/F-bookCover/DSC03933.JPG,char_data/리/DSC03933.JPG_2.jpg,1908,480,640,36,387,423,282,335,True,59
리,61,kaist_dataset/Korean/Digital_Camera/F-bookCover/DSC04218.JPG,char_data/리/DSC04218.JPG_2.jpg,3050,480,640,50,193,243,127,188,True,59
리,53,kaist_dataset/Korean/Digital_Camera/F-bookCover/DSC04228.JPG,char_data/리/DSC04228.JPG_2.jpg,1219,480,640,23,69,92,113,166,True,59
리,169,kaist_dataset/Korean/Digital_Camera/F-bookCover/P090911030.jpg,char_data/리/P090911030.jpg_2.jpg,26364,480,640,156,276,432,287,456,True,59
리,81,kaist_dataset/Korean/Digital_Camera/F-bookCover/P090911044.jpg,char_data/리/P090911044.jpg_2.jpg,7776,480,640,96,216,312,97,178,True,59
리,50,kaist_dataset/Korean/Digital_Camera/G-others/2007-12-09-day-exterior-062.jpg,char_data/리/2007-12-09-day-exterior-062.jpg_2.jpg,1800,1600,1200,36,594,630,69,119,True,59
리,95,kaist_dataset/Korean/Digital_Camera/indoor1/080119-0030.jpg,char_data/리/080119-0030.jpg_2.jpg,7220,1200,1600,76,586,662,431,526,True,59
리,77,kaist_dataset/Korean/Digital_Camera/indoor1/094.jpg,char_data/리/094.jpg_2.jpg,8393,480,640,109,449,558,165,242,True,59
리,70,kaist_dataset/Korean/Digital_Camera/indoor1/141.JPG,char_data/리/141.JPG_2.jpg,3780,480,640,54,457,511,211,281,True,59
리,30,kaist_dataset/Korean/Digital_Camera/indoor1/145.JPG,char_data/리/145.JPG_2.jpg,900,480,640,30,560,590,283,313,True,59
리,101,kaist_dataset/Korean/Digital_Camera/indoor1/2007-12-08-day-139.jpg,char_data/리/2007-12-08-day-139.jpg_2.jpg,9494,1200,1600,94,488,582,410,511,True,59
리,63,kaist_dataset/Korean/Digital_Camera/indoor1/DSC02720.JPG,char_data/리/DSC02720.JPG_2.jpg,3654,480,640,58,559,617,79,142,True,59
리,114,kaist_dataset/Korean/Digital_Camera/indoor1/DSC02721.JPG,char_data/리/DSC02721.JPG_2.jpg,9348,480,640,82,91,173,138,252,True,59
리,105,kaist_dataset/Korean/Digital_Camera/indoor1/DSC02735.JPG,char_data/리/DSC02735.JPG_2.jpg,12600,480,640,120,504,624,314,419,True,59
리,39,kaist_dataset/Korean/Digital_Camera/indoor1/DSC02742.JPG,char_data/리/DSC02742.JPG_2.jpg,1053,480,640,27,280,307,199,238,True,59
리,84,kaist_dataset/Korean/Digital_Camera/indoor1/DSC02765.JPG,char_data/리/DSC02765.JPG_2.jpg,7560,480,640,90,382,472,193,277,True,59
리,77,kaist_dataset/Korean/Digital_Camera/indoor2/DSC03391.JPG,char_data/리/DSC03391.JPG_2.jpg,4697,480,640,61,399,460,236,313,True,59
리,64,kaist_dataset/Korean/Digital_Camera/indoor2/DSC03399.JPG,char_data/리/DSC03399.JPG_2.jpg,2304,480,640,36,217,253,253,317,True,59
리,74,kaist_dataset/Korean/Digital_Camera/indoor2/DSC03497.JPG,char_data/리/DSC03497.JPG_2.jpg,3848,480,640,52,198,250,85,159,True,59
리,49,kaist_dataset/Korean/Digital_Camera/indoor2/DSC03564.JPG,char_data/리/DSC03564.JPG_2.jpg,2940,480,640,60,254,314,166,215,True,59
리,65,kaist_dataset/Korean/Digital_Camera/indoor2/DSC03902.JPG,char_data/리/DSC03902.JPG_2.jpg,3250,480,640,50,326,376,135,200,True,59
리,43,kaist_dataset/Korean/Digital_Camera/indoor2/DSC03983.JPG,char_data/리/DSC03983.JPG_2.jpg,1677,480,640,39,379,418,278,321,True,59
리,123,kaist_dataset/Korean/Digital_Camera/indoor2/DSC03994.JPG,char_data/리/DSC03994.JPG_4.jpg,7749,480,640,63,420,483,145,268,True,59
리,53,kaist_dataset/Korean/Digital_Camera/indoor2/DSC03994.JPG,char_data/리/DSC03994.JPG_5.jpg,1961,480,640,37,99,136,86,139,True,59
리,81,kaist_dataset/Korean/Digital_Camera/indoor2/DSC03995.JPG,char_data/리/DSC03995.JPG_4.jpg,8343,480,640,103,56,159,112,193,True,59
리,44,kaist_dataset/Korean/Digital_Camera/indoor2/DSC03995.JPG,char_data/리/DSC03995.JPG_5.jpg,1980,480,640,45,288,333,270,314,True,59
리,114,kaist_dataset/Korean/Digital_Camera/indoor2/DSC04417.JPG,char_data/리/DSC04417.JPG_2.jpg,7410,480,640,65,429,494,123,237,True,59
리,30,kaist_dataset/Korean/Digital_Camera/outdoor1/026.jpg,char_data/리/026.jpg_4.jpg,1020,480,640,34,266,300,108,138,True,59
리,33,kaist_dataset/Korean/Digital_Camera/outdoor1/026.jpg,char_data/리/026.jpg_5.jpg,660,480,640,20,388,408,257,290,True,59
리,100,kaist_dataset/Korean/Digital_Camera/outdoor1/029.JPG,char_data/리/029.JPG_2.jpg,6100,480,640,61,140,201,192,292,True,59
리,35,kaist_dataset/Korean/Digital_Camera/outdoor1/046.jpg,char_data/리/046.jpg_2.jpg,840,256,363,24,95,119,115,150,True,59
리,70,kaist_dataset/Korean/Digital_Camera/outdoor1/115.jpg,char_data/리/115.jpg_2.jpg,3430,480,640,49,226,275,284,354,True,59
리,82,kaist_dataset/Korean/Digital_Camera/outdoor1/125.JPG,char_data/리/125.JPG_2.jpg,6314,480,640,77,451,528,171,253,True,59
리,36,kaist_dataset/Korean/Digital_Camera/outdoor1/40.jpg,char_data/리/40.jpg_2.jpg,1080,308,367,30,282,312,65,101,True,59
리,74,kaist_dataset/Korean/Digital_Camera/outdoor2/080116-0063.jpg,char_data/리/080116-0063.jpg_4.jpg,4292,600,800,58,449,507,318,392,True,59
리,29,kaist_dataset/Korean/Digital_Camera/outdoor2/080116-0063.jpg,char_data/리/080116-0063.jpg_5.jpg,783,600,800,27,574,601,571,599,True,59
리,221,kaist_dataset/Korean/Digital_Camera/outdoor2/080118-0018.jpg,char_data/리/080118-0018.jpg_2.jpg,42653,1200,1600,193,1176,1369,457,678,True,59
리,70,kaist_dataset/Korean/Digital_Camera/outdoor2/2007-12-08-day-094.jpg,char_data/리/2007-12-08-day-094.jpg_2.jpg,3430,1600,1200,49,1020,1069,578,648,True,59
리,55,kaist_dataset/Korean/Digital_Camera/outdoor2/2007-12-08-day-109.jpg,char_data/리/2007-12-08-day-109.jpg_4.jpg,1595,1200,1600,29,514,543,881,936,True,59
리,45,kaist_dataset/Korean/Digital_Camera/outdoor2/2007-12-08-day-109.jpg,char_data/리/2007-12-08-day-109.jpg_5.jpg,720,1200,1600,16,637,653,1127,1172,True,59
리,42,kaist_dataset/Korean/Digital_Camera/outdoor2/2007-12-09-day-exterior-035.jpg,char_data/리/2007-12-09-day-exterior-035.jpg_2.jpg,1764,1200,1600,42,901,943,506,548,True,59
리,243,kaist_dataset/Korean/Digital_Camera/outdoor2/2007-12-09-day-exterior-036.jpg,char_data/리/2007-12-09-day-exterior-036.jpg_4.jpg,62937,1200,1600,259,504,763,431,674,True,59
리,51,kaist_dataset/Korean/Digital_Camera/outdoor2/2007-12-09-day-exterior-036.jpg,char_data/리/2007-12-09-day-exterior-036.jpg_5.jpg,2499,1200,1600,49,1461,1510,1106,1157,True,59
리,142,kaist_dataset/Korean/Digital_Camera/outdoor2/2007-12-09-day-exterior-084.jpg,char_data/리/2007-12-09-day-exterior-084.jpg_2.jpg,19028,1200,1600,134,888,1022,452,594,True,59
리,57,kaist_dataset/Korean/Digital_Camera/outdoor2/DSC02327.JPG,char_data/리/DSC02327.JPG_4.jpg,3192,480,640,56,486,542,166,223,True,59
리,66,kaist_dataset/Korean/Digital_Camera/outdoor2/DSC02327.JPG,char_data/리/DSC02327.JPG_5.jpg,4224,480,640,64,213,277,267,333,True,59
리,40,kaist_dataset/Korean/Digital_Camera/outdoor2/DSC02366.JPG,char_data/리/DSC02366.JPG_2.jpg,1240,480,640,31,229,260,174,214,True,59
리,65,kaist_dataset/Korean/Digital_Camera/outdoor2/DSC02420.JPG,char_data/리/DSC02420.JPG_2.jpg,3835,480,640,59,547,606,276,341,True,59
리,45,kaist_dataset/Korean/Digital_Camera/outdoor2/DSC02506.JPG,char_data/리/DSC02506.JPG_2.jpg,1980,480,640,44,132,176,101,146,True,59
리,86,kaist_dataset/Korean/Digital_Camera/outdoor3/DSC02531.JPG,char_data/리/DSC02531.JPG_2.jpg,7998,480,640,93,373,466,247,333,True,59
리,87,kaist_dataset/Korean/Digital_Camera/outdoor3/DSC02558.JPG,char_data/리/DSC02558.JPG_2.jpg,7308,480,640,84,287,371,144,231,True,59
리,64,kaist_dataset/Korean/Digital_Camera/outdoor3/DSC02878.JPG,char_data/리/DSC02878.JPG_2.jpg,3968,480,640,62,155,217,188,252,True,59
리,55,kaist_dataset/Korean/Digital_Camera/outdoor3/DSC02891.JPG,char_data/리/DSC02891.JPG_2.jpg,2585,480,640,47,423,470,352,407,True,59
리,68,kaist_dataset/Korean/Digital_Camera/outdoor3/DSC02901.JPG,char_data/리/DSC02901.JPG_2.jpg,3400,480,640,50,468,518,388,456,True,59
리,67,kaist_dataset/Korean/Digital_Camera/outdoor3/DSC02934.JPG,char_data/리/DSC02934.JPG_2.jpg,4958,480,640,74,492,566,58,125,True,59
리,86,kaist_dataset/Korean/Digital_Camera/outdoor3/DSC02983.JPG,char_data/리/DSC02983.JPG_2.jpg,7482,480,640,87,291,378,43,129,True,59
리,87,kaist_dataset/Korean/Digital_Camera/outdoor3/DSC02997.JPG,char_data/리/DSC02997.JPG_2.jpg,6264,480,640,72,511,583,162,249,True,59
리,87,kaist_dataset/Korean/Digital_Camera/outdoor3/DSC02999.JPG,char_data/리/DSC02999.JPG_2.jpg,4524,480,640,52,383,435,43,130,True,59
리,194,kaist_dataset/Korean/Digital_Camera/outdoor3/DSC03182.JPG,char_data/리/DSC03182.JPG_2.jpg,16296,480,640,84,221,305,201,395,True,59
리,47,kaist_dataset/Korean/Digital_Camera/outdoor3/DSC03235.JPG,char_data/리/DSC03235.JPG_4.jpg,1927,480,640,41,40,81,365,412,True,59
리,44,kaist_dataset/Korean/Digital_Camera/outdoor3/DSC03235.JPG,char_data/리/DSC03235.JPG_5.jpg,1760,480,640,40,416,456,361,405,True,59
리,38,kaist_dataset/Korean/Digital_Camera/outdoor4/DSC03268.JPG,char_data/리/DSC03268.JPG_2.jpg,1824,480,640,48,127,175,192,230,True,59
리,69,kaist_dataset/Korean/Digital_Camera/outdoor4/DSC03288.JPG,char_data/리/DSC03288.JPG_2.jpg,4623,480,640,67,472,539,58,127,True,59
리,63,kaist_dataset/Korean/Digital_Camera/outdoor4/DSC03321.JPG,char_data/리/DSC03321.JPG_2.jpg,3843,480,640,61,238,299,107,170,True,59
리,68,kaist_dataset/Korean/Digital_Camera/outdoor4/DSC03505.JPG,char_data/리/DSC03505.JPG_2.jpg,3876,480,640,57,192,249,239,307,True,59
리,62,kaist_dataset/Korean/Digital_Camera/outdoor4/DSC03591.JPG,char_data/리/DSC03591.JPG_2.jpg,3472,480,640,56,409,465,325,387,True,59
리,90,kaist_dataset/Korean/Digital_Camera/outdoor4/DSC03593.JPG,char_data/리/DSC03593.JPG_2.jpg,7200,480,640,80,420,500,167,257,True,59
리,55,kaist_dataset/Korean/Digital_Camera/outdoor4/DSC03595.JPG,char_data/리/DSC03595.JPG_2.jpg,2640,480,640,48,498,546,174,229,True,59
리,68,kaist_dataset/Korean/Digital_Camera/outdoor4/DSC03597.JPG,char_data/리/DSC03597.JPG_2.jpg,4760,480,640,70,473,543,89,157,True,59
리,34,kaist_dataset/Korean/Digital_Camera/outdoor5/DSC03636.JPG,char_data/리/DSC03636.JPG_2.jpg,884,480,640,26,110,136,398,432,True,59
리,116,kaist_dataset/Korean/Digital_Camera/outdoor5/DSC03646.JPG,char_data/리/DSC03646.JPG_2.jpg,9396,480,640,81,383,464,343,459,True,59
리,53,kaist_dataset/Korean/Digital_Camera/outdoor5/DSC03683.JPG,char_data/리/DSC03683.JPG_2.jpg,2438,480,640,46,463,509,46,99,True,59
리,45,kaist_dataset/Korean/Digital_Camera/outdoor5/DSC03692.JPG,char_data/리/DSC03692.JPG_2.jpg,1170,480,640,26,318,344,175,220,True,59
리,41,kaist_dataset/Korean/Digital_Camera/outdoor5/DSC03746.JPG,char_data/리/DSC03746.JPG_2.jpg,1886,480,640,46,538,584,359,400,True,59
리,28,kaist_dataset/Korean/Digital_Camera/outdoor5/DSC03751.JPG,char_data/리/DSC03751.JPG_2.jpg,812,480,640,29,557,586,370,398,True,59
리,35,kaist_dataset/Korean/Digital_Camera/outdoor5/DSC03768.JPG,char_data/리/DSC03768.JPG_2.jpg,1295,480,640,37,289,326,238,273,True,59
리,26,kaist_dataset/Korean/Digital_Camera/outdoor5/DSC03777.JPG,char_data/리/DSC03777.JPG_2.jpg,546,480,640,21,85,106,275,301,True,59
리,106,kaist_dataset/Korean/Digital_Camera/outdoor5/DSC03860.JPG,char_data/리/DSC03860.JPG_2.jpg,14840,480,640,140,150,290,66,172,True,59
리,63,kaist_dataset/Korean/Digital_Camera/outdoor5/DSC03993.JPG,char_data/리/DSC03993.JPG_2.jpg,3087,480,640,49,285,334,119,182,True,59
리,95,kaist_dataset/Korean/Digital_Camera/outdoor5/DSC04027.JPG,char_data/리/DSC04027.JPG_2.jpg,7505,480,640,79,520,599,274,369,True,59
리,104,kaist_dataset/Korean/Digital_Camera/outdoor6/DSC04041.JPG,char_data/리/DSC04041.JPG_2.jpg,7696,480,640,74,391,465,10,114,True,59
리,53,kaist_dataset/Korean/Digital_Camera/outdoor6/DSC04044.JPG,char_data/리/DSC04044.JPG_2.jpg,2703,480,640,51,55,106,417,470,True,59
리,62,kaist_dataset/Korean/Digital_Camera/outdoor6/DSC04045.JPG,char_data/리/DSC04045.JPG_2.jpg,3720,480,640,60,120,180,104,166,True,59
리,59,kaist_dataset/Korean/Digital_Camera/outdoor6/DSC04062.JPG,char_data/리/DSC04062.JPG_2.jpg,3422,480,640,58,496,554,224,283,True,59
리,66,kaist_dataset/Korean/Digital_Camera/outdoor6/DSC04073.JPG,char_data/리/DSC04073.JPG_2.jpg,3234,480,640,49,292,341,30,96,True,59
리,75,kaist_dataset/Korean/Digital_Camera/outdoor6/DSC04084.JPG,char_data/리/DSC04084.JPG_2.jpg,4725,480,640,63,250,313,183,258,True,59
리,76,kaist_dataset/Korean/Digital_Camera/outdoor6/DSC04095.JPG,char_data/리/DSC04095.JPG_2.jpg,5396,480,640,71,254,325,216,292,True,59
리,31,kaist_dataset/Korean/Digital_Camera/outdoor6/DSC04112.JPG,char_data/리/DSC04112.JPG_2.jpg,806,480,640,26,87,113,275,306,True,59
리,49,kaist_dataset/Korean/Digital_Camera/outdoor6/DSC04137.JPG,char_data/리/DSC04137.JPG_2.jpg,2842,480,640,58,447,505,401,450,True,59
리,64,kaist_dataset/Korean/Digital_Camera/outdoor6/DSC04307.JPG,char_data/리/DSC04307.JPG_2.jpg,3072,480,640,48,463,511,284,348,True,59
리,66,kaist_dataset/Korean/Digital_Camera/outdoor6/DSC04347.JPG,char_data/리/DSC04347.JPG_2.jpg,6204,480,640,94,242,336,334,400,True,59
리,83,kaist_dataset/Korean/Digital_Camera/outdoor6/DSC04400.JPG,char_data/리/DSC04400.JPG_2.jpg,5478,480,640,66,390,456,303,386,True,59
리,70,kaist_dataset/Korean/Digital_Camera/outdoor6/DSC04435.JPG,char_data/리/DSC04435.JPG_2.jpg,3780,480,640,54,274,328,373,443,True,59
리,62,kaist_dataset/Korean/Digital_Camera/outdoor7/P1010009.JPG,char_data/리/P1010009.JPG_2.jpg,3782,480,640,61,455,516,157,219,True,59
리,49,kaist_dataset/Korean/Digital_Camera/outdoor7/P1010035.JPG,char_data/리/P1010035.JPG_2.jpg,2107,480,640,43,129,172,123,172,True,59
리,56,kaist_dataset/Korean/Digital_Camera/outdoor7/P1010070.JPG,char_data/리/P1010070.JPG_4.jpg,4144,480,640,74,400,474,26,82,True,59
리,63,kaist_dataset/Korean/Digital_Camera/outdoor7/P1010070.JPG,char_data/리/P1010070.JPG_5.jpg,5166,480,640,82,405,487,100,163,True,59
리,48,kaist_dataset/Korean/Digital_Camera/outdoor7/P1010089.JPG,char_data/리/P1010089.JPG_2.jpg,3552,480,640,74,264,338,9,57,True,59
리,64,kaist_dataset/Korean/Digital_Camera/outdoor7/P1010106.JPG,char_data/리/P1010106.JPG_2.jpg,3136,480,640,49,49,98,169,233,True,59
리,82,kaist_dataset/Korean/Digital_Camera/outdoor7/P1010115.JPG,char_data/리/P1010115.JPG_2.jpg,6970,480,640,85,428,513,310,392,True,59
리,60,kaist_dataset/Korean/Digital_Camera/outdoor7/P1010126.JPG,char_data/리/P1010126.JPG_2.jpg,3780,480,640,63,422,485,78,138,True,59
리,212,kaist_dataset/Korean/Digital_Camera/outdoor8/2007-12-08-day-132.jpg,char_data/리/2007-12-08-day-132.jpg_2.jpg,24804,1200,1600,117,620,737,539,751,True,59
리,109,kaist_dataset/Korean/Digital_Camera/outdoor8/P1010143.JPG,char_data/리/P1010143.JPG_2.jpg,12971,480,640,119,298,417,158,267,True,59
리,36,kaist_dataset/Korean/Digital_Camera/outdoor8/P1010178.JPG,char_data/리/P1010178.JPG_2.jpg,1332,480,640,37,373,410,348,384,True,59
리,106,kaist_dataset/Korean/Digital_Camera/outdoor8/P1011112.JPG,char_data/리/P1011112.JPG_4.jpg,9858,480,640,93,356,449,101,207,True,59
리,42,kaist_dataset/Korean/Digital_Camera/outdoor8/P1011112.JPG,char_data/리/P1011112.JPG_5.jpg,1176,480,640,28,59,87,192,234,True,59
리,81,"kaist_dataset/Korean/Mobile_Phone/(M,K)A-shadow/P090912067.jpg",char_data/리/P090912067.jpg_2.jpg,7614,480,640,94,232,326,186,267,True,59
리,75,"kaist_dataset/Korean/Mobile_Phone/(M,K)B-light/P090911073.jpg",char_data/리/P090911073.jpg_2.jpg,4725,480,640,63,214,277,292,367,True,59
리,96,"kaist_dataset/Korean/Mobile_Phone/(M,K)C-outdoor/P090912041.jpg",char_data/리/P090912041.jpg_2.jpg,7872,480,640,82,164,246,161,257,True,59
리,34,"kaist_dataset/Korean/Mobile_Phone/(M,K)C-outdoor/P090912048.jpg",char_data/리/P090912048.jpg_2.jpg,1530,480,640,45,381,426,89,123,True,59
리,102,"kaist_dataset/Korean/Mobile_Phone/(M,K)E-bookCover/P090831029.jpg",char_data/리/P090831029.jpg_2.jpg,7140,480,640,70,194,264,209,311,True,59
리,54,"kaist_dataset/Korean/Mobile_Phone/(M,K)E-bookCover/P090831036.jpg",char_data/리/P090831036.jpg_2.jpg,2160,480,640,40,182,222,21,75,True,59
리,108,"kaist_dataset/Korean/Mobile_Phone/(M,K)E-bookCover/P090831040.jpg",char_data/리/P090831040.jpg_2.jpg,10260,480,640,95,140,235,123,231,True,59
리,72,"kaist_dataset/Korean/Mobile_Phone/(M,K)E-bookCover/P090831082.jpg",char_data/리/P090831082.jpg_2.jpg,4896,480,640,68,79,147,36,108,True,59
리,73,"kaist_dataset/Korean/Mobile_Phone/(M,K)E-bookCover/P090831084.jpg",char_data/리/P090831084.jpg_2.jpg,4891,480,640,67,65,132,38,111,True,59
리,77,"kaist_dataset/Korean/Mobile_Phone/(M,K)E-bookCover/P090831086.jpg",char_data/리/P090831086.jpg_2.jpg,4697,480,640,61,91,152,34,111,True,59
리,72,"kaist_dataset/Korean/Mobile_Phone/(M,K)E-bookCover/P090831087.jpg",char_data/리/P090831087.jpg_2.jpg,4464,480,640,62,94,156,29,101,True,59
리,74,"kaist_dataset/Korean/Mobile_Phone/(M,K)E-bookCover/P090831088.jpg",char_data/리/P090831088.jpg_2.jpg,4366,480,640,59,97,156,18,92,True,59
리,94,"kaist_dataset/Korean/Mobile_Phone/(M,K)E-bookCover/P090831089.jpg",char_data/리/P090831089.jpg_2.jpg,7332,480,640,78,96,174,16,110,True,59
리,90,"kaist_dataset/Korean/Mobile_Phone/(M,K)E-bookCover/P090831090.jpg",char_data/리/P090831090.jpg_2.jpg,7200,480,640,80,123,203,31,121,True,59
리,82,"kaist_dataset/Korean/Mobile_Phone/(M,K)E-bookCover/P090831091.jpg",char_data/리/P090831091.jpg_2.jpg,6560,480,640,80,100,180,27,109,True,59
리,78,"kaist_dataset/Korean/Mobile_Phone/(M,K)E-bookCover/P090831094.jpg",char_data/리/P090831094.jpg_2.jpg,6006,480,640,77,85,162,39,117,True,59
리,83,"kaist_dataset/Korean/Mobile_Phone/(M,K)E-bookCover/P090831095.jpg",char_data/리/P090831095.jpg_2.jpg,7221,480,640,87,103,190,31,114,True,59
리,71,"kaist_dataset/Korean/Mobile_Phone/(M,K)E-bookCover/P090831096.jpg",char_data/리/P090831096.jpg_2.jpg,5112,480,640,72,103,175,42,113,True,59
리,88,"kaist_dataset/Korean/Mobile_Phone/(M,K)E-bookCover/P090831097.jpg",char_data/리/P090831097.jpg_2.jpg,6688,480,640,76,99,175,33,121,True,59
리,86,"kaist_dataset/Korean/Mobile_Phone/(M,K)E-bookCover/P090831098.jpg",char_data/리/P090831098.jpg_2.jpg,5504,480,640,64,130,194,28,114,True,59
리,91,"kaist_dataset/Korean/Mobile_Phone/(M,K)E-bookCover/P090831099.jpg",char_data/리/P090831099.jpg_2.jpg,7189,480,640,79,106,185,16,107,True,59
리,91,"kaist_dataset/Korean/Mobile_Phone/(M,K)E-bookCover/P090831100.jpg",char_data/리/P090831100.jpg_2.jpg,6643,480,640,73,92,165,44,135,True,59
리,140,"kaist_dataset/Korean/Mobile_Phone/(M,K)E-bookCover/P090831127.jpg",char_data/리/P090831127.jpg_2.jpg,10920,480,640,78,115,193,223,363,True,59
리,76,"kaist_dataset/Korean/Mobile_Phone/(M,K)E-bookCover/P090903028.jpg",char_data/리/P090903028.jpg_4.jpg,4864,480,640,64,83,147,206,282,True,59
리,75,"kaist_dataset/Korean/Mobile_Phone/(M,K)E-bookCover/P090903028.jpg",char_data/리/P090903028.jpg_5.jpg,4950,480,640,66,205,271,223,298,True,59
리,54,"kaist_dataset/Korean/Mobile_Phone/(M,K)E-bookCover/P090903057.jpg",char_data/리/P090903057.jpg_2.jpg,2484,480,640,46,101,147,53,107,True,59
리,94,"kaist_dataset/Korean/Mobile_Phone/(M,K)E-bookCover/P090903066.jpg",char_data/리/P090903066.jpg_2.jpg,7332,480,640,78,401,479,155,249,True,59
리,83,"kaist_dataset/Korean/Mobile_Phone/(M,K)E-bookCover/P090903067.jpg",char_data/리/P090903067.jpg_2.jpg,5146,480,640,62,327,389,21,104,True,59
리,117,"kaist_dataset/Korean/Mobile_Phone/(M,K)E-bookCover/P090903096.jpg",char_data/리/P090903096.jpg_2.jpg,8892,480,640,76,533,609,166,283,True,59
리,108,"kaist_dataset/Korean/Mobile_Phone/(M,K)E-bookCover/P090911019.jpg",char_data/리/P090911019.jpg_2.jpg,10692,480,640,99,429,528,186,294,True,59
리,53,"kaist_dataset/Korean/Mobile_Phone/(M,K)E-bookCover/P090911082.jpg",char_data/리/P090911082.jpg_2.jpg,3233,480,640,61,376,437,239,292,True,59
리,54,kaist_dataset/Mixed/Digital_Camera/(C.S)A-shadow/DSC03845.JPG,char_data/리/DSC03845.JPG_2.jpg,2268,480,640,42,369,411,142,196,True,59
리,33,kaist_dataset/Mixed/Digital_Camera/(C.S)C-outdoor1/027.JPG,char_data/리/027.JPG_2.jpg,561,480,640,17,340,357,272,305,True,59
리,110,kaist_dataset/Mixed/Digital_Camera/(C.S)C-outdoor1/080119-0008.jpg,char_data/리/080119-0008.jpg_2.jpg,8140,1200,1600,74,390,464,346,456,True,59
리,77,kaist_dataset/Mixed/Digital_Camera/(C.S)C-outdoor1/080119-0017.jpg,char_data/리/080119-0017.jpg_2.jpg,5159,1200,1600,67,1077,1144,1079,1156,True,59
리,31,kaist_dataset/Mixed/Digital_Camera/(C.S)C-outdoor1/090.JPG,char_data/리/090.JPG_8.jpg,589,480,640,19,265,284,314,345,True,59
리,26,kaist_dataset/Mixed/Digital_Camera/(C.S)C-outdoor1/090.JPG,char_data/리/090.JPG_9.jpg,676,480,640,26,460,486,316,342,True,59
리,22,kaist_dataset/Mixed/Digital_Camera/(C.S)C-outdoor1/090.JPG,char_data/리/090.JPG_10.jpg,638,480,640,29,586,615,321,343,True,59
리,131,kaist_dataset/Mixed/Digital_Camera/(C.S)C-outdoor1/090.JPG,char_data/리/090.JPG_11.jpg,11790,480,640,90,59,149,176,307,True,59
리,60,kaist_dataset/Mixed/Digital_Camera/(C.S)C-outdoor1/1.JPG,char_data/리/1.JPG_2.jpg,3960,576,768,66,617,683,347,407,True,59
리,104,kaist_dataset/Mixed/Digital_Camera/(C.S)C-outdoor1/112.JPG,char_data/리/112.JPG_2.jpg,10296,480,640,99,99,198,172,276,True,59
리,55,kaist_dataset/Mixed/Digital_Camera/(C.S)C-outdoor1/2007-12-09-day-exterior-078.jpg,char_data/리/2007-12-09-day-exterior-078.jpg_4.jpg,2255,1200,1600,41,942,983,561,616,True,59
리,52,kaist_dataset/Mixed/Digital_Camera/(C.S)C-outdoor1/2007-12-09-day-exterior-078.jpg,char_data/리/2007-12-09-day-exterior-078.jpg_5.jpg,1820,1200,1600,35,1025,1060,561,613,True,59
리,112,kaist_dataset/Mixed/Digital_Camera/(C.S)C-outdoor1/DSC02240.JPG,char_data/리/DSC02240.JPG_2.jpg,10304,480,640,92,313,405,160,272,True,59
리,79,kaist_dataset/Mixed/Digital_Camera/(C.S)C-outdoor1/DSC02319.JPG,char_data/리/DSC02319.JPG_2.jpg,5056,480,640,64,252,316,242,321,True,59
리,81,kaist_dataset/Mixed/Digital_Camera/(C.S)C-outdoor1/P1010011.JPG,char_data/리/P1010011.JPG_2.jpg,5832,480,640,72,367,439,217,298,True,59
리,102,kaist_dataset/Mixed/Digital_Camera/(C.S)C-outdoor2/DSC02400.JPG,char_data/리/DSC02400.JPG_4.jpg,13464,480,640,132,168,300,161,263,True,59
리,100,kaist_dataset/Mixed/Digital_Camera/(C.S)C-outdoor2/DSC02400.JPG,char_data/리/DSC02400.JPG_5.jpg,12200,480,640,122,488,610,173,273,True,59
리,118,kaist_dataset/Mixed/Digital_Camera/(C.S)C-outdoor2/DSC02419.JPG,char_data/리/DSC02419.JPG_2.jpg,16048,480,640,136,178,314,71,189,True,59
리,47,kaist_dataset/Mixed/Digital_Camera/(C.S)C-outdoor2/DSC02434.JPG,char_data/리/DSC02434.JPG_2.jpg,2397,480,640,51,198,249,95,142,True,59
리,115,kaist_dataset/Mixed/Digital_Camera/(C.S)C-outdoor2/DSC02460.JPG,char_data/리/DSC02460.JPG_2.jpg,13110,480,640,114,259,373,167,282,True,59
리,64,kaist_dataset/Mixed/Digital_Camera/(C.S)C-outdoor2/DSC02479.JPG,char_data/리/DSC02479.JPG_2.jpg,5568,480,640,87,317,404,161,225,True,59
리,80,kaist_dataset/Mixed/Digital_Camera/(C.S)C-outdoor2/DSC02543.JPG,char_data/리/DSC02543.JPG_2.jpg,6480,480,640,81,253,334,270,350,True,59
리,82,kaist_dataset/Mixed/Digital_Camera/(C.S)C-outdoor2/DSC02555.JPG,char_data/리/DSC02555.JPG_2.jpg,8036,480,640,98,537,635,165,247,True,59
리,103,kaist_dataset/Mixed/Digital_Camera/(C.S)C-outdoor2/P1010013.JPG,char_data/리/P1010013.JPG_2.jpg,8858,480,640,86,453,539,240,343,True,59
리,50,kaist_dataset/Mixed/Digital_Camera/(C.S)C-outdoor3/DSC03015.JPG,char_data/리/DSC03015.JPG_2.jpg,2400,480,640,48,146,194,148,198,True,59
리,40,kaist_dataset/Mixed/Digital_Camera/(C.S)C-outdoor3/DSC03055.JPG,char_data/리/DSC03055.JPG_2.jpg,1200,480,640,30,95,125,215,255,True,59
리,48,kaist_dataset/Mixed/Digital_Camera/(C.S)C-outdoor3/DSC03061.JPG,char_data/리/DSC03061.JPG_2.jpg,1056,480,640,22,214,236,247,295,True,59
리,46,kaist_dataset/Mixed/Digital_Camera/(C.S)C-outdoor3/DSC03210.JPG,char_data/리/DSC03210.JPG_2.jpg,2116,480,640,46,462,508,344,390,True,59
리,65,kaist_dataset/Mixed/Digital_Camera/(C.S)C-outdoor3/DSC03227.JPG,char_data/리/DSC03227.JPG_2.jpg,2405,480,640,37,254,291,391,456,True,59
리,115,kaist_dataset/Mixed/Digital_Camera/(C.S)C-outdoor3/DSC03241.JPG,char_data/리/DSC03241.JPG_2.jpg,12190,480,640,106,43,149,186,301,True,59
리,65,kaist_dataset/Mixed/Digital_Camera/(C.S)C-outdoor3/DSC03245.JPG,char_data/리/DSC03245.JPG_2.jpg,4485,480,640,69,109,178,369,434,True,59
리,69,kaist_dataset/Mixed/Digital_Camera/(C.S)C-outdoor3/DSC03311.JPG,char_data/리/DSC03311.JPG_2.jpg,5244,480,640,76,543,619,296,365,True,59
리,130,kaist_dataset/Mixed/Digital_Camera/(C.S)C-outdoor3/DSC03323.JPG,char_data/리/DSC03323.JPG_2.jpg,24050,480,640,185,404,589,121,251,True,59
리,46,kaist_dataset/Mixed/Digital_Camera/(C.S)C-outdoor3/DSC03332.JPG,char_data/리/DSC03332.JPG_2.jpg,2162,480,640,47,385,432,116,162,True,59
리,35,kaist_dataset/Mixed/Digital_Camera/(C.S)C-outdoor3/P1010016.JPG,char_data/리/P1010016.JPG_2.jpg,945,480,640,27,440,467,253,288,False,59
리,71,kaist_dataset/Mixed/Digital_Camera/(C.S)C-outdoor4/DSC03433.JPG,char_data/리/DSC03433.JPG_2.jpg,4757,480,640,67,374,441,226,297,False,59
리,68,kaist_dataset/Mixed/Digital_Camera/(C.S)C-outdoor4/DSC03539.JPG,char_data/리/DSC03539.JPG_4.jpg,5848,480,640,86,119,205,153,221,False,59
리,72,kaist_dataset/Mixed/Digital_Camera/(C.S)C-outdoor4/DSC03539.JPG,char_data/리/DSC03539.JPG_5.jpg,5832,480,640,81,464,545,154,226,False,59
리,35,kaist_dataset/Mixed/Digital_Camera/(C.S)C-outdoor4/DSC03556.JPG,char_data/리/DSC03556.JPG_2.jpg,1085,480,640,31,72,103,213,248,False,59
리,61,kaist_dataset/Mixed/Digital_Camera/(C.S)C-outdoor4/DSC03572.JPG,char_data/리/DSC03572.JPG_2.jpg,4148,480,640,68,426,494,225,286,False,59
리,144,kaist_dataset/Mixed/Digital_Camera/(C.S)C-outdoor4/DSC03635.JPG,char_data/리/DSC03635.JPG_2.jpg,17136,480,640,119,69,188,264,408,False,59
리,87,kaist_dataset/Mixed/Digital_Camera/(C.S)C-outdoor4/DSC03637.JPG,char_data/리/DSC03637.JPG_2.jpg,11397,480,640,131,505,636,189,276,False,59
리,152,kaist_dataset/Mixed/Digital_Camera/(C.S)C-outdoor4/DSC03638.JPG,char_data/리/DSC03638.JPG_2.jpg,17024,480,640,112,75,187,255,407,False,59
리,47,kaist_dataset/Mixed/Digital_Camera/(C.S)C-outdoor4/DSC03652.JPG,char_data/리/DSC03652.JPG_2.jpg,1551,480,640,33,495,528,201,248,False,59
리,69,kaist_dataset/Mixed/Digital_Camera/(C.S)C-outdoor4/DSC03673.JPG,char_data/리/DSC03673.JPG_2.jpg,3726,480,640,54,155,209,108,177,False,59
리,104,kaist_dataset/Mixed/Digital_Camera/(C.S)C-outdoor4/DSC03677.JPG,char_data/리/DSC03677.JPG_2.jpg,8008,480,640,77,130,207,282,386,False,59
리,50,kaist_dataset/Mixed/Digital_Camera/(C.S)C-outdoor4/DSC03678.JPG,char_data/리/DSC03678.JPG_2.jpg,1600,480,640,32,155,187,183,233,False,59
리,33,kaist_dataset/Mixed/Digital_Camera/(C.S)C-outdoor4/DSC03735.JPG,char_data/리/DSC03735.JPG_2.jpg,594,480,640,18,294,312,193,226,False,59
리,92,kaist_dataset/Mixed/Digital_Camera/(C.S)C-outdoor4/DSC03784.JPG,char_data/리/DSC03784.JPG_2.jpg,6808,480,640,74,532,606,182,274,False,59
리,45,kaist_dataset/Mixed/Digital_Camera/(C.S)C-outdoor5/DSC03837.JPG,char_data/리/DSC03837.JPG_4.jpg,1710,480,640,38,63,101,370,415,False,59
리,69,kaist_dataset/Mixed/Digital_Camera/(C.S)C-outdoor5/DSC03837.JPG,char_data/리/DSC03837.JPG_5.jpg,3726,480,640,54,75,129,69,138,False,59
리,33,kaist_dataset/Mixed/Digital_Camera/(C.S)C-outdoor5/DSC03839.JPG,char_data/리/DSC03839.JPG_2.jpg,792,480,640,24,349,373,410,443,False,59
리,62,kaist_dataset/Mixed/Digital_Camera/(C.S)C-outdoor5/DSC03842.JPG,char_data/리/DSC03842.JPG_2.jpg,2232,480,640,36,203,239,139,201,False,59
리,83,kaist_dataset/Mixed/Digital_Camera/(C.S)C-outdoor5/DSC04032.JPG,char_data/리/DSC04032.JPG_2.jpg,8881,480,640,107,506,613,298,381,False,59
리,47,kaist_dataset/Mixed/Digital_Camera/(C.S)C-outdoor5/DSC04061.JPG,char_data/리/DSC04061.JPG_2.jpg,3525,480,640,75,435,510,38,85,False,59
리,117,kaist_dataset/Mixed/Digital_Camera/(C.S)C-outdoor5/DSC04071.JPG,char_data/리/DSC04071.JPG_2.jpg,15093,480,640,129,488,617,237,354,False,59
리,29,kaist_dataset/Mixed/Digital_Camera/(C.S)C-outdoor5/DSC04124.JPG,char_data/리/DSC04124.JPG_2.jpg,493,480,640,17,139,156,150,179,False,59
리,115,kaist_dataset/Mixed/Digital_Camera/(C.S)C-outdoor5/DSC04135.JPG,char_data/리/DSC04135.JPG_4.jpg,4255,480,640,37,202,239,254,369,False,59
리,105,kaist_dataset/Mixed/Digital_Camera/(C.S)C-outdoor5/DSC04135.JPG,char_data/리/DSC04135.JPG_5.jpg,3150,480,640,30,314,344,259,364,False,59
리,74,kaist_dataset/Mixed/Digital_Camera/(C.S)C-outdoor5/DSC04323.JPG,char_data/리/DSC04323.JPG_2.jpg,5476,480,640,74,453,527,125,199,False,59
리,142,kaist_dataset/Mixed/Digital_Camera/(C.S)C-outdoor5/DSC04401.JPG,char_data/리/DSC04401.JPG_2.jpg,13916,480,640,98,469,567,89,231,False,59
리,67,kaist_dataset/Mixed/Digital_Camera/(C.S)C-outdoor5/P1010002.JPG,char_data/리/P1010002.JPG_2.jpg,6767,480,640,101,145,246,143,210,False,59
리,30,kaist_dataset/Mixed/Digital_Camera/(C.S)C-outdoor6/P1010075.JPG,char_data/리/P1010075.JPG_2.jpg,780,480,640,26,375,401,137,167,False,59
리,67,kaist_dataset/Mixed/Digital_Camera/(C.S)C-outdoor6/P1010090.JPG,char_data/리/P1010090.JPG_2.jpg,4757,480,640,71,447,518,129,196,False,59
리,81,kaist_dataset/Mixed/Digital_Camera/(C.S)C-outdoor6/P1010095.JPG,char_data/리/P1010095.JPG_4.jpg,6399,480,640,79,216,295,133,214,False,59
리,59,kaist_dataset/Mixed/Digital_Camera/(C.S)C-outdoor6/P1010095.JPG,char_data/리/P1010095.JPG_5.jpg,3776,480,640,64,144,208,306,365,False,59
리,103,kaist_dataset/Mixed/Digital_Camera/(C.S)C-outdoor6/P1010103.JPG,char_data/리/P1010103.JPG_2.jpg,10300,480,640,100,488,588,81,184,False,59
리,62,kaist_dataset/Mixed/Digital_Camera/(C.S)D-indoor1/DSC02713.JPG,char_data/리/DSC02713.JPG_2.jpg,3410,480,640,55,377,432,291,353,False,59
리,40,kaist_dataset/Mixed/Digital_Camera/(C.S)D-indoor1/DSC03122.JPG,char_data/리/DSC03122.JPG_2.jpg,1480,480,640,37,345,382,246,286,False,59
리,49,kaist_dataset/Mixed/Digital_Camera/(C.S)D-indoor1/DSC03126.JPG,char_data/리/DSC03126.JPG_2.jpg,2107,480,640,43,285,328,282,331,False,59
리,119,kaist_dataset/Mixed/Digital_Camera/(C.S)D-indoor1/DSC03472.JPG,char_data/리/DSC03472.JPG_2.jpg,9163,480,640,77,411,488,181,300,False,59
리,78,kaist_dataset/Mixed/Digital_Camera/(C.S)D-indoor1/DSC04173.JPG,char_data/리/DSC04173.JPG_2.jpg,4524,480,640,58,425,483,320,398,False,59
리,54,kaist_dataset/Mixed/Digital_Camera/(C.S)D-indoor1/DSC04203.JPG,char_data/리/DSC04203.JPG_2.jpg,2376,480,640,44,518,562,288,342,False,59
리,66,kaist_dataset/Mixed/Digital_Camera/(C.S)D-indoor1/DSC04231.JPG,char_data/리/DSC04231.JPG_2.jpg,2772,480,640,42,248,290,201,267,False,59
리,93,kaist_dataset/Mixed/Digital_Camera/(C.S)D-indoor2/DSC04409.JPG,char_data/리/DSC04409.JPG_2.jpg,3627,480,640,39,344,383,145,238,False,59
리,89,kaist_dataset/Mixed/Digital_Camera/(C.S)D-indoor2/P090911016.jpg,char_data/리/P090911016.jpg_2.jpg,6230,480,640,70,183,253,146,235,False,59
리,45,kaist_dataset/Mixed/Digital_Camera/(C.S)E-night/DSC02569.JPG,char_data/리/DSC02569.JPG_4.jpg,2115,480,640,47,379,426,222,267,False,59
리,40,kaist_dataset/Mixed/Digital_Camera/(C.S)E-night/DSC02569.JPG,char_data/리/DSC02569.JPG_5.jpg,1240,480,640,31,337,368,364,404,False,59
리,61,kaist_dataset/Mixed/Digital_Camera/(C.S)E-night/DSC02574.JPG,char_data/리/DSC02574.JPG_2.jpg,3294,480,640,54,518,572,55,116,False,59
리,123,kaist_dataset/Mixed/Digital_Camera/(C.S)E-night/DSC02595.JPG,char_data/리/DSC02595.JPG_2.jpg,18081,480,640,147,449,596,207,330,False,59
리,114,kaist_dataset/Mixed/Digital_Camera/(C.S)E-night/DSC02673.JPG,char_data/리/DSC02673.JPG_2.jpg,7980,480,640,70,201,271,156,270,False,59
리,35,kaist_dataset/Mixed/Digital_Camera/(C.S)E-night/DSC03561.JPG,char_data/리/DSC03561.JPG_2.jpg,1120,480,640,32,179,211,36,71,False,59
리,123,kaist_dataset/Mixed/Mobile_Phone/(C.M)C-bookCover/P090831115.jpg,char_data/리/P090831115.jpg_2.jpg,10209,480,640,83,413,496,35,158,False,59
리,43,kaist_dataset/Mixed/Mobile_Phone/(C.M)C-bookCover/P090902016.jpg,char_data/리/P090902016.jpg_2.jpg,1591,480,640,37,337,374,206,249,False,59
l,79,kaist_dataset/English/Digital_Camera/(E.S)A-shadow/DSC02857.JPG,char_data/l/DSC02857.JPG_4.jpg,1975,480,640,25,179,204,202,281,True,38
l,84,kaist_dataset/English/Digital_Camera/(E.S)A-shadow/DSC02857.JPG,char_data/l/DSC02857.JPG_5.jpg,2436,480,640,29,204,233,201,285,True,38
l,84,kaist_dataset/English/Digital_Camera/(E.S)A-shadow/DSC02858.JPG,char_data/l/DSC02858.JPG_4.jpg,2604,480,640,31,112,143,306,390,True,38
l,88,kaist_dataset/English/Digital_Camera/(E.S)A-shadow/DSC02858.JPG,char_data/l/DSC02858.JPG_5.jpg,2904,480,640,33,140,173,303,391,True,38
l,56,kaist_dataset/English/Digital_Camera/(E.S)A-shadow/DSC03026.JPG,char_data/l/DSC03026.JPG_2.jpg,1960,480,640,35,315,350,154,210,True,38
l,66,kaist_dataset/English/Digital_Camera/(E.S)A-shadow/DSC03075.JPG,char_data/l/DSC03075.JPG_6.jpg,858,480,640,13,161,174,340,406,True,38
l,53,kaist_dataset/English/Digital_Camera/(E.S)A-shadow/DSC03075.JPG,char_data/l/DSC03075.JPG_7.jpg,742,480,640,14,197,211,352,405,True,38
l,67,kaist_dataset/English/Digital_Camera/(E.S)A-shadow/DSC03079.JPG,char_data/l/DSC03079.JPG_2.jpg,1072,480,640,16,351,367,322,389,True,38
l,76,kaist_dataset/English/Digital_Camera/(E.S)A-shadow/IMG_2647.JPG,char_data/l/IMG_2647.JPG_2.jpg,1292,480,640,17,209,226,166,242,True,38
l,90,kaist_dataset/English/Digital_Camera/(E.S)B-light/DSC02587.JPG,char_data/l/DSC02587.JPG_6.jpg,2430,480,640,27,330,357,188,278,True,38
l,102,kaist_dataset/English/Digital_Camera/(E.S)B-light/DSC02587.JPG,char_data/l/DSC02587.JPG_7.jpg,2754,480,640,27,142,169,317,419,True,38
l,110,kaist_dataset/English/Digital_Camera/(E.S)B-light/DSC02587.JPG,char_data/l/DSC02587.JPG_8.jpg,2530,480,640,23,168,191,315,425,True,38
l,45,kaist_dataset/English/Digital_Camera/(E.S)B-light/크기변환_%B0%A3%C6%C74_fabdent.jpg,char_data/l/크기변환_%B0%A3%C6%C74_fabdent.jpg_2.jpg,495,480,640,11,196,207,251,296,True,38
l,73,kaist_dataset/English/Digital_Camera/(E.S)C-outdoor1/027.jpg,char_data/l/027.jpg_2.jpg,2263,300,472,31,52,83,118,191,True,38
l,26,kaist_dataset/English/Digital_Camera/(E.S)C-outdoor1/056.JPG,char_data/l/056.JPG_4.jpg,182,480,640,7,139,146,240,266,True,38
l,44,kaist_dataset/English/Digital_Camera/(E.S)C-outdoor1/077.JPG,char_data/l/077.JPG_4.jpg,748,480,640,17,235,252,203,247,True,38
l,54,kaist_dataset/English/Digital_Camera/(E.S)C-outdoor1/080116-0066.jpg,char_data/l/080116-0066.jpg_2.jpg,702,600,800,13,426,439,342,396,True,38
l,70,kaist_dataset/English/Digital_Camera/(E.S)C-outdoor1/080119-0012.jpg,char_data/l/080119-0012.jpg_4.jpg,3150,1200,1600,45,1027,1072,537,607,True,38
l,253,kaist_dataset/English/Digital_Camera/(E.S)C-outdoor1/080119-0036.jpg,char_data/l/080119-0036.jpg_2.jpg,20240,1200,1600,80,308,388,307,560,True,38
l,147,kaist_dataset/English/Digital_Camera/(E.S)C-outdoor1/100.JPG,char_data/l/100.JPG_4.jpg,6468,480,640,44,568,612,34,181,True,38
l,64,kaist_dataset/English/Digital_Camera/(E.S)C-outdoor1/109.jpg,char_data/l/109.jpg_2.jpg,1536,480,640,24,305,329,172,236,True,38
l,107,kaist_dataset/English/Digital_Camera/(E.S)C-outdoor1/129.JPG,char_data/l/129.JPG_2.jpg,2140,480,640,20,390,410,200,307,True,38
l,188,kaist_dataset/English/Digital_Camera/(E.S)C-outdoor1/2007-12-08-day-015.jpg,char_data/l/2007-12-08-day-015.jpg_6.jpg,22372,1200,1600,119,542,661,460,648,True,38
l,45,kaist_dataset/English/Digital_Camera/(E.S)C-outdoor1/2007-12-08-day-015.jpg,char_data/l/2007-12-08-day-015.jpg_7.jpg,450,1200,1600,10,695,705,808,853,True,38
l,47,kaist_dataset/English/Digital_Camera/(E.S)C-outdoor1/2007-12-08-day-015.jpg,char_data/l/2007-12-08-day-015.jpg_8.jpg,329,1200,1600,7,706,713,805,852,True,38
l,133,kaist_dataset/English/Digital_Camera/(E.S)C-outdoor1/2007-12-08-day-111.jpg,char_data/l/2007-12-08-day-111.jpg_2.jpg,6916,1200,1600,52,678,730,461,594,True,38
l,51,kaist_dataset/English/Digital_Camera/(E.S)C-outdoor1/2007-12-09-day-exterior-063.jpg,char_data/l/2007-12-09-day-exterior-063.jpg_4.jpg,612,1200,1600,12,1,13,518,569,True,38
l,46,kaist_dataset/English/Digital_Camera/(E.S)C-outdoor1/DSC02352.JPG,char_data/l/DSC02352.JPG_2.jpg,690,480,640,15,524,539,313,359,True,38
l,110,kaist_dataset/English/Digital_Camera/(E.S)C-outdoor1/DSC02387.JPG,char_data/l/DSC02387.JPG_4.jpg,3850,480,640,35,209,244,191,301,True,38
l,32,kaist_dataset/English/Digital_Camera/(E.S)C-outdoor1/DSC02387.JPG,char_data/l/DSC02387.JPG_5.jpg,352,480,640,11,350,361,297,329,True,38
l,154,kaist_dataset/English/Digital_Camera/(E.S)C-outdoor1/DSC02415.JPG,char_data/l/DSC02415.JPG_2.jpg,8932,480,640,58,97,155,51,205,True,38
l,26,kaist_dataset/English/Digital_Camera/(E.S)C-outdoor1/DSC02417.JPG,char_data/l/DSC02417.JPG_2.jpg,234,480,640,9,551,560,141,167,True,38
l,66,kaist_dataset/English/Digital_Camera/(E.S)C-outdoor1/DSC02442.JPG,char_data/l/DSC02442.JPG_2.jpg,1518,480,640,23,252,275,159,225,True,38
l,87,kaist_dataset/English/Digital_Camera/(E.S)C-outdoor1/DSC02491.JPG,char_data/l/DSC02491.JPG_6.jpg,2523,480,640,29,183,212,313,400,True,38
l,94,kaist_dataset/English/Digital_Camera/(E.S)C-outdoor1/DSC02491.JPG,char_data/l/DSC02491.JPG_7.jpg,1692,480,640,18,163,181,214,308,True,38
l,90,kaist_dataset/English/Digital_Camera/(E.S)C-outdoor1/DSC02491.JPG,char_data/l/DSC02491.JPG_8.jpg,2070,480,640,23,406,429,120,210,True,38
l,56,kaist_dataset/English/Digital_Camera/(E.S)C-outdoor1/DSC02500.JPG,char_data/l/DSC02500.JPG_4.jpg,840,480,640,15,499,514,286,342,True,38
l,72,kaist_dataset/English/Digital_Camera/(E.S)C-outdoor1/DSC02514.JPG,char_data/l/DSC02514.JPG_6.jpg,792,480,640,11,321,332,174,246,True,38
l,76,kaist_dataset/English/Digital_Camera/(E.S)C-outdoor1/DSC02514.JPG,char_data/l/DSC02514.JPG_7.jpg,532,480,640,7,335,342,176,252,True,38
l,74,kaist_dataset/English/Digital_Camera/(E.S)C-outdoor1/DSC02514.JPG,char_data/l/DSC02514.JPG_8.jpg,1258,480,640,17,494,511,187,261,True,38
l,44,kaist_dataset/English/Digital_Camera/(E.S)C-outdoor1/DSC02559.JPG,char_data/l/DSC02559.JPG_5.jpg,528,480,640,12,239,251,124,168,True,38
l,44,kaist_dataset/English/Digital_Camera/(E.S)C-outdoor1/DSC02918.JPG,char_data/l/DSC02918.JPG_2.jpg,1056,480,640,24,407,431,175,219,True,38
l,49,kaist_dataset/English/Digital_Camera/(E.S)C-outdoor2/DSC03053.JPG,char_data/l/DSC03053.JPG_2.jpg,833,480,640,17,289,306,128,177,True,38
l,49,kaist_dataset/English/Digital_Camera/(E.S)C-outdoor2/DSC03160.JPG,char_data/l/DSC03160.JPG_4.jpg,588,480,640,12,285,297,142,191,True,38
l,41,kaist_dataset/English/Digital_Camera/(E.S)C-outdoor2/DSC03160.JPG,char_data/l/DSC03160.JPG_5.jpg,369,480,640,9,365,374,148,189,True,38
l,48,kaist_dataset/English/Digital_Camera/(E.S)C-outdoor2/DSC03162.JPG,char_data/l/DSC03162.JPG_2.jpg,480,480,640,10,254,264,139,187,True,38
l,52,kaist_dataset/English/Digital_Camera/(E.S)C-outdoor2/DSC03167.JPG,char_data/l/DSC03167.JPG_2.jpg,1092,480,640,21,375,396,299,351,True,38
l,61,kaist_dataset/English/Digital_Camera/(E.S)C-outdoor2/DSC03170.JPG,char_data/l/DSC03170.JPG_2.jpg,1159,480,640,19,348,367,299,360,True,38
l,66,kaist_dataset/English/Digital_Camera/(E.S)C-outdoor2/DSC03201.JPG,char_data/l/DSC03201.JPG_2.jpg,1056,480,640,16,358,374,70,136,True,38
l,32,kaist_dataset/English/Digital_Camera/(E.S)C-outdoor2/DSC03208.JPG,char_data/l/DSC03208.JPG_7.jpg,448,480,640,14,349,363,165,197,True,38
l,31,kaist_dataset/English/Digital_Camera/(E.S)C-outdoor2/DSC03208.JPG,char_data/l/DSC03208.JPG_8.jpg,465,480,640,15,363,378,162,193,True,38
l,41,kaist_dataset/English/Digital_Camera/(E.S)C-outdoor2/DSC03225.JPG,char_data/l/DSC03225.JPG_2.jpg,615,480,640,15,378,393,81,122,True,38
l,53,kaist_dataset/English/Digital_Camera/(E.S)C-outdoor2/DSC03262.JPG,char_data/l/DSC03262.JPG_2.jpg,1272,480,640,24,120,144,122,175,True,38
l,98,kaist_dataset/English/Digital_Camera/(E.S)C-outdoor2/DSC03281.JPG,char_data/l/DSC03281.JPG_2.jpg,2548,480,640,26,387,413,203,301,True,38
l,67,kaist_dataset/English/Digital_Camera/(E.S)C-outdoor2/DSC03290.JPG,char_data/l/DSC03290.JPG_2.jpg,938,480,640,14,375,389,82,149,True,38
l,47,kaist_dataset/English/Digital_Camera/(E.S)C-outdoor2/DSC03307.JPG,char_data/l/DSC03307.JPG_2.jpg,470,480,640,10,335,345,165,212,True,38
l,95,kaist_dataset/English/Digital_Camera/(E.S)C-outdoor2/DSC03408.JPG,char_data/l/DSC03408.JPG_2.jpg,3610,480,640,38,333,371,326,421,True,38
l,68,kaist_dataset/English/Digital_Camera/(E.S)C-outdoor2/DSC03412.JPG,char_data/l/DSC03412.JPG_7.jpg,1496,480,640,22,363,385,139,207,True,38
l,67,kaist_dataset/English/Digital_Camera/(E.S)C-outdoor2/DSC03412.JPG,char_data/l/DSC03412.JPG_8.jpg,1474,480,640,22,383,405,136,203,True,38
l,60,kaist_dataset/English/Digital_Camera/(E.S)C-outdoor2/DSC03440.JPG,char_data/l/DSC03440.JPG_2.jpg,960,480,640,16,147,163,13,73,True,38
l,130,kaist_dataset/English/Digital_Camera/(E.S)C-outdoor2/DSC03786.JPG,char_data/l/DSC03786.JPG_2.jpg,5460,480,640,42,368,410,164,294,True,38
l,57,kaist_dataset/English/Digital_Camera/(E.S)C-outdoor2/DSC04035.JPG,char_data/l/DSC04035.JPG_2.jpg,969,480,640,17,379,396,188,245,True,38
l,64,kaist_dataset/English/Digital_Camera/(E.S)C-outdoor2/DSC04163.JPG,char_data/l/DSC04163.JPG_7.jpg,1280,480,640,20,490,510,254,318,True,38
l,69,kaist_dataset/English/Digital_Camera/(E.S)C-outdoor2/DSC04163.JPG,char_data/l/DSC04163.JPG_8.jpg,1794,480,640,26,508,534,254,323,True,38
l,107,kaist_dataset/English/Digital_Camera/(E.S)C-outdoor2/IMG_2618.JPG,char_data/l/IMG_2618.JPG_2.jpg,4280,279,640,40,182,222,161,268,True,38
l,99,kaist_dataset/English/Digital_Camera/(E.S)C-outdoor2/P1010015.JPG,char_data/l/P1010015.JPG_2.jpg,2871,480,640,29,502,531,128,227,True,38
l,158,kaist_dataset/English/Digital_Camera/(E.S)C-outdoor2/P1010024.JPG,char_data/l/P1010024.JPG_2.jpg,8690,480,640,55,251,306,196,354,True,38
l,63,kaist_dataset/English/Digital_Camera/(E.S)C-outdoor2/P1010057.JPG,char_data/l/P1010057.JPG_2.jpg,882,480,640,14,271,285,185,248,True,38
l,35,kaist_dataset/English/Digital_Camera/(E.S)C-outdoor3/P1010123.JPG,char_data/l/P1010123.JPG_4.jpg,245,480,640,7,569,576,64,99,True,38
l,31,kaist_dataset/English/Digital_Camera/(E.S)C-outdoor3/P1010123.JPG,char_data/l/P1010123.JPG_5.jpg,186,480,640,6,81,87,70,101,True,38
l,82,kaist_dataset/English/Digital_Camera/(E.S)C-outdoor3/크기변환_%B0%A3%C6%C71_fabdent.jpg,char_data/l/크기변환_%B0%A3%C6%C71_fabdent.jpg_4.jpg,2132,480,640,26,172,198,228,310,True,38
l,80,kaist_dataset/English/Digital_Camera/(E.S)C-outdoor3/크기변환_%B0%A3%C6%C71_fabdent.jpg,char_data/l/크기변환_%B0%A3%C6%C71_fabdent.jpg_5.jpg,2000,480,640,25,432,457,223,303,True,38
l,24,kaist_dataset/English/Digital_Camera/(E.S)C-outdoor3/크기변환_P1010076.JPG,char_data/l/크기변환_P1010076.JPG_5.jpg,192,480,640,8,236,244,102,126,True,38
l,45,kaist_dataset/English/Digital_Camera/(E.S)D-indoor/080119-0009.jpg,char_data/l/080119-0009.jpg_2.jpg,495,1200,1600,11,647,658,955,1000,True,38
l,66,kaist_dataset/English/Digital_Camera/(E.S)D-indoor/DSC03078.JPG,char_data/l/DSC03078.JPG_2.jpg,1056,480,640,16,150,166,220,286,True,38
l,100,kaist_dataset/English/Digital_Camera/(E.S)D-indoor/DSC03080.JPG,char_data/l/DSC03080.JPG_2.jpg,2900,480,640,29,212,241,340,440,True,38
l,57,kaist_dataset/English/Digital_Camera/(E.S)D-indoor/DSC03083.JPG,char_data/l/DSC03083.JPG_4.jpg,912,480,640,16,238,254,389,446,True,38
l,75,kaist_dataset/English/Digital_Camera/(E.S)D-indoor/DSC03087.JPG,char_data/l/DSC03087.JPG_2.jpg,2175,480,640,29,381,410,357,432,True,38
l,51,kaist_dataset/English/Digital_Camera/(E.S)D-indoor/DSC03090.JPG,char_data/l/DSC03090.JPG_2.jpg,510,480,640,10,450,460,230,281,True,38
l,75,kaist_dataset/English/Digital_Camera/(E.S)D-indoor/DSC03093.JPG,char_data/l/DSC03093.JPG_2.jpg,2100,480,640,28,558,586,116,191,True,38
l,41,kaist_dataset/English/Digital_Camera/(E.S)D-indoor/DSC03112.JPG,char_data/l/DSC03112.JPG_4.jpg,328,480,640,8,241,249,206,247,True,38
l,41,kaist_dataset/English/Digital_Camera/(E.S)D-indoor/DSC03112.JPG,char_data/l/DSC03112.JPG_5.jpg,533,480,640,13,330,343,208,249,True,38
l,41,kaist_dataset/English/Digital_Camera/(E.S)D-indoor/DSC03142.JPG,char_data/l/DSC03142.JPG_2.jpg,369,480,640,9,285,294,362,403,True,38
l,36,kaist_dataset/English/Digital_Camera/(E.S)D-indoor/DSC03145.JPG,char_data/l/DSC03145.JPG_8.jpg,324,480,640,9,218,227,177,213,True,38
l,35,kaist_dataset/English/Digital_Camera/(E.S)D-indoor/DSC03145.JPG,char_data/l/DSC03145.JPG_9.jpg,315,480,640,9,227,236,176,211,True,38
l,35,kaist_dataset/English/Digital_Camera/(E.S)D-indoor/DSC03145.JPG,char_data/l/DSC03145.JPG_10.jpg,315,480,640,9,222,231,123,158,True,38
l,36,kaist_dataset/English/Digital_Camera/(E.S)D-indoor/DSC03145.JPG,char_data/l/DSC03145.JPG_11.jpg,360,480,640,10,231,241,122,158,True,38
l,63,kaist_dataset/English/Digital_Camera/(E.S)D-indoor/DSC03150.JPG,char_data/l/DSC03150.JPG_4.jpg,1638,480,640,26,364,390,17,80,True,38
l,62,kaist_dataset/English/Digital_Camera/(E.S)D-indoor/DSC03150.JPG,char_data/l/DSC03150.JPG_5.jpg,1736,480,640,28,493,521,13,75,True,38
l,51,kaist_dataset/English/Digital_Camera/(E.S)D-indoor/DSC03532.JPG,char_data/l/DSC03532.JPG_2.jpg,765,480,640,15,300,315,425,476,True,38
l,52,kaist_dataset/English/Digital_Camera/(E.S)D-indoor/DSC03936.JPG,char_data/l/DSC03936.JPG_2.jpg,1456,480,640,28,511,539,163,215,True,38
l,49,kaist_dataset/English/Digital_Camera/(E.S)D-indoor/DSC03947.JPG,char_data/l/DSC03947.JPG_2.jpg,931,480,640,19,516,535,407,456,True,38
l,154,kaist_dataset/English/Digital_Camera/(E.S)E-night/068.jpg,char_data/l/068.jpg_2.jpg,9856,519,742,64,440,504,260,414,True,38
l,115,kaist_dataset/English/Digital_Camera/(E.S)E-night/DSC02610.JPG,char_data/l/DSC02610.JPG_6.jpg,7130,480,640,62,464,526,138,253,True,38
l,39,kaist_dataset/English/Digital_Camera/(E.S)E-night/DSC02610.JPG,char_data/l/DSC02610.JPG_7.jpg,975,480,640,25,279,304,267,306,True,38
l,48,kaist_dataset/English/Digital_Camera/(E.S)E-night/DSC02610.JPG,char_data/l/DSC02610.JPG_8.jpg,1056,480,640,22,478,500,258,306,True,38
l,98,kaist_dataset/English/Digital_Camera/(E.S)E-night/크기변환_P1010163.JPG,char_data/l/크기변환_P1010163.JPG_2.jpg,4116,480,640,42,288,330,86,184,True,38
l,40,kaist_dataset/English/Digital_Camera/(E.S)F-others/080119-0007.jpg,char_data/l/080119-0007.jpg_13.jpg,400,1200,1600,10,787,797,908,948,True,38
l,71,kaist_dataset/English/Digital_Camera/(E.S)F-others/080119-0007.jpg,char_data/l/080119-0007.jpg_14.jpg,1633,1200,1600,23,1105,1128,686,757,True,38
l,115,kaist_dataset/English/Digital_Camera/(E.S)F-others/DSC02923.JPG,char_data/l/DSC02923.JPG_4.jpg,5060,480,640,44,446,490,253,368,True,38
l,42,kaist_dataset/English/Digital_Camera/(E.S)F-others/DSC03218.JPG,char_data/l/DSC03218.JPG_4.jpg,504,480,640,12,371,383,316,358,True,38
l,42,kaist_dataset/English/Digital_Camera/(E.S)F-others/DSC03218.JPG,char_data/l/DSC03218.JPG_5.jpg,840,480,640,20,383,403,315,357,True,38
l,32,kaist_dataset/English/Digital_Camera/(E.S)F-others/크기변환_%C4%BF%C7%C7%B5%B9%C3%E2%B0%A3%C6%C7_%281%29_alto99kr.jpg,char_data/l/크기변환_%C4%BF%C7%C7%B5%B9%C3%E2%B0%A3%C6%C7_%281%29_alto99kr.jpg_2.jpg,480,480,640,15,313,328,196,228,True,38
l,67,kaist_dataset/English/Mobile_Phone/(E.M)A-outdoor/P090912072.jpg,char_data/l/P090912072.jpg_2.jpg,1407,480,640,21,104,125,28,95,True,38
l,64,kaist_dataset/English/Mobile_Phone/(E.M)B-indoor/P090902018.jpg,char_data/l/P090902018.jpg_7.jpg,1216,480,640,19,322,341,177,241,True,38
l,70,kaist_dataset/English/Mobile_Phone/(E.M)B-indoor/P090902018.jpg,char_data/l/P090902018.jpg_8.jpg,2030,480,640,29,340,369,177,247,True,38
l,59,kaist_dataset/English/Mobile_Phone/(E.M)B-indoor/P090911060.jpg,char_data/l/P090911060.jpg_2.jpg,1947,480,640,33,228,261,14,73,True,38
l,60,kaist_dataset/English/Mobile_Phone/(E.M)B-indoor/P090911084.jpg,char_data/l/P090911084.jpg_4.jpg,1080,480,640,18,282,300,150,210,True,38
l,65,kaist_dataset/English/Mobile_Phone/(E.M)B-indoor/P090911084.jpg,char_data/l/P090911084.jpg_5.jpg,910,480,640,14,300,314,146,211,True,38
l,124,kaist_dataset/English/Mobile_Phone/(E.M)B-indoor/P090911086.jpg,char_data/l/P090911086.jpg_2.jpg,4340,480,640,35,222,257,211,335,True,38
l,61,kaist_dataset/English/Mobile_Phone/(E.M)C-bookCover/P090903030.jpg,char_data/l/P090903030.jpg_2.jpg,1159,480,640,19,90,109,62,123,True,38
l,24,kaist_dataset/Korean/Digital_Camera/B-light/DSC02987.JPG,char_data/l/DSC02987.JPG_2.jpg,192,480,640,8,378,386,281,305,True,38
l,54,kaist_dataset/Korean/Digital_Camera/G-others/2007-12-08-day-112.jpg,char_data/l/2007-12-08-day-112.jpg_2.jpg,756,1200,1600,14,867,881,483,537,True,38
l,28,kaist_dataset/Korean/Digital_Camera/indoor1/080119-0029.jpg,char_data/l/080119-0029.jpg_4.jpg,196,1200,1600,7,293,300,580,608,True,38
l,27,kaist_dataset/Korean/Digital_Camera/indoor1/080119-0029.jpg,char_data/l/080119-0029.jpg_5.jpg,162,1200,1600,6,302,308,579,606,True,38
l,19,kaist_dataset/Korean/Digital_Camera/outdoor1/001.JPG,char_data/l/001.JPG_6.jpg,228,480,640,12,145,157,244,263,True,38
l,23,kaist_dataset/Korean/Digital_Camera/outdoor1/001.JPG,char_data/l/001.JPG_7.jpg,161,480,640,7,221,228,240,263,True,38
l,22,kaist_dataset/Korean/Digital_Camera/outdoor1/001.JPG,char_data/l/001.JPG_8.jpg,176,480,640,8,464,472,238,260,True,38
l,63,kaist_dataset/Korean/Digital_Camera/outdoor1/2007-12-08-day-087.jpg,char_data/l/2007-12-08-day-087.jpg_2.jpg,1071,1200,1600,17,1228,1245,668,731,True,38
l,43,kaist_dataset/Korean/Digital_Camera/outdoor2/2007-12-09-day-exterior-036.jpg,char_data/l/2007-12-09-day-exterior-036.jpg_2.jpg,688,1200,1600,16,1383,1399,545,588,True,38
l,31,kaist_dataset/Mixed/Digital_Camera/(C.S)A-shadow/DSC02624.JPG,char_data/l/DSC02624.JPG_4.jpg,186,480,640,6,258,264,400,431,True,38
l,61,kaist_dataset/Mixed/Digital_Camera/(C.S)A-shadow/DSC03207.JPG,char_data/l/DSC03207.JPG_4.jpg,1098,480,640,18,366,384,200,261,True,38
l,32,kaist_dataset/Mixed/Digital_Camera/(C.S)C-outdoor1/003.JPG,char_data/l/003.JPG_2.jpg,256,480,640,8,421,429,251,283,True,38
l,79,kaist_dataset/Mixed/Digital_Camera/(C.S)C-outdoor1/080116-0084.jpg,char_data/l/080116-0084.jpg_2.jpg,2686,600,800,34,457,491,189,268,True,38
l,47,kaist_dataset/Mixed/Digital_Camera/(C.S)C-outdoor1/101.JPG,char_data/l/101.JPG_5.jpg,987,480,640,21,261,282,247,294,True,38
l,26,kaist_dataset/Mixed/Digital_Camera/(C.S)C-outdoor1/2.JPG,char_data/l/2.JPG_2.jpg,182,576,768,7,544,551,392,418,True,38
l,36,kaist_dataset/Mixed/Digital_Camera/(C.S)C-outdoor1/DSC02242.JPG,char_data/l/DSC02242.JPG_2.jpg,252,480,640,7,309,316,160,196,True,38
l,34,kaist_dataset/Mixed/Digital_Camera/(C.S)C-outdoor1/DSC02318.JPG,char_data/l/DSC02318.JPG_4.jpg,340,480,640,10,364,374,317,351,True,38
l,29,kaist_dataset/Mixed/Digital_Camera/(C.S)C-outdoor1/DSC02318.JPG,char_data/l/DSC02318.JPG_5.jpg,377,480,640,13,510,523,325,354,True,38
l,46,kaist_dataset/Mixed/Digital_Camera/(C.S)C-outdoor1/DSC02320.JPG,char_data/l/DSC02320.JPG_4.jpg,460,480,640,10,385,395,223,269,True,38
l,23,kaist_dataset/Mixed/Digital_Camera/(C.S)C-outdoor1/DSC02320.JPG,char_data/l/DSC02320.JPG_5.jpg,138,480,640,6,558,564,252,275,True,38
l,83,kaist_dataset/Mixed/Digital_Camera/(C.S)C-outdoor1/DSC02344.JPG,char_data/l/DSC02344.JPG_2.jpg,1909,480,640,23,307,330,142,225,True,38
l,30,kaist_dataset/Mixed/Digital_Camera/(C.S)C-outdoor2/DSC02479.JPG,char_data/l/DSC02479.JPG_2.jpg,360,480,640,12,425,437,222,252,True,38
l,39,kaist_dataset/Mixed/Digital_Camera/(C.S)C-outdoor2/DSC02482.JPG,char_data/l/DSC02482.JPG_4.jpg,663,480,640,17,97,114,271,310,True,38
l,41,kaist_dataset/Mixed/Digital_Camera/(C.S)C-outdoor2/DSC02482.JPG,char_data/l/DSC02482.JPG_5.jpg,779,480,640,19,113,132,270,311,True,38
l,25,kaist_dataset/Mixed/Digital_Camera/(C.S)C-outdoor2/DSC02483.JPG,char_data/l/DSC02483.JPG_4.jpg,125,480,640,5,330,335,150,175,True,38
l,25,kaist_dataset/Mixed/Digital_Camera/(C.S)C-outdoor2/DSC02483.JPG,char_data/l/DSC02483.JPG_5.jpg,200,480,640,8,472,480,147,172,True,38
l,35,kaist_dataset/Mixed/Digital_Camera/(C.S)C-outdoor2/DSC02511.JPG,char_data/l/DSC02511.JPG_4.jpg,560,480,640,16,125,141,204,239,True,38
l,36,kaist_dataset/Mixed/Digital_Camera/(C.S)C-outdoor2/DSC02545.JPG,char_data/l/DSC02545.JPG_2.jpg,432,480,640,12,493,505,357,393,True,38
l,31,kaist_dataset/Mixed/Digital_Camera/(C.S)C-outdoor2/DSC02624.JPG,char_data/l/DSC02624.JPG_5.jpg,186,480,640,6,258,264,400,431,True,38
l,68,kaist_dataset/Mixed/Digital_Camera/(C.S)C-outdoor2/DSC02701.JPG,char_data/l/DSC02701.JPG_2.jpg,1768,480,640,26,413,439,97,165,True,38
l,40,kaist_dataset/Mixed/Digital_Camera/(C.S)C-outdoor2/DSC02869.JPG,char_data/l/DSC02869.JPG_2.jpg,440,480,640,11,306,317,141,181,True,38
l,36,kaist_dataset/Mixed/Digital_Camera/(C.S)C-outdoor2/DSC02894.JPG,char_data/l/DSC02894.JPG_2.jpg,468,480,640,13,221,234,266,302,True,38
l,100,kaist_dataset/Mixed/Digital_Camera/(C.S)C-outdoor2/DSC02940.JPG,char_data/l/DSC02940.JPG_2.jpg,5100,480,640,51,317,368,212,312,True,38
l,35,kaist_dataset/Mixed/Digital_Camera/(C.S)C-outdoor3/DSC02970.JPG,char_data/l/DSC02970.JPG_2.jpg,350,480,640,10,210,220,303,338,True,38
l,49,kaist_dataset/Mixed/Digital_Camera/(C.S)C-outdoor3/DSC02989.JPG,char_data/l/DSC02989.JPG_8.jpg,686,480,640,14,447,461,348,397,True,38
l,30,kaist_dataset/Mixed/Digital_Camera/(C.S)C-outdoor3/DSC03020.JPG,char_data/l/DSC03020.JPG_14.jpg,210,480,640,7,459,466,302,332,True,38
l,51,kaist_dataset/Mixed/Digital_Camera/(C.S)C-outdoor3/DSC03063.JPG,char_data/l/DSC03063.JPG_2.jpg,765,480,640,15,476,491,294,345,True,38
l,48,kaist_dataset/Mixed/Digital_Camera/(C.S)C-outdoor3/DSC03177.JPG,char_data/l/DSC03177.JPG_2.jpg,768,480,640,16,254,270,136,184,True,38
l,31,kaist_dataset/Mixed/Digital_Camera/(C.S)C-outdoor3/DSC03187.JPG,char_data/l/DSC03187.JPG_2.jpg,527,480,640,17,227,244,391,422,True,38
l,147,kaist_dataset/Mixed/Digital_Camera/(C.S)C-outdoor3/DSC03210.JPG,char_data/l/DSC03210.JPG_4.jpg,5586,480,640,38,332,370,205,352,True,38
l,140,kaist_dataset/Mixed/Digital_Camera/(C.S)C-outdoor3/DSC03210.JPG,char_data/l/DSC03210.JPG_5.jpg,5460,480,640,39,369,408,200,340,True,38
l,31,kaist_dataset/Mixed/Digital_Camera/(C.S)C-outdoor3/DSC03271.JPG,char_data/l/DSC03271.JPG_2.jpg,465,480,640,15,357,372,111,142,True,38
l,34,kaist_dataset/Mixed/Digital_Camera/(C.S)C-outdoor3/DSC03328.JPG,char_data/l/DSC03328.JPG_2.jpg,272,480,640,8,316,324,238,272,True,38
l,66,kaist_dataset/Mixed/Digital_Camera/(C.S)C-outdoor3/DSC03409.JPG,char_data/l/DSC03409.JPG_5.jpg,1386,480,640,21,348,369,127,193,True,38
l,72,kaist_dataset/Mixed/Digital_Camera/(C.S)C-outdoor3/DSC03421.JPG,char_data/l/DSC03421.JPG_4.jpg,1440,480,640,20,468,488,246,318,True,38
l,112,kaist_dataset/Mixed/Digital_Camera/(C.S)C-outdoor3/DSC03421.JPG,char_data/l/DSC03421.JPG_5.jpg,4368,480,640,39,315,354,80,192,True,38
l,98,kaist_dataset/Mixed/Digital_Camera/(C.S)C-outdoor3/P1010016.JPG,char_data/l/P1010016.JPG_4.jpg,3038,480,640,31,335,366,154,252,True,38
l,102,kaist_dataset/Mixed/Digital_Camera/(C.S)C-outdoor3/P1010016.JPG,char_data/l/P1010016.JPG_5.jpg,3060,480,640,30,364,394,152,254,True,38
l,92,kaist_dataset/Mixed/Digital_Camera/(C.S)C-outdoor4/DSC03544.JPG,char_data/l/DSC03544.JPG_2.jpg,2392,480,640,26,155,181,163,255,True,38
l,30,kaist_dataset/Mixed/Digital_Camera/(C.S)C-outdoor4/DSC03552.JPG,char_data/l/DSC03552.JPG_2.jpg,390,480,640,13,334,347,320,350,True,38
l,27,kaist_dataset/Mixed/Digital_Camera/(C.S)C-outdoor4/DSC03556.JPG,char_data/l/DSC03556.JPG_2.jpg,216,480,640,8,342,350,322,349,True,38
l,48,kaist_dataset/Mixed/Digital_Camera/(C.S)C-outdoor4/DSC03569.JPG,char_data/l/DSC03569.JPG_2.jpg,720,480,640,15,323,338,170,218,True,38
l,103,kaist_dataset/Mixed/Digital_Camera/(C.S)C-outdoor4/DSC03572.JPG,char_data/l/DSC03572.JPG_2.jpg,3296,480,640,32,214,246,102,205,True,38
l,38,kaist_dataset/Mixed/Digital_Camera/(C.S)C-outdoor4/DSC03586.JPG,char_data/l/DSC03586.JPG_2.jpg,646,480,640,17,478,495,158,196,True,38
l,43,kaist_dataset/Mixed/Digital_Camera/(C.S)C-outdoor4/DSC03642.JPG,char_data/l/DSC03642.JPG_4.jpg,731,480,640,17,399,416,243,286,True,38
l,96,kaist_dataset/Mixed/Digital_Camera/(C.S)C-outdoor4/DSC03651.JPG,char_data/l/DSC03651.JPG_2.jpg,2400,480,640,25,446,471,157,253,True,38
l,32,kaist_dataset/Mixed/Digital_Camera/(C.S)C-outdoor4/DSC03661.JPG,char_data/l/DSC03661.JPG_7.jpg,384,480,640,12,147,159,271,303,True,38
l,28,kaist_dataset/Mixed/Digital_Camera/(C.S)C-outdoor4/DSC03670.JPG,char_data/l/DSC03670.JPG_2.jpg,168,480,640,6,218,224,322,350,True,38
l,30,kaist_dataset/Mixed/Digital_Camera/(C.S)C-outdoor4/DSC03677.JPG,char_data/l/DSC03677.JPG_2.jpg,210,480,640,7,497,504,317,347,True,38
l,33,kaist_dataset/Mixed/Digital_Camera/(C.S)C-outdoor4/DSC03682.JPG,char_data/l/DSC03682.JPG_2.jpg,231,480,640,7,542,549,323,356,True,38
l,31,kaist_dataset/Mixed/Digital_Camera/(C.S)C-outdoor4/DSC03718.JPG,char_data/l/DSC03718.JPG_2.jpg,217,480,640,7,82,89,258,289,True,38
l,40,kaist_dataset/Mixed/Digital_Camera/(C.S)C-outdoor4/DSC03719.JPG,char_data/l/DSC03719.JPG_2.jpg,440,480,640,11,85,96,27,67,True,38
l,88,kaist_dataset/Mixed/Digital_Camera/(C.S)C-outdoor4/DSC03733.JPG,char_data/l/DSC03733.JPG_2.jpg,2464,480,640,28,321,349,191,279,True,38
l,45,kaist_dataset/Mixed/Digital_Camera/(C.S)C-outdoor4/DSC03781.JPG,char_data/l/DSC03781.JPG_2.jpg,990,480,640,22,326,348,265,310,True,38
l,34,kaist_dataset/Mixed/Digital_Camera/(C.S)C-outdoor5/DSC03839.JPG,char_data/l/DSC03839.JPG_2.jpg,408,480,640,12,237,249,364,398,True,38
l,72,kaist_dataset/Mixed/Digital_Camera/(C.S)C-outdoor5/DSC04029.JPG,char_data/l/DSC04029.JPG_2.jpg,1512,480,640,21,218,239,162,234,True,38
l,33,kaist_dataset/Mixed/Digital_Camera/(C.S)C-outdoor5/DSC04069.JPG,char_data/l/DSC04069.JPG_4.jpg,396,480,640,12,268,280,422,455,True,38
l,37,kaist_dataset/Mixed/Digital_Camera/(C.S)C-outdoor5/DSC04069.JPG,char_data/l/DSC04069.JPG_5.jpg,444,480,640,12,151,163,382,419,True,38
l,38,kaist_dataset/Mixed/Digital_Camera/(C.S)C-outdoor5/DSC04070.JPG,char_data/l/DSC04070.JPG_4.jpg,304,480,640,8,171,179,108,146,True,38
l,25,kaist_dataset/Mixed/Digital_Camera/(C.S)C-outdoor5/DSC04091.JPG,char_data/l/DSC04091.JPG_4.jpg,175,480,640,7,342,349,430,455,True,38
l,29,kaist_dataset/Mixed/Digital_Camera/(C.S)C-outdoor5/DSC04091.JPG,char_data/l/DSC04091.JPG_5.jpg,174,480,640,6,349,355,430,459,True,38
l,85,kaist_dataset/Mixed/Digital_Camera/(C.S)C-outdoor5/DSC04115.JPG,char_data/l/DSC04115.JPG_2.jpg,2040,480,640,24,266,290,190,275,True,38
l,44,kaist_dataset/Mixed/Digital_Camera/(C.S)C-outdoor5/DSC04154.JPG,char_data/l/DSC04154.JPG_2.jpg,704,480,640,16,553,569,234,278,True,38
l,45,kaist_dataset/Mixed/Digital_Camera/(C.S)C-outdoor5/DSC04321.JPG,char_data/l/DSC04321.JPG_2.jpg,540,480,640,12,377,389,197,242,True,38
l,50,kaist_dataset/Mixed/Digital_Camera/(C.S)C-outdoor5/DSC04322.JPG,char_data/l/DSC04322.JPG_4.jpg,550,480,640,11,242,253,212,262,True,38
l,45,kaist_dataset/Mixed/Digital_Camera/(C.S)C-outdoor5/DSC04322.JPG,char_data/l/DSC04322.JPG_5.jpg,810,480,640,18,551,569,223,268,True,38
l,111,kaist_dataset/Mixed/Digital_Camera/(C.S)C-outdoor5/DSC04349.JPG,char_data/l/DSC04349.JPG_2.jpg,4107,480,640,37,220,257,75,186,True,38
l,30,kaist_dataset/Mixed/Digital_Camera/(C.S)C-outdoor5/DSC04357.JPG,char_data/l/DSC04357.JPG_8.jpg,330,480,640,11,376,387,379,409,True,38
l,26,kaist_dataset/Mixed/Digital_Camera/(C.S)C-outdoor5/DSC04357.JPG,char_data/l/DSC04357.JPG_9.jpg,130,480,640,5,370,375,380,406,True,38
l,28,kaist_dataset/Mixed/Digital_Camera/(C.S)C-outdoor5/DSC04357.JPG,char_data/l/DSC04357.JPG_10.jpg,168,480,640,6,389,395,352,380,True,38
l,28,kaist_dataset/Mixed/Digital_Camera/(C.S)C-outdoor5/DSC04357.JPG,char_data/l/DSC04357.JPG_11.jpg,168,480,640,6,425,431,354,382,True,38
l,45,kaist_dataset/Mixed/Digital_Camera/(C.S)C-outdoor5/DSC04429.JPG,char_data/l/DSC04429.JPG_4.jpg,495,480,640,11,328,339,247,292,False,38
l,45,kaist_dataset/Mixed/Digital_Camera/(C.S)C-outdoor5/DSC04429.JPG,char_data/l/DSC04429.JPG_5.jpg,675,480,640,15,337,352,247,292,False,38
l,78,kaist_dataset/Mixed/Digital_Camera/(C.S)C-outdoor6/DSC03324.JPG,char_data/l/DSC03324.JPG_8.jpg,2418,480,640,31,286,317,76,154,False,38
l,78,kaist_dataset/Mixed/Digital_Camera/(C.S)C-outdoor6/DSC03324.JPG,char_data/l/DSC03324.JPG_9.jpg,2106,480,640,27,315,342,75,153,False,38
l,70,kaist_dataset/Mixed/Digital_Camera/(C.S)C-outdoor6/DSC03324.JPG,char_data/l/DSC03324.JPG_10.jpg,2380,480,640,34,460,494,71,141,False,38
l,74,kaist_dataset/Mixed/Digital_Camera/(C.S)C-outdoor6/DSC03324.JPG,char_data/l/DSC03324.JPG_11.jpg,2368,480,640,32,491,523,69,143,False,38
l,33,kaist_dataset/Mixed/Digital_Camera/(C.S)C-outdoor6/P1010020.JPG,char_data/l/P1010020.JPG_2.jpg,363,480,640,11,117,128,334,367,False,38
l,40,kaist_dataset/Mixed/Digital_Camera/(C.S)C-outdoor6/P1010021.JPG,char_data/l/P1010021.JPG_2.jpg,600,480,640,15,75,90,210,250,False,38
l,60,kaist_dataset/Mixed/Digital_Camera/(C.S)C-outdoor6/P1010052.JPG,char_data/l/P1010052.JPG_2.jpg,1140,480,640,19,472,491,119,179,False,38
l,22,kaist_dataset/Mixed/Digital_Camera/(C.S)C-outdoor6/P1010065.JPG,char_data/l/P1010065.JPG_2.jpg,176,480,640,8,224,232,235,257,False,38
l,34,kaist_dataset/Mixed/Digital_Camera/(C.S)C-outdoor6/P1010069.JPG,char_data/l/P1010069.JPG_2.jpg,306,480,640,9,226,235,297,331,False,38
l,36,kaist_dataset/Mixed/Digital_Camera/(C.S)C-outdoor6/P1010075.JPG,char_data/l/P1010075.JPG_2.jpg,324,480,640,9,416,425,307,343,False,38
l,90,kaist_dataset/Mixed/Digital_Camera/(C.S)C-outdoor6/P1010116.JPG,char_data/l/P1010116.JPG_2.jpg,1710,480,640,19,355,374,183,273,False,38
l,45,kaist_dataset/Mixed/Digital_Camera/(C.S)C-outdoor6/크기변환_P1010029.JPG,char_data/l/크기변환_P1010029.JPG_2.jpg,495,480,640,11,345,356,12,57,False,38
l,56,kaist_dataset/Mixed/Digital_Camera/(C.S)D-indoor1/082.JPG,char_data/l/082.JPG_2.jpg,1064,480,640,19,164,183,174,230,False,38
l,48,kaist_dataset/Mixed/Digital_Camera/(C.S)D-indoor1/DSC02787.JPG,char_data/l/DSC02787.JPG_2.jpg,480,480,640,10,151,161,378,426,False,38
l,35,kaist_dataset/Mixed/Digital_Camera/(C.S)D-indoor1/DSC03096.JPG,char_data/l/DSC03096.JPG_4.jpg,350,480,640,10,130,140,420,455,False,38
l,35,kaist_dataset/Mixed/Digital_Camera/(C.S)D-indoor1/DSC03096.JPG,char_data/l/DSC03096.JPG_5.jpg,315,480,640,9,400,409,423,458,False,38
l,54,kaist_dataset/Mixed/Digital_Camera/(C.S)D-indoor1/DSC03118.JPG,char_data/l/DSC03118.JPG_6.jpg,540,480,640,10,489,499,148,202,False,38
l,51,kaist_dataset/Mixed/Digital_Camera/(C.S)D-indoor1/DSC03118.JPG,char_data/l/DSC03118.JPG_7.jpg,459,480,640,9,329,338,221,272,False,38
l,51,kaist_dataset/Mixed/Digital_Camera/(C.S)D-indoor1/DSC03118.JPG,char_data/l/DSC03118.JPG_8.jpg,459,480,640,9,338,347,221,272,False,38
l,46,kaist_dataset/Mixed/Digital_Camera/(C.S)D-indoor1/DSC03123.JPG,char_data/l/DSC03123.JPG_2.jpg,828,480,640,18,428,446,176,222,False,38
l,46,kaist_dataset/Mixed/Digital_Camera/(C.S)D-indoor1/DSC03132.JPG,char_data/l/DSC03132.JPG_2.jpg,506,480,640,11,230,241,172,218,False,38
l,57,kaist_dataset/Mixed/Digital_Camera/(C.S)D-indoor1/DSC03133.JPG,char_data/l/DSC03133.JPG_2.jpg,684,480,640,12,431,443,143,200,False,38
l,67,kaist_dataset/Mixed/Digital_Camera/(C.S)D-indoor1/DSC03455.JPG,char_data/l/DSC03455.JPG_2.jpg,1407,480,640,21,316,337,385,452,False,38
l,105,kaist_dataset/Mixed/Digital_Camera/(C.S)D-indoor1/DSC03909.JPG,char_data/l/DSC03909.JPG_4.jpg,2625,480,640,25,299,324,80,185,False,38
l,110,kaist_dataset/Mixed/Digital_Camera/(C.S)D-indoor1/DSC03909.JPG,char_data/l/DSC03909.JPG_5.jpg,2530,480,640,23,324,347,76,186,False,38
l,56,kaist_dataset/Mixed/Digital_Camera/(C.S)D-indoor1/DSC03912.JPG,char_data/l/DSC03912.JPG_2.jpg,896,480,640,16,385,401,38,94,False,38
l,45,kaist_dataset/Mixed/Digital_Camera/(C.S)D-indoor1/DSC03953.JPG,char_data/l/DSC03953.JPG_2.jpg,630,480,640,14,315,329,384,429,False,38
l,44,kaist_dataset/Mixed/Digital_Camera/(C.S)D-indoor1/DSC04022.JPG,char_data/l/DSC04022.JPG_2.jpg,528,480,640,12,338,350,161,205,False,38
l,44,kaist_dataset/Mixed/Digital_Camera/(C.S)D-indoor1/DSC04206.JPG,char_data/l/DSC04206.JPG_4.jpg,572,480,640,13,333,346,287,331,False,38
l,36,kaist_dataset/Mixed/Digital_Camera/(C.S)D-indoor1/DSC04206.JPG,char_data/l/DSC04206.JPG_5.jpg,288,480,640,8,346,354,289,325,False,38
l,44,kaist_dataset/Mixed/Digital_Camera/(C.S)E-night/DSC02569.JPG,char_data/l/DSC02569.JPG_2.jpg,528,480,640,12,221,233,406,450,False,38
l,42,kaist_dataset/Mixed/Digital_Camera/(C.S)E-night/DSC02647.JPG,char_data/l/DSC02647.JPG_2.jpg,588,480,640,14,161,175,288,330,False,38
l,28,kaist_dataset/Mixed/Digital_Camera/(C.S)E-night/P1010155.JPG,char_data/l/P1010155.JPG_2.jpg,280,480,640,10,426,436,285,313,False,38
l,77,kaist_dataset/Mixed/Digital_Camera/(C.S)F-others/047.jpg,char_data/l/047.jpg_8.jpg,1925,252,339,25,273,298,26,103,False,38
l,20,kaist_dataset/Mixed/Digital_Camera/(C.S)F-others/2007-12-08-day-067.jpg,char_data/l/2007-12-08-day-067.jpg_2.jpg,1200,1600,1200,60,440,500,846,866,False,38
l,70,kaist_dataset/Mixed/Digital_Camera/(C.S)F-others/DSC02696.JPG,char_data/l/DSC02696.JPG_2.jpg,2100,480,640,30,375,405,305,375,False,38
l,60,kaist_dataset/Mixed/Mobile_Phone/(C.M)B-indoor/P090831023.jpg,char_data/l/P090831023.jpg_2.jpg,1380,480,640,23,343,366,266,326,False,38
l,50,kaist_dataset/Mixed/Mobile_Phone/(C.M)C-bookCover/P090831115.jpg,char_data/l/P090831115.jpg_2.jpg,800,480,640,16,251,267,159,209,False,38
l,59,kaist_dataset/Mixed/Mobile_Phone/(C.M)C-bookCover/P090831118.jpg,char_data/l/P090831118.jpg_2.jpg,1121,480,640,19,475,494,198,257,False,38
l,80,kaist_dataset/Mixed/Mobile_Phone/(C.M)C-bookCover/P090831126.jpg,char_data/l/P090831126.jpg_4.jpg,2080,480,640,26,372,398,266,346,False,38
l,78,kaist_dataset/Mixed/Mobile_Phone/(C.M)C-bookCover/P090831126.jpg,char_data/l/P090831126.jpg_5.jpg,2106,480,640,27,396,423,265,343,False,38
l,37,kaist_dataset/Mixed/Mobile_Phone/(C.M)C-bookCover/P090902016.jpg,char_data/l/P090902016.jpg_6.jpg,481,480,640,13,319,332,136,173,False,38
l,38,kaist_dataset/Mixed/Mobile_Phone/(C.M)C-bookCover/P090902016.jpg,char_data/l/P090902016.jpg_7.jpg,418,480,640,11,135,146,267,305,False,38
l,44,kaist_dataset/Mixed/Mobile_Phone/(C.M)C-bookCover/P090902016.jpg,char_data/l/P090902016.jpg_8.jpg,616,480,640,14,145,159,267,311,False,38
l,41,kaist_dataset/Mixed/Mobile_Phone/(C.M)C-bookCover/P090903024.jpg,char_data/l/P090903024.jpg_2.jpg,738,480,640,18,527,545,106,147,False,38
l,62,kaist_dataset/Mixed/Mobile_Phone/(C.M)C-bookCover/P090904004.jpg,char_data/l/P090904004.jpg_2.jpg,1054,480,640,17,546,563,384,446,False,38
F,71,kaist_dataset/English/Digital_Camera/(E.S)A-shadow/DSC02423.JPG,char_data/F/DSC02423.JPG_4.jpg,2911,480,640,41,531,572,168,239,True,17
F,43,kaist_dataset/English/Digital_Camera/(E.S)A-shadow/DSC02423.JPG,char_data/F/DSC02423.JPG_5.jpg,1075,480,640,25,445,470,244,287,True,17
F,90,kaist_dataset/English/Digital_Camera/(E.S)A-shadow/DSC02629.JPG,char_data/F/DSC02629.JPG_4.jpg,4770,480,640,53,373,426,306,396,True,17
F,93,kaist_dataset/English/Digital_Camera/(E.S)A-shadow/DSC02629.JPG,char_data/F/DSC02629.JPG_5.jpg,5115,480,640,55,423,478,303,396,True,17
F,34,kaist_dataset/English/Digital_Camera/(E.S)A-shadow/P1010044.JPG,char_data/F/P1010044.JPG_2.jpg,952,480,640,28,227,255,185,219,True,17
F,27,kaist_dataset/English/Digital_Camera/(E.S)B-light/080116-0059.jpg,char_data/F/080116-0059.jpg_4.jpg,405,1200,1600,15,827,842,799,826,True,17
F,32,kaist_dataset/English/Digital_Camera/(E.S)B-light/080116-0059.jpg,char_data/F/080116-0059.jpg_5.jpg,416,1200,1600,13,972,985,768,800,True,17
F,50,kaist_dataset/English/Digital_Camera/(E.S)B-light/DSC03007.JPG,char_data/F/DSC03007.JPG_2.jpg,1150,480,640,23,354,377,272,322,True,17
F,63,kaist_dataset/English/Digital_Camera/(E.S)C-outdoor1/035.jpg,char_data/F/035.jpg_2.jpg,1701,210,354,27,100,127,22,85,True,17
F,43,kaist_dataset/English/Digital_Camera/(E.S)C-outdoor1/080116-0065.jpg,char_data/F/080116-0065.jpg_2.jpg,1247,600,800,29,457,486,204,247,True,17
F,67,kaist_dataset/English/Digital_Camera/(E.S)C-outdoor1/080118-0011.jpg,char_data/F/080118-0011.jpg_2.jpg,3350,1200,1600,50,711,761,596,663,True,17
F,284,kaist_dataset/English/Digital_Camera/(E.S)C-outdoor1/080119-0036.jpg,char_data/F/080119-0036.jpg_2.jpg,54812,1200,1600,193,116,309,298,582,True,17
F,35,kaist_dataset/English/Digital_Camera/(E.S)C-outdoor1/107.jpg,char_data/F/107.jpg_2.jpg,980,480,640,28,459,487,334,369,True,17
F,50,kaist_dataset/English/Digital_Camera/(E.S)C-outdoor1/113.jpg,char_data/F/113.jpg_6.jpg,1800,480,640,36,295,331,171,221,True,17
F,52,kaist_dataset/English/Digital_Camera/(E.S)C-outdoor1/113.jpg,char_data/F/113.jpg_7.jpg,1976,480,640,38,331,369,169,221,True,17
F,51,kaist_dataset/English/Digital_Camera/(E.S)C-outdoor1/DSC02355.JPG,char_data/F/DSC02355.JPG_2.jpg,1581,480,640,31,39,70,298,349,True,17
F,76,kaist_dataset/English/Digital_Camera/(E.S)C-outdoor1/DSC02356.JPG,char_data/F/DSC02356.JPG_8.jpg,3268,480,640,43,159,202,165,241,True,17
F,78,kaist_dataset/English/Digital_Camera/(E.S)C-outdoor1/DSC02356.JPG,char_data/F/DSC02356.JPG_9.jpg,3042,480,640,39,202,241,167,245,True,17
F,48,kaist_dataset/English/Digital_Camera/(E.S)C-outdoor1/DSC02427.JPG,char_data/F/DSC02427.JPG_8.jpg,1152,480,640,24,555,579,239,287,True,17
F,50,kaist_dataset/English/Digital_Camera/(E.S)C-outdoor1/DSC02427.JPG,char_data/F/DSC02427.JPG_9.jpg,850,480,640,17,580,597,236,286,True,17
F,53,kaist_dataset/English/Digital_Camera/(E.S)C-outdoor2/DSC03023.JPG,char_data/F/DSC03023.JPG_4.jpg,1749,480,640,33,384,417,298,351,True,17
F,53,kaist_dataset/English/Digital_Camera/(E.S)C-outdoor2/DSC03023.JPG,char_data/F/DSC03023.JPG_5.jpg,1431,480,640,27,415,442,298,351,True,17
F,75,kaist_dataset/English/Digital_Camera/(E.S)C-outdoor2/DSC03050.JPG,char_data/F/DSC03050.JPG_2.jpg,6525,480,640,87,83,170,210,285,True,17
F,38,kaist_dataset/English/Digital_Camera/(E.S)C-outdoor2/DSC03162.JPG,char_data/F/DSC03162.JPG_2.jpg,798,480,640,21,585,606,142,180,True,17
F,77,kaist_dataset/English/Digital_Camera/(E.S)C-outdoor2/DSC03191.JPG,char_data/F/DSC03191.JPG_4.jpg,3850,480,640,50,214,264,224,301,True,17
F,78,kaist_dataset/English/Digital_Camera/(E.S)C-outdoor2/DSC03191.JPG,char_data/F/DSC03191.JPG_5.jpg,3978,480,640,51,262,313,221,299,True,17
F,67,kaist_dataset/English/Digital_Camera/(E.S)C-outdoor2/DSC03264.JPG,char_data/F/DSC03264.JPG_2.jpg,3283,480,640,49,194,243,229,296,True,17
F,42,kaist_dataset/English/Digital_Camera/(E.S)C-outdoor2/DSC03317.JPG,char_data/F/DSC03317.JPG_2.jpg,756,480,640,18,460,478,257,299,True,17
F,83,kaist_dataset/English/Digital_Camera/(E.S)C-outdoor2/DSC03432.JPG,char_data/F/DSC03432.JPG_2.jpg,4150,480,640,50,137,187,355,438,True,17
F,66,kaist_dataset/English/Digital_Camera/(E.S)C-outdoor2/DSC03684.JPG,char_data/F/DSC03684.JPG_2.jpg,3696,480,640,56,67,123,76,142,True,17
F,43,kaist_dataset/English/Digital_Camera/(E.S)C-outdoor2/DSC03831.JPG,char_data/F/DSC03831.JPG_2.jpg,946,480,640,22,362,384,123,166,True,17
F,65,kaist_dataset/English/Digital_Camera/(E.S)C-outdoor2/DSC04079.JPG,char_data/F/DSC04079.JPG_4.jpg,2665,480,640,41,65,106,38,103,True,17
F,138,kaist_dataset/English/Digital_Camera/(E.S)C-outdoor2/DSC04397.JPG,char_data/F/DSC04397.JPG_2.jpg,14076,480,640,102,25,127,181,319,True,17
F,33,kaist_dataset/English/Digital_Camera/(E.S)C-outdoor2/DSC04437.JPG,char_data/F/DSC04437.JPG_8.jpg,594,480,640,18,74,92,41,74,True,17
F,30,kaist_dataset/English/Digital_Camera/(E.S)C-outdoor2/DSC04437.JPG,char_data/F/DSC04437.JPG_10.jpg,630,480,640,21,73,94,76,106,True,17
F,80,kaist_dataset/English/Digital_Camera/(E.S)C-outdoor2/DSC04437.JPG,char_data/F/DSC04437.JPG_11.jpg,4480,480,640,56,70,126,108,188,True,17
F,156,kaist_dataset/English/Digital_Camera/(E.S)C-outdoor2/DSC04458.JPG,char_data/F/DSC04458.JPG_2.jpg,15132,480,640,97,37,134,99,255,True,17
F,56,kaist_dataset/English/Digital_Camera/(E.S)C-outdoor2/IMG_2481.JPG,char_data/F/IMG_2481.JPG_4.jpg,1736,480,640,31,287,318,257,313,True,17
F,59,kaist_dataset/English/Digital_Camera/(E.S)C-outdoor2/IMG_2481.JPG,char_data/F/IMG_2481.JPG_5.jpg,2065,480,640,35,321,356,255,314,True,17
F,58,kaist_dataset/English/Digital_Camera/(E.S)C-outdoor2/P1010057.JPG,char_data/F/P1010057.JPG_2.jpg,2320,480,640,40,141,181,184,242,True,17
F,29,kaist_dataset/English/Digital_Camera/(E.S)C-outdoor3/P1010123.JPG,char_data/F/P1010123.JPG_12.jpg,580,480,640,20,495,515,67,96,True,17
F,27,kaist_dataset/English/Digital_Camera/(E.S)C-outdoor3/P1010123.JPG,char_data/F/P1010123.JPG_13.jpg,621,480,640,23,508,531,101,128,True,17
F,29,kaist_dataset/English/Digital_Camera/(E.S)C-outdoor3/P1010123.JPG,char_data/F/P1010123.JPG_14.jpg,609,480,640,21,524,545,129,158,True,17
F,34,kaist_dataset/English/Digital_Camera/(E.S)C-outdoor3/P1010123.JPG,char_data/F/P1010123.JPG_15.jpg,680,480,640,20,1,20,71,105,True,17
F,32,kaist_dataset/English/Digital_Camera/(E.S)C-outdoor3/P1010123.JPG,char_data/F/P1010123.JPG_16.jpg,768,480,640,24,5,29,108,140,True,17
F,36,kaist_dataset/English/Digital_Camera/(E.S)C-outdoor3/P1010123.JPG,char_data/F/P1010123.JPG_17.jpg,864,480,640,24,19,43,139,175,True,17
F,88,kaist_dataset/English/Digital_Camera/(E.S)C-outdoor3/P1010133.JPG,char_data/F/P1010133.JPG_2.jpg,5104,480,640,58,210,268,61,149,True,17
F,62,kaist_dataset/English/Digital_Camera/(E.S)C-outdoor3/크기변환_P1010028.JPG,char_data/F/크기변환_P1010028.JPG_2.jpg,2170,480,640,35,156,191,165,227,True,17
F,33,kaist_dataset/English/Digital_Camera/(E.S)D-indoor/080119-0009.jpg,char_data/F/080119-0009.jpg_6.jpg,759,1200,1600,23,36,59,1058,1091,True,17
F,56,kaist_dataset/English/Digital_Camera/(E.S)D-indoor/080119-0009.jpg,char_data/F/080119-0009.jpg_7.jpg,1064,1200,1600,19,563,582,919,975,True,17
F,208,kaist_dataset/English/Digital_Camera/(E.S)D-indoor/DSC02725.JPG,char_data/F/DSC02725.JPG_2.jpg,32032,480,640,154,321,475,167,375,True,17
F,91,kaist_dataset/English/Digital_Camera/(E.S)D-indoor/DSC02850.JPG,char_data/F/DSC02850.JPG_2.jpg,5551,480,640,61,259,320,149,240,True,17
F,48,kaist_dataset/English/Digital_Camera/(E.S)D-indoor/DSC03090.JPG,char_data/F/DSC03090.JPG_2.jpg,1536,480,640,32,419,451,233,281,True,17
F,62,kaist_dataset/English/Digital_Camera/(E.S)D-indoor/DSC03112.JPG,char_data/F/DSC03112.JPG_2.jpg,2728,480,640,44,242,286,253,315,True,17
F,60,kaist_dataset/English/Digital_Camera/(E.S)D-indoor/DSC03150.JPG,char_data/F/DSC03150.JPG_2.jpg,2580,480,640,43,288,331,19,79,True,17
F,47,kaist_dataset/English/Digital_Camera/(E.S)D-indoor/DSC03396.JPG,char_data/F/DSC03396.JPG_2.jpg,1645,480,640,35,444,479,336,383,True,17
F,37,kaist_dataset/English/Digital_Camera/(E.S)D-indoor/DSC03901.JPG,char_data/F/DSC03901.JPG_2.jpg,1110,480,640,30,447,477,117,154,True,17
F,130,kaist_dataset/English/Digital_Camera/(E.S)D-indoor/DSC03911.JPG,char_data/F/DSC03911.JPG_2.jpg,9360,480,640,72,37,109,316,446,True,17
F,86,kaist_dataset/English/Digital_Camera/(E.S)D-indoor/DSC04255.JPG,char_data/F/DSC04255.JPG_2.jpg,6192,480,640,72,144,216,280,366,True,17
F,19,kaist_dataset/English/Digital_Camera/(E.S)E-night/111.jpg,char_data/F/111.jpg_2.jpg,209,480,640,11,232,243,265,284,True,17
F,37,kaist_dataset/English/Digital_Camera/(E.S)F-others/080119-0007.jpg,char_data/F/080119-0007.jpg_2.jpg,1961,1200,1600,53,1216,1269,779,816,True,17
F,190,kaist_dataset/English/Digital_Camera/(E.S)F-others/080119-0014.jpg,char_data/F/080119-0014.jpg_2.jpg,19570,1200,1600,103,482,585,420,610,True,17
F,49,kaist_dataset/English/Digital_Camera/(E.S)F-others/086.jpg,char_data/F/086.jpg_4.jpg,784,480,640,16,352,368,319,368,True,17
F,45,kaist_dataset/English/Digital_Camera/(E.S)F-others/086.jpg,char_data/F/086.jpg_5.jpg,720,480,640,16,365,381,326,371,True,17
F,106,kaist_dataset/English/Digital_Camera/(E.S)F-others/DSC02646.JPG,char_data/F/DSC02646.JPG_6.jpg,5512,480,640,52,82,134,294,400,True,17
F,109,kaist_dataset/English/Digital_Camera/(E.S)F-others/DSC02646.JPG,char_data/F/DSC02646.JPG_7.jpg,4360,480,640,40,283,323,228,337,True,17
F,114,kaist_dataset/English/Digital_Camera/(E.S)F-others/DSC02646.JPG,char_data/F/DSC02646.JPG_8.jpg,4560,480,640,40,321,361,211,325,True,17
F,48,kaist_dataset/English/Digital_Camera/(E.S)F-others/DSC02884.JPG,char_data/F/DSC02884.JPG_2.jpg,1392,480,640,29,329,358,61,109,True,17
F,86,kaist_dataset/English/Digital_Camera/(E.S)F-others/크기변환_%C4%BF%C7%C7%B5%B9%C3%E2%B0%A3%C6%C7_%281%29_alto99kr.jpg,char_data/F/크기변환_%C4%BF%C7%C7%B5%B9%C3%E2%B0%A3%C6%C7_%281%29_alto99kr.jpg_4.jpg,5934,480,640,69,274,343,262,348,True,17
F,85,kaist_dataset/English/Digital_Camera/(E.S)F-others/크기변환_%C4%BF%C7%C7%B5%B9%C3%E2%B0%A3%C6%C7_%281%29_alto99kr.jpg,char_data/F/크기변환_%C4%BF%C7%C7%B5%B9%C3%E2%B0%A3%C6%C7_%281%29_alto99kr.jpg_5.jpg,6120,480,640,72,352,424,253,338,True,17
F,91,kaist_dataset/English/Mobile_Phone/(E.M)A-outdoor/P090911071.jpg,char_data/F/P090911071.jpg_2.jpg,6097,480,640,67,66,133,124,215,True,17
F,65,kaist_dataset/English/Mobile_Phone/(E.M)B-indoor/P090911067.jpg,char_data/F/P090911067.jpg_2.jpg,1950,480,640,30,212,242,211,276,True,17
F,100,kaist_dataset/English/Mobile_Phone/(E.M)B-indoor/P090911083.jpg,char_data/F/P090911083.jpg_2.jpg,7100,480,640,71,61,132,194,294,True,17
F,126,kaist_dataset/English/Mobile_Phone/(E.M)C-bookCover/P090831037.jpg,char_data/F/P090831037.jpg_2.jpg,13230,480,640,105,167,272,53,179,True,17
F,65,kaist_dataset/English/Mobile_Phone/(E.M)C-bookCover/P090831075.jpg,char_data/F/P090831075.jpg_2.jpg,2210,480,640,34,234,268,160,225,True,17
F,55,kaist_dataset/English/Mobile_Phone/(E.M)C-bookCover/P090903015.jpg,char_data/F/P090903015.jpg_4.jpg,1925,480,640,35,274,309,75,130,True,17
F,46,kaist_dataset/English/Mobile_Phone/(E.M)C-bookCover/P090903015.jpg,char_data/F/P090903015.jpg_5.jpg,1748,480,640,38,123,161,150,196,True,17
F,80,kaist_dataset/English/Mobile_Phone/(E.M)C-bookCover/P090903071.jpg,char_data/F/P090903071.jpg_2.jpg,5440,480,640,68,469,537,146,226,True,17
F,104,kaist_dataset/English/Mobile_Phone/(E.M)C-bookCover/P090903076.jpg,char_data/F/P090903076.jpg_2.jpg,7592,480,640,73,456,529,181,285,True,17
F,118,kaist_dataset/English/Mobile_Phone/(E.M)C-bookCover/P090905007.jpg,char_data/F/P090905007.jpg_2.jpg,8850,480,640,75,13,88,17,135,True,17
F,18,kaist_dataset/Korean/Digital_Camera/E-night/103.jpg,char_data/F/103.jpg_2.jpg,180,480,640,10,363,373,153,171,True,17
F,41,kaist_dataset/Korean/Digital_Camera/E-night/DSC03861.JPG,char_data/F/DSC03861.JPG_2.jpg,1271,480,640,31,295,326,425,466,True,17
F,77,kaist_dataset/Korean/Digital_Camera/G-others/2007-12-09-day-exterior-005.jpg,char_data/F/2007-12-09-day-exterior-005.jpg_2.jpg,7777,1600,1200,101,74,175,1334,1411,True,17
F,59,kaist_dataset/Korean/Digital_Camera/G-others/DSC02584.JPG,char_data/F/DSC02584.JPG_2.jpg,3009,480,640,51,431,482,313,372,True,17
F,30,kaist_dataset/Korean/Digital_Camera/outdoor1/2007-12-08-day-087.jpg,char_data/F/2007-12-08-day-087.jpg_2.jpg,840,1200,1600,28,77,105,507,537,True,17
F,61,kaist_dataset/Korean/Digital_Camera/outdoor2/2007-12-08-day-101.jpg,char_data/F/2007-12-08-day-101.jpg_2.jpg,2867,1200,1600,47,237,284,1091,1152,True,17
F,50,kaist_dataset/Korean/Digital_Camera/outdoor6/DSC04350.JPG,char_data/F/DSC04350.JPG_2.jpg,2000,480,640,40,564,604,376,426,True,17
F,36,"kaist_dataset/Korean/Mobile_Phone/(M,K)F-others/P090912070.jpg",char_data/F/P090912070.jpg_2.jpg,828,480,640,23,265,288,288,324,True,17
F,56,kaist_dataset/Mixed/Digital_Camera/(C.S)A-shadow/DSC03258.JPG,char_data/F/DSC03258.JPG_2.jpg,1736,480,640,31,437,468,369,425,True,17
F,68,kaist_dataset/Mixed/Digital_Camera/(C.S)C-outdoor1/014.JPG,char_data/F/014.JPG_2.jpg,1836,480,640,27,144,171,196,264,True,17
F,51,kaist_dataset/Mixed/Digital_Camera/(C.S)C-outdoor1/066.JPG,char_data/F/066.JPG_2.jpg,2193,480,640,43,509,552,175,226,True,17
F,67,kaist_dataset/Mixed/Digital_Camera/(C.S)C-outdoor1/080119-0008.jpg,char_data/F/080119-0008.jpg_2.jpg,2278,1200,1600,34,1139,1173,658,725,True,17
F,178,kaist_dataset/Mixed/Digital_Camera/(C.S)C-outdoor1/080119-0017.jpg,char_data/F/080119-0017.jpg_2.jpg,19936,1200,1600,112,327,439,558,736,True,17
F,53,kaist_dataset/Mixed/Digital_Camera/(C.S)C-outdoor1/105.jpg,char_data/F/105.jpg_2.jpg,1484,480,640,28,443,471,371,424,True,17
F,61,kaist_dataset/Mixed/Digital_Camera/(C.S)C-outdoor1/112.JPG,char_data/F/112.JPG_2.jpg,3111,480,640,51,137,188,283,344,True,17
F,123,kaist_dataset/Mixed/Digital_Camera/(C.S)C-outdoor1/113.JPG,char_data/F/113.JPG_8.jpg,8364,480,640,68,492,560,228,351,True,17
F,39,kaist_dataset/Mixed/Digital_Camera/(C.S)C-outdoor1/114.jpg,char_data/F/114.jpg_4.jpg,1170,480,640,30,261,291,262,301,True,17
F,33,kaist_dataset/Mixed/Digital_Camera/(C.S)C-outdoor1/114.jpg,char_data/F/114.jpg_5.jpg,957,480,640,29,311,340,269,302,True,17
F,29,kaist_dataset/Mixed/Digital_Camera/(C.S)C-outdoor1/118.JPG,char_data/F/118.JPG_2.jpg,580,480,640,20,580,600,364,393,True,17
F,29,kaist_dataset/Mixed/Digital_Camera/(C.S)C-outdoor1/2007-12-09-day-exterior-051.jpg,char_data/F/2007-12-09-day-exterior-051.jpg_4.jpg,493,1200,1600,17,548,565,609,638,True,17
F,24,kaist_dataset/Mixed/Digital_Camera/(C.S)C-outdoor1/2007-12-09-day-exterior-051.jpg,char_data/F/2007-12-09-day-exterior-051.jpg_5.jpg,384,1200,1600,16,566,582,610,634,True,17
F,37,kaist_dataset/Mixed/Digital_Camera/(C.S)C-outdoor1/DSC02312.JPG,char_data/F/DSC02312.JPG_2.jpg,1702,480,640,46,477,523,223,260,True,17
F,50,kaist_dataset/Mixed/Digital_Camera/(C.S)C-outdoor1/DSC02325.JPG,char_data/F/DSC02325.JPG_2.jpg,1950,480,640,39,306,345,244,294,True,17
F,53,kaist_dataset/Mixed/Digital_Camera/(C.S)C-outdoor1/P1010009.JPG,char_data/F/P1010009.JPG_2.jpg,1749,480,640,33,345,378,187,240,True,17
F,46,kaist_dataset/Mixed/Digital_Camera/(C.S)C-outdoor2/DSC02389.JPG,char_data/F/DSC02389.JPG_2.jpg,1748,480,640,38,553,591,21,67,True,17
F,41,kaist_dataset/Mixed/Digital_Camera/(C.S)C-outdoor2/DSC02413.JPG,char_data/F/DSC02413.JPG_2.jpg,820,480,640,20,585,605,204,245,True,17
F,46,kaist_dataset/Mixed/Digital_Camera/(C.S)C-outdoor2/DSC02429.JPG,char_data/F/DSC02429.JPG_2.jpg,1334,480,640,29,358,387,109,155,True,17
F,28,kaist_dataset/Mixed/Digital_Camera/(C.S)C-outdoor2/DSC02466.JPG,char_data/F/DSC02466.JPG_2.jpg,1092,480,640,39,490,529,258,286,True,17
F,45,kaist_dataset/Mixed/Digital_Camera/(C.S)C-outdoor2/DSC02482.JPG,char_data/F/DSC02482.JPG_2.jpg,1530,480,640,34,520,554,159,204,True,17
F,45,kaist_dataset/Mixed/Digital_Camera/(C.S)C-outdoor2/DSC02490.JPG,char_data/F/DSC02490.JPG_2.jpg,1035,480,640,23,419,442,407,452,True,17
F,63,kaist_dataset/Mixed/Digital_Camera/(C.S)C-outdoor2/DSC02502.JPG,char_data/F/DSC02502.JPG_2.jpg,4473,480,640,71,488,559,340,403,True,17
F,48,kaist_dataset/Mixed/Digital_Camera/(C.S)C-outdoor2/DSC02503.JPG,char_data/F/DSC02503.JPG_2.jpg,2832,480,640,59,121,180,369,417,True,17
F,43,kaist_dataset/Mixed/Digital_Camera/(C.S)C-outdoor2/DSC02511.JPG,char_data/F/DSC02511.JPG_2.jpg,1290,480,640,30,605,635,409,452,True,17
F,73,kaist_dataset/Mixed/Digital_Camera/(C.S)C-outdoor2/DSC02513.JPG,char_data/F/DSC02513.JPG_2.jpg,2409,480,640,33,356,389,238,311,True,17
F,40,kaist_dataset/Mixed/Digital_Camera/(C.S)C-outdoor2/DSC02533.JPG,char_data/F/DSC02533.JPG_2.jpg,1240,480,640,31,278,309,362,402,True,17
F,35,kaist_dataset/Mixed/Digital_Camera/(C.S)C-outdoor2/DSC02885.JPG,char_data/F/DSC02885.JPG_2.jpg,630,480,640,18,580,598,63,98,True,17
F,29,kaist_dataset/Mixed/Digital_Camera/(C.S)C-outdoor2/DSC02886.JPG,char_data/F/DSC02886.JPG_2.jpg,609,480,640,21,516,537,129,158,True,17
F,43,kaist_dataset/Mixed/Digital_Camera/(C.S)C-outdoor2/DSC02887.JPG,char_data/F/DSC02887.JPG_2.jpg,817,480,640,19,428,447,114,157,True,17
F,48,kaist_dataset/Mixed/Digital_Camera/(C.S)C-outdoor2/DSC02895.JPG,char_data/F/DSC02895.JPG_2.jpg,1440,480,640,30,103,133,357,405,True,17
F,27,kaist_dataset/Mixed/Digital_Camera/(C.S)C-outdoor2/DSC02947.JPG,char_data/F/DSC02947.JPG_2.jpg,513,480,640,19,587,606,244,271,True,17
F,57,kaist_dataset/Mixed/Digital_Camera/(C.S)C-outdoor3/DSC02962.JPG,char_data/F/DSC02962.JPG_2.jpg,2622,480,640,46,34,80,223,280,True,17
F,36,kaist_dataset/Mixed/Digital_Camera/(C.S)C-outdoor3/DSC02970.JPG,char_data/F/DSC02970.JPG_2.jpg,972,480,640,27,183,210,303,339,True,17
F,28,kaist_dataset/Mixed/Digital_Camera/(C.S)C-outdoor3/DSC02989.JPG,char_data/F/DSC02989.JPG_4.jpg,560,480,640,20,80,100,175,203,True,17
F,82,kaist_dataset/Mixed/Digital_Camera/(C.S)C-outdoor3/DSC02989.JPG,char_data/F/DSC02989.JPG_5.jpg,6970,480,640,85,166,251,166,248,True,17
F,51,kaist_dataset/Mixed/Digital_Camera/(C.S)C-outdoor3/DSC03004.JPG,char_data/F/DSC03004.JPG_2.jpg,1632,480,640,32,600,632,355,406,True,17
F,43,kaist_dataset/Mixed/Digital_Camera/(C.S)C-outdoor3/DSC03020.JPG,char_data/F/DSC03020.JPG_4.jpg,1161,480,640,27,431,458,261,304,True,17
F,21,kaist_dataset/Mixed/Digital_Camera/(C.S)C-outdoor3/DSC03033.JPG,char_data/F/DSC03033.JPG_2.jpg,378,480,640,18,25,43,158,179,True,17
F,30,kaist_dataset/Mixed/Digital_Camera/(C.S)C-outdoor3/DSC03035.JPG,char_data/F/DSC03035.JPG_2.jpg,660,480,640,22,307,329,401,431,True,17
F,51,kaist_dataset/Mixed/Digital_Camera/(C.S)C-outdoor3/DSC03061.JPG,char_data/F/DSC03061.JPG_2.jpg,2805,480,640,55,196,251,151,202,True,17
F,118,kaist_dataset/Mixed/Digital_Camera/(C.S)C-outdoor3/DSC03190.JPG,char_data/F/DSC03190.JPG_2.jpg,10266,480,640,87,53,140,201,319,True,17
F,46,kaist_dataset/Mixed/Digital_Camera/(C.S)C-outdoor3/DSC03241.JPG,char_data/F/DSC03241.JPG_2.jpg,1426,480,640,31,339,370,305,351,True,17
F,58,kaist_dataset/Mixed/Digital_Camera/(C.S)C-outdoor3/DSC03242.JPG,char_data/F/DSC03242.JPG_4.jpg,4060,480,640,70,263,333,368,426,True,17
F,59,kaist_dataset/Mixed/Digital_Camera/(C.S)C-outdoor3/DSC03269.JPG,char_data/F/DSC03269.JPG_2.jpg,2301,480,640,39,439,478,360,419,True,17
F,92,kaist_dataset/Mixed/Digital_Camera/(C.S)C-outdoor3/DSC03271.JPG,char_data/F/DSC03271.JPG_2.jpg,4876,480,640,53,329,382,345,437,True,17
F,55,kaist_dataset/Mixed/Digital_Camera/(C.S)C-outdoor3/DSC03273.JPG,char_data/F/DSC03273.JPG_2.jpg,2090,480,640,38,552,590,288,343,True,17
F,52,kaist_dataset/Mixed/Digital_Camera/(C.S)C-outdoor3/DSC03274.JPG,char_data/F/DSC03274.JPG_2.jpg,1612,480,640,31,471,502,369,421,True,17
F,63,kaist_dataset/Mixed/Digital_Camera/(C.S)C-outdoor3/DSC03284.JPG,char_data/F/DSC03284.JPG_2.jpg,4158,480,640,66,235,301,336,399,True,17
F,43,kaist_dataset/Mixed/Digital_Camera/(C.S)C-outdoor3/DSC03301.JPG,char_data/F/DSC03301.JPG_2.jpg,1290,480,640,30,567,597,132,175,True,17
F,63,kaist_dataset/Mixed/Digital_Camera/(C.S)C-outdoor3/DSC03302.JPG,char_data/F/DSC03302.JPG_2.jpg,2457,480,640,39,594,633,251,314,True,17
F,23,kaist_dataset/Mixed/Digital_Camera/(C.S)C-outdoor3/DSC03303.JPG,char_data/F/DSC03303.JPG_4.jpg,690,480,640,30,588,618,110,133,True,17
F,29,kaist_dataset/Mixed/Digital_Camera/(C.S)C-outdoor3/DSC03303.JPG,char_data/F/DSC03303.JPG_5.jpg,493,480,640,17,606,623,273,302,True,17
F,64,kaist_dataset/Mixed/Digital_Camera/(C.S)C-outdoor3/DSC03306.JPG,char_data/F/DSC03306.JPG_2.jpg,2048,480,640,32,281,313,394,458,True,17
F,48,kaist_dataset/Mixed/Digital_Camera/(C.S)C-outdoor3/DSC03310.JPG,char_data/F/DSC03310.JPG_8.jpg,1392,480,640,29,580,609,323,371,True,17
F,55,kaist_dataset/Mixed/Digital_Camera/(C.S)C-outdoor3/DSC03314.JPG,char_data/F/DSC03314.JPG_2.jpg,1595,480,640,29,327,356,360,415,True,17
F,25,kaist_dataset/Mixed/Digital_Camera/(C.S)C-outdoor3/DSC03315.JPG,char_data/F/DSC03315.JPG_2.jpg,525,480,640,21,556,577,124,149,True,17
F,35,kaist_dataset/Mixed/Digital_Camera/(C.S)C-outdoor3/DSC03316.JPG,char_data/F/DSC03316.JPG_2.jpg,665,480,640,19,336,355,83,118,True,17
F,52,kaist_dataset/Mixed/Digital_Camera/(C.S)C-outdoor3/DSC03323.JPG,char_data/F/DSC03323.JPG_2.jpg,1924,480,640,37,593,630,264,316,True,17
F,35,kaist_dataset/Mixed/Digital_Camera/(C.S)C-outdoor3/DSC03328.JPG,char_data/F/DSC03328.JPG_4.jpg,910,480,640,26,292,318,238,273,True,17
F,37,kaist_dataset/Mixed/Digital_Camera/(C.S)C-outdoor3/DSC03328.JPG,char_data/F/DSC03328.JPG_5.jpg,740,480,640,20,291,311,400,437,True,17
F,45,kaist_dataset/Mixed/Digital_Camera/(C.S)C-outdoor3/DSC03329.JPG,char_data/F/DSC03329.JPG_2.jpg,1530,480,640,34,408,442,431,476,True,17
F,55,kaist_dataset/Mixed/Digital_Camera/(C.S)C-outdoor3/DSC03330.JPG,char_data/F/DSC03330.JPG_2.jpg,2530,480,640,46,82,128,376,431,True,17
F,56,kaist_dataset/Mixed/Digital_Camera/(C.S)C-outdoor3/DSC03331.JPG,char_data/F/DSC03331.JPG_2.jpg,1568,480,640,28,99,127,376,432,True,17
F,33,kaist_dataset/Mixed/Digital_Camera/(C.S)C-outdoor4/DSC03446.JPG,char_data/F/DSC03446.JPG_2.jpg,924,480,640,28,96,124,287,320,True,17
F,44,kaist_dataset/Mixed/Digital_Camera/(C.S)C-outdoor4/DSC03618.JPG,char_data/F/DSC03618.JPG_2.jpg,1276,480,640,29,600,629,412,456,True,17
F,27,kaist_dataset/Mixed/Digital_Camera/(C.S)C-outdoor4/DSC03670.JPG,char_data/F/DSC03670.JPG_2.jpg,621,480,640,23,305,328,321,348,True,17
F,30,kaist_dataset/Mixed/Digital_Camera/(C.S)C-outdoor4/DSC03691.JPG,char_data/F/DSC03691.JPG_2.jpg,420,480,640,14,507,521,221,251,True,17
F,31,kaist_dataset/Mixed/Digital_Camera/(C.S)C-outdoor4/DSC03693.JPG,char_data/F/DSC03693.JPG_2.jpg,589,480,640,19,602,621,358,389,True,17
F,50,kaist_dataset/Mixed/Digital_Camera/(C.S)C-outdoor4/DSC03702.JPG,char_data/F/DSC03702.JPG_2.jpg,1700,480,640,34,530,564,353,403,True,17
F,48,kaist_dataset/Mixed/Digital_Camera/(C.S)C-outdoor4/DSC03707.JPG,char_data/F/DSC03707.JPG_2.jpg,1488,480,640,31,327,358,88,136,True,17
F,90,kaist_dataset/Mixed/Digital_Camera/(C.S)C-outdoor4/DSC03711.JPG,char_data/F/DSC03711.JPG_2.jpg,4680,480,640,52,526,578,96,186,True,17
F,43,kaist_dataset/Mixed/Digital_Camera/(C.S)C-outdoor4/DSC03718.JPG,char_data/F/DSC03718.JPG_2.jpg,817,480,640,19,147,166,248,291,True,17
F,37,kaist_dataset/Mixed/Digital_Camera/(C.S)C-outdoor4/DSC03719.JPG,char_data/F/DSC03719.JPG_2.jpg,703,480,640,19,154,173,27,64,True,17
F,36,kaist_dataset/Mixed/Digital_Camera/(C.S)C-outdoor4/DSC03730.JPG,char_data/F/DSC03730.JPG_2.jpg,648,480,640,18,552,570,246,282,True,17
F,38,kaist_dataset/Mixed/Digital_Camera/(C.S)C-outdoor4/DSC03732.JPG,char_data/F/DSC03732.JPG_2.jpg,1026,480,640,27,584,611,390,428,True,17
F,27,kaist_dataset/Mixed/Digital_Camera/(C.S)C-outdoor4/DSC03737.JPG,char_data/F/DSC03737.JPG_2.jpg,594,480,640,22,565,587,174,201,True,17
F,49,kaist_dataset/Mixed/Digital_Camera/(C.S)C-outdoor4/DSC03738.JPG,char_data/F/DSC03738.JPG_2.jpg,1911,480,640,39,130,169,232,281,True,17
F,36,kaist_dataset/Mixed/Digital_Camera/(C.S)C-outdoor4/DSC03764.JPG,char_data/F/DSC03764.JPG_4.jpg,720,480,640,20,183,203,232,268,True,17
F,34,kaist_dataset/Mixed/Digital_Camera/(C.S)C-outdoor4/DSC03764.JPG,char_data/F/DSC03764.JPG_5.jpg,714,480,640,21,203,224,233,267,True,17
F,66,kaist_dataset/Mixed/Digital_Camera/(C.S)C-outdoor5/DSC03821.JPG,char_data/F/DSC03821.JPG_4.jpg,3234,480,640,49,568,617,170,236,True,17
F,69,kaist_dataset/Mixed/Digital_Camera/(C.S)C-outdoor5/DSC03824.JPG,char_data/F/DSC03824.JPG_2.jpg,3243,480,640,47,555,602,127,196,True,17
F,22,kaist_dataset/Mixed/Digital_Camera/(C.S)C-outdoor5/DSC04031.JPG,char_data/F/DSC04031.JPG_2.jpg,286,480,640,13,420,433,383,405,True,17
F,42,kaist_dataset/Mixed/Digital_Camera/(C.S)C-outdoor5/DSC04055.JPG,char_data/F/DSC04055.JPG_4.jpg,1428,480,640,34,575,609,371,413,True,17
F,45,kaist_dataset/Mixed/Digital_Camera/(C.S)C-outdoor5/DSC04055.JPG,char_data/F/DSC04055.JPG_5.jpg,1440,480,640,32,328,360,183,228,True,17
F,47,kaist_dataset/Mixed/Digital_Camera/(C.S)C-outdoor5/DSC04057.JPG,char_data/F/DSC04057.JPG_8.jpg,1504,480,640,32,534,566,320,367,True,17
F,63,kaist_dataset/Mixed/Digital_Camera/(C.S)C-outdoor5/DSC04060.JPG,char_data/F/DSC04060.JPG_2.jpg,2079,480,640,33,149,182,180,243,True,17
F,35,kaist_dataset/Mixed/Digital_Camera/(C.S)C-outdoor5/DSC04071.JPG,char_data/F/DSC04071.JPG_2.jpg,840,480,640,24,379,403,367,402,True,17
F,95,kaist_dataset/Mixed/Digital_Camera/(C.S)C-outdoor5/DSC04115.JPG,char_data/F/DSC04115.JPG_2.jpg,5510,480,640,58,73,131,190,285,True,17
F,58,kaist_dataset/Mixed/Digital_Camera/(C.S)C-outdoor5/DSC04349.JPG,char_data/F/DSC04349.JPG_4.jpg,1508,480,640,26,383,409,302,360,True,17
F,59,kaist_dataset/Mixed/Digital_Camera/(C.S)C-outdoor5/DSC04349.JPG,char_data/F/DSC04349.JPG_5.jpg,1239,480,640,21,408,429,301,360,True,17
F,60,kaist_dataset/Mixed/Digital_Camera/(C.S)C-outdoor5/DSC04447.JPG,char_data/F/DSC04447.JPG_2.jpg,2100,480,640,35,196,231,349,409,True,17
F,160,kaist_dataset/Mixed/Digital_Camera/(C.S)C-outdoor5/DSC04451.JPG,char_data/F/DSC04451.JPG_4.jpg,12800,480,640,80,441,521,287,447,True,17
F,156,kaist_dataset/Mixed/Digital_Camera/(C.S)C-outdoor5/DSC04451.JPG,char_data/F/DSC04451.JPG_5.jpg,14976,480,640,96,516,612,284,440,True,17
F,52,kaist_dataset/Mixed/Digital_Camera/(C.S)C-outdoor5/DSC04461.JPG,char_data/F/DSC04461.JPG_2.jpg,2860,480,640,55,386,441,351,403,True,17
F,100,kaist_dataset/Mixed/Digital_Camera/(C.S)C-outdoor5/DSC04465.JPG,char_data/F/DSC04465.JPG_2.jpg,5100,480,640,51,468,519,287,387,False,17
F,24,kaist_dataset/Mixed/Digital_Camera/(C.S)C-outdoor6/117.JPG,char_data/F/117.JPG_2.jpg,408,480,640,17,404,421,266,290,False,17
F,37,kaist_dataset/Mixed/Digital_Camera/(C.S)C-outdoor6/P1010018.JPG,char_data/F/P1010018.JPG_2.jpg,1147,480,640,31,363,394,242,279,False,17
F,40,kaist_dataset/Mixed/Digital_Camera/(C.S)C-outdoor6/P1010021.JPG,char_data/F/P1010021.JPG_2.jpg,1240,480,640,31,469,500,204,244,False,17
F,46,kaist_dataset/Mixed/Digital_Camera/(C.S)C-outdoor6/P1010027.JPG,char_data/F/P1010027.JPG_2.jpg,1518,480,640,33,530,563,328,374,False,17
F,50,kaist_dataset/Mixed/Digital_Camera/(C.S)C-outdoor6/P1010030.JPG,char_data/F/P1010030.JPG_2.jpg,2000,480,640,40,90,130,408,458,False,17
F,66,kaist_dataset/Mixed/Digital_Camera/(C.S)C-outdoor6/P1010054.JPG,char_data/F/P1010054.JPG_2.jpg,2970,480,640,45,432,477,371,437,False,17
F,82,kaist_dataset/Mixed/Digital_Camera/(C.S)C-outdoor6/P1010055.JPG,char_data/F/P1010055.JPG_2.jpg,4428,480,640,54,479,533,262,344,False,17
F,33,kaist_dataset/Mixed/Digital_Camera/(C.S)C-outdoor6/P1010062.JPG,char_data/F/P1010062.JPG_2.jpg,792,480,640,24,597,621,256,289,False,17
F,20,kaist_dataset/Mixed/Digital_Camera/(C.S)C-outdoor6/P1010063.JPG,char_data/F/P1010063.JPG_8.jpg,220,480,640,11,450,461,342,362,False,17
F,20,kaist_dataset/Mixed/Digital_Camera/(C.S)C-outdoor6/P1010063.JPG,char_data/F/P1010063.JPG_9.jpg,180,480,640,9,460,469,340,360,False,17
F,51,kaist_dataset/Mixed/Digital_Camera/(C.S)C-outdoor6/P1010063.JPG,char_data/F/P1010063.JPG_10.jpg,1428,480,640,28,349,377,318,369,False,17
F,52,kaist_dataset/Mixed/Digital_Camera/(C.S)C-outdoor6/P1010063.JPG,char_data/F/P1010063.JPG_11.jpg,1820,480,640,35,376,411,304,356,False,17
F,23,kaist_dataset/Mixed/Digital_Camera/(C.S)C-outdoor6/P1010096.JPG,char_data/F/P1010096.JPG_2.jpg,345,480,640,15,449,464,207,230,False,17
F,32,kaist_dataset/Mixed/Digital_Camera/(C.S)C-outdoor6/P1010111.JPG,char_data/F/P1010111.JPG_2.jpg,832,480,640,26,342,368,342,374,False,17
F,26,kaist_dataset/Mixed/Digital_Camera/(C.S)C-outdoor6/P1010114.JPG,char_data/F/P1010114.JPG_2.jpg,442,480,640,17,294,311,219,245,False,17
F,44,kaist_dataset/Mixed/Digital_Camera/(C.S)C-outdoor6/P1010127.JPG,char_data/F/P1010127.JPG_2.jpg,1276,480,640,29,484,513,289,333,False,17
F,35,kaist_dataset/Mixed/Digital_Camera/(C.S)C-outdoor6/P1010129.JPG,char_data/F/P1010129.JPG_2.jpg,805,480,640,23,576,599,230,265,False,17
F,37,kaist_dataset/Mixed/Digital_Camera/(C.S)C-outdoor6/P1010132.JPG,char_data/F/P1010132.JPG_4.jpg,925,480,640,25,505,530,90,127,False,17
F,30,kaist_dataset/Mixed/Digital_Camera/(C.S)C-outdoor6/P1010137.JPG,char_data/F/P1010137.JPG_2.jpg,600,480,640,20,525,545,179,209,False,17
F,39,kaist_dataset/Mixed/Digital_Camera/(C.S)C-outdoor6/크기변환_20040626112330924_im_orz6564_netdkwk.jpg,char_data/F/크기변환_20040626112330924_im_orz6564_netdkwk.jpg_2.jpg,1365,480,640,35,424,459,368,407,False,17
F,30,kaist_dataset/Mixed/Digital_Camera/(C.S)C-outdoor6/크기변환_P1010029.JPG,char_data/F/크기변환_P1010029.JPG_2.jpg,570,480,640,19,251,270,14,44,False,17
F,167,kaist_dataset/Mixed/Digital_Camera/(C.S)D-indoor1/DSC02724.JPG,char_data/F/DSC02724.JPG_2.jpg,17702,480,640,106,308,414,225,392,False,17
F,162,kaist_dataset/Mixed/Digital_Camera/(C.S)D-indoor1/DSC02726.JPG,char_data/F/DSC02726.JPG_2.jpg,25596,480,640,158,337,495,35,197,False,17
F,40,kaist_dataset/Mixed/Digital_Camera/(C.S)D-indoor1/DSC02804.JPG,char_data/F/DSC02804.JPG_2.jpg,840,480,640,21,363,384,350,390,False,17
F,48,kaist_dataset/Mixed/Digital_Camera/(C.S)D-indoor1/DSC03372.JPG,char_data/F/DSC03372.JPG_2.jpg,1536,480,640,32,31,63,404,452,False,17
F,64,kaist_dataset/Mixed/Digital_Camera/(C.S)D-indoor1/DSC03478.JPG,char_data/F/DSC03478.JPG_2.jpg,2880,480,640,45,165,210,125,189,False,17
F,29,kaist_dataset/Mixed/Digital_Camera/(C.S)D-indoor1/DSC03959.JPG,char_data/F/DSC03959.JPG_4.jpg,638,480,640,22,300,322,187,216,False,17
F,31,kaist_dataset/Mixed/Digital_Camera/(C.S)D-indoor1/DSC03959.JPG,char_data/F/DSC03959.JPG_5.jpg,806,480,640,26,322,348,191,222,False,17
F,64,kaist_dataset/Mixed/Digital_Camera/(C.S)D-indoor1/DSC03999.JPG,char_data/F/DSC03999.JPG_2.jpg,2496,480,640,39,544,583,286,350,False,17
F,51,kaist_dataset/Mixed/Digital_Camera/(C.S)D-indoor1/DSC04002.JPG,char_data/F/DSC04002.JPG_2.jpg,2244,480,640,44,42,86,312,363,False,17
F,100,kaist_dataset/Mixed/Digital_Camera/(C.S)D-indoor1/DSC04003.JPG,char_data/F/DSC04003.JPG_2.jpg,7700,480,640,77,331,408,82,182,False,17
F,67,kaist_dataset/Mixed/Digital_Camera/(C.S)D-indoor2/DSC04409.JPG,char_data/F/DSC04409.JPG_2.jpg,1608,480,640,24,523,547,156,223,False,17
F,47,kaist_dataset/Mixed/Digital_Camera/(C.S)D-indoor2/DSC04421.JPG,char_data/F/DSC04421.JPG_2.jpg,1081,480,640,23,594,617,215,262,False,17
F,65,kaist_dataset/Mixed/Digital_Camera/(C.S)D-indoor2/DSC04463.JPG,char_data/F/DSC04463.JPG_2.jpg,4355,480,640,67,552,619,36,101,False,17
F,47,kaist_dataset/Mixed/Digital_Camera/(C.S)E-night/DSC02575.JPG,char_data/F/DSC02575.JPG_2.jpg,1833,480,640,39,565,604,367,414,False,17
F,33,kaist_dataset/Mixed/Digital_Camera/(C.S)E-night/DSC02623.JPG,char_data/F/DSC02623.JPG_2.jpg,1023,480,640,31,604,635,407,440,False,17
F,48,kaist_dataset/Mixed/Digital_Camera/(C.S)E-night/DSC02672.JPG,char_data/F/DSC02672.JPG_2.jpg,768,480,640,16,317,333,170,218,False,17
F,31,kaist_dataset/Mixed/Digital_Camera/(C.S)E-night/DSC02673.JPG,char_data/F/DSC02673.JPG_2.jpg,558,480,640,18,405,423,305,336,False,17
F,38,kaist_dataset/Mixed/Digital_Camera/(C.S)E-night/DSC03031.JPG,char_data/F/DSC03031.JPG_2.jpg,684,480,640,18,104,122,18,56,False,17
F,38,kaist_dataset/Mixed/Digital_Camera/(C.S)F-others/DSC02504.JPG,char_data/F/DSC02504.JPG_2.jpg,1292,480,640,34,519,553,389,427,False,17
F,90,kaist_dataset/Mixed/Digital_Camera/(C.S)F-others/DSC03224.JPG,char_data/F/DSC03224.JPG_2.jpg,5760,480,640,64,258,322,333,423,False,17
F,78,kaist_dataset/Mixed/Mobile_Phone/(C.M)A-outdoor/P090912062.jpg,char_data/F/P090912062.jpg_4.jpg,3900,480,640,50,55,105,2,80,False,17
F,53,kaist_dataset/Mixed/Mobile_Phone/(C.M)A-outdoor/P090912066.jpg,char_data/F/P090912066.jpg_2.jpg,1325,480,640,25,454,479,214,267,False,17
F,30,kaist_dataset/Mixed/Mobile_Phone/(C.M)A-outdoor/P090912068.jpg,char_data/F/P090912068.jpg_2.jpg,900,480,640,30,416,446,130,160,False,17
F,47,kaist_dataset/Mixed/Mobile_Phone/(C.M)B-indoor/P090831021.jpg,char_data/F/P090831021.jpg_2.jpg,1739,480,640,37,234,271,330,377,False,17
지,26,kaist_dataset/English/Digital_Camera/(E.S)B-light/080116-0059.jpg,char_data/지/080116-0059.jpg_12.jpg,468,1200,1600,18,1141,1159,941,967,True,82
지,33,kaist_dataset/English/Digital_Camera/(E.S)B-light/080116-0059.jpg,char_data/지/080116-0059.jpg_13.jpg,759,1200,1600,23,614,637,1080,1113,True,82
지,34,kaist_dataset/English/Digital_Camera/(E.S)B-light/080116-0059.jpg,char_data/지/080116-0059.jpg_14.jpg,646,1200,1600,19,724,743,1076,1110,True,82
지,37,kaist_dataset/English/Digital_Camera/(E.S)B-light/080116-0059.jpg,char_data/지/080116-0059.jpg_15.jpg,740,1200,1600,20,948,968,1065,1102,True,82
지,40,kaist_dataset/English/Digital_Camera/(E.S)B-light/080116-0059.jpg,char_data/지/080116-0059.jpg_16.jpg,800,1200,1600,20,570,590,1140,1180,True,82
지,26,kaist_dataset/English/Digital_Camera/(E.S)B-light/080116-0059.jpg,char_data/지/080116-0059.jpg_17.jpg,442,1200,1600,17,943,960,1028,1054,True,82
지,156,kaist_dataset/Korean/Digital_Camera/A-shadow/DSC02667.JPG,char_data/지/DSC02667.JPG_2.jpg,15288,480,640,98,135,233,253,409,True,82
지,88,kaist_dataset/Korean/Digital_Camera/A-shadow/DSC03438.JPG,char_data/지/DSC03438.JPG_2.jpg,6424,480,640,73,305,378,363,451,True,82
지,33,kaist_dataset/Korean/Digital_Camera/A-shadow/DSC03462.JPG,char_data/지/DSC03462.JPG_2.jpg,924,480,640,28,249,277,51,84,True,82
지,59,kaist_dataset/Korean/Digital_Camera/A-shadow/DSC03755.JPG,char_data/지/DSC03755.JPG_2.jpg,2773,480,640,47,484,531,125,184,True,82
지,76,kaist_dataset/Korean/Digital_Camera/A-shadow/DSC04320.JPG,char_data/지/DSC04320.JPG_2.jpg,3040,480,640,40,166,206,393,469,True,82
지,92,kaist_dataset/Korean/Digital_Camera/A-shadow/P090911055.jpg,char_data/지/P090911055.jpg_2.jpg,8832,480,640,96,241,337,214,306,True,82
지,60,kaist_dataset/Korean/Digital_Camera/A-shadow/P1010064.JPG,char_data/지/P1010064.JPG_6.jpg,3000,480,640,50,167,217,133,193,True,82
지,56,kaist_dataset/Korean/Digital_Camera/A-shadow/P1010064.JPG,char_data/지/P1010064.JPG_7.jpg,2520,480,640,45,279,324,284,340,True,82
지,43,kaist_dataset/Korean/Digital_Camera/A-shadow/P1010064.JPG,char_data/지/P1010064.JPG_8.jpg,1333,480,640,31,358,389,407,450,True,82
지,23,kaist_dataset/Korean/Digital_Camera/E-night/DSC02648.JPG,char_data/지/DSC02648.JPG_2.jpg,874,480,640,38,410,448,383,406,True,82
지,55,kaist_dataset/Korean/Digital_Camera/E-night/DSC03849.JPG,char_data/지/DSC03849.JPG_2.jpg,2970,480,640,54,333,387,369,424,True,82
지,77,kaist_dataset/Korean/Digital_Camera/F-bookCover/DSC02812.JPG,char_data/지/DSC02812.JPG_2.jpg,5621,480,640,73,167,240,38,115,True,82
지,64,kaist_dataset/Korean/Digital_Camera/F-bookCover/DSC02813.JPG,char_data/지/DSC02813.JPG_2.jpg,4416,480,640,69,136,205,44,108,True,82
지,71,kaist_dataset/Korean/Digital_Camera/F-bookCover/DSC02814.JPG,char_data/지/DSC02814.JPG_2.jpg,4828,480,640,68,160,228,36,107,True,82
지,51,kaist_dataset/Korean/Digital_Camera/F-bookCover/DSC02815.JPG,char_data/지/DSC02815.JPG_2.jpg,2703,480,640,53,174,227,55,106,True,82
지,125,kaist_dataset/Korean/Digital_Camera/F-bookCover/DSC03929.JPG,char_data/지/DSC03929.JPG_2.jpg,13000,480,640,104,506,610,203,328,True,82
지,57,kaist_dataset/Korean/Digital_Camera/F-bookCover/DSC04228.JPG,char_data/지/DSC04228.JPG_2.jpg,1482,480,640,26,92,118,113,170,True,82
지,132,kaist_dataset/Korean/Digital_Camera/F-bookCover/DSC04229.JPG,char_data/지/DSC04229.JPG_2.jpg,13068,480,640,99,474,573,164,296,True,82
지,53,kaist_dataset/Korean/Digital_Camera/G-others/2007-12-08-day-112.jpg,char_data/지/2007-12-08-day-112.jpg_2.jpg,1908,1200,1600,36,140,176,1044,1097,True,82
지,192,kaist_dataset/Korean/Digital_Camera/G-others/2007-12-09-day-exterior-028.jpg,char_data/지/2007-12-09-day-exterior-028.jpg_2.jpg,58560,1600,1200,305,484,789,965,1157,True,82
지,53,kaist_dataset/Korean/Digital_Camera/G-others/DSC03065.JPG,char_data/지/DSC03065.JPG_2.jpg,3710,480,640,70,248,318,409,462,True,82
지,42,kaist_dataset/Korean/Digital_Camera/indoor1/057.jpg,char_data/지/057.jpg_2.jpg,1638,322,425,39,209,248,36,78,True,82
지,69,kaist_dataset/Korean/Digital_Camera/indoor1/094.jpg,char_data/지/094.jpg_2.jpg,8280,480,640,120,442,562,83,152,True,82
지,93,kaist_dataset/Korean/Digital_Camera/indoor1/DSC02704.JPG,char_data/지/DSC02704.JPG_2.jpg,7068,480,640,76,330,406,217,310,True,82
지,77,kaist_dataset/Korean/Digital_Camera/indoor1/DSC02728.JPG,char_data/지/DSC02728.JPG_2.jpg,5621,480,640,73,147,220,173,250,True,82
지,69,kaist_dataset/Korean/Digital_Camera/indoor1/DSC02745.JPG,char_data/지/DSC02745.JPG_2.jpg,7590,480,640,110,324,434,272,341,True,82
지,89,kaist_dataset/Korean/Digital_Camera/indoor1/DSC02758.JPG,char_data/지/DSC02758.JPG_2.jpg,18156,480,640,204,343,547,186,275,True,82
지,57,kaist_dataset/Korean/Digital_Camera/indoor1/DSC03379.JPG,char_data/지/DSC03379.JPG_2.jpg,3819,480,640,67,202,269,275,332,True,82
지,94,kaist_dataset/Korean/Digital_Camera/indoor2/DSC03385.JPG,char_data/지/DSC03385.JPG_2.jpg,7332,480,640,78,182,260,302,396,True,82
지,115,kaist_dataset/Korean/Digital_Camera/indoor2/DSC03480.JPG,char_data/지/DSC03480.JPG_2.jpg,9775,480,640,85,131,216,328,443,True,82
지,78,kaist_dataset/Korean/Digital_Camera/indoor2/DSC03497.JPG,char_data/지/DSC03497.JPG_2.jpg,4680,480,640,60,249,309,84,162,True,82
지,117,kaist_dataset/Korean/Digital_Camera/indoor2/DSC03994.JPG,char_data/지/DSC03994.JPG_4.jpg,8190,480,640,70,124,194,143,260,True,82
지,56,kaist_dataset/Korean/Digital_Camera/indoor2/DSC03994.JPG,char_data/지/DSC03994.JPG_5.jpg,2128,480,640,38,161,199,275,331,True,82
지,49,kaist_dataset/Korean/Digital_Camera/indoor2/DSC03995.JPG,char_data/지/DSC03995.JPG_2.jpg,2009,480,640,41,65,106,271,320,True,82
지,66,kaist_dataset/Korean/Digital_Camera/indoor2/DSC04006.JPG,char_data/지/DSC04006.JPG_2.jpg,2376,480,640,36,405,441,156,222,True,82
지,80,kaist_dataset/Korean/Digital_Camera/indoor2/DSC04175.JPG,char_data/지/DSC04175.JPG_2.jpg,3760,480,640,47,251,298,369,449,True,82
지,51,kaist_dataset/Korean/Digital_Camera/indoor2/DSC04204.JPG,char_data/지/DSC04204.JPG_2.jpg,1938,480,640,38,242,280,275,326,True,82
지,71,kaist_dataset/Korean/Digital_Camera/indoor2/DSC04243.JPG,char_data/지/DSC04243.JPG_2.jpg,4757,480,640,67,499,566,287,358,True,82
지,107,kaist_dataset/Korean/Digital_Camera/indoor2/DSC04253.JPG,char_data/지/DSC04253.JPG_2.jpg,4815,480,640,45,406,451,92,199,True,82
지,60,kaist_dataset/Korean/Digital_Camera/outdoor1/018.JPG,char_data/지/018.JPG_2.jpg,3780,480,640,63,447,510,203,263,True,82
지,70,kaist_dataset/Korean/Digital_Camera/outdoor1/019.JPG,char_data/지/019.JPG_2.jpg,10360,480,640,148,319,467,176,246,True,82
지,30,kaist_dataset/Korean/Digital_Camera/outdoor1/045.JPG,char_data/지/045.JPG_2.jpg,750,480,640,25,425,450,261,291,True,82
지,24,kaist_dataset/Korean/Digital_Camera/outdoor1/102.JPG,char_data/지/102.JPG_2.jpg,528,480,640,22,533,555,314,338,True,82
지,33,kaist_dataset/Korean/Digital_Camera/outdoor1/109.JPG,char_data/지/109.JPG_2.jpg,1122,480,640,34,323,357,108,141,True,82
지,76,kaist_dataset/Korean/Digital_Camera/outdoor1/2007-12-08-day-056.jpg,char_data/지/2007-12-08-day-056.jpg_2.jpg,5548,1200,1600,73,892,965,785,861,True,82
지,57,kaist_dataset/Korean/Digital_Camera/outdoor1/2007-12-08-day-057.jpg,char_data/지/2007-12-08-day-057.jpg_4.jpg,2565,1200,1600,45,37,82,704,761,True,82
지,24,kaist_dataset/Korean/Digital_Camera/outdoor1/2007-12-08-day-057.jpg,char_data/지/2007-12-08-day-057.jpg_5.jpg,1272,1200,1600,53,636,689,1003,1027,True,82
지,77,kaist_dataset/Korean/Digital_Camera/outdoor1/2007-12-08-day-065.jpg,char_data/지/2007-12-08-day-065.jpg_2.jpg,5544,1600,1200,72,722,794,1241,1318,True,82
지,103,kaist_dataset/Korean/Digital_Camera/outdoor1/53.JPG,char_data/지/53.JPG_4.jpg,8961,401,766,87,168,255,49,152,True,82
지,46,kaist_dataset/Korean/Digital_Camera/outdoor1/53.JPG,char_data/지/53.JPG_5.jpg,1150,401,766,25,662,687,285,331,True,82
지,151,kaist_dataset/Korean/Digital_Camera/outdoor2/080118-0018.jpg,char_data/지/080118-0018.jpg_2.jpg,15402,1200,1600,102,371,473,938,1089,True,82
지,82,kaist_dataset/Korean/Digital_Camera/outdoor2/2007-12-08-day-129.jpg,char_data/지/2007-12-08-day-129.jpg_2.jpg,5822,1200,1600,71,892,963,672,754,True,82
지,52,kaist_dataset/Korean/Digital_Camera/outdoor2/DSC02305.JPG,char_data/지/DSC02305.JPG_2.jpg,3796,480,640,73,26,99,242,294,True,82
지,31,kaist_dataset/Korean/Digital_Camera/outdoor2/DSC02326.JPG,char_data/지/DSC02326.JPG_2.jpg,868,480,640,28,109,137,329,360,True,82
지,66,kaist_dataset/Korean/Digital_Camera/outdoor2/DSC02388.JPG,char_data/지/DSC02388.JPG_2.jpg,5412,480,640,82,43,125,373,439,True,82
지,120,kaist_dataset/Korean/Digital_Camera/outdoor2/DSC02486.JPG,char_data/지/DSC02486.JPG_2.jpg,5400,480,640,45,411,456,230,350,True,82
지,71,kaist_dataset/Korean/Digital_Camera/outdoor2/DSC02498.JPG,char_data/지/DSC02498.JPG_2.jpg,4828,480,640,68,198,266,347,418,True,82
지,103,kaist_dataset/Korean/Digital_Camera/outdoor2/DSC02507.JPG,char_data/지/DSC02507.JPG_2.jpg,11330,480,640,110,468,578,106,209,True,82
지,47,kaist_dataset/Korean/Digital_Camera/outdoor2/DSC02512.JPG,char_data/지/DSC02512.JPG_2.jpg,2726,480,640,58,260,318,231,278,True,82
지,125,kaist_dataset/Korean/Digital_Camera/outdoor2/DSC02520.JPG,char_data/지/DSC02520.JPG_2.jpg,13625,480,640,109,496,605,148,273,True,82
지,74,kaist_dataset/Korean/Digital_Camera/outdoor3/DSC02939.JPG,char_data/지/DSC02939.JPG_2.jpg,6364,480,640,86,74,160,285,359,True,82
지,50,kaist_dataset/Korean/Digital_Camera/outdoor3/DSC02972.JPG,char_data/지/DSC02972.JPG_2.jpg,3050,480,640,61,132,193,30,80,True,82
지,92,kaist_dataset/Korean/Digital_Camera/outdoor3/DSC02975.JPG,char_data/지/DSC02975.JPG_4.jpg,5980,480,640,65,438,503,347,439,True,82
지,130,kaist_dataset/Korean/Digital_Camera/outdoor3/DSC02975.JPG,char_data/지/DSC02975.JPG_5.jpg,19240,480,640,148,192,340,102,232,True,82
지,64,kaist_dataset/Korean/Digital_Camera/outdoor3/DSC02999.JPG,char_data/지/DSC02999.JPG_2.jpg,4096,480,640,64,356,420,343,407,True,82
지,39,kaist_dataset/Korean/Digital_Camera/outdoor3/DSC03064.JPG,char_data/지/DSC03064.JPG_2.jpg,1443,480,640,37,250,287,238,277,True,82
지,113,kaist_dataset/Korean/Digital_Camera/outdoor3/DSC03180.JPG,char_data/지/DSC03180.JPG_2.jpg,10283,480,640,91,392,483,363,476,True,82
지,70,kaist_dataset/Korean/Digital_Camera/outdoor3/DSC03183.JPG,char_data/지/DSC03183.JPG_2.jpg,5740,480,640,82,466,548,336,406,True,82
지,48,kaist_dataset/Korean/Digital_Camera/outdoor3/DSC03220.JPG,char_data/지/DSC03220.JPG_2.jpg,2112,480,640,44,63,107,97,145,True,82
지,47,kaist_dataset/Korean/Digital_Camera/outdoor3/DSC03238.JPG,char_data/지/DSC03238.JPG_2.jpg,1598,480,640,34,331,365,288,335,True,82
지,72,kaist_dataset/Korean/Digital_Camera/outdoor3/DSC03240.JPG,char_data/지/DSC03240.JPG_2.jpg,4032,480,640,56,233,289,27,99,True,82
지,95,kaist_dataset/Korean/Digital_Camera/outdoor3/DSC03243.JPG,char_data/지/DSC03243.JPG_2.jpg,7885,480,640,83,436,519,303,398,True,82
지,30,kaist_dataset/Korean/Digital_Camera/outdoor4/DSC03319.JPG,char_data/지/DSC03319.JPG_2.jpg,1350,480,640,45,153,198,132,162,True,82
지,40,kaist_dataset/Korean/Digital_Camera/outdoor4/DSC03326.JPG,char_data/지/DSC03326.JPG_2.jpg,1000,480,640,25,550,575,219,259,True,82
지,66,kaist_dataset/Korean/Digital_Camera/outdoor4/DSC03442.JPG,char_data/지/DSC03442.JPG_2.jpg,3432,480,640,52,391,443,60,126,True,82
지,83,kaist_dataset/Korean/Digital_Camera/outdoor4/DSC03461.JPG,char_data/지/DSC03461.JPG_2.jpg,5810,480,640,70,434,504,167,250,True,82
지,66,kaist_dataset/Korean/Digital_Camera/outdoor4/DSC03505.JPG,char_data/지/DSC03505.JPG_2.jpg,4026,480,640,61,245,306,236,302,True,82
지,45,kaist_dataset/Korean/Digital_Camera/outdoor4/DSC03538.JPG,char_data/지/DSC03538.JPG_2.jpg,1080,480,640,24,242,266,116,161,True,82
지,100,kaist_dataset/Korean/Digital_Camera/outdoor4/DSC03546.JPG,char_data/지/DSC03546.JPG_2.jpg,11000,480,640,110,277,387,203,303,True,82
지,44,kaist_dataset/Korean/Digital_Camera/outdoor4/DSC03547.JPG,char_data/지/DSC03547.JPG_2.jpg,1628,480,640,37,441,478,164,208,True,82
지,37,kaist_dataset/Korean/Digital_Camera/outdoor4/DSC03576.JPG,char_data/지/DSC03576.JPG_2.jpg,1073,480,640,29,310,339,320,357,True,82
지,45,kaist_dataset/Korean/Digital_Camera/outdoor4/DSC03577.JPG,char_data/지/DSC03577.JPG_2.jpg,1890,480,640,42,288,330,282,327,True,82
지,49,kaist_dataset/Korean/Digital_Camera/outdoor4/DSC03578.JPG,char_data/지/DSC03578.JPG_2.jpg,1078,480,640,22,290,312,145,194,True,82
지,58,kaist_dataset/Korean/Digital_Camera/outdoor4/DSC03584.JPG,char_data/지/DSC03584.JPG_2.jpg,2958,480,640,51,369,420,170,228,True,82
지,63,kaist_dataset/Korean/Digital_Camera/outdoor4/DSC03605.JPG,char_data/지/DSC03605.JPG_2.jpg,3906,480,640,62,351,413,142,205,True,82
지,89,kaist_dataset/Korean/Digital_Camera/outdoor5/DSC03623.JPG,char_data/지/DSC03623.JPG_2.jpg,9434,480,640,106,440,546,231,320,True,82
지,121,kaist_dataset/Korean/Digital_Camera/outdoor5/DSC03625.JPG,char_data/지/DSC03625.JPG_2.jpg,5566,480,640,46,515,561,312,433,True,82
지,97,kaist_dataset/Korean/Digital_Camera/outdoor5/DSC03629.JPG,char_data/지/DSC03629.JPG_2.jpg,3298,480,640,34,564,598,55,152,True,82
지,43,kaist_dataset/Korean/Digital_Camera/outdoor5/DSC03632.JPG,char_data/지/DSC03632.JPG_4.jpg,2580,480,640,60,140,200,144,187,True,82
지,66,kaist_dataset/Korean/Digital_Camera/outdoor5/DSC03632.JPG,char_data/지/DSC03632.JPG_5.jpg,3168,480,640,48,238,286,179,245,True,82
지,56,kaist_dataset/Korean/Digital_Camera/outdoor5/DSC03653.JPG,char_data/지/DSC03653.JPG_2.jpg,1456,480,640,26,491,517,83,139,True,82
지,103,kaist_dataset/Korean/Digital_Camera/outdoor5/DSC03659.JPG,char_data/지/DSC03659.JPG_2.jpg,10094,480,640,98,406,504,124,227,True,82
지,36,kaist_dataset/Korean/Digital_Camera/outdoor5/DSC03669.JPG,char_data/지/DSC03669.JPG_2.jpg,1620,480,640,45,433,478,313,349,True,82
지,43,kaist_dataset/Korean/Digital_Camera/outdoor5/DSC03683.JPG,char_data/지/DSC03683.JPG_2.jpg,1161,480,640,27,473,500,240,283,True,82
지,118,kaist_dataset/Korean/Digital_Camera/outdoor5/DSC03713.JPG,char_data/지/DSC03713.JPG_2.jpg,10856,480,640,92,308,400,190,308,True,82
지,115,kaist_dataset/Korean/Digital_Camera/outdoor5/DSC03729.JPG,char_data/지/DSC03729.JPG_2.jpg,13110,480,640,114,156,270,272,387,True,82
지,152,kaist_dataset/Korean/Digital_Camera/outdoor5/DSC03746.JPG,char_data/지/DSC03746.JPG_4.jpg,19760,480,640,130,460,590,147,299,True,82
지,70,kaist_dataset/Korean/Digital_Camera/outdoor5/DSC03746.JPG,char_data/지/DSC03746.JPG_5.jpg,5530,480,640,79,178,257,325,395,True,82
지,40,kaist_dataset/Korean/Digital_Camera/outdoor5/DSC03766.JPG,char_data/지/DSC03766.JPG_2.jpg,2320,480,640,58,479,537,95,135,True,82
지,35,kaist_dataset/Korean/Digital_Camera/outdoor5/DSC03768.JPG,char_data/지/DSC03768.JPG_2.jpg,1330,480,640,38,74,112,238,273,True,82
지,70,kaist_dataset/Korean/Digital_Camera/outdoor5/DSC03774.JPG,char_data/지/DSC03774.JPG_2.jpg,6020,480,640,86,7,93,52,122,True,82
지,87,kaist_dataset/Korean/Digital_Camera/outdoor5/DSC03789.JPG,char_data/지/DSC03789.JPG_2.jpg,5133,480,640,59,325,384,1,87,True,82
지,57,kaist_dataset/Korean/Digital_Camera/outdoor5/DSC03791.JPG,char_data/지/DSC03791.JPG_2.jpg,2793,480,640,49,403,452,86,143,True,82
지,46,kaist_dataset/Korean/Digital_Camera/outdoor5/DSC03832.JPG,char_data/지/DSC03832.JPG_2.jpg,2484,480,640,54,305,359,93,139,True,82
지,109,kaist_dataset/Korean/Digital_Camera/outdoor5/DSC03857.JPG,char_data/지/DSC03857.JPG_2.jpg,8175,480,640,75,372,447,285,394,True,82
지,109,kaist_dataset/Korean/Digital_Camera/outdoor5/DSC03864.JPG,char_data/지/DSC03864.JPG_2.jpg,7521,480,640,69,530,599,48,157,True,82
지,65,kaist_dataset/Korean/Digital_Camera/outdoor5/DSC03993.JPG,char_data/지/DSC03993.JPG_2.jpg,3055,480,640,47,333,380,118,183,True,82
지,80,kaist_dataset/Korean/Digital_Camera/outdoor5/DSC03997.JPG,char_data/지/DSC03997.JPG_2.jpg,5680,480,640,71,418,489,228,308,True,82
지,22,kaist_dataset/Korean/Digital_Camera/outdoor5/DSC04028.JPG,char_data/지/DSC04028.JPG_2.jpg,616,480,640,28,493,521,345,367,True,82
지,53,kaist_dataset/Korean/Digital_Camera/outdoor6/DSC04043.JPG,char_data/지/DSC04043.JPG_2.jpg,1060,480,640,20,320,340,219,272,True,82
지,78,kaist_dataset/Korean/Digital_Camera/outdoor6/DSC04083.JPG,char_data/지/DSC04083.JPG_2.jpg,5928,480,640,76,550,626,166,244,True,82
지,45,kaist_dataset/Korean/Digital_Camera/outdoor6/DSC04099.JPG,char_data/지/DSC04099.JPG_2.jpg,2070,480,640,46,56,102,409,454,True,82
지,61,kaist_dataset/Korean/Digital_Camera/outdoor6/DSC04110.JPG,char_data/지/DSC04110.JPG_2.jpg,2989,480,640,49,246,295,165,226,True,82
지,73,kaist_dataset/Korean/Digital_Camera/outdoor6/DSC04113.JPG,char_data/지/DSC04113.JPG_2.jpg,6059,480,640,83,162,245,365,438,True,82
지,73,kaist_dataset/Korean/Digital_Camera/outdoor6/DSC04147.JPG,char_data/지/DSC04147.JPG_2.jpg,4526,480,640,62,336,398,90,163,True,82
지,46,kaist_dataset/Korean/Digital_Camera/outdoor6/DSC04156.JPG,char_data/지/DSC04156.JPG_2.jpg,2024,480,640,44,80,124,47,93,True,82
지,57,kaist_dataset/Korean/Digital_Camera/outdoor6/DSC04398.JPG,char_data/지/DSC04398.JPG_2.jpg,2223,480,640,39,273,312,376,433,True,82
지,96,kaist_dataset/Korean/Digital_Camera/outdoor6/DSC04440.JPG,char_data/지/DSC04440.JPG_2.jpg,7008,480,640,73,433,506,42,138,True,82
지,93,kaist_dataset/Korean/Digital_Camera/outdoor7/DSC04454.JPG,char_data/지/DSC04454.JPG_2.jpg,5766,480,640,62,166,228,86,179,True,82
지,42,kaist_dataset/Korean/Digital_Camera/outdoor7/P1010003.JPG,char_data/지/P1010003.JPG_2.jpg,1806,480,640,43,338,381,92,134,True,82
지,34,kaist_dataset/Korean/Digital_Camera/outdoor7/P1010016.JPG,char_data/지/P1010016.JPG_2.jpg,1088,480,640,32,538,570,116,150,True,82
지,83,kaist_dataset/Korean/Digital_Camera/outdoor7/P1010020.JPG,char_data/지/P1010020.JPG_2.jpg,6972,480,640,84,217,301,207,290,True,82
지,57,kaist_dataset/Korean/Digital_Camera/outdoor7/P1010047.JPG,char_data/지/P1010047.JPG_4.jpg,3306,480,640,58,394,452,121,178,True,82
지,59,kaist_dataset/Korean/Digital_Camera/outdoor7/P1010047.JPG,char_data/지/P1010047.JPG_5.jpg,3127,480,640,53,328,381,193,252,True,82
지,58,kaist_dataset/Korean/Digital_Camera/outdoor7/P1010065.JPG,char_data/지/P1010065.JPG_2.jpg,4408,480,640,76,307,383,249,307,True,82
지,35,kaist_dataset/Korean/Digital_Camera/outdoor7/P1010067.JPG,char_data/지/P1010067.JPG_4.jpg,1260,480,640,36,425,461,314,349,True,82
지,70,kaist_dataset/Korean/Digital_Camera/outdoor7/P1010068.JPG,char_data/지/P1010068.JPG_2.jpg,4060,480,640,58,37,95,268,338,True,82
지,36,kaist_dataset/Korean/Digital_Camera/outdoor7/P1010069.JPG,char_data/지/P1010069.JPG_2.jpg,1116,480,640,31,484,515,319,355,True,82
지,50,kaist_dataset/Korean/Digital_Camera/outdoor7/P1010077.JPG,char_data/지/P1010077.JPG_2.jpg,1950,480,640,39,299,338,310,360,True,82
지,46,kaist_dataset/Korean/Digital_Camera/outdoor7/P1010085.JPG,char_data/지/P1010085.JPG_2.jpg,1426,480,640,31,472,503,60,106,True,82
지,46,kaist_dataset/Korean/Digital_Camera/outdoor7/P1010111.JPG,char_data/지/P1010111.JPG_2.jpg,1472,480,640,32,59,91,217,263,True,82
지,30,kaist_dataset/Korean/Digital_Camera/outdoor7/P1010136.JPG,char_data/지/P1010136.JPG_2.jpg,660,480,640,22,395,417,264,294,True,82
지,27,kaist_dataset/Korean/Digital_Camera/outdoor8/P1010170.JPG,char_data/지/P1010170.JPG_2.jpg,891,480,640,33,530,563,273,300,True,82
지,31,"kaist_dataset/Korean/Mobile_Phone/(M,K)A-shadow/P090912067.jpg",char_data/지/P090912067.jpg_2.jpg,1209,480,640,39,402,441,401,432,True,82
지,42,"kaist_dataset/Korean/Mobile_Phone/(M,K)E-bookCover/P090831031.jpg",char_data/지/P090831031.jpg_2.jpg,1512,480,640,36,369,405,303,345,True,82
지,43,"kaist_dataset/Korean/Mobile_Phone/(M,K)E-bookCover/P090831033.jpg",char_data/지/P090831033.jpg_2.jpg,1376,480,640,32,326,358,407,450,True,82
지,43,"kaist_dataset/Korean/Mobile_Phone/(M,K)E-bookCover/P090831034.jpg",char_data/지/P090831034.jpg_4.jpg,1376,480,640,32,327,359,341,384,True,82
지,70,"kaist_dataset/Korean/Mobile_Phone/(M,K)E-bookCover/P090831034.jpg",char_data/지/P090831034.jpg_5.jpg,3990,480,640,57,393,450,86,156,True,82
지,87,"kaist_dataset/Korean/Mobile_Phone/(M,K)E-bookCover/P090831035.jpg",char_data/지/P090831035.jpg_2.jpg,6003,480,640,69,407,476,35,122,True,82
지,39,"kaist_dataset/Korean/Mobile_Phone/(M,K)E-bookCover/P090831056.jpg",char_data/지/P090831056.jpg_4.jpg,1170,480,640,30,460,490,306,345,True,82
지,40,"kaist_dataset/Korean/Mobile_Phone/(M,K)E-bookCover/P090831056.jpg",char_data/지/P090831056.jpg_5.jpg,1080,480,640,27,116,143,407,447,True,82
지,91,"kaist_dataset/Korean/Mobile_Phone/(M,K)E-bookCover/P090831103.jpg",char_data/지/P090831103.jpg_2.jpg,5824,480,640,64,489,553,37,128,True,82
지,142,"kaist_dataset/Korean/Mobile_Phone/(M,K)E-bookCover/P090831108.jpg",char_data/지/P090831108.jpg_2.jpg,15194,480,640,107,481,588,99,241,True,82
지,141,"kaist_dataset/Korean/Mobile_Phone/(M,K)E-bookCover/P090831144.jpg",char_data/지/P090831144.jpg_2.jpg,10716,480,640,76,362,438,98,239,True,82
지,74,"kaist_dataset/Korean/Mobile_Phone/(M,K)E-bookCover/P090903010.jpg",char_data/지/P090903010.jpg_2.jpg,5846,480,640,79,135,214,14,88,True,82
지,41,"kaist_dataset/Korean/Mobile_Phone/(M,K)E-bookCover/P090903029.jpg",char_data/지/P090903029.jpg_2.jpg,1025,480,640,25,338,363,257,298,True,82
지,80,"kaist_dataset/Korean/Mobile_Phone/(M,K)E-bookCover/P090903078.jpg",char_data/지/P090903078.jpg_2.jpg,7920,480,640,99,462,561,18,98,True,82
지,118,"kaist_dataset/Korean/Mobile_Phone/(M,K)E-bookCover/P090903091.jpg",char_data/지/P090903091.jpg_2.jpg,11092,480,640,94,329,423,230,348,True,82
지,122,"kaist_dataset/Korean/Mobile_Phone/(M,K)E-bookCover/P090903093.jpg",char_data/지/P090903093.jpg_2.jpg,19398,480,640,159,295,454,193,315,True,82
지,104,"kaist_dataset/Korean/Mobile_Phone/(M,K)E-bookCover/P090911028.jpg",char_data/지/P090911028.jpg_2.jpg,12896,480,640,124,368,492,107,211,True,82
지,71,"kaist_dataset/Korean/Mobile_Phone/(M,K)E-bookCover/P090911042.jpg",char_data/지/P090911042.jpg_2.jpg,6106,480,640,86,172,258,201,272,True,82
지,116,"kaist_dataset/Korean/Mobile_Phone/(M,K)E-bookCover/P090911074.jpg",char_data/지/P090911074.jpg_2.jpg,17864,480,640,154,421,575,195,311,True,82
지,88,"kaist_dataset/Korean/Mobile_Phone/(M,K)E-bookCover/P090912003.jpg",char_data/지/P090912003.jpg_2.jpg,5808,480,640,66,117,183,84,172,True,82
지,79,"kaist_dataset/Korean/Mobile_Phone/(M,K)E-bookCover/P090912006.jpg",char_data/지/P090912006.jpg_2.jpg,4266,480,640,54,553,607,95,174,True,82
지,47,"kaist_dataset/Korean/Mobile_Phone/(M,K)F-others/P090912039.jpg",char_data/지/P090912039.jpg_2.jpg,3290,480,640,70,180,250,63,110,True,82
지,66,kaist_dataset/Mixed/Digital_Camera/(C.S)A-shadow/DSC03520.JPG,char_data/지/DSC03520.JPG_2.jpg,3102,480,640,47,520,567,43,109,True,82
지,67,kaist_dataset/Mixed/Digital_Camera/(C.S)B-light/134.JPG,char_data/지/134.JPG_2.jpg,3484,480,640,52,158,210,220,287,True,82
지,78,kaist_dataset/Mixed/Digital_Camera/(C.S)C-outdoor1/047.JPG,char_data/지/047.JPG_2.jpg,6318,480,640,81,276,357,143,221,True,82
지,44,kaist_dataset/Mixed/Digital_Camera/(C.S)C-outdoor1/133.JPG,char_data/지/133.JPG_2.jpg,1760,480,640,40,299,339,330,374,True,82
지,34,kaist_dataset/Mixed/Digital_Camera/(C.S)C-outdoor1/135.JPG,char_data/지/135.JPG_2.jpg,1054,480,640,31,201,232,254,288,True,82
지,53,kaist_dataset/Mixed/Digital_Camera/(C.S)C-outdoor1/2007-12-09-day-exterior-051.jpg,char_data/지/2007-12-09-day-exterior-051.jpg_2.jpg,2597,1200,1600,49,1116,1165,787,840,True,82
지,62,kaist_dataset/Mixed/Digital_Camera/(C.S)C-outdoor1/2007-12-09-day-exterior-078.jpg,char_data/지/2007-12-09-day-exterior-078.jpg_2.jpg,2604,1200,1600,42,1148,1190,549,611,True,82
지,87,kaist_dataset/Mixed/Digital_Camera/(C.S)C-outdoor1/48.JPG,char_data/지/48.JPG_2.jpg,6177,576,768,71,242,313,490,575,True,82
지,31,kaist_dataset/Mixed/Digital_Camera/(C.S)C-outdoor1/DSC02240.JPG,char_data/지/DSC02240.JPG_2.jpg,620,480,640,20,533,553,301,332,True,82
지,46,kaist_dataset/Mixed/Digital_Camera/(C.S)C-outdoor1/DSC02322.JPG,char_data/지/DSC02322.JPG_2.jpg,2346,480,640,51,414,465,362,408,True,82
지,44,kaist_dataset/Mixed/Digital_Camera/(C.S)C-outdoor2/DSC02389.JPG,char_data/지/DSC02389.JPG_2.jpg,2024,480,640,46,498,544,238,282,True,82
지,30,kaist_dataset/Mixed/Digital_Camera/(C.S)C-outdoor2/DSC02460.JPG,char_data/지/DSC02460.JPG_2.jpg,1080,480,640,36,68,104,309,339,True,82
지,121,kaist_dataset/Mixed/Digital_Camera/(C.S)C-outdoor2/DSC02551.JPG,char_data/지/DSC02551.JPG_2.jpg,13673,480,640,113,151,264,107,228,True,82
지,94,kaist_dataset/Mixed/Digital_Camera/(C.S)C-outdoor2/DSC02870.JPG,char_data/지/DSC02870.JPG_2.jpg,8460,480,640,90,285,375,172,266,True,82
지,46,kaist_dataset/Mixed/Digital_Camera/(C.S)C-outdoor2/DSC02887.JPG,char_data/지/DSC02887.JPG_2.jpg,1932,480,640,42,298,340,233,279,True,82
지,67,kaist_dataset/Mixed/Digital_Camera/(C.S)C-outdoor2/DSC02895.JPG,char_data/지/DSC02895.JPG_2.jpg,5494,480,640,82,207,289,232,299,True,82
지,62,kaist_dataset/Mixed/Digital_Camera/(C.S)C-outdoor3/DSC02989.JPG,char_data/지/DSC02989.JPG_2.jpg,1860,480,640,30,176,206,333,395,True,82
지,133,kaist_dataset/Mixed/Digital_Camera/(C.S)C-outdoor3/DSC03260.JPG,char_data/지/DSC03260.JPG_2.jpg,13832,480,640,104,141,245,155,288,True,82
지,56,kaist_dataset/Mixed/Digital_Camera/(C.S)C-outdoor3/DSC03265.JPG,char_data/지/DSC03265.JPG_2.jpg,2688,480,640,48,350,398,200,256,True,82
지,65,kaist_dataset/Mixed/Digital_Camera/(C.S)C-outdoor3/DSC03266.JPG,char_data/지/DSC03266.JPG_2.jpg,4030,480,640,62,345,407,177,242,False,82
지,76,kaist_dataset/Mixed/Digital_Camera/(C.S)C-outdoor3/DSC03267.JPG,char_data/지/DSC03267.JPG_2.jpg,5548,480,640,73,357,430,179,255,False,82
지,64,kaist_dataset/Mixed/Digital_Camera/(C.S)C-outdoor3/DSC03269.JPG,char_data/지/DSC03269.JPG_2.jpg,3648,480,640,57,270,327,354,418,False,82
지,83,kaist_dataset/Mixed/Digital_Camera/(C.S)C-outdoor3/DSC03271.JPG,char_data/지/DSC03271.JPG_2.jpg,7719,480,640,93,295,388,209,292,False,82
지,28,kaist_dataset/Mixed/Digital_Camera/(C.S)C-outdoor3/DSC03312.JPG,char_data/지/DSC03312.JPG_2.jpg,1036,480,640,37,458,495,294,322,False,82
지,52,kaist_dataset/Mixed/Digital_Camera/(C.S)C-outdoor3/DSC03314.JPG,char_data/지/DSC03314.JPG_2.jpg,2496,480,640,48,252,300,102,154,False,82
지,42,kaist_dataset/Mixed/Digital_Camera/(C.S)C-outdoor4/DSC03581.JPG,char_data/지/DSC03581.JPG_2.jpg,1848,480,640,44,227,271,194,236,False,82
지,74,kaist_dataset/Mixed/Digital_Camera/(C.S)C-outdoor4/DSC03582.JPG,char_data/지/DSC03582.JPG_2.jpg,5550,480,640,75,190,265,274,348,False,82
지,51,kaist_dataset/Mixed/Digital_Camera/(C.S)C-outdoor4/DSC03628.JPG,char_data/지/DSC03628.JPG_4.jpg,2346,480,640,46,321,367,355,406,False,82
지,108,kaist_dataset/Mixed/Digital_Camera/(C.S)C-outdoor4/DSC03628.JPG,char_data/지/DSC03628.JPG_5.jpg,10260,480,640,95,322,417,219,327,False,82
지,37,kaist_dataset/Mixed/Digital_Camera/(C.S)C-outdoor4/DSC03633.JPG,char_data/지/DSC03633.JPG_2.jpg,1739,480,640,47,378,425,270,307,False,82
지,105,kaist_dataset/Mixed/Digital_Camera/(C.S)C-outdoor4/DSC03654.JPG,char_data/지/DSC03654.JPG_2.jpg,12810,480,640,122,272,394,27,132,False,82
지,78,kaist_dataset/Mixed/Digital_Camera/(C.S)C-outdoor4/DSC03656.JPG,char_data/지/DSC03656.JPG_2.jpg,6552,480,640,84,425,509,325,403,False,82
지,41,kaist_dataset/Mixed/Digital_Camera/(C.S)C-outdoor4/DSC03667.JPG,char_data/지/DSC03667.JPG_2.jpg,1353,480,640,33,106,139,212,253,False,82
지,121,kaist_dataset/Mixed/Digital_Camera/(C.S)C-outdoor4/DSC03743.JPG,char_data/지/DSC03743.JPG_2.jpg,14399,480,640,119,461,580,298,419,False,82
지,59,kaist_dataset/Mixed/Digital_Camera/(C.S)C-outdoor4/DSC03756.JPG,char_data/지/DSC03756.JPG_2.jpg,2950,480,640,50,85,135,128,187,False,82
지,23,kaist_dataset/Mixed/Digital_Camera/(C.S)C-outdoor4/DSC03764.JPG,char_data/지/DSC03764.JPG_2.jpg,667,480,640,29,405,434,237,260,False,82
지,82,kaist_dataset/Mixed/Digital_Camera/(C.S)C-outdoor4/DSC03773.JPG,char_data/지/DSC03773.JPG_2.jpg,8364,480,640,102,4,106,156,238,False,82
지,104,kaist_dataset/Mixed/Digital_Camera/(C.S)C-outdoor4/DSC03787.JPG,char_data/지/DSC03787.JPG_2.jpg,11336,480,640,109,305,414,14,118,False,82
지,27,kaist_dataset/Mixed/Digital_Camera/(C.S)C-outdoor5/DSC03822.JPG,char_data/지/DSC03822.JPG_2.jpg,432,480,640,16,562,578,149,176,False,82
지,40,kaist_dataset/Mixed/Digital_Camera/(C.S)C-outdoor5/DSC03823.JPG,char_data/지/DSC03823.JPG_2.jpg,920,480,640,23,543,566,167,207,False,82
지,68,kaist_dataset/Mixed/Digital_Camera/(C.S)C-outdoor5/DSC03830.JPG,char_data/지/DSC03830.JPG_2.jpg,2992,480,640,44,451,495,30,98,False,82
지,95,kaist_dataset/Mixed/Digital_Camera/(C.S)C-outdoor5/DSC04016.JPG,char_data/지/DSC04016.JPG_2.jpg,4940,480,640,52,427,479,8,103,False,82
지,123,kaist_dataset/Mixed/Digital_Camera/(C.S)C-outdoor5/DSC04029.JPG,char_data/지/DSC04029.JPG_2.jpg,9348,480,640,76,399,475,42,165,False,82
지,87,kaist_dataset/Mixed/Digital_Camera/(C.S)C-outdoor5/DSC04056.JPG,char_data/지/DSC04056.JPG_2.jpg,4959,480,640,57,417,474,327,414,False,82
지,86,kaist_dataset/Mixed/Digital_Camera/(C.S)C-outdoor5/DSC04063.JPG,char_data/지/DSC04063.JPG_2.jpg,3010,480,640,35,102,137,264,350,False,82
지,101,kaist_dataset/Mixed/Digital_Camera/(C.S)C-outdoor5/DSC04086.JPG,char_data/지/DSC04086.JPG_2.jpg,9292,480,640,92,203,295,245,346,False,82
지,72,kaist_dataset/Mixed/Digital_Camera/(C.S)C-outdoor5/DSC04091.JPG,char_data/지/DSC04091.JPG_2.jpg,4176,480,640,58,162,220,243,315,False,82
지,103,kaist_dataset/Mixed/Digital_Camera/(C.S)C-outdoor5/DSC04146.JPG,char_data/지/DSC04146.JPG_2.jpg,9064,480,640,88,301,389,283,386,False,82
지,109,kaist_dataset/Mixed/Digital_Camera/(C.S)C-outdoor5/DSC04290.JPG,char_data/지/DSC04290.JPG_2.jpg,6104,480,640,56,319,375,65,174,False,82
지,69,kaist_dataset/Mixed/Digital_Camera/(C.S)C-outdoor5/DSC04338.JPG,char_data/지/DSC04338.JPG_2.jpg,4623,480,640,67,88,155,103,172,False,82
지,67,kaist_dataset/Mixed/Digital_Camera/(C.S)C-outdoor5/DSC04399.JPG,char_data/지/DSC04399.JPG_2.jpg,3417,480,640,51,172,223,203,270,False,82
지,27,kaist_dataset/Mixed/Digital_Camera/(C.S)C-outdoor6/P1010052.JPG,char_data/지/P1010052.JPG_2.jpg,648,480,640,24,512,536,348,375,False,82
지,33,kaist_dataset/Mixed/Digital_Camera/(C.S)C-outdoor6/P1010056.JPG,char_data/지/P1010056.JPG_2.jpg,693,480,640,21,557,578,230,263,False,82
지,51,kaist_dataset/Mixed/Digital_Camera/(C.S)C-outdoor6/P1010067.JPG,char_data/지/P1010067.JPG_5.jpg,2754,480,640,54,38,92,314,365,False,82
지,21,kaist_dataset/Mixed/Digital_Camera/(C.S)C-outdoor6/P1010097.JPG,char_data/지/P1010097.JPG_2.jpg,567,480,640,27,576,603,134,155,False,82
지,76,kaist_dataset/Mixed/Digital_Camera/(C.S)D-indoor1/DSC02771.JPG,char_data/지/DSC02771.JPG_2.jpg,6308,480,640,83,427,510,221,297,False,82
지,40,kaist_dataset/Mixed/Digital_Camera/(C.S)D-indoor1/DSC03909.JPG,char_data/지/DSC03909.JPG_2.jpg,1040,480,640,26,199,225,303,343,False,82
지,67,kaist_dataset/Mixed/Digital_Camera/(C.S)D-indoor1/DSC04231.JPG,char_data/지/DSC04231.JPG_2.jpg,3283,480,640,49,290,339,201,268,False,82
지,42,kaist_dataset/Mixed/Digital_Camera/(C.S)D-indoor2/DSC04421.JPG,char_data/지/DSC04421.JPG_2.jpg,1428,480,640,34,514,548,218,260,False,82
지,85,kaist_dataset/Mixed/Digital_Camera/(C.S)E-night/DSC02672.JPG,char_data/지/DSC02672.JPG_2.jpg,5950,480,640,70,271,341,315,400,False,82
지,34,kaist_dataset/Mixed/Digital_Camera/(C.S)E-night/DSC02678.JPG,char_data/지/DSC02678.JPG_2.jpg,1292,480,640,38,482,520,387,421,False,82
지,96,kaist_dataset/Mixed/Digital_Camera/(C.S)F-others/2007-12-09-day-exterior-032.jpg,char_data/지/2007-12-09-day-exterior-032.jpg_2.jpg,7776,1600,1200,81,552,633,1177,1273,False,82
지,81,kaist_dataset/Mixed/Mobile_Phone/(C.M)A-outdoor/P090912068.jpg,char_data/지/P090912068.jpg_2.jpg,4536,480,640,56,398,454,165,246,False,82
지,42,kaist_dataset/Mixed/Mobile_Phone/(C.M)C-bookCover/P090831045.jpg,char_data/지/P090831045.jpg_2.jpg,1848,480,640,44,267,311,305,347,False,82
지,38,kaist_dataset/Mixed/Mobile_Phone/(C.M)C-bookCover/P090903072.jpg,char_data/지/P090903072.jpg_2.jpg,1178,480,640,31,322,353,352,390,False,82
사,34,kaist_dataset/English/Digital_Camera/(E.S)B-light/080116-0059.jpg,char_data/사/080116-0059.jpg_2.jpg,680,1200,1600,20,765,785,1075,1109,True,64
사,47,kaist_dataset/Korean/Digital_Camera/A-shadow/DSC04315.JPG,char_data/사/DSC04315.JPG_4.jpg,1786,480,640,38,501,539,420,467,True,64
사,97,kaist_dataset/Korean/Digital_Camera/A-shadow/DSC04315.JPG,char_data/사/DSC04315.JPG_5.jpg,6402,480,640,66,530,596,318,415,True,64
사,65,kaist_dataset/Korean/Digital_Camera/A-shadow/P1010036.JPG,char_data/사/P1010036.JPG_2.jpg,3965,480,640,61,379,440,96,161,True,64
사,67,kaist_dataset/Korean/Digital_Camera/F-bookCover/DSC04222.JPG,char_data/사/DSC04222.JPG_2.jpg,3484,480,640,52,76,128,55,122,True,64
사,120,kaist_dataset/Korean/Digital_Camera/F-bookCover/DSC04229.JPG,char_data/사/DSC04229.JPG_2.jpg,12240,480,640,102,262,364,31,151,True,64
사,63,kaist_dataset/Korean/Digital_Camera/F-bookCover/DSC04230.JPG,char_data/사/DSC04230.JPG_2.jpg,3402,480,640,54,139,193,175,238,True,64
사,61,kaist_dataset/Korean/Digital_Camera/F-bookCover/DSC04235.JPG,char_data/사/DSC04235.JPG_2.jpg,2135,480,640,35,199,234,95,156,True,64
사,139,kaist_dataset/Korean/Digital_Camera/F-bookCover/P090911040.jpg,char_data/사/P090911040.jpg_4.jpg,25437,480,640,183,37,220,325,464,True,64
사,131,kaist_dataset/Korean/Digital_Camera/F-bookCover/P090911040.jpg,char_data/사/P090911040.jpg_5.jpg,24366,480,640,186,62,248,46,177,True,64
사,33,kaist_dataset/Korean/Digital_Camera/indoor1/057.jpg,char_data/사/057.jpg_2.jpg,792,322,425,24,309,333,240,273,True,64
사,62,kaist_dataset/Korean/Digital_Camera/indoor1/117.jpg,char_data/사/117.jpg_2.jpg,3782,480,640,61,282,343,273,335,True,64
사,64,kaist_dataset/Korean/Digital_Camera/indoor1/141.JPG,char_data/사/141.JPG_2.jpg,3520,480,640,55,389,444,218,282,True,64
사,68,kaist_dataset/Korean/Digital_Camera/indoor1/DSC02716.JPG,char_data/사/DSC02716.JPG_2.jpg,3808,480,640,56,60,116,204,272,True,64
사,78,kaist_dataset/Korean/Digital_Camera/indoor1/DSC02717.JPG,char_data/사/DSC02717.JPG_2.jpg,5850,480,640,75,429,504,327,405,True,64
사,74,kaist_dataset/Korean/Digital_Camera/indoor1/DSC02731.JPG,char_data/사/DSC02731.JPG_2.jpg,4514,480,640,61,436,497,314,388,True,64
사,94,kaist_dataset/Korean/Digital_Camera/indoor1/DSC02778.JPG,char_data/사/DSC02778.JPG_2.jpg,8366,480,640,89,504,593,273,367,True,64
사,93,kaist_dataset/Korean/Digital_Camera/indoor1/DSC03377.JPG,char_data/사/DSC03377.JPG_2.jpg,9393,480,640,101,167,268,246,339,True,64
사,52,kaist_dataset/Korean/Digital_Camera/indoor2/DSC03484.JPG,char_data/사/DSC03484.JPG_4.jpg,2184,480,640,42,272,314,118,170,True,64
사,50,kaist_dataset/Korean/Digital_Camera/indoor2/DSC03484.JPG,char_data/사/DSC03484.JPG_5.jpg,1700,480,640,34,473,507,125,175,True,64
사,47,kaist_dataset/Korean/Digital_Camera/indoor2/DSC03564.JPG,char_data/사/DSC03564.JPG_2.jpg,2961,480,640,63,192,255,169,216,True,64
사,106,kaist_dataset/Korean/Digital_Camera/indoor2/DSC03700.JPG,char_data/사/DSC03700.JPG_2.jpg,9646,480,640,91,510,601,341,447,True,64
사,38,kaist_dataset/Korean/Digital_Camera/indoor2/DSC03975.JPG,char_data/사/DSC03975.JPG_2.jpg,836,480,640,22,111,133,290,328,True,64
사,35,kaist_dataset/Korean/Digital_Camera/indoor2/DSC04001.JPG,char_data/사/DSC04001.JPG_2.jpg,1085,480,640,31,146,177,125,160,True,64
사,44,kaist_dataset/Korean/Digital_Camera/indoor2/DSC04004.JPG,char_data/사/DSC04004.JPG_2.jpg,1936,480,640,44,355,399,156,200,True,64
사,89,kaist_dataset/Korean/Digital_Camera/outdoor1/043.JPG,char_data/사/043.JPG_2.jpg,10146,480,640,114,95,209,176,265,True,64
사,220,kaist_dataset/Korean/Digital_Camera/outdoor1/097.JPG,char_data/사/097.JPG_2.jpg,31460,480,640,143,456,599,147,367,True,64
사,113,kaist_dataset/Korean/Digital_Camera/outdoor1/122.JPG,char_data/사/122.JPG_2.jpg,15707,480,640,139,436,575,154,267,True,64
사,33,kaist_dataset/Korean/Digital_Camera/outdoor1/128.JPG,char_data/사/128.JPG_2.jpg,528,480,640,16,346,362,116,149,True,64
사,89,kaist_dataset/Korean/Digital_Camera/outdoor1/2007-12-08-day-065.jpg,char_data/사/2007-12-08-day-065.jpg_2.jpg,7387,1600,1200,83,488,571,877,966,True,64
사,31,kaist_dataset/Korean/Digital_Camera/outdoor1/307.jpg,char_data/사/307.jpg_2.jpg,1333,204,330,43,171,214,43,74,True,64
사,157,kaist_dataset/Korean/Digital_Camera/outdoor2/2007-12-08-day-129.jpg,char_data/사/2007-12-08-day-129.jpg_2.jpg,18212,1200,1600,116,953,1069,510,667,True,64
사,42,kaist_dataset/Korean/Digital_Camera/outdoor2/2007-12-09-day-exterior-035.jpg,char_data/사/2007-12-09-day-exterior-035.jpg_2.jpg,1638,1200,1600,39,734,773,503,545,True,64
사,88,kaist_dataset/Korean/Digital_Camera/outdoor2/DSC02307.JPG,char_data/사/DSC02307.JPG_2.jpg,10560,480,640,120,363,483,202,290,True,64
사,88,kaist_dataset/Korean/Digital_Camera/outdoor2/DSC02310.JPG,char_data/사/DSC02310.JPG_2.jpg,9856,480,640,112,477,589,113,201,True,64
사,30,kaist_dataset/Korean/Digital_Camera/outdoor2/DSC02380.JPG,char_data/사/DSC02380.JPG_2.jpg,540,480,640,18,86,104,251,281,True,64
사,40,kaist_dataset/Korean/Digital_Camera/outdoor2/DSC02383.JPG,char_data/사/DSC02383.JPG_2.jpg,920,480,640,23,504,527,275,315,True,64
사,129,kaist_dataset/Korean/Digital_Camera/outdoor2/DSC02412.JPG,char_data/사/DSC02412.JPG_4.jpg,7611,480,640,59,492,551,269,398,True,64
사,39,kaist_dataset/Korean/Digital_Camera/outdoor2/DSC02412.JPG,char_data/사/DSC02412.JPG_5.jpg,1989,480,640,51,555,606,275,314,True,64
사,112,kaist_dataset/Korean/Digital_Camera/outdoor2/DSC02445.JPG,char_data/사/DSC02445.JPG_4.jpg,21056,480,640,188,225,413,103,215,True,64
사,40,kaist_dataset/Korean/Digital_Camera/outdoor2/DSC02445.JPG,char_data/사/DSC02445.JPG_5.jpg,2160,480,640,54,318,372,405,445,True,64
사,109,kaist_dataset/Korean/Digital_Camera/outdoor2/DSC02470.JPG,char_data/사/DSC02470.JPG_4.jpg,10137,480,640,93,442,535,244,353,True,64
사,62,kaist_dataset/Korean/Digital_Camera/outdoor2/DSC02470.JPG,char_data/사/DSC02470.JPG_5.jpg,2108,480,640,34,165,199,376,438,True,64
사,98,kaist_dataset/Korean/Digital_Camera/outdoor2/DSC02486.JPG,char_data/사/DSC02486.JPG_2.jpg,6174,480,640,63,251,314,118,216,True,64
사,70,kaist_dataset/Korean/Digital_Camera/outdoor3/DSC02900.JPG,char_data/사/DSC02900.JPG_4.jpg,4410,480,640,63,503,566,147,217,True,64
사,24,kaist_dataset/Korean/Digital_Camera/outdoor3/DSC02900.JPG,char_data/사/DSC02900.JPG_5.jpg,792,480,640,33,573,606,140,164,True,64
사,29,kaist_dataset/Korean/Digital_Camera/outdoor3/DSC02908.JPG,char_data/사/DSC02908.JPG_2.jpg,812,480,640,28,234,262,180,209,True,64
사,92,kaist_dataset/Korean/Digital_Camera/outdoor3/DSC02951.JPG,char_data/사/DSC02951.JPG_2.jpg,6164,480,640,67,543,610,293,385,True,64
사,90,kaist_dataset/Korean/Digital_Camera/outdoor3/DSC03159.JPG,char_data/사/DSC03159.JPG_2.jpg,6570,480,640,73,29,102,52,142,True,64
사,77,kaist_dataset/Korean/Digital_Camera/outdoor4/DSC03313.JPG,char_data/사/DSC03313.JPG_2.jpg,5390,480,640,70,386,456,57,134,True,64
사,70,kaist_dataset/Korean/Digital_Camera/outdoor4/DSC03320.JPG,char_data/사/DSC03320.JPG_2.jpg,5390,480,640,77,373,450,136,206,True,64
사,40,kaist_dataset/Korean/Digital_Camera/outdoor4/DSC03326.JPG,char_data/사/DSC03326.JPG_2.jpg,1160,480,640,29,574,603,216,256,True,64
사,49,kaist_dataset/Korean/Digital_Camera/outdoor4/DSC03327.JPG,char_data/사/DSC03327.JPG_4.jpg,2646,480,640,54,142,196,315,364,True,64
사,60,kaist_dataset/Korean/Digital_Camera/outdoor4/DSC03327.JPG,char_data/사/DSC03327.JPG_5.jpg,3600,480,640,60,415,475,291,351,True,64
사,50,kaist_dataset/Korean/Digital_Camera/outdoor4/DSC03437.JPG,char_data/사/DSC03437.JPG_2.jpg,3050,480,640,61,356,417,31,81,True,64
사,77,kaist_dataset/Korean/Digital_Camera/outdoor4/DSC03550.JPG,char_data/사/DSC03550.JPG_4.jpg,4620,480,640,60,521,581,188,265,True,64
사,32,kaist_dataset/Korean/Digital_Camera/outdoor4/DSC03550.JPG,char_data/사/DSC03550.JPG_5.jpg,992,480,640,31,582,613,181,213,True,64
사,78,kaist_dataset/Korean/Digital_Camera/outdoor4/DSC03553.JPG,char_data/사/DSC03553.JPG_4.jpg,4992,480,640,64,553,617,47,125,True,64
사,41,kaist_dataset/Korean/Digital_Camera/outdoor4/DSC03553.JPG,char_data/사/DSC03553.JPG_5.jpg,1476,480,640,36,495,531,129,170,True,64
사,67,kaist_dataset/Korean/Digital_Camera/outdoor4/DSC03566.JPG,char_data/사/DSC03566.JPG_2.jpg,5025,480,640,75,523,598,10,77,True,64
사,46,kaist_dataset/Korean/Digital_Camera/outdoor4/DSC03578.JPG,char_data/사/DSC03578.JPG_2.jpg,1288,480,640,28,129,157,148,194,True,64
사,76,kaist_dataset/Korean/Digital_Camera/outdoor4/DSC03583.JPG,char_data/사/DSC03583.JPG_2.jpg,4104,480,640,54,227,281,254,330,True,64
사,69,kaist_dataset/Korean/Digital_Camera/outdoor4/DSC03607.JPG,char_data/사/DSC03607.JPG_2.jpg,4623,480,640,67,237,304,270,339,True,64
사,72,kaist_dataset/Korean/Digital_Camera/outdoor5/DSC03626.JPG,char_data/사/DSC03626.JPG_2.jpg,4608,480,640,64,451,515,198,270,True,64
사,50,kaist_dataset/Korean/Digital_Camera/outdoor5/DSC03632.JPG,char_data/사/DSC03632.JPG_6.jpg,1800,480,640,36,262,298,77,127,True,64
사,67,kaist_dataset/Korean/Digital_Camera/outdoor5/DSC03632.JPG,char_data/사/DSC03632.JPG_7.jpg,3417,480,640,51,381,432,188,255,True,64
사,53,kaist_dataset/Korean/Digital_Camera/outdoor5/DSC03632.JPG,char_data/사/DSC03632.JPG_8.jpg,2332,480,640,44,416,460,316,369,True,64
사,73,kaist_dataset/Korean/Digital_Camera/outdoor5/DSC03668.JPG,char_data/사/DSC03668.JPG_2.jpg,5329,480,640,73,163,236,176,249,True,64
사,37,kaist_dataset/Korean/Digital_Camera/outdoor5/DSC03692.JPG,char_data/사/DSC03692.JPG_2.jpg,888,480,640,24,224,248,176,213,True,64
사,56,kaist_dataset/Korean/Digital_Camera/outdoor5/DSC03694.JPG,char_data/사/DSC03694.JPG_2.jpg,2296,480,640,41,583,624,51,107,True,64
사,60,kaist_dataset/Korean/Digital_Camera/outdoor5/DSC03715.JPG,char_data/사/DSC03715.JPG_2.jpg,2340,480,640,39,472,511,171,231,True,64
사,41,kaist_dataset/Korean/Digital_Camera/outdoor5/DSC03740.JPG,char_data/사/DSC03740.JPG_2.jpg,1394,480,640,34,158,192,290,331,True,64
사,41,kaist_dataset/Korean/Digital_Camera/outdoor5/DSC03746.JPG,char_data/사/DSC03746.JPG_2.jpg,1886,480,640,46,537,583,319,360,True,64
사,45,kaist_dataset/Korean/Digital_Camera/outdoor5/DSC03750.JPG,char_data/사/DSC03750.JPG_2.jpg,1890,480,640,42,345,387,413,458,True,64
사,122,kaist_dataset/Korean/Digital_Camera/outdoor5/DSC03763.JPG,char_data/사/DSC03763.JPG_2.jpg,18300,480,640,150,220,370,244,366,True,64
사,27,kaist_dataset/Korean/Digital_Camera/outdoor5/DSC04028.JPG,char_data/사/DSC04028.JPG_2.jpg,1053,480,640,39,273,312,245,272,True,64
사,80,kaist_dataset/Korean/Digital_Camera/outdoor6/DSC04042.JPG,char_data/사/DSC04042.JPG_2.jpg,5040,480,640,63,344,407,269,349,True,64
사,94,kaist_dataset/Korean/Digital_Camera/outdoor6/DSC04082.JPG,char_data/사/DSC04082.JPG_2.jpg,7238,480,640,77,133,210,101,195,True,64
사,87,kaist_dataset/Korean/Digital_Camera/outdoor6/DSC04101.JPG,char_data/사/DSC04101.JPG_2.jpg,6177,480,640,71,191,262,366,453,True,64
사,72,kaist_dataset/Korean/Digital_Camera/outdoor6/DSC04103.JPG,char_data/사/DSC04103.JPG_2.jpg,4824,480,640,67,135,202,162,234,True,64
사,72,kaist_dataset/Korean/Digital_Camera/outdoor6/DSC04121.JPG,char_data/사/DSC04121.JPG_2.jpg,3672,480,640,51,409,460,37,109,True,64
사,67,kaist_dataset/Korean/Digital_Camera/outdoor6/DSC04316.JPG,char_data/사/DSC04316.JPG_2.jpg,4958,480,640,74,456,530,171,238,True,64
사,69,kaist_dataset/Korean/Digital_Camera/outdoor6/DSC04332.JPG,char_data/사/DSC04332.JPG_4.jpg,3933,480,640,57,291,348,164,233,True,64
사,62,kaist_dataset/Korean/Digital_Camera/outdoor6/DSC04332.JPG,char_data/사/DSC04332.JPG_5.jpg,3410,480,640,55,346,401,164,226,True,64
사,71,kaist_dataset/Korean/Digital_Camera/outdoor6/DSC04435.JPG,char_data/사/DSC04435.JPG_2.jpg,4402,480,640,62,486,548,378,449,True,64
사,89,kaist_dataset/Korean/Digital_Camera/outdoor7/DSC04454.JPG,char_data/사/DSC04454.JPG_2.jpg,7209,480,640,81,223,304,88,177,True,64
사,138,kaist_dataset/Korean/Digital_Camera/outdoor7/P1010011.JPG,char_data/사/P1010011.JPG_6.jpg,15318,480,640,111,503,614,78,216,True,64
사,53,kaist_dataset/Korean/Digital_Camera/outdoor7/P1010011.JPG,char_data/사/P1010011.JPG_7.jpg,1696,480,640,32,130,162,223,276,True,64
사,90,kaist_dataset/Korean/Digital_Camera/outdoor7/P1010011.JPG,char_data/사/P1010011.JPG_8.jpg,7200,480,640,80,307,387,365,455,True,64
사,55,kaist_dataset/Korean/Digital_Camera/outdoor7/P1010015.JPG,char_data/사/P1010015.JPG_4.jpg,2530,480,640,46,537,583,115,170,True,64
사,74,kaist_dataset/Korean/Digital_Camera/outdoor7/P1010020.JPG,char_data/사/P1010020.JPG_4.jpg,6660,480,640,90,447,537,49,123,True,64
사,75,kaist_dataset/Korean/Digital_Camera/outdoor7/P1010020.JPG,char_data/사/P1010020.JPG_5.jpg,7050,480,640,94,469,563,216,291,True,64
사,82,kaist_dataset/Korean/Digital_Camera/outdoor7/P1010024.JPG,char_data/사/P1010024.JPG_2.jpg,6642,480,640,81,268,349,97,179,True,64
사,82,kaist_dataset/Korean/Digital_Camera/outdoor7/P1010035.JPG,char_data/사/P1010035.JPG_2.jpg,6642,480,640,81,333,414,131,213,True,64
사,156,kaist_dataset/Korean/Digital_Camera/outdoor7/P1010038.JPG,char_data/사/P1010038.JPG_2.jpg,24336,480,640,156,468,624,102,258,True,64
사,97,kaist_dataset/Korean/Digital_Camera/outdoor7/P1010039.JPG,char_data/사/P1010039.JPG_2.jpg,6111,480,640,63,158,221,110,207,True,64
사,80,kaist_dataset/Korean/Digital_Camera/outdoor7/P1010051.JPG,char_data/사/P1010051.JPG_2.jpg,7280,480,640,91,348,439,215,295,True,64
사,74,kaist_dataset/Korean/Digital_Camera/outdoor7/P1010073.JPG,char_data/사/P1010073.JPG_2.jpg,8140,480,640,110,39,149,270,344,True,64
사,71,kaist_dataset/Korean/Digital_Camera/outdoor7/P1010074.JPG,char_data/사/P1010074.JPG_2.jpg,6035,480,640,85,47,132,249,320,True,64
사,90,kaist_dataset/Korean/Digital_Camera/outdoor7/P1010080.JPG,char_data/사/P1010080.JPG_2.jpg,8640,480,640,96,251,347,178,268,True,64
사,95,kaist_dataset/Korean/Digital_Camera/outdoor7/P1010082.JPG,char_data/사/P1010082.JPG_4.jpg,8360,480,640,88,495,583,93,188,True,64
사,114,kaist_dataset/Korean/Digital_Camera/outdoor7/P1010085.JPG,char_data/사/P1010085.JPG_4.jpg,13680,480,640,120,458,578,137,251,True,64
사,53,kaist_dataset/Korean/Digital_Camera/outdoor7/P1010085.JPG,char_data/사/P1010085.JPG_5.jpg,1537,480,640,29,548,577,56,109,True,64
사,106,kaist_dataset/Korean/Digital_Camera/outdoor7/P1010088.JPG,char_data/사/P1010088.JPG_2.jpg,8692,480,640,82,402,484,174,280,True,64
사,84,kaist_dataset/Korean/Digital_Camera/outdoor7/P1010100.JPG,char_data/사/P1010100.JPG_4.jpg,5460,480,640,65,474,539,116,200,True,64
사,33,kaist_dataset/Korean/Digital_Camera/outdoor7/P1010100.JPG,char_data/사/P1010100.JPG_5.jpg,1716,480,640,52,545,597,106,139,True,64
사,49,kaist_dataset/Korean/Digital_Camera/outdoor7/P1010111.JPG,char_data/사/P1010111.JPG_4.jpg,1715,480,640,35,281,316,219,268,True,64
사,21,kaist_dataset/Korean/Digital_Camera/outdoor7/P1010111.JPG,char_data/사/P1010111.JPG_5.jpg,567,480,640,27,321,348,211,232,True,64
사,70,kaist_dataset/Korean/Digital_Camera/outdoor8/P1010147.JPG,char_data/사/P1010147.JPG_4.jpg,4480,480,640,64,413,477,213,283,True,64
사,40,kaist_dataset/Korean/Digital_Camera/outdoor8/P1010147.JPG,char_data/사/P1010147.JPG_5.jpg,1120,480,640,28,479,507,261,301,True,64
사,77,kaist_dataset/Korean/Digital_Camera/outdoor8/P1010160.JPG,char_data/사/P1010160.JPG_4.jpg,3542,480,640,46,522,568,53,130,True,64
사,40,kaist_dataset/Korean/Digital_Camera/outdoor8/P1010160.JPG,char_data/사/P1010160.JPG_5.jpg,1400,480,640,35,476,511,141,181,True,64
사,84,kaist_dataset/Korean/Digital_Camera/outdoor8/P1010171.JPG,char_data/사/P1010171.JPG_2.jpg,7056,480,640,84,186,270,126,210,True,64
사,102,kaist_dataset/Korean/Digital_Camera/outdoor8/P1010181.JPG,char_data/사/P1010181.JPG_2.jpg,11832,480,640,116,375,491,70,172,True,64
사,144,"kaist_dataset/Korean/Mobile_Phone/(M,K)E-bookCover/P090831052.jpg",char_data/사/P090831052.jpg_2.jpg,16560,480,640,115,41,156,137,281,True,64
사,106,"kaist_dataset/Korean/Mobile_Phone/(M,K)E-bookCover/P090831067.jpg",char_data/사/P090831067.jpg_2.jpg,11872,480,640,112,55,167,74,180,True,64
사,99,"kaist_dataset/Korean/Mobile_Phone/(M,K)E-bookCover/P090831100.jpg",char_data/사/P090831100.jpg_2.jpg,9999,480,640,101,190,291,31,130,True,64
사,81,"kaist_dataset/Korean/Mobile_Phone/(M,K)E-bookCover/P090903038.jpg",char_data/사/P090903038.jpg_2.jpg,6156,480,640,76,80,156,108,189,True,64
사,38,"kaist_dataset/Korean/Mobile_Phone/(M,K)E-bookCover/P090903051.jpg",char_data/사/P090903051.jpg_2.jpg,1406,480,640,37,254,291,203,241,True,64
사,51,"kaist_dataset/Korean/Mobile_Phone/(M,K)E-bookCover/P090903057.jpg",char_data/사/P090903057.jpg_2.jpg,2397,480,640,47,487,534,51,102,True,64
사,75,"kaist_dataset/Korean/Mobile_Phone/(M,K)E-bookCover/P090911024.jpg",char_data/사/P090911024.jpg_2.jpg,7200,480,640,96,266,362,108,183,True,64
사,57,"kaist_dataset/Korean/Mobile_Phone/(M,K)E-bookCover/P090911042.jpg",char_data/사/P090911042.jpg_2.jpg,4731,480,640,83,206,289,103,160,True,64
사,57,"kaist_dataset/Korean/Mobile_Phone/(M,K)E-bookCover/P090912005.jpg",char_data/사/P090912005.jpg_2.jpg,3534,480,640,62,575,637,35,92,True,64
사,84,kaist_dataset/Mixed/Digital_Camera/(C.S)A-shadow/DSC02567.JPG,char_data/사/DSC02567.JPG_4.jpg,4200,480,640,50,473,523,42,126,True,64
사,94,kaist_dataset/Mixed/Digital_Camera/(C.S)A-shadow/DSC04304.JPG,char_data/사/DSC04304.JPG_4.jpg,5076,480,640,54,448,502,143,237,True,64
사,48,kaist_dataset/Mixed/Digital_Camera/(C.S)A-shadow/DSC04304.JPG,char_data/사/DSC04304.JPG_5.jpg,1920,480,640,40,503,543,204,252,True,64
사,79,kaist_dataset/Mixed/Digital_Camera/(C.S)A-shadow/P1010019.JPG,char_data/사/P1010019.JPG_2.jpg,6557,480,640,83,44,127,156,235,True,64
사,79,kaist_dataset/Mixed/Digital_Camera/(C.S)C-outdoor1/047.JPG,char_data/사/047.JPG_2.jpg,6873,480,640,87,441,528,140,219,True,64
사,88,kaist_dataset/Mixed/Digital_Camera/(C.S)C-outdoor1/080119-0017.jpg,char_data/사/080119-0017.jpg_2.jpg,5456,1200,1600,62,799,861,1096,1184,True,64
사,109,kaist_dataset/Mixed/Digital_Camera/(C.S)C-outdoor1/080119-0033.jpg,char_data/사/080119-0033.jpg_4.jpg,10355,1200,1600,95,737,832,817,926,True,64
사,95,kaist_dataset/Mixed/Digital_Camera/(C.S)C-outdoor1/080119-0033.jpg,char_data/사/080119-0033.jpg_5.jpg,8645,1200,1600,91,583,674,936,1031,True,64
사,41,kaist_dataset/Mixed/Digital_Camera/(C.S)C-outdoor1/1.JPG,char_data/사/1.JPG_2.jpg,2173,576,768,53,500,553,514,555,True,64
사,111,kaist_dataset/Mixed/Digital_Camera/(C.S)C-outdoor1/105.jpg,char_data/사/105.jpg_2.jpg,13653,480,640,123,210,333,225,336,True,64
사,169,kaist_dataset/Mixed/Digital_Camera/(C.S)C-outdoor1/2007-12-09-day-exterior-078.jpg,char_data/사/2007-12-09-day-exterior-078.jpg_8.jpg,17745,1200,1600,105,797,902,392,561,True,64
사,54,kaist_dataset/Mixed/Digital_Camera/(C.S)C-outdoor1/2007-12-09-day-exterior-078.jpg,char_data/사/2007-12-09-day-exterior-078.jpg_9.jpg,1890,1200,1600,35,984,1019,560,614,True,64
사,56,kaist_dataset/Mixed/Digital_Camera/(C.S)C-outdoor1/2007-12-09-day-exterior-078.jpg,char_data/사/2007-12-09-day-exterior-078.jpg_10.jpg,2016,1200,1600,36,1064,1100,558,614,True,64
사,64,kaist_dataset/Mixed/Digital_Camera/(C.S)C-outdoor1/2007-12-09-day-exterior-078.jpg,char_data/사/2007-12-09-day-exterior-078.jpg_11.jpg,2624,1200,1600,41,1105,1146,553,617,True,64
사,101,kaist_dataset/Mixed/Digital_Camera/(C.S)C-outdoor1/55.JPG,char_data/사/55.JPG_2.jpg,10201,576,768,101,571,672,260,361,True,64
사,73,kaist_dataset/Mixed/Digital_Camera/(C.S)C-outdoor1/56.JPG,char_data/사/56.JPG_4.jpg,4234,576,768,58,492,550,216,289,True,64
사,74,kaist_dataset/Mixed/Digital_Camera/(C.S)C-outdoor1/56.JPG,char_data/사/56.JPG_5.jpg,4514,576,768,61,552,613,213,287,True,64
사,69,kaist_dataset/Mixed/Digital_Camera/(C.S)C-outdoor1/DSC02244.JPG,char_data/사/DSC02244.JPG_4.jpg,2898,480,640,42,427,469,251,320,True,64
사,71,kaist_dataset/Mixed/Digital_Camera/(C.S)C-outdoor1/DSC02244.JPG,char_data/사/DSC02244.JPG_5.jpg,3195,480,640,45,232,277,251,322,True,64
사,77,kaist_dataset/Mixed/Digital_Camera/(C.S)C-outdoor1/DSC02349.JPG,char_data/사/DSC02349.JPG_2.jpg,4697,480,640,61,463,524,119,196,True,64
사,42,kaist_dataset/Mixed/Digital_Camera/(C.S)C-outdoor1/DSC02350.JPG,char_data/사/DSC02350.JPG_2.jpg,1890,480,640,45,586,631,311,353,True,64
사,44,kaist_dataset/Mixed/Digital_Camera/(C.S)C-outdoor1/P1010010.JPG,char_data/사/P1010010.JPG_2.jpg,1496,480,640,34,490,524,155,199,True,64
사,70,kaist_dataset/Mixed/Digital_Camera/(C.S)C-outdoor2/DSC02377.JPG,char_data/사/DSC02377.JPG_2.jpg,5670,480,640,81,59,140,245,315,True,64
사,91,kaist_dataset/Mixed/Digital_Camera/(C.S)C-outdoor2/DSC02422.JPG,char_data/사/DSC02422.JPG_2.jpg,5733,480,640,63,450,513,94,185,True,64
사,42,kaist_dataset/Mixed/Digital_Camera/(C.S)C-outdoor2/DSC02434.JPG,char_data/사/DSC02434.JPG_2.jpg,1806,480,640,43,146,189,97,139,True,64
사,72,kaist_dataset/Mixed/Digital_Camera/(C.S)C-outdoor2/DSC02461.JPG,char_data/사/DSC02461.JPG_2.jpg,4104,480,640,57,571,628,168,240,True,64
사,84,kaist_dataset/Mixed/Digital_Camera/(C.S)C-outdoor2/DSC02567.JPG,char_data/사/DSC02567.JPG_5.jpg,4200,480,640,50,473,523,42,126,True,64
사,30,kaist_dataset/Mixed/Digital_Camera/(C.S)C-outdoor2/DSC02936.JPG,char_data/사/DSC02936.JPG_2.jpg,750,480,640,25,279,304,225,255,True,64
사,26,kaist_dataset/Mixed/Digital_Camera/(C.S)C-outdoor2/P1010015.JPG,char_data/사/P1010015.JPG_5.jpg,442,480,640,17,238,255,184,210,True,64
사,99,kaist_dataset/Mixed/Digital_Camera/(C.S)C-outdoor3/DSC02986.JPG,char_data/사/DSC02986.JPG_2.jpg,11979,480,640,121,26,147,184,283,True,64
사,72,kaist_dataset/Mixed/Digital_Camera/(C.S)C-outdoor3/DSC03185.JPG,char_data/사/DSC03185.JPG_2.jpg,4968,480,640,69,526,595,94,166,True,64
사,53,kaist_dataset/Mixed/Digital_Camera/(C.S)C-outdoor3/DSC03255.JPG,char_data/사/DSC03255.JPG_2.jpg,4558,480,640,86,130,216,131,184,True,64
사,66,kaist_dataset/Mixed/Digital_Camera/(C.S)C-outdoor3/DSC03292.JPG,char_data/사/DSC03292.JPG_2.jpg,5082,480,640,77,530,607,49,115,True,64
사,66,kaist_dataset/Mixed/Digital_Camera/(C.S)C-outdoor3/DSC03303.JPG,char_data/사/DSC03303.JPG_4.jpg,2970,480,640,45,468,513,114,180,True,64
사,70,kaist_dataset/Mixed/Digital_Camera/(C.S)C-outdoor3/DSC03303.JPG,char_data/사/DSC03303.JPG_5.jpg,5250,480,640,75,390,465,212,282,True,64
사,90,kaist_dataset/Mixed/Digital_Camera/(C.S)C-outdoor3/DSC03314.JPG,char_data/사/DSC03314.JPG_4.jpg,3960,480,640,44,351,395,170,260,True,64
사,85,kaist_dataset/Mixed/Digital_Camera/(C.S)C-outdoor3/DSC03314.JPG,char_data/사/DSC03314.JPG_5.jpg,3825,480,640,45,407,452,177,262,True,64
사,44,kaist_dataset/Mixed/Digital_Camera/(C.S)C-outdoor3/DSC03315.JPG,char_data/사/DSC03315.JPG_4.jpg,2684,480,640,61,124,185,75,119,True,64
사,50,kaist_dataset/Mixed/Digital_Camera/(C.S)C-outdoor3/DSC03315.JPG,char_data/사/DSC03315.JPG_5.jpg,3300,480,640,66,426,492,65,115,True,64
사,72,kaist_dataset/Mixed/Digital_Camera/(C.S)C-outdoor3/DSC03316.JPG,char_data/사/DSC03316.JPG_2.jpg,5400,480,640,75,360,435,8,80,True,64
사,37,kaist_dataset/Mixed/Digital_Camera/(C.S)C-outdoor3/DSC03429.JPG,char_data/사/DSC03429.JPG_2.jpg,1517,480,640,41,138,179,202,239,True,64
사,129,kaist_dataset/Mixed/Digital_Camera/(C.S)C-outdoor4/DSC03435.JPG,char_data/사/DSC03435.JPG_4.jpg,8643,480,640,67,516,583,280,409,True,64
사,38,kaist_dataset/Mixed/Digital_Camera/(C.S)C-outdoor4/DSC03435.JPG,char_data/사/DSC03435.JPG_5.jpg,1824,480,640,48,446,494,240,278,True,64
사,76,kaist_dataset/Mixed/Digital_Camera/(C.S)C-outdoor4/DSC03446.JPG,char_data/사/DSC03446.JPG_2.jpg,4484,480,640,59,476,535,217,293,True,64
사,80,kaist_dataset/Mixed/Digital_Camera/(C.S)C-outdoor4/DSC03533.JPG,char_data/사/DSC03533.JPG_2.jpg,5040,480,640,63,446,509,185,265,True,64
사,100,kaist_dataset/Mixed/Digital_Camera/(C.S)C-outdoor4/DSC03534.JPG,char_data/사/DSC03534.JPG_2.jpg,6400,480,640,64,405,469,135,235,True,64
사,50,kaist_dataset/Mixed/Digital_Camera/(C.S)C-outdoor4/DSC03604.JPG,char_data/사/DSC03604.JPG_2.jpg,2700,480,640,54,305,359,269,319,True,64
사,57,kaist_dataset/Mixed/Digital_Camera/(C.S)C-outdoor4/DSC03667.JPG,char_data/사/DSC03667.JPG_2.jpg,3192,480,640,56,228,284,282,339,True,64
사,67,kaist_dataset/Mixed/Digital_Camera/(C.S)C-outdoor4/DSC03673.JPG,char_data/사/DSC03673.JPG_2.jpg,4288,480,640,64,206,270,111,178,True,64
사,46,kaist_dataset/Mixed/Digital_Camera/(C.S)C-outdoor5/DSC04069.JPG,char_data/사/DSC04069.JPG_2.jpg,1748,480,640,38,95,133,305,351,True,64
사,39,kaist_dataset/Mixed/Digital_Camera/(C.S)C-outdoor5/DSC04070.JPG,char_data/사/DSC04070.JPG_2.jpg,1560,480,640,40,184,224,51,90,False,64
사,112,kaist_dataset/Mixed/Digital_Camera/(C.S)C-outdoor5/DSC04071.JPG,char_data/사/DSC04071.JPG_2.jpg,13328,480,640,119,262,381,241,353,False,64
사,47,kaist_dataset/Mixed/Digital_Camera/(C.S)C-outdoor5/DSC04108.JPG,char_data/사/DSC04108.JPG_4.jpg,2021,480,640,43,446,489,184,231,False,64
사,46,kaist_dataset/Mixed/Digital_Camera/(C.S)C-outdoor5/DSC04108.JPG,char_data/사/DSC04108.JPG_5.jpg,1564,480,640,34,490,524,187,233,False,64
사,49,kaist_dataset/Mixed/Digital_Camera/(C.S)C-outdoor5/DSC04357.JPG,char_data/사/DSC04357.JPG_2.jpg,2009,480,640,41,205,246,291,340,False,64
사,40,kaist_dataset/Mixed/Digital_Camera/(C.S)C-outdoor5/DSC04434.JPG,char_data/사/DSC04434.JPG_2.jpg,1400,480,640,35,357,392,427,467,False,64
사,76,kaist_dataset/Mixed/Digital_Camera/(C.S)C-outdoor5/DSC04450.JPG,char_data/사/DSC04450.JPG_2.jpg,5168,480,640,68,305,373,343,419,False,64
사,64,kaist_dataset/Mixed/Digital_Camera/(C.S)C-outdoor6/080116-0057.jpg,char_data/사/080116-0057.jpg_2.jpg,3456,1200,1600,54,973,1027,1079,1143,False,64
사,104,kaist_dataset/Mixed/Digital_Camera/(C.S)C-outdoor6/P1010018.JPG,char_data/사/P1010018.JPG_2.jpg,9568,480,640,92,539,631,124,228,False,64
사,42,kaist_dataset/Mixed/Digital_Camera/(C.S)C-outdoor6/P1010021.JPG,char_data/사/P1010021.JPG_2.jpg,1722,480,640,41,110,151,408,450,False,64
사,93,kaist_dataset/Mixed/Digital_Camera/(C.S)C-outdoor6/P1010045.JPG,char_data/사/P1010045.JPG_2.jpg,7254,480,640,78,355,433,284,377,False,64
사,60,kaist_dataset/Mixed/Digital_Camera/(C.S)C-outdoor6/P1010082.JPG,char_data/사/P1010082.JPG_5.jpg,3360,480,640,56,183,239,135,195,False,64
사,138,kaist_dataset/Mixed/Digital_Camera/(C.S)C-outdoor6/P1010084.JPG,char_data/사/P1010084.JPG_2.jpg,16836,480,640,122,507,629,14,152,False,64
사,109,kaist_dataset/Mixed/Digital_Camera/(C.S)C-outdoor6/P1010087.JPG,char_data/사/P1010087.JPG_2.jpg,16459,480,640,151,229,380,39,148,False,64
사,54,kaist_dataset/Mixed/Digital_Camera/(C.S)C-outdoor6/P1010132.JPG,char_data/사/P1010132.JPG_2.jpg,4320,480,640,80,279,359,82,136,False,64
사,77,kaist_dataset/Mixed/Digital_Camera/(C.S)C-outdoor6/P1010137.JPG,char_data/사/P1010137.JPG_4.jpg,6391,480,640,83,354,437,92,169,False,64
사,41,kaist_dataset/Mixed/Digital_Camera/(C.S)C-outdoor6/P1010137.JPG,char_data/사/P1010137.JPG_5.jpg,1681,480,640,41,269,310,254,295,False,64
사,156,kaist_dataset/Mixed/Digital_Camera/(C.S)D-indoor1/DSC02733.JPG,char_data/사/DSC02733.JPG_2.jpg,24648,480,640,158,16,174,132,288,False,64
사,64,kaist_dataset/Mixed/Digital_Camera/(C.S)D-indoor1/DSC02772.JPG,char_data/사/DSC02772.JPG_2.jpg,3520,480,640,55,428,483,286,350,False,64
사,36,kaist_dataset/Mixed/Digital_Camera/(C.S)D-indoor1/DSC02789.JPG,char_data/사/DSC02789.JPG_2.jpg,1692,480,640,47,559,606,208,244,False,64
사,69,kaist_dataset/Mixed/Digital_Camera/(C.S)D-indoor1/DSC03986.JPG,char_data/사/DSC03986.JPG_2.jpg,4002,480,640,58,484,542,59,128,False,64
사,43,kaist_dataset/Mixed/Digital_Camera/(C.S)D-indoor1/DSC03998.JPG,char_data/사/DSC03998.JPG_2.jpg,1333,480,640,31,18,49,181,224,False,64
사,70,kaist_dataset/Mixed/Digital_Camera/(C.S)D-indoor1/DSC04173.JPG,char_data/사/DSC04173.JPG_2.jpg,3850,480,640,55,243,298,401,471,False,64
사,52,kaist_dataset/Mixed/Digital_Camera/(C.S)D-indoor1/DSC04223.JPG,char_data/사/DSC04223.JPG_2.jpg,2912,480,640,56,250,306,344,396,False,64
사,101,kaist_dataset/Mixed/Digital_Camera/(C.S)D-indoor1/DSC04231.JPG,char_data/사/DSC04231.JPG_2.jpg,5858,480,640,58,384,442,269,370,False,64
사,97,kaist_dataset/Mixed/Digital_Camera/(C.S)E-night/P1010151.JPG,char_data/사/P1010151.JPG_2.jpg,3686,480,640,38,543,581,248,345,False,64
사,56,kaist_dataset/Mixed/Digital_Camera/(C.S)E-night/P1010152.JPG,char_data/사/P1010152.JPG_4.jpg,3248,480,640,58,286,344,65,121,False,64
사,55,kaist_dataset/Mixed/Digital_Camera/(C.S)E-night/P1010152.JPG,char_data/사/P1010152.JPG_5.jpg,3630,480,640,66,88,154,137,192,False,64
사,88,kaist_dataset/Mixed/Digital_Camera/(C.S)F-others/2007-12-08-day-113.jpg,char_data/사/2007-12-08-day-113.jpg_2.jpg,5632,1200,1600,64,614,678,715,803,False,64
사,82,kaist_dataset/Mixed/Digital_Camera/(C.S)F-others/DSC02777.JPG,char_data/사/DSC02777.JPG_2.jpg,8036,480,640,98,463,561,215,297,False,64
사,73,kaist_dataset/Mixed/Digital_Camera/(C.S)F-others/DSC02803.JPG,char_data/사/DSC02803.JPG_2.jpg,6278,480,640,86,272,358,291,364,False,64
사,76,kaist_dataset/Mixed/Digital_Camera/(C.S)F-others/DSC02893.JPG,char_data/사/DSC02893.JPG_6.jpg,6460,480,640,85,527,612,146,222,False,64
사,44,kaist_dataset/Mixed/Digital_Camera/(C.S)F-others/DSC02893.JPG,char_data/사/DSC02893.JPG_7.jpg,2156,480,640,49,455,504,244,288,False,64
사,70,kaist_dataset/Mixed/Digital_Camera/(C.S)F-others/DSC02893.JPG,char_data/사/DSC02893.JPG_8.jpg,6930,480,640,99,34,133,277,347,False,64
사,80,kaist_dataset/Mixed/Mobile_Phone/(C.M)A-outdoor/P090903099.jpg,char_data/사/P090903099.jpg_2.jpg,6240,480,640,78,530,608,159,239,False,64
사,72,kaist_dataset/Mixed/Mobile_Phone/(C.M)A-outdoor/P090912068.jpg,char_data/사/P090912068.jpg_2.jpg,4032,480,640,56,342,398,166,238,False,64
사,59,kaist_dataset/Mixed/Mobile_Phone/(C.M)B-indoor/P090831012.jpg,char_data/사/P090831012.jpg_2.jpg,4484,480,640,76,285,361,109,168,False,64
사,70,kaist_dataset/Mixed/Mobile_Phone/(C.M)B-indoor/P090831013.jpg,char_data/사/P090831013.jpg_2.jpg,5110,480,640,73,234,307,113,183,False,64
사,62,kaist_dataset/Mixed/Mobile_Phone/(C.M)B-indoor/P090831014.jpg,char_data/사/P090831014.jpg_2.jpg,4340,480,640,70,325,395,98,160,False,64
사,66,kaist_dataset/Mixed/Mobile_Phone/(C.M)B-indoor/P090831015.jpg,char_data/사/P090831015.jpg_2.jpg,4224,480,640,64,315,379,138,204,False,64
사,45,kaist_dataset/Mixed/Mobile_Phone/(C.M)C-bookCover/P090902016.jpg,char_data/사/P090902016.jpg_2.jpg,1935,480,640,43,437,480,207,252,False,64
사,74,kaist_dataset/Mixed/Mobile_Phone/(C.M)C-bookCover/P090903024.jpg,char_data/사/P090903024.jpg_2.jpg,5032,480,640,68,421,489,361,435,False,64
사,66,kaist_dataset/Mixed/Mobile_Phone/(C.M)C-bookCover/P090904004.jpg,char_data/사/P090904004.jpg_2.jpg,5412,480,640,82,215,297,57,123,False,64
사,97,kaist_dataset/Mixed/Mobile_Phone/(C.M)C-bookCover/P090904005.jpg,char_data/사/P090904005.jpg_2.jpg,14162,480,640,146,374,520,170,267,False,64
대,30,kaist_dataset/English/Digital_Camera/(E.S)B-light/080116-0059.jpg,char_data/대/080116-0059.jpg_2.jpg,570,1200,1600,19,828,847,1073,1103,True,55
대,37,kaist_dataset/English/Digital_Camera/(E.S)C-outdoor1/2007-12-09-day-exterior-063.jpg,char_data/대/2007-12-09-day-exterior-063.jpg_2.jpg,1295,1200,1600,35,980,1015,626,663,True,55
대,44,kaist_dataset/Korean/Digital_Camera/A-shadow/2007-12-09-day-exterior-031.jpg,char_data/대/2007-12-09-day-exterior-031.jpg_2.jpg,1628,1200,1600,37,800,837,958,1002,True,55
대,68,kaist_dataset/Korean/Digital_Camera/A-shadow/2007-12-09-day-exterior-040.jpg,char_data/대/2007-12-09-day-exterior-040.jpg_4.jpg,1904,1200,1600,28,274,302,814,882,True,55
대,65,kaist_dataset/Korean/Digital_Camera/A-shadow/2007-12-09-day-exterior-040.jpg,char_data/대/2007-12-09-day-exterior-040.jpg_5.jpg,5655,1200,1600,87,456,543,817,882,True,55
대,97,kaist_dataset/Korean/Digital_Camera/A-shadow/DSC03792.JPG,char_data/대/DSC03792.JPG_2.jpg,6596,480,640,68,318,386,257,354,True,55
대,93,kaist_dataset/Korean/Digital_Camera/A-shadow/DSC03793.JPG,char_data/대/DSC03793.JPG_2.jpg,7998,480,640,86,404,490,161,254,True,55
대,139,kaist_dataset/Korean/Digital_Camera/A-shadow/DSC04299.JPG,char_data/대/DSC04299.JPG_2.jpg,16958,480,640,122,304,426,83,222,True,55
대,157,kaist_dataset/Korean/Digital_Camera/A-shadow/DSC04300.JPG,char_data/대/DSC04300.JPG_2.jpg,21823,480,640,139,234,373,32,189,True,55
대,70,kaist_dataset/Korean/Digital_Camera/A-shadow/DSC04311.JPG,char_data/대/DSC04311.JPG_2.jpg,4900,480,640,70,76,146,134,204,True,55
대,46,kaist_dataset/Korean/Digital_Camera/A-shadow/DSC04315.JPG,char_data/대/DSC04315.JPG_4.jpg,1472,480,640,32,332,364,417,463,True,55
대,116,kaist_dataset/Korean/Digital_Camera/A-shadow/DSC04315.JPG,char_data/대/DSC04315.JPG_5.jpg,10324,480,640,89,111,200,291,407,True,55
대,101,kaist_dataset/Korean/Digital_Camera/E-night/DSC02662.JPG,char_data/대/DSC02662.JPG_2.jpg,11817,480,640,117,242,359,204,305,True,55
대,70,kaist_dataset/Korean/Digital_Camera/F-bookCover/DSC03929.JPG,char_data/대/DSC03929.JPG_2.jpg,3920,480,640,56,54,110,131,201,True,55
대,134,kaist_dataset/Korean/Digital_Camera/G-others/2007-12-09-day-exterior-005.jpg,char_data/대/2007-12-09-day-exterior-005.jpg_2.jpg,14606,1600,1200,109,355,464,520,654,True,55
대,71,kaist_dataset/Korean/Digital_Camera/indoor1/DSC02706.JPG,char_data/대/DSC02706.JPG_2.jpg,4757,480,640,67,47,114,234,305,True,55
대,117,kaist_dataset/Korean/Digital_Camera/indoor1/DSC02710.JPG,char_data/대/DSC02710.JPG_2.jpg,13806,480,640,118,374,492,244,361,True,55
대,58,kaist_dataset/Korean/Digital_Camera/indoor1/DSC02716.JPG,char_data/대/DSC02716.JPG_2.jpg,2900,480,640,50,232,282,212,270,True,55
대,71,kaist_dataset/Korean/Digital_Camera/indoor1/DSC03092.JPG,char_data/대/DSC03092.JPG_2.jpg,3905,480,640,55,447,502,88,159,True,55
대,80,kaist_dataset/Korean/Digital_Camera/indoor1/DSC03097.JPG,char_data/대/DSC03097.JPG_2.jpg,5680,480,640,71,371,442,254,334,True,55
대,49,kaist_dataset/Korean/Digital_Camera/indoor1/DSC03113.JPG,char_data/대/DSC03113.JPG_4.jpg,1862,480,640,38,125,163,148,197,True,55
대,42,kaist_dataset/Korean/Digital_Camera/indoor1/DSC03113.JPG,char_data/대/DSC03113.JPG_5.jpg,1386,480,640,33,117,150,279,321,True,55
대,110,kaist_dataset/Korean/Digital_Camera/indoor1/DSC03154.JPG,char_data/대/DSC03154.JPG_2.jpg,8580,480,640,78,64,142,186,296,True,55
대,97,kaist_dataset/Korean/Digital_Camera/indoor1/DSC03155.JPG,char_data/대/DSC03155.JPG_2.jpg,6790,480,640,70,26,96,132,229,True,55
대,71,kaist_dataset/Korean/Digital_Camera/indoor1/DSC03362.JPG,char_data/대/DSC03362.JPG_2.jpg,4615,480,640,65,448,513,265,336,True,55
대,100,kaist_dataset/Korean/Digital_Camera/indoor1/DSC03363.JPG,char_data/대/DSC03363.JPG_2.jpg,8700,480,640,87,399,486,250,350,True,55
대,161,kaist_dataset/Korean/Digital_Camera/indoor2/DSC03471.JPG,char_data/대/DSC03471.JPG_2.jpg,10948,480,640,68,377,445,239,400,True,55
대,104,kaist_dataset/Korean/Digital_Camera/indoor2/DSC03700.JPG,char_data/대/DSC03700.JPG_2.jpg,7904,480,640,76,115,191,338,442,True,55
대,56,kaist_dataset/Korean/Digital_Camera/indoor2/DSC03994.JPG,char_data/대/DSC03994.JPG_2.jpg,1624,480,640,29,431,460,90,146,True,55
대,71,kaist_dataset/Korean/Digital_Camera/indoor2/DSC04186.JPG,char_data/대/DSC04186.JPG_2.jpg,4047,480,640,57,229,286,75,146,True,55
대,73,kaist_dataset/Korean/Digital_Camera/indoor2/P071209063.jpg,char_data/대/P071209063.jpg_2.jpg,9928,1200,1600,136,193,329,1090,1163,True,55
대,51,kaist_dataset/Korean/Digital_Camera/outdoor1/028.JPG,char_data/대/028.JPG_4.jpg,2142,480,640,42,51,93,176,227,True,55
대,61,kaist_dataset/Korean/Digital_Camera/outdoor1/028.JPG,char_data/대/028.JPG_5.jpg,3294,480,640,54,87,141,394,455,True,55
대,76,kaist_dataset/Korean/Digital_Camera/outdoor1/124.JPG,char_data/대/124.JPG_2.jpg,5928,480,640,78,205,283,170,246,True,55
대,114,kaist_dataset/Korean/Digital_Camera/outdoor1/127.JPG,char_data/대/127.JPG_2.jpg,9804,480,640,86,160,246,151,265,True,55
대,102,kaist_dataset/Korean/Digital_Camera/outdoor1/128.JPG,char_data/대/128.JPG_2.jpg,7752,480,640,76,138,214,176,278,True,55
대,82,kaist_dataset/Korean/Digital_Camera/outdoor1/2007-12-08-day-065.jpg,char_data/대/2007-12-08-day-065.jpg_2.jpg,5904,1600,1200,72,380,452,1240,1322,True,55
대,201,kaist_dataset/Korean/Digital_Camera/outdoor1/46.JPG,char_data/대/46.JPG_2.jpg,22110,576,768,110,177,287,145,346,True,55
대,124,kaist_dataset/Korean/Digital_Camera/outdoor2/080119-0032.jpg,char_data/대/080119-0032.jpg_2.jpg,23188,1200,1600,187,1202,1389,293,417,True,55
대,214,kaist_dataset/Korean/Digital_Camera/outdoor2/2007-12-08-day-129.jpg,char_data/대/2007-12-08-day-129.jpg_2.jpg,34454,1200,1600,161,481,642,450,664,True,55
대,96,kaist_dataset/Korean/Digital_Camera/outdoor2/DSC02310.JPG,char_data/대/DSC02310.JPG_2.jpg,11520,480,640,120,186,306,103,199,True,55
대,128,kaist_dataset/Korean/Digital_Camera/outdoor2/DSC02326.JPG,char_data/대/DSC02326.JPG_2.jpg,9984,480,640,78,99,177,192,320,True,55
대,135,kaist_dataset/Korean/Digital_Camera/outdoor2/DSC02373.JPG,char_data/대/DSC02373.JPG_2.jpg,16065,480,640,119,20,139,185,320,True,55
대,106,kaist_dataset/Korean/Digital_Camera/outdoor2/DSC02378.JPG,char_data/대/DSC02378.JPG_2.jpg,12190,480,640,115,222,337,189,295,True,55
대,115,kaist_dataset/Korean/Digital_Camera/outdoor2/DSC02381.JPG,char_data/대/DSC02381.JPG_2.jpg,13455,480,640,117,470,587,229,344,True,55
대,105,kaist_dataset/Korean/Digital_Camera/outdoor2/DSC02383.JPG,char_data/대/DSC02383.JPG_2.jpg,9870,480,640,94,30,124,166,271,True,55
대,38,kaist_dataset/Korean/Digital_Camera/outdoor2/DSC02393.JPG,char_data/대/DSC02393.JPG_2.jpg,1140,480,640,30,384,414,302,340,True,55
대,40,kaist_dataset/Korean/Digital_Camera/outdoor2/DSC02426.JPG,char_data/대/DSC02426.JPG_2.jpg,1840,480,640,46,524,570,10,50,True,55
대,118,kaist_dataset/Korean/Digital_Camera/outdoor2/DSC02464.JPG,char_data/대/DSC02464.JPG_2.jpg,10148,480,640,86,539,625,185,303,True,55
대,120,kaist_dataset/Korean/Digital_Camera/outdoor2/DSC02488.JPG,char_data/대/DSC02488.JPG_2.jpg,14160,480,640,118,39,157,295,415,True,55
대,219,kaist_dataset/Korean/Digital_Camera/outdoor3/DSC02550.JPG,char_data/대/DSC02550.JPG_2.jpg,48618,480,640,222,345,567,190,409,True,55
대,53,kaist_dataset/Korean/Digital_Camera/outdoor3/DSC02686.JPG,char_data/대/DSC02686.JPG_2.jpg,1961,480,640,37,5,42,54,107,True,55
대,161,kaist_dataset/Korean/Digital_Camera/outdoor3/DSC03157.JPG,char_data/대/DSC03157.JPG_2.jpg,18998,480,640,118,482,600,90,251,True,55
대,118,kaist_dataset/Korean/Digital_Camera/outdoor3/DSC03158.JPG,char_data/대/DSC03158.JPG_2.jpg,10266,480,640,87,538,625,244,362,True,55
대,81,kaist_dataset/Korean/Digital_Camera/outdoor3/DSC03251.JPG,char_data/대/DSC03251.JPG_2.jpg,4212,480,640,52,171,223,270,351,True,55
대,100,kaist_dataset/Korean/Digital_Camera/outdoor4/DSC03252.JPG,char_data/대/DSC03252.JPG_2.jpg,15900,480,640,159,289,448,312,412,True,55
대,47,kaist_dataset/Korean/Digital_Camera/outdoor4/DSC03261.JPG,char_data/대/DSC03261.JPG_2.jpg,2068,480,640,44,113,157,391,438,True,55
대,36,kaist_dataset/Korean/Digital_Camera/outdoor4/DSC03326.JPG,char_data/대/DSC03326.JPG_2.jpg,900,480,640,25,497,522,221,257,True,55
대,50,kaist_dataset/Korean/Digital_Camera/outdoor4/DSC03419.JPG,char_data/대/DSC03419.JPG_2.jpg,2750,480,640,55,26,81,212,262,True,55
대,78,kaist_dataset/Korean/Digital_Camera/outdoor4/DSC03449.JPG,char_data/대/DSC03449.JPG_2.jpg,3510,480,640,45,198,243,289,367,True,55
대,51,kaist_dataset/Korean/Digital_Camera/outdoor4/DSC03538.JPG,char_data/대/DSC03538.JPG_2.jpg,1377,480,640,27,46,73,110,161,True,55
대,88,kaist_dataset/Korean/Digital_Camera/outdoor4/DSC03542.JPG,char_data/대/DSC03542.JPG_2.jpg,5456,480,640,62,42,104,122,210,True,55
대,96,kaist_dataset/Korean/Digital_Camera/outdoor4/DSC03547.JPG,char_data/대/DSC03547.JPG_2.jpg,10656,480,640,111,307,418,70,166,True,55
대,52,kaist_dataset/Korean/Digital_Camera/outdoor4/DSC03578.JPG,char_data/대/DSC03578.JPG_2.jpg,2340,480,640,45,139,184,227,279,True,55
대,45,kaist_dataset/Korean/Digital_Camera/outdoor4/DSC03588.JPG,char_data/대/DSC03588.JPG_2.jpg,1800,480,640,40,151,191,6,51,True,55
대,67,kaist_dataset/Korean/Digital_Camera/outdoor4/DSC03592.JPG,char_data/대/DSC03592.JPG_2.jpg,3886,480,640,58,336,394,303,370,True,55
대,76,kaist_dataset/Korean/Digital_Camera/outdoor4/DSC03594.JPG,char_data/대/DSC03594.JPG_2.jpg,4560,480,640,60,299,359,99,175,True,55
대,58,kaist_dataset/Korean/Digital_Camera/outdoor4/DSC03596.JPG,char_data/대/DSC03596.JPG_2.jpg,3016,480,640,52,95,147,138,196,True,55
대,77,kaist_dataset/Korean/Digital_Camera/outdoor4/DSC03597.JPG,char_data/대/DSC03597.JPG_2.jpg,5467,480,640,71,211,282,80,157,True,55
대,84,kaist_dataset/Korean/Digital_Camera/outdoor4/DSC03610.JPG,char_data/대/DSC03610.JPG_2.jpg,6468,480,640,77,47,124,21,105,True,55
대,70,kaist_dataset/Korean/Digital_Camera/outdoor4/DSC03612.JPG,char_data/대/DSC03612.JPG_2.jpg,3710,480,640,53,34,87,31,101,True,55
대,73,kaist_dataset/Korean/Digital_Camera/outdoor4/DSC03619.JPG,char_data/대/DSC03619.JPG_2.jpg,5183,480,640,71,155,226,387,460,True,55
대,52,kaist_dataset/Korean/Digital_Camera/outdoor5/DSC03632.JPG,char_data/대/DSC03632.JPG_2.jpg,2756,480,640,53,441,494,182,234,True,55
대,82,kaist_dataset/Korean/Digital_Camera/outdoor5/DSC03645.JPG,char_data/대/DSC03645.JPG_2.jpg,3116,480,640,38,35,73,205,287,True,55
대,87,kaist_dataset/Korean/Digital_Camera/outdoor5/DSC03659.JPG,char_data/대/DSC03659.JPG_2.jpg,6351,480,640,73,231,304,212,299,True,55
대,63,kaist_dataset/Korean/Digital_Camera/outdoor5/DSC03681.JPG,char_data/대/DSC03681.JPG_2.jpg,2709,480,640,43,278,321,353,416,True,55
대,129,kaist_dataset/Korean/Digital_Camera/outdoor5/DSC03683.JPG,char_data/대/DSC03683.JPG_4.jpg,12513,480,640,97,276,373,106,235,True,55
대,47,kaist_dataset/Korean/Digital_Camera/outdoor5/DSC03683.JPG,char_data/대/DSC03683.JPG_5.jpg,1974,480,640,42,338,380,51,98,True,55
대,39,kaist_dataset/Korean/Digital_Camera/outdoor5/DSC03692.JPG,char_data/대/DSC03692.JPG_2.jpg,897,480,640,23,296,319,178,217,True,55
대,79,kaist_dataset/Korean/Digital_Camera/outdoor5/DSC03739.JPG,char_data/대/DSC03739.JPG_4.jpg,4740,480,640,60,362,422,170,249,True,55
대,73,kaist_dataset/Korean/Digital_Camera/outdoor5/DSC03739.JPG,char_data/대/DSC03739.JPG_5.jpg,4453,480,640,61,107,168,374,447,True,55
대,60,kaist_dataset/Korean/Digital_Camera/outdoor5/DSC03740.JPG,char_data/대/DSC03740.JPG_2.jpg,3240,480,640,54,85,139,211,271,True,55
대,56,kaist_dataset/Korean/Digital_Camera/outdoor5/DSC03749.JPG,char_data/대/DSC03749.JPG_2.jpg,1904,480,640,34,215,249,87,143,True,55
대,36,kaist_dataset/Korean/Digital_Camera/outdoor5/DSC03853.JPG,char_data/대/DSC03853.JPG_2.jpg,864,480,640,24,444,468,116,152,True,55
대,104,kaist_dataset/Korean/Digital_Camera/outdoor5/DSC03858.JPG,char_data/대/DSC03858.JPG_2.jpg,11232,480,640,108,299,407,287,391,True,55
대,59,kaist_dataset/Korean/Digital_Camera/outdoor5/DSC03864.JPG,char_data/대/DSC03864.JPG_2.jpg,3540,480,640,60,44,104,195,254,True,55
대,38,kaist_dataset/Korean/Digital_Camera/outdoor5/DSC04038.JPG,char_data/대/DSC04038.JPG_2.jpg,1406,480,640,37,109,146,209,247,True,55
대,46,kaist_dataset/Korean/Digital_Camera/outdoor6/DSC04043.JPG,char_data/대/DSC04043.JPG_6.jpg,966,480,640,21,192,213,218,264,True,55
대,47,kaist_dataset/Korean/Digital_Camera/outdoor6/DSC04043.JPG,char_data/대/DSC04043.JPG_7.jpg,893,480,640,19,362,381,224,271,True,55
대,53,kaist_dataset/Korean/Digital_Camera/outdoor6/DSC04043.JPG,char_data/대/DSC04043.JPG_8.jpg,1219,480,640,23,538,561,221,274,True,55
대,69,kaist_dataset/Korean/Digital_Camera/outdoor6/DSC04074.JPG,char_data/대/DSC04074.JPG_2.jpg,4002,480,640,58,19,77,26,95,True,55
대,29,kaist_dataset/Korean/Digital_Camera/outdoor6/DSC04077.JPG,char_data/대/DSC04077.JPG_2.jpg,870,480,640,30,208,238,189,218,True,55
대,85,kaist_dataset/Korean/Digital_Camera/outdoor6/DSC04085.JPG,char_data/대/DSC04085.JPG_2.jpg,5525,480,640,65,148,213,249,334,True,55
대,82,kaist_dataset/Korean/Digital_Camera/outdoor6/DSC04089.JPG,char_data/대/DSC04089.JPG_2.jpg,4346,480,640,53,347,400,183,265,True,55
대,39,kaist_dataset/Korean/Digital_Camera/outdoor6/DSC04099.JPG,char_data/대/DSC04099.JPG_2.jpg,1365,480,640,35,185,220,171,210,True,55
대,39,kaist_dataset/Korean/Digital_Camera/outdoor6/DSC04116.JPG,char_data/대/DSC04116.JPG_2.jpg,1287,480,640,33,194,227,175,214,True,55
대,132,kaist_dataset/Korean/Digital_Camera/outdoor6/DSC04118.JPG,char_data/대/DSC04118.JPG_2.jpg,17424,480,640,132,388,520,57,189,True,55
대,80,kaist_dataset/Korean/Digital_Camera/outdoor6/DSC04295.JPG,char_data/대/DSC04295.JPG_2.jpg,6320,480,640,79,360,439,109,189,True,55
대,104,kaist_dataset/Korean/Digital_Camera/outdoor6/DSC04296.JPG,char_data/대/DSC04296.JPG_2.jpg,5512,480,640,53,395,448,99,203,True,55
대,92,kaist_dataset/Korean/Digital_Camera/outdoor6/DSC04308.JPG,char_data/대/DSC04308.JPG_2.jpg,7268,480,640,79,115,194,279,371,True,55
대,79,kaist_dataset/Korean/Digital_Camera/outdoor6/DSC04341.JPG,char_data/대/DSC04341.JPG_2.jpg,5846,480,640,74,111,185,151,230,True,55
대,50,kaist_dataset/Korean/Digital_Camera/outdoor6/DSC04344.JPG,char_data/대/DSC04344.JPG_2.jpg,2850,480,640,57,2,59,192,242,True,55
대,73,kaist_dataset/Korean/Digital_Camera/outdoor6/DSC04363.JPG,char_data/대/DSC04363.JPG_2.jpg,4672,480,640,64,49,113,180,253,True,55
대,54,kaist_dataset/Korean/Digital_Camera/outdoor6/DSC04398.JPG,char_data/대/DSC04398.JPG_2.jpg,2430,480,640,45,402,447,376,430,True,55
대,76,kaist_dataset/Korean/Digital_Camera/outdoor6/DSC04445.JPG,char_data/대/DSC04445.JPG_4.jpg,4788,480,640,63,236,299,168,244,True,55
대,73,kaist_dataset/Korean/Digital_Camera/outdoor6/DSC04445.JPG,char_data/대/DSC04445.JPG_5.jpg,4380,480,640,60,239,299,93,166,True,55
대,153,kaist_dataset/Korean/Digital_Camera/outdoor7/DSC04452.JPG,char_data/대/DSC04452.JPG_2.jpg,19584,480,640,128,401,529,284,437,True,55
대,86,kaist_dataset/Korean/Digital_Camera/outdoor7/DSC04457.JPG,char_data/대/DSC04457.JPG_2.jpg,4558,480,640,53,59,112,206,292,True,55
대,87,kaist_dataset/Korean/Digital_Camera/outdoor7/P1010001.JPG,char_data/대/P1010001.JPG_2.jpg,8613,480,640,99,525,624,118,205,True,55
대,46,kaist_dataset/Korean/Digital_Camera/outdoor7/P1010009.JPG,char_data/대/P1010009.JPG_4.jpg,2208,480,640,48,372,420,83,129,True,55
대,72,kaist_dataset/Korean/Digital_Camera/outdoor7/P1010009.JPG,char_data/대/P1010009.JPG_5.jpg,5400,480,640,75,39,114,151,223,True,55
대,83,kaist_dataset/Korean/Digital_Camera/outdoor7/P1010017.JPG,char_data/대/P1010017.JPG_2.jpg,2324,480,640,28,176,204,352,435,True,55
대,112,kaist_dataset/Korean/Digital_Camera/outdoor7/P1010021.JPG,char_data/대/P1010021.JPG_2.jpg,16576,480,640,148,372,520,133,245,True,55
대,132,kaist_dataset/Korean/Digital_Camera/outdoor7/P1010031.JPG,char_data/대/P1010031.JPG_2.jpg,10560,480,640,80,16,96,75,207,True,55
대,84,kaist_dataset/Korean/Digital_Camera/outdoor7/P1010032.JPG,char_data/대/P1010032.JPG_2.jpg,5124,480,640,61,24,85,219,303,True,55
대,91,kaist_dataset/Korean/Digital_Camera/outdoor7/P1010037.JPG,char_data/대/P1010037.JPG_2.jpg,7553,480,640,83,492,575,134,225,True,55
대,57,kaist_dataset/Korean/Digital_Camera/outdoor7/P1010075.JPG,char_data/대/P1010075.JPG_2.jpg,3819,480,640,67,373,440,182,239,True,55
대,86,kaist_dataset/Korean/Digital_Camera/outdoor7/P1010076.JPG,char_data/대/P1010076.JPG_2.jpg,7912,480,640,92,296,388,189,275,True,55
대,119,kaist_dataset/Korean/Digital_Camera/outdoor7/P1010085.JPG,char_data/대/P1010085.JPG_2.jpg,16065,480,640,135,116,251,135,254,True,55
대,25,kaist_dataset/Korean/Digital_Camera/outdoor7/P1010107.JPG,char_data/대/P1010107.JPG_2.jpg,725,480,640,29,99,128,64,89,True,55
대,84,kaist_dataset/Korean/Digital_Camera/outdoor7/P1010117.JPG,char_data/대/P1010117.JPG_2.jpg,5712,480,640,68,423,491,106,190,True,55
대,28,kaist_dataset/Korean/Digital_Camera/outdoor7/P1010121.JPG,char_data/대/P1010121.JPG_2.jpg,784,480,640,28,323,351,211,239,True,55
대,40,kaist_dataset/Korean/Digital_Camera/outdoor8/P1010178.JPG,char_data/대/P1010178.JPG_2.jpg,1360,480,640,34,340,374,347,387,True,55
대,134,kaist_dataset/Korean/Digital_Camera/outdoor8/크기변환_P1010005.JPG,char_data/대/크기변환_P1010005.JPG_2.jpg,20904,480,640,156,245,401,104,238,True,55
대,79,"kaist_dataset/Korean/Mobile_Phone/(M,K)C-outdoor/P090912044.jpg",char_data/대/P090912044.jpg_2.jpg,5688,480,640,72,7,79,123,202,True,55
대,96,"kaist_dataset/Korean/Mobile_Phone/(M,K)E-bookCover/P090831035.jpg",char_data/대/P090831035.jpg_2.jpg,6336,480,640,66,101,167,32,128,True,55
대,71,"kaist_dataset/Korean/Mobile_Phone/(M,K)E-bookCover/P090831081.jpg",char_data/대/P090831081.jpg_2.jpg,4047,480,640,57,291,348,31,102,True,55
대,113,"kaist_dataset/Korean/Mobile_Phone/(M,K)E-bookCover/P090831102.jpg",char_data/대/P090831102.jpg_2.jpg,10961,480,640,97,142,239,37,150,True,55
대,105,"kaist_dataset/Korean/Mobile_Phone/(M,K)E-bookCover/P090831105.jpg",char_data/대/P090831105.jpg_2.jpg,7350,480,640,70,3,73,104,209,True,55
대,121,"kaist_dataset/Korean/Mobile_Phone/(M,K)E-bookCover/P090831130.jpg",char_data/대/P090831130.jpg_2.jpg,8712,480,640,72,524,596,196,317,True,55
대,52,"kaist_dataset/Korean/Mobile_Phone/(M,K)E-bookCover/P090831132.jpg",char_data/대/P090831132.jpg_2.jpg,2028,480,640,39,122,161,214,266,True,55
대,65,kaist_dataset/Mixed/Digital_Camera/(C.S)A-shadow/DSC04326.JPG,char_data/대/DSC04326.JPG_2.jpg,3315,480,640,51,51,102,17,82,True,55
대,65,kaist_dataset/Mixed/Digital_Camera/(C.S)A-shadow/P090912075.jpg,char_data/대/P090912075.jpg_2.jpg,4940,480,640,76,161,237,66,131,True,55
대,27,kaist_dataset/Mixed/Digital_Camera/(C.S)C-outdoor1/027.JPG,char_data/대/027.JPG_2.jpg,378,480,640,14,326,340,274,301,True,55
대,185,kaist_dataset/Mixed/Digital_Camera/(C.S)C-outdoor1/080118-0007.jpg,char_data/대/080118-0007.jpg_2.jpg,23125,1200,1600,125,848,973,182,367,True,55
대,107,kaist_dataset/Mixed/Digital_Camera/(C.S)C-outdoor1/080119-0008.jpg,char_data/대/080119-0008.jpg_2.jpg,7490,1200,1600,70,643,713,346,453,True,55
대,101,kaist_dataset/Mixed/Digital_Camera/(C.S)C-outdoor1/115.JPG,char_data/대/115.JPG_2.jpg,10908,480,640,108,214,322,164,265,True,55
대,47,kaist_dataset/Mixed/Digital_Camera/(C.S)C-outdoor1/2007-12-08-day-130.jpg,char_data/대/2007-12-08-day-130.jpg_2.jpg,940,1200,1600,20,282,302,463,510,True,55
대,25,kaist_dataset/Mixed/Digital_Camera/(C.S)C-outdoor1/48.JPG,char_data/대/48.JPG_2.jpg,550,576,768,22,98,120,338,363,True,55
대,137,kaist_dataset/Mixed/Digital_Camera/(C.S)C-outdoor1/56.JPG,char_data/대/56.JPG_4.jpg,14248,576,768,104,19,123,222,359,True,55
대,40,kaist_dataset/Mixed/Digital_Camera/(C.S)C-outdoor1/56.JPG,char_data/대/56.JPG_5.jpg,1040,576,768,26,599,625,296,336,True,55
대,57,kaist_dataset/Mixed/Digital_Camera/(C.S)C-outdoor1/57.JPG,char_data/대/57.JPG_2.jpg,2451,500,766,43,612,655,388,445,True,55
대,46,kaist_dataset/Mixed/Digital_Camera/(C.S)C-outdoor1/DSC02320.JPG,char_data/대/DSC02320.JPG_4.jpg,1518,480,640,33,188,221,348,394,True,55
대,39,kaist_dataset/Mixed/Digital_Camera/(C.S)C-outdoor1/DSC02320.JPG,char_data/대/DSC02320.JPG_5.jpg,1326,480,640,34,467,501,349,388,True,55
대,35,kaist_dataset/Mixed/Digital_Camera/(C.S)C-outdoor1/DSC02349.JPG,char_data/대/DSC02349.JPG_2.jpg,980,480,640,28,492,520,198,233,True,55
대,43,kaist_dataset/Mixed/Digital_Camera/(C.S)C-outdoor2/DSC02376.JPG,char_data/대/DSC02376.JPG_2.jpg,1462,480,640,34,259,293,337,380,True,55
대,31,kaist_dataset/Mixed/Digital_Camera/(C.S)C-outdoor2/DSC02397.JPG,char_data/대/DSC02397.JPG_2.jpg,837,480,640,27,353,380,209,240,True,55
대,101,kaist_dataset/Mixed/Digital_Camera/(C.S)C-outdoor2/DSC02422.JPG,char_data/대/DSC02422.JPG_2.jpg,6060,480,640,60,122,182,93,194,True,55
대,37,kaist_dataset/Mixed/Digital_Camera/(C.S)C-outdoor2/DSC02460.JPG,char_data/대/DSC02460.JPG_2.jpg,1184,480,640,32,133,165,304,341,True,55
대,40,kaist_dataset/Mixed/Digital_Camera/(C.S)C-outdoor2/DSC02503.JPG,char_data/대/DSC02503.JPG_4.jpg,1640,480,640,41,184,225,39,79,True,55
대,165,kaist_dataset/Mixed/Digital_Camera/(C.S)C-outdoor2/DSC02503.JPG,char_data/대/DSC02503.JPG_5.jpg,20790,480,640,126,61,187,138,303,True,55
대,44,kaist_dataset/Mixed/Digital_Camera/(C.S)C-outdoor2/DSC02543.JPG,char_data/대/DSC02543.JPG_2.jpg,1628,480,640,37,55,92,327,371,True,55
대,88,kaist_dataset/Mixed/Digital_Camera/(C.S)C-outdoor2/DSC02877.JPG,char_data/대/DSC02877.JPG_2.jpg,4928,480,640,56,42,98,137,225,True,55
대,34,kaist_dataset/Mixed/Digital_Camera/(C.S)C-outdoor2/DSC02917.JPG,char_data/대/DSC02917.JPG_2.jpg,1088,480,640,32,391,423,224,258,True,55
대,31,kaist_dataset/Mixed/Digital_Camera/(C.S)C-outdoor2/DSC02936.JPG,char_data/대/DSC02936.JPG_2.jpg,930,480,640,30,405,435,227,258,True,55
대,46,kaist_dataset/Mixed/Digital_Camera/(C.S)C-outdoor3/DSC02956.JPG,char_data/대/DSC02956.JPG_2.jpg,1748,480,640,38,367,405,400,446,True,55
대,42,kaist_dataset/Mixed/Digital_Camera/(C.S)C-outdoor3/DSC03055.JPG,char_data/대/DSC03055.JPG_2.jpg,1176,480,640,28,194,222,217,259,True,55
대,48,kaist_dataset/Mixed/Digital_Camera/(C.S)C-outdoor3/DSC03177.JPG,char_data/대/DSC03177.JPG_2.jpg,1632,480,640,34,412,446,207,255,True,55
대,63,kaist_dataset/Mixed/Digital_Camera/(C.S)C-outdoor3/DSC03185.JPG,char_data/대/DSC03185.JPG_2.jpg,5103,480,640,81,58,139,80,143,True,55
대,105,kaist_dataset/Mixed/Digital_Camera/(C.S)C-outdoor3/DSC03212.JPG,char_data/대/DSC03212.JPG_2.jpg,10290,480,640,98,65,163,108,213,True,55
대,67,kaist_dataset/Mixed/Digital_Camera/(C.S)C-outdoor3/DSC03234.JPG,char_data/대/DSC03234.JPG_2.jpg,4623,480,640,69,24,93,121,188,True,55
대,36,kaist_dataset/Mixed/Digital_Camera/(C.S)C-outdoor3/DSC03236.JPG,char_data/대/DSC03236.JPG_2.jpg,864,480,640,24,475,499,427,463,True,55
대,43,kaist_dataset/Mixed/Digital_Camera/(C.S)C-outdoor3/DSC03259.JPG,char_data/대/DSC03259.JPG_2.jpg,1419,480,640,33,106,139,341,384,True,55
대,74,kaist_dataset/Mixed/Digital_Camera/(C.S)C-outdoor3/DSC03269.JPG,char_data/대/DSC03269.JPG_2.jpg,7104,480,640,96,220,316,197,271,True,55
대,63,kaist_dataset/Mixed/Digital_Camera/(C.S)C-outdoor3/DSC03314.JPG,char_data/대/DSC03314.JPG_2.jpg,3024,480,640,48,107,155,97,160,True,55
대,65,kaist_dataset/Mixed/Digital_Camera/(C.S)C-outdoor3/DSC03316.JPG,char_data/대/DSC03316.JPG_2.jpg,3965,480,640,61,78,139,15,80,True,55
대,40,kaist_dataset/Mixed/Digital_Camera/(C.S)C-outdoor4/DSC03531.JPG,char_data/대/DSC03531.JPG_4.jpg,1600,480,640,40,105,145,427,467,True,55
대,58,kaist_dataset/Mixed/Digital_Camera/(C.S)C-outdoor4/DSC03531.JPG,char_data/대/DSC03531.JPG_5.jpg,3248,480,640,56,201,257,415,473,True,55
대,51,kaist_dataset/Mixed/Digital_Camera/(C.S)C-outdoor4/DSC03556.JPG,char_data/대/DSC03556.JPG_2.jpg,1734,480,640,34,38,72,250,301,False,55
대,58,kaist_dataset/Mixed/Digital_Camera/(C.S)C-outdoor4/DSC03604.JPG,char_data/대/DSC03604.JPG_2.jpg,2610,480,640,45,355,400,271,329,False,55
대,50,kaist_dataset/Mixed/Digital_Camera/(C.S)C-outdoor4/DSC03613.JPG,char_data/대/DSC03613.JPG_2.jpg,2000,480,640,40,46,86,27,77,False,55
대,78,kaist_dataset/Mixed/Digital_Camera/(C.S)C-outdoor4/DSC03631.JPG,char_data/대/DSC03631.JPG_2.jpg,2574,480,640,33,46,79,172,250,False,55
대,107,kaist_dataset/Mixed/Digital_Camera/(C.S)C-outdoor4/DSC03633.JPG,char_data/대/DSC03633.JPG_2.jpg,7276,480,640,68,27,95,149,256,False,55
대,42,kaist_dataset/Mixed/Digital_Camera/(C.S)C-outdoor4/DSC03642.JPG,char_data/대/DSC03642.JPG_2.jpg,1092,480,640,26,358,384,352,394,False,55
대,57,kaist_dataset/Mixed/Digital_Camera/(C.S)C-outdoor4/DSC03662.JPG,char_data/대/DSC03662.JPG_2.jpg,1767,480,640,31,124,155,150,207,False,55
대,83,kaist_dataset/Mixed/Digital_Camera/(C.S)C-outdoor4/DSC03665.JPG,char_data/대/DSC03665.JPG_2.jpg,8300,480,640,100,91,191,67,150,False,55
대,33,kaist_dataset/Mixed/Digital_Camera/(C.S)C-outdoor4/DSC03677.JPG,char_data/대/DSC03677.JPG_2.jpg,726,480,640,22,472,494,283,316,False,55
대,46,kaist_dataset/Mixed/Digital_Camera/(C.S)C-outdoor4/DSC03678.JPG,char_data/대/DSC03678.JPG_2.jpg,1426,480,640,31,310,341,240,286,False,55
대,28,kaist_dataset/Mixed/Digital_Camera/(C.S)C-outdoor5/DSC03822.JPG,char_data/대/DSC03822.JPG_4.jpg,756,480,640,27,482,509,149,177,False,55
대,28,kaist_dataset/Mixed/Digital_Camera/(C.S)C-outdoor5/DSC03822.JPG,char_data/대/DSC03822.JPG_5.jpg,476,480,640,17,525,542,150,178,False,55
대,34,kaist_dataset/Mixed/Digital_Camera/(C.S)C-outdoor5/DSC03823.JPG,char_data/대/DSC03823.JPG_4.jpg,1020,480,640,30,441,471,168,202,False,55
대,35,kaist_dataset/Mixed/Digital_Camera/(C.S)C-outdoor5/DSC03823.JPG,char_data/대/DSC03823.JPG_5.jpg,770,480,640,22,494,516,167,202,False,55
대,62,kaist_dataset/Mixed/Digital_Camera/(C.S)C-outdoor5/DSC04015.JPG,char_data/대/DSC04015.JPG_2.jpg,3162,480,640,51,415,466,171,233,False,55
대,97,kaist_dataset/Mixed/Digital_Camera/(C.S)C-outdoor5/DSC04016.JPG,char_data/대/DSC04016.JPG_2.jpg,5626,480,640,58,531,589,9,106,False,55
대,75,kaist_dataset/Mixed/Digital_Camera/(C.S)C-outdoor5/DSC04017.JPG,char_data/대/DSC04017.JPG_2.jpg,4500,480,640,60,454,514,343,418,False,55
대,112,kaist_dataset/Mixed/Digital_Camera/(C.S)C-outdoor5/DSC04029.JPG,char_data/대/DSC04029.JPG_4.jpg,9520,480,640,85,474,559,51,163,False,55
대,38,kaist_dataset/Mixed/Digital_Camera/(C.S)C-outdoor5/DSC04029.JPG,char_data/대/DSC04029.JPG_5.jpg,1520,480,640,40,138,178,245,283,False,55
대,54,kaist_dataset/Mixed/Digital_Camera/(C.S)C-outdoor5/DSC04031.JPG,char_data/대/DSC04031.JPG_2.jpg,5022,480,640,93,168,261,330,384,False,55
대,76,kaist_dataset/Mixed/Digital_Camera/(C.S)C-outdoor5/DSC04091.JPG,char_data/대/DSC04091.JPG_2.jpg,3648,480,640,48,67,115,244,320,False,55
대,57,kaist_dataset/Mixed/Digital_Camera/(C.S)C-outdoor5/DSC04094.JPG,char_data/대/DSC04094.JPG_2.jpg,2622,480,640,46,131,177,190,247,False,55
대,35,kaist_dataset/Mixed/Digital_Camera/(C.S)C-outdoor5/DSC04115.JPG,char_data/대/DSC04115.JPG_2.jpg,1330,480,640,38,158,196,361,396,False,55
대,62,kaist_dataset/Mixed/Digital_Camera/(C.S)C-outdoor5/DSC04139.JPG,char_data/대/DSC04139.JPG_2.jpg,1364,480,640,22,348,370,322,384,False,55
대,109,kaist_dataset/Mixed/Digital_Camera/(C.S)C-outdoor5/DSC04290.JPG,char_data/대/DSC04290.JPG_2.jpg,6649,480,640,61,263,324,64,173,False,55
대,72,kaist_dataset/Mixed/Digital_Camera/(C.S)C-outdoor5/DSC04321.JPG,char_data/대/DSC04321.JPG_2.jpg,5112,480,640,71,276,347,118,190,False,55
대,79,kaist_dataset/Mixed/Digital_Camera/(C.S)C-outdoor5/DSC04322.JPG,char_data/대/DSC04322.JPG_2.jpg,5688,480,640,72,165,237,125,204,False,55
대,73,kaist_dataset/Mixed/Digital_Camera/(C.S)C-outdoor5/DSC04323.JPG,char_data/대/DSC04323.JPG_2.jpg,4818,480,640,66,261,327,122,195,False,55
대,74,kaist_dataset/Mixed/Digital_Camera/(C.S)C-outdoor5/DSC04449.JPG,char_data/대/DSC04449.JPG_2.jpg,3478,480,640,47,260,307,218,292,False,55
대,73,kaist_dataset/Mixed/Digital_Camera/(C.S)C-outdoor5/DSC04450.JPG,char_data/대/DSC04450.JPG_2.jpg,4088,480,640,56,182,238,132,205,False,55
대,154,kaist_dataset/Mixed/Digital_Camera/(C.S)C-outdoor5/DSC04451.JPG,char_data/대/DSC04451.JPG_2.jpg,20328,480,640,132,388,520,48,202,False,55
대,81,kaist_dataset/Mixed/Digital_Camera/(C.S)C-outdoor6/P1010045.JPG,char_data/대/P1010045.JPG_4.jpg,5427,480,640,67,213,280,60,141,False,55
대,38,kaist_dataset/Mixed/Digital_Camera/(C.S)C-outdoor6/P1010045.JPG,char_data/대/P1010045.JPG_5.jpg,1064,480,640,28,407,435,404,442,False,55
대,61,kaist_dataset/Mixed/Digital_Camera/(C.S)C-outdoor6/P1010067.JPG,char_data/대/P1010067.JPG_2.jpg,4819,480,640,79,17,96,185,246,False,55
대,77,kaist_dataset/Mixed/Digital_Camera/(C.S)C-outdoor6/P1010098.JPG,char_data/대/P1010098.JPG_2.jpg,6853,480,640,89,74,163,303,380,False,55
대,73,kaist_dataset/Mixed/Digital_Camera/(C.S)D-indoor1/DSC02772.JPG,char_data/대/DSC02772.JPG_2.jpg,3723,480,640,51,261,312,285,358,False,55
대,55,kaist_dataset/Mixed/Digital_Camera/(C.S)D-indoor1/DSC03094.JPG,char_data/대/DSC03094.JPG_2.jpg,3850,480,640,70,106,176,82,137,False,55
대,78,kaist_dataset/Mixed/Digital_Camera/(C.S)D-indoor1/DSC03095.JPG,char_data/대/DSC03095.JPG_2.jpg,4680,480,640,60,174,234,239,317,False,55
대,103,kaist_dataset/Mixed/Digital_Camera/(C.S)D-indoor1/DSC03980.JPG,char_data/대/DSC03980.JPG_2.jpg,8961,480,640,87,157,244,31,134,False,55
대,70,kaist_dataset/Mixed/Digital_Camera/(C.S)D-indoor2/DSC04254.JPG,char_data/대/DSC04254.JPG_2.jpg,3500,480,640,50,187,237,269,339,False,55
대,109,kaist_dataset/Mixed/Digital_Camera/(C.S)D-indoor2/DSC04256.JPG,char_data/대/DSC04256.JPG_2.jpg,10682,480,640,98,61,159,55,164,False,55
대,87,kaist_dataset/Mixed/Digital_Camera/(C.S)D-indoor2/DSC04409.JPG,char_data/대/DSC04409.JPG_2.jpg,3480,480,640,40,144,184,149,236,False,55
대,215,kaist_dataset/Mixed/Digital_Camera/(C.S)F-others/2007-12-09-day-exterior-023.jpg,char_data/대/2007-12-09-day-exterior-023.jpg_2.jpg,49450,1200,1600,230,1275,1505,417,632,False,55
L,95,kaist_dataset/English/Digital_Camera/(E.S)A-shadow/DSC02633.JPG,char_data/L/DSC02633.JPG_2.jpg,6175,480,640,65,13,78,175,270,True,22
L,52,kaist_dataset/English/Digital_Camera/(E.S)A-shadow/DSC03075.JPG,char_data/L/DSC03075.JPG_8.jpg,1508,480,640,29,308,337,350,402,True,22
L,38,kaist_dataset/English/Digital_Camera/(E.S)A-shadow/P1010044.JPG,char_data/L/P1010044.JPG_2.jpg,1102,480,640,29,403,432,355,393,True,22
L,106,kaist_dataset/English/Digital_Camera/(E.S)B-light/080116-0053.jpg,char_data/L/080116-0053.jpg_2.jpg,6572,600,800,62,608,670,224,330,True,22
L,25,kaist_dataset/English/Digital_Camera/(E.S)B-light/080116-0059.jpg,char_data/L/080116-0059.jpg_6.jpg,275,1200,1600,11,1103,1114,825,850,True,22
L,23,kaist_dataset/English/Digital_Camera/(E.S)B-light/080116-0059.jpg,char_data/L/080116-0059.jpg_7.jpg,437,1200,1600,19,536,555,804,827,True,22
L,30,kaist_dataset/English/Digital_Camera/(E.S)B-light/080116-0059.jpg,char_data/L/080116-0059.jpg_8.jpg,360,1200,1600,12,815,827,798,828,True,22
L,55,kaist_dataset/English/Digital_Camera/(E.S)B-light/DSC02712.JPG,char_data/L/DSC02712.JPG_2.jpg,1045,480,640,19,340,359,217,272,True,22
L,25,kaist_dataset/English/Digital_Camera/(E.S)B-light/x.jpg,char_data/L/x.jpg_2.jpg,425,240,320,17,186,203,104,129,True,22
L,102,kaist_dataset/English/Digital_Camera/(E.S)B-light/크기변환_%B0%A3%C6%C7_ktimt007.jpg,char_data/L/크기변환_%B0%A3%C6%C7_ktimt007.jpg_2.jpg,4896,480,640,48,476,524,208,310,True,22
L,64,kaist_dataset/English/Digital_Camera/(E.S)C-outdoor1/026.JPG,char_data/L/026.JPG_2.jpg,2176,480,640,34,247,281,203,267,True,22
L,65,kaist_dataset/English/Digital_Camera/(E.S)C-outdoor1/055.JPG,char_data/L/055.JPG_2.jpg,3510,480,640,54,428,482,192,257,True,22
L,23,kaist_dataset/English/Digital_Camera/(E.S)C-outdoor1/056.JPG,char_data/L/056.JPG_5.jpg,276,480,640,12,215,227,242,265,True,22
L,22,kaist_dataset/English/Digital_Camera/(E.S)C-outdoor1/077.JPG,char_data/L/077.JPG_5.jpg,308,480,640,14,389,403,253,275,True,22
L,68,kaist_dataset/English/Digital_Camera/(E.S)C-outdoor1/080.jpg,char_data/L/080.jpg_2.jpg,3060,253,350,45,72,117,79,147,True,22
L,85,kaist_dataset/English/Digital_Camera/(E.S)C-outdoor1/080116-0064.jpg,char_data/L/080116-0064.jpg_2.jpg,3655,600,800,43,311,354,225,310,True,22
L,44,kaist_dataset/English/Digital_Camera/(E.S)C-outdoor1/080116-0065.jpg,char_data/L/080116-0065.jpg_8.jpg,1232,600,800,28,521,549,204,248,True,22
L,47,kaist_dataset/English/Digital_Camera/(E.S)C-outdoor1/080116-0065.jpg,char_data/L/080116-0065.jpg_9.jpg,1316,600,800,28,551,579,203,250,True,22
L,43,kaist_dataset/English/Digital_Camera/(E.S)C-outdoor1/080116-0065.jpg,char_data/L/080116-0065.jpg_10.jpg,1118,600,800,26,349,375,331,374,True,22
L,44,kaist_dataset/English/Digital_Camera/(E.S)C-outdoor1/080116-0065.jpg,char_data/L/080116-0065.jpg_11.jpg,1100,600,800,25,376,401,332,376,True,22
L,65,kaist_dataset/English/Digital_Camera/(E.S)C-outdoor1/080118-0011.jpg,char_data/L/080118-0011.jpg_2.jpg,3055,1200,1600,47,1036,1083,930,995,True,22
L,56,kaist_dataset/English/Digital_Camera/(E.S)C-outdoor1/080119-0012.jpg,char_data/L/080119-0012.jpg_5.jpg,1344,1200,1600,24,631,655,581,637,True,22
L,385,kaist_dataset/English/Digital_Camera/(E.S)C-outdoor1/080120-0001.jpg,char_data/L/080120-0001.jpg_2.jpg,139370,1200,1600,362,46,408,475,860,True,22
L,90,kaist_dataset/English/Digital_Camera/(E.S)C-outdoor1/083.JPG,char_data/L/083.JPG_2.jpg,6120,480,640,68,477,545,166,256,True,22
L,54,kaist_dataset/English/Digital_Camera/(E.S)C-outdoor1/089.jpg,char_data/L/089.jpg_2.jpg,1620,480,640,30,99,129,285,339,True,22
L,170,kaist_dataset/English/Digital_Camera/(E.S)C-outdoor1/100.JPG,char_data/L/100.JPG_5.jpg,20060,480,640,118,61,179,230,400,True,22
L,153,kaist_dataset/English/Digital_Camera/(E.S)C-outdoor1/142.JPG,char_data/L/142.JPG_2.jpg,13311,480,640,87,301,388,195,348,True,22
L,123,kaist_dataset/English/Digital_Camera/(E.S)C-outdoor1/2007-12-09-day-exterior-056.jpg,char_data/L/2007-12-09-day-exterior-056.jpg_2.jpg,7503,1200,1600,61,674,735,504,627,True,22
L,138,kaist_dataset/English/Digital_Camera/(E.S)C-outdoor1/2007-12-09-day-exterior-063.jpg,char_data/L/2007-12-09-day-exterior-063.jpg_5.jpg,12282,1200,1600,89,616,705,401,539,True,22
L,75,kaist_dataset/English/Digital_Camera/(E.S)C-outdoor1/DSC02243.JPG,char_data/L/DSC02243.JPG_2.jpg,2175,480,640,29,434,463,211,286,True,22
L,93,kaist_dataset/English/Digital_Camera/(E.S)C-outdoor1/DSC02306.JPG,char_data/L/DSC02306.JPG_2.jpg,7161,480,640,77,173,250,147,240,True,22
L,47,kaist_dataset/English/Digital_Camera/(E.S)C-outdoor1/DSC02355.JPG,char_data/L/DSC02355.JPG_2.jpg,1316,480,640,28,188,216,301,348,True,22
L,73,kaist_dataset/English/Digital_Camera/(E.S)C-outdoor1/DSC02364.JPG,char_data/L/DSC02364.JPG_2.jpg,4380,480,640,60,451,511,250,323,True,22
L,84,kaist_dataset/English/Digital_Camera/(E.S)C-outdoor1/DSC02398.JPG,char_data/L/DSC02398.JPG_2.jpg,4368,480,640,52,462,514,221,305,True,22
L,131,kaist_dataset/English/Digital_Camera/(E.S)C-outdoor1/DSC02448.JPG,char_data/L/DSC02448.JPG_2.jpg,12052,480,640,92,125,217,36,167,True,22
L,118,kaist_dataset/English/Digital_Camera/(E.S)C-outdoor1/DSC02500.JPG,char_data/L/DSC02500.JPG_5.jpg,5664,480,640,48,57,105,175,293,True,22
L,44,kaist_dataset/English/Digital_Camera/(E.S)C-outdoor1/DSC02559.JPG,char_data/L/DSC02559.JPG_4.jpg,1188,480,640,27,143,170,122,166,True,22
L,43,kaist_dataset/English/Digital_Camera/(E.S)C-outdoor1/DSC02618.JPG,char_data/L/DSC02618.JPG_2.jpg,559,480,640,13,301,314,170,213,True,22
L,59,kaist_dataset/English/Digital_Camera/(E.S)C-outdoor1/DSC02619.JPG,char_data/L/DSC02619.JPG_2.jpg,2773,480,640,47,446,493,212,271,True,22
L,94,kaist_dataset/English/Digital_Camera/(E.S)C-outdoor1/DSC02897.JPG,char_data/L/DSC02897.JPG_2.jpg,6016,480,640,64,499,563,269,363,True,22
L,184,kaist_dataset/English/Digital_Camera/(E.S)C-outdoor2/DSC02949.JPG,char_data/L/DSC02949.JPG_2.jpg,5520,480,640,30,285,315,62,246,True,22
L,79,kaist_dataset/English/Digital_Camera/(E.S)C-outdoor2/DSC02984.JPG,char_data/L/DSC02984.JPG_2.jpg,3950,480,640,50,455,505,107,186,True,22
L,75,kaist_dataset/English/Digital_Camera/(E.S)C-outdoor2/DSC02993.JPG,char_data/L/DSC02993.JPG_2.jpg,3675,480,640,49,405,454,228,303,True,22
L,76,kaist_dataset/English/Digital_Camera/(E.S)C-outdoor2/DSC03025.JPG,char_data/L/DSC03025.JPG_2.jpg,3192,480,640,42,341,383,127,203,True,22
L,47,kaist_dataset/English/Digital_Camera/(E.S)C-outdoor2/DSC03165.JPG,char_data/L/DSC03165.JPG_2.jpg,2209,480,640,47,195,242,237,284,True,22
L,25,kaist_dataset/English/Digital_Camera/(E.S)C-outdoor2/DSC03208.JPG,char_data/L/DSC03208.JPG_6.jpg,725,480,640,29,143,172,168,193,True,22
L,59,kaist_dataset/English/Digital_Camera/(E.S)C-outdoor2/DSC03412.JPG,char_data/L/DSC03412.JPG_6.jpg,2301,480,640,39,434,473,398,457,True,22
L,61,kaist_dataset/English/Digital_Camera/(E.S)C-outdoor2/DSC03413.JPG,char_data/L/DSC03413.JPG_2.jpg,2562,480,640,42,282,324,201,262,True,22
L,55,kaist_dataset/English/Digital_Camera/(E.S)C-outdoor2/DSC03414.JPG,char_data/L/DSC03414.JPG_2.jpg,2530,480,640,46,114,160,351,406,True,22
L,83,kaist_dataset/English/Digital_Camera/(E.S)C-outdoor2/DSC03705.JPG,char_data/L/DSC03705.JPG_6.jpg,3735,480,640,45,342,387,198,281,True,22
L,84,kaist_dataset/English/Digital_Camera/(E.S)C-outdoor2/DSC03705.JPG,char_data/L/DSC03705.JPG_7.jpg,3528,480,640,42,387,429,198,282,True,22
L,59,kaist_dataset/English/Digital_Camera/(E.S)C-outdoor2/DSC03705.JPG,char_data/L/DSC03705.JPG_8.jpg,3481,480,640,59,144,203,312,371,True,22
L,71,kaist_dataset/English/Digital_Camera/(E.S)C-outdoor2/DSC04080.JPG,char_data/L/DSC04080.JPG_4.jpg,4331,480,640,61,159,220,288,359,True,22
L,38,kaist_dataset/English/Digital_Camera/(E.S)C-outdoor2/DSC04080.JPG,char_data/L/DSC04080.JPG_5.jpg,1368,480,640,36,437,473,354,392,True,22
L,132,kaist_dataset/English/Digital_Camera/(E.S)C-outdoor2/DSC04163.JPG,char_data/L/DSC04163.JPG_6.jpg,15180,480,640,115,303,418,112,244,True,22
L,93,kaist_dataset/English/Digital_Camera/(E.S)C-outdoor3/P1010133.JPG,char_data/L/P1010133.JPG_2.jpg,6696,480,640,72,466,538,151,244,True,22
L,86,kaist_dataset/English/Digital_Camera/(E.S)C-outdoor3/P1010138.JPG,char_data/L/P1010138.JPG_2.jpg,5504,480,640,64,116,180,76,162,True,22
L,94,kaist_dataset/English/Digital_Camera/(E.S)C-outdoor3/r.jpg,char_data/L/r.jpg_2.jpg,4794,240,320,51,177,228,98,192,True,22
L,57,kaist_dataset/English/Digital_Camera/(E.S)C-outdoor3/크기변환_%B0%A3%C6%C718_m_starfirm.jpg,char_data/L/크기변환_%B0%A3%C6%C718_m_starfirm.jpg_2.jpg,2337,480,640,41,465,506,204,261,True,22
L,59,kaist_dataset/English/Digital_Camera/(E.S)C-outdoor3/크기변환_%C8%AD%C0%CC%C6%AE%C4%FE%C6%AE%B0%A3%C6%C7_%BA%B9%BB%E7_1-bona0007.jpg,char_data/L/크기변환_%C8%AD%C0%CC%C6%AE%C4%FE%C6%AE%B0%A3%C6%C7_%BA%B9%BB%E7_1-bona0007.jpg_2.jpg,2950,480,640,50,461,511,280,339,True,22
L,49,kaist_dataset/English/Digital_Camera/(E.S)C-outdoor3/크기변환_P1010076.JPG,char_data/L/크기변환_P1010076.JPG_4.jpg,1911,480,640,39,303,342,125,174,True,22
L,34,kaist_dataset/English/Digital_Camera/(E.S)D-indoor/308.jpg,char_data/L/308.jpg_2.jpg,782,212,385,23,146,169,47,81,True,22
L,93,kaist_dataset/English/Digital_Camera/(E.S)D-indoor/DSC02850.JPG,char_data/L/DSC02850.JPG_2.jpg,5673,480,640,61,200,261,146,239,True,22
L,58,kaist_dataset/English/Digital_Camera/(E.S)D-indoor/DSC03071.JPG,char_data/L/DSC03071.JPG_2.jpg,1856,480,640,32,245,277,221,279,True,22
L,58,kaist_dataset/English/Digital_Camera/(E.S)D-indoor/DSC03083.JPG,char_data/L/DSC03083.JPG_5.jpg,2320,480,640,40,369,409,391,449,True,22
L,72,kaist_dataset/English/Digital_Camera/(E.S)D-indoor/DSC03376.JPG,char_data/L/DSC03376.JPG_2.jpg,3672,480,640,51,180,231,380,452,True,22
L,56,kaist_dataset/English/Digital_Camera/(E.S)D-indoor/DSC03395.JPG,char_data/L/DSC03395.JPG_2.jpg,2128,480,640,38,156,194,411,467,True,22
L,45,kaist_dataset/English/Digital_Camera/(E.S)D-indoor/DSC03401.JPG,char_data/L/DSC03401.JPG_2.jpg,1485,480,640,33,315,348,236,281,True,22
L,65,kaist_dataset/English/Digital_Camera/(E.S)D-indoor/DSC03883.JPG,char_data/L/DSC03883.JPG_6.jpg,3055,480,640,47,36,83,322,387,True,22
L,66,kaist_dataset/English/Digital_Camera/(E.S)D-indoor/DSC03883.JPG,char_data/L/DSC03883.JPG_7.jpg,2310,480,640,35,383,418,311,377,True,22
L,61,kaist_dataset/English/Digital_Camera/(E.S)D-indoor/DSC03883.JPG,char_data/L/DSC03883.JPG_8.jpg,2257,480,640,37,418,455,313,374,True,22
L,68,kaist_dataset/English/Digital_Camera/(E.S)D-indoor/DSC03887.JPG,char_data/L/DSC03887.JPG_2.jpg,3060,480,640,45,394,439,165,233,True,22
L,33,kaist_dataset/English/Digital_Camera/(E.S)D-indoor/DSC03901.JPG,char_data/L/DSC03901.JPG_2.jpg,726,480,640,22,360,382,124,157,True,22
L,55,kaist_dataset/English/Digital_Camera/(E.S)D-indoor/DSC03918.JPG,char_data/L/DSC03918.JPG_2.jpg,1485,480,640,27,375,402,410,465,True,22
L,33,kaist_dataset/English/Digital_Camera/(E.S)D-indoor/DSC03935.JPG,char_data/L/DSC03935.JPG_2.jpg,693,480,640,21,327,348,46,79,True,22
L,66,kaist_dataset/English/Digital_Camera/(E.S)D-indoor/DSC03941.JPG,char_data/L/DSC03941.JPG_2.jpg,2112,480,640,32,287,319,233,299,True,22
L,29,kaist_dataset/English/Digital_Camera/(E.S)D-indoor/z.jpg,char_data/L/z.jpg_2.jpg,580,240,320,20,169,189,72,101,True,22
L,119,kaist_dataset/English/Digital_Camera/(E.S)E-night/080116-0056.jpg,char_data/L/080116-0056.jpg_2.jpg,9520,1200,1600,80,539,619,561,680,True,22
L,103,kaist_dataset/English/Digital_Camera/(E.S)E-night/DSC02606.JPG,char_data/L/DSC02606.JPG_2.jpg,8652,480,640,84,325,409,194,297,True,22
L,32,kaist_dataset/English/Digital_Camera/(E.S)F-others/080119-0007.jpg,char_data/L/080119-0007.jpg_10.jpg,1632,1200,1600,51,1250,1301,996,1028,True,22
L,35,kaist_dataset/English/Digital_Camera/(E.S)F-others/080119-0007.jpg,char_data/L/080119-0007.jpg_11.jpg,1750,1200,1600,50,1205,1255,723,758,True,22
L,34,kaist_dataset/English/Digital_Camera/(E.S)F-others/080119-0007.jpg,char_data/L/080119-0007.jpg_12.jpg,1836,1200,1600,54,1196,1250,694,728,True,22
L,167,kaist_dataset/English/Digital_Camera/(E.S)F-others/080119-0013.jpg,char_data/L/080119-0013.jpg_2.jpg,19205,1200,1600,115,873,988,663,830,True,22
L,28,kaist_dataset/English/Digital_Camera/(E.S)F-others/DSC02923.JPG,char_data/L/DSC02923.JPG_5.jpg,420,480,640,15,246,261,411,439,True,22
L,44,kaist_dataset/English/Digital_Camera/(E.S)F-others/m.jpg,char_data/L/m.jpg_2.jpg,968,240,320,22,21,43,187,231,True,22
L,120,kaist_dataset/English/Mobile_Phone/(E.M)A-outdoor/P090911085.jpg,char_data/L/P090911085.jpg_2.jpg,9840,480,640,82,294,376,119,239,True,22
L,75,kaist_dataset/English/Mobile_Phone/(E.M)B-indoor/P090902018.jpg,char_data/L/P090902018.jpg_6.jpg,2400,480,640,32,332,364,61,136,True,22
L,124,kaist_dataset/English/Mobile_Phone/(E.M)B-indoor/P090903005.jpg,char_data/L/P090903005.jpg_2.jpg,11160,480,640,90,156,246,172,296,True,22
L,84,kaist_dataset/English/Mobile_Phone/(E.M)B-indoor/P090903007.jpg,char_data/L/P090903007.jpg_2.jpg,5292,480,640,63,3,66,255,339,True,22
L,85,kaist_dataset/English/Mobile_Phone/(E.M)B-indoor/P090911067.jpg,char_data/L/P090911067.jpg_2.jpg,4845,480,640,57,72,129,197,282,True,22
L,81,kaist_dataset/English/Mobile_Phone/(E.M)C-bookCover/P090831042.jpg,char_data/L/P090831042.jpg_2.jpg,5589,480,640,69,491,560,195,276,True,22
L,65,kaist_dataset/English/Mobile_Phone/(E.M)C-bookCover/P090831075.jpg,char_data/L/P090831075.jpg_2.jpg,2600,480,640,40,570,610,162,227,True,22
L,54,kaist_dataset/English/Mobile_Phone/(E.M)C-bookCover/P090903015.jpg,char_data/L/P090903015.jpg_4.jpg,1728,480,640,32,307,339,75,129,True,22
L,54,kaist_dataset/English/Mobile_Phone/(E.M)C-bookCover/P090903015.jpg,char_data/L/P090903015.jpg_5.jpg,1728,480,640,32,272,304,144,198,True,22
L,66,kaist_dataset/English/Mobile_Phone/(E.M)C-bookCover/P090903041.jpg,char_data/L/P090903041.jpg_2.jpg,3036,480,640,46,406,452,26,92,True,22
L,58,kaist_dataset/English/Mobile_Phone/(E.M)C-bookCover/P090903054.jpg,char_data/L/P090903054.jpg_2.jpg,1740,480,640,30,209,239,351,409,True,22
L,38,kaist_dataset/English/Mobile_Phone/(E.M)C-bookCover/P090903055.jpg,char_data/L/P090903055.jpg_2.jpg,1178,480,640,31,367,398,409,447,True,22
L,151,kaist_dataset/English/Mobile_Phone/(E.M)C-bookCover/P090903081.jpg,char_data/L/P090903081.jpg_2.jpg,10872,480,640,72,421,493,105,256,True,22
L,98,kaist_dataset/English/Mobile_Phone/(E.M)C-bookCover/P090905007.jpg,char_data/L/P090905007.jpg_2.jpg,5978,480,640,61,89,150,28,126,True,22
L,50,kaist_dataset/Korean/Digital_Camera/outdoor2/2007-12-09-day-exterior-006.jpg,char_data/L/2007-12-09-day-exterior-006.jpg_2.jpg,1400,1200,1600,28,1554,1582,580,630,True,22
L,85,kaist_dataset/Korean/Digital_Camera/outdoor6/DSC04439.JPG,char_data/L/DSC04439.JPG_2.jpg,3655,480,640,43,124,167,53,138,True,22
L,42,kaist_dataset/Mixed/Digital_Camera/(C.S)A-shadow/DSC02609.JPG,char_data/L/DSC02609.JPG_4.jpg,1218,480,640,29,389,418,296,338,True,22
L,45,kaist_dataset/Mixed/Digital_Camera/(C.S)A-shadow/DSC02902.JPG,char_data/L/DSC02902.JPG_2.jpg,855,480,640,19,297,316,377,422,True,22
L,64,kaist_dataset/Mixed/Digital_Camera/(C.S)A-shadow/DSC03207.JPG,char_data/L/DSC03207.JPG_5.jpg,2496,480,640,39,406,445,198,262,True,22
L,32,kaist_dataset/Mixed/Digital_Camera/(C.S)B-light/DSC03298.JPG,char_data/L/DSC03298.JPG_2.jpg,448,480,640,14,339,353,288,320,True,22
L,27,kaist_dataset/Mixed/Digital_Camera/(C.S)C-outdoor1/047.JPG,char_data/L/047.JPG_6.jpg,432,480,640,16,187,203,236,263,True,22
L,31,kaist_dataset/Mixed/Digital_Camera/(C.S)C-outdoor1/047.JPG,char_data/L/047.JPG_7.jpg,651,480,640,21,44,65,240,271,True,22
L,32,kaist_dataset/Mixed/Digital_Camera/(C.S)C-outdoor1/048.JPG,char_data/L/048.JPG_2.jpg,416,480,640,13,234,247,255,287,True,22
L,32,kaist_dataset/Mixed/Digital_Camera/(C.S)C-outdoor1/054.JPG,char_data/L/054.JPG_4.jpg,800,480,640,25,376,401,272,304,True,22
L,24,kaist_dataset/Mixed/Digital_Camera/(C.S)C-outdoor1/054.JPG,char_data/L/054.JPG_5.jpg,408,480,640,17,421,438,306,330,True,22
L,53,kaist_dataset/Mixed/Digital_Camera/(C.S)C-outdoor1/080119-0006.jpg,char_data/L/080119-0006.jpg_2.jpg,2226,1200,1600,42,415,457,737,790,True,22
L,69,kaist_dataset/Mixed/Digital_Camera/(C.S)C-outdoor1/080119-0008.jpg,char_data/L/080119-0008.jpg_2.jpg,2139,1200,1600,31,1175,1206,658,727,True,22
L,140,kaist_dataset/Mixed/Digital_Camera/(C.S)C-outdoor1/080119-0037.jpg,char_data/L/080119-0037.jpg_2.jpg,10360,1200,1600,74,21,95,880,1020,True,22
L,68,kaist_dataset/Mixed/Digital_Camera/(C.S)C-outdoor1/1.JPG,char_data/L/1.JPG_2.jpg,2312,576,768,34,564,598,203,271,True,22
L,108,kaist_dataset/Mixed/Digital_Camera/(C.S)C-outdoor1/101.JPG,char_data/L/101.JPG_4.jpg,9612,480,640,89,101,190,137,245,True,22
L,16,kaist_dataset/Mixed/Digital_Camera/(C.S)C-outdoor1/135.JPG,char_data/L/135.JPG_6.jpg,224,480,640,14,281,295,201,217,True,22
L,20,kaist_dataset/Mixed/Digital_Camera/(C.S)C-outdoor1/135.JPG,char_data/L/135.JPG_7.jpg,200,480,640,10,261,271,174,194,True,22
L,22,kaist_dataset/Mixed/Digital_Camera/(C.S)C-outdoor1/135.JPG,char_data/L/135.JPG_8.jpg,330,480,640,15,269,284,174,196,True,22
L,50,kaist_dataset/Mixed/Digital_Camera/(C.S)C-outdoor1/2007-12-08-day-130.jpg,char_data/L/2007-12-08-day-130.jpg_4.jpg,2150,1200,1600,43,818,861,699,749,True,22
L,44,kaist_dataset/Mixed/Digital_Camera/(C.S)C-outdoor1/2007-12-08-day-130.jpg,char_data/L/2007-12-08-day-130.jpg_5.jpg,1276,1200,1600,29,902,931,750,794,True,22
L,47,kaist_dataset/Mixed/Digital_Camera/(C.S)C-outdoor1/3.JPG,char_data/L/3.JPG_2.jpg,987,576,768,21,659,680,416,463,True,22
L,35,kaist_dataset/Mixed/Digital_Camera/(C.S)C-outdoor1/48.JPG,char_data/L/48.JPG_2.jpg,945,576,768,27,241,268,183,218,True,22
L,56,kaist_dataset/Mixed/Digital_Camera/(C.S)C-outdoor2/DSC02359.JPG,char_data/L/DSC02359.JPG_2.jpg,1176,480,640,21,196,217,406,462,True,22
L,55,kaist_dataset/Mixed/Digital_Camera/(C.S)C-outdoor2/DSC02365.JPG,char_data/L/DSC02365.JPG_2.jpg,1265,480,640,23,234,257,91,146,True,22
L,38,kaist_dataset/Mixed/Digital_Camera/(C.S)C-outdoor2/DSC02368.JPG,char_data/L/DSC02368.JPG_2.jpg,532,480,640,14,105,119,383,421,True,22
L,34,kaist_dataset/Mixed/Digital_Camera/(C.S)C-outdoor2/DSC02377.JPG,char_data/L/DSC02377.JPG_2.jpg,646,480,640,19,392,411,355,389,True,22
L,32,kaist_dataset/Mixed/Digital_Camera/(C.S)C-outdoor2/DSC02391.JPG,char_data/L/DSC02391.JPG_2.jpg,800,480,640,25,366,391,332,364,True,22
L,37,kaist_dataset/Mixed/Digital_Camera/(C.S)C-outdoor2/DSC02419.JPG,char_data/L/DSC02419.JPG_2.jpg,962,480,640,26,56,82,202,239,True,22
L,43,kaist_dataset/Mixed/Digital_Camera/(C.S)C-outdoor2/DSC02511.JPG,char_data/L/DSC02511.JPG_5.jpg,731,480,640,17,207,224,397,440,True,22
L,26,kaist_dataset/Mixed/Digital_Camera/(C.S)C-outdoor2/DSC02879.JPG,char_data/L/DSC02879.JPG_2.jpg,286,480,640,11,254,265,285,311,True,22
L,106,kaist_dataset/Mixed/Digital_Camera/(C.S)C-outdoor2/DSC02917.JPG,char_data/L/DSC02917.JPG_4.jpg,6678,480,640,63,78,141,74,180,True,22
L,35,kaist_dataset/Mixed/Digital_Camera/(C.S)C-outdoor2/DSC02917.JPG,char_data/L/DSC02917.JPG_5.jpg,700,480,640,20,1,21,223,258,True,22
L,38,kaist_dataset/Mixed/Digital_Camera/(C.S)C-outdoor3/DSC02989.JPG,char_data/L/DSC02989.JPG_6.jpg,684,480,640,18,108,126,171,209,True,22
L,37,kaist_dataset/Mixed/Digital_Camera/(C.S)C-outdoor3/DSC02989.JPG,char_data/L/DSC02989.JPG_7.jpg,1147,480,640,31,290,321,267,304,True,22
L,156,kaist_dataset/Mixed/Digital_Camera/(C.S)C-outdoor3/DSC03006.JPG,char_data/L/DSC03006.JPG_2.jpg,12012,480,640,77,337,414,108,264,True,22
L,40,kaist_dataset/Mixed/Digital_Camera/(C.S)C-outdoor3/DSC03020.JPG,char_data/L/DSC03020.JPG_10.jpg,800,480,640,20,309,329,261,301,True,22
L,42,kaist_dataset/Mixed/Digital_Camera/(C.S)C-outdoor3/DSC03020.JPG,char_data/L/DSC03020.JPG_11.jpg,714,480,640,17,330,347,262,304,True,22
L,34,kaist_dataset/Mixed/Digital_Camera/(C.S)C-outdoor3/DSC03020.JPG,char_data/L/DSC03020.JPG_12.jpg,612,480,640,18,458,476,265,299,True,22
L,41,kaist_dataset/Mixed/Digital_Camera/(C.S)C-outdoor3/DSC03020.JPG,char_data/L/DSC03020.JPG_13.jpg,861,480,640,21,582,603,265,306,True,22
L,25,kaist_dataset/Mixed/Digital_Camera/(C.S)C-outdoor3/DSC03033.JPG,char_data/L/DSC03033.JPG_4.jpg,425,480,640,17,27,44,131,156,True,22
L,23,kaist_dataset/Mixed/Digital_Camera/(C.S)C-outdoor3/DSC03033.JPG,char_data/L/DSC03033.JPG_5.jpg,230,480,640,10,43,53,157,180,True,22
L,34,kaist_dataset/Mixed/Digital_Camera/(C.S)C-outdoor3/DSC03035.JPG,char_data/L/DSC03035.JPG_2.jpg,646,480,640,19,329,348,403,437,True,22
L,98,kaist_dataset/Mixed/Digital_Camera/(C.S)C-outdoor3/DSC03054.JPG,char_data/L/DSC03054.JPG_2.jpg,5880,480,640,60,288,348,225,323,True,22
L,103,kaist_dataset/Mixed/Digital_Camera/(C.S)C-outdoor3/DSC03176.JPG,char_data/L/DSC03176.JPG_2.jpg,7107,480,640,69,54,123,267,370,True,22
L,97,kaist_dataset/Mixed/Digital_Camera/(C.S)C-outdoor3/DSC03217.JPG,char_data/L/DSC03217.JPG_2.jpg,7469,480,640,77,182,259,228,325,True,22
L,102,kaist_dataset/Mixed/Digital_Camera/(C.S)C-outdoor3/DSC03247.JPG,char_data/L/DSC03247.JPG_2.jpg,4692,480,640,46,429,475,154,256,True,22
L,74,kaist_dataset/Mixed/Digital_Camera/(C.S)C-outdoor3/DSC03274.JPG,char_data/L/DSC03274.JPG_2.jpg,4958,480,640,67,204,271,86,160,True,22
L,43,kaist_dataset/Mixed/Digital_Camera/(C.S)C-outdoor3/DSC03329.JPG,char_data/L/DSC03329.JPG_2.jpg,989,480,640,23,445,468,437,479,True,22
L,42,kaist_dataset/Mixed/Digital_Camera/(C.S)C-outdoor3/DSC03330.JPG,char_data/L/DSC03330.JPG_2.jpg,966,480,640,23,128,151,394,436,True,22
L,48,kaist_dataset/Mixed/Digital_Camera/(C.S)C-outdoor3/DSC03331.JPG,char_data/L/DSC03331.JPG_2.jpg,960,480,640,20,126,146,376,424,True,22
L,73,kaist_dataset/Mixed/Digital_Camera/(C.S)C-outdoor3/DSC03409.JPG,char_data/L/DSC03409.JPG_4.jpg,3285,480,640,45,136,181,116,189,True,22
L,37,kaist_dataset/Mixed/Digital_Camera/(C.S)C-outdoor4/DSC03617.JPG,char_data/L/DSC03617.JPG_2.jpg,814,480,640,22,158,180,389,426,True,22
L,35,kaist_dataset/Mixed/Digital_Camera/(C.S)C-outdoor4/DSC03640.JPG,char_data/L/DSC03640.JPG_2.jpg,560,480,640,16,131,147,399,434,True,22
L,36,kaist_dataset/Mixed/Digital_Camera/(C.S)C-outdoor4/DSC03642.JPG,char_data/L/DSC03642.JPG_5.jpg,252,480,640,7,410,417,398,434,True,22
L,92,kaist_dataset/Mixed/Digital_Camera/(C.S)C-outdoor4/DSC03652.JPG,char_data/L/DSC03652.JPG_2.jpg,4416,480,640,48,105,153,175,267,True,22
L,52,kaist_dataset/Mixed/Digital_Camera/(C.S)C-outdoor4/DSC03655.JPG,char_data/L/DSC03655.JPG_2.jpg,1196,480,640,23,198,221,386,438,True,22
L,73,kaist_dataset/Mixed/Digital_Camera/(C.S)C-outdoor4/DSC03661.JPG,char_data/L/DSC03661.JPG_6.jpg,3212,480,640,44,485,529,238,311,True,22
L,26,kaist_dataset/Mixed/Digital_Camera/(C.S)C-outdoor4/DSC03661.JPG,char_data/L/DSC03661.JPG_8.jpg,260,480,640,10,364,374,336,362,True,22
L,29,kaist_dataset/Mixed/Digital_Camera/(C.S)C-outdoor4/DSC03676.JPG,char_data/L/DSC03676.JPG_2.jpg,348,480,640,12,54,66,270,299,True,22
L,35,kaist_dataset/Mixed/Digital_Camera/(C.S)C-outdoor4/DSC03711.JPG,char_data/L/DSC03711.JPG_6.jpg,665,480,640,19,280,299,392,427,True,22
L,47,kaist_dataset/Mixed/Digital_Camera/(C.S)C-outdoor4/DSC03711.JPG,char_data/L/DSC03711.JPG_7.jpg,1128,480,640,24,359,383,377,424,True,22
L,50,kaist_dataset/Mixed/Digital_Camera/(C.S)C-outdoor4/DSC03711.JPG,char_data/L/DSC03711.JPG_8.jpg,1200,480,640,24,582,606,382,432,True,22
L,77,kaist_dataset/Mixed/Digital_Camera/(C.S)C-outdoor5/DSC03820.JPG,char_data/L/DSC03820.JPG_4.jpg,3773,480,640,49,39,88,356,433,True,22
L,72,kaist_dataset/Mixed/Digital_Camera/(C.S)C-outdoor5/DSC03820.JPG,char_data/L/DSC03820.JPG_5.jpg,3384,480,640,47,231,278,362,434,True,22
L,20,kaist_dataset/Mixed/Digital_Camera/(C.S)C-outdoor5/DSC04031.JPG,char_data/L/DSC04031.JPG_2.jpg,340,480,640,17,137,154,381,401,True,22
L,59,kaist_dataset/Mixed/Digital_Camera/(C.S)C-outdoor5/DSC04054.JPG,char_data/L/DSC04054.JPG_2.jpg,2478,480,640,42,63,105,61,120,True,22
L,40,kaist_dataset/Mixed/Digital_Camera/(C.S)C-outdoor5/DSC04055.JPG,char_data/L/DSC04055.JPG_2.jpg,440,480,640,11,228,239,371,411,True,22
L,51,kaist_dataset/Mixed/Digital_Camera/(C.S)C-outdoor5/DSC04059.JPG,char_data/L/DSC04059.JPG_2.jpg,1377,480,640,27,306,333,126,177,False,22
L,38,kaist_dataset/Mixed/Digital_Camera/(C.S)C-outdoor5/DSC04070.JPG,char_data/L/DSC04070.JPG_5.jpg,532,480,640,14,322,336,106,144,False,22
L,39,kaist_dataset/Mixed/Digital_Camera/(C.S)C-outdoor5/DSC04109.JPG,char_data/L/DSC04109.JPG_2.jpg,1092,480,640,28,115,143,151,190,False,22
L,41,kaist_dataset/Mixed/Digital_Camera/(C.S)C-outdoor5/DSC04129.JPG,char_data/L/DSC04129.JPG_2.jpg,1189,480,640,29,377,406,378,419,False,22
L,48,kaist_dataset/Mixed/Digital_Camera/(C.S)C-outdoor5/DSC04305.JPG,char_data/L/DSC04305.JPG_4.jpg,1152,480,640,24,502,526,81,129,False,22
L,54,kaist_dataset/Mixed/Digital_Camera/(C.S)C-outdoor5/DSC04305.JPG,char_data/L/DSC04305.JPG_5.jpg,1404,480,640,26,525,551,77,131,False,22
L,28,kaist_dataset/Mixed/Digital_Camera/(C.S)C-outdoor5/DSC04360.JPG,char_data/L/DSC04360.JPG_4.jpg,364,480,640,13,106,119,347,375,False,22
L,31,kaist_dataset/Mixed/Digital_Camera/(C.S)C-outdoor5/DSC04360.JPG,char_data/L/DSC04360.JPG_5.jpg,403,480,640,13,132,145,382,413,False,22
L,99,kaist_dataset/Mixed/Digital_Camera/(C.S)C-outdoor5/DSC04465.JPG,char_data/L/DSC04465.JPG_2.jpg,8019,480,640,81,519,600,286,385,False,22
L,41,kaist_dataset/Mixed/Digital_Camera/(C.S)C-outdoor5/P1010007.JPG,char_data/L/P1010007.JPG_2.jpg,861,480,640,21,228,249,272,313,False,22
L,58,kaist_dataset/Mixed/Digital_Camera/(C.S)C-outdoor6/080116-0057.jpg,char_data/L/080116-0057.jpg_2.jpg,2262,1200,1600,39,787,826,823,881,False,22
L,30,kaist_dataset/Mixed/Digital_Camera/(C.S)C-outdoor6/P1010082.JPG,char_data/L/P1010082.JPG_2.jpg,450,480,640,15,154,169,229,259,False,22
L,28,kaist_dataset/Mixed/Digital_Camera/(C.S)C-outdoor6/P1010088.JPG,char_data/L/P1010088.JPG_2.jpg,364,480,640,13,279,292,221,249,False,22
L,34,kaist_dataset/Mixed/Digital_Camera/(C.S)C-outdoor6/P1010095.JPG,char_data/L/P1010095.JPG_2.jpg,476,480,640,14,132,146,181,215,False,22
L,24,kaist_dataset/Mixed/Digital_Camera/(C.S)C-outdoor6/P1010114.JPG,char_data/L/P1010114.JPG_2.jpg,360,480,640,15,313,328,220,244,False,22
L,27,kaist_dataset/Mixed/Digital_Camera/(C.S)C-outdoor6/크기변환_fadscf0009_creawell.jpg,char_data/L/크기변환_fadscf0009_creawell.jpg_2.jpg,486,480,640,18,251,269,156,183,False,22
L,54,kaist_dataset/Mixed/Digital_Camera/(C.S)D-indoor1/131.JPG,char_data/L/131.JPG_2.jpg,2322,480,640,43,212,255,214,268,False,22
L,48,kaist_dataset/Mixed/Digital_Camera/(C.S)D-indoor1/DSC02713.JPG,char_data/L/DSC02713.JPG_2.jpg,1392,480,640,29,386,415,155,203,False,22
L,83,kaist_dataset/Mixed/Digital_Camera/(C.S)D-indoor1/DSC02732.JPG,char_data/L/DSC02732.JPG_2.jpg,5810,480,640,70,332,402,139,222,False,22
L,69,kaist_dataset/Mixed/Digital_Camera/(C.S)D-indoor1/DSC02770.JPG,char_data/L/DSC02770.JPG_2.jpg,3312,480,640,48,211,259,339,408,False,22
L,37,kaist_dataset/Mixed/Digital_Camera/(C.S)D-indoor1/DSC03073.JPG,char_data/L/DSC03073.JPG_2.jpg,851,480,640,23,211,234,288,325,False,22
L,81,kaist_dataset/Mixed/Digital_Camera/(C.S)D-indoor1/DSC03469.JPG,char_data/L/DSC03469.JPG_2.jpg,4779,480,640,59,543,602,336,417,False,22
L,104,kaist_dataset/Mixed/Digital_Camera/(C.S)D-indoor1/DSC03890.JPG,char_data/L/DSC03890.JPG_2.jpg,7176,480,640,69,214,283,243,347,False,22
L,59,kaist_dataset/Mixed/Digital_Camera/(C.S)D-indoor1/DSC03959.JPG,char_data/L/DSC03959.JPG_4.jpg,2124,480,640,36,298,334,113,172,False,22
L,57,kaist_dataset/Mixed/Digital_Camera/(C.S)D-indoor1/DSC03959.JPG,char_data/L/DSC03959.JPG_5.jpg,2223,480,640,39,333,372,106,163,False,22
L,172,kaist_dataset/Mixed/Digital_Camera/(C.S)D-indoor1/DSC04223.JPG,char_data/L/DSC04223.JPG_2.jpg,15480,480,640,90,186,276,12,184,False,22
L,38,kaist_dataset/Mixed/Digital_Camera/(C.S)D-indoor1/DSC04246.JPG,char_data/L/DSC04246.JPG_2.jpg,1026,480,640,27,420,447,248,286,False,22
L,36,kaist_dataset/Mixed/Digital_Camera/(C.S)D-indoor2/DSC04254.JPG,char_data/L/DSC04254.JPG_2.jpg,936,480,640,26,159,185,341,377,False,22
L,89,kaist_dataset/Mixed/Digital_Camera/(C.S)D-indoor2/DSC04443.JPG,char_data/L/DSC04443.JPG_2.jpg,4895,480,640,55,56,111,48,137,False,22
L,47,kaist_dataset/Mixed/Digital_Camera/(C.S)E-night/DSC02672.JPG,char_data/L/DSC02672.JPG_2.jpg,1222,480,640,26,275,301,170,217,False,22
L,38,kaist_dataset/Mixed/Digital_Camera/(C.S)E-night/DSC02673.JPG,char_data/L/DSC02673.JPG_2.jpg,418,480,640,11,266,277,304,342,False,22
L,32,kaist_dataset/Mixed/Digital_Camera/(C.S)E-night/DSC02903.JPG,char_data/L/DSC02903.JPG_2.jpg,640,480,640,20,295,315,265,297,False,22
L,53,kaist_dataset/Mixed/Digital_Camera/(C.S)F-others/2007-12-08-day-113.jpg,char_data/L/2007-12-08-day-113.jpg_2.jpg,1325,1200,1600,25,797,822,381,434,False,22
L,65,kaist_dataset/Mixed/Digital_Camera/(C.S)F-others/58.JPG,char_data/L/58.JPG_2.jpg,2795,764,499,43,19,62,167,232,False,22
L,41,kaist_dataset/Mixed/Digital_Camera/(C.S)F-others/DSC02504.JPG,char_data/L/DSC02504.JPG_2.jpg,1271,480,640,31,160,191,314,355,False,22
L,42,kaist_dataset/Mixed/Digital_Camera/(C.S)F-others/DSC02609.JPG,char_data/L/DSC02609.JPG_5.jpg,1218,480,640,29,389,418,296,338,False,22
L,37,kaist_dataset/Mixed/Mobile_Phone/(C.M)A-outdoor/P090908006.jpg,char_data/L/P090908006.jpg_2.jpg,814,480,640,22,291,313,366,403,False,22
L,37,kaist_dataset/Mixed/Mobile_Phone/(C.M)B-indoor/P090831005.jpg,char_data/L/P090831005.jpg_2.jpg,740,480,640,20,248,268,235,272,False,22
L,66,kaist_dataset/Mixed/Mobile_Phone/(C.M)C-bookCover/P090831113.jpg,char_data/L/P090831113.jpg_4.jpg,3366,480,640,51,234,285,234,300,False,22
L,73,kaist_dataset/Mixed/Mobile_Phone/(C.M)C-bookCover/P090831113.jpg,char_data/L/P090831113.jpg_5.jpg,3066,480,640,42,331,373,225,298,False,22
L,85,kaist_dataset/Mixed/Mobile_Phone/(C.M)C-bookCover/P090831114.jpg,char_data/L/P090831114.jpg_2.jpg,5185,480,640,61,212,273,243,328,False,22
L,41,kaist_dataset/Mixed/Mobile_Phone/(C.M)C-bookCover/P090904005.jpg,char_data/L/P090904005.jpg_2.jpg,1230,480,640,30,416,446,115,156,False,22
B,66,kaist_dataset/English/Digital_Camera/(E.S)A-shadow/DSC03081.JPG,char_data/B/DSC03081.JPG_2.jpg,4158,480,640,63,292,355,255,321,True,13
B,64,kaist_dataset/English/Digital_Camera/(E.S)A-shadow/IMG_2647.JPG,char_data/B/IMG_2647.JPG_2.jpg,3264,480,640,51,164,215,93,157,True,13
B,121,kaist_dataset/English/Digital_Camera/(E.S)A-shadow/P1010035.JPG,char_data/B/P1010035.JPG_2.jpg,13915,480,640,115,323,438,161,282,True,13
B,127,kaist_dataset/English/Digital_Camera/(E.S)B-light/080116-0053.jpg,char_data/B/080116-0053.jpg_2.jpg,11303,600,800,89,14,103,209,336,True,13
B,199,kaist_dataset/English/Digital_Camera/(E.S)B-light/080116-0059.jpg,char_data/B/080116-0059.jpg_2.jpg,28656,1200,1600,144,137,281,1,199,True,13
B,31,kaist_dataset/English/Digital_Camera/(E.S)B-light/v.jpg,char_data/B/v.jpg_2.jpg,589,240,320,19,99,118,55,86,True,13
B,73,kaist_dataset/English/Digital_Camera/(E.S)C-outdoor1/027.jpg,char_data/B/027.jpg_2.jpg,3650,300,472,50,1,50,117,190,True,13
B,47,kaist_dataset/English/Digital_Camera/(E.S)C-outdoor1/031.JPG,char_data/B/031.JPG_2.jpg,1880,480,640,40,367,407,201,248,True,13
B,60,kaist_dataset/English/Digital_Camera/(E.S)C-outdoor1/034.JPG,char_data/B/034.JPG_2.jpg,3840,480,640,64,14,78,191,251,True,13
B,64,kaist_dataset/English/Digital_Camera/(E.S)C-outdoor1/035.jpg,char_data/B/035.jpg_2.jpg,2432,210,354,38,112,150,85,149,True,13
B,32,kaist_dataset/English/Digital_Camera/(E.S)C-outdoor1/041.JPG,char_data/B/041.JPG_2.jpg,768,480,640,24,539,563,255,287,True,13
B,61,kaist_dataset/English/Digital_Camera/(E.S)C-outdoor1/042.JPG,char_data/B/042.JPG_2.jpg,2806,480,640,46,460,506,217,278,True,13
B,19,kaist_dataset/English/Digital_Camera/(E.S)C-outdoor1/061.jpg,char_data/B/061.jpg_2.jpg,513,219,323,27,105,132,86,105,True,13
B,53,kaist_dataset/English/Digital_Camera/(E.S)C-outdoor1/064.JPG,char_data/B/064.JPG_2.jpg,1537,480,640,29,334,363,185,238,True,13
B,60,kaist_dataset/English/Digital_Camera/(E.S)C-outdoor1/076.JPG,char_data/B/076.JPG_4.jpg,2760,480,640,46,225,271,209,269,True,13
B,15,kaist_dataset/English/Digital_Camera/(E.S)C-outdoor1/076.JPG,char_data/B/076.JPG_5.jpg,180,480,640,12,552,564,320,335,True,13
B,92,kaist_dataset/English/Digital_Camera/(E.S)C-outdoor1/080116-0065.jpg,char_data/B/080116-0065.jpg_4.jpg,5060,600,800,55,345,400,240,332,True,13
B,37,kaist_dataset/English/Digital_Camera/(E.S)C-outdoor1/080116-0065.jpg,char_data/B/080116-0065.jpg_5.jpg,888,600,800,24,160,184,365,402,True,13
B,30,kaist_dataset/English/Digital_Camera/(E.S)C-outdoor1/113.jpg,char_data/B/113.jpg_4.jpg,510,480,640,17,322,339,270,300,True,13
B,30,kaist_dataset/English/Digital_Camera/(E.S)C-outdoor1/113.jpg,char_data/B/113.jpg_5.jpg,780,480,640,26,486,512,302,332,True,13
B,63,kaist_dataset/English/Digital_Camera/(E.S)C-outdoor1/139.JPG,char_data/B/139.JPG_4.jpg,3150,480,640,50,83,133,252,315,True,13
B,63,kaist_dataset/English/Digital_Camera/(E.S)C-outdoor1/139.JPG,char_data/B/139.JPG_5.jpg,3087,480,640,49,82,131,251,314,True,13
B,149,kaist_dataset/English/Digital_Camera/(E.S)C-outdoor1/142.JPG,char_data/B/142.JPG_2.jpg,14006,480,640,94,388,482,194,343,True,13
B,46,kaist_dataset/English/Digital_Camera/(E.S)C-outdoor1/2007-12-08-day-015.jpg,char_data/B/2007-12-08-day-015.jpg_2.jpg,1610,1200,1600,35,637,672,805,851,True,13
B,268,kaist_dataset/English/Digital_Camera/(E.S)C-outdoor1/2007-12-08-day-098.jpg,char_data/B/2007-12-08-day-098.jpg_9.jpg,46364,1200,1600,173,641,814,423,691,True,13
B,41,kaist_dataset/English/Digital_Camera/(E.S)C-outdoor1/6.jpg,char_data/B/6.jpg_2.jpg,1599,255,731,39,265,304,98,139,True,13
B,17,kaist_dataset/English/Digital_Camera/(E.S)C-outdoor1/7.jpg,char_data/B/7.jpg_2.jpg,187,574,680,11,202,213,104,121,True,13
B,65,kaist_dataset/English/Digital_Camera/(E.S)C-outdoor1/DSC02243.JPG,char_data/B/DSC02243.JPG_2.jpg,2405,480,640,37,496,533,223,288,True,13
B,95,kaist_dataset/English/Digital_Camera/(E.S)C-outdoor1/DSC02356.JPG,char_data/B/DSC02356.JPG_6.jpg,5225,480,640,55,345,400,150,245,True,13
B,123,kaist_dataset/English/Digital_Camera/(E.S)C-outdoor1/DSC02387.JPG,char_data/B/DSC02387.JPG_4.jpg,11562,480,640,94,90,184,123,246,True,13
B,77,kaist_dataset/English/Digital_Camera/(E.S)C-outdoor1/DSC02394.JPG,char_data/B/DSC02394.JPG_2.jpg,3619,480,640,47,326,373,255,332,True,13
B,65,kaist_dataset/English/Digital_Camera/(E.S)C-outdoor1/DSC02395.JPG,char_data/B/DSC02395.JPG_2.jpg,3445,480,640,53,110,163,298,363,True,13
B,74,kaist_dataset/English/Digital_Camera/(E.S)C-outdoor1/DSC02398.JPG,char_data/B/DSC02398.JPG_2.jpg,3774,480,640,51,67,118,245,319,True,13
B,114,kaist_dataset/English/Digital_Camera/(E.S)C-outdoor1/DSC02427.JPG,char_data/B/DSC02427.JPG_2.jpg,8436,480,640,74,343,417,107,221,True,13
B,78,kaist_dataset/English/Digital_Camera/(E.S)C-outdoor1/DSC02514.JPG,char_data/B/DSC02514.JPG_4.jpg,2886,480,640,37,265,302,169,247,True,13
B,130,kaist_dataset/English/Digital_Camera/(E.S)C-outdoor1/DSC02618.JPG,char_data/B/DSC02618.JPG_4.jpg,12220,480,640,94,166,260,213,343,True,13
B,34,kaist_dataset/English/Digital_Camera/(E.S)C-outdoor1/DSC02618.JPG,char_data/B/DSC02618.JPG_5.jpg,646,480,640,19,282,301,173,207,True,13
B,68,kaist_dataset/English/Digital_Camera/(E.S)C-outdoor1/DSC02619.JPG,char_data/B/DSC02619.JPG_4.jpg,2788,480,640,41,37,78,223,291,True,13
B,67,kaist_dataset/English/Digital_Camera/(E.S)C-outdoor1/DSC02619.JPG,char_data/B/DSC02619.JPG_5.jpg,3283,480,640,49,538,587,208,275,True,13
B,103,kaist_dataset/English/Digital_Camera/(E.S)C-outdoor2/DSC02984.JPG,char_data/B/DSC02984.JPG_2.jpg,7313,480,640,71,21,92,103,206,True,13
B,81,kaist_dataset/English/Digital_Camera/(E.S)C-outdoor2/DSC02993.JPG,char_data/B/DSC02993.JPG_2.jpg,4455,480,640,55,350,405,227,308,True,13
B,57,kaist_dataset/English/Digital_Camera/(E.S)C-outdoor2/DSC03001.JPG,char_data/B/DSC03001.JPG_2.jpg,2565,480,640,45,1,46,201,258,True,13
B,48,kaist_dataset/English/Digital_Camera/(E.S)C-outdoor2/DSC03203.JPG,char_data/B/DSC03203.JPG_2.jpg,2016,480,640,42,426,468,313,361,True,13
B,71,kaist_dataset/English/Digital_Camera/(E.S)C-outdoor2/DSC03229.JPG,char_data/B/DSC03229.JPG_2.jpg,3053,480,640,43,525,568,149,220,True,13
B,57,kaist_dataset/English/Digital_Camera/(E.S)C-outdoor2/DSC03307.JPG,char_data/B/DSC03307.JPG_4.jpg,1824,480,640,32,197,229,152,209,True,13
B,67,kaist_dataset/English/Digital_Camera/(E.S)C-outdoor2/DSC03307.JPG,char_data/B/DSC03307.JPG_5.jpg,2747,480,640,41,225,266,225,292,True,13
B,32,kaist_dataset/English/Digital_Camera/(E.S)C-outdoor2/DSC03317.JPG,char_data/B/DSC03317.JPG_2.jpg,864,480,640,27,433,460,322,354,True,13
B,41,kaist_dataset/English/Digital_Camera/(E.S)C-outdoor2/DSC03664.JPG,char_data/B/DSC03664.JPG_2.jpg,1517,480,640,37,368,405,26,67,True,13
B,60,kaist_dataset/English/Digital_Camera/(E.S)C-outdoor2/DSC03684.JPG,char_data/B/DSC03684.JPG_2.jpg,2700,480,640,45,336,381,90,150,True,13
B,71,kaist_dataset/English/Digital_Camera/(E.S)C-outdoor2/DSC03759.JPG,char_data/B/DSC03759.JPG_2.jpg,8023,480,640,113,63,176,192,263,True,13
B,129,kaist_dataset/English/Digital_Camera/(E.S)C-outdoor2/DSC04430.JPG,char_data/B/DSC04430.JPG_2.jpg,17544,480,640,136,61,197,132,261,True,13
B,33,kaist_dataset/English/Digital_Camera/(E.S)C-outdoor2/DSC04437.JPG,char_data/B/DSC04437.JPG_8.jpg,594,480,640,18,156,174,38,71,True,13
B,28,kaist_dataset/English/Digital_Camera/(E.S)C-outdoor2/DSC04437.JPG,char_data/B/DSC04437.JPG_9.jpg,616,480,640,22,155,177,74,102,True,13
B,76,kaist_dataset/English/Digital_Camera/(E.S)C-outdoor2/DSC04437.JPG,char_data/B/DSC04437.JPG_11.jpg,4864,480,640,64,311,375,107,183,True,13
B,167,kaist_dataset/English/Digital_Camera/(E.S)C-outdoor2/DSC04458.JPG,char_data/B/DSC04458.JPG_2.jpg,16700,480,640,100,36,136,257,424,True,13
B,63,kaist_dataset/English/Digital_Camera/(E.S)C-outdoor3/DSC02788.JPG,char_data/B/DSC02788.JPG_2.jpg,2772,480,640,44,155,199,321,384,True,13
B,84,kaist_dataset/English/Digital_Camera/(E.S)C-outdoor3/DSC03046.JPG,char_data/B/DSC03046.JPG_2.jpg,5544,480,640,66,180,246,127,211,True,13
B,82,kaist_dataset/English/Digital_Camera/(E.S)C-outdoor3/크기변환_%B0%A3%C6%C718_m_starfirm.jpg,char_data/B/크기변환_%B0%A3%C6%C718_m_starfirm.jpg_2.jpg,6642,480,640,81,336,417,190,272,True,13
B,113,kaist_dataset/English/Digital_Camera/(E.S)D-indoor/080119-0015.jpg,char_data/B/080119-0015.jpg_4.jpg,15142,1200,1600,134,516,650,520,633,True,13
B,34,kaist_dataset/English/Digital_Camera/(E.S)D-indoor/080119-0015.jpg,char_data/B/080119-0015.jpg_5.jpg,986,1200,1600,29,796,825,628,662,True,13
B,31,kaist_dataset/English/Digital_Camera/(E.S)D-indoor/308.jpg,char_data/B/308.jpg_4.jpg,868,212,385,28,36,64,45,76,True,13
B,28,kaist_dataset/English/Digital_Camera/(E.S)D-indoor/308.jpg,char_data/B/308.jpg_5.jpg,672,212,385,24,96,120,50,78,True,13
B,62,kaist_dataset/English/Digital_Camera/(E.S)D-indoor/DSC02769.JPG,char_data/B/DSC02769.JPG_2.jpg,3038,480,640,49,86,135,222,284,True,13
B,102,kaist_dataset/English/Digital_Camera/(E.S)D-indoor/DSC02852.JPG,char_data/B/DSC02852.JPG_2.jpg,6018,480,640,59,350,409,320,422,True,13
B,57,kaist_dataset/English/Digital_Camera/(E.S)D-indoor/DSC03071.JPG,char_data/B/DSC03071.JPG_2.jpg,2109,480,640,37,292,329,222,279,True,13
B,47,kaist_dataset/English/Digital_Camera/(E.S)D-indoor/DSC03090.JPG,char_data/B/DSC03090.JPG_2.jpg,1175,480,640,25,228,253,284,331,True,13
B,68,kaist_dataset/English/Digital_Camera/(E.S)D-indoor/DSC03091.JPG,char_data/B/DSC03091.JPG_2.jpg,3468,480,640,51,232,283,114,182,True,13
B,51,kaist_dataset/English/Digital_Camera/(E.S)D-indoor/DSC03093.JPG,char_data/B/DSC03093.JPG_2.jpg,2040,480,640,40,286,326,200,251,True,13
B,82,kaist_dataset/English/Digital_Camera/(E.S)D-indoor/DSC03136.JPG,char_data/B/DSC03136.JPG_2.jpg,3034,480,640,37,116,153,245,327,True,13
B,47,kaist_dataset/English/Digital_Camera/(E.S)D-indoor/DSC03142.JPG,char_data/B/DSC03142.JPG_2.jpg,1316,480,640,28,316,344,359,406,True,13
B,37,kaist_dataset/English/Digital_Camera/(E.S)D-indoor/DSC03901.JPG,char_data/B/DSC03901.JPG_6.jpg,740,480,640,20,177,197,260,297,True,13
B,66,kaist_dataset/English/Digital_Camera/(E.S)D-indoor/DSC03901.JPG,char_data/B/DSC03901.JPG_7.jpg,2376,480,640,36,418,454,164,230,True,13
B,61,kaist_dataset/English/Digital_Camera/(E.S)D-indoor/DSC03901.JPG,char_data/B/DSC03901.JPG_8.jpg,2196,480,640,36,452,488,165,226,True,13
B,40,kaist_dataset/English/Digital_Camera/(E.S)D-indoor/DSC03942.JPG,char_data/B/DSC03942.JPG_4.jpg,1000,480,640,25,100,125,1,40,True,13
B,49,kaist_dataset/English/Digital_Camera/(E.S)D-indoor/DSC03942.JPG,char_data/B/DSC03942.JPG_5.jpg,1274,480,640,26,397,423,366,415,True,13
B,96,kaist_dataset/English/Digital_Camera/(E.S)E-night/DSC02641.JPG,char_data/B/DSC02641.JPG_2.jpg,5664,480,640,59,350,409,269,365,True,13
B,90,kaist_dataset/English/Digital_Camera/(E.S)E-night/DSC02675.JPG,char_data/B/DSC02675.JPG_2.jpg,7380,480,640,82,51,133,177,267,True,13
B,168,kaist_dataset/English/Digital_Camera/(E.S)F-others/080116-0058.jpg,char_data/B/080116-0058.jpg_2.jpg,13272,1200,1600,79,670,749,332,500,True,13
B,215,kaist_dataset/English/Digital_Camera/(E.S)F-others/2007-12-09-day-exterior-047.jpg,char_data/B/2007-12-09-day-exterior-047.jpg_6.jpg,37840,1200,1600,176,616,792,428,643,True,13
B,134,kaist_dataset/English/Digital_Camera/(E.S)F-others/2007-12-09-day-exterior-047.jpg,char_data/B/2007-12-09-day-exterior-047.jpg_7.jpg,17286,1200,1600,129,214,343,425,559,True,13
B,41,kaist_dataset/English/Digital_Camera/(E.S)F-others/2007-12-09-day-exterior-047.jpg,char_data/B/2007-12-09-day-exterior-047.jpg_8.jpg,1025,1200,1600,25,637,662,1069,1110,True,13
B,29,kaist_dataset/English/Digital_Camera/(E.S)F-others/m.jpg,char_data/B/m.jpg_2.jpg,754,240,320,26,232,258,98,127,True,13
B,33,kaist_dataset/English/Digital_Camera/(E.S)F-others/크기변환_%C4%BF%C7%C7%B5%B9%C3%E2%B0%A3%C6%C7_%281%29_alto99kr.jpg,char_data/B/크기변환_%C4%BF%C7%C7%B5%B9%C3%E2%B0%A3%C6%C7_%281%29_alto99kr.jpg_2.jpg,1386,480,640,42,271,313,197,230,True,13
B,92,kaist_dataset/English/Mobile_Phone/(E.M)B-indoor/P090831011.jpg,char_data/B/P090831011.jpg_2.jpg,5612,480,640,61,341,402,116,208,True,13
B,122,kaist_dataset/English/Mobile_Phone/(E.M)B-indoor/P090911080.jpg,char_data/B/P090911080.jpg_6.jpg,11102,480,640,91,17,108,176,298,True,13
B,116,kaist_dataset/English/Mobile_Phone/(E.M)B-indoor/P090911081.jpg,char_data/B/P090911081.jpg_5.jpg,11136,480,640,96,447,543,176,292,True,13
B,52,kaist_dataset/English/Mobile_Phone/(E.M)C-bookCover/P090903030.jpg,char_data/B/P090903030.jpg_2.jpg,1768,480,640,34,191,225,65,117,True,13
B,57,kaist_dataset/English/Mobile_Phone/(E.M)C-bookCover/P090903054.jpg,char_data/B/P090903054.jpg_2.jpg,2280,480,640,40,382,422,347,404,True,13
B,105,kaist_dataset/English/Mobile_Phone/(E.M)C-bookCover/P090903076.jpg,char_data/B/P090903076.jpg_2.jpg,8925,480,640,85,261,346,174,279,True,13
B,14,kaist_dataset/Korean/Digital_Camera/E-night/103.jpg,char_data/B/103.jpg_2.jpg,84,480,640,6,311,317,156,170,True,13
B,42,kaist_dataset/Korean/Digital_Camera/E-night/DSC02662.JPG,char_data/B/DSC02662.JPG_2.jpg,1008,480,640,24,483,507,371,413,True,13
B,34,kaist_dataset/Korean/Digital_Camera/indoor1/2007-12-08-day-139.jpg,char_data/B/2007-12-08-day-139.jpg_2.jpg,952,1200,1600,28,420,448,354,388,True,13
B,45,kaist_dataset/Korean/Digital_Camera/outdoor1/2007-12-08-day-056.jpg,char_data/B/2007-12-08-day-056.jpg_2.jpg,2070,1200,1600,46,827,873,399,444,True,13
B,68,kaist_dataset/Korean/Digital_Camera/outdoor1/40.jpg,char_data/B/40.jpg_2.jpg,3128,308,367,46,7,53,18,86,True,13
B,68,kaist_dataset/Korean/Digital_Camera/outdoor5/DSC03869.JPG,char_data/B/DSC03869.JPG_2.jpg,2788,480,640,41,161,202,266,334,True,13
B,84,kaist_dataset/Mixed/Digital_Camera/(C.S)C-outdoor1/038.JPG,char_data/B/038.JPG_2.jpg,4116,480,640,49,441,490,213,297,True,13
B,139,kaist_dataset/Mixed/Digital_Camera/(C.S)C-outdoor1/049.JPG,char_data/B/049.JPG_2.jpg,8757,480,640,63,351,414,176,315,True,13
B,39,kaist_dataset/Mixed/Digital_Camera/(C.S)C-outdoor1/080.JPG,char_data/B/080.JPG_6.jpg,897,480,640,23,51,74,69,108,True,13
B,283,kaist_dataset/Mixed/Digital_Camera/(C.S)C-outdoor1/080118-0007.jpg,char_data/B/080118-0007.jpg_2.jpg,62543,1200,1600,221,848,1069,427,710,True,13
B,50,kaist_dataset/Mixed/Digital_Camera/(C.S)C-outdoor1/080119-0006.jpg,char_data/B/080119-0006.jpg_2.jpg,2100,1200,1600,42,545,587,734,784,True,13
B,117,kaist_dataset/Mixed/Digital_Camera/(C.S)C-outdoor1/080119-0027.jpg,char_data/B/080119-0027.jpg_2.jpg,15561,1200,1600,133,459,592,475,592,True,13
B,43,kaist_dataset/Mixed/Digital_Camera/(C.S)C-outdoor1/119.JPG,char_data/B/119.JPG_2.jpg,1505,480,640,35,349,384,193,236,True,13
B,32,kaist_dataset/Mixed/Digital_Camera/(C.S)C-outdoor1/2007-12-09-day-exterior-051.jpg,char_data/B/2007-12-09-day-exterior-051.jpg_6.jpg,832,1200,1600,26,496,522,642,674,True,13
B,81,kaist_dataset/Mixed/Digital_Camera/(C.S)C-outdoor1/2007-12-09-day-exterior-051.jpg,char_data/B/2007-12-09-day-exterior-051.jpg_7.jpg,7533,1200,1600,93,205,298,983,1064,True,13
B,103,kaist_dataset/Mixed/Digital_Camera/(C.S)C-outdoor1/2007-12-09-day-exterior-051.jpg,char_data/B/2007-12-09-day-exterior-051.jpg_8.jpg,11227,1200,1600,109,1352,1461,986,1089,True,13
B,20,kaist_dataset/Mixed/Digital_Camera/(C.S)C-outdoor1/3.JPG,char_data/B/3.JPG_4.jpg,300,576,768,15,278,293,63,83,True,13
B,25,kaist_dataset/Mixed/Digital_Camera/(C.S)C-outdoor1/3.JPG,char_data/B/3.JPG_5.jpg,400,576,768,16,481,497,51,76,True,13
B,31,kaist_dataset/Mixed/Digital_Camera/(C.S)C-outdoor1/DSC02240.JPG,char_data/B/DSC02240.JPG_2.jpg,651,480,640,21,231,252,282,313,True,13
B,48,kaist_dataset/Mixed/Digital_Camera/(C.S)C-outdoor1/DSC02309.JPG,char_data/B/DSC02309.JPG_4.jpg,1104,480,640,23,505,528,241,289,True,13
B,42,kaist_dataset/Mixed/Digital_Camera/(C.S)C-outdoor1/DSC02309.JPG,char_data/B/DSC02309.JPG_5.jpg,1134,480,640,27,437,464,391,433,True,13
B,35,kaist_dataset/Mixed/Digital_Camera/(C.S)C-outdoor1/DSC02323.JPG,char_data/B/DSC02323.JPG_2.jpg,875,480,640,25,44,69,280,315,True,13
B,32,kaist_dataset/Mixed/Digital_Camera/(C.S)C-outdoor2/DSC02397.JPG,char_data/B/DSC02397.JPG_6.jpg,576,480,640,18,10,28,143,175,True,13
B,150,kaist_dataset/Mixed/Digital_Camera/(C.S)C-outdoor2/DSC02397.JPG,char_data/B/DSC02397.JPG_7.jpg,21150,480,640,141,14,155,292,442,True,13
B,53,kaist_dataset/Mixed/Digital_Camera/(C.S)C-outdoor2/DSC02397.JPG,char_data/B/DSC02397.JPG_8.jpg,2650,480,640,50,561,611,425,478,True,13
B,26,kaist_dataset/Mixed/Digital_Camera/(C.S)C-outdoor2/DSC02483.JPG,char_data/B/DSC02483.JPG_2.jpg,546,480,640,21,246,267,153,179,True,13
B,31,kaist_dataset/Mixed/Digital_Camera/(C.S)C-outdoor2/DSC02890.JPG,char_data/B/DSC02890.JPG_2.jpg,620,480,640,20,199,219,407,438,True,13
B,55,kaist_dataset/Mixed/Digital_Camera/(C.S)C-outdoor3/DSC02962.JPG,char_data/B/DSC02962.JPG_2.jpg,2750,480,640,50,229,279,191,246,True,13
B,41,kaist_dataset/Mixed/Digital_Camera/(C.S)C-outdoor3/DSC03020.JPG,char_data/B/DSC03020.JPG_4.jpg,1230,480,640,30,261,291,258,299,True,13
B,116,kaist_dataset/Mixed/Digital_Camera/(C.S)C-outdoor3/DSC03186.JPG,char_data/B/DSC03186.JPG_2.jpg,12876,480,640,111,258,369,35,151,True,13
B,39,kaist_dataset/Mixed/Digital_Camera/(C.S)C-outdoor3/DSC03209.JPG,char_data/B/DSC03209.JPG_2.jpg,1131,480,640,29,146,175,415,454,True,13
B,43,kaist_dataset/Mixed/Digital_Camera/(C.S)C-outdoor3/DSC03210.JPG,char_data/B/DSC03210.JPG_2.jpg,774,480,640,18,140,158,144,187,True,13
B,94,kaist_dataset/Mixed/Digital_Camera/(C.S)C-outdoor3/DSC03217.JPG,char_data/B/DSC03217.JPG_2.jpg,8272,480,640,88,515,603,238,332,True,13
B,48,kaist_dataset/Mixed/Digital_Camera/(C.S)C-outdoor3/DSC03223.JPG,char_data/B/DSC03223.JPG_2.jpg,1632,480,640,34,130,164,431,479,True,13
B,44,kaist_dataset/Mixed/Digital_Camera/(C.S)C-outdoor3/DSC03308.JPG,char_data/B/DSC03308.JPG_2.jpg,1364,480,640,31,416,447,243,287,True,13
B,77,kaist_dataset/Mixed/Digital_Camera/(C.S)C-outdoor3/DSC03310.JPG,char_data/B/DSC03310.JPG_4.jpg,4928,480,640,64,96,160,116,193,True,13
B,61,kaist_dataset/Mixed/Digital_Camera/(C.S)C-outdoor3/DSC03310.JPG,char_data/B/DSC03310.JPG_5.jpg,1708,480,640,28,510,538,108,169,True,13
B,90,kaist_dataset/Mixed/Digital_Camera/(C.S)C-outdoor3/DSC03421.JPG,char_data/B/DSC03421.JPG_2.jpg,3330,480,640,37,59,96,216,306,True,13
B,42,kaist_dataset/Mixed/Digital_Camera/(C.S)C-outdoor3/DSC03428.JPG,char_data/B/DSC03428.JPG_2.jpg,1008,480,640,24,181,205,323,365,True,13
B,28,kaist_dataset/Mixed/Digital_Camera/(C.S)C-outdoor3/DSC03430.JPG,char_data/B/DSC03430.JPG_2.jpg,616,480,640,22,223,245,240,268,True,13
B,73,kaist_dataset/Mixed/Digital_Camera/(C.S)C-outdoor3/DSC03431.JPG,char_data/B/DSC03431.JPG_2.jpg,2847,480,640,39,27,66,29,102,True,13
B,54,kaist_dataset/Mixed/Digital_Camera/(C.S)C-outdoor4/DSC03433.JPG,char_data/B/DSC03433.JPG_2.jpg,1512,480,640,28,145,173,379,433,True,13
B,52,kaist_dataset/Mixed/Digital_Camera/(C.S)C-outdoor4/DSC03604.JPG,char_data/B/DSC03604.JPG_2.jpg,1508,480,640,29,296,325,206,258,True,13
B,30,kaist_dataset/Mixed/Digital_Camera/(C.S)C-outdoor4/DSC03670.JPG,char_data/B/DSC03670.JPG_2.jpg,810,480,640,27,178,205,323,353,True,13
B,47,kaist_dataset/Mixed/Digital_Camera/(C.S)C-outdoor4/DSC03677.JPG,char_data/B/DSC03677.JPG_2.jpg,893,480,640,19,73,92,289,336,True,13
B,57,kaist_dataset/Mixed/Digital_Camera/(C.S)C-outdoor4/DSC03678.JPG,char_data/B/DSC03678.JPG_2.jpg,1026,480,640,18,57,75,227,284,True,13
B,39,kaist_dataset/Mixed/Digital_Camera/(C.S)C-outdoor4/DSC03711.JPG,char_data/B/DSC03711.JPG_2.jpg,897,480,640,23,408,431,386,425,True,13
B,61,kaist_dataset/Mixed/Digital_Camera/(C.S)C-outdoor4/DSC03756.JPG,char_data/B/DSC03756.JPG_2.jpg,2806,480,640,46,342,388,385,446,True,13
B,29,kaist_dataset/Mixed/Digital_Camera/(C.S)C-outdoor4/DSC03758.JPG,char_data/B/DSC03758.JPG_2.jpg,754,480,640,26,177,203,272,301,True,13
B,42,kaist_dataset/Mixed/Digital_Camera/(C.S)C-outdoor4/DSC03764.JPG,char_data/B/DSC03764.JPG_2.jpg,1176,480,640,28,296,324,225,267,True,13
B,77,kaist_dataset/Mixed/Digital_Camera/(C.S)C-outdoor5/DSC03820.JPG,char_data/B/DSC03820.JPG_2.jpg,4158,480,640,54,328,382,360,437,True,13
B,78,kaist_dataset/Mixed/Digital_Camera/(C.S)C-outdoor5/DSC03822.JPG,char_data/B/DSC03822.JPG_2.jpg,4602,480,640,59,343,402,83,161,True,13
B,104,kaist_dataset/Mixed/Digital_Camera/(C.S)C-outdoor5/DSC03823.JPG,char_data/B/DSC03823.JPG_2.jpg,8840,480,640,85,237,322,75,179,True,13
B,52,kaist_dataset/Mixed/Digital_Camera/(C.S)C-outdoor5/DSC03847.JPG,char_data/B/DSC03847.JPG_2.jpg,1612,480,640,31,281,312,86,138,True,13
B,45,kaist_dataset/Mixed/Digital_Camera/(C.S)C-outdoor5/DSC04015.JPG,char_data/B/DSC04015.JPG_2.jpg,1125,480,640,25,250,275,125,170,True,13
B,70,kaist_dataset/Mixed/Digital_Camera/(C.S)C-outdoor5/DSC04029.JPG,char_data/B/DSC04029.JPG_2.jpg,2660,480,640,38,181,219,161,231,True,13
B,43,kaist_dataset/Mixed/Digital_Camera/(C.S)C-outdoor5/DSC04055.JPG,char_data/B/DSC04055.JPG_2.jpg,688,480,640,16,250,266,370,413,True,13
B,31,kaist_dataset/Mixed/Digital_Camera/(C.S)C-outdoor5/DSC04092.JPG,char_data/B/DSC04092.JPG_2.jpg,682,480,640,22,159,181,330,361,True,13
B,68,kaist_dataset/Mixed/Digital_Camera/(C.S)C-outdoor5/DSC04097.JPG,char_data/B/DSC04097.JPG_2.jpg,2856,480,640,42,473,515,177,245,True,13
B,50,kaist_dataset/Mixed/Digital_Camera/(C.S)C-outdoor5/DSC04104.JPG,char_data/B/DSC04104.JPG_2.jpg,1750,480,640,35,200,235,35,85,True,13
B,95,kaist_dataset/Mixed/Digital_Camera/(C.S)C-outdoor5/DSC04122.JPG,char_data/B/DSC04122.JPG_2.jpg,6555,480,640,69,204,273,294,389,True,13
B,194,kaist_dataset/Mixed/Digital_Camera/(C.S)C-outdoor5/DSC04447.JPG,char_data/B/DSC04447.JPG_4.jpg,28324,480,640,146,437,583,83,277,True,13
B,58,kaist_dataset/Mixed/Digital_Camera/(C.S)C-outdoor5/DSC04447.JPG,char_data/B/DSC04447.JPG_5.jpg,2378,480,640,41,402,443,348,406,True,13
B,125,kaist_dataset/Mixed/Digital_Camera/(C.S)C-outdoor5/DSC04465.JPG,char_data/B/DSC04465.JPG_2.jpg,9500,480,640,76,118,194,274,399,True,13
B,85,kaist_dataset/Mixed/Digital_Camera/(C.S)C-outdoor5/P1010006.JPG,char_data/B/P1010006.JPG_2.jpg,4335,480,640,51,346,397,214,299,True,13
B,179,kaist_dataset/Mixed/Digital_Camera/(C.S)C-outdoor6/080116-0057.jpg,char_data/B/080116-0057.jpg_2.jpg,25418,1200,1600,142,165,307,535,714,True,13
B,39,kaist_dataset/Mixed/Digital_Camera/(C.S)C-outdoor6/DSC03324.JPG,char_data/B/DSC03324.JPG_2.jpg,1092,480,640,28,11,39,57,96,True,13
B,35,kaist_dataset/Mixed/Digital_Camera/(C.S)C-outdoor6/P1010074.JPG,char_data/B/P1010074.JPG_2.jpg,1645,480,640,47,563,610,300,335,True,13
B,25,kaist_dataset/Mixed/Digital_Camera/(C.S)C-outdoor6/P1010096.JPG,char_data/B/P1010096.JPG_2.jpg,675,480,640,27,253,280,203,228,True,13
B,30,kaist_dataset/Mixed/Digital_Camera/(C.S)C-outdoor6/P1010138.JPG,char_data/B/P1010138.JPG_2.jpg,930,480,640,31,80,111,173,203,False,13
B,30,kaist_dataset/Mixed/Digital_Camera/(C.S)C-outdoor6/크기변환_P1010029.JPG,char_data/B/크기변환_P1010029.JPG_2.jpg,660,480,640,22,157,179,16,46,False,13
B,40,kaist_dataset/Mixed/Digital_Camera/(C.S)D-indoor1/DSC02714.JPG,char_data/B/DSC02714.JPG_2.jpg,1640,480,640,41,134,175,70,110,False,13
B,46,kaist_dataset/Mixed/Digital_Camera/(C.S)D-indoor1/DSC02746.JPG,char_data/B/DSC02746.JPG_2.jpg,2208,480,640,48,114,162,237,283,False,13
B,46,kaist_dataset/Mixed/Digital_Camera/(C.S)D-indoor1/DSC02747.JPG,char_data/B/DSC02747.JPG_2.jpg,3082,480,640,67,59,126,274,320,False,13
B,43,kaist_dataset/Mixed/Digital_Camera/(C.S)D-indoor1/DSC02748.JPG,char_data/B/DSC02748.JPG_2.jpg,2236,480,640,52,79,131,289,332,False,13
B,39,kaist_dataset/Mixed/Digital_Camera/(C.S)D-indoor1/DSC02749.JPG,char_data/B/DSC02749.JPG_2.jpg,2106,480,640,54,102,156,317,356,False,13
B,38,kaist_dataset/Mixed/Digital_Camera/(C.S)D-indoor1/DSC02750.JPG,char_data/B/DSC02750.JPG_2.jpg,2052,480,640,54,97,151,218,256,False,13
B,46,kaist_dataset/Mixed/Digital_Camera/(C.S)D-indoor1/DSC02751.JPG,char_data/B/DSC02751.JPG_2.jpg,2668,480,640,58,90,148,202,248,False,13
B,45,kaist_dataset/Mixed/Digital_Camera/(C.S)D-indoor1/DSC02752.JPG,char_data/B/DSC02752.JPG_2.jpg,3555,480,640,79,53,132,201,246,False,13
B,45,kaist_dataset/Mixed/Digital_Camera/(C.S)D-indoor1/DSC02755.JPG,char_data/B/DSC02755.JPG_2.jpg,3510,480,640,78,69,147,202,247,False,13
B,82,kaist_dataset/Mixed/Digital_Camera/(C.S)D-indoor1/DSC02756.JPG,char_data/B/DSC02756.JPG_4.jpg,3936,480,640,48,112,160,185,267,False,13
B,32,kaist_dataset/Mixed/Digital_Camera/(C.S)D-indoor1/DSC02756.JPG,char_data/B/DSC02756.JPG_5.jpg,576,480,640,18,362,380,145,177,False,13
B,42,kaist_dataset/Mixed/Digital_Camera/(C.S)D-indoor1/DSC03073.JPG,char_data/B/DSC03073.JPG_5.jpg,882,480,640,21,361,382,286,328,False,13
B,65,kaist_dataset/Mixed/Digital_Camera/(C.S)D-indoor1/DSC03121.JPG,char_data/B/DSC03121.JPG_2.jpg,2210,480,640,34,202,236,190,255,False,13
B,51,kaist_dataset/Mixed/Digital_Camera/(C.S)D-indoor1/DSC03124.JPG,char_data/B/DSC03124.JPG_2.jpg,1938,480,640,38,200,238,195,246,False,13
B,62,kaist_dataset/Mixed/Digital_Camera/(C.S)D-indoor1/DSC03130.JPG,char_data/B/DSC03130.JPG_2.jpg,2542,480,640,41,233,274,162,224,False,13
B,42,kaist_dataset/Mixed/Digital_Camera/(C.S)D-indoor1/DSC03134.JPG,char_data/B/DSC03134.JPG_2.jpg,1386,480,640,33,204,237,161,203,False,13
B,46,kaist_dataset/Mixed/Digital_Camera/(C.S)D-indoor1/DSC04009.JPG,char_data/B/DSC04009.JPG_2.jpg,1702,480,640,37,341,378,400,446,False,13
B,49,kaist_dataset/Mixed/Digital_Camera/(C.S)D-indoor2/DSC04487.JPG,char_data/B/DSC04487.JPG_2.jpg,1813,480,640,37,182,219,165,214,False,13
B,150,kaist_dataset/Mixed/Digital_Camera/(C.S)E-night/DSC02585.JPG,char_data/B/DSC02585.JPG_2.jpg,17850,480,640,119,141,260,226,376,False,13
B,46,kaist_dataset/Mixed/Digital_Camera/(C.S)E-night/DSC02623.JPG,char_data/B/DSC02623.JPG_2.jpg,1610,480,640,35,421,456,395,441,False,13
B,65,kaist_dataset/Mixed/Digital_Camera/(C.S)E-night/DSC02660.JPG,char_data/B/DSC02660.JPG_4.jpg,3835,480,640,59,200,259,74,139,False,13
B,35,kaist_dataset/Mixed/Digital_Camera/(C.S)E-night/DSC02660.JPG,char_data/B/DSC02660.JPG_5.jpg,665,480,640,19,330,349,380,415,False,13
B,34,kaist_dataset/Mixed/Digital_Camera/(C.S)E-night/DSC03031.JPG,char_data/B/DSC03031.JPG_2.jpg,646,480,640,19,273,292,24,58,False,13
B,57,kaist_dataset/Mixed/Digital_Camera/(C.S)E-night/DSC03840.JPG,char_data/B/DSC03840.JPG_2.jpg,2736,480,640,48,141,189,111,168,False,13
B,48,kaist_dataset/Mixed/Digital_Camera/(C.S)F-others/085.jpg,char_data/B/085.jpg_2.jpg,1248,480,640,26,372,398,181,229,False,13
B,170,kaist_dataset/Mixed/Digital_Camera/(C.S)F-others/2007-12-09-day-exterior-032.jpg,char_data/B/2007-12-09-day-exterior-032.jpg_4.jpg,10710,1600,1200,63,472,535,971,1141,False,13
B,32,kaist_dataset/Mixed/Digital_Camera/(C.S)F-others/2007-12-09-day-exterior-032.jpg,char_data/B/2007-12-09-day-exterior-032.jpg_5.jpg,1088,1600,1200,34,631,665,348,380,False,13
B,117,kaist_dataset/Mixed/Digital_Camera/(C.S)F-others/DSC02504.JPG,char_data/B/DSC02504.JPG_4.jpg,12051,480,640,103,139,242,161,278,False,13
B,49,kaist_dataset/Mixed/Digital_Camera/(C.S)F-others/DSC02504.JPG,char_data/B/DSC02504.JPG_5.jpg,2352,480,640,48,76,124,254,303,False,13
B,60,kaist_dataset/Mixed/Digital_Camera/(C.S)F-others/DSC02611.JPG,char_data/B/DSC02611.JPG_2.jpg,2640,480,640,44,212,256,81,141,False,13
B,43,kaist_dataset/Mixed/Digital_Camera/(C.S)F-others/DSC02803.JPG,char_data/B/DSC02803.JPG_2.jpg,1376,480,640,32,115,147,354,397,False,13
B,28,kaist_dataset/Mixed/Mobile_Phone/(C.M)A-outdoor/P090908006.jpg,char_data/B/P090908006.jpg_6.jpg,476,480,640,17,37,54,376,404,False,13
B,28,kaist_dataset/Mixed/Mobile_Phone/(C.M)A-outdoor/P090908006.jpg,char_data/B/P090908006.jpg_7.jpg,504,480,640,18,90,108,375,403,False,13
B,29,kaist_dataset/Mixed/Mobile_Phone/(C.M)A-outdoor/P090908006.jpg,char_data/B/P090908006.jpg_8.jpg,493,480,640,17,144,161,374,403,False,13
B,39,kaist_dataset/Mixed/Mobile_Phone/(C.M)A-outdoor/P090912062.jpg,char_data/B/P090912062.jpg_4.jpg,780,480,640,20,593,613,118,157,False,13
B,83,kaist_dataset/Mixed/Mobile_Phone/(C.M)A-outdoor/P090912062.jpg,char_data/B/P090912062.jpg_5.jpg,4482,480,640,54,15,69,92,175,False,13
B,43,kaist_dataset/Mixed/Mobile_Phone/(C.M)C-bookCover/P090831045.jpg,char_data/B/P090831045.jpg_2.jpg,1204,480,640,28,16,44,302,345,False,13
B,54,kaist_dataset/Mixed/Mobile_Phone/(C.M)C-bookCover/P090831124.jpg,char_data/B/P090831124.jpg_2.jpg,1890,480,640,35,346,381,117,171,False,13
문,34,kaist_dataset/English/Digital_Camera/(E.S)B-light/080116-0059.jpg,char_data/문/080116-0059.jpg_2.jpg,612,1200,1600,18,660,678,1079,1113,True,61
문,59,kaist_dataset/Korean/Digital_Camera/A-shadow/2007-12-09-day-exterior-025.jpg,char_data/문/2007-12-09-day-exterior-025.jpg_2.jpg,3068,1200,1600,52,146,198,832,891,True,61
문,38,kaist_dataset/Korean/Digital_Camera/A-shadow/2007-12-09-day-exterior-026.jpg,char_data/문/2007-12-09-day-exterior-026.jpg_2.jpg,1406,1200,1600,37,778,815,788,826,True,61
문,125,kaist_dataset/Korean/Digital_Camera/A-shadow/DSC03535.JPG,char_data/문/DSC03535.JPG_2.jpg,13375,480,640,107,347,454,64,189,True,61
문,40,kaist_dataset/Korean/Digital_Camera/A-shadow/DSC03536.JPG,char_data/문/DSC03536.JPG_2.jpg,1960,480,640,49,150,199,174,214,True,61
문,51,kaist_dataset/Korean/Digital_Camera/A-shadow/DSC03755.JPG,char_data/문/DSC03755.JPG_2.jpg,2142,480,640,42,48,90,199,250,True,61
문,37,kaist_dataset/Korean/Digital_Camera/B-light/DSC02987.JPG,char_data/문/DSC02987.JPG_2.jpg,1258,480,640,34,528,562,126,163,True,61
문,53,kaist_dataset/Korean/Digital_Camera/E-night/DSC02597.JPG,char_data/문/DSC02597.JPG_2.jpg,2544,480,640,48,485,533,27,80,True,61
문,32,kaist_dataset/Korean/Digital_Camera/E-night/DSC02626.JPG,char_data/문/DSC02626.JPG_2.jpg,992,480,640,31,544,575,132,164,True,61
문,36,kaist_dataset/Korean/Digital_Camera/E-night/DSC03850.JPG,char_data/문/DSC03850.JPG_2.jpg,1008,480,640,28,338,366,388,424,True,61
문,66,kaist_dataset/Korean/Digital_Camera/E-night/사진14.jpg 수정.jpg,char_data/문/사진14.jpg 수정.jpg_2.jpg,2772,300,400,42,179,221,161,227,True,61
문,167,kaist_dataset/Korean/Digital_Camera/F-bookCover/DSC02839.JPG,char_data/문/DSC02839.JPG_2.jpg,19539,480,640,117,350,467,276,443,True,61
문,61,kaist_dataset/Korean/Digital_Camera/F-bookCover/DSC04218.JPG,char_data/문/DSC04218.JPG_2.jpg,3172,480,640,52,143,195,195,256,True,61
문,97,kaist_dataset/Korean/Digital_Camera/F-bookCover/DSC04224.JPG,char_data/문/DSC04224.JPG_2.jpg,8342,480,640,86,480,566,147,244,True,61
문,107,kaist_dataset/Korean/Digital_Camera/F-bookCover/DSC04227.JPG,char_data/문/DSC04227.JPG_2.jpg,6527,480,640,61,257,318,62,169,True,61
문,101,kaist_dataset/Korean/Digital_Camera/F-bookCover/DSC04232.JPG,char_data/문/DSC04232.JPG_2.jpg,7676,480,640,76,104,180,125,226,True,61
문,61,kaist_dataset/Korean/Digital_Camera/F-bookCover/DSC04235.JPG,char_data/문/DSC04235.JPG_4.jpg,2135,480,640,35,167,202,97,158,True,61
문,56,kaist_dataset/Korean/Digital_Camera/F-bookCover/DSC04235.JPG,char_data/문/DSC04235.JPG_5.jpg,2128,480,640,38,310,348,104,160,True,61
문,90,kaist_dataset/Korean/Digital_Camera/F-bookCover/DSC04240.JPG,char_data/문/DSC04240.JPG_4.jpg,5670,480,640,63,135,198,82,172,True,61
문,74,kaist_dataset/Korean/Digital_Camera/F-bookCover/DSC04240.JPG,char_data/문/DSC04240.JPG_5.jpg,4736,480,640,64,312,376,97,171,True,61
문,85,kaist_dataset/Korean/Digital_Camera/F-bookCover/DSC04241.JPG,char_data/문/DSC04241.JPG_2.jpg,5610,480,640,66,169,235,251,336,True,61
문,138,kaist_dataset/Korean/Digital_Camera/G-others/2007-12-09-day-exterior-005.jpg,char_data/문/2007-12-09-day-exterior-005.jpg_2.jpg,16008,1600,1200,116,588,704,503,641,True,61
문,29,kaist_dataset/Korean/Digital_Camera/G-others/DSC03863.JPG,char_data/문/DSC03863.JPG_2.jpg,870,480,640,30,304,334,450,479,True,61
문,76,kaist_dataset/Korean/Digital_Camera/indoor1/080119-0029.jpg,char_data/문/080119-0029.jpg_2.jpg,6156,1200,1600,81,45,126,570,646,True,61
문,26,kaist_dataset/Korean/Digital_Camera/indoor1/136.JPG,char_data/문/136.JPG_2.jpg,702,480,640,27,324,351,264,290,True,61
문,99,kaist_dataset/Korean/Digital_Camera/indoor1/DSC02723.JPG,char_data/문/DSC02723.JPG_2.jpg,7722,480,640,78,321,399,329,428,True,61
문,96,kaist_dataset/Korean/Digital_Camera/indoor1/DSC02778.JPG,char_data/문/DSC02778.JPG_2.jpg,8352,480,640,87,334,421,279,375,True,61
문,98,kaist_dataset/Korean/Digital_Camera/indoor2/DSC03385.JPG,char_data/문/DSC03385.JPG_2.jpg,7742,480,640,79,34,113,301,399,True,61
문,83,kaist_dataset/Korean/Digital_Camera/indoor2/DSC03559.JPG,char_data/문/DSC03559.JPG_2.jpg,6557,480,640,79,100,179,73,156,True,61
문,107,kaist_dataset/Korean/Digital_Camera/indoor2/DSC03564.JPG,char_data/문/DSC03564.JPG_2.jpg,10914,480,640,102,229,331,55,162,True,61
문,60,kaist_dataset/Korean/Digital_Camera/indoor2/DSC03974.JPG,char_data/문/DSC03974.JPG_2.jpg,3480,480,640,58,399,457,410,470,True,61
문,48,kaist_dataset/Korean/Digital_Camera/indoor2/DSC04004.JPG,char_data/문/DSC04004.JPG_2.jpg,1296,480,640,27,327,354,156,204,True,61
문,119,kaist_dataset/Korean/Digital_Camera/indoor2/크기변환_%BD%C7%B3%BB%B0%A3%C6%C7_moon8481.jpg,char_data/문/크기변환_%BD%C7%B3%BB%B0%A3%C6%C7_moon8481.jpg_2.jpg,11424,480,640,96,125,221,39,158,True,61
문,24,kaist_dataset/Korean/Digital_Camera/outdoor1/011.JPG,char_data/문/011.JPG_2.jpg,456,480,640,19,184,203,259,283,True,61
문,40,kaist_dataset/Korean/Digital_Camera/outdoor1/018.JPG,char_data/문/018.JPG_2.jpg,560,480,640,14,158,172,173,213,True,61
문,33,kaist_dataset/Korean/Digital_Camera/outdoor1/026.jpg,char_data/문/026.jpg_2.jpg,561,480,640,17,429,446,258,291,True,61
문,88,kaist_dataset/Korean/Digital_Camera/outdoor1/028.JPG,char_data/문/028.JPG_2.jpg,8360,480,640,95,108,203,181,269,True,61
문,40,kaist_dataset/Korean/Digital_Camera/outdoor1/029.JPG,char_data/문/029.JPG_2.jpg,1400,480,640,35,321,356,147,187,True,61
문,85,kaist_dataset/Korean/Digital_Camera/outdoor1/039.JPG,char_data/문/039.JPG_2.jpg,5015,480,640,59,499,558,211,296,True,61
문,32,kaist_dataset/Korean/Digital_Camera/outdoor1/040.JPG,char_data/문/040.JPG_2.jpg,1184,480,640,37,412,449,147,179,True,61
문,103,kaist_dataset/Korean/Digital_Camera/outdoor1/106.JPG,char_data/문/106.JPG_2.jpg,10403,480,640,101,347,448,161,264,True,61
문,24,kaist_dataset/Korean/Digital_Camera/outdoor1/109.JPG,char_data/문/109.JPG_4.jpg,432,480,640,18,348,366,32,56,True,61
문,32,kaist_dataset/Korean/Digital_Camera/outdoor1/109.JPG,char_data/문/109.JPG_5.jpg,1056,480,640,33,228,261,109,141,True,61
문,26,kaist_dataset/Korean/Digital_Camera/outdoor1/125.JPG,char_data/문/125.JPG_2.jpg,572,480,640,22,136,158,255,281,True,61
문,34,kaist_dataset/Korean/Digital_Camera/outdoor1/2007-12-08-day-087.jpg,char_data/문/2007-12-08-day-087.jpg_2.jpg,1122,1200,1600,33,116,149,462,496,True,61
문,31,kaist_dataset/Korean/Digital_Camera/outdoor1/39.jpg,char_data/문/39.jpg_2.jpg,806,197,320,26,208,234,41,72,True,61
문,108,kaist_dataset/Korean/Digital_Camera/outdoor1/54.JPG,char_data/문/54.JPG_2.jpg,11232,523,767,104,363,467,248,356,True,61
문,58,kaist_dataset/Korean/Digital_Camera/outdoor2/2007-12-09-day-exterior-006.jpg,char_data/문/2007-12-09-day-exterior-006.jpg_2.jpg,3132,1200,1600,54,852,906,612,670,True,61
문,45,kaist_dataset/Korean/Digital_Camera/outdoor2/2007-12-09-day-exterior-007.jpg,char_data/문/2007-12-09-day-exterior-007.jpg_2.jpg,1935,1200,1600,43,71,114,331,376,True,61
문,77,kaist_dataset/Korean/Digital_Camera/outdoor2/2007-12-09-day-exterior-012.jpg,char_data/문/2007-12-09-day-exterior-012.jpg_2.jpg,5544,1200,1600,72,733,805,625,702,True,61
문,74,kaist_dataset/Korean/Digital_Camera/outdoor2/2007-12-09-day-exterior-035.jpg,char_data/문/2007-12-09-day-exterior-035.jpg_4.jpg,7622,1200,1600,103,1228,1331,626,700,True,61
문,38,kaist_dataset/Korean/Digital_Camera/outdoor2/2007-12-09-day-exterior-035.jpg,char_data/문/2007-12-09-day-exterior-035.jpg_5.jpg,1482,1200,1600,39,823,862,504,542,True,61
문,64,kaist_dataset/Korean/Digital_Camera/outdoor2/DSC02304.JPG,char_data/문/DSC02304.JPG_2.jpg,5504,480,640,86,550,636,169,233,True,61
문,36,kaist_dataset/Korean/Digital_Camera/outdoor2/DSC02326.JPG,char_data/문/DSC02326.JPG_2.jpg,936,480,640,26,135,161,152,188,True,61
문,45,kaist_dataset/Korean/Digital_Camera/outdoor2/DSC02366.JPG,char_data/문/DSC02366.JPG_2.jpg,1665,480,640,37,303,340,166,211,True,61
문,37,kaist_dataset/Korean/Digital_Camera/outdoor2/DSC02396.JPG,char_data/문/DSC02396.JPG_2.jpg,1184,480,640,32,338,370,173,210,True,61
문,32,kaist_dataset/Korean/Digital_Camera/outdoor2/DSC02420.JPG,char_data/문/DSC02420.JPG_2.jpg,1216,480,640,38,171,209,84,116,True,61
문,49,kaist_dataset/Korean/Digital_Camera/outdoor2/DSC02426.JPG,char_data/문/DSC02426.JPG_2.jpg,1960,480,640,40,228,268,215,264,True,61
문,105,kaist_dataset/Korean/Digital_Camera/outdoor2/DSC02453.JPG,char_data/문/DSC02453.JPG_2.jpg,8715,480,640,83,354,437,110,215,True,61
문,116,kaist_dataset/Korean/Digital_Camera/outdoor2/DSC02499.JPG,char_data/문/DSC02499.JPG_2.jpg,12064,480,640,104,141,245,126,242,True,61
문,58,kaist_dataset/Korean/Digital_Camera/outdoor3/DSC02891.JPG,char_data/문/DSC02891.JPG_2.jpg,2958,480,640,51,513,564,348,406,True,61
문,127,kaist_dataset/Korean/Digital_Camera/outdoor3/DSC02911.JPG,char_data/문/DSC02911.JPG_2.jpg,11049,480,640,87,14,101,134,261,True,61
문,65,kaist_dataset/Korean/Digital_Camera/outdoor3/DSC02934.JPG,char_data/문/DSC02934.JPG_2.jpg,4680,480,640,72,358,430,135,200,True,61
문,52,kaist_dataset/Korean/Digital_Camera/outdoor3/DSC03220.JPG,char_data/문/DSC03220.JPG_2.jpg,3172,480,640,61,490,551,51,103,True,61
문,28,kaist_dataset/Korean/Digital_Camera/outdoor3/DSC03232.JPG,char_data/문/DSC03232.JPG_2.jpg,1008,480,640,36,105,141,294,322,True,61
문,79,kaist_dataset/Korean/Digital_Camera/outdoor3/DSC03251.JPG,char_data/문/DSC03251.JPG_2.jpg,4187,480,640,53,409,462,269,348,True,61
문,41,kaist_dataset/Korean/Digital_Camera/outdoor4/DSC03272.JPG,char_data/문/DSC03272.JPG_2.jpg,1107,480,640,27,267,294,246,287,True,61
문,82,kaist_dataset/Korean/Digital_Camera/outdoor4/DSC03321.JPG,char_data/문/DSC03321.JPG_2.jpg,5904,480,640,72,372,444,104,186,True,61
문,72,kaist_dataset/Korean/Digital_Camera/outdoor4/DSC03443.JPG,char_data/문/DSC03443.JPG_2.jpg,4032,480,640,56,509,565,402,474,True,61
문,80,kaist_dataset/Korean/Digital_Camera/outdoor4/DSC03452.JPG,char_data/문/DSC03452.JPG_2.jpg,3200,480,640,40,410,450,191,271,True,61
문,42,kaist_dataset/Korean/Digital_Camera/outdoor4/DSC03545.JPG,char_data/문/DSC03545.JPG_2.jpg,2142,480,640,51,500,551,1,42,True,61
문,64,kaist_dataset/Korean/Digital_Camera/outdoor4/DSC03596.JPG,char_data/문/DSC03596.JPG_2.jpg,3264,480,640,51,195,246,139,203,True,61
문,94,kaist_dataset/Korean/Digital_Camera/outdoor5/DSC03623.JPG,char_data/문/DSC03623.JPG_2.jpg,7050,480,640,75,374,449,108,202,True,61
문,38,kaist_dataset/Korean/Digital_Camera/outdoor5/DSC03671.JPG,char_data/문/DSC03671.JPG_2.jpg,1216,480,640,32,434,466,264,302,True,61
문,52,kaist_dataset/Korean/Digital_Camera/outdoor5/DSC03708.JPG,char_data/문/DSC03708.JPG_2.jpg,2340,480,640,45,218,263,262,314,True,61
문,68,kaist_dataset/Korean/Digital_Camera/outdoor5/DSC03712.JPG,char_data/문/DSC03712.JPG_2.jpg,2856,480,640,42,573,615,46,114,True,61
문,81,kaist_dataset/Korean/Digital_Camera/outdoor5/DSC03727.JPG,char_data/문/DSC03727.JPG_2.jpg,5103,480,640,63,275,338,395,476,True,61
문,64,kaist_dataset/Korean/Digital_Camera/outdoor5/DSC03736.JPG,char_data/문/DSC03736.JPG_2.jpg,2496,480,640,39,387,426,338,402,True,61
문,36,kaist_dataset/Korean/Digital_Camera/outdoor5/DSC03740.JPG,char_data/문/DSC03740.JPG_2.jpg,1296,480,640,36,84,120,293,329,True,61
문,33,kaist_dataset/Korean/Digital_Camera/outdoor5/DSC03777.JPG,char_data/문/DSC03777.JPG_2.jpg,792,480,640,24,203,227,276,309,True,61
문,48,kaist_dataset/Korean/Digital_Camera/outdoor5/DSC03838.JPG,char_data/문/DSC03838.JPG_2.jpg,1776,480,640,37,320,357,139,187,True,61
문,28,kaist_dataset/Korean/Digital_Camera/outdoor5/DSC04028.JPG,char_data/문/DSC04028.JPG_2.jpg,1008,480,640,36,429,465,243,271,True,61
문,120,kaist_dataset/Korean/Digital_Camera/outdoor5/DSC04034.JPG,char_data/문/DSC04034.JPG_2.jpg,7440,480,640,62,313,375,296,416,True,61
문,45,kaist_dataset/Korean/Digital_Camera/outdoor5/DSC04040.JPG,char_data/문/DSC04040.JPG_8.jpg,1710,480,640,38,63,101,123,168,True,61
문,60,kaist_dataset/Korean/Digital_Camera/outdoor5/DSC04040.JPG,char_data/문/DSC04040.JPG_9.jpg,3180,480,640,53,217,270,118,178,True,61
문,36,kaist_dataset/Korean/Digital_Camera/outdoor5/DSC04040.JPG,char_data/문/DSC04040.JPG_10.jpg,1476,480,640,41,222,263,186,222,True,61
문,113,kaist_dataset/Korean/Digital_Camera/outdoor5/DSC04040.JPG,char_data/문/DSC04040.JPG_11.jpg,11413,480,640,101,318,419,223,336,True,61
문,61,kaist_dataset/Korean/Digital_Camera/outdoor6/DSC04050.JPG,char_data/문/DSC04050.JPG_2.jpg,4636,480,640,76,474,550,150,211,True,61
문,77,kaist_dataset/Korean/Digital_Camera/outdoor6/DSC04089.JPG,char_data/문/DSC04089.JPG_2.jpg,4158,480,640,54,398,452,184,261,True,61
문,40,kaist_dataset/Korean/Digital_Camera/outdoor6/DSC04090.JPG,char_data/문/DSC04090.JPG_2.jpg,1320,480,640,33,380,413,31,71,True,61
문,83,kaist_dataset/Korean/Digital_Camera/outdoor6/DSC04134.JPG,char_data/문/DSC04134.JPG_2.jpg,6723,480,640,81,458,539,391,474,True,61
문,154,kaist_dataset/Korean/Digital_Camera/outdoor6/DSC04301.JPG,char_data/문/DSC04301.JPG_4.jpg,13090,480,640,85,351,436,171,325,True,61
문,91,kaist_dataset/Korean/Digital_Camera/outdoor6/DSC04301.JPG,char_data/문/DSC04301.JPG_5.jpg,8008,480,640,88,225,313,54,145,True,61
문,80,kaist_dataset/Korean/Digital_Camera/outdoor6/DSC04328.JPG,char_data/문/DSC04328.JPG_2.jpg,3360,480,640,42,489,531,22,102,True,61
문,129,kaist_dataset/Korean/Digital_Camera/outdoor6/DSC04370.JPG,char_data/문/DSC04370.JPG_4.jpg,8127,480,640,63,361,424,161,290,True,61
문,85,kaist_dataset/Korean/Digital_Camera/outdoor6/DSC04370.JPG,char_data/문/DSC04370.JPG_5.jpg,5610,480,640,66,262,328,65,150,True,61
문,74,kaist_dataset/Korean/Digital_Camera/outdoor6/DSC04445.JPG,char_data/문/DSC04445.JPG_2.jpg,5032,480,640,68,359,427,93,167,True,61
문,110,kaist_dataset/Korean/Digital_Camera/outdoor7/DSC04457.JPG,char_data/문/DSC04457.JPG_2.jpg,12100,480,640,110,511,621,210,320,True,61
문,131,kaist_dataset/Korean/Digital_Camera/outdoor7/P1010011.JPG,char_data/문/P1010011.JPG_2.jpg,13755,480,640,105,264,369,83,214,True,61
문,82,kaist_dataset/Korean/Digital_Camera/outdoor7/P1010015.JPG,char_data/문/P1010015.JPG_2.jpg,4264,480,640,52,466,518,204,286,True,61
문,81,kaist_dataset/Korean/Digital_Camera/outdoor7/P1010055.JPG,char_data/문/P1010055.JPG_2.jpg,8424,480,640,104,410,514,109,190,True,61
문,86,kaist_dataset/Korean/Digital_Camera/outdoor7/P1010072.JPG,char_data/문/P1010072.JPG_2.jpg,4386,480,640,51,497,548,117,203,True,61
문,53,kaist_dataset/Korean/Digital_Camera/outdoor7/P1010075.JPG,char_data/문/P1010075.JPG_4.jpg,4134,480,640,78,130,208,183,236,True,61
문,72,kaist_dataset/Korean/Digital_Camera/outdoor7/P1010126.JPG,char_data/문/P1010126.JPG_2.jpg,4608,480,640,64,285,349,157,229,True,61
문,26,kaist_dataset/Korean/Digital_Camera/outdoor7/P1010135.JPG,char_data/문/P1010135.JPG_2.jpg,754,480,640,29,458,487,91,117,True,61
문,54,kaist_dataset/Korean/Digital_Camera/outdoor7/P1010138.JPG,char_data/문/P1010138.JPG_2.jpg,2646,480,640,49,469,518,219,273,True,61
문,75,kaist_dataset/Korean/Digital_Camera/outdoor8/P090912069.jpg,char_data/문/P090912069.jpg_2.jpg,3675,480,640,49,433,482,136,211,True,61
문,80,kaist_dataset/Korean/Digital_Camera/outdoor8/P1010142.JPG,char_data/문/P1010142.JPG_2.jpg,6960,480,640,87,429,516,172,252,True,61
문,48,kaist_dataset/Korean/Digital_Camera/outdoor8/sharp2번_039.jpg,char_data/문/sharp2번_039.jpg_2.jpg,1536,240,320,32,248,280,103,151,True,61
문,130,"kaist_dataset/Korean/Mobile_Phone/(M,K)E-bookCover/P090831031.jpg",char_data/문/P090831031.jpg_2.jpg,11180,480,640,86,228,314,159,289,True,61
문,118,"kaist_dataset/Korean/Mobile_Phone/(M,K)E-bookCover/P090831036.jpg",char_data/문/P090831036.jpg_2.jpg,11682,480,640,99,396,495,230,348,True,61
문,138,"kaist_dataset/Korean/Mobile_Phone/(M,K)E-bookCover/P090831055.jpg",char_data/문/P090831055.jpg_2.jpg,12834,480,640,93,380,473,291,429,True,61
문,116,"kaist_dataset/Korean/Mobile_Phone/(M,K)E-bookCover/P090831090.jpg",char_data/문/P090831090.jpg_2.jpg,10788,480,640,93,318,411,11,127,True,61
문,108,"kaist_dataset/Korean/Mobile_Phone/(M,K)E-bookCover/P090831099.jpg",char_data/문/P090831099.jpg_2.jpg,10584,480,640,98,208,306,3,111,True,61
문,63,kaist_dataset/Mixed/Digital_Camera/(C.S)C-outdoor1/014.JPG,char_data/문/014.JPG_2.jpg,2394,480,640,38,559,597,192,255,True,61
문,51,kaist_dataset/Mixed/Digital_Camera/(C.S)C-outdoor1/025.JPG,char_data/문/025.JPG_2.jpg,1887,480,640,37,471,508,85,136,True,61
문,21,kaist_dataset/Mixed/Digital_Camera/(C.S)C-outdoor1/048.JPG,char_data/문/048.JPG_2.jpg,231,480,640,11,144,155,155,176,True,61
문,85,kaist_dataset/Mixed/Digital_Camera/(C.S)C-outdoor1/080119-0017.jpg,char_data/문/080119-0017.jpg_2.jpg,6290,1200,1600,74,593,667,1109,1194,True,61
문,45,kaist_dataset/Mixed/Digital_Camera/(C.S)C-outdoor1/2.JPG,char_data/문/2.JPG_2.jpg,1485,576,768,33,352,385,16,61,True,61
문,70,kaist_dataset/Mixed/Digital_Camera/(C.S)C-outdoor2/DSC02361.JPG,char_data/문/DSC02361.JPG_2.jpg,6230,480,640,89,550,639,287,357,True,61
문,47,kaist_dataset/Mixed/Digital_Camera/(C.S)C-outdoor2/DSC02376.JPG,char_data/문/DSC02376.JPG_2.jpg,1927,480,640,41,200,241,135,182,True,61
문,30,kaist_dataset/Mixed/Digital_Camera/(C.S)C-outdoor2/DSC02379.JPG,char_data/문/DSC02379.JPG_2.jpg,570,480,640,19,296,315,293,323,True,61
문,31,kaist_dataset/Mixed/Digital_Camera/(C.S)C-outdoor2/DSC02411.JPG,char_data/문/DSC02411.JPG_2.jpg,1147,480,640,37,222,259,158,189,True,61
문,42,kaist_dataset/Mixed/Digital_Camera/(C.S)C-outdoor2/DSC02434.JPG,char_data/문/DSC02434.JPG_2.jpg,1932,480,640,46,498,544,121,163,True,61
문,40,kaist_dataset/Mixed/Digital_Camera/(C.S)C-outdoor2/DSC02490.JPG,char_data/문/DSC02490.JPG_2.jpg,1400,480,640,35,265,300,42,82,True,61
문,154,kaist_dataset/Mixed/Digital_Camera/(C.S)C-outdoor2/DSC02503.JPG,char_data/문/DSC02503.JPG_2.jpg,18942,480,640,123,314,437,128,282,True,61
문,46,kaist_dataset/Mixed/Digital_Camera/(C.S)C-outdoor2/DSC02872.JPG,char_data/문/DSC02872.JPG_2.jpg,1610,480,640,35,301,336,384,430,True,61
문,58,kaist_dataset/Mixed/Digital_Camera/(C.S)C-outdoor2/DSC02912.JPG,char_data/문/DSC02912.JPG_2.jpg,2320,480,640,40,427,467,60,118,True,61
문,49,kaist_dataset/Mixed/Digital_Camera/(C.S)C-outdoor2/DSC02937.JPG,char_data/문/DSC02937.JPG_2.jpg,1813,480,640,37,506,543,184,233,True,61
문,45,kaist_dataset/Mixed/Digital_Camera/(C.S)C-outdoor3/DSC03061.JPG,char_data/문/DSC03061.JPG_2.jpg,990,480,640,22,105,127,248,293,True,61
문,54,kaist_dataset/Mixed/Digital_Camera/(C.S)C-outdoor3/DSC03196.JPG,char_data/문/DSC03196.JPG_2.jpg,2052,480,640,38,532,570,390,444,True,61
문,49,kaist_dataset/Mixed/Digital_Camera/(C.S)C-outdoor3/DSC03212.JPG,char_data/문/DSC03212.JPG_2.jpg,1568,480,640,32,197,229,253,302,True,61
문,64,kaist_dataset/Mixed/Digital_Camera/(C.S)C-outdoor3/DSC03227.JPG,char_data/문/DSC03227.JPG_2.jpg,2624,480,640,41,376,417,390,454,True,61
문,44,kaist_dataset/Mixed/Digital_Camera/(C.S)C-outdoor3/DSC03249.JPG,char_data/문/DSC03249.JPG_2.jpg,1716,480,640,39,352,391,239,283,True,61
문,46,kaist_dataset/Mixed/Digital_Camera/(C.S)C-outdoor3/DSC03283.JPG,char_data/문/DSC03283.JPG_2.jpg,1288,480,640,28,384,412,150,196,True,61
문,36,kaist_dataset/Mixed/Digital_Camera/(C.S)C-outdoor3/DSC03301.JPG,char_data/문/DSC03301.JPG_2.jpg,1224,480,640,34,264,298,150,186,True,61
문,52,kaist_dataset/Mixed/Digital_Camera/(C.S)C-outdoor3/DSC03332.JPG,char_data/문/DSC03332.JPG_2.jpg,2548,480,640,49,477,526,103,155,True,61
문,72,kaist_dataset/Mixed/Digital_Camera/(C.S)C-outdoor3/DSC03430.JPG,char_data/문/DSC03430.JPG_2.jpg,4752,480,640,66,298,364,143,215,True,61
문,36,kaist_dataset/Mixed/Digital_Camera/(C.S)C-outdoor4/DSC03435.JPG,char_data/문/DSC03435.JPG_2.jpg,1044,480,640,29,360,389,238,274,True,61
문,55,kaist_dataset/Mixed/Digital_Camera/(C.S)C-outdoor4/DSC03620.JPG,char_data/문/DSC03620.JPG_2.jpg,4015,480,640,73,321,394,83,138,True,61
문,42,kaist_dataset/Mixed/Digital_Camera/(C.S)C-outdoor4/DSC03634.JPG,char_data/문/DSC03634.JPG_4.jpg,1218,480,640,29,330,359,422,464,True,61
문,41,kaist_dataset/Mixed/Digital_Camera/(C.S)C-outdoor4/DSC03634.JPG,char_data/문/DSC03634.JPG_5.jpg,1845,480,640,45,507,552,370,411,True,61
문,54,kaist_dataset/Mixed/Digital_Camera/(C.S)C-outdoor4/DSC03667.JPG,char_data/문/DSC03667.JPG_2.jpg,2808,480,640,52,116,168,284,338,True,61
문,36,kaist_dataset/Mixed/Digital_Camera/(C.S)C-outdoor4/DSC03672.JPG,char_data/문/DSC03672.JPG_2.jpg,1152,480,640,32,319,351,125,161,True,61
문,38,kaist_dataset/Mixed/Digital_Camera/(C.S)C-outdoor4/DSC03730.JPG,char_data/문/DSC03730.JPG_2.jpg,1444,480,640,38,124,162,261,299,True,61
문,43,kaist_dataset/Mixed/Digital_Camera/(C.S)C-outdoor4/DSC03732.JPG,char_data/문/DSC03732.JPG_2.jpg,2021,480,640,47,72,119,398,441,True,61
문,40,kaist_dataset/Mixed/Digital_Camera/(C.S)C-outdoor4/DSC03735.JPG,char_data/문/DSC03735.JPG_2.jpg,800,480,640,20,330,350,187,227,True,61
문,36,kaist_dataset/Mixed/Digital_Camera/(C.S)C-outdoor4/DSC03745.JPG,char_data/문/DSC03745.JPG_2.jpg,1188,480,640,33,357,390,221,257,True,61
문,56,kaist_dataset/Mixed/Digital_Camera/(C.S)C-outdoor4/DSC03773.JPG,char_data/문/DSC03773.JPG_2.jpg,2352,480,640,42,213,255,106,162,True,61
문,68,kaist_dataset/Mixed/Digital_Camera/(C.S)C-outdoor4/DSC03781.JPG,char_data/문/DSC03781.JPG_2.jpg,4012,480,640,59,63,122,220,288,True,61
문,65,kaist_dataset/Mixed/Digital_Camera/(C.S)C-outdoor4/DSC03785.JPG,char_data/문/DSC03785.JPG_2.jpg,3315,480,640,51,216,267,24,89,True,61
문,40,kaist_dataset/Mixed/Digital_Camera/(C.S)C-outdoor5/DSC03821.JPG,char_data/문/DSC03821.JPG_2.jpg,920,480,640,23,84,107,79,119,True,61
문,72,kaist_dataset/Mixed/Digital_Camera/(C.S)C-outdoor5/DSC03830.JPG,char_data/문/DSC03830.JPG_2.jpg,2736,480,640,38,540,578,26,98,True,61
문,49,kaist_dataset/Mixed/Digital_Camera/(C.S)C-outdoor5/DSC03837.JPG,char_data/문/DSC03837.JPG_2.jpg,1421,480,640,29,155,184,245,294,True,61
문,63,kaist_dataset/Mixed/Digital_Camera/(C.S)C-outdoor5/DSC03847.JPG,char_data/문/DSC03847.JPG_2.jpg,2961,480,640,47,136,183,14,77,True,61
문,112,kaist_dataset/Mixed/Digital_Camera/(C.S)C-outdoor5/DSC04013.JPG,char_data/문/DSC04013.JPG_2.jpg,5152,480,640,46,492,538,317,429,True,61
문,34,kaist_dataset/Mixed/Digital_Camera/(C.S)C-outdoor5/DSC04124.JPG,char_data/문/DSC04124.JPG_2.jpg,476,480,640,14,173,187,148,182,True,61
문,44,kaist_dataset/Mixed/Digital_Camera/(C.S)C-outdoor5/DSC04150.JPG,char_data/문/DSC04150.JPG_2.jpg,1276,480,640,29,571,600,309,353,False,61
문,56,kaist_dataset/Mixed/Digital_Camera/(C.S)C-outdoor5/DSC04337.JPG,char_data/문/DSC04337.JPG_2.jpg,1792,480,640,32,440,472,108,164,False,61
문,62,kaist_dataset/Mixed/Digital_Camera/(C.S)C-outdoor5/DSC04349.JPG,char_data/문/DSC04349.JPG_2.jpg,3224,480,640,52,203,255,302,364,False,61
문,35,kaist_dataset/Mixed/Digital_Camera/(C.S)C-outdoor5/DSC04434.JPG,char_data/문/DSC04434.JPG_2.jpg,1015,480,640,29,262,291,433,468,False,61
문,87,kaist_dataset/Mixed/Digital_Camera/(C.S)C-outdoor5/P1010007.JPG,char_data/문/P1010007.JPG_2.jpg,5220,480,640,60,206,266,356,443,False,61
문,103,kaist_dataset/Mixed/Digital_Camera/(C.S)C-outdoor6/P1010018.JPG,char_data/문/P1010018.JPG_2.jpg,10712,480,640,104,283,387,123,226,False,61
문,107,kaist_dataset/Mixed/Digital_Camera/(C.S)C-outdoor6/P1010021.JPG,char_data/문/P1010021.JPG_4.jpg,14766,480,640,138,337,475,87,194,False,61
문,41,kaist_dataset/Mixed/Digital_Camera/(C.S)C-outdoor6/P1010021.JPG,char_data/문/P1010021.JPG_5.jpg,1640,480,640,40,198,238,408,449,False,61
문,38,kaist_dataset/Mixed/Digital_Camera/(C.S)C-outdoor6/P1010073.JPG,char_data/문/P1010073.JPG_2.jpg,1026,480,640,27,230,257,236,274,False,61
문,29,kaist_dataset/Mixed/Digital_Camera/(C.S)C-outdoor6/P1010075.JPG,char_data/문/P1010075.JPG_5.jpg,522,480,640,18,501,519,134,163,False,61
문,34,kaist_dataset/Mixed/Digital_Camera/(C.S)C-outdoor6/P1010097.JPG,char_data/문/P1010097.JPG_4.jpg,884,480,640,26,33,59,51,85,False,61
문,72,kaist_dataset/Mixed/Digital_Camera/(C.S)C-outdoor6/P1010097.JPG,char_data/문/P1010097.JPG_5.jpg,3960,480,640,55,194,249,93,165,False,61
문,40,kaist_dataset/Mixed/Digital_Camera/(C.S)C-outdoor6/P1010098.JPG,char_data/문/P1010098.JPG_2.jpg,1000,480,640,25,27,52,434,474,False,61
문,52,kaist_dataset/Mixed/Digital_Camera/(C.S)C-outdoor6/P1010114.JPG,char_data/문/P1010114.JPG_2.jpg,2496,480,640,48,407,455,13,65,False,61
문,108,kaist_dataset/Mixed/Digital_Camera/(C.S)C-outdoor6/크기변환_P1010029.JPG,char_data/문/크기변환_P1010029.JPG_2.jpg,7128,480,640,66,295,361,127,235,False,61
문,62,kaist_dataset/Mixed/Digital_Camera/(C.S)D-indoor1/DSC02724.JPG,char_data/문/DSC02724.JPG_2.jpg,2728,480,640,44,81,125,110,172,False,61
문,37,kaist_dataset/Mixed/Digital_Camera/(C.S)D-indoor1/DSC02751.JPG,char_data/문/DSC02751.JPG_2.jpg,1998,480,640,54,401,455,246,283,False,61
문,66,kaist_dataset/Mixed/Digital_Camera/(C.S)D-indoor1/DSC02755.JPG,char_data/문/DSC02755.JPG_2.jpg,3498,480,640,53,419,472,205,271,False,61
문,161,kaist_dataset/Mixed/Digital_Camera/(C.S)D-indoor1/DSC02770.JPG,char_data/문/DSC02770.JPG_2.jpg,27370,480,640,170,140,310,152,313,False,61
문,68,kaist_dataset/Mixed/Digital_Camera/(C.S)D-indoor1/DSC02776.JPG,char_data/문/DSC02776.JPG_2.jpg,4828,480,640,71,354,425,210,278,False,61
문,50,kaist_dataset/Mixed/Digital_Camera/(C.S)D-indoor1/DSC03119.JPG,char_data/문/DSC03119.JPG_2.jpg,2150,480,640,43,337,380,231,281,False,61
문,47,kaist_dataset/Mixed/Digital_Camera/(C.S)D-indoor1/DSC03478.JPG,char_data/문/DSC03478.JPG_2.jpg,2350,480,640,50,369,419,98,145,False,61
문,116,kaist_dataset/Mixed/Digital_Camera/(C.S)D-indoor1/DSC03479.JPG,char_data/문/DSC03479.JPG_2.jpg,9744,480,640,84,536,620,326,442,False,61
문,78,kaist_dataset/Mixed/Digital_Camera/(C.S)D-indoor1/DSC03998.JPG,char_data/문/DSC03998.JPG_2.jpg,2028,480,640,26,538,564,310,388,False,61
문,138,kaist_dataset/Mixed/Digital_Camera/(C.S)D-indoor1/DSC04002.JPG,char_data/문/DSC04002.JPG_2.jpg,5796,480,640,42,398,440,138,276,False,61
문,142,kaist_dataset/Mixed/Digital_Camera/(C.S)D-indoor1/DSC04233.JPG,char_data/문/DSC04233.JPG_2.jpg,17892,480,640,126,210,336,179,321,False,61
문,41,kaist_dataset/Mixed/Digital_Camera/(C.S)E-night/DSC02569.JPG,char_data/문/DSC02569.JPG_2.jpg,1394,480,640,34,406,440,366,407,False,61
문,61,kaist_dataset/Mixed/Digital_Camera/(C.S)E-night/DSC02574.JPG,char_data/문/DSC02574.JPG_2.jpg,2989,480,640,49,165,214,408,469,False,61
문,53,kaist_dataset/Mixed/Digital_Camera/(C.S)E-night/DSC02585.JPG,char_data/문/DSC02585.JPG_2.jpg,1749,480,640,33,244,277,400,453,False,61
문,40,kaist_dataset/Mixed/Digital_Camera/(C.S)E-night/DSC02586.JPG,char_data/문/DSC02586.JPG_2.jpg,1320,480,640,33,360,393,169,209,False,61
문,52,kaist_dataset/Mixed/Digital_Camera/(C.S)E-night/DSC02602.JPG,char_data/문/DSC02602.JPG_2.jpg,2652,480,640,51,349,400,311,363,False,61
문,38,kaist_dataset/Mixed/Digital_Camera/(C.S)E-night/DSC03561.JPG,char_data/문/DSC03561.JPG_2.jpg,1292,480,640,34,356,390,28,66,False,61
문,95,kaist_dataset/Mixed/Digital_Camera/(C.S)E-night/DSC03871.JPG,char_data/문/DSC03871.JPG_2.jpg,5985,480,640,63,446,509,100,195,False,61
문,25,kaist_dataset/Mixed/Digital_Camera/(C.S)F-others/085.jpg,char_data/문/085.jpg_2.jpg,325,480,640,13,430,443,234,259,False,61
문,40,kaist_dataset/Mixed/Digital_Camera/(C.S)F-others/097.jpg,char_data/문/097.jpg_2.jpg,640,480,640,16,468,484,309,349,False,61
문,182,kaist_dataset/Mixed/Digital_Camera/(C.S)F-others/2007-12-08-day-067.jpg,char_data/문/2007-12-08-day-067.jpg_2.jpg,23296,1600,1200,128,520,648,356,538,False,61
문,50,kaist_dataset/Mixed/Digital_Camera/(C.S)F-others/2007-12-08-day-113.jpg,char_data/문/2007-12-08-day-113.jpg_2.jpg,1600,1200,1600,32,1014,1046,864,914,False,61
문,43,kaist_dataset/Mixed/Mobile_Phone/(C.M)C-bookCover/P090902016.jpg,char_data/문/P090902016.jpg_2.jpg,1720,480,640,40,522,562,207,250,False,61
문,136,kaist_dataset/Mixed/Mobile_Phone/(C.M)C-bookCover/P090903072.jpg,char_data/문/P090903072.jpg_2.jpg,17816,480,640,131,465,596,197,333,False,61
문,117,kaist_dataset/Mixed/Mobile_Phone/(C.M)C-bookCover/P090905002.jpg,char_data/문/P090905002.jpg_2.jpg,11583,480,640,99,294,393,158,275,False,61
원,36,kaist_dataset/English/Digital_Camera/(E.S)B-light/080116-0059.jpg,char_data/원/080116-0059.jpg_2.jpg,684,1200,1600,19,538,557,1038,1074,True,73
원,265,kaist_dataset/Korean/Digital_Camera/A-shadow/2007-12-09-day-exterior-025.jpg,char_data/원/2007-12-09-day-exterior-025.jpg_2.jpg,56445,1200,1600,213,775,988,390,655,True,73
원,89,kaist_dataset/Korean/Digital_Camera/A-shadow/DSC03536.JPG,char_data/원/DSC03536.JPG_2.jpg,8099,480,640,91,400,491,127,216,True,73
원,122,kaist_dataset/Korean/Digital_Camera/E-night/DSC02626.JPG,char_data/원/DSC02626.JPG_2.jpg,11712,480,640,96,160,256,214,336,True,73
원,128,kaist_dataset/Korean/Digital_Camera/E-night/DSC03503.JPG,char_data/원/DSC03503.JPG_2.jpg,12800,480,640,100,524,624,116,244,True,73
원,33,kaist_dataset/Korean/Digital_Camera/E-night/DSC03851.JPG,char_data/원/DSC03851.JPG_2.jpg,1518,480,640,46,490,536,322,355,True,73
원,30,kaist_dataset/Korean/Digital_Camera/E-night/P1010149.JPG,char_data/원/P1010149.JPG_2.jpg,990,480,640,33,491,524,228,258,True,73
원,151,kaist_dataset/Korean/Digital_Camera/F-bookCover/DSC02838.JPG,char_data/원/DSC02838.JPG_2.jpg,22197,480,640,147,148,295,30,181,True,73
원,55,kaist_dataset/Korean/Digital_Camera/G-others/005.JPG,char_data/원/005.JPG_2.jpg,1980,768,576,36,389,425,363,418,True,73
원,175,kaist_dataset/Korean/Digital_Camera/G-others/2007-12-08-day-108.jpg,char_data/원/2007-12-08-day-108.jpg_2.jpg,22575,1200,1600,129,494,623,383,558,True,73
원,112,kaist_dataset/Korean/Digital_Camera/G-others/2007-12-09-day-exterior-005.jpg,char_data/원/2007-12-09-day-exterior-005.jpg_4.jpg,19600,1600,1200,175,8,183,1209,1321,True,73
원,120,kaist_dataset/Korean/Digital_Camera/G-others/2007-12-09-day-exterior-005.jpg,char_data/원/2007-12-09-day-exterior-005.jpg_5.jpg,11400,1600,1200,95,740,835,340,460,True,73
원,278,kaist_dataset/Korean/Digital_Camera/G-others/2007-12-09-day-exterior-062.jpg,char_data/원/2007-12-09-day-exterior-062.jpg_2.jpg,78118,1600,1200,281,455,736,1106,1384,True,73
원,84,kaist_dataset/Korean/Digital_Camera/G-others/DSC03862.JPG,char_data/원/DSC03862.JPG_2.jpg,8316,480,640,99,269,368,223,307,True,73
원,32,kaist_dataset/Korean/Digital_Camera/indoor1/145.JPG,char_data/원/145.JPG_4.jpg,896,480,640,28,46,74,241,273,True,73
원,25,kaist_dataset/Korean/Digital_Camera/indoor1/145.JPG,char_data/원/145.JPG_5.jpg,700,480,640,28,604,632,243,268,True,73
원,78,kaist_dataset/Korean/Digital_Camera/indoor1/DSC02699.JPG,char_data/원/DSC02699.JPG_2.jpg,4368,480,640,56,489,545,349,427,True,73
원,61,kaist_dataset/Korean/Digital_Camera/indoor1/DSC02700.JPG,char_data/원/DSC02700.JPG_2.jpg,3172,480,640,52,535,587,315,376,True,73
원,106,kaist_dataset/Korean/Digital_Camera/indoor1/DSC02705.JPG,char_data/원/DSC02705.JPG_2.jpg,7102,480,640,67,286,353,202,308,True,73
원,85,kaist_dataset/Korean/Digital_Camera/indoor1/DSC02723.JPG,char_data/원/DSC02723.JPG_2.jpg,4675,480,640,55,225,280,218,303,True,73
원,104,kaist_dataset/Korean/Digital_Camera/indoor1/DSC03154.JPG,char_data/원/DSC03154.JPG_2.jpg,7488,480,640,72,218,290,183,287,True,73
원,50,kaist_dataset/Korean/Digital_Camera/indoor1/DSC03364.JPG,char_data/원/DSC03364.JPG_2.jpg,2050,480,640,41,538,579,280,330,True,73
원,46,kaist_dataset/Korean/Digital_Camera/indoor1/DSC03375.JPG,char_data/원/DSC03375.JPG_2.jpg,1978,480,640,43,521,564,236,282,True,73
원,102,kaist_dataset/Korean/Digital_Camera/indoor2/DSC03474.JPG,char_data/원/DSC03474.JPG_2.jpg,8160,480,640,80,397,477,44,146,True,73
원,60,kaist_dataset/Korean/Digital_Camera/indoor2/DSC03475.JPG,char_data/원/DSC03475.JPG_2.jpg,4020,480,640,67,378,445,22,82,True,73
원,127,kaist_dataset/Korean/Digital_Camera/indoor2/DSC03558.JPG,char_data/원/DSC03558.JPG_2.jpg,11557,480,640,91,211,302,169,296,True,73
원,123,kaist_dataset/Korean/Digital_Camera/indoor2/DSC03560.JPG,char_data/원/DSC03560.JPG_2.jpg,5781,480,640,47,296,343,150,273,True,73
원,106,kaist_dataset/Korean/Digital_Camera/indoor2/DSC03564.JPG,char_data/원/DSC03564.JPG_2.jpg,11130,480,640,105,122,227,54,160,True,73
원,61,kaist_dataset/Korean/Digital_Camera/indoor2/DSC03818.JPG,char_data/원/DSC03818.JPG_2.jpg,3477,480,640,57,243,300,380,441,True,73
원,82,kaist_dataset/Korean/Digital_Camera/indoor2/DSC04175.JPG,char_data/원/DSC04175.JPG_2.jpg,4100,480,640,50,298,348,367,449,True,73
원,113,kaist_dataset/Korean/Digital_Camera/indoor2/DSC04253.JPG,char_data/원/DSC04253.JPG_2.jpg,4633,480,640,41,450,491,91,204,True,73
원,115,kaist_dataset/Korean/Digital_Camera/indoor2/DSC04417.JPG,char_data/원/DSC04417.JPG_2.jpg,7475,480,640,65,562,627,125,240,True,73
원,73,kaist_dataset/Korean/Digital_Camera/indoor2/DSC04422.JPG,char_data/원/DSC04422.JPG_2.jpg,4015,480,640,55,449,504,226,299,True,73
원,90,kaist_dataset/Korean/Digital_Camera/indoor2/DSC04423.JPG,char_data/원/DSC04423.JPG_2.jpg,6210,480,640,69,427,496,227,317,True,73
원,88,kaist_dataset/Korean/Digital_Camera/outdoor1/029.JPG,char_data/원/029.JPG_2.jpg,5720,480,640,65,517,582,200,288,True,73
원,96,kaist_dataset/Korean/Digital_Camera/outdoor1/123.JPG,char_data/원/123.JPG_2.jpg,7584,480,640,79,164,243,162,258,True,73
원,109,kaist_dataset/Korean/Digital_Camera/outdoor1/127.JPG,char_data/원/127.JPG_2.jpg,9810,480,640,90,437,527,148,257,True,73
원,166,kaist_dataset/Korean/Digital_Camera/outdoor1/2007-12-08-day-057.jpg,char_data/원/2007-12-08-day-057.jpg_2.jpg,16766,1200,1600,101,3,104,499,665,True,73
원,113,kaist_dataset/Korean/Digital_Camera/outdoor1/54.JPG,char_data/원/54.JPG_2.jpg,11865,523,767,105,575,680,248,361,True,73
원,217,kaist_dataset/Korean/Digital_Camera/outdoor2/080119-0032.jpg,char_data/원/080119-0032.jpg_2.jpg,38843,1200,1600,179,907,1086,628,845,True,73
원,211,kaist_dataset/Korean/Digital_Camera/outdoor2/2007-12-09-day-exterior-009.jpg,char_data/원/2007-12-09-day-exterior-009.jpg_2.jpg,36292,1200,1600,172,984,1156,433,644,True,73
원,50,kaist_dataset/Korean/Digital_Camera/outdoor2/2007-12-09-day-exterior-035.jpg,char_data/원/2007-12-09-day-exterior-035.jpg_2.jpg,2800,1200,1600,56,317,373,1094,1144,True,73
원,86,kaist_dataset/Korean/Digital_Camera/outdoor2/DSC02467.JPG,char_data/원/DSC02467.JPG_2.jpg,7998,480,640,93,463,556,169,255,True,73
원,177,kaist_dataset/Korean/Digital_Camera/outdoor2/DSC02478.JPG,char_data/원/DSC02478.JPG_2.jpg,24072,480,640,136,204,340,86,263,True,73
원,106,kaist_dataset/Korean/Digital_Camera/outdoor2/DSC02488.JPG,char_data/원/DSC02488.JPG_2.jpg,10918,480,640,103,392,495,314,420,True,73
원,77,kaist_dataset/Korean/Digital_Camera/outdoor2/DSC02506.JPG,char_data/원/DSC02506.JPG_4.jpg,3850,480,640,50,329,379,78,155,True,73
원,102,kaist_dataset/Korean/Digital_Camera/outdoor2/DSC02506.JPG,char_data/원/DSC02506.JPG_5.jpg,9690,480,640,95,508,603,320,422,True,73
원,98,kaist_dataset/Korean/Digital_Camera/outdoor3/DSC02552.JPG,char_data/원/DSC02552.JPG_2.jpg,10094,480,640,103,503,606,267,365,True,73
원,75,kaist_dataset/Korean/Digital_Camera/outdoor3/DSC02878.JPG,char_data/원/DSC02878.JPG_2.jpg,5925,480,640,79,512,591,152,227,True,73
원,47,kaist_dataset/Korean/Digital_Camera/outdoor3/DSC02888.JPG,char_data/원/DSC02888.JPG_2.jpg,2632,480,640,56,536,592,351,398,True,73
원,92,kaist_dataset/Korean/Digital_Camera/outdoor3/DSC02941.JPG,char_data/원/DSC02941.JPG_2.jpg,8464,480,640,92,438,530,166,258,True,73
원,45,kaist_dataset/Korean/Digital_Camera/outdoor3/DSC03049.JPG,char_data/원/DSC03049.JPG_2.jpg,2610,480,640,58,326,384,228,273,True,73
원,27,kaist_dataset/Korean/Digital_Camera/outdoor3/DSC03163.JPG,char_data/원/DSC03163.JPG_2.jpg,1053,480,640,39,513,552,190,217,True,73
원,67,kaist_dataset/Korean/Digital_Camera/outdoor3/DSC03195.JPG,char_data/원/DSC03195.JPG_2.jpg,3953,480,640,59,383,442,252,319,True,73
원,83,kaist_dataset/Korean/Digital_Camera/outdoor3/DSC03206.JPG,char_data/원/DSC03206.JPG_4.jpg,6391,480,640,77,150,227,184,267,True,73
원,31,kaist_dataset/Korean/Digital_Camera/outdoor3/DSC03206.JPG,char_data/원/DSC03206.JPG_5.jpg,744,480,640,24,346,370,168,199,True,73
원,85,kaist_dataset/Korean/Digital_Camera/outdoor3/DSC03232.JPG,char_data/원/DSC03232.JPG_2.jpg,6715,480,640,79,550,629,182,267,True,73
원,61,kaist_dataset/Korean/Digital_Camera/outdoor3/DSC03237.JPG,char_data/원/DSC03237.JPG_2.jpg,3599,480,640,59,79,138,171,232,True,73
원,131,kaist_dataset/Korean/Digital_Camera/outdoor4/DSC03261.JPG,char_data/원/DSC03261.JPG_2.jpg,15589,480,640,119,484,603,272,403,True,73
원,60,kaist_dataset/Korean/Digital_Camera/outdoor4/DSC03268.JPG,char_data/원/DSC03268.JPG_2.jpg,3300,480,640,55,73,128,187,247,True,73
원,117,kaist_dataset/Korean/Digital_Camera/outdoor4/DSC03272.JPG,char_data/원/DSC03272.JPG_2.jpg,11700,480,640,100,514,614,304,421,True,73
원,164,kaist_dataset/Korean/Digital_Camera/outdoor4/DSC03286.JPG,char_data/원/DSC03286.JPG_2.jpg,27060,480,640,165,79,244,202,366,True,73
원,103,kaist_dataset/Korean/Digital_Camera/outdoor4/DSC03445.JPG,char_data/원/DSC03445.JPG_2.jpg,8755,480,640,85,546,631,198,301,True,73
원,159,kaist_dataset/Korean/Digital_Camera/outdoor4/DSC03452.JPG,char_data/원/DSC03452.JPG_2.jpg,7791,480,640,49,494,543,114,273,True,73
원,91,kaist_dataset/Korean/Digital_Camera/outdoor4/DSC03537.JPG,char_data/원/DSC03537.JPG_2.jpg,7189,480,640,79,519,598,17,108,True,73
원,113,kaist_dataset/Korean/Digital_Camera/outdoor4/DSC03550.JPG,char_data/원/DSC03550.JPG_2.jpg,9153,480,640,81,276,357,61,174,True,73
원,116,kaist_dataset/Korean/Digital_Camera/outdoor4/DSC03553.JPG,char_data/원/DSC03553.JPG_2.jpg,7888,480,640,68,134,202,38,154,True,73
원,76,kaist_dataset/Korean/Digital_Camera/outdoor4/DSC03566.JPG,char_data/원/DSC03566.JPG_2.jpg,7904,480,640,104,104,208,11,87,True,73
원,39,kaist_dataset/Korean/Digital_Camera/outdoor4/DSC03573.JPG,char_data/원/DSC03573.JPG_2.jpg,1794,480,640,46,229,275,156,195,True,73
원,143,kaist_dataset/Korean/Digital_Camera/outdoor4/DSC03574.JPG,char_data/원/DSC03574.JPG_2.jpg,13013,480,640,91,193,284,177,320,True,73
원,72,kaist_dataset/Korean/Digital_Camera/outdoor4/DSC03584.JPG,char_data/원/DSC03584.JPG_2.jpg,4248,480,640,59,96,155,162,234,True,73
원,57,kaist_dataset/Korean/Digital_Camera/outdoor4/DSC03595.JPG,char_data/원/DSC03595.JPG_2.jpg,2451,480,640,43,366,409,178,235,True,73
원,74,kaist_dataset/Korean/Digital_Camera/outdoor4/DSC03602.JPG,char_data/원/DSC03602.JPG_2.jpg,4884,480,640,66,170,236,160,234,True,73
원,80,kaist_dataset/Korean/Digital_Camera/outdoor4/DSC03606.JPG,char_data/원/DSC03606.JPG_2.jpg,6480,480,640,81,529,610,337,417,True,73
원,84,kaist_dataset/Korean/Digital_Camera/outdoor4/DSC03608.JPG,char_data/원/DSC03608.JPG_2.jpg,6552,480,640,78,502,580,42,126,True,73
원,28,kaist_dataset/Korean/Digital_Camera/outdoor5/DSC03636.JPG,char_data/원/DSC03636.JPG_2.jpg,672,480,640,24,274,298,159,187,True,73
원,63,kaist_dataset/Korean/Digital_Camera/outdoor5/DSC03742.JPG,char_data/원/DSC03742.JPG_2.jpg,4032,480,640,64,369,433,379,442,True,73
원,67,kaist_dataset/Korean/Digital_Camera/outdoor5/DSC03744.JPG,char_data/원/DSC03744.JPG_2.jpg,6700,480,640,100,525,625,225,292,True,73
원,109,kaist_dataset/Korean/Digital_Camera/outdoor5/DSC03752.JPG,char_data/원/DSC03752.JPG_2.jpg,10573,480,640,97,502,599,329,438,True,73
원,96,kaist_dataset/Korean/Digital_Camera/outdoor5/DSC03780.JPG,char_data/원/DSC03780.JPG_2.jpg,8736,480,640,91,498,589,363,459,True,73
원,75,kaist_dataset/Korean/Digital_Camera/outdoor5/DSC03858.JPG,char_data/원/DSC03858.JPG_2.jpg,4575,480,640,61,330,391,391,466,True,73
원,86,kaist_dataset/Korean/Digital_Camera/outdoor5/DSC03970.JPG,char_data/원/DSC03970.JPG_2.jpg,6880,480,640,80,542,622,13,99,True,73
원,122,kaist_dataset/Korean/Digital_Camera/outdoor5/DSC04000.JPG,char_data/원/DSC04000.JPG_2.jpg,11590,480,640,95,527,622,318,440,True,73
원,126,kaist_dataset/Korean/Digital_Camera/outdoor5/DSC04036.JPG,char_data/원/DSC04036.JPG_2.jpg,13104,480,640,104,506,610,61,187,True,73
원,99,kaist_dataset/Korean/Digital_Camera/outdoor5/DSC04038.JPG,char_data/원/DSC04038.JPG_2.jpg,8118,480,640,82,423,505,208,307,True,73
원,98,kaist_dataset/Korean/Digital_Camera/outdoor5/DSC04039.JPG,char_data/원/DSC04039.JPG_2.jpg,9996,480,640,102,466,568,192,290,True,73
원,77,kaist_dataset/Korean/Digital_Camera/outdoor6/DSC04089.JPG,char_data/원/DSC04089.JPG_2.jpg,4158,480,640,54,100,154,171,248,True,73
원,81,kaist_dataset/Korean/Digital_Camera/outdoor6/DSC04134.JPG,char_data/원/DSC04134.JPG_2.jpg,5994,480,640,74,99,173,393,474,True,73
원,48,kaist_dataset/Korean/Digital_Camera/outdoor6/DSC04157.JPG,char_data/원/DSC04157.JPG_2.jpg,2928,480,640,61,479,540,168,216,True,73
원,81,kaist_dataset/Korean/Digital_Camera/outdoor6/DSC04296.JPG,char_data/원/DSC04296.JPG_2.jpg,4779,480,640,59,197,256,227,308,True,73
원,84,kaist_dataset/Korean/Digital_Camera/outdoor6/DSC04328.JPG,char_data/원/DSC04328.JPG_2.jpg,4284,480,640,51,574,625,19,103,True,73
원,81,kaist_dataset/Korean/Digital_Camera/outdoor6/DSC04333.JPG,char_data/원/DSC04333.JPG_2.jpg,7857,480,640,97,506,603,154,235,True,73
원,56,kaist_dataset/Korean/Digital_Camera/outdoor6/DSC04341.JPG,char_data/원/DSC04341.JPG_2.jpg,3920,480,640,70,218,288,57,113,True,73
원,109,kaist_dataset/Korean/Digital_Camera/outdoor6/DSC04398.JPG,char_data/원/DSC04398.JPG_6.jpg,9810,480,640,90,472,562,239,348,True,73
원,63,kaist_dataset/Korean/Digital_Camera/outdoor6/DSC04398.JPG,char_data/원/DSC04398.JPG_7.jpg,2646,480,640,42,311,353,377,440,True,73
원,66,kaist_dataset/Korean/Digital_Camera/outdoor6/DSC04398.JPG,char_data/원/DSC04398.JPG_8.jpg,2838,480,640,43,523,566,370,436,True,73
원,83,kaist_dataset/Korean/Digital_Camera/outdoor6/DSC04400.JPG,char_data/원/DSC04400.JPG_4.jpg,7387,480,640,89,480,569,137,220,True,73
원,82,kaist_dataset/Korean/Digital_Camera/outdoor6/DSC04400.JPG,char_data/원/DSC04400.JPG_5.jpg,5330,480,640,65,518,583,303,385,True,73
원,113,kaist_dataset/Korean/Digital_Camera/outdoor6/DSC04407.JPG,char_data/원/DSC04407.JPG_2.jpg,10283,480,640,91,535,626,85,198,True,73
원,108,kaist_dataset/Korean/Digital_Camera/outdoor6/DSC04439.JPG,char_data/원/DSC04439.JPG_2.jpg,9504,480,640,88,383,471,45,153,True,73
원,56,kaist_dataset/Korean/Digital_Camera/outdoor7/DSC04455.JPG,char_data/원/DSC04455.JPG_2.jpg,2072,480,640,37,355,392,363,419,True,73
원,101,kaist_dataset/Korean/Digital_Camera/outdoor7/P1010053.JPG,char_data/원/P1010053.JPG_2.jpg,9393,480,640,93,166,259,135,236,True,73
원,144,kaist_dataset/Korean/Digital_Camera/outdoor7/P1010079.JPG,char_data/원/P1010079.JPG_2.jpg,21600,480,640,150,178,328,179,323,True,73
원,76,kaist_dataset/Korean/Digital_Camera/outdoor7/P1010089.JPG,char_data/원/P1010089.JPG_2.jpg,5472,480,640,72,303,375,113,189,True,73
원,79,kaist_dataset/Korean/Digital_Camera/outdoor7/P1010091.JPG,char_data/원/P1010091.JPG_2.jpg,5767,480,640,73,511,584,159,238,True,73
원,96,kaist_dataset/Korean/Digital_Camera/outdoor7/P1010131.JPG,char_data/원/P1010131.JPG_2.jpg,7008,480,640,73,161,234,110,206,True,73
원,97,kaist_dataset/Korean/Digital_Camera/outdoor8/DSC02875.JPG,char_data/원/DSC02875.JPG_2.jpg,6111,480,640,63,558,621,142,239,True,73
원,78,"kaist_dataset/Korean/Mobile_Phone/(M,K)A-shadow/P090912065.jpg",char_data/원/P090912065.jpg_2.jpg,5538,480,640,71,274,345,63,141,True,73
원,127,"kaist_dataset/Korean/Mobile_Phone/(M,K)E-bookCover/P090831069.jpg",char_data/원/P090831069.jpg_2.jpg,12954,480,640,102,209,311,25,152,True,73
원,187,"kaist_dataset/Korean/Mobile_Phone/(M,K)E-bookCover/P090903064.jpg",char_data/원/P090903064.jpg_2.jpg,33286,480,640,178,246,424,252,439,True,73
원,40,"kaist_dataset/Korean/Mobile_Phone/(M,K)E-bookCover/P090911024.jpg",char_data/원/P090911024.jpg_2.jpg,1360,480,640,34,265,299,46,86,True,73
원,72,kaist_dataset/Mixed/Digital_Camera/(C.S)A-shadow/DSC02579.JPG,char_data/원/DSC02579.JPG_2.jpg,5400,480,640,75,489,564,320,392,True,73
원,79,kaist_dataset/Mixed/Digital_Camera/(C.S)A-shadow/DSC03207.JPG,char_data/원/DSC03207.JPG_2.jpg,4582,480,640,58,276,334,337,416,True,73
원,56,kaist_dataset/Mixed/Digital_Camera/(C.S)C-outdoor1/003.JPG,char_data/원/003.JPG_2.jpg,3024,480,640,54,521,575,183,239,True,73
원,56,kaist_dataset/Mixed/Digital_Camera/(C.S)C-outdoor1/066.JPG,char_data/원/066.JPG_2.jpg,2856,480,640,51,418,469,177,233,True,73
원,62,kaist_dataset/Mixed/Digital_Camera/(C.S)C-outdoor1/080.JPG,char_data/원/080.JPG_2.jpg,4340,480,640,70,185,255,199,261,True,73
원,95,kaist_dataset/Mixed/Digital_Camera/(C.S)C-outdoor1/114.jpg,char_data/원/114.jpg_2.jpg,7125,480,640,75,340,415,163,258,True,73
원,99,kaist_dataset/Mixed/Digital_Camera/(C.S)C-outdoor1/118.JPG,char_data/원/118.JPG_2.jpg,11583,480,640,117,476,593,144,243,True,73
원,35,kaist_dataset/Mixed/Digital_Camera/(C.S)C-outdoor1/DSC02349.JPG,char_data/원/DSC02349.JPG_2.jpg,770,480,640,22,618,639,199,234,True,73
원,111,kaist_dataset/Mixed/Digital_Camera/(C.S)C-outdoor2/DSC02374.JPG,char_data/원/DSC02374.JPG_2.jpg,12987,480,640,117,158,275,190,301,True,73
원,71,kaist_dataset/Mixed/Digital_Camera/(C.S)C-outdoor2/DSC02502.JPG,char_data/원/DSC02502.JPG_2.jpg,4899,480,640,69,478,547,200,271,True,73
원,121,kaist_dataset/Mixed/Digital_Camera/(C.S)C-outdoor2/DSC02503.JPG,char_data/원/DSC02503.JPG_2.jpg,9559,480,640,79,528,607,146,267,True,73
원,67,kaist_dataset/Mixed/Digital_Camera/(C.S)C-outdoor2/DSC02511.JPG,char_data/원/DSC02511.JPG_4.jpg,5159,480,640,77,470,547,150,217,True,73
원,104,kaist_dataset/Mixed/Digital_Camera/(C.S)C-outdoor2/DSC02511.JPG,char_data/원/DSC02511.JPG_5.jpg,9984,480,640,96,504,600,297,401,True,73
원,80,kaist_dataset/Mixed/Digital_Camera/(C.S)C-outdoor2/DSC02543.JPG,char_data/원/DSC02543.JPG_2.jpg,5760,480,640,72,497,569,269,349,True,73
원,63,kaist_dataset/Mixed/Digital_Camera/(C.S)C-outdoor2/DSC02545.JPG,char_data/원/DSC02545.JPG_2.jpg,3339,480,640,53,535,588,294,357,True,73
원,69,kaist_dataset/Mixed/Digital_Camera/(C.S)C-outdoor2/DSC02879.JPG,char_data/원/DSC02879.JPG_2.jpg,5934,480,640,86,484,570,178,247,True,73
원,100,kaist_dataset/Mixed/Digital_Camera/(C.S)C-outdoor2/DSC02933.JPG,char_data/원/DSC02933.JPG_2.jpg,7800,480,640,78,460,538,121,221,True,73
원,28,kaist_dataset/Mixed/Digital_Camera/(C.S)C-outdoor2/DSC02940.JPG,char_data/원/DSC02940.JPG_2.jpg,672,480,640,24,497,521,323,351,True,73
원,43,kaist_dataset/Mixed/Digital_Camera/(C.S)C-outdoor3/DSC02962.JPG,char_data/원/DSC02962.JPG_2.jpg,1720,480,640,40,183,223,351,394,True,73
원,115,kaist_dataset/Mixed/Digital_Camera/(C.S)C-outdoor3/DSC03047.JPG,char_data/원/DSC03047.JPG_2.jpg,15295,480,640,133,126,259,57,172,True,73
원,54,kaist_dataset/Mixed/Digital_Camera/(C.S)C-outdoor3/DSC03233.JPG,char_data/원/DSC03233.JPG_2.jpg,3618,480,640,67,497,564,273,327,True,73
원,108,kaist_dataset/Mixed/Digital_Camera/(C.S)C-outdoor3/DSC03274.JPG,char_data/원/DSC03274.JPG_2.jpg,8856,480,640,82,427,509,251,359,True,73
원,123,kaist_dataset/Mixed/Digital_Camera/(C.S)C-outdoor3/DSC03275.JPG,char_data/원/DSC03275.JPG_2.jpg,11562,480,640,94,533,627,58,181,True,73
원,59,kaist_dataset/Mixed/Digital_Camera/(C.S)C-outdoor3/DSC03314.JPG,char_data/원/DSC03314.JPG_2.jpg,2360,480,640,40,480,520,96,155,True,73
원,61,kaist_dataset/Mixed/Digital_Camera/(C.S)C-outdoor3/DSC03332.JPG,char_data/원/DSC03332.JPG_2.jpg,3843,480,640,63,448,511,330,391,True,73
원,63,kaist_dataset/Mixed/Digital_Camera/(C.S)C-outdoor4/DSC03544.JPG,char_data/원/DSC03544.JPG_2.jpg,3024,480,640,48,163,211,259,322,True,73
원,196,kaist_dataset/Mixed/Digital_Camera/(C.S)C-outdoor4/DSC03548.JPG,char_data/원/DSC03548.JPG_4.jpg,21560,480,640,110,143,253,173,369,True,73
원,200,kaist_dataset/Mixed/Digital_Camera/(C.S)C-outdoor4/DSC03548.JPG,char_data/원/DSC03548.JPG_5.jpg,25000,480,640,125,477,602,175,375,True,73
원,106,kaist_dataset/Mixed/Digital_Camera/(C.S)C-outdoor4/DSC03549.JPG,char_data/원/DSC03549.JPG_2.jpg,9116,480,640,86,100,186,131,237,True,73
원,69,kaist_dataset/Mixed/Digital_Camera/(C.S)C-outdoor4/DSC03554.JPG,char_data/원/DSC03554.JPG_2.jpg,7659,480,640,111,219,330,37,106,True,73
원,103,kaist_dataset/Mixed/Digital_Camera/(C.S)C-outdoor4/DSC03569.JPG,char_data/원/DSC03569.JPG_6.jpg,12051,480,640,117,238,355,44,147,True,73
원,107,kaist_dataset/Mixed/Digital_Camera/(C.S)C-outdoor4/DSC03569.JPG,char_data/원/DSC03569.JPG_7.jpg,13482,480,640,126,503,629,30,137,True,73
원,48,kaist_dataset/Mixed/Digital_Camera/(C.S)C-outdoor4/DSC03569.JPG,char_data/원/DSC03569.JPG_8.jpg,1680,480,640,35,38,73,178,226,True,73
원,80,kaist_dataset/Mixed/Digital_Camera/(C.S)C-outdoor4/DSC03570.JPG,char_data/원/DSC03570.JPG_2.jpg,3600,480,640,45,92,137,346,426,True,73
원,45,kaist_dataset/Mixed/Digital_Camera/(C.S)C-outdoor4/DSC03571.JPG,char_data/원/DSC03571.JPG_2.jpg,1080,480,640,24,512,536,299,344,True,73
원,84,kaist_dataset/Mixed/Digital_Camera/(C.S)C-outdoor4/DSC03579.JPG,char_data/원/DSC03579.JPG_2.jpg,7812,480,640,93,154,247,211,295,True,73
원,91,kaist_dataset/Mixed/Digital_Camera/(C.S)C-outdoor4/DSC03616.JPG,char_data/원/DSC03616.JPG_2.jpg,8645,480,640,95,527,622,53,144,True,73
원,97,kaist_dataset/Mixed/Digital_Camera/(C.S)C-outdoor4/DSC03633.JPG,char_data/원/DSC03633.JPG_2.jpg,6596,480,640,68,453,521,156,253,True,73
원,85,kaist_dataset/Mixed/Digital_Camera/(C.S)C-outdoor4/DSC03644.JPG,char_data/원/DSC03644.JPG_2.jpg,6205,480,640,73,516,589,343,428,True,73
원,118,kaist_dataset/Mixed/Digital_Camera/(C.S)C-outdoor4/DSC03655.JPG,char_data/원/DSC03655.JPG_2.jpg,11918,480,640,101,513,614,244,362,True,73
원,93,kaist_dataset/Mixed/Digital_Camera/(C.S)C-outdoor4/DSC03665.JPG,char_data/원/DSC03665.JPG_2.jpg,10602,480,640,114,514,628,61,154,True,73
원,43,kaist_dataset/Mixed/Digital_Camera/(C.S)C-outdoor4/DSC03674.JPG,char_data/원/DSC03674.JPG_2.jpg,1118,480,640,26,585,611,342,385,True,73
원,54,kaist_dataset/Mixed/Digital_Camera/(C.S)C-outdoor4/DSC03678.JPG,char_data/원/DSC03678.JPG_2.jpg,1836,480,640,34,276,310,179,233,True,73
원,84,kaist_dataset/Mixed/Digital_Camera/(C.S)C-outdoor4/DSC03691.JPG,char_data/원/DSC03691.JPG_2.jpg,6132,480,640,73,574,639,124,208,True,73
원,127,kaist_dataset/Mixed/Digital_Camera/(C.S)C-outdoor4/DSC03737.JPG,char_data/원/DSC03737.JPG_2.jpg,14478,480,640,114,484,598,36,163,False,73
원,67,kaist_dataset/Mixed/Digital_Camera/(C.S)C-outdoor5/DSC03867.JPG,char_data/원/DSC03867.JPG_2.jpg,3752,480,640,56,363,419,201,268,False,73
원,118,kaist_dataset/Mixed/Digital_Camera/(C.S)C-outdoor5/DSC04013.JPG,char_data/원/DSC04013.JPG_2.jpg,4484,480,640,38,581,619,317,435,False,73
원,118,kaist_dataset/Mixed/Digital_Camera/(C.S)C-outdoor5/DSC04033.JPG,char_data/원/DSC04033.JPG_2.jpg,11800,480,640,100,476,576,134,252,False,73
원,67,kaist_dataset/Mixed/Digital_Camera/(C.S)C-outdoor5/DSC04139.JPG,char_data/원/DSC04139.JPG_2.jpg,1541,480,640,23,314,337,321,388,False,73
원,91,kaist_dataset/Mixed/Digital_Camera/(C.S)C-outdoor5/DSC04155.JPG,char_data/원/DSC04155.JPG_2.jpg,9009,480,640,99,122,221,208,299,False,73
원,113,kaist_dataset/Mixed/Digital_Camera/(C.S)C-outdoor5/DSC04290.JPG,char_data/원/DSC04290.JPG_2.jpg,6328,480,640,56,546,602,69,182,False,73
원,52,kaist_dataset/Mixed/Digital_Camera/(C.S)C-outdoor5/DSC04337.JPG,char_data/원/DSC04337.JPG_2.jpg,1976,480,640,38,241,279,104,156,False,73
원,91,kaist_dataset/Mixed/Digital_Camera/(C.S)C-outdoor5/DSC04349.JPG,char_data/원/DSC04349.JPG_2.jpg,6188,480,640,68,536,604,91,182,False,73
원,76,kaist_dataset/Mixed/Digital_Camera/(C.S)C-outdoor5/DSC04357.JPG,char_data/원/DSC04357.JPG_2.jpg,4484,480,640,59,369,428,216,292,False,73
원,51,kaist_dataset/Mixed/Digital_Camera/(C.S)C-outdoor5/DSC04395.JPG,char_data/원/DSC04395.JPG_2.jpg,2142,480,640,42,246,288,284,335,False,73
원,73,kaist_dataset/Mixed/Digital_Camera/(C.S)C-outdoor5/DSC04401.JPG,char_data/원/DSC04401.JPG_2.jpg,4453,480,640,61,569,630,164,237,False,73
원,78,kaist_dataset/Mixed/Digital_Camera/(C.S)C-outdoor5/DSC04449.JPG,char_data/원/DSC04449.JPG_2.jpg,3666,480,640,47,87,134,213,291,False,73
원,43,kaist_dataset/Mixed/Digital_Camera/(C.S)C-outdoor5/DSC04456.JPG,char_data/원/DSC04456.JPG_4.jpg,1204,480,640,28,371,399,224,267,False,73
원,103,kaist_dataset/Mixed/Digital_Camera/(C.S)C-outdoor5/DSC04456.JPG,char_data/원/DSC04456.JPG_5.jpg,8343,480,640,81,553,634,65,168,False,73
원,66,kaist_dataset/Mixed/Digital_Camera/(C.S)C-outdoor6/P1010020.JPG,char_data/원/P1010020.JPG_2.jpg,4950,480,640,75,282,357,172,238,False,73
원,52,kaist_dataset/Mixed/Digital_Camera/(C.S)C-outdoor6/P1010054.JPG,char_data/원/P1010054.JPG_2.jpg,1924,480,640,37,412,449,218,270,False,73
원,104,kaist_dataset/Mixed/Digital_Camera/(C.S)C-outdoor6/P1010063.JPG,char_data/원/P1010063.JPG_2.jpg,9568,480,640,92,468,560,139,243,False,73
원,103,kaist_dataset/Mixed/Digital_Camera/(C.S)C-outdoor6/P1010129.JPG,char_data/원/P1010129.JPG_2.jpg,11433,480,640,111,230,341,136,239,False,73
원,48,kaist_dataset/Mixed/Digital_Camera/(C.S)D-indoor1/DSC03909.JPG,char_data/원/DSC03909.JPG_2.jpg,1296,480,640,27,340,367,299,347,False,73
원,87,kaist_dataset/Mixed/Digital_Camera/(C.S)D-indoor1/DSC03998.JPG,char_data/원/DSC03998.JPG_2.jpg,2523,480,640,29,590,619,306,393,False,73
원,149,kaist_dataset/Mixed/Digital_Camera/(C.S)D-indoor1/DSC04002.JPG,char_data/원/DSC04002.JPG_2.jpg,8046,480,640,54,476,530,137,286,False,73
원,104,kaist_dataset/Mixed/Digital_Camera/(C.S)D-indoor1/DSC04003.JPG,char_data/원/DSC04003.JPG_2.jpg,8320,480,640,80,510,590,207,311,False,73
원,68,kaist_dataset/Mixed/Digital_Camera/(C.S)D-indoor2/DSC04254.JPG,char_data/원/DSC04254.JPG_2.jpg,3332,480,640,49,537,586,265,333,False,73
원,94,kaist_dataset/Mixed/Digital_Camera/(C.S)D-indoor2/DSC04409.JPG,char_data/원/DSC04409.JPG_2.jpg,4230,480,640,45,425,470,146,240,False,73
원,124,kaist_dataset/Mixed/Digital_Camera/(C.S)D-indoor2/DSC04442.JPG,char_data/원/DSC04442.JPG_2.jpg,10292,480,640,83,412,495,22,146,False,73
원,71,kaist_dataset/Mixed/Digital_Camera/(C.S)D-indoor2/DSC04463.JPG,char_data/원/DSC04463.JPG_2.jpg,5467,480,640,77,359,436,35,106,False,73
원,65,kaist_dataset/Mixed/Digital_Camera/(C.S)E-night/DSC02600.JPG,char_data/원/DSC02600.JPG_4.jpg,4485,480,640,69,447,516,201,266,False,73
원,66,kaist_dataset/Mixed/Digital_Camera/(C.S)E-night/DSC02600.JPG,char_data/원/DSC02600.JPG_5.jpg,4356,480,640,66,447,513,406,472,False,73
원,80,kaist_dataset/Mixed/Digital_Camera/(C.S)E-night/DSC02672.JPG,char_data/원/DSC02672.JPG_2.jpg,5520,480,640,69,551,620,320,400,False,73
원,165,kaist_dataset/Mixed/Digital_Camera/(C.S)E-night/DSC03561.JPG,char_data/원/DSC03561.JPG_2.jpg,15015,480,640,91,140,231,80,245,False,73
원,121,kaist_dataset/Mixed/Digital_Camera/(C.S)E-night/P1010156.JPG,char_data/원/P1010156.JPG_2.jpg,11011,480,640,91,454,545,106,227,False,73
원,111,kaist_dataset/Mixed/Digital_Camera/(C.S)F-others/58.JPG,char_data/원/58.JPG_2.jpg,17649,764,499,159,37,196,372,483,False,73
원,116,kaist_dataset/Mixed/Digital_Camera/(C.S)F-others/DSC02696.JPG,char_data/원/DSC02696.JPG_2.jpg,11832,480,640,102,399,501,124,240,False,73
원,68,kaist_dataset/Mixed/Mobile_Phone/(C.M)A-outdoor/P090912040.jpg,char_data/원/P090912040.jpg_4.jpg,5916,480,640,87,138,225,123,191,False,73
원,77,kaist_dataset/Mixed/Mobile_Phone/(C.M)A-outdoor/P090912040.jpg,char_data/원/P090912040.jpg_5.jpg,5390,480,640,70,432,502,122,199,False,73
원,86,kaist_dataset/Mixed/Mobile_Phone/(C.M)A-outdoor/P090912066.jpg,char_data/원/P090912066.jpg_4.jpg,3526,480,640,41,345,386,98,184,False,73
원,60,kaist_dataset/Mixed/Mobile_Phone/(C.M)A-outdoor/P090912066.jpg,char_data/원/P090912066.jpg_5.jpg,2040,480,640,34,390,424,201,261,False,73
원,39,kaist_dataset/Mixed/Mobile_Phone/(C.M)C-bookCover/P090903009.jpg,char_data/원/P090903009.jpg_2.jpg,975,480,640,25,87,112,352,391,False,73
장,248,kaist_dataset/Korean/Digital_Camera/A-shadow/2007-12-09-day-exterior-025.jpg,char_data/장/2007-12-09-day-exterior-025.jpg_2.jpg,50344,1200,1600,203,571,774,385,633,True,78
장,69,kaist_dataset/Korean/Digital_Camera/A-shadow/2007-12-09-day-exterior-031.jpg,char_data/장/2007-12-09-day-exterior-031.jpg_2.jpg,4554,1200,1600,66,1191,1257,976,1045,True,78
장,89,kaist_dataset/Korean/Digital_Camera/A-shadow/DSC02599.JPG,char_data/장/DSC02599.JPG_2.jpg,6586,480,640,74,463,537,375,464,True,78
장,152,kaist_dataset/Korean/Digital_Camera/A-shadow/DSC02667.JPG,char_data/장/DSC02667.JPG_2.jpg,13528,480,640,89,436,525,247,399,True,78
장,76,kaist_dataset/Korean/Digital_Camera/A-shadow/DSC03755.JPG,char_data/장/DSC03755.JPG_2.jpg,5472,480,640,72,551,623,27,103,True,78
장,101,kaist_dataset/Korean/Digital_Camera/A-shadow/DSC03793.JPG,char_data/장/DSC03793.JPG_2.jpg,8080,480,640,80,454,534,30,131,True,78
장,51,kaist_dataset/Korean/Digital_Camera/A-shadow/DSC04315.JPG,char_data/장/DSC04315.JPG_2.jpg,1479,480,640,29,405,434,416,467,True,78
장,72,kaist_dataset/Korean/Digital_Camera/A-shadow/P1010034.JPG,char_data/장/P1010034.JPG_2.jpg,5472,480,640,76,512,588,308,380,True,78
장,107,kaist_dataset/Korean/Digital_Camera/E-night/DSC02582.JPG,char_data/장/DSC02582.JPG_2.jpg,7490,480,640,70,537,607,204,311,True,78
장,121,kaist_dataset/Korean/Digital_Camera/E-night/DSC02588.JPG,char_data/장/DSC02588.JPG_2.jpg,7502,480,640,62,531,593,312,433,True,78
장,55,kaist_dataset/Korean/Digital_Camera/E-night/DSC02593.JPG,char_data/장/DSC02593.JPG_2.jpg,1485,480,640,27,117,144,382,437,True,78
장,181,kaist_dataset/Korean/Digital_Camera/E-night/DSC02608.JPG,char_data/장/DSC02608.JPG_2.jpg,22444,480,640,124,475,599,211,392,True,78
장,104,kaist_dataset/Korean/Digital_Camera/E-night/DSC02626.JPG,char_data/장/DSC02626.JPG_2.jpg,8736,480,640,84,66,150,240,344,True,78
장,133,kaist_dataset/Korean/Digital_Camera/E-night/DSC02658.JPG,char_data/장/DSC02658.JPG_2.jpg,10507,480,640,79,555,634,198,331,True,78
장,63,kaist_dataset/Korean/Digital_Camera/E-night/DSC02662.JPG,char_data/장/DSC02662.JPG_2.jpg,4410,480,640,70,381,451,329,392,True,78
장,150,kaist_dataset/Korean/Digital_Camera/G-others/080119-0005.jpg,char_data/장/080119-0005.jpg_2.jpg,21300,1600,1200,142,684,826,460,610,True,78
장,134,kaist_dataset/Korean/Digital_Camera/G-others/DSC03226.JPG,char_data/장/DSC03226.JPG_2.jpg,20770,480,640,155,117,272,339,473,True,78
장,55,kaist_dataset/Korean/Digital_Camera/indoor1/DSC02715.JPG,char_data/장/DSC02715.JPG_2.jpg,2860,480,640,52,518,570,242,297,True,78
장,91,kaist_dataset/Korean/Digital_Camera/indoor1/DSC02717.JPG,char_data/장/DSC02717.JPG_2.jpg,7826,480,640,86,505,591,328,419,True,78
장,45,kaist_dataset/Korean/Digital_Camera/indoor1/DSC02720.JPG,char_data/장/DSC02720.JPG_2.jpg,1665,480,640,37,537,574,203,248,True,78
장,124,kaist_dataset/Korean/Digital_Camera/indoor1/DSC02722.JPG,char_data/장/DSC02722.JPG_2.jpg,14136,480,640,114,374,488,213,337,True,78
장,128,kaist_dataset/Korean/Digital_Camera/indoor1/DSC02727.JPG,char_data/장/DSC02727.JPG_2.jpg,11776,480,640,92,358,450,98,226,True,78
장,77,kaist_dataset/Korean/Digital_Camera/indoor1/DSC02731.JPG,char_data/장/DSC02731.JPG_2.jpg,4851,480,640,63,497,560,316,393,True,78
장,73,kaist_dataset/Korean/Digital_Camera/indoor1/DSC03037.JPG,char_data/장/DSC03037.JPG_2.jpg,4380,480,640,60,233,293,55,128,True,78
장,81,kaist_dataset/Korean/Digital_Camera/indoor1/DSC03152.JPG,char_data/장/DSC03152.JPG_2.jpg,4860,480,640,60,95,155,221,302,True,78
장,90,kaist_dataset/Korean/Digital_Camera/indoor1/DSC03359.JPG,char_data/장/DSC03359.JPG_2.jpg,6210,480,640,69,517,586,261,351,True,78
장,70,kaist_dataset/Korean/Digital_Camera/indoor1/DSC03360.JPG,char_data/장/DSC03360.JPG_2.jpg,4900,480,640,70,507,577,307,377,True,78
장,89,kaist_dataset/Korean/Digital_Camera/indoor1/DSC03361.JPG,char_data/장/DSC03361.JPG_2.jpg,6586,480,640,74,518,592,165,254,True,78
장,69,kaist_dataset/Korean/Digital_Camera/indoor1/DSC03362.JPG,char_data/장/DSC03362.JPG_2.jpg,3933,480,640,57,338,395,269,338,True,78
장,78,kaist_dataset/Korean/Digital_Camera/indoor1/DSC03370.JPG,char_data/장/DSC03370.JPG_2.jpg,2730,480,640,35,528,563,117,195,True,78
장,77,kaist_dataset/Korean/Digital_Camera/indoor1/DSC03378.JPG,char_data/장/DSC03378.JPG_2.jpg,4389,480,640,57,471,528,140,217,True,78
장,95,kaist_dataset/Korean/Digital_Camera/indoor2/DSC03385.JPG,char_data/장/DSC03385.JPG_2.jpg,8740,480,640,92,521,613,293,388,True,78
장,58,kaist_dataset/Korean/Digital_Camera/indoor2/DSC03399.JPG,char_data/장/DSC03399.JPG_2.jpg,3364,480,640,58,500,558,223,281,True,78
장,54,kaist_dataset/Korean/Digital_Camera/indoor2/DSC03468.JPG,char_data/장/DSC03468.JPG_2.jpg,2754,480,640,51,309,360,127,181,True,78
장,120,kaist_dataset/Korean/Digital_Camera/indoor2/DSC03560.JPG,char_data/장/DSC03560.JPG_2.jpg,6720,480,640,56,441,497,138,258,True,78
장,110,kaist_dataset/Korean/Digital_Camera/indoor2/DSC03563.JPG,char_data/장/DSC03563.JPG_2.jpg,7040,480,640,64,172,236,237,347,True,78
장,77,kaist_dataset/Korean/Digital_Camera/indoor2/DSC03975.JPG,char_data/장/DSC03975.JPG_2.jpg,4158,480,640,54,305,359,190,267,True,78
장,48,kaist_dataset/Korean/Digital_Camera/indoor2/DSC03994.JPG,char_data/장/DSC03994.JPG_2.jpg,1152,480,640,24,308,332,93,141,True,78
장,63,kaist_dataset/Korean/Digital_Camera/indoor2/DSC03995.JPG,char_data/장/DSC03995.JPG_4.jpg,3906,480,640,62,254,316,206,269,True,78
장,66,kaist_dataset/Korean/Digital_Camera/indoor2/DSC03995.JPG,char_data/장/DSC03995.JPG_5.jpg,3894,480,640,59,517,576,193,259,True,78
장,111,kaist_dataset/Korean/Digital_Camera/indoor2/DSC04253.JPG,char_data/장/DSC04253.JPG_2.jpg,4329,480,640,39,492,531,92,203,True,78
장,40,kaist_dataset/Korean/Digital_Camera/outdoor1/028.JPG,char_data/장/028.JPG_2.jpg,1600,480,640,40,400,440,416,456,True,78
장,56,kaist_dataset/Korean/Digital_Camera/outdoor1/061.JPG,char_data/장/061.JPG_2.jpg,2016,480,640,36,162,198,203,259,True,78
장,103,kaist_dataset/Korean/Digital_Camera/outdoor1/085.JPG,char_data/장/085.JPG_2.jpg,10918,480,640,106,384,490,183,286,True,78
장,101,kaist_dataset/Korean/Digital_Camera/outdoor1/110.JPG,char_data/장/110.JPG_2.jpg,8686,480,640,86,374,460,151,252,True,78
장,131,kaist_dataset/Korean/Digital_Camera/outdoor1/120.JPG,char_data/장/120.JPG_2.jpg,12052,480,640,92,174,266,142,273,True,78
장,111,kaist_dataset/Korean/Digital_Camera/outdoor1/128.JPG,char_data/장/128.JPG_2.jpg,8658,480,640,78,56,134,178,289,True,78
장,17,kaist_dataset/Korean/Digital_Camera/outdoor1/2007-12-08-day-047.jpg,char_data/장/2007-12-08-day-047.jpg_2.jpg,425,1200,1600,25,573,598,936,953,True,78
장,229,kaist_dataset/Korean/Digital_Camera/outdoor1/2007-12-08-day-056.jpg,char_data/장/2007-12-08-day-056.jpg_2.jpg,48777,1200,1600,213,460,673,512,741,True,78
장,37,kaist_dataset/Korean/Digital_Camera/outdoor1/2007-12-08-day-057.jpg,char_data/장/2007-12-08-day-057.jpg_2.jpg,1739,1200,1600,47,449,496,1044,1081,True,78
장,198,kaist_dataset/Korean/Digital_Camera/outdoor1/46.JPG,char_data/장/46.JPG_2.jpg,23562,576,768,119,579,698,148,346,True,78
장,108,kaist_dataset/Korean/Digital_Camera/outdoor2/2007-12-08-day-094.jpg,char_data/장/2007-12-08-day-094.jpg_2.jpg,7992,1600,1200,74,1027,1101,365,473,True,78
장,183,kaist_dataset/Korean/Digital_Camera/outdoor2/2007-12-09-day-exterior-012.jpg,char_data/장/2007-12-09-day-exterior-012.jpg_4.jpg,34404,1200,1600,188,277,465,424,607,True,78
장,51,kaist_dataset/Korean/Digital_Camera/outdoor2/2007-12-09-day-exterior-012.jpg,char_data/장/2007-12-09-day-exterior-012.jpg_5.jpg,2856,1200,1600,56,875,931,864,915,True,78
장,114,kaist_dataset/Korean/Digital_Camera/outdoor2/DSC02305.JPG,char_data/장/DSC02305.JPG_2.jpg,14592,480,640,128,192,320,120,234,True,78
장,28,kaist_dataset/Korean/Digital_Camera/outdoor2/DSC02313.JPG,char_data/장/DSC02313.JPG_4.jpg,1400,480,640,50,261,311,13,41,True,78
장,34,kaist_dataset/Korean/Digital_Camera/outdoor2/DSC02313.JPG,char_data/장/DSC02313.JPG_5.jpg,1768,480,640,52,478,530,11,45,True,78
장,33,kaist_dataset/Korean/Digital_Camera/outdoor2/DSC02380.JPG,char_data/장/DSC02380.JPG_2.jpg,891,480,640,27,48,75,250,283,True,78
장,35,kaist_dataset/Korean/Digital_Camera/outdoor2/DSC02396.JPG,char_data/장/DSC02396.JPG_2.jpg,1015,480,640,29,107,136,187,222,True,78
장,84,kaist_dataset/Korean/Digital_Camera/outdoor2/DSC02468.JPG,char_data/장/DSC02468.JPG_2.jpg,6888,480,640,82,244,326,202,286,True,78
장,136,kaist_dataset/Korean/Digital_Camera/outdoor2/DSC02478.JPG,char_data/장/DSC02478.JPG_2.jpg,12512,480,640,92,535,627,135,271,True,78
장,120,kaist_dataset/Korean/Digital_Camera/outdoor2/DSC02495.JPG,char_data/장/DSC02495.JPG_2.jpg,11640,480,640,97,242,339,244,364,True,78
장,111,kaist_dataset/Korean/Digital_Camera/outdoor2/DSC02499.JPG,char_data/장/DSC02499.JPG_2.jpg,11988,480,640,108,371,479,125,236,True,78
장,39,kaist_dataset/Korean/Digital_Camera/outdoor3/DSC02531.JPG,char_data/장/DSC02531.JPG_2.jpg,1014,480,640,26,79,105,288,327,True,78
장,67,kaist_dataset/Korean/Digital_Camera/outdoor3/DSC02537.JPG,char_data/장/DSC02537.JPG_2.jpg,3417,480,640,51,365,416,353,420,True,78
장,101,kaist_dataset/Korean/Digital_Camera/outdoor3/DSC02541.JPG,char_data/장/DSC02541.JPG_2.jpg,7373,480,640,73,522,595,285,386,True,78
장,114,kaist_dataset/Korean/Digital_Camera/outdoor3/DSC02561.JPG,char_data/장/DSC02561.JPG_2.jpg,9918,480,640,87,212,299,201,315,True,78
장,57,kaist_dataset/Korean/Digital_Camera/outdoor3/DSC02891.JPG,char_data/장/DSC02891.JPG_4.jpg,2394,480,640,42,165,207,351,408,True,78
장,95,kaist_dataset/Korean/Digital_Camera/outdoor3/DSC02891.JPG,char_data/장/DSC02891.JPG_5.jpg,7695,480,640,81,440,521,194,289,True,78
장,121,kaist_dataset/Korean/Digital_Camera/outdoor3/DSC02911.JPG,char_data/장/DSC02911.JPG_2.jpg,7986,480,640,66,557,623,155,276,True,78
장,90,kaist_dataset/Korean/Digital_Camera/outdoor3/DSC02931.JPG,char_data/장/DSC02931.JPG_2.jpg,6300,480,640,70,366,436,38,128,True,78
장,97,kaist_dataset/Korean/Digital_Camera/outdoor3/DSC03213.JPG,char_data/장/DSC03213.JPG_2.jpg,8439,480,640,87,524,611,103,200,True,78
장,48,kaist_dataset/Korean/Digital_Camera/outdoor3/DSC03215.JPG,char_data/장/DSC03215.JPG_2.jpg,4032,480,640,84,208,292,326,374,True,78
장,165,kaist_dataset/Korean/Digital_Camera/outdoor3/DSC03237.JPG,char_data/장/DSC03237.JPG_2.jpg,19800,480,640,120,365,485,204,369,True,78
장,96,kaist_dataset/Korean/Digital_Camera/outdoor3/DSC03243.JPG,char_data/장/DSC03243.JPG_2.jpg,8160,480,640,85,147,232,313,409,True,78
장,106,kaist_dataset/Korean/Digital_Camera/outdoor4/DSC03405.JPG,char_data/장/DSC03405.JPG_2.jpg,10918,480,640,103,429,532,311,417,True,78
장,59,kaist_dataset/Korean/Digital_Camera/outdoor4/DSC03416.JPG,char_data/장/DSC03416.JPG_2.jpg,2419,480,640,41,481,522,281,340,True,78
장,133,kaist_dataset/Korean/Digital_Camera/outdoor4/DSC03420.JPG,char_data/장/DSC03420.JPG_2.jpg,15162,480,640,114,484,598,198,331,True,78
장,54,kaist_dataset/Korean/Digital_Camera/outdoor4/DSC03437.JPG,char_data/장/DSC03437.JPG_2.jpg,2052,480,640,38,578,616,33,87,True,78
장,57,kaist_dataset/Korean/Digital_Camera/outdoor4/DSC03443.JPG,char_data/장/DSC03443.JPG_2.jpg,2337,480,640,41,514,555,333,390,True,78
장,112,kaist_dataset/Korean/Digital_Camera/outdoor4/DSC03509.JPG,char_data/장/DSC03509.JPG_2.jpg,11312,480,640,101,380,481,33,145,True,78
장,71,kaist_dataset/Korean/Digital_Camera/outdoor4/DSC03555.JPG,char_data/장/DSC03555.JPG_2.jpg,3195,480,640,45,454,499,353,424,True,78
장,38,kaist_dataset/Korean/Digital_Camera/outdoor4/DSC03573.JPG,char_data/장/DSC03573.JPG_2.jpg,1900,480,640,50,459,509,156,194,True,78
장,63,kaist_dataset/Korean/Digital_Camera/outdoor4/DSC03611.JPG,char_data/장/DSC03611.JPG_2.jpg,3969,480,640,63,222,285,405,468,True,78
장,66,kaist_dataset/Korean/Digital_Camera/outdoor4/DSC03612.JPG,char_data/장/DSC03612.JPG_2.jpg,4422,480,640,67,538,605,41,107,True,78
장,90,kaist_dataset/Korean/Digital_Camera/outdoor5/DSC03645.JPG,char_data/장/DSC03645.JPG_2.jpg,4140,480,640,46,39,85,295,385,True,78
장,104,kaist_dataset/Korean/Digital_Camera/outdoor5/DSC03685.JPG,char_data/장/DSC03685.JPG_2.jpg,11232,480,640,108,86,194,55,159,True,78
장,29,kaist_dataset/Korean/Digital_Camera/outdoor5/DSC03688.JPG,char_data/장/DSC03688.JPG_2.jpg,493,480,640,17,502,519,228,257,True,78
장,144,kaist_dataset/Korean/Digital_Camera/outdoor5/DSC03692.JPG,char_data/장/DSC03692.JPG_2.jpg,17280,480,640,120,333,453,254,398,True,78
장,78,kaist_dataset/Korean/Digital_Camera/outdoor5/DSC03710.JPG,char_data/장/DSC03710.JPG_2.jpg,4446,480,640,57,276,333,329,407,True,78
장,130,kaist_dataset/Korean/Digital_Camera/outdoor5/DSC03717.JPG,char_data/장/DSC03717.JPG_2.jpg,8450,480,640,65,268,333,215,345,True,78
장,51,kaist_dataset/Korean/Digital_Camera/outdoor5/DSC03740.JPG,char_data/장/DSC03740.JPG_2.jpg,2550,480,640,50,485,535,214,265,True,78
장,133,kaist_dataset/Korean/Digital_Camera/outdoor5/DSC03768.JPG,char_data/장/DSC03768.JPG_4.jpg,10108,480,640,76,462,538,103,236,True,78
장,36,kaist_dataset/Korean/Digital_Camera/outdoor5/DSC03768.JPG,char_data/장/DSC03768.JPG_5.jpg,1440,480,640,40,127,167,236,272,True,78
장,30,kaist_dataset/Korean/Digital_Camera/outdoor5/DSC03777.JPG,char_data/장/DSC03777.JPG_2.jpg,870,480,640,29,150,179,276,306,True,78
장,99,kaist_dataset/Korean/Digital_Camera/outdoor5/DSC03778.JPG,char_data/장/DSC03778.JPG_2.jpg,6930,480,640,70,328,398,228,327,True,78
장,113,kaist_dataset/Korean/Digital_Camera/outdoor5/DSC03832.JPG,char_data/장/DSC03832.JPG_2.jpg,15707,480,640,139,400,539,223,336,True,78
장,85,kaist_dataset/Korean/Digital_Camera/outdoor5/DSC03848.JPG,char_data/장/DSC03848.JPG_2.jpg,5100,480,640,60,444,504,83,168,True,78
장,35,kaist_dataset/Korean/Digital_Camera/outdoor5/DSC03853.JPG,char_data/장/DSC03853.JPG_4.jpg,1015,480,640,29,378,407,116,151,True,78
장,69,kaist_dataset/Korean/Digital_Camera/outdoor5/DSC03853.JPG,char_data/장/DSC03853.JPG_5.jpg,5313,480,640,77,392,469,305,374,True,78
장,36,kaist_dataset/Korean/Digital_Camera/outdoor5/DSC03993.JPG,char_data/장/DSC03993.JPG_2.jpg,1584,480,640,44,317,361,432,468,True,78
장,120,kaist_dataset/Korean/Digital_Camera/outdoor6/DSC04058.JPG,char_data/장/DSC04058.JPG_2.jpg,11280,480,640,94,515,609,129,249,True,78
장,73,kaist_dataset/Korean/Digital_Camera/outdoor6/DSC04074.JPG,char_data/장/DSC04074.JPG_2.jpg,3723,480,640,51,562,613,22,95,True,78
장,36,kaist_dataset/Korean/Digital_Camera/outdoor6/DSC04077.JPG,char_data/장/DSC04077.JPG_2.jpg,828,480,640,23,334,357,187,223,True,78
장,98,kaist_dataset/Korean/Digital_Camera/outdoor6/DSC04090.JPG,char_data/장/DSC04090.JPG_2.jpg,11368,480,640,116,442,558,77,175,True,78
장,43,kaist_dataset/Korean/Digital_Camera/outdoor6/DSC04099.JPG,char_data/장/DSC04099.JPG_2.jpg,1247,480,640,29,344,373,169,212,True,78
장,39,kaist_dataset/Korean/Digital_Camera/outdoor6/DSC04116.JPG,char_data/장/DSC04116.JPG_2.jpg,1365,480,640,35,349,384,176,215,True,78
장,80,kaist_dataset/Korean/Digital_Camera/outdoor6/DSC04341.JPG,char_data/장/DSC04341.JPG_2.jpg,6400,480,640,80,110,190,71,151,True,78
장,46,kaist_dataset/Korean/Digital_Camera/outdoor6/DSC04344.JPG,char_data/장/DSC04344.JPG_2.jpg,2622,480,640,57,1,57,146,192,True,78
장,68,kaist_dataset/Korean/Digital_Camera/outdoor6/DSC04363.JPG,char_data/장/DSC04363.JPG_2.jpg,4624,480,640,68,472,540,182,250,True,78
장,40,kaist_dataset/Korean/Digital_Camera/outdoor7/P1010019.JPG,char_data/장/P1010019.JPG_2.jpg,1640,480,640,41,391,432,243,283,True,78
장,100,kaist_dataset/Korean/Digital_Camera/outdoor7/P1010021.JPG,char_data/장/P1010021.JPG_2.jpg,12200,480,640,122,455,577,265,365,True,78
장,218,kaist_dataset/Korean/Digital_Camera/outdoor7/P1010028.JPG,char_data/장/P1010028.JPG_2.jpg,23980,480,640,110,473,583,31,249,True,78
장,74,kaist_dataset/Korean/Digital_Camera/outdoor7/P1010043.JPG,char_data/장/P1010043.JPG_2.jpg,6290,480,640,85,367,452,211,285,True,78
장,46,kaist_dataset/Korean/Digital_Camera/outdoor7/P1010085.JPG,char_data/장/P1010085.JPG_2.jpg,1380,480,640,30,155,185,61,107,True,78
장,166,kaist_dataset/Korean/Digital_Camera/outdoor7/P1010086.JPG,char_data/장/P1010086.JPG_2.jpg,40670,480,640,245,265,510,77,243,True,78
장,163,kaist_dataset/Korean/Digital_Camera/outdoor7/P1010087.JPG,char_data/장/P1010087.JPG_2.jpg,19560,480,640,120,462,582,61,224,True,78
장,88,kaist_dataset/Korean/Digital_Camera/outdoor7/P1010101.JPG,char_data/장/P1010101.JPG_4.jpg,5544,480,640,63,263,326,125,213,True,78
장,83,kaist_dataset/Korean/Digital_Camera/outdoor7/P1010101.JPG,char_data/장/P1010101.JPG_5.jpg,6225,480,640,75,432,507,128,211,True,78
장,112,kaist_dataset/Korean/Digital_Camera/outdoor7/P1010106.JPG,char_data/장/P1010106.JPG_2.jpg,10080,480,640,90,267,357,100,212,True,78
장,106,kaist_dataset/Korean/Digital_Camera/outdoor7/P1010122.JPG,char_data/장/P1010122.JPG_2.jpg,7950,480,640,75,405,480,41,147,True,78
장,69,kaist_dataset/Korean/Digital_Camera/outdoor8/DSC02929.JPG,char_data/장/DSC02929.JPG_2.jpg,5244,480,640,76,407,483,148,217,True,78
장,92,kaist_dataset/Korean/Digital_Camera/outdoor8/P1010170.JPG,char_data/장/P1010170.JPG_2.jpg,13064,480,640,142,277,419,171,263,True,78
장,82,"kaist_dataset/Korean/Mobile_Phone/(M,K)A-shadow/P090912052.jpg",char_data/장/P090912052.jpg_2.jpg,6888,480,640,84,502,586,61,143,True,78
장,67,"kaist_dataset/Korean/Mobile_Phone/(M,K)C-outdoor/P090912044.jpg",char_data/장/P090912044.jpg_2.jpg,4422,480,640,66,429,495,116,183,True,78
장,124,"kaist_dataset/Korean/Mobile_Phone/(M,K)C-outdoor/P090912048.jpg",char_data/장/P090912048.jpg_2.jpg,13020,480,640,105,309,414,144,268,True,78
장,73,"kaist_dataset/Korean/Mobile_Phone/(M,K)D-indoor/P090911061.jpg",char_data/장/P090911061.jpg_2.jpg,4891,480,640,67,315,382,133,206,True,78
장,43,"kaist_dataset/Korean/Mobile_Phone/(M,K)D-indoor/P090911066.jpg",char_data/장/P090911066.jpg_2.jpg,1763,480,640,41,160,201,387,430,True,78
장,45,"kaist_dataset/Korean/Mobile_Phone/(M,K)D-indoor/P090911069.jpg",char_data/장/P090911069.jpg_2.jpg,2250,480,640,50,278,328,163,208,True,78
장,73,"kaist_dataset/Korean/Mobile_Phone/(M,K)E-bookCover/P090831058.jpg",char_data/장/P090831058.jpg_4.jpg,4745,480,640,65,78,143,195,268,True,78
장,75,"kaist_dataset/Korean/Mobile_Phone/(M,K)E-bookCover/P090831058.jpg",char_data/장/P090831058.jpg_5.jpg,4800,480,640,64,79,143,292,367,True,78
장,105,"kaist_dataset/Korean/Mobile_Phone/(M,K)E-bookCover/P090903077.jpg",char_data/장/P090903077.jpg_2.jpg,10500,480,640,100,115,215,288,393,True,78
장,39,"kaist_dataset/Korean/Mobile_Phone/(M,K)E-bookCover/P090903087.jpg",char_data/장/P090903087.jpg_2.jpg,1326,480,640,34,425,459,140,179,True,78
장,131,"kaist_dataset/Korean/Mobile_Phone/(M,K)E-bookCover/P090903091.jpg",char_data/장/P090903091.jpg_2.jpg,17030,480,640,130,209,339,81,212,True,78
장,80,"kaist_dataset/Korean/Mobile_Phone/(M,K)E-bookCover/P090912010.jpg",char_data/장/P090912010.jpg_2.jpg,4080,480,640,51,381,432,184,264,True,78
장,117,kaist_dataset/Mixed/Digital_Camera/(C.S)A-shadow/DSC03305.JPG,char_data/장/DSC03305.JPG_2.jpg,7956,480,640,68,501,569,201,318,True,78
장,66,kaist_dataset/Mixed/Digital_Camera/(C.S)A-shadow/DSC04326.JPG,char_data/장/DSC04326.JPG_2.jpg,3366,480,640,51,1,51,18,84,True,78
장,84,kaist_dataset/Mixed/Digital_Camera/(C.S)C-outdoor1/080119-0017.jpg,char_data/장/080119-0017.jpg_2.jpg,5712,1200,1600,68,863,931,1094,1178,True,78
장,138,kaist_dataset/Mixed/Digital_Camera/(C.S)C-outdoor1/080119-0033.jpg,char_data/장/080119-0033.jpg_2.jpg,15318,1200,1600,111,733,844,143,281,True,78
장,81,kaist_dataset/Mixed/Digital_Camera/(C.S)C-outdoor1/48.JPG,char_data/장/48.JPG_4.jpg,6156,576,768,76,351,427,490,571,True,78
장,62,kaist_dataset/Mixed/Digital_Camera/(C.S)C-outdoor1/48.JPG,char_data/장/48.JPG_5.jpg,3534,576,768,57,353,410,246,308,True,78
장,30,kaist_dataset/Mixed/Digital_Camera/(C.S)C-outdoor1/57.JPG,char_data/장/57.JPG_2.jpg,600,500,766,20,634,654,461,491,True,78
장,135,kaist_dataset/Mixed/Digital_Camera/(C.S)C-outdoor1/DSC02312.JPG,char_data/장/DSC02312.JPG_2.jpg,19170,480,640,142,477,619,57,192,True,78
장,90,kaist_dataset/Mixed/Digital_Camera/(C.S)C-outdoor2/DSC02492.JPG,char_data/장/DSC02492.JPG_2.jpg,6390,480,640,71,561,632,217,307,True,78
장,95,kaist_dataset/Mixed/Digital_Camera/(C.S)C-outdoor2/DSC02553.JPG,char_data/장/DSC02553.JPG_2.jpg,7410,480,640,78,546,624,175,270,True,78
장,78,kaist_dataset/Mixed/Digital_Camera/(C.S)C-outdoor2/DSC02869.JPG,char_data/장/DSC02869.JPG_2.jpg,3198,480,640,41,315,356,56,134,True,78
장,68,kaist_dataset/Mixed/Digital_Camera/(C.S)C-outdoor2/DSC02872.JPG,char_data/장/DSC02872.JPG_2.jpg,3604,480,640,53,358,411,146,214,True,78
장,103,kaist_dataset/Mixed/Digital_Camera/(C.S)C-outdoor2/DSC02907.JPG,char_data/장/DSC02907.JPG_2.jpg,9270,480,640,90,451,541,374,477,True,78
장,50,kaist_dataset/Mixed/Digital_Camera/(C.S)C-outdoor2/DSC02917.JPG,char_data/장/DSC02917.JPG_2.jpg,2150,480,640,43,252,295,390,440,True,78
장,58,kaist_dataset/Mixed/Digital_Camera/(C.S)C-outdoor2/DSC02919.JPG,char_data/장/DSC02919.JPG_2.jpg,3538,480,640,61,78,139,250,308,True,78
장,72,kaist_dataset/Mixed/Digital_Camera/(C.S)C-outdoor2/DSC02922.JPG,char_data/장/DSC02922.JPG_2.jpg,3312,480,640,46,296,342,235,307,True,78
장,41,kaist_dataset/Mixed/Digital_Camera/(C.S)C-outdoor2/DSC02933.JPG,char_data/장/DSC02933.JPG_2.jpg,943,480,640,23,413,436,240,281,True,78
장,85,kaist_dataset/Mixed/Digital_Camera/(C.S)C-outdoor3/DSC02969.JPG,char_data/장/DSC02969.JPG_2.jpg,6035,480,640,71,345,416,99,184,True,78
장,88,kaist_dataset/Mixed/Digital_Camera/(C.S)C-outdoor3/DSC03015.JPG,char_data/장/DSC03015.JPG_2.jpg,4224,480,640,48,549,597,162,250,True,78
장,82,kaist_dataset/Mixed/Digital_Camera/(C.S)C-outdoor3/DSC03179.JPG,char_data/장/DSC03179.JPG_2.jpg,4592,480,640,56,410,466,245,327,False,78
장,47,kaist_dataset/Mixed/Digital_Camera/(C.S)C-outdoor3/DSC03223.JPG,char_data/장/DSC03223.JPG_2.jpg,2491,480,640,53,567,620,420,467,False,78
장,86,kaist_dataset/Mixed/Digital_Camera/(C.S)C-outdoor3/DSC03234.JPG,char_data/장/DSC03234.JPG_2.jpg,7568,480,640,88,536,624,77,163,False,78
장,119,kaist_dataset/Mixed/Digital_Camera/(C.S)C-outdoor3/DSC03254.JPG,char_data/장/DSC03254.JPG_2.jpg,12495,480,640,105,533,638,71,190,False,78
장,75,kaist_dataset/Mixed/Digital_Camera/(C.S)C-outdoor3/DSC03431.JPG,char_data/장/DSC03431.JPG_2.jpg,5175,480,640,69,403,472,28,103,False,78
장,75,kaist_dataset/Mixed/Digital_Camera/(C.S)C-outdoor4/DSC03433.JPG,char_data/장/DSC03433.JPG_2.jpg,5175,480,640,69,172,241,224,299,False,78
장,67,kaist_dataset/Mixed/Digital_Camera/(C.S)C-outdoor4/DSC03439.JPG,char_data/장/DSC03439.JPG_2.jpg,3484,480,640,52,291,343,338,405,False,78
장,84,kaist_dataset/Mixed/Digital_Camera/(C.S)C-outdoor4/DSC03533.JPG,char_data/장/DSC03533.JPG_2.jpg,5040,480,640,60,558,618,185,269,False,78
장,103,kaist_dataset/Mixed/Digital_Camera/(C.S)C-outdoor4/DSC03534.JPG,char_data/장/DSC03534.JPG_2.jpg,7210,480,640,70,528,598,138,241,False,78
장,40,kaist_dataset/Mixed/Digital_Camera/(C.S)C-outdoor4/DSC03581.JPG,char_data/장/DSC03581.JPG_2.jpg,1720,480,640,43,392,435,198,238,False,78
장,68,kaist_dataset/Mixed/Digital_Camera/(C.S)C-outdoor4/DSC03582.JPG,char_data/장/DSC03582.JPG_2.jpg,5780,480,640,85,490,575,274,342,False,78
장,61,kaist_dataset/Mixed/Digital_Camera/(C.S)C-outdoor4/DSC03620.JPG,char_data/장/DSC03620.JPG_2.jpg,4636,480,640,76,433,509,399,460,False,78
장,81,kaist_dataset/Mixed/Digital_Camera/(C.S)C-outdoor4/DSC03631.JPG,char_data/장/DSC03631.JPG_2.jpg,3078,480,640,38,45,83,255,336,False,78
장,137,kaist_dataset/Mixed/Digital_Camera/(C.S)C-outdoor4/DSC03675.JPG,char_data/장/DSC03675.JPG_4.jpg,10138,480,640,74,460,534,196,333,False,78
장,52,kaist_dataset/Mixed/Digital_Camera/(C.S)C-outdoor4/DSC03675.JPG,char_data/장/DSC03675.JPG_5.jpg,1872,480,640,36,526,562,135,187,False,78
장,70,kaist_dataset/Mixed/Digital_Camera/(C.S)C-outdoor4/DSC03718.JPG,char_data/장/DSC03718.JPG_2.jpg,4060,480,640,58,219,277,313,383,False,78
장,81,kaist_dataset/Mixed/Digital_Camera/(C.S)C-outdoor4/DSC03719.JPG,char_data/장/DSC03719.JPG_2.jpg,4617,480,640,57,227,284,88,169,False,78
장,96,kaist_dataset/Mixed/Digital_Camera/(C.S)C-outdoor4/DSC03735.JPG,char_data/장/DSC03735.JPG_2.jpg,7392,480,640,77,202,279,227,323,False,78
장,103,kaist_dataset/Mixed/Digital_Camera/(C.S)C-outdoor4/DSC03769.JPG,char_data/장/DSC03769.JPG_2.jpg,5665,480,640,55,148,203,306,409,False,78
장,84,kaist_dataset/Mixed/Digital_Camera/(C.S)C-outdoor5/DSC03837.JPG,char_data/장/DSC03837.JPG_2.jpg,5040,480,640,60,434,494,164,248,False,78
장,70,kaist_dataset/Mixed/Digital_Camera/(C.S)C-outdoor5/DSC03867.JPG,char_data/장/DSC03867.JPG_2.jpg,3990,480,640,57,200,257,197,267,False,78
장,69,kaist_dataset/Mixed/Digital_Camera/(C.S)C-outdoor5/DSC04092.JPG,char_data/장/DSC04092.JPG_2.jpg,5520,480,640,80,462,542,301,370,False,78
장,57,kaist_dataset/Mixed/Digital_Camera/(C.S)C-outdoor5/DSC04094.JPG,char_data/장/DSC04094.JPG_2.jpg,2850,480,640,50,376,426,193,250,False,78
장,42,kaist_dataset/Mixed/Digital_Camera/(C.S)C-outdoor5/DSC04109.JPG,char_data/장/DSC04109.JPG_4.jpg,1176,480,640,28,568,596,135,177,False,78
장,54,kaist_dataset/Mixed/Digital_Camera/(C.S)C-outdoor5/DSC04109.JPG,char_data/장/DSC04109.JPG_5.jpg,2916,480,640,54,275,329,308,362,False,78
장,69,kaist_dataset/Mixed/Digital_Camera/(C.S)C-outdoor5/DSC04322.JPG,char_data/장/DSC04322.JPG_2.jpg,5727,480,640,83,81,164,126,195,False,78
장,70,kaist_dataset/Mixed/Digital_Camera/(C.S)C-outdoor5/DSC04323.JPG,char_data/장/DSC04323.JPG_2.jpg,4970,480,640,71,192,263,124,194,False,78
장,151,kaist_dataset/Mixed/Digital_Camera/(C.S)C-outdoor5/DSC04330.JPG,char_data/장/DSC04330.JPG_2.jpg,12382,480,640,82,492,574,198,349,False,78
장,62,kaist_dataset/Mixed/Digital_Camera/(C.S)C-outdoor6/080116-0057.jpg,char_data/장/080116-0057.jpg_2.jpg,3596,1200,1600,58,907,965,1081,1143,False,78
장,112,kaist_dataset/Mixed/Digital_Camera/(C.S)C-outdoor6/P1010020.JPG,char_data/장/P1010020.JPG_2.jpg,7504,480,640,67,526,593,211,323,False,78
장,98,kaist_dataset/Mixed/Digital_Camera/(C.S)C-outdoor6/P1010056.JPG,char_data/장/P1010056.JPG_2.jpg,10192,480,640,104,488,592,121,219,False,78
장,124,kaist_dataset/Mixed/Digital_Camera/(C.S)C-outdoor6/P1010075.JPG,char_data/장/P1010075.JPG_2.jpg,12276,480,640,99,371,470,172,296,False,78
장,47,kaist_dataset/Mixed/Digital_Camera/(C.S)D-indoor1/DSC04203.JPG,char_data/장/DSC04203.JPG_2.jpg,2256,480,640,48,433,481,291,338,False,78
장,169,kaist_dataset/Mixed/Digital_Camera/(C.S)E-night/DSC02678.JPG,char_data/장/DSC02678.JPG_2.jpg,17914,480,640,106,501,607,185,354,False,78
장,45,kaist_dataset/Mixed/Digital_Camera/(C.S)E-night/DSC03514.JPG,char_data/장/DSC03514.JPG_2.jpg,1710,480,640,38,394,432,156,201,False,78
장,74,kaist_dataset/Mixed/Digital_Camera/(C.S)E-night/DSC03516.JPG,char_data/장/DSC03516.JPG_2.jpg,4144,480,640,56,566,622,90,164,False,78
장,157,kaist_dataset/Mixed/Digital_Camera/(C.S)E-night/DSC03561.JPG,char_data/장/DSC03561.JPG_2.jpg,15072,480,640,96,406,502,77,234,False,78
장,43,kaist_dataset/Mixed/Mobile_Phone/(C.M)A-outdoor/P090908005.jpg,char_data/장/P090908005.jpg_2.jpg,1806,480,640,42,47,89,146,189,False,78
장,40,kaist_dataset/Mixed/Mobile_Phone/(C.M)A-outdoor/P090908006.jpg,char_data/장/P090908006.jpg_2.jpg,2000,480,640,50,26,76,276,316,False,78
c,65,kaist_dataset/English/Digital_Camera/(E.S)A-shadow/DSC03026.JPG,char_data/c/DSC03026.JPG_2.jpg,4290,480,640,66,67,133,163,228,True,32
c,78,kaist_dataset/English/Digital_Camera/(E.S)A-shadow/DSC03077.JPG,char_data/c/DSC03077.JPG_4.jpg,5382,480,640,69,157,226,353,431,True,32
c,82,kaist_dataset/English/Digital_Camera/(E.S)A-shadow/DSC03077.JPG,char_data/c/DSC03077.JPG_5.jpg,5904,480,640,72,429,501,352,434,True,32
c,56,kaist_dataset/English/Digital_Camera/(E.S)A-shadow/DSC03079.JPG,char_data/c/DSC03079.JPG_2.jpg,1232,480,640,22,257,279,335,391,True,32
c,59,kaist_dataset/English/Digital_Camera/(E.S)A-shadow/DSC03084.JPG,char_data/c/DSC03084.JPG_4.jpg,1298,480,640,22,143,165,369,428,True,32
c,63,kaist_dataset/English/Digital_Camera/(E.S)A-shadow/DSC03084.JPG,char_data/c/DSC03084.JPG_5.jpg,1260,480,640,20,487,507,369,432,True,32
c,49,kaist_dataset/English/Digital_Camera/(E.S)A-shadow/IMG_2647.JPG,char_data/c/IMG_2647.JPG_2.jpg,2303,480,640,47,160,207,260,309,True,32
c,88,kaist_dataset/English/Digital_Camera/(E.S)B-light/DSC02587.JPG,char_data/c/DSC02587.JPG_2.jpg,5192,480,640,59,375,434,198,286,True,32
c,27,kaist_dataset/English/Digital_Camera/(E.S)C-outdoor1/036.jpg,char_data/c/036.jpg_2.jpg,810,197,354,30,274,304,84,111,True,32
c,45,kaist_dataset/English/Digital_Camera/(E.S)C-outdoor1/055.JPG,char_data/c/055.JPG_2.jpg,1980,480,640,44,61,105,203,248,True,32
c,19,kaist_dataset/English/Digital_Camera/(E.S)C-outdoor1/056.JPG,char_data/c/056.JPG_7.jpg,114,480,640,6,302,308,243,262,True,32
c,66,kaist_dataset/English/Digital_Camera/(E.S)C-outdoor1/056.JPG,char_data/c/056.JPG_8.jpg,3498,480,640,53,492,545,175,241,True,32
c,81,kaist_dataset/English/Digital_Camera/(E.S)C-outdoor1/129.JPG,char_data/c/129.JPG_2.jpg,3645,480,640,45,460,505,213,294,True,32
c,42,kaist_dataset/English/Digital_Camera/(E.S)C-outdoor1/138.JPG,char_data/c/138.JPG_2.jpg,1344,480,640,32,344,376,264,306,True,32
c,133,kaist_dataset/English/Digital_Camera/(E.S)C-outdoor1/2007-12-08-day-015.jpg,char_data/c/2007-12-08-day-015.jpg_2.jpg,20615,1200,1600,155,931,1086,651,784,True,32
c,30,kaist_dataset/English/Digital_Camera/(E.S)C-outdoor1/DSC02356.JPG,char_data/c/DSC02356.JPG_5.jpg,750,480,640,25,371,396,315,345,True,32
c,23,kaist_dataset/English/Digital_Camera/(E.S)C-outdoor1/DSC02387.JPG,char_data/c/DSC02387.JPG_2.jpg,368,480,640,16,435,451,301,324,True,32
c,46,kaist_dataset/English/Digital_Camera/(E.S)C-outdoor1/DSC02442.JPG,char_data/c/DSC02442.JPG_2.jpg,1702,480,640,37,313,350,177,223,True,32
c,79,kaist_dataset/English/Digital_Camera/(E.S)C-outdoor1/DSC02491.JPG,char_data/c/DSC02491.JPG_5.jpg,5293,480,640,67,269,336,224,303,True,32
c,55,kaist_dataset/English/Digital_Camera/(E.S)C-outdoor1/DSC02514.JPG,char_data/c/DSC02514.JPG_5.jpg,1925,480,640,35,461,496,199,254,True,32
c,116,kaist_dataset/English/Digital_Camera/(E.S)C-outdoor1/DSC02914.JPG,char_data/c/DSC02914.JPG_2.jpg,8584,480,640,74,61,135,185,301,True,32
c,50,kaist_dataset/English/Digital_Camera/(E.S)C-outdoor2/DSC02998.JPG,char_data/c/DSC02998.JPG_2.jpg,2400,480,640,48,207,255,414,464,True,32
c,39,kaist_dataset/English/Digital_Camera/(E.S)C-outdoor2/DSC03160.JPG,char_data/c/DSC03160.JPG_4.jpg,1014,480,640,26,406,432,148,187,True,32
c,37,kaist_dataset/English/Digital_Camera/(E.S)C-outdoor2/DSC03160.JPG,char_data/c/DSC03160.JPG_5.jpg,851,480,640,23,454,477,148,185,True,32
c,36,kaist_dataset/English/Digital_Camera/(E.S)C-outdoor2/DSC03162.JPG,char_data/c/DSC03162.JPG_4.jpg,756,480,640,21,181,202,146,182,True,32
c,35,kaist_dataset/English/Digital_Camera/(E.S)C-outdoor2/DSC03162.JPG,char_data/c/DSC03162.JPG_5.jpg,910,480,640,26,269,295,143,178,True,32
c,45,kaist_dataset/English/Digital_Camera/(E.S)C-outdoor2/DSC03203.JPG,char_data/c/DSC03203.JPG_2.jpg,1845,480,640,41,93,134,426,471,True,32
c,25,kaist_dataset/English/Digital_Camera/(E.S)C-outdoor2/DSC03208.JPG,char_data/c/DSC03208.JPG_2.jpg,525,480,640,21,280,301,168,193,True,32
c,47,kaist_dataset/English/Digital_Camera/(E.S)C-outdoor2/DSC03290.JPG,char_data/c/DSC03290.JPG_9.jpg,1363,480,640,29,244,273,101,148,True,32
c,44,kaist_dataset/English/Digital_Camera/(E.S)C-outdoor2/DSC03290.JPG,char_data/c/DSC03290.JPG_11.jpg,1584,480,640,36,347,383,313,357,True,32
c,75,kaist_dataset/English/Digital_Camera/(E.S)C-outdoor2/DSC03408.JPG,char_data/c/DSC03408.JPG_2.jpg,3900,480,640,52,426,478,345,420,True,32
c,57,kaist_dataset/English/Digital_Camera/(E.S)C-outdoor2/DSC03412.JPG,char_data/c/DSC03412.JPG_4.jpg,2166,480,640,38,288,326,147,204,True,32
c,54,kaist_dataset/English/Digital_Camera/(E.S)C-outdoor2/DSC04052.JPG,char_data/c/DSC04052.JPG_4.jpg,1890,480,640,35,230,265,173,227,True,32
c,34,kaist_dataset/English/Digital_Camera/(E.S)C-outdoor2/DSC04052.JPG,char_data/c/DSC04052.JPG_5.jpg,748,480,640,22,493,515,189,223,True,32
c,38,kaist_dataset/English/Digital_Camera/(E.S)C-outdoor2/DSC04064.JPG,char_data/c/DSC04064.JPG_5.jpg,1026,480,640,27,320,347,139,177,True,32
c,44,kaist_dataset/English/Digital_Camera/(E.S)C-outdoor2/DSC04163.JPG,char_data/c/DSC04163.JPG_2.jpg,1584,480,640,36,199,235,268,312,True,32
c,75,kaist_dataset/English/Digital_Camera/(E.S)C-outdoor2/DSC04397.JPG,char_data/c/DSC04397.JPG_2.jpg,2775,480,640,37,129,166,119,194,True,32
c,105,kaist_dataset/English/Digital_Camera/(E.S)C-outdoor2/DSC04430.JPG,char_data/c/DSC04430.JPG_2.jpg,9975,480,640,95,442,537,169,274,True,32
c,59,kaist_dataset/English/Digital_Camera/(E.S)C-outdoor3/P1010086.JPG,char_data/c/P1010086.JPG_2.jpg,3658,480,640,62,272,334,88,147,True,32
c,34,kaist_dataset/English/Digital_Camera/(E.S)D-indoor/080119-0009.jpg,char_data/c/080119-0009.jpg_2.jpg,442,1200,1600,13,607,620,1059,1093,True,32
c,45,kaist_dataset/English/Digital_Camera/(E.S)D-indoor/DSC02859.JPG,char_data/c/DSC02859.JPG_2.jpg,1305,480,640,29,483,512,349,394,True,32
c,62,kaist_dataset/English/Digital_Camera/(E.S)D-indoor/DSC02860.JPG,char_data/c/DSC02860.JPG_2.jpg,2914,480,640,47,245,292,83,145,True,32
c,52,kaist_dataset/English/Digital_Camera/(E.S)D-indoor/DSC02862.JPG,char_data/c/DSC02862.JPG_2.jpg,2184,480,640,42,387,429,255,307,True,32
c,50,kaist_dataset/English/Digital_Camera/(E.S)D-indoor/DSC03074.JPG,char_data/c/DSC03074.JPG_2.jpg,1400,480,640,28,114,142,269,319,True,32
c,64,kaist_dataset/English/Digital_Camera/(E.S)D-indoor/DSC03076.JPG,char_data/c/DSC03076.JPG_4.jpg,2112,480,640,33,199,232,301,365,True,32
c,63,kaist_dataset/English/Digital_Camera/(E.S)D-indoor/DSC03076.JPG,char_data/c/DSC03076.JPG_5.jpg,2268,480,640,36,322,358,298,361,True,32
c,56,kaist_dataset/English/Digital_Camera/(E.S)D-indoor/DSC03078.JPG,char_data/c/DSC03078.JPG_2.jpg,1904,480,640,34,305,339,305,361,True,32
c,47,kaist_dataset/English/Digital_Camera/(E.S)D-indoor/DSC03083.JPG,char_data/c/DSC03083.JPG_2.jpg,1034,480,640,22,301,323,402,449,True,32
c,57,kaist_dataset/English/Digital_Camera/(E.S)D-indoor/DSC03087.JPG,char_data/c/DSC03087.JPG_2.jpg,2052,480,640,36,219,255,372,429,True,32
c,36,kaist_dataset/English/Digital_Camera/(E.S)D-indoor/DSC03090.JPG,char_data/c/DSC03090.JPG_2.jpg,828,480,640,23,328,351,243,279,True,32
c,41,kaist_dataset/English/Digital_Camera/(E.S)D-indoor/DSC03093.JPG,char_data/c/DSC03093.JPG_4.jpg,1517,480,640,37,488,525,148,189,True,32
c,47,kaist_dataset/English/Digital_Camera/(E.S)D-indoor/DSC03093.JPG,char_data/c/DSC03093.JPG_5.jpg,1316,480,640,28,353,381,211,258,True,32
c,47,kaist_dataset/English/Digital_Camera/(E.S)D-indoor/DSC03151.JPG,char_data/c/DSC03151.JPG_2.jpg,1222,480,640,26,563,589,110,157,True,32
c,48,kaist_dataset/English/Digital_Camera/(E.S)D-indoor/DSC03936.JPG,char_data/c/DSC03936.JPG_4.jpg,1584,480,640,33,448,481,93,141,True,32
c,37,kaist_dataset/English/Digital_Camera/(E.S)D-indoor/DSC03947.JPG,char_data/c/DSC03947.JPG_2.jpg,888,480,640,24,349,373,427,464,True,32
c,81,kaist_dataset/English/Digital_Camera/(E.S)D-indoor/DSC04023.JPG,char_data/c/DSC04023.JPG_2.jpg,4293,480,640,53,310,363,225,306,True,32
c,66,kaist_dataset/English/Digital_Camera/(E.S)E-night/111.jpg,char_data/c/111.jpg_2.jpg,3168,480,640,48,269,317,189,255,True,32
c,77,kaist_dataset/English/Digital_Camera/(E.S)E-night/DSC02981.JPG,char_data/c/DSC02981.JPG_2.jpg,2926,480,640,38,217,255,379,456,True,32
c,41,kaist_dataset/English/Digital_Camera/(E.S)F-others/080116-0058.jpg,char_data/c/080116-0058.jpg_2.jpg,943,1200,1600,23,81,104,636,677,True,32
c,52,kaist_dataset/English/Digital_Camera/(E.S)F-others/080119-0007.jpg,char_data/c/080119-0007.jpg_10.jpg,1508,1200,1600,29,896,925,813,865,True,32
c,47,kaist_dataset/English/Digital_Camera/(E.S)F-others/080119-0007.jpg,char_data/c/080119-0007.jpg_14.jpg,1551,1200,1600,33,928,961,744,791,True,32
c,28,kaist_dataset/English/Digital_Camera/(E.S)F-others/크기변환_%C4%BF%C7%C7%B5%B9%C3%E2%B0%A3%C6%C7_%281%29_alto99kr.jpg,char_data/c/크기변환_%C4%BF%C7%C7%B5%B9%C3%E2%B0%A3%C6%C7_%281%29_alto99kr.jpg_4.jpg,644,480,640,23,354,377,204,232,True,32
c,79,kaist_dataset/English/Mobile_Phone/(E.M)A-outdoor/P090911071.jpg,char_data/c/P090911071.jpg_2.jpg,3950,480,640,50,283,333,118,197,True,32
c,44,kaist_dataset/English/Mobile_Phone/(E.M)A-outdoor/P090912072.jpg,char_data/c/P090912072.jpg_2.jpg,1452,480,640,33,39,72,109,153,True,32
c,89,kaist_dataset/English/Mobile_Phone/(E.M)B-indoor/P090903002.jpg,char_data/c/P090903002.jpg_2.jpg,6853,480,640,77,122,199,291,380,True,32
c,95,kaist_dataset/English/Mobile_Phone/(E.M)B-indoor/P090903003.jpg,char_data/c/P090903003.jpg_2.jpg,7125,480,640,75,307,382,259,354,True,32
c,81,kaist_dataset/English/Mobile_Phone/(E.M)B-indoor/P090903004.jpg,char_data/c/P090903004.jpg_2.jpg,5265,480,640,65,463,528,249,330,True,32
c,61,kaist_dataset/English/Mobile_Phone/(E.M)B-indoor/P090903008.jpg,char_data/c/P090903008.jpg_4.jpg,2684,480,640,44,154,198,35,96,True,32
c,53,kaist_dataset/English/Mobile_Phone/(E.M)B-indoor/P090903008.jpg,char_data/c/P090903008.jpg_5.jpg,2173,480,640,41,535,576,43,96,True,32
c,118,kaist_dataset/English/Mobile_Phone/(E.M)C-bookCover/P090831022.jpg,char_data/c/P090831022.jpg_2.jpg,12036,480,640,102,513,615,151,269,True,32
c,117,kaist_dataset/Korean/Digital_Camera/A-shadow/2007-12-09-day-exterior-025.jpg,char_data/c/2007-12-09-day-exterior-025.jpg_2.jpg,9009,1200,1600,77,18,95,660,777,True,32
c,43,kaist_dataset/Korean/Digital_Camera/G-others/080119-0005.jpg,char_data/c/080119-0005.jpg_2.jpg,1333,1600,1200,31,740,771,1165,1208,True,32
c,41,kaist_dataset/Korean/Digital_Camera/indoor1/080119-0018.jpg,char_data/c/080119-0018.jpg_2.jpg,902,1200,1600,22,1176,1198,709,750,True,32
c,17,kaist_dataset/Korean/Digital_Camera/indoor1/080119-0029.jpg,char_data/c/080119-0029.jpg_2.jpg,204,1200,1600,12,928,940,665,682,True,32
c,22,kaist_dataset/Korean/Digital_Camera/outdoor1/001.JPG,char_data/c/001.JPG_6.jpg,242,480,640,11,95,106,244,266,True,32
c,20,kaist_dataset/Korean/Digital_Camera/outdoor1/001.JPG,char_data/c/001.JPG_7.jpg,180,480,640,9,487,496,240,260,True,32
c,22,kaist_dataset/Korean/Digital_Camera/outdoor1/001.JPG,char_data/c/001.JPG_8.jpg,264,480,640,12,547,559,239,261,True,32
c,44,kaist_dataset/Korean/Digital_Camera/outdoor1/2007-12-08-day-087.jpg,char_data/c/2007-12-08-day-087.jpg_2.jpg,1628,1200,1600,37,1354,1391,677,721,True,32
c,71,kaist_dataset/Korean/Digital_Camera/outdoor2/2007-12-08-day-101.jpg,char_data/c/2007-12-08-day-101.jpg_9.jpg,3337,1200,1600,47,528,575,371,442,True,32
c,36,kaist_dataset/Korean/Digital_Camera/outdoor2/2007-12-09-day-exterior-036.jpg,char_data/c/2007-12-09-day-exterior-036.jpg_2.jpg,1080,1200,1600,30,1447,1477,553,589,True,32
c,34,kaist_dataset/Mixed/Digital_Camera/(C.S)A-shadow/DSC02609.JPG,char_data/c/DSC02609.JPG_8.jpg,578,480,640,17,270,287,314,348,True,32
c,55,kaist_dataset/Mixed/Digital_Camera/(C.S)A-shadow/DSC03207.JPG,char_data/c/DSC03207.JPG_4.jpg,2145,480,640,39,272,311,205,260,True,32
c,52,kaist_dataset/Mixed/Digital_Camera/(C.S)A-shadow/DSC03207.JPG,char_data/c/DSC03207.JPG_5.jpg,1820,480,640,35,521,556,207,259,True,32
c,28,kaist_dataset/Mixed/Digital_Camera/(C.S)C-outdoor1/003.JPG,char_data/c/003.JPG_6.jpg,308,480,640,11,248,259,258,286,True,32
c,21,kaist_dataset/Mixed/Digital_Camera/(C.S)C-outdoor1/003.JPG,char_data/c/003.JPG_7.jpg,210,480,640,10,290,300,262,283,True,32
c,18,kaist_dataset/Mixed/Digital_Camera/(C.S)C-outdoor1/003.JPG,char_data/c/003.JPG_8.jpg,216,480,640,12,374,386,259,277,True,32
c,32,kaist_dataset/Mixed/Digital_Camera/(C.S)C-outdoor1/021.JPG,char_data/c/021.JPG_2.jpg,448,480,640,14,501,515,133,165,True,32
c,38,kaist_dataset/Mixed/Digital_Camera/(C.S)C-outdoor1/062.JPG,char_data/c/062.JPG_2.jpg,684,480,640,18,239,257,167,205,True,32
c,54,kaist_dataset/Mixed/Digital_Camera/(C.S)C-outdoor1/080116-0084.jpg,char_data/c/080116-0084.jpg_2.jpg,2700,600,800,50,543,593,215,269,True,32
c,51,kaist_dataset/Mixed/Digital_Camera/(C.S)C-outdoor1/101.JPG,char_data/c/101.JPG_2.jpg,1938,480,640,38,383,421,241,292,True,32
c,30,kaist_dataset/Mixed/Digital_Camera/(C.S)C-outdoor1/115.JPG,char_data/c/115.JPG_2.jpg,570,480,640,19,482,501,273,303,True,32
c,29,kaist_dataset/Mixed/Digital_Camera/(C.S)C-outdoor1/2.JPG,char_data/c/2.JPG_2.jpg,232,576,768,8,125,133,382,411,True,32
c,52,kaist_dataset/Mixed/Digital_Camera/(C.S)C-outdoor1/2007-12-08-day-118.jpg,char_data/c/2007-12-08-day-118.jpg_2.jpg,1820,1200,1600,35,1372,1407,425,477,True,32
c,55,kaist_dataset/Mixed/Digital_Camera/(C.S)C-outdoor1/2007-12-09-day-exterior-004.jpg,char_data/c/2007-12-09-day-exterior-004.jpg_2.jpg,2310,1200,1600,42,625,667,671,726,True,32
c,25,kaist_dataset/Mixed/Digital_Camera/(C.S)C-outdoor1/DSC02318.JPG,char_data/c/DSC02318.JPG_2.jpg,625,480,640,25,461,486,329,354,True,32
c,24,kaist_dataset/Mixed/Digital_Camera/(C.S)C-outdoor1/DSC02320.JPG,char_data/c/DSC02320.JPG_2.jpg,216,480,640,9,576,585,252,276,True,32
c,32,kaist_dataset/Mixed/Digital_Camera/(C.S)C-outdoor1/DSC02325.JPG,char_data/c/DSC02325.JPG_2.jpg,576,480,640,18,281,299,322,354,True,32
c,41,kaist_dataset/Mixed/Digital_Camera/(C.S)C-outdoor2/DSC02400.JPG,char_data/c/DSC02400.JPG_4.jpg,1435,480,640,35,24,59,327,368,True,32
c,42,kaist_dataset/Mixed/Digital_Camera/(C.S)C-outdoor2/DSC02400.JPG,char_data/c/DSC02400.JPG_5.jpg,1428,480,640,34,462,496,325,367,True,32
c,39,kaist_dataset/Mixed/Digital_Camera/(C.S)C-outdoor2/DSC02407.JPG,char_data/c/DSC02407.JPG_2.jpg,1326,480,640,34,449,483,185,224,True,32
c,34,kaist_dataset/Mixed/Digital_Camera/(C.S)C-outdoor2/DSC02411.JPG,char_data/c/DSC02411.JPG_12.jpg,782,480,640,23,72,95,353,387,True,32
c,43,kaist_dataset/Mixed/Digital_Camera/(C.S)C-outdoor2/DSC02411.JPG,char_data/c/DSC02411.JPG_13.jpg,860,480,640,20,121,141,351,394,True,32
c,39,kaist_dataset/Mixed/Digital_Camera/(C.S)C-outdoor2/DSC02411.JPG,char_data/c/DSC02411.JPG_14.jpg,975,480,640,25,267,292,353,392,True,32
c,19,kaist_dataset/Mixed/Digital_Camera/(C.S)C-outdoor2/DSC02421.JPG,char_data/c/DSC02421.JPG_4.jpg,361,480,640,19,346,365,214,233,True,32
c,20,kaist_dataset/Mixed/Digital_Camera/(C.S)C-outdoor2/DSC02421.JPG,char_data/c/DSC02421.JPG_5.jpg,380,480,640,19,436,455,212,232,True,32
c,19,kaist_dataset/Mixed/Digital_Camera/(C.S)C-outdoor2/DSC02430.JPG,char_data/c/DSC02430.JPG_2.jpg,209,480,640,11,85,96,33,52,True,32
c,32,kaist_dataset/Mixed/Digital_Camera/(C.S)C-outdoor2/DSC02482.JPG,char_data/c/DSC02482.JPG_2.jpg,864,480,640,27,170,197,275,307,True,32
c,24,kaist_dataset/Mixed/Digital_Camera/(C.S)C-outdoor2/DSC02483.JPG,char_data/c/DSC02483.JPG_2.jpg,360,480,640,15,404,419,153,177,True,32
c,46,kaist_dataset/Mixed/Digital_Camera/(C.S)C-outdoor2/DSC02519.JPG,char_data/c/DSC02519.JPG_4.jpg,1334,480,640,29,255,284,226,272,True,32
c,33,kaist_dataset/Mixed/Digital_Camera/(C.S)C-outdoor2/DSC02545.JPG,char_data/c/DSC02545.JPG_6.jpg,825,480,640,25,417,442,366,399,True,32
c,29,kaist_dataset/Mixed/Digital_Camera/(C.S)C-outdoor2/DSC02545.JPG,char_data/c/DSC02545.JPG_8.jpg,638,480,640,22,555,577,364,393,True,32
c,27,kaist_dataset/Mixed/Digital_Camera/(C.S)C-outdoor2/DSC02560.JPG,char_data/c/DSC02560.JPG_2.jpg,513,480,640,19,222,241,301,328,True,32
c,30,kaist_dataset/Mixed/Digital_Camera/(C.S)C-outdoor2/DSC02886.JPG,char_data/c/DSC02886.JPG_2.jpg,600,480,640,20,553,573,130,160,True,32
c,27,kaist_dataset/Mixed/Digital_Camera/(C.S)C-outdoor2/DSC02912.JPG,char_data/c/DSC02912.JPG_2.jpg,459,480,640,17,274,291,16,43,True,32
c,36,kaist_dataset/Mixed/Digital_Camera/(C.S)C-outdoor2/DSC02936.JPG,char_data/c/DSC02936.JPG_8.jpg,468,480,640,13,378,391,85,121,True,32
c,41,kaist_dataset/Mixed/Digital_Camera/(C.S)C-outdoor3/DSC02962.JPG,char_data/c/DSC02962.JPG_4.jpg,1476,480,640,36,282,318,263,304,True,32
c,36,kaist_dataset/Mixed/Digital_Camera/(C.S)C-outdoor3/DSC02978.JPG,char_data/c/DSC02978.JPG_2.jpg,828,480,640,23,188,211,169,205,True,32
c,25,kaist_dataset/Mixed/Digital_Camera/(C.S)C-outdoor3/DSC03020.JPG,char_data/c/DSC03020.JPG_2.jpg,400,480,640,16,481,497,307,332,True,32
c,60,kaist_dataset/Mixed/Digital_Camera/(C.S)C-outdoor3/DSC03047.JPG,char_data/c/DSC03047.JPG_2.jpg,1740,480,640,29,248,277,195,255,True,32
c,41,kaist_dataset/Mixed/Digital_Camera/(C.S)C-outdoor3/DSC03177.JPG,char_data/c/DSC03177.JPG_2.jpg,1435,480,640,35,401,436,147,188,True,32
c,105,kaist_dataset/Mixed/Digital_Camera/(C.S)C-outdoor3/DSC03196.JPG,char_data/c/DSC03196.JPG_2.jpg,9135,480,640,87,538,625,286,391,True,32
c,29,kaist_dataset/Mixed/Digital_Camera/(C.S)C-outdoor3/DSC03271.JPG,char_data/c/DSC03271.JPG_2.jpg,551,480,640,19,280,299,114,143,True,32
c,60,kaist_dataset/Mixed/Digital_Camera/(C.S)C-outdoor3/DSC03310.JPG,char_data/c/DSC03310.JPG_2.jpg,1680,480,640,28,375,403,107,167,True,32
c,47,kaist_dataset/Mixed/Digital_Camera/(C.S)C-outdoor3/DSC03332.JPG,char_data/c/DSC03332.JPG_2.jpg,1692,480,640,36,415,451,223,270,True,32
c,60,kaist_dataset/Mixed/Digital_Camera/(C.S)C-outdoor3/DSC03422.JPG,char_data/c/DSC03422.JPG_5.jpg,1680,480,640,28,315,343,258,318,True,32
c,75,kaist_dataset/Mixed/Digital_Camera/(C.S)C-outdoor4/DSC03634.JPG,char_data/c/DSC03634.JPG_7.jpg,4500,480,640,60,465,525,287,362,True,32
c,76,kaist_dataset/Mixed/Digital_Camera/(C.S)C-outdoor4/DSC03634.JPG,char_data/c/DSC03634.JPG_8.jpg,4940,480,640,65,524,589,288,364,True,32
c,77,kaist_dataset/Mixed/Digital_Camera/(C.S)C-outdoor4/DSC03635.JPG,char_data/c/DSC03635.JPG_2.jpg,4466,480,640,58,214,272,165,242,True,32
c,76,kaist_dataset/Mixed/Digital_Camera/(C.S)C-outdoor4/DSC03638.JPG,char_data/c/DSC03638.JPG_2.jpg,3952,480,640,52,229,281,124,200,True,32
c,44,kaist_dataset/Mixed/Digital_Camera/(C.S)C-outdoor4/DSC03642.JPG,char_data/c/DSC03642.JPG_4.jpg,1056,480,640,24,252,276,252,296,True,32
c,40,kaist_dataset/Mixed/Digital_Camera/(C.S)C-outdoor4/DSC03642.JPG,char_data/c/DSC03642.JPG_5.jpg,1040,480,640,26,434,460,246,286,True,32
c,53,kaist_dataset/Mixed/Digital_Camera/(C.S)C-outdoor4/DSC03643.JPG,char_data/c/DSC03643.JPG_4.jpg,2173,480,640,41,163,204,258,311,True,32
c,45,kaist_dataset/Mixed/Digital_Camera/(C.S)C-outdoor4/DSC03643.JPG,char_data/c/DSC03643.JPG_5.jpg,1980,480,640,44,390,434,276,321,True,32
c,30,kaist_dataset/Mixed/Digital_Camera/(C.S)C-outdoor4/DSC03667.JPG,char_data/c/DSC03667.JPG_2.jpg,450,480,640,15,263,278,381,411,True,32
c,32,kaist_dataset/Mixed/Digital_Camera/(C.S)C-outdoor4/DSC03672.JPG,char_data/c/DSC03672.JPG_2.jpg,576,480,640,18,357,375,413,445,True,32
c,29,kaist_dataset/Mixed/Digital_Camera/(C.S)C-outdoor4/DSC03682.JPG,char_data/c/DSC03682.JPG_7.jpg,609,480,640,21,382,403,328,357,True,32
c,38,kaist_dataset/Mixed/Digital_Camera/(C.S)C-outdoor4/DSC03773.JPG,char_data/c/DSC03773.JPG_2.jpg,1406,480,640,37,428,465,290,328,True,32
c,37,kaist_dataset/Mixed/Digital_Camera/(C.S)C-outdoor5/DSC03821.JPG,char_data/c/DSC03821.JPG_6.jpg,925,480,640,25,25,50,33,70,True,32
c,39,kaist_dataset/Mixed/Digital_Camera/(C.S)C-outdoor5/DSC03821.JPG,char_data/c/DSC03821.JPG_7.jpg,975,480,640,25,382,407,42,81,True,32
c,36,kaist_dataset/Mixed/Digital_Camera/(C.S)C-outdoor5/DSC03821.JPG,char_data/c/DSC03821.JPG_8.jpg,720,480,640,20,452,472,46,82,True,32
c,34,kaist_dataset/Mixed/Digital_Camera/(C.S)C-outdoor5/DSC03839.JPG,char_data/c/DSC03839.JPG_2.jpg,646,480,640,19,211,230,39,73,True,32
c,33,kaist_dataset/Mixed/Digital_Camera/(C.S)C-outdoor5/DSC04069.JPG,char_data/c/DSC04069.JPG_8.jpg,495,480,640,15,486,501,382,415,True,32
c,30,kaist_dataset/Mixed/Digital_Camera/(C.S)C-outdoor5/DSC04091.JPG,char_data/c/DSC04091.JPG_2.jpg,660,480,640,22,360,382,429,459,True,32
c,42,kaist_dataset/Mixed/Digital_Camera/(C.S)C-outdoor5/DSC04097.JPG,char_data/c/DSC04097.JPG_5.jpg,1302,480,640,31,261,292,198,240,True,32
c,30,kaist_dataset/Mixed/Digital_Camera/(C.S)C-outdoor5/DSC04109.JPG,char_data/c/DSC04109.JPG_2.jpg,960,480,640,32,168,200,160,190,True,32
c,33,kaist_dataset/Mixed/Digital_Camera/(C.S)C-outdoor5/DSC04125.JPG,char_data/c/DSC04125.JPG_6.jpg,462,480,640,14,140,154,430,463,True,32
c,27,kaist_dataset/Mixed/Digital_Camera/(C.S)C-outdoor5/DSC04125.JPG,char_data/c/DSC04125.JPG_7.jpg,297,480,640,11,178,189,429,456,True,32
c,29,kaist_dataset/Mixed/Digital_Camera/(C.S)C-outdoor5/DSC04125.JPG,char_data/c/DSC04125.JPG_8.jpg,522,480,640,18,240,258,430,459,True,32
c,46,kaist_dataset/Mixed/Digital_Camera/(C.S)C-outdoor5/DSC04129.JPG,char_data/c/DSC04129.JPG_4.jpg,1794,480,640,39,284,323,372,418,True,32
c,44,kaist_dataset/Mixed/Digital_Camera/(C.S)C-outdoor5/DSC04162.JPG,char_data/c/DSC04162.JPG_5.jpg,1320,480,640,30,245,275,331,375,True,32
c,42,kaist_dataset/Mixed/Digital_Camera/(C.S)C-outdoor5/DSC04322.JPG,char_data/c/DSC04322.JPG_2.jpg,756,480,640,18,465,483,223,265,True,32
c,39,kaist_dataset/Mixed/Digital_Camera/(C.S)C-outdoor5/DSC04323.JPG,char_data/c/DSC04323.JPG_2.jpg,702,480,640,18,511,529,205,244,True,32
c,46,kaist_dataset/Mixed/Digital_Camera/(C.S)C-outdoor5/DSC04399.JPG,char_data/c/DSC04399.JPG_2.jpg,1610,480,640,35,485,520,213,259,False,32
c,42,kaist_dataset/Mixed/Digital_Camera/(C.S)C-outdoor5/DSC04456.JPG,char_data/c/DSC04456.JPG_4.jpg,1680,480,640,40,139,179,175,217,False,32
c,42,kaist_dataset/Mixed/Digital_Camera/(C.S)C-outdoor5/DSC04456.JPG,char_data/c/DSC04456.JPG_5.jpg,1554,480,640,37,520,557,177,219,False,32
c,162,kaist_dataset/Mixed/Digital_Camera/(C.S)C-outdoor6/080116-0057.jpg,char_data/c/080116-0057.jpg_6.jpg,15552,1200,1600,96,330,426,339,501,False,32
c,162,kaist_dataset/Mixed/Digital_Camera/(C.S)C-outdoor6/080116-0057.jpg,char_data/c/080116-0057.jpg_7.jpg,16362,1200,1600,101,427,528,344,506,False,32
c,37,kaist_dataset/Mixed/Digital_Camera/(C.S)C-outdoor6/090.jpg,char_data/c/090.jpg_5.jpg,1295,480,640,35,348,383,150,187,False,32
c,24,kaist_dataset/Mixed/Digital_Camera/(C.S)C-outdoor6/P1010069.JPG,char_data/c/P1010069.JPG_4.jpg,408,480,640,17,234,251,302,326,False,32
c,25,kaist_dataset/Mixed/Digital_Camera/(C.S)C-outdoor6/P1010069.JPG,char_data/c/P1010069.JPG_5.jpg,425,480,640,17,276,293,304,329,False,32
c,35,kaist_dataset/Mixed/Digital_Camera/(C.S)C-outdoor6/P1010085.JPG,char_data/c/P1010085.JPG_5.jpg,770,480,640,22,107,129,132,167,False,32
c,58,kaist_dataset/Mixed/Digital_Camera/(C.S)C-outdoor6/P1010116.JPG,char_data/c/P1010116.JPG_2.jpg,1276,480,640,22,302,324,204,262,False,32
c,38,kaist_dataset/Mixed/Digital_Camera/(C.S)D-indoor1/DSC02787.JPG,char_data/c/DSC02787.JPG_4.jpg,608,480,640,16,84,100,385,423,False,32
c,29,kaist_dataset/Mixed/Digital_Camera/(C.S)D-indoor1/DSC03096.JPG,char_data/c/DSC03096.JPG_7.jpg,464,480,640,16,367,383,426,455,False,32
c,30,kaist_dataset/Mixed/Digital_Camera/(C.S)D-indoor1/DSC03096.JPG,char_data/c/DSC03096.JPG_8.jpg,480,480,640,16,539,555,429,459,False,32
c,45,kaist_dataset/Mixed/Digital_Camera/(C.S)D-indoor1/DSC03121.JPG,char_data/c/DSC03121.JPG_2.jpg,1215,480,640,27,268,295,202,247,False,32
c,29,kaist_dataset/Mixed/Digital_Camera/(C.S)D-indoor1/DSC03122.JPG,char_data/c/DSC03122.JPG_2.jpg,493,480,640,17,412,429,151,180,False,32
c,56,kaist_dataset/Mixed/Digital_Camera/(C.S)D-indoor1/DSC03455.JPG,char_data/c/DSC03455.JPG_2.jpg,1344,480,640,24,243,267,396,452,False,32
c,32,kaist_dataset/Mixed/Digital_Camera/(C.S)D-indoor1/DSC03466.JPG,char_data/c/DSC03466.JPG_2.jpg,800,480,640,25,397,422,233,265,False,32
c,80,kaist_dataset/Mixed/Digital_Camera/(C.S)D-indoor1/DSC03909.JPG,char_data/c/DSC03909.JPG_2.jpg,4000,480,640,50,410,460,200,280,False,32
c,36,kaist_dataset/Mixed/Digital_Camera/(C.S)D-indoor1/DSC04206.JPG,char_data/c/DSC04206.JPG_5.jpg,576,480,640,16,370,386,292,328,False,32
c,39,kaist_dataset/Mixed/Digital_Camera/(C.S)D-indoor1/DSC04244.JPG,char_data/c/DSC04244.JPG_2.jpg,1014,480,640,26,364,390,238,277,False,32
c,38,kaist_dataset/Mixed/Digital_Camera/(C.S)D-indoor1/DSC04246.JPG,char_data/c/DSC04246.JPG_5.jpg,684,480,640,18,223,241,250,288,False,32
c,35,kaist_dataset/Mixed/Digital_Camera/(C.S)D-indoor2/DSC04248.JPG,char_data/c/DSC04248.JPG_5.jpg,735,480,640,21,322,343,224,259,False,32
c,36,kaist_dataset/Mixed/Digital_Camera/(C.S)D-indoor2/DSC04254.JPG,char_data/c/DSC04254.JPG_7.jpg,648,480,640,18,383,401,340,376,False,32
c,25,kaist_dataset/Mixed/Digital_Camera/(C.S)E-night/DSC02569.JPG,char_data/c/DSC02569.JPG_2.jpg,475,480,640,19,458,477,275,300,False,32
c,54,kaist_dataset/Mixed/Digital_Camera/(C.S)E-night/DSC03840.JPG,char_data/c/DSC03840.JPG_2.jpg,2106,480,640,39,214,253,125,179,False,32
c,20,kaist_dataset/Mixed/Digital_Camera/(C.S)E-night/P1010151.JPG,char_data/c/P1010151.JPG_2.jpg,240,480,640,12,504,516,205,225,False,32
c,91,kaist_dataset/Mixed/Digital_Camera/(C.S)F-others/2007-12-08-day-044.jpg,char_data/c/2007-12-08-day-044.jpg_4.jpg,6006,1200,1600,66,261,327,409,500,False,32
c,42,kaist_dataset/Mixed/Digital_Camera/(C.S)F-others/2007-12-08-day-044.jpg,char_data/c/2007-12-08-day-044.jpg_5.jpg,1092,1200,1600,26,814,840,802,844,False,32
c,34,kaist_dataset/Mixed/Digital_Camera/(C.S)F-others/DSC02609.JPG,char_data/c/DSC02609.JPG_10.jpg,578,480,640,17,270,287,314,348,False,32
c,72,kaist_dataset/Mixed/Digital_Camera/(C.S)F-others/DSC03489.JPG,char_data/c/DSC03489.JPG_2.jpg,3240,480,640,45,362,407,352,424,False,32
c,48,kaist_dataset/Mixed/Mobile_Phone/(C.M)B-indoor/P090831010.jpg,char_data/c/P090831010.jpg_2.jpg,1584,480,640,33,296,329,292,340,False,32
c,41,kaist_dataset/Mixed/Mobile_Phone/(C.M)B-indoor/P090831014.jpg,char_data/c/P090831014.jpg_2.jpg,1271,480,640,31,344,375,171,212,False,32
c,49,kaist_dataset/Mixed/Mobile_Phone/(C.M)B-indoor/P090831015.jpg,char_data/c/P090831015.jpg_2.jpg,1617,480,640,33,403,436,214,263,False,32
c,42,kaist_dataset/Mixed/Mobile_Phone/(C.M)B-indoor/P090831018.jpg,char_data/c/P090831018.jpg_2.jpg,1722,480,640,41,437,478,237,279,False,32
c,54,kaist_dataset/Mixed/Mobile_Phone/(C.M)B-indoor/P090831023.jpg,char_data/c/P090831023.jpg_2.jpg,1998,480,640,37,261,298,274,328,False,32
c,35,kaist_dataset/Mixed/Mobile_Phone/(C.M)C-bookCover/P090831080.jpg,char_data/c/P090831080.jpg_5.jpg,770,480,640,22,266,288,413,448,False,32
c,38,kaist_dataset/Mixed/Mobile_Phone/(C.M)C-bookCover/P090831118.jpg,char_data/c/P090831118.jpg_2.jpg,798,480,640,21,411,432,221,259,False,32
c,32,kaist_dataset/Mixed/Mobile_Phone/(C.M)C-bookCover/P090902016.jpg,char_data/c/P090902016.jpg_4.jpg,768,480,640,24,296,320,144,176,False,32
기,23,kaist_dataset/English/Digital_Camera/(E.S)C-outdoor1/056.JPG,char_data/기/056.JPG_4.jpg,345,480,640,15,177,192,244,267,True,53
기,22,kaist_dataset/English/Digital_Camera/(E.S)C-outdoor1/056.JPG,char_data/기/056.JPG_5.jpg,352,480,640,16,192,208,244,266,True,53
기,309,kaist_dataset/Korean/Digital_Camera/A-shadow/2007-12-09-day-exterior-031.jpg,char_data/기/2007-12-09-day-exterior-031.jpg_2.jpg,92082,1200,1600,298,1164,1462,300,609,True,53
기,44,kaist_dataset/Korean/Digital_Camera/A-shadow/DSC04315.JPG,char_data/기/DSC04315.JPG_2.jpg,1232,480,640,28,432,460,416,460,True,53
기,111,kaist_dataset/Korean/Digital_Camera/A-shadow/P090911055.jpg,char_data/기/P090911055.jpg_2.jpg,10434,480,640,94,147,241,211,322,True,53
기,88,kaist_dataset/Korean/Digital_Camera/A-shadow/P1010036.JPG,char_data/기/P1010036.JPG_2.jpg,5192,480,640,59,475,534,1,89,True,53
기,96,kaist_dataset/Korean/Digital_Camera/B-light/080119-0026.jpg,char_data/기/080119-0026.jpg_2.jpg,8544,1200,1600,89,724,813,1032,1128,True,53
기,71,kaist_dataset/Korean/Digital_Camera/E-night/DSC03523.JPG,char_data/기/DSC03523.JPG_2.jpg,4402,480,640,62,147,209,282,353,True,53
기,60,kaist_dataset/Korean/Digital_Camera/E-night/DSC03870.JPG,char_data/기/DSC03870.JPG_2.jpg,4380,480,640,73,482,555,146,206,True,53
기,79,kaist_dataset/Korean/Digital_Camera/F-bookCover/DSC02814.JPG,char_data/기/DSC02814.JPG_2.jpg,8374,480,640,106,497,603,239,318,True,53
기,70,kaist_dataset/Korean/Digital_Camera/F-bookCover/DSC02829.JPG,char_data/기/DSC02829.JPG_2.jpg,4410,480,640,63,565,628,365,435,True,53
기,82,kaist_dataset/Korean/Digital_Camera/F-bookCover/DSC02830.JPG,char_data/기/DSC02830.JPG_2.jpg,7544,480,640,92,526,618,251,333,True,53
기,86,kaist_dataset/Korean/Digital_Camera/F-bookCover/DSC02831.JPG,char_data/기/DSC02831.JPG_2.jpg,7826,480,640,91,510,601,204,290,True,53
기,96,kaist_dataset/Korean/Digital_Camera/F-bookCover/DSC02833.JPG,char_data/기/DSC02833.JPG_2.jpg,6624,480,640,69,509,578,330,426,True,53
기,111,kaist_dataset/Korean/Digital_Camera/F-bookCover/DSC02838.JPG,char_data/기/DSC02838.JPG_2.jpg,10212,480,640,92,414,506,185,296,True,53
기,125,kaist_dataset/Korean/Digital_Camera/F-bookCover/DSC02839.JPG,char_data/기/DSC02839.JPG_2.jpg,16625,480,640,133,60,193,148,273,True,53
기,71,kaist_dataset/Korean/Digital_Camera/F-bookCover/DSC03926.JPG,char_data/기/DSC03926.JPG_2.jpg,4473,480,640,63,280,343,277,348,True,53
기,68,kaist_dataset/Korean/Digital_Camera/F-bookCover/DSC03931.JPG,char_data/기/DSC03931.JPG_2.jpg,3808,480,640,56,379,435,163,231,True,53
기,80,kaist_dataset/Korean/Digital_Camera/F-bookCover/DSC03934.JPG,char_data/기/DSC03934.JPG_2.jpg,5840,480,640,73,231,304,30,110,True,53
기,121,kaist_dataset/Korean/Digital_Camera/F-bookCover/DSC04229.JPG,char_data/기/DSC04229.JPG_2.jpg,11979,480,640,99,249,348,321,442,True,53
기,73,kaist_dataset/Korean/Digital_Camera/F-bookCover/DSC04241.JPG,char_data/기/DSC04241.JPG_2.jpg,5037,480,640,69,467,536,255,328,True,53
기,148,kaist_dataset/Korean/Digital_Camera/G-others/2007-12-08-day-045.jpg,char_data/기/2007-12-08-day-045.jpg_4.jpg,15540,1200,1600,105,1204,1309,1050,1198,True,53
기,413,kaist_dataset/Korean/Digital_Camera/G-others/2007-12-08-day-045.jpg,char_data/기/2007-12-08-day-045.jpg_5.jpg,253582,1200,1600,614,957,1571,302,715,True,53
기,117,kaist_dataset/Korean/Digital_Camera/G-others/DSC02904.JPG,char_data/기/DSC02904.JPG_2.jpg,10530,480,640,90,456,546,18,135,True,53
기,47,kaist_dataset/Korean/Digital_Camera/indoor1/DSC02700.JPG,char_data/기/DSC02700.JPG_2.jpg,1692,480,640,36,38,74,418,465,True,53
기,100,kaist_dataset/Korean/Digital_Camera/indoor1/DSC02704.JPG,char_data/기/DSC02704.JPG_2.jpg,8500,480,640,85,492,577,214,314,True,53
기,99,kaist_dataset/Korean/Digital_Camera/indoor1/DSC02705.JPG,char_data/기/DSC02705.JPG_2.jpg,6237,480,640,63,517,580,206,305,True,53
기,63,kaist_dataset/Korean/Digital_Camera/indoor1/DSC02723.JPG,char_data/기/DSC02723.JPG_2.jpg,3843,480,640,61,306,367,144,207,True,53
기,32,kaist_dataset/Korean/Digital_Camera/indoor1/DSC02760.JPG,char_data/기/DSC02760.JPG_2.jpg,1248,480,640,39,505,544,140,172,True,53
기,41,kaist_dataset/Korean/Digital_Camera/indoor1/DSC03113.JPG,char_data/기/DSC03113.JPG_2.jpg,1394,480,640,34,314,348,116,157,True,53
기,49,kaist_dataset/Korean/Digital_Camera/indoor1/DSC03116.JPG,char_data/기/DSC03116.JPG_2.jpg,2156,480,640,44,362,406,252,301,True,53
기,76,kaist_dataset/Korean/Digital_Camera/indoor1/DSC03152.JPG,char_data/기/DSC03152.JPG_2.jpg,4104,480,640,54,228,282,225,301,True,53
기,81,kaist_dataset/Korean/Digital_Camera/indoor1/DSC03347.JPG,char_data/기/DSC03347.JPG_2.jpg,5670,480,640,70,376,446,136,217,True,53
기,117,kaist_dataset/Korean/Digital_Camera/indoor1/DSC03351.JPG,char_data/기/DSC03351.JPG_2.jpg,12987,480,640,111,404,515,142,259,True,53
기,66,kaist_dataset/Korean/Digital_Camera/indoor1/DSC03381.JPG,char_data/기/DSC03381.JPG_2.jpg,3168,480,640,48,262,310,315,381,True,53
기,44,kaist_dataset/Korean/Digital_Camera/indoor2/DSC03424.JPG,char_data/기/DSC03424.JPG_2.jpg,1760,480,640,40,286,326,284,328,True,53
기,111,kaist_dataset/Korean/Digital_Camera/indoor2/DSC03480.JPG,char_data/기/DSC03480.JPG_2.jpg,10101,480,640,91,212,303,327,438,True,53
기,69,kaist_dataset/Korean/Digital_Camera/indoor2/DSC03530.JPG,char_data/기/DSC03530.JPG_4.jpg,6141,480,640,89,386,475,262,331,True,53
기,31,kaist_dataset/Korean/Digital_Camera/indoor2/DSC03530.JPG,char_data/기/DSC03530.JPG_5.jpg,1209,480,640,39,432,471,218,249,True,53
기,83,kaist_dataset/Korean/Digital_Camera/indoor2/DSC03977.JPG,char_data/기/DSC03977.JPG_2.jpg,8051,480,640,97,127,224,87,170,True,53
기,43,kaist_dataset/Korean/Digital_Camera/indoor2/DSC04012.JPG,char_data/기/DSC04012.JPG_2.jpg,1806,480,640,42,344,386,192,235,True,53
기,80,kaist_dataset/Korean/Digital_Camera/indoor2/DSC04176.JPG,char_data/기/DSC04176.JPG_2.jpg,6320,480,640,79,414,493,100,180,True,53
기,77,kaist_dataset/Korean/Digital_Camera/indoor2/DSC04195.JPG,char_data/기/DSC04195.JPG_2.jpg,4697,480,640,61,517,578,66,143,True,53
기,115,kaist_dataset/Korean/Digital_Camera/indoor2/DSC04253.JPG,char_data/기/DSC04253.JPG_2.jpg,4715,480,640,41,325,366,96,211,True,53
기,50,kaist_dataset/Korean/Digital_Camera/outdoor1/007.JPG,char_data/기/007.JPG_6.jpg,2600,480,640,52,477,529,338,388,True,53
기,68,kaist_dataset/Korean/Digital_Camera/outdoor1/007.JPG,char_data/기/007.JPG_7.jpg,7072,480,640,104,112,216,187,255,True,53
기,55,kaist_dataset/Korean/Digital_Camera/outdoor1/007.JPG,char_data/기/007.JPG_8.jpg,3080,480,640,56,27,83,341,396,True,53
기,19,kaist_dataset/Korean/Digital_Camera/outdoor1/011.JPG,char_data/기/011.JPG_2.jpg,380,480,640,20,145,165,261,280,True,53
기,62,kaist_dataset/Korean/Digital_Camera/outdoor1/033.JPG,char_data/기/033.JPG_2.jpg,3720,480,640,60,379,439,199,261,True,53
기,104,kaist_dataset/Korean/Digital_Camera/outdoor1/040.JPG,char_data/기/040.JPG_2.jpg,7904,480,640,76,147,223,186,290,True,53
기,235,kaist_dataset/Korean/Digital_Camera/outdoor1/097.JPG,char_data/기/097.JPG_2.jpg,31725,480,640,135,181,316,134,369,True,53
기,64,kaist_dataset/Korean/Digital_Camera/outdoor1/126.JPG,char_data/기/126.JPG_2.jpg,5120,480,640,80,277,357,191,255,True,53
기,75,kaist_dataset/Korean/Digital_Camera/outdoor1/2007-12-08-day-065.jpg,char_data/기/2007-12-08-day-065.jpg_2.jpg,5100,1600,1200,68,153,221,409,484,True,53
기,154,kaist_dataset/Korean/Digital_Camera/outdoor2/2007-12-09-day-exterior-006.jpg,char_data/기/2007-12-09-day-exterior-006.jpg_4.jpg,26026,1200,1600,169,205,374,139,293,True,53
기,120,kaist_dataset/Korean/Digital_Camera/outdoor2/2007-12-09-day-exterior-006.jpg,char_data/기/2007-12-09-day-exterior-006.jpg_5.jpg,14160,1200,1600,118,1482,1599,289,409,True,53
기,143,kaist_dataset/Korean/Digital_Camera/outdoor2/2007-12-09-day-exterior-008.jpg,char_data/기/2007-12-09-day-exterior-008.jpg_2.jpg,24739,1200,1600,173,1445,1599,109,252,True,53
기,74,kaist_dataset/Korean/Digital_Camera/outdoor2/2007-12-09-day-exterior-012.jpg,char_data/기/2007-12-09-day-exterior-012.jpg_2.jpg,3922,1200,1600,53,257,310,631,705,True,53
기,41,kaist_dataset/Korean/Digital_Camera/outdoor2/2007-12-09-day-exterior-035.jpg,char_data/기/2007-12-09-day-exterior-035.jpg_2.jpg,1517,1200,1600,37,657,694,503,544,True,53
기,126,kaist_dataset/Korean/Digital_Camera/outdoor2/DSC02304.JPG,char_data/기/DSC02304.JPG_2.jpg,11718,480,640,93,166,259,104,230,True,53
기,106,kaist_dataset/Korean/Digital_Camera/outdoor2/DSC02452.JPG,char_data/기/DSC02452.JPG_4.jpg,11978,480,640,113,259,372,177,283,True,53
기,102,kaist_dataset/Korean/Digital_Camera/outdoor2/DSC02452.JPG,char_data/기/DSC02452.JPG_5.jpg,12036,480,640,118,247,365,296,398,True,53
기,156,kaist_dataset/Korean/Digital_Camera/outdoor2/DSC02496.JPG,char_data/기/DSC02496.JPG_2.jpg,19188,480,640,123,268,391,204,360,True,53
기,46,kaist_dataset/Korean/Digital_Camera/outdoor2/DSC02499.JPG,char_data/기/DSC02499.JPG_2.jpg,3174,480,640,69,38,107,1,47,True,53
기,52,kaist_dataset/Korean/Digital_Camera/outdoor3/DSC02698.JPG,char_data/기/DSC02698.JPG_2.jpg,2236,480,640,43,90,133,390,442,True,53
기,45,kaist_dataset/Korean/Digital_Camera/outdoor3/DSC02951.JPG,char_data/기/DSC02951.JPG_2.jpg,2295,480,640,51,443,494,53,98,True,53
기,82,kaist_dataset/Korean/Digital_Camera/outdoor3/DSC03181.JPG,char_data/기/DSC03181.JPG_2.jpg,3936,480,640,48,151,199,250,332,True,53
기,97,kaist_dataset/Korean/Digital_Camera/outdoor3/DSC03182.JPG,char_data/기/DSC03182.JPG_2.jpg,7857,480,640,81,457,538,38,135,True,53
기,49,kaist_dataset/Korean/Digital_Camera/outdoor3/DSC03220.JPG,char_data/기/DSC03220.JPG_2.jpg,2107,480,640,43,152,195,89,138,True,53
기,35,kaist_dataset/Korean/Digital_Camera/outdoor4/DSC03272.JPG,char_data/기/DSC03272.JPG_2.jpg,1155,480,640,33,210,243,251,286,True,53
기,74,kaist_dataset/Korean/Digital_Camera/outdoor4/DSC03319.JPG,char_data/기/DSC03319.JPG_2.jpg,3848,480,640,52,250,302,7,81,True,53
기,79,kaist_dataset/Korean/Digital_Camera/outdoor4/DSC03510.JPG,char_data/기/DSC03510.JPG_2.jpg,5451,480,640,69,199,268,76,155,True,53
기,102,kaist_dataset/Korean/Digital_Camera/outdoor4/DSC03513.JPG,char_data/기/DSC03513.JPG_2.jpg,9180,480,640,90,456,546,38,140,True,53
기,87,kaist_dataset/Korean/Digital_Camera/outdoor4/DSC03537.JPG,char_data/기/DSC03537.JPG_2.jpg,6960,480,640,80,357,437,23,110,True,53
기,46,kaist_dataset/Korean/Digital_Camera/outdoor4/DSC03578.JPG,char_data/기/DSC03578.JPG_2.jpg,1012,480,640,22,357,379,146,192,True,53
기,78,kaist_dataset/Korean/Digital_Camera/outdoor4/DSC03590.JPG,char_data/기/DSC03590.JPG_2.jpg,5148,480,640,66,556,622,123,201,True,53
기,50,kaist_dataset/Korean/Digital_Camera/outdoor5/DSC03632.JPG,char_data/기/DSC03632.JPG_2.jpg,1900,480,640,38,296,334,74,124,True,53
기,49,kaist_dataset/Korean/Digital_Camera/outdoor5/DSC03683.JPG,char_data/기/DSC03683.JPG_2.jpg,2254,480,640,46,177,223,46,95,True,53
기,85,kaist_dataset/Korean/Digital_Camera/outdoor5/DSC03710.JPG,char_data/기/DSC03710.JPG_2.jpg,3570,480,640,42,486,528,326,411,True,53
기,61,kaist_dataset/Korean/Digital_Camera/outdoor5/DSC03713.JPG,char_data/기/DSC03713.JPG_2.jpg,2806,480,640,46,295,341,396,457,True,53
기,126,kaist_dataset/Korean/Digital_Camera/outdoor5/DSC03717.JPG,char_data/기/DSC03717.JPG_2.jpg,4536,480,640,36,512,548,216,342,True,53
기,62,kaist_dataset/Korean/Digital_Camera/outdoor5/DSC03749.JPG,char_data/기/DSC03749.JPG_2.jpg,2480,480,640,40,80,120,82,144,True,53
기,98,kaist_dataset/Korean/Digital_Camera/outdoor5/DSC03780.JPG,char_data/기/DSC03780.JPG_2.jpg,8330,480,640,85,319,404,361,459,True,53
기,142,kaist_dataset/Korean/Digital_Camera/outdoor5/DSC03782.JPG,char_data/기/DSC03782.JPG_2.jpg,15336,480,640,108,470,578,103,245,True,53
기,75,kaist_dataset/Korean/Digital_Camera/outdoor5/DSC03791.JPG,char_data/기/DSC03791.JPG_2.jpg,4725,480,640,63,101,164,70,145,True,53
기,106,kaist_dataset/Korean/Digital_Camera/outdoor5/DSC03868.JPG,char_data/기/DSC03868.JPG_2.jpg,7950,480,640,75,310,385,234,340,True,53
기,70,kaist_dataset/Korean/Digital_Camera/outdoor5/DSC03869.JPG,char_data/기/DSC03869.JPG_2.jpg,4270,480,640,61,246,307,262,332,True,53
기,62,kaist_dataset/Korean/Digital_Camera/outdoor5/DSC03996.JPG,char_data/기/DSC03996.JPG_2.jpg,2666,480,640,43,204,247,84,146,True,53
기,78,kaist_dataset/Korean/Digital_Camera/outdoor6/DSC04042.JPG,char_data/기/DSC04042.JPG_2.jpg,5148,480,640,66,470,536,276,354,True,53
기,42,kaist_dataset/Korean/Digital_Camera/outdoor6/DSC04044.JPG,char_data/기/DSC04044.JPG_2.jpg,1218,480,640,29,589,618,356,398,True,53
기,72,kaist_dataset/Korean/Digital_Camera/outdoor6/DSC04045.JPG,char_data/기/DSC04045.JPG_2.jpg,5544,480,640,77,422,499,28,100,True,53
기,79,kaist_dataset/Korean/Digital_Camera/outdoor6/DSC04117.JPG,char_data/기/DSC04117.JPG_2.jpg,4661,480,640,59,462,521,189,268,True,53
기,58,kaist_dataset/Korean/Digital_Camera/outdoor6/DSC04141.JPG,char_data/기/DSC04141.JPG_2.jpg,2262,480,640,39,247,286,357,415,True,53
기,48,kaist_dataset/Korean/Digital_Camera/outdoor6/DSC04148.JPG,char_data/기/DSC04148.JPG_6.jpg,1440,480,640,30,243,273,251,299,True,53
기,42,kaist_dataset/Korean/Digital_Camera/outdoor6/DSC04148.JPG,char_data/기/DSC04148.JPG_7.jpg,1722,480,640,41,250,291,306,348,True,53
기,44,kaist_dataset/Korean/Digital_Camera/outdoor6/DSC04148.JPG,char_data/기/DSC04148.JPG_8.jpg,1584,480,640,36,311,347,365,409,True,53
기,137,kaist_dataset/Korean/Digital_Camera/outdoor6/DSC04352.JPG,char_data/기/DSC04352.JPG_2.jpg,15481,480,640,113,213,326,126,263,True,53
기,91,kaist_dataset/Korean/Digital_Camera/outdoor6/DSC04440.JPG,char_data/기/DSC04440.JPG_2.jpg,7007,480,640,77,357,434,38,129,True,53
기,101,kaist_dataset/Korean/Digital_Camera/outdoor7/P1010021.JPG,char_data/기/P1010021.JPG_2.jpg,9898,480,640,98,524,622,144,245,True,53
기,78,kaist_dataset/Korean/Digital_Camera/outdoor7/P1010066.JPG,char_data/기/P1010066.JPG_2.jpg,7566,480,640,97,433,530,65,143,True,53
기,65,kaist_dataset/Korean/Digital_Camera/outdoor7/P1010075.JPG,char_data/기/P1010075.JPG_2.jpg,4030,480,640,62,306,368,254,319,True,53
기,82,kaist_dataset/Korean/Digital_Camera/outdoor7/P1010101.JPG,char_data/기/P1010101.JPG_2.jpg,6068,480,640,74,174,248,118,200,True,53
기,54,kaist_dataset/Korean/Digital_Camera/outdoor7/P1010138.JPG,char_data/기/P1010138.JPG_2.jpg,2646,480,640,49,180,229,217,271,True,53
기,235,kaist_dataset/Korean/Digital_Camera/outdoor8/2007-12-08-day-132.jpg,char_data/기/2007-12-08-day-132.jpg_2.jpg,24675,1200,1600,105,1041,1146,577,812,True,53
기,67,kaist_dataset/Korean/Digital_Camera/outdoor8/DSC02950.JPG,char_data/기/DSC02950.JPG_2.jpg,4154,480,640,62,550,612,164,231,True,53
기,71,kaist_dataset/Korean/Digital_Camera/outdoor8/P1010142.JPG,char_data/기/P1010142.JPG_2.jpg,5893,480,640,83,208,291,92,163,True,53
기,46,kaist_dataset/Korean/Digital_Camera/outdoor8/P1010170.JPG,char_data/기/P1010170.JPG_2.jpg,1886,480,640,41,234,275,269,315,True,53
기,71,kaist_dataset/Korean/Digital_Camera/outdoor8/크기변환_P1010026.JPG,char_data/기/크기변환_P1010026.JPG_2.jpg,4189,480,640,59,411,470,131,202,True,53
기,81,kaist_dataset/Korean/Digital_Camera/outdoor8/크기변환_P1010033.JPG,char_data/기/크기변환_P1010033.JPG_2.jpg,6237,480,640,77,375,452,58,139,True,53
기,67,"kaist_dataset/Korean/Mobile_Phone/(M,K)C-outdoor/P090903101.jpg",char_data/기/P090903101.jpg_2.jpg,4154,480,640,62,359,421,169,236,True,53
기,56,"kaist_dataset/Korean/Mobile_Phone/(M,K)D-indoor/P090912028.jpg",char_data/기/P090912028.jpg_2.jpg,3416,480,640,61,199,260,409,465,True,53
기,172,"kaist_dataset/Korean/Mobile_Phone/(M,K)E-bookCover/P090831027.jpg",char_data/기/P090831027.jpg_2.jpg,18920,480,640,110,207,317,179,351,True,53
기,99,"kaist_dataset/Korean/Mobile_Phone/(M,K)E-bookCover/P090831029.jpg",char_data/기/P090831029.jpg_2.jpg,6534,480,640,66,499,565,198,297,True,53
기,133,"kaist_dataset/Korean/Mobile_Phone/(M,K)E-bookCover/P090831033.jpg",char_data/기/P090831033.jpg_4.jpg,14364,480,640,108,488,596,187,320,True,53
기,51,"kaist_dataset/Korean/Mobile_Phone/(M,K)E-bookCover/P090831033.jpg",char_data/기/P090831033.jpg_5.jpg,1785,480,640,35,549,584,404,455,True,53
기,49,"kaist_dataset/Korean/Mobile_Phone/(M,K)E-bookCover/P090831034.jpg",char_data/기/P090831034.jpg_4.jpg,1519,480,640,31,289,320,339,388,True,53
기,96,"kaist_dataset/Korean/Mobile_Phone/(M,K)E-bookCover/P090831034.jpg",char_data/기/P090831034.jpg_5.jpg,8832,480,640,92,494,586,172,268,True,53
기,69,"kaist_dataset/Korean/Mobile_Phone/(M,K)E-bookCover/P090831047.jpg",char_data/기/P090831047.jpg_2.jpg,4002,480,640,58,140,198,152,221,True,53
기,122,"kaist_dataset/Korean/Mobile_Phone/(M,K)E-bookCover/P090831056.jpg",char_data/기/P090831056.jpg_8.jpg,11346,480,640,93,494,587,166,288,True,53
기,43,"kaist_dataset/Korean/Mobile_Phone/(M,K)E-bookCover/P090831056.jpg",char_data/기/P090831056.jpg_9.jpg,1161,480,640,27,308,335,305,348,True,53
기,46,"kaist_dataset/Korean/Mobile_Phone/(M,K)E-bookCover/P090831056.jpg",char_data/기/P090831056.jpg_10.jpg,1288,480,640,28,336,364,305,351,True,53
기,45,"kaist_dataset/Korean/Mobile_Phone/(M,K)E-bookCover/P090831056.jpg",char_data/기/P090831056.jpg_11.jpg,1440,480,640,32,548,580,302,347,True,53
기,92,"kaist_dataset/Korean/Mobile_Phone/(M,K)E-bookCover/P090831067.jpg",char_data/기/P090831067.jpg_2.jpg,9752,480,640,106,379,485,83,175,True,53
기,132,"kaist_dataset/Korean/Mobile_Phone/(M,K)E-bookCover/P090831127.jpg",char_data/기/P090831127.jpg_2.jpg,9768,480,640,74,274,348,222,354,True,53
기,82,"kaist_dataset/Korean/Mobile_Phone/(M,K)E-bookCover/P090831150.jpg",char_data/기/P090831150.jpg_2.jpg,7708,480,640,94,89,183,62,144,True,53
기,102,"kaist_dataset/Korean/Mobile_Phone/(M,K)E-bookCover/P090831155.jpg",char_data/기/P090831155.jpg_2.jpg,7548,480,640,74,471,545,55,157,True,53
기,132,"kaist_dataset/Korean/Mobile_Phone/(M,K)E-bookCover/P090903031.jpg",char_data/기/P090903031.jpg_2.jpg,13464,480,640,102,489,591,76,208,True,53
기,95,"kaist_dataset/Korean/Mobile_Phone/(M,K)E-bookCover/P090903032.jpg",char_data/기/P090903032.jpg_6.jpg,7790,480,640,82,443,525,139,234,True,53
기,40,"kaist_dataset/Korean/Mobile_Phone/(M,K)E-bookCover/P090903032.jpg",char_data/기/P090903032.jpg_7.jpg,1040,480,640,26,276,302,256,296,True,53
기,35,"kaist_dataset/Korean/Mobile_Phone/(M,K)E-bookCover/P090903032.jpg",char_data/기/P090903032.jpg_8.jpg,945,480,640,27,465,492,248,283,True,53
기,131,"kaist_dataset/Korean/Mobile_Phone/(M,K)E-bookCover/P090905008.jpg",char_data/기/P090905008.jpg_2.jpg,13362,480,640,102,156,258,135,266,True,53
기,127,"kaist_dataset/Korean/Mobile_Phone/(M,K)E-bookCover/P090911002.jpg",char_data/기/P090911002.jpg_2.jpg,13843,480,640,109,304,413,149,276,True,53
기,38,"kaist_dataset/Korean/Mobile_Phone/(M,K)E-bookCover/P090911007.jpg",char_data/기/P090911007.jpg_2.jpg,1444,480,640,38,199,237,124,162,True,53
기,71,"kaist_dataset/Korean/Mobile_Phone/(M,K)E-bookCover/P090911011.jpg",char_data/기/P090911011.jpg_2.jpg,5467,480,640,77,312,389,239,310,True,53
기,63,"kaist_dataset/Korean/Mobile_Phone/(M,K)F-others/P090911041.jpg",char_data/기/P090911041.jpg_2.jpg,4977,480,640,79,360,439,333,396,True,53
기,86,kaist_dataset/Mixed/Digital_Camera/(C.S)A-shadow/DSC04306.JPG,char_data/기/DSC04306.JPG_2.jpg,5590,480,640,65,342,407,322,408,True,53
기,65,kaist_dataset/Mixed/Digital_Camera/(C.S)C-outdoor1/003.JPG,char_data/기/003.JPG_2.jpg,3055,480,640,47,254,301,185,250,True,53
기,113,kaist_dataset/Mixed/Digital_Camera/(C.S)C-outdoor1/080118-0014.jpg,char_data/기/080118-0014.jpg_2.jpg,9944,1200,1600,88,1,88,81,194,True,53
기,138,kaist_dataset/Mixed/Digital_Camera/(C.S)C-outdoor1/080119-0033.jpg,char_data/기/080119-0033.jpg_2.jpg,12696,1200,1600,92,846,938,143,281,True,53
기,63,kaist_dataset/Mixed/Digital_Camera/(C.S)C-outdoor1/081.JPG,char_data/기/081.JPG_2.jpg,5544,480,640,88,511,599,137,200,True,53
기,83,kaist_dataset/Mixed/Digital_Camera/(C.S)C-outdoor1/118.JPG,char_data/기/118.JPG_2.jpg,4648,480,640,56,490,546,265,348,True,53
기,80,kaist_dataset/Mixed/Digital_Camera/(C.S)C-outdoor1/121.JPG,char_data/기/121.JPG_2.jpg,5920,480,640,74,310,384,185,265,True,53
기,46,kaist_dataset/Mixed/Digital_Camera/(C.S)C-outdoor1/133.JPG,char_data/기/133.JPG_2.jpg,1794,480,640,39,390,429,330,376,True,53
기,88,kaist_dataset/Mixed/Digital_Camera/(C.S)C-outdoor1/2007-12-08-day-118.jpg,char_data/기/2007-12-08-day-118.jpg_2.jpg,10560,1200,1600,120,613,733,582,670,True,53
기,129,kaist_dataset/Mixed/Digital_Camera/(C.S)C-outdoor1/DSC02350.JPG,char_data/기/DSC02350.JPG_2.jpg,12513,480,640,97,240,337,269,398,True,53
기,61,kaist_dataset/Mixed/Digital_Camera/(C.S)C-outdoor2/DSC02376.JPG,char_data/기/DSC02376.JPG_2.jpg,3843,480,640,63,194,257,249,310,True,53
기,56,kaist_dataset/Mixed/Digital_Camera/(C.S)C-outdoor2/DSC02493.JPG,char_data/기/DSC02493.JPG_2.jpg,1792,480,640,32,421,453,372,428,True,53
기,62,kaist_dataset/Mixed/Digital_Camera/(C.S)C-outdoor2/DSC02533.JPG,char_data/기/DSC02533.JPG_2.jpg,3472,480,640,56,43,99,111,173,True,53
기,69,kaist_dataset/Mixed/Digital_Camera/(C.S)C-outdoor3/DSC02989.JPG,char_data/기/DSC02989.JPG_2.jpg,2346,480,640,34,119,153,327,396,True,53
기,40,kaist_dataset/Mixed/Digital_Camera/(C.S)C-outdoor3/DSC03055.JPG,char_data/기/DSC03055.JPG_2.jpg,1280,480,640,32,317,349,219,259,True,53
기,62,kaist_dataset/Mixed/Digital_Camera/(C.S)C-outdoor3/DSC03273.JPG,char_data/기/DSC03273.JPG_2.jpg,3534,480,640,57,506,563,212,274,True,53
기,52,kaist_dataset/Mixed/Digital_Camera/(C.S)C-outdoor3/DSC03302.JPG,char_data/기/DSC03302.JPG_2.jpg,3120,480,640,60,244,304,61,113,True,53
기,81,kaist_dataset/Mixed/Digital_Camera/(C.S)C-outdoor3/DSC03329.JPG,char_data/기/DSC03329.JPG_2.jpg,5508,480,640,68,8,76,162,243,False,53
기,74,kaist_dataset/Mixed/Digital_Camera/(C.S)C-outdoor3/DSC03409.JPG,char_data/기/DSC03409.JPG_2.jpg,4958,480,640,67,125,192,31,105,False,53
기,67,kaist_dataset/Mixed/Digital_Camera/(C.S)C-outdoor4/DSC03433.JPG,char_data/기/DSC03433.JPG_4.jpg,4221,480,640,63,475,538,144,211,False,53
기,74,kaist_dataset/Mixed/Digital_Camera/(C.S)C-outdoor4/DSC03433.JPG,char_data/기/DSC03433.JPG_5.jpg,5032,480,640,68,475,543,223,297,False,53
기,97,kaist_dataset/Mixed/Digital_Camera/(C.S)C-outdoor4/DSC03633.JPG,char_data/기/DSC03633.JPG_2.jpg,6887,480,640,71,315,386,157,254,False,53
기,82,kaist_dataset/Mixed/Digital_Camera/(C.S)C-outdoor4/DSC03656.JPG,char_data/기/DSC03656.JPG_2.jpg,7298,480,640,89,141,230,326,408,False,53
기,55,kaist_dataset/Mixed/Digital_Camera/(C.S)C-outdoor4/DSC03662.JPG,char_data/기/DSC03662.JPG_2.jpg,1540,480,640,28,37,65,157,212,False,53
기,55,kaist_dataset/Mixed/Digital_Camera/(C.S)C-outdoor4/DSC03707.JPG,char_data/기/DSC03707.JPG_2.jpg,2200,480,640,40,220,260,218,273,False,53
기,66,kaist_dataset/Mixed/Digital_Camera/(C.S)C-outdoor4/DSC03745.JPG,char_data/기/DSC03745.JPG_8.jpg,5940,480,640,90,329,419,113,179,False,53
기,36,kaist_dataset/Mixed/Digital_Camera/(C.S)C-outdoor4/DSC03745.JPG,char_data/기/DSC03745.JPG_9.jpg,972,480,640,27,85,112,218,254,False,53
기,31,kaist_dataset/Mixed/Digital_Camera/(C.S)C-outdoor4/DSC03745.JPG,char_data/기/DSC03745.JPG_10.jpg,899,480,640,29,177,206,223,254,False,53
기,32,kaist_dataset/Mixed/Digital_Camera/(C.S)C-outdoor4/DSC03745.JPG,char_data/기/DSC03745.JPG_11.jpg,896,480,640,28,298,326,224,256,False,53
기,82,kaist_dataset/Mixed/Digital_Camera/(C.S)C-outdoor4/DSC03757.JPG,char_data/기/DSC03757.JPG_2.jpg,6232,480,640,76,266,342,218,300,False,53
기,58,kaist_dataset/Mixed/Digital_Camera/(C.S)C-outdoor4/DSC03773.JPG,char_data/기/DSC03773.JPG_2.jpg,2146,480,640,37,255,292,108,166,False,53
기,44,kaist_dataset/Mixed/Digital_Camera/(C.S)C-outdoor5/DSC03822.JPG,char_data/기/DSC03822.JPG_2.jpg,1496,480,640,34,462,496,101,145,False,53
기,62,kaist_dataset/Mixed/Digital_Camera/(C.S)C-outdoor5/DSC03823.JPG,char_data/기/DSC03823.JPG_2.jpg,2852,480,640,46,405,451,98,160,False,53
기,91,kaist_dataset/Mixed/Digital_Camera/(C.S)C-outdoor5/DSC03867.JPG,char_data/기/DSC03867.JPG_2.jpg,7462,480,640,82,293,375,59,150,False,53
기,65,kaist_dataset/Mixed/Digital_Camera/(C.S)C-outdoor5/DSC04059.JPG,char_data/기/DSC04059.JPG_2.jpg,4355,480,640,67,441,508,40,105,False,53
기,45,kaist_dataset/Mixed/Digital_Camera/(C.S)C-outdoor5/DSC04135.JPG,char_data/기/DSC04135.JPG_2.jpg,2340,480,640,52,280,332,382,427,False,53
기,73,kaist_dataset/Mixed/Digital_Camera/(C.S)C-outdoor5/DSC04149.JPG,char_data/기/DSC04149.JPG_2.jpg,4964,480,640,68,353,421,212,285,False,53
기,83,kaist_dataset/Mixed/Digital_Camera/(C.S)C-outdoor6/P1010069.JPG,char_data/기/P1010069.JPG_2.jpg,8632,480,640,104,531,635,231,314,False,53
기,33,kaist_dataset/Mixed/Digital_Camera/(C.S)C-outdoor6/P1010093.JPG,char_data/기/P1010093.JPG_2.jpg,891,480,640,27,350,377,242,275,False,53
기,47,kaist_dataset/Mixed/Digital_Camera/(C.S)C-outdoor6/P1010095.JPG,char_data/기/P1010095.JPG_2.jpg,1833,480,640,39,393,432,307,354,False,53
기,37,kaist_dataset/Mixed/Digital_Camera/(C.S)C-outdoor6/P1010097.JPG,char_data/기/P1010097.JPG_2.jpg,814,480,640,22,170,192,49,86,False,53
기,45,kaist_dataset/Mixed/Digital_Camera/(C.S)C-outdoor6/P1010098.JPG,char_data/기/P1010098.JPG_2.jpg,1080,480,640,24,163,187,435,479,False,53
기,96,kaist_dataset/Mixed/Digital_Camera/(C.S)D-indoor1/DSC02711.JPG,char_data/기/DSC02711.JPG_2.jpg,5760,480,640,60,377,437,240,336,False,53
기,107,kaist_dataset/Mixed/Digital_Camera/(C.S)D-indoor1/DSC02787.JPG,char_data/기/DSC02787.JPG_2.jpg,6420,480,640,60,46,106,257,364,False,53
기,43,kaist_dataset/Mixed/Digital_Camera/(C.S)D-indoor1/DSC02840.JPG,char_data/기/DSC02840.JPG_2.jpg,1419,480,640,33,264,297,369,412,False,53
기,67,kaist_dataset/Mixed/Digital_Camera/(C.S)D-indoor1/DSC03133.JPG,char_data/기/DSC03133.JPG_2.jpg,3618,480,640,54,353,407,219,286,False,53
기,85,kaist_dataset/Mixed/Digital_Camera/(C.S)D-indoor1/DSC04197.JPG,char_data/기/DSC04197.JPG_2.jpg,6460,480,640,76,505,581,215,300,False,53
기,94,kaist_dataset/Mixed/Digital_Camera/(C.S)D-indoor1/DSC04203.JPG,char_data/기/DSC04203.JPG_2.jpg,6862,480,640,73,529,602,162,256,False,53
기,68,kaist_dataset/Mixed/Digital_Camera/(C.S)E-night/P1010155.JPG,char_data/기/P1010155.JPG_2.jpg,5304,480,640,78,157,235,185,253,False,53
기,64,kaist_dataset/Mixed/Mobile_Phone/(C.M)B-indoor/P090831018.jpg,char_data/기/P090831018.jpg_2.jpg,5504,480,640,86,358,444,157,221,False,53
기,79,kaist_dataset/Mixed/Mobile_Phone/(C.M)B-indoor/P090831021.jpg,char_data/기/P090831021.jpg_2.jpg,5530,480,640,70,367,437,125,204,False,53
기,100,kaist_dataset/Mixed/Mobile_Phone/(C.M)B-indoor/P090831023.jpg,char_data/기/P090831023.jpg_2.jpg,10000,480,640,100,154,254,152,252,False,53
기,64,kaist_dataset/Mixed/Mobile_Phone/(C.M)C-bookCover/P090904004.jpg,char_data/기/P090904004.jpg_4.jpg,4224,480,640,66,555,621,52,116,False,53
기,39,kaist_dataset/Mixed/Mobile_Phone/(C.M)C-bookCover/P090904004.jpg,char_data/기/P090904004.jpg_5.jpg,1131,480,640,29,592,621,143,182,False,53
기,80,kaist_dataset/Mixed/Mobile_Phone/(C.M)C-bookCover/P090904005.jpg,char_data/기/P090904005.jpg_2.jpg,8400,480,640,105,518,623,288,368,False,53
P,80,kaist_dataset/English/Digital_Camera/(E.S)A-shadow/DSC02857.JPG,char_data/P/DSC02857.JPG_4.jpg,4640,480,640,58,389,447,198,278,True,26
P,90,kaist_dataset/English/Digital_Camera/(E.S)A-shadow/DSC03026.JPG,char_data/P/DSC03026.JPG_2.jpg,5670,480,640,63,368,431,123,213,True,26
P,63,kaist_dataset/English/Digital_Camera/(E.S)A-shadow/DSC03075.JPG,char_data/P/DSC03075.JPG_2.jpg,2961,480,640,47,78,125,342,405,True,26
P,40,kaist_dataset/English/Digital_Camera/(E.S)A-shadow/P1010044.JPG,char_data/P/P1010044.JPG_4.jpg,1200,480,640,30,276,306,358,398,True,26
P,38,kaist_dataset/English/Digital_Camera/(E.S)A-shadow/P1010044.JPG,char_data/P/P1010044.JPG_5.jpg,1026,480,640,27,378,405,356,394,True,26
P,116,kaist_dataset/English/Digital_Camera/(E.S)B-light/080116-0053.jpg,char_data/P/080116-0053.jpg_2.jpg,9396,600,800,81,422,503,217,333,True,26
P,191,kaist_dataset/English/Digital_Camera/(E.S)B-light/080116-0059.jpg,char_data/P/080116-0059.jpg_12.jpg,21774,1200,1600,114,1400,1514,104,295,True,26
P,239,kaist_dataset/English/Digital_Camera/(E.S)B-light/080116-0059.jpg,char_data/P/080116-0059.jpg_13.jpg,34416,1200,1600,144,441,585,490,729,True,26
P,29,kaist_dataset/English/Digital_Camera/(E.S)B-light/080116-0059.jpg,char_data/P/080116-0059.jpg_14.jpg,406,1200,1600,14,1088,1102,824,853,True,26
P,32,kaist_dataset/English/Digital_Camera/(E.S)B-light/080116-0059.jpg,char_data/P/080116-0059.jpg_15.jpg,512,1200,1600,16,662,678,768,800,True,26
P,30,kaist_dataset/English/Digital_Camera/(E.S)B-light/080116-0059.jpg,char_data/P/080116-0059.jpg_16.jpg,450,1200,1600,15,679,694,772,802,True,26
P,30,kaist_dataset/English/Digital_Camera/(E.S)B-light/080116-0059.jpg,char_data/P/080116-0059.jpg_17.jpg,630,1200,1600,21,1084,1105,768,798,True,26
P,22,kaist_dataset/English/Digital_Camera/(E.S)B-light/v.jpg,char_data/P/v.jpg_2.jpg,484,240,320,22,247,269,61,83,True,26
P,49,kaist_dataset/English/Digital_Camera/(E.S)C-outdoor1/001.jpg,char_data/P/001.jpg_4.jpg,1078,257,470,22,198,220,18,67,True,26
P,49,kaist_dataset/English/Digital_Camera/(E.S)C-outdoor1/001.jpg,char_data/P/001.jpg_5.jpg,1127,257,470,23,218,241,17,66,True,26
P,27,kaist_dataset/English/Digital_Camera/(E.S)C-outdoor1/056.JPG,char_data/P/056.JPG_4.jpg,324,480,640,12,256,268,238,265,True,26
P,76,kaist_dataset/English/Digital_Camera/(E.S)C-outdoor1/056.JPG,char_data/P/056.JPG_5.jpg,5396,480,640,71,81,152,160,236,True,26
P,48,kaist_dataset/English/Digital_Camera/(E.S)C-outdoor1/064.JPG,char_data/P/064.JPG_2.jpg,1728,480,640,36,140,176,184,232,True,26
P,72,kaist_dataset/English/Digital_Camera/(E.S)C-outdoor1/080118-0011.jpg,char_data/P/080118-0011.jpg_4.jpg,2952,1200,1600,41,813,854,938,1010,True,26
P,72,kaist_dataset/English/Digital_Camera/(E.S)C-outdoor1/080118-0011.jpg,char_data/P/080118-0011.jpg_5.jpg,3384,1200,1600,47,986,1033,930,1002,True,26
P,60,kaist_dataset/English/Digital_Camera/(E.S)C-outdoor1/080119-0012.jpg,char_data/P/080119-0012.jpg_2.jpg,1920,1200,1600,32,667,699,580,640,True,26
P,61,kaist_dataset/English/Digital_Camera/(E.S)C-outdoor1/1.jpg,char_data/P/1.jpg_2.jpg,4209,480,640,69,269,338,126,187,True,26
P,205,kaist_dataset/English/Digital_Camera/(E.S)C-outdoor1/2007-12-08-day-117.jpg,char_data/P/2007-12-08-day-117.jpg_2.jpg,31160,1200,1600,152,615,767,513,718,True,26
P,54,kaist_dataset/English/Digital_Camera/(E.S)C-outdoor1/6.jpg,char_data/P/6.jpg_2.jpg,2106,255,731,39,61,100,98,152,True,26
P,80,kaist_dataset/English/Digital_Camera/(E.S)C-outdoor1/DSC02398.JPG,char_data/P/DSC02398.JPG_2.jpg,4480,480,640,56,404,460,224,304,True,26
P,138,kaist_dataset/English/Digital_Camera/(E.S)C-outdoor1/DSC02406.JPG,char_data/P/DSC02406.JPG_2.jpg,15594,480,640,113,392,505,269,407,True,26
P,78,kaist_dataset/English/Digital_Camera/(E.S)C-outdoor1/DSC02408.JPG,char_data/P/DSC02408.JPG_2.jpg,5070,480,640,65,504,569,272,350,True,26
P,47,kaist_dataset/English/Digital_Camera/(E.S)C-outdoor1/DSC02427.JPG,char_data/P/DSC02427.JPG_2.jpg,1410,480,640,30,306,336,238,285,True,26
P,194,kaist_dataset/English/Digital_Camera/(E.S)C-outdoor1/DSC02475.JPG,char_data/P/DSC02475.JPG_2.jpg,23280,480,640,120,111,231,53,247,True,26
P,233,kaist_dataset/English/Digital_Camera/(E.S)C-outdoor1/DSC02868.JPG,char_data/P/DSC02868.JPG_2.jpg,34717,480,640,149,231,380,220,453,True,26
P,106,kaist_dataset/English/Digital_Camera/(E.S)C-outdoor2/DSC02984.JPG,char_data/P/DSC02984.JPG_2.jpg,7420,480,640,70,381,451,96,202,True,26
P,84,kaist_dataset/English/Digital_Camera/(E.S)C-outdoor2/DSC02993.JPG,char_data/P/DSC02993.JPG_2.jpg,4452,480,640,53,234,287,226,310,True,26
P,41,kaist_dataset/English/Digital_Camera/(E.S)C-outdoor2/DSC03053.JPG,char_data/P/DSC03053.JPG_2.jpg,1148,480,640,28,31,59,135,176,True,26
P,47,kaist_dataset/English/Digital_Camera/(E.S)C-outdoor2/DSC03161.JPG,char_data/P/DSC03161.JPG_4.jpg,1645,480,640,35,302,337,223,270,True,26
P,57,kaist_dataset/English/Digital_Camera/(E.S)C-outdoor2/DSC03161.JPG,char_data/P/DSC03161.JPG_5.jpg,1425,480,640,25,365,390,213,270,True,26
P,59,kaist_dataset/English/Digital_Camera/(E.S)C-outdoor2/DSC03166.JPG,char_data/P/DSC03166.JPG_2.jpg,2832,480,640,48,226,274,263,322,True,26
P,48,kaist_dataset/English/Digital_Camera/(E.S)C-outdoor2/DSC03203.JPG,char_data/P/DSC03203.JPG_2.jpg,1632,480,640,34,322,356,313,361,True,26
P,28,kaist_dataset/English/Digital_Camera/(E.S)C-outdoor2/DSC03208.JPG,char_data/P/DSC03208.JPG_2.jpg,588,480,640,21,171,192,168,196,True,26
P,67,kaist_dataset/English/Digital_Camera/(E.S)C-outdoor2/DSC03225.JPG,char_data/P/DSC03225.JPG_2.jpg,3216,480,640,48,165,213,49,116,True,26
P,54,kaist_dataset/English/Digital_Camera/(E.S)C-outdoor2/DSC03413.JPG,char_data/P/DSC03413.JPG_2.jpg,2484,480,640,46,479,525,209,263,True,26
P,60,kaist_dataset/English/Digital_Camera/(E.S)C-outdoor2/DSC03414.JPG,char_data/P/DSC03414.JPG_2.jpg,3300,480,640,55,257,312,353,413,True,26
P,54,kaist_dataset/English/Digital_Camera/(E.S)C-outdoor2/DSC03575.JPG,char_data/P/DSC03575.JPG_2.jpg,1836,480,640,34,340,374,261,315,True,26
P,58,kaist_dataset/English/Digital_Camera/(E.S)C-outdoor2/DSC03650.JPG,char_data/P/DSC03650.JPG_2.jpg,2320,480,640,40,68,108,203,261,True,26
P,100,kaist_dataset/English/Digital_Camera/(E.S)C-outdoor2/DSC03731.JPG,char_data/P/DSC03731.JPG_2.jpg,8700,480,640,87,56,143,18,118,True,26
P,75,kaist_dataset/English/Digital_Camera/(E.S)C-outdoor2/DSC04079.JPG,char_data/P/DSC04079.JPG_2.jpg,3525,480,640,47,50,97,262,337,True,26
P,60,kaist_dataset/English/Digital_Camera/(E.S)C-outdoor2/DSC04120.JPG,char_data/P/DSC04120.JPG_2.jpg,2040,480,640,34,531,565,138,198,True,26
P,164,kaist_dataset/English/Digital_Camera/(E.S)C-outdoor2/DSC04433.JPG,char_data/P/DSC04433.JPG_2.jpg,21320,480,640,130,38,168,102,266,True,26
P,58,kaist_dataset/English/Digital_Camera/(E.S)C-outdoor2/IMG_2481.JPG,char_data/P/IMG_2481.JPG_2.jpg,3016,480,640,52,247,299,194,252,True,26
P,179,kaist_dataset/English/Digital_Camera/(E.S)C-outdoor2/P1010024.JPG,char_data/P/P1010024.JPG_2.jpg,18974,480,640,106,145,251,208,387,True,26
P,68,kaist_dataset/English/Digital_Camera/(E.S)C-outdoor3/DSC03046.JPG,char_data/P/DSC03046.JPG_2.jpg,3672,480,640,54,528,582,120,188,True,26
P,39,kaist_dataset/English/Digital_Camera/(E.S)C-outdoor3/r.jpg,char_data/P/r.jpg_2.jpg,1443,240,320,37,35,72,47,86,True,26
P,45,kaist_dataset/English/Digital_Camera/(E.S)C-outdoor3/s.jpg,char_data/P/s.jpg_2.jpg,1845,240,320,41,61,102,81,126,True,26
P,79,kaist_dataset/English/Digital_Camera/(E.S)C-outdoor3/크기변환_%B0%A3%C6%C71_fabdent.jpg,char_data/P/크기변환_%B0%A3%C6%C71_fabdent.jpg_4.jpg,4582,480,640,58,32,90,236,315,True,26
P,73,kaist_dataset/English/Digital_Camera/(E.S)C-outdoor3/크기변환_%B0%A3%C6%C71_fabdent.jpg,char_data/P/크기변환_%B0%A3%C6%C71_fabdent.jpg_5.jpg,4161,480,640,57,290,347,231,304,True,26
P,149,kaist_dataset/English/Digital_Camera/(E.S)D-indoor/DSC02842.JPG,char_data/P/DSC02842.JPG_2.jpg,18327,480,640,123,353,476,148,297,True,26
P,64,kaist_dataset/English/Digital_Camera/(E.S)D-indoor/DSC02854.JPG,char_data/P/DSC02854.JPG_2.jpg,3072,480,640,48,345,393,142,206,True,26
P,62,kaist_dataset/English/Digital_Camera/(E.S)D-indoor/DSC03078.JPG,char_data/P/DSC03078.JPG_4.jpg,2976,480,640,48,60,108,220,282,True,26
P,104,kaist_dataset/English/Digital_Camera/(E.S)D-indoor/DSC03080.JPG,char_data/P/DSC03080.JPG_4.jpg,7800,480,640,75,58,133,341,445,True,26
P,89,kaist_dataset/English/Digital_Camera/(E.S)D-indoor/DSC03093.JPG,char_data/P/DSC03093.JPG_2.jpg,5429,480,640,61,217,278,107,196,True,26
P,77,kaist_dataset/English/Digital_Camera/(E.S)D-indoor/DSC03881.JPG,char_data/P/DSC03881.JPG_4.jpg,4081,480,640,53,255,308,295,372,True,26
P,59,kaist_dataset/English/Digital_Camera/(E.S)D-indoor/DSC03881.JPG,char_data/P/DSC03881.JPG_5.jpg,2596,480,640,44,357,401,310,369,True,26
P,92,kaist_dataset/English/Digital_Camera/(E.S)D-indoor/DSC03896.JPG,char_data/P/DSC03896.JPG_4.jpg,4232,480,640,46,145,191,227,319,True,26
P,39,kaist_dataset/English/Digital_Camera/(E.S)D-indoor/DSC03896.JPG,char_data/P/DSC03896.JPG_5.jpg,1014,480,640,26,391,417,355,394,True,26
P,35,kaist_dataset/English/Digital_Camera/(E.S)D-indoor/DSC03901.JPG,char_data/P/DSC03901.JPG_4.jpg,665,480,640,19,329,348,262,297,True,26
P,77,kaist_dataset/English/Digital_Camera/(E.S)D-indoor/DSC03901.JPG,char_data/P/DSC03901.JPG_5.jpg,4004,480,640,52,72,124,160,237,True,26
P,104,kaist_dataset/English/Digital_Camera/(E.S)D-indoor/DSC03911.JPG,char_data/P/DSC03911.JPG_2.jpg,5512,480,640,53,520,573,320,424,True,26
P,69,kaist_dataset/English/Digital_Camera/(E.S)D-indoor/DSC03941.JPG,char_data/P/DSC03941.JPG_4.jpg,2760,480,640,40,178,218,220,289,True,26
P,74,kaist_dataset/English/Digital_Camera/(E.S)D-indoor/DSC03941.JPG,char_data/P/DSC03941.JPG_5.jpg,3626,480,640,49,338,387,233,307,True,26
P,46,kaist_dataset/English/Digital_Camera/(E.S)D-indoor/DSC03942.JPG,char_data/P/DSC03942.JPG_2.jpg,1748,480,640,38,575,613,381,427,True,26
P,71,kaist_dataset/English/Digital_Camera/(E.S)D-indoor/DSC03943.JPG,char_data/P/DSC03943.JPG_2.jpg,3692,480,640,52,336,388,212,283,True,26
P,15,kaist_dataset/English/Digital_Camera/(E.S)E-night/111.jpg,char_data/P/111.jpg_2.jpg,195,480,640,13,217,230,286,301,True,26
P,108,kaist_dataset/English/Digital_Camera/(E.S)E-night/DSC02674.JPG,char_data/P/DSC02674.JPG_2.jpg,9180,480,640,85,229,314,199,307,True,26
P,109,kaist_dataset/English/Digital_Camera/(E.S)E-night/크기변환_%BA%F7%BD%BA%BD%C5%B8%DE%B4%BA_01_tjtjdska2008.jpg,char_data/P/크기변환_%BA%F7%BD%BA%BD%C5%B8%DE%B4%BA_01_tjtjdska2008.jpg_2.jpg,6649,480,640,61,313,374,153,262,True,26
P,108,kaist_dataset/English/Digital_Camera/(E.S)F-others/080116-0058.jpg,char_data/P/080116-0058.jpg_4.jpg,4644,1200,1600,43,1093,1136,520,628,True,26
P,156,kaist_dataset/English/Digital_Camera/(E.S)F-others/080116-0058.jpg,char_data/P/080116-0058.jpg_5.jpg,7176,1200,1600,46,782,828,717,873,True,26
P,60,kaist_dataset/English/Digital_Camera/(E.S)F-others/080119-0007.jpg,char_data/P/080119-0007.jpg_2.jpg,2940,1200,1600,49,715,764,843,903,True,26
P,93,kaist_dataset/English/Digital_Camera/(E.S)F-others/DSC03291.JPG,char_data/P/DSC03291.JPG_4.jpg,3999,480,640,43,239,282,176,269,True,26
P,92,kaist_dataset/English/Digital_Camera/(E.S)F-others/DSC03291.JPG,char_data/P/DSC03291.JPG_5.jpg,4232,480,640,46,281,327,184,276,True,26
P,101,kaist_dataset/English/Digital_Camera/(E.S)F-others/크기변환_%B0%A3%C6%C72_ktimt007.jpg,char_data/P/크기변환_%B0%A3%C6%C72_ktimt007.jpg_2.jpg,5252,480,640,52,34,86,230,331,True,26
P,122,kaist_dataset/English/Mobile_Phone/(E.M)A-outdoor/P090911064.jpg,char_data/P/P090911064.jpg_2.jpg,12932,480,640,106,206,312,132,254,True,26
P,178,kaist_dataset/English/Mobile_Phone/(E.M)B-indoor/P090903001.jpg,char_data/P/P090903001.jpg_4.jpg,25276,480,640,142,22,164,100,278,True,26
P,80,kaist_dataset/English/Mobile_Phone/(E.M)C-bookCover/P090831075.jpg,char_data/P/P090831075.jpg_2.jpg,4240,480,640,53,81,134,153,233,True,26
P,48,kaist_dataset/English/Mobile_Phone/(E.M)C-bookCover/P090903030.jpg,char_data/P/P090903030.jpg_2.jpg,1632,480,640,34,439,473,62,110,True,26
P,67,kaist_dataset/English/Mobile_Phone/(E.M)C-bookCover/P090903071.jpg,char_data/P/P090903071.jpg_2.jpg,3819,480,640,57,102,159,221,288,True,26
P,174,kaist_dataset/English/Mobile_Phone/(E.M)C-bookCover/P090903081.jpg,char_data/P/P090903081.jpg_2.jpg,18444,480,640,106,17,123,89,263,True,26
P,146,kaist_dataset/English/Mobile_Phone/(E.M)C-bookCover/P090903082.jpg,char_data/P/P090903082.jpg_4.jpg,17666,480,640,121,65,186,33,179,True,26
P,148,kaist_dataset/English/Mobile_Phone/(E.M)C-bookCover/P090903082.jpg,char_data/P/P090903082.jpg_5.jpg,13616,480,640,92,326,418,32,180,True,26
P,122,kaist_dataset/Korean/Digital_Camera/E-night/DSC02631.JPG,char_data/P/DSC02631.JPG_2.jpg,8784,480,640,72,358,430,199,321,True,26
P,48,kaist_dataset/Korean/Digital_Camera/G-others/080119-0005.jpg,char_data/P/080119-0005.jpg_6.jpg,1632,1600,1200,34,544,578,1144,1192,True,26
P,34,kaist_dataset/Korean/Digital_Camera/indoor2/DSC03564.JPG,char_data/P/DSC03564.JPG_2.jpg,646,480,640,19,220,239,409,443,True,26
P,79,kaist_dataset/Korean/Digital_Camera/outdoor2/080118-0018.jpg,char_data/P/080118-0018.jpg_2.jpg,7979,1200,1600,101,1105,1206,673,752,True,26
P,76,kaist_dataset/Korean/Digital_Camera/outdoor2/2007-12-08-day-101.jpg,char_data/P/2007-12-08-day-101.jpg_4.jpg,3724,1200,1600,49,828,877,372,448,True,26
P,29,kaist_dataset/Korean/Digital_Camera/outdoor2/2007-12-08-day-101.jpg,char_data/P/2007-12-08-day-101.jpg_5.jpg,493,1200,1600,17,237,254,1052,1081,True,26
P,23,kaist_dataset/Korean/Digital_Camera/outdoor2/2007-12-08-day-109.jpg,char_data/P/2007-12-08-day-109.jpg_2.jpg,276,1200,1600,12,153,165,830,853,True,26
P,52,kaist_dataset/Korean/Digital_Camera/outdoor2/2007-12-09-day-exterior-035.jpg,char_data/P/2007-12-09-day-exterior-035.jpg_2.jpg,1352,1200,1600,26,947,973,718,770,True,26
P,76,kaist_dataset/Korean/Digital_Camera/outdoor2/2007-12-09-day-exterior-068.jpg,char_data/P/2007-12-09-day-exterior-068.jpg_2.jpg,3724,1200,1600,49,584,633,937,1013,True,26
P,37,kaist_dataset/Mixed/Digital_Camera/(C.S)A-shadow/DSC02568.JPG,char_data/P/DSC02568.JPG_4.jpg,925,480,640,25,284,309,145,182,True,26
P,45,kaist_dataset/Mixed/Digital_Camera/(C.S)C-outdoor1/078.JPG,char_data/P/078.JPG_2.jpg,1890,480,640,42,291,333,45,90,True,26
P,52,kaist_dataset/Mixed/Digital_Camera/(C.S)C-outdoor1/080116-0084.jpg,char_data/P/080116-0084.jpg_2.jpg,1716,600,800,33,448,481,300,352,True,26
P,137,kaist_dataset/Mixed/Digital_Camera/(C.S)C-outdoor1/080119-0037.jpg,char_data/P/080119-0037.jpg_2.jpg,9316,1200,1600,68,583,651,861,998,True,26
P,30,kaist_dataset/Mixed/Digital_Camera/(C.S)C-outdoor1/090.JPG,char_data/P/090.JPG_2.jpg,600,480,640,20,442,462,362,392,True,26
P,23,kaist_dataset/Mixed/Digital_Camera/(C.S)C-outdoor1/114.jpg,char_data/P/114.jpg_2.jpg,506,480,640,22,144,166,365,388,True,26
P,20,kaist_dataset/Mixed/Digital_Camera/(C.S)C-outdoor1/135.JPG,char_data/P/135.JPG_2.jpg,380,480,640,19,262,281,199,219,True,26
P,65,kaist_dataset/Mixed/Digital_Camera/(C.S)C-outdoor1/2007-12-08-day-091.jpg,char_data/P/2007-12-08-day-091.jpg_2.jpg,2470,1200,1600,38,102,140,607,672,True,26
P,65,kaist_dataset/Mixed/Digital_Camera/(C.S)C-outdoor1/2007-12-09-day-exterior-004.jpg,char_data/P/2007-12-09-day-exterior-004.jpg_2.jpg,4485,1200,1600,69,319,388,662,727,True,26
P,23,kaist_dataset/Mixed/Digital_Camera/(C.S)C-outdoor1/DSC02319.JPG,char_data/P/DSC02319.JPG_2.jpg,506,480,640,22,78,100,275,298,True,26
P,146,kaist_dataset/Mixed/Digital_Camera/(C.S)C-outdoor2/DSC02365.JPG,char_data/P/DSC02365.JPG_2.jpg,23068,480,640,158,128,286,310,456,True,26
P,36,kaist_dataset/Mixed/Digital_Camera/(C.S)C-outdoor2/DSC02368.JPG,char_data/P/DSC02368.JPG_2.jpg,504,480,640,14,376,390,383,419,True,26
P,24,kaist_dataset/Mixed/Digital_Camera/(C.S)C-outdoor2/DSC02397.JPG,char_data/P/DSC02397.JPG_4.jpg,456,480,640,19,80,99,141,165,True,26
P,16,kaist_dataset/Mixed/Digital_Camera/(C.S)C-outdoor2/DSC02397.JPG,char_data/P/DSC02397.JPG_5.jpg,320,480,640,20,116,136,144,160,True,26
P,43,kaist_dataset/Mixed/Digital_Camera/(C.S)C-outdoor2/DSC02419.JPG,char_data/P/DSC02419.JPG_2.jpg,1376,480,640,32,1,32,201,244,True,26
P,81,kaist_dataset/Mixed/Digital_Camera/(C.S)C-outdoor2/DSC02436.JPG,char_data/P/DSC02436.JPG_2.jpg,4374,480,640,54,66,120,172,253,True,26
P,50,kaist_dataset/Mixed/Digital_Camera/(C.S)C-outdoor2/DSC02502.JPG,char_data/P/DSC02502.JPG_2.jpg,1850,480,640,37,72,109,87,137,True,26
P,178,kaist_dataset/Mixed/Digital_Camera/(C.S)C-outdoor2/DSC02505.JPG,char_data/P/DSC02505.JPG_2.jpg,27946,480,640,157,88,245,208,386,True,26
P,117,kaist_dataset/Mixed/Digital_Camera/(C.S)C-outdoor2/DSC02551.JPG,char_data/P/DSC02551.JPG_2.jpg,11115,480,640,95,318,413,273,390,True,26
P,37,kaist_dataset/Mixed/Digital_Camera/(C.S)C-outdoor2/DSC02568.JPG,char_data/P/DSC02568.JPG_5.jpg,925,480,640,25,284,309,145,182,True,26
P,35,kaist_dataset/Mixed/Digital_Camera/(C.S)C-outdoor2/DSC02864.JPG,char_data/P/DSC02864.JPG_2.jpg,840,480,640,24,469,493,261,296,True,26
P,37,kaist_dataset/Mixed/Digital_Camera/(C.S)C-outdoor2/DSC02867.JPG,char_data/P/DSC02867.JPG_2.jpg,1073,480,640,29,249,278,403,440,True,26
P,88,kaist_dataset/Mixed/Digital_Camera/(C.S)C-outdoor2/DSC02870.JPG,char_data/P/DSC02870.JPG_2.jpg,4488,480,640,51,319,370,274,362,True,26
P,41,kaist_dataset/Mixed/Digital_Camera/(C.S)C-outdoor2/DSC02872.JPG,char_data/P/DSC02872.JPG_2.jpg,902,480,640,22,247,269,222,263,True,26
P,39,kaist_dataset/Mixed/Digital_Camera/(C.S)C-outdoor2/DSC02910.JPG,char_data/P/DSC02910.JPG_4.jpg,1053,480,640,27,266,293,51,90,True,26
P,38,kaist_dataset/Mixed/Digital_Camera/(C.S)C-outdoor2/DSC02910.JPG,char_data/P/DSC02910.JPG_5.jpg,874,480,640,23,509,532,53,91,True,26
P,123,kaist_dataset/Mixed/Digital_Camera/(C.S)C-outdoor2/DSC02922.JPG,char_data/P/DSC02922.JPG_2.jpg,11685,480,640,95,257,352,86,209,True,26
P,48,kaist_dataset/Mixed/Digital_Camera/(C.S)C-outdoor2/DSC02924.JPG,char_data/P/DSC02924.JPG_2.jpg,1728,480,640,36,302,338,317,365,True,26
P,44,kaist_dataset/Mixed/Digital_Camera/(C.S)C-outdoor3/DSC02964.JPG,char_data/P/DSC02964.JPG_2.jpg,1144,480,640,26,593,619,105,149,True,26
P,41,kaist_dataset/Mixed/Digital_Camera/(C.S)C-outdoor3/DSC02989.JPG,char_data/P/DSC02989.JPG_4.jpg,1435,480,640,35,329,364,268,309,True,26
P,42,kaist_dataset/Mixed/Digital_Camera/(C.S)C-outdoor3/DSC02989.JPG,char_data/P/DSC02989.JPG_5.jpg,1176,480,640,28,600,628,273,315,True,26
P,96,kaist_dataset/Mixed/Digital_Camera/(C.S)C-outdoor3/DSC03015.JPG,char_data/P/DSC03015.JPG_2.jpg,6528,480,640,68,281,349,158,254,True,26
P,23,kaist_dataset/Mixed/Digital_Camera/(C.S)C-outdoor3/DSC03033.JPG,char_data/P/DSC03033.JPG_2.jpg,322,480,640,14,155,169,149,172,True,26
P,69,kaist_dataset/Mixed/Digital_Camera/(C.S)C-outdoor3/DSC03048.JPG,char_data/P/DSC03048.JPG_4.jpg,2277,480,640,33,295,328,134,203,True,26
P,70,kaist_dataset/Mixed/Digital_Camera/(C.S)C-outdoor3/DSC03048.JPG,char_data/P/DSC03048.JPG_5.jpg,2240,480,640,32,418,450,139,209,True,26
P,85,kaist_dataset/Mixed/Digital_Camera/(C.S)C-outdoor3/DSC03164.JPG,char_data/P/DSC03164.JPG_2.jpg,6205,480,640,73,74,147,79,164,True,26
P,126,kaist_dataset/Mixed/Digital_Camera/(C.S)C-outdoor3/DSC03179.JPG,char_data/P/DSC03179.JPG_2.jpg,12978,480,640,103,360,463,82,208,True,26
P,95,kaist_dataset/Mixed/Digital_Camera/(C.S)C-outdoor3/DSC03217.JPG,char_data/P/DSC03217.JPG_2.jpg,7315,480,640,77,346,423,234,329,True,26
P,98,kaist_dataset/Mixed/Digital_Camera/(C.S)C-outdoor3/DSC03247.JPG,char_data/P/DSC03247.JPG_2.jpg,6566,480,640,67,363,430,155,253,True,26
P,19,kaist_dataset/Mixed/Digital_Camera/(C.S)C-outdoor3/DSC03255.JPG,char_data/P/DSC03255.JPG_2.jpg,437,480,640,23,502,525,185,204,True,26
P,128,kaist_dataset/Mixed/Digital_Camera/(C.S)C-outdoor3/DSC03259.JPG,char_data/P/DSC03259.JPG_2.jpg,11264,480,640,88,264,352,69,197,True,26
P,74,kaist_dataset/Mixed/Digital_Camera/(C.S)C-outdoor3/DSC03274.JPG,char_data/P/DSC03274.JPG_2.jpg,5180,480,640,70,135,205,86,160,True,26
P,34,kaist_dataset/Mixed/Digital_Camera/(C.S)C-outdoor3/DSC03329.JPG,char_data/P/DSC03329.JPG_2.jpg,952,480,640,28,562,590,444,478,True,26
P,40,kaist_dataset/Mixed/Digital_Camera/(C.S)C-outdoor3/DSC03330.JPG,char_data/P/DSC03330.JPG_2.jpg,840,480,640,21,235,256,400,440,True,26
P,38,kaist_dataset/Mixed/Digital_Camera/(C.S)C-outdoor3/DSC03331.JPG,char_data/P/DSC03331.JPG_2.jpg,760,480,640,20,225,245,379,417,True,26
P,55,kaist_dataset/Mixed/Digital_Camera/(C.S)C-outdoor3/DSC03429.JPG,char_data/P/DSC03429.JPG_2.jpg,2420,480,640,44,458,502,142,197,True,26
P,67,kaist_dataset/Mixed/Digital_Camera/(C.S)C-outdoor4/DSC03439.JPG,char_data/P/DSC03439.JPG_2.jpg,3551,480,640,53,108,161,349,416,True,26
P,156,kaist_dataset/Mixed/Digital_Camera/(C.S)C-outdoor4/DSC03519.JPG,char_data/P/DSC03519.JPG_2.jpg,18720,480,640,120,138,258,175,331,True,26
P,116,kaist_dataset/Mixed/Digital_Camera/(C.S)C-outdoor4/DSC03572.JPG,char_data/P/DSC03572.JPG_2.jpg,10556,480,640,91,63,154,96,212,True,26
P,74,kaist_dataset/Mixed/Digital_Camera/(C.S)C-outdoor4/DSC03581.JPG,char_data/P/DSC03581.JPG_2.jpg,4292,480,640,58,80,138,100,174,True,26
P,46,kaist_dataset/Mixed/Digital_Camera/(C.S)C-outdoor4/DSC03620.JPG,char_data/P/DSC03620.JPG_2.jpg,2208,480,640,48,501,549,90,136,True,26
P,126,kaist_dataset/Mixed/Digital_Camera/(C.S)C-outdoor4/DSC03628.JPG,char_data/P/DSC03628.JPG_2.jpg,10080,480,640,80,250,330,25,151,True,26
P,66,kaist_dataset/Mixed/Digital_Camera/(C.S)C-outdoor4/DSC03673.JPG,char_data/P/DSC03673.JPG_2.jpg,2574,480,640,39,252,291,176,242,True,26
P,36,kaist_dataset/Mixed/Digital_Camera/(C.S)C-outdoor4/DSC03679.JPG,char_data/P/DSC03679.JPG_2.jpg,900,480,640,25,200,225,105,141,False,26
P,32,kaist_dataset/Mixed/Digital_Camera/(C.S)C-outdoor4/DSC03716.JPG,char_data/P/DSC03716.JPG_2.jpg,384,480,640,12,400,412,237,269,False,26
P,90,kaist_dataset/Mixed/Digital_Camera/(C.S)C-outdoor4/DSC03730.JPG,char_data/P/DSC03730.JPG_2.jpg,5850,480,640,65,100,165,321,411,False,26
P,96,kaist_dataset/Mixed/Digital_Camera/(C.S)C-outdoor5/DSC03822.JPG,char_data/P/DSC03822.JPG_2.jpg,7776,480,640,81,39,120,71,167,False,26
P,58,kaist_dataset/Mixed/Digital_Camera/(C.S)C-outdoor5/DSC04059.JPG,char_data/P/DSC04059.JPG_2.jpg,1334,480,640,23,269,292,120,178,False,26
P,80,kaist_dataset/Mixed/Digital_Camera/(C.S)C-outdoor5/DSC04078.JPG,char_data/P/DSC04078.JPG_2.jpg,4240,480,640,53,414,467,281,361,False,26
P,45,kaist_dataset/Mixed/Digital_Camera/(C.S)C-outdoor5/DSC04098.JPG,char_data/P/DSC04098.JPG_2.jpg,1440,480,640,32,253,285,71,116,False,26
P,49,kaist_dataset/Mixed/Digital_Camera/(C.S)C-outdoor5/DSC04119.JPG,char_data/P/DSC04119.JPG_2.jpg,1666,480,640,34,582,616,145,194,False,26
P,234,kaist_dataset/Mixed/Digital_Camera/(C.S)C-outdoor5/DSC04444.JPG,char_data/P/DSC04444.JPG_2.jpg,36972,480,640,158,77,235,181,415,False,26
P,64,kaist_dataset/Mixed/Digital_Camera/(C.S)C-outdoor6/025.jpg,char_data/P/025.jpg_4.jpg,4928,293,472,77,10,87,75,139,False,26
P,83,kaist_dataset/Mixed/Digital_Camera/(C.S)C-outdoor6/025.jpg,char_data/P/025.jpg_5.jpg,4731,293,472,57,145,202,58,141,False,26
P,158,kaist_dataset/Mixed/Digital_Camera/(C.S)C-outdoor6/P1010052.JPG,char_data/P/P1010052.JPG_2.jpg,13430,480,640,85,365,450,181,339,False,26
P,26,kaist_dataset/Mixed/Digital_Camera/(C.S)C-outdoor6/P1010063.JPG,char_data/P/P1010063.JPG_2.jpg,312,480,640,12,304,316,402,428,False,26
P,39,kaist_dataset/Mixed/Digital_Camera/(C.S)D-indoor1/DSC03096.JPG,char_data/P/DSC03096.JPG_4.jpg,975,480,640,25,251,276,416,455,False,26
P,78,kaist_dataset/Mixed/Digital_Camera/(C.S)D-indoor1/DSC03460.JPG,char_data/P/DSC03460.JPG_2.jpg,2652,480,640,34,146,180,374,452,False,26
P,84,kaist_dataset/Mixed/Digital_Camera/(C.S)D-indoor1/DSC03472.JPG,char_data/P/DSC03472.JPG_2.jpg,3780,480,640,45,366,411,23,107,False,26
P,36,kaist_dataset/Mixed/Digital_Camera/(C.S)D-indoor1/DSC03904.JPG,char_data/P/DSC03904.JPG_2.jpg,576,480,640,16,312,328,214,250,False,26
P,71,kaist_dataset/Mixed/Digital_Camera/(C.S)D-indoor1/DSC03925.JPG,char_data/P/DSC03925.JPG_2.jpg,3408,480,640,48,304,352,382,453,False,26
P,46,kaist_dataset/Mixed/Digital_Camera/(C.S)D-indoor1/DSC03986.JPG,char_data/P/DSC03986.JPG_2.jpg,782,480,640,17,234,251,162,208,False,26
P,60,kaist_dataset/Mixed/Digital_Camera/(C.S)D-indoor1/DSC04019.JPG,char_data/P/DSC04019.JPG_2.jpg,1980,480,640,33,360,393,140,200,False,26
P,80,kaist_dataset/Mixed/Digital_Camera/(C.S)D-indoor2/DSC04443.JPG,char_data/P/DSC04443.JPG_2.jpg,4640,480,640,58,403,461,304,384,False,26
P,180,kaist_dataset/Mixed/Digital_Camera/(C.S)E-night/DSC02602.JPG,char_data/P/DSC02602.JPG_4.jpg,18900,480,640,105,210,315,120,300,False,26
P,175,kaist_dataset/Mixed/Digital_Camera/(C.S)E-night/DSC02602.JPG,char_data/P/DSC02602.JPG_5.jpg,18200,480,640,104,316,420,135,310,False,26
P,121,kaist_dataset/Mixed/Digital_Camera/(C.S)E-night/DSC02664.JPG,char_data/P/DSC02664.JPG_2.jpg,8712,480,640,72,399,471,117,238,False,26
P,34,kaist_dataset/Mixed/Digital_Camera/(C.S)E-night/DSC03031.JPG,char_data/P/DSC03031.JPG_2.jpg,680,480,640,20,137,157,22,56,False,26
P,54,kaist_dataset/Mixed/Digital_Camera/(C.S)E-night/DSC03514.JPG,char_data/P/DSC03514.JPG_2.jpg,2700,480,640,50,366,416,211,265,False,26
P,28,kaist_dataset/Mixed/Digital_Camera/(C.S)E-night/DSC03516.JPG,char_data/P/DSC03516.JPG_2.jpg,896,480,640,32,59,91,129,157,False,26
P,48,kaist_dataset/Mixed/Digital_Camera/(C.S)E-night/DSC03517.JPG,char_data/P/DSC03517.JPG_2.jpg,1104,480,640,23,192,215,83,131,False,26
P,47,kaist_dataset/Mixed/Digital_Camera/(C.S)F-others/047.jpg,char_data/P/047.jpg_2.jpg,1128,252,339,24,222,246,121,168,False,26
P,27,kaist_dataset/Mixed/Digital_Camera/(C.S)F-others/097.jpg,char_data/P/097.jpg_2.jpg,351,480,640,13,185,198,165,192,False,26
P,72,kaist_dataset/Mixed/Digital_Camera/(C.S)F-others/2007-12-08-day-113.jpg,char_data/P/2007-12-08-day-113.jpg_2.jpg,3384,1200,1600,47,910,957,658,730,False,26
P,129,kaist_dataset/Mixed/Digital_Camera/(C.S)F-others/DSC02881.JPG,char_data/P/DSC02881.JPG_8.jpg,19995,480,640,155,188,343,110,239,False,26
P,72,kaist_dataset/Mixed/Digital_Camera/(C.S)F-others/DSC02881.JPG,char_data/P/DSC02881.JPG_9.jpg,5976,480,640,83,136,219,329,401,False,26
P,70,kaist_dataset/Mixed/Digital_Camera/(C.S)F-others/DSC02881.JPG,char_data/P/DSC02881.JPG_10.jpg,4410,480,640,63,233,296,315,385,False,26
P,69,kaist_dataset/Mixed/Digital_Camera/(C.S)F-others/DSC02881.JPG,char_data/P/DSC02881.JPG_11.jpg,6003,480,640,87,503,590,255,324,False,26
P,101,kaist_dataset/Mixed/Digital_Camera/(C.S)F-others/DSC03489.JPG,char_data/P/DSC03489.JPG_2.jpg,7171,480,640,71,263,334,318,419,False,26
P,35,kaist_dataset/Mixed/Mobile_Phone/(C.M)A-outdoor/P090912038.jpg,char_data/P/P090912038.jpg_2.jpg,875,480,640,25,239,264,161,196,False,26
P,103,kaist_dataset/Mixed/Mobile_Phone/(C.M)C-bookCover/P090905002.jpg,char_data/P/P090905002.jpg_2.jpg,9167,480,640,89,41,130,26,129,False,26
점,33,kaist_dataset/English/Digital_Camera/(E.S)C-outdoor1/109.jpg,char_data/점/109.jpg_2.jpg,924,480,640,28,47,75,245,278,True,80
점,41,kaist_dataset/English/Digital_Camera/(E.S)C-outdoor1/2007-12-09-day-exterior-063.jpg,char_data/점/2007-12-09-day-exterior-063.jpg_2.jpg,1271,1200,1600,31,1099,1130,628,669,True,80
점,61,kaist_dataset/Korean/Digital_Camera/A-shadow/2007-12-09-day-exterior-025.jpg,char_data/점/2007-12-09-day-exterior-025.jpg_2.jpg,3477,1200,1600,57,199,256,833,894,True,80
점,34,kaist_dataset/Korean/Digital_Camera/A-shadow/DSC02598.JPG,char_data/점/DSC02598.JPG_4.jpg,850,480,640,25,473,498,416,450,True,80
점,22,kaist_dataset/Korean/Digital_Camera/E-night/106.jpg,char_data/점/106.jpg_2.jpg,462,480,640,21,525,546,330,352,True,80
점,69,kaist_dataset/Korean/Digital_Camera/E-night/DSC02594.JPG,char_data/점/DSC02594.JPG_2.jpg,4623,480,640,67,392,459,296,365,True,80
점,100,kaist_dataset/Korean/Digital_Camera/E-night/DSC02596.JPG,char_data/점/DSC02596.JPG_2.jpg,9100,480,640,91,530,621,250,350,True,80
점,57,kaist_dataset/Korean/Digital_Camera/E-night/DSC02597.JPG,char_data/점/DSC02597.JPG_4.jpg,2166,480,640,38,330,368,287,344,True,80
점,54,kaist_dataset/Korean/Digital_Camera/E-night/DSC02597.JPG,char_data/점/DSC02597.JPG_5.jpg,2754,480,640,51,532,583,27,81,True,80
점,32,kaist_dataset/Korean/Digital_Camera/E-night/DSC02626.JPG,char_data/점/DSC02626.JPG_2.jpg,1280,480,640,40,575,615,128,160,True,80
점,45,kaist_dataset/Korean/Digital_Camera/E-night/DSC02645.JPG,char_data/점/DSC02645.JPG_2.jpg,1350,480,640,30,261,291,336,381,True,80
점,31,kaist_dataset/Korean/Digital_Camera/E-night/DSC03850.JPG,char_data/점/DSC03850.JPG_2.jpg,899,480,640,29,366,395,391,422,True,80
점,68,kaist_dataset/Korean/Digital_Camera/E-night/사진14.jpg 수정.jpg,char_data/점/사진14.jpg 수정.jpg_2.jpg,3672,300,400,54,222,276,156,224,True,80
점,61,kaist_dataset/Korean/Digital_Camera/G-others/2007-12-08-day-045.jpg,char_data/점/2007-12-08-day-045.jpg_2.jpg,2745,1200,1600,45,1307,1352,700,761,True,80
점,34,kaist_dataset/Korean/Digital_Camera/G-others/DSC03863.JPG,char_data/점/DSC03863.JPG_2.jpg,1326,480,640,39,334,373,447,479,True,80
점,65,kaist_dataset/Korean/Digital_Camera/indoor1/DSC02716.JPG,char_data/점/DSC02716.JPG_2.jpg,3705,480,640,57,381,438,208,273,True,80
점,43,kaist_dataset/Korean/Digital_Camera/indoor1/DSC02729.JPG,char_data/점/DSC02729.JPG_2.jpg,1591,480,640,37,380,417,250,293,True,80
점,51,kaist_dataset/Korean/Digital_Camera/indoor2/DSC04204.JPG,char_data/점/DSC04204.JPG_2.jpg,1836,480,640,36,280,316,276,327,True,80
점,22,kaist_dataset/Korean/Digital_Camera/outdoor1/011.JPG,char_data/점/011.JPG_2.jpg,506,480,640,23,203,226,258,280,True,80
점,21,kaist_dataset/Korean/Digital_Camera/outdoor1/015.JPG,char_data/점/015.JPG_2.jpg,273,480,640,13,560,573,264,285,True,80
점,46,kaist_dataset/Korean/Digital_Camera/outdoor1/016.JPG,char_data/점/016.JPG_2.jpg,2530,480,640,55,201,256,195,241,True,80
점,36,kaist_dataset/Korean/Digital_Camera/outdoor1/018.JPG,char_data/점/018.JPG_2.jpg,972,480,640,27,172,199,182,218,True,80
점,33,kaist_dataset/Korean/Digital_Camera/outdoor1/023.JPG,char_data/점/023.JPG_2.jpg,1320,480,640,40,424,464,264,297,True,80
점,29,kaist_dataset/Korean/Digital_Camera/outdoor1/026.jpg,char_data/점/026.jpg_2.jpg,609,480,640,21,446,467,260,289,True,80
점,33,kaist_dataset/Korean/Digital_Camera/outdoor1/033.JPG,char_data/점/033.JPG_2.jpg,1254,480,640,38,577,615,198,231,True,80
점,87,kaist_dataset/Korean/Digital_Camera/outdoor1/039.JPG,char_data/점/039.JPG_2.jpg,5829,480,640,67,558,625,211,298,True,80
점,31,kaist_dataset/Korean/Digital_Camera/outdoor1/045.JPG,char_data/점/045.JPG_2.jpg,899,480,640,29,454,483,259,290,True,80
점,31,kaist_dataset/Korean/Digital_Camera/outdoor1/052.JPG,char_data/점/052.JPG_2.jpg,465,480,640,15,536,551,330,361,True,80
점,36,kaist_dataset/Korean/Digital_Camera/outdoor1/057.JPG,char_data/점/057.JPG_2.jpg,1008,480,640,28,471,499,302,338,True,80
점,83,kaist_dataset/Korean/Digital_Camera/outdoor1/124.JPG,char_data/점/124.JPG_2.jpg,7138,480,640,86,544,630,160,243,True,80
점,22,kaist_dataset/Korean/Digital_Camera/outdoor1/2007-12-08-day-047.jpg,char_data/점/2007-12-08-day-047.jpg_2.jpg,528,1200,1600,24,544,568,889,911,True,80
점,58,kaist_dataset/Korean/Digital_Camera/outdoor1/2007-12-08-day-050.jpg,char_data/점/2007-12-08-day-050.jpg_2.jpg,3132,1200,1600,54,1193,1247,726,784,True,80
점,32,kaist_dataset/Korean/Digital_Camera/outdoor1/2007-12-08-day-056.jpg,char_data/점/2007-12-08-day-056.jpg_2.jpg,960,1200,1600,30,463,493,806,838,True,80
점,34,kaist_dataset/Korean/Digital_Camera/outdoor1/2007-12-08-day-087.jpg,char_data/점/2007-12-08-day-087.jpg_2.jpg,1190,1200,1600,35,149,184,460,494,True,80
점,33,kaist_dataset/Korean/Digital_Camera/outdoor1/39.jpg,char_data/점/39.jpg_2.jpg,924,197,320,28,233,261,38,71,True,80
점,43,kaist_dataset/Korean/Digital_Camera/outdoor1/45.jpg,char_data/점/45.jpg_2.jpg,1376,253,373,32,308,340,81,124,True,80
점,54,kaist_dataset/Korean/Digital_Camera/outdoor2/2007-12-08-day-101.jpg,char_data/점/2007-12-08-day-101.jpg_4.jpg,1782,1200,1600,33,688,721,641,695,True,80
점,41,kaist_dataset/Korean/Digital_Camera/outdoor2/2007-12-08-day-101.jpg,char_data/점/2007-12-08-day-101.jpg_5.jpg,861,1200,1600,21,1017,1038,743,784,True,80
점,54,kaist_dataset/Korean/Digital_Camera/outdoor2/2007-12-09-day-exterior-007.jpg,char_data/점/2007-12-09-day-exterior-007.jpg_2.jpg,1890,1200,1600,35,114,149,327,381,True,80
점,56,kaist_dataset/Korean/Digital_Camera/outdoor2/2007-12-09-day-exterior-008.jpg,char_data/점/2007-12-09-day-exterior-008.jpg_4.jpg,3640,1200,1600,65,1536,1599,526,582,True,80
점,120,kaist_dataset/Korean/Digital_Camera/outdoor2/2007-12-09-day-exterior-008.jpg,char_data/점/2007-12-09-day-exterior-008.jpg_5.jpg,16320,1200,1600,136,837,973,538,658,True,80
점,75,kaist_dataset/Korean/Digital_Camera/outdoor2/2007-12-09-day-exterior-036.jpg,char_data/점/2007-12-09-day-exterior-036.jpg_4.jpg,2925,1200,1600,39,11,50,504,579,True,80
점,44,kaist_dataset/Korean/Digital_Camera/outdoor2/2007-12-09-day-exterior-036.jpg,char_data/점/2007-12-09-day-exterior-036.jpg_5.jpg,1760,1200,1600,40,1367,1407,629,673,True,80
점,34,kaist_dataset/Korean/Digital_Camera/outdoor2/DSC02311.JPG,char_data/점/DSC02311.JPG_2.jpg,782,480,640,23,409,432,254,288,True,80
점,119,kaist_dataset/Korean/Digital_Camera/outdoor2/DSC02326.JPG,char_data/점/DSC02326.JPG_2.jpg,8925,480,640,75,536,611,212,331,True,80
점,41,kaist_dataset/Korean/Digital_Camera/outdoor2/DSC02366.JPG,char_data/점/DSC02366.JPG_4.jpg,1599,480,640,39,339,378,171,212,True,80
점,37,kaist_dataset/Korean/Digital_Camera/outdoor2/DSC02366.JPG,char_data/점/DSC02366.JPG_5.jpg,1073,480,640,29,246,275,409,446,True,80
점,93,kaist_dataset/Korean/Digital_Camera/outdoor2/DSC02380.JPG,char_data/점/DSC02380.JPG_2.jpg,9021,480,640,97,502,599,135,228,True,80
점,44,kaist_dataset/Korean/Digital_Camera/outdoor2/DSC02393.JPG,char_data/점/DSC02393.JPG_2.jpg,1100,480,640,25,416,441,304,348,True,80
점,46,kaist_dataset/Korean/Digital_Camera/outdoor2/DSC02426.JPG,char_data/점/DSC02426.JPG_2.jpg,1978,480,640,43,101,144,221,267,True,80
점,36,kaist_dataset/Korean/Digital_Camera/outdoor2/DSC02453.JPG,char_data/점/DSC02453.JPG_4.jpg,1008,480,640,28,609,637,242,278,True,80
점,100,kaist_dataset/Korean/Digital_Camera/outdoor2/DSC02453.JPG,char_data/점/DSC02453.JPG_5.jpg,8000,480,640,80,436,516,109,209,True,80
점,93,kaist_dataset/Korean/Digital_Camera/outdoor2/DSC02486.JPG,char_data/점/DSC02486.JPG_2.jpg,6510,480,640,70,46,116,122,215,True,80
점,43,kaist_dataset/Korean/Digital_Camera/outdoor3/DSC02546.JPG,char_data/점/DSC02546.JPG_2.jpg,1204,480,640,28,79,107,419,462,True,80
점,34,kaist_dataset/Korean/Digital_Camera/outdoor3/DSC02598.JPG,char_data/점/DSC02598.JPG_5.jpg,850,480,640,25,473,498,416,450,True,80
점,90,kaist_dataset/Korean/Digital_Camera/outdoor3/DSC02702.JPG,char_data/점/DSC02702.JPG_2.jpg,7020,480,640,78,511,589,354,444,True,80
점,67,kaist_dataset/Korean/Digital_Camera/outdoor3/DSC02891.JPG,char_data/점/DSC02891.JPG_2.jpg,3551,480,640,53,563,616,344,411,True,80
점,69,kaist_dataset/Korean/Digital_Camera/outdoor3/DSC02934.JPG,char_data/점/DSC02934.JPG_2.jpg,5037,480,640,73,428,501,134,203,True,80
점,47,kaist_dataset/Korean/Digital_Camera/outdoor3/DSC02941.JPG,char_data/점/DSC02941.JPG_2.jpg,1551,480,640,33,268,301,247,294,True,80
점,37,kaist_dataset/Korean/Digital_Camera/outdoor3/DSC02957.JPG,char_data/점/DSC02957.JPG_2.jpg,851,480,640,23,593,616,421,458,True,80
점,62,kaist_dataset/Korean/Digital_Camera/outdoor3/DSC03198.JPG,char_data/점/DSC03198.JPG_2.jpg,3844,480,640,62,262,324,131,193,True,80
점,64,kaist_dataset/Korean/Digital_Camera/outdoor3/DSC03220.JPG,char_data/점/DSC03220.JPG_4.jpg,4096,480,640,64,552,616,36,100,True,80
점,38,kaist_dataset/Korean/Digital_Camera/outdoor3/DSC03220.JPG,char_data/점/DSC03220.JPG_5.jpg,1216,480,640,32,583,615,191,229,True,80
점,77,kaist_dataset/Korean/Digital_Camera/outdoor3/DSC03251.JPG,char_data/점/DSC03251.JPG_2.jpg,4851,480,640,63,463,526,274,351,True,80
점,84,kaist_dataset/Korean/Digital_Camera/outdoor4/DSC03321.JPG,char_data/점/DSC03321.JPG_2.jpg,6048,480,640,72,443,515,103,187,True,80
점,55,kaist_dataset/Korean/Digital_Camera/outdoor4/DSC03443.JPG,char_data/점/DSC03443.JPG_2.jpg,1705,480,640,31,433,464,255,310,True,80
점,97,kaist_dataset/Korean/Digital_Camera/outdoor4/DSC03506.JPG,char_data/점/DSC03506.JPG_2.jpg,8148,480,640,84,70,154,43,140,True,80
점,40,kaist_dataset/Korean/Digital_Camera/outdoor5/DSC03692.JPG,char_data/점/DSC03692.JPG_2.jpg,840,480,640,21,345,366,181,221,True,80
점,66,kaist_dataset/Korean/Digital_Camera/outdoor5/DSC03736.JPG,char_data/점/DSC03736.JPG_2.jpg,3234,480,640,49,426,475,337,403,True,80
점,123,kaist_dataset/Korean/Digital_Camera/outdoor5/DSC03770.JPG,char_data/점/DSC03770.JPG_2.jpg,10209,480,640,83,530,613,287,410,True,80
점,49,kaist_dataset/Korean/Digital_Camera/outdoor5/DSC03779.JPG,char_data/점/DSC03779.JPG_2.jpg,1715,480,640,35,411,446,235,284,True,80
점,42,kaist_dataset/Korean/Digital_Camera/outdoor5/DSC03838.JPG,char_data/점/DSC03838.JPG_2.jpg,1764,480,640,42,359,401,140,182,True,80
점,53,kaist_dataset/Korean/Digital_Camera/outdoor5/DSC03996.JPG,char_data/점/DSC03996.JPG_2.jpg,2279,480,640,43,286,329,87,140,True,80
점,25,kaist_dataset/Korean/Digital_Camera/outdoor5/DSC04028.JPG,char_data/점/DSC04028.JPG_2.jpg,1050,480,640,42,462,504,248,273,True,80
점,51,kaist_dataset/Korean/Digital_Camera/outdoor5/DSC04040.JPG,char_data/점/DSC04040.JPG_4.jpg,3060,480,640,60,333,393,126,177,True,80
점,121,kaist_dataset/Korean/Digital_Camera/outdoor5/DSC04040.JPG,char_data/점/DSC04040.JPG_5.jpg,11616,480,640,96,532,628,221,342,True,80
점,32,kaist_dataset/Korean/Digital_Camera/outdoor6/DSC04041.JPG,char_data/점/DSC04041.JPG_2.jpg,992,480,640,31,366,397,139,171,True,80
점,81,kaist_dataset/Korean/Digital_Camera/outdoor6/DSC04085.JPG,char_data/점/DSC04085.JPG_2.jpg,6237,480,640,77,429,506,244,325,True,80
점,52,kaist_dataset/Korean/Digital_Camera/outdoor6/DSC04110.JPG,char_data/점/DSC04110.JPG_2.jpg,2080,480,640,40,504,544,165,217,True,80
점,43,kaist_dataset/Korean/Digital_Camera/outdoor6/DSC04339.JPG,char_data/점/DSC04339.JPG_2.jpg,1634,480,640,38,233,271,208,251,True,80
점,175,kaist_dataset/Korean/Digital_Camera/outdoor6/DSC04372.JPG,char_data/점/DSC04372.JPG_2.jpg,31150,480,640,178,392,570,203,378,True,80
점,97,kaist_dataset/Korean/Digital_Camera/outdoor7/P1010023.JPG,char_data/점/P1010023.JPG_2.jpg,5432,480,640,56,459,515,178,275,True,80
점,29,kaist_dataset/Korean/Digital_Camera/outdoor7/P1010054.JPG,char_data/점/P1010054.JPG_2.jpg,841,480,640,29,444,473,231,260,True,80
점,83,kaist_dataset/Korean/Digital_Camera/outdoor7/P1010055.JPG,char_data/점/P1010055.JPG_2.jpg,7885,480,640,95,532,627,113,196,True,80
점,81,kaist_dataset/Korean/Digital_Camera/outdoor7/P1010072.JPG,char_data/점/P1010072.JPG_2.jpg,5103,480,640,63,543,606,116,197,True,80
점,33,kaist_dataset/Korean/Digital_Camera/outdoor7/P1010101.JPG,char_data/점/P1010101.JPG_2.jpg,1287,480,640,39,269,308,233,266,True,80
점,30,kaist_dataset/Korean/Digital_Camera/outdoor7/P1010107.JPG,char_data/점/P1010107.JPG_2.jpg,960,480,640,32,594,626,225,255,True,80
점,29,kaist_dataset/Korean/Digital_Camera/outdoor7/P1010121.JPG,char_data/점/P1010121.JPG_2.jpg,899,480,640,31,381,412,212,241,True,80
점,59,kaist_dataset/Korean/Digital_Camera/outdoor7/P1010126.JPG,char_data/점/P1010126.JPG_2.jpg,4484,480,640,76,372,448,159,218,True,80
점,31,kaist_dataset/Korean/Digital_Camera/outdoor7/P1010135.JPG,char_data/점/P1010135.JPG_2.jpg,1302,480,640,42,488,530,88,119,True,80
점,50,kaist_dataset/Korean/Digital_Camera/outdoor7/P1010138.JPG,char_data/점/P1010138.JPG_4.jpg,2500,480,640,50,516,566,219,269,True,80
점,32,kaist_dataset/Korean/Digital_Camera/outdoor7/P1010138.JPG,char_data/점/P1010138.JPG_5.jpg,928,480,640,29,142,171,287,319,True,80
점,72,kaist_dataset/Korean/Digital_Camera/outdoor8/P090912069.jpg,char_data/점/P090912069.jpg_4.jpg,6912,480,640,96,478,574,117,189,True,80
점,35,kaist_dataset/Korean/Digital_Camera/outdoor8/P090912069.jpg,char_data/점/P090912069.jpg_5.jpg,1330,480,640,38,207,245,266,301,True,80
점,86,kaist_dataset/Korean/Digital_Camera/outdoor8/P1010142.JPG,char_data/점/P1010142.JPG_4.jpg,8686,480,640,101,510,611,168,254,True,80
점,38,kaist_dataset/Korean/Digital_Camera/outdoor8/P1010142.JPG,char_data/점/P1010142.JPG_5.jpg,1140,480,640,30,124,154,281,319,True,80
점,45,kaist_dataset/Korean/Digital_Camera/outdoor8/P1010143.JPG,char_data/점/P1010143.JPG_2.jpg,1800,480,640,40,260,300,257,302,True,80
점,38,kaist_dataset/Korean/Digital_Camera/outdoor8/P1010178.JPG,char_data/점/P1010178.JPG_2.jpg,1330,480,640,35,411,446,347,385,True,80
점,51,kaist_dataset/Korean/Digital_Camera/outdoor8/sharp2번_039.jpg,char_data/점/sharp2번_039.jpg_2.jpg,1734,240,320,34,278,312,103,154,True,80
점,95,kaist_dataset/Mixed/Digital_Camera/(C.S)A-shadow/DSC02581.JPG,char_data/점/DSC02581.JPG_2.jpg,9405,480,640,99,503,602,277,372,True,80
점,148,kaist_dataset/Mixed/Digital_Camera/(C.S)A-shadow/DSC03207.JPG,char_data/점/DSC03207.JPG_2.jpg,16872,480,640,114,142,256,39,187,True,80
점,62,kaist_dataset/Mixed/Digital_Camera/(C.S)C-outdoor1/014.JPG,char_data/점/014.JPG_4.jpg,2480,480,640,40,594,634,193,255,True,80
점,20,kaist_dataset/Mixed/Digital_Camera/(C.S)C-outdoor1/014.JPG,char_data/점/014.JPG_5.jpg,360,480,640,18,586,604,277,297,True,80
점,55,kaist_dataset/Mixed/Digital_Camera/(C.S)C-outdoor1/025.JPG,char_data/점/025.JPG_2.jpg,2200,480,640,40,507,547,84,139,True,80
점,27,kaist_dataset/Mixed/Digital_Camera/(C.S)C-outdoor1/027.JPG,char_data/점/027.JPG_2.jpg,594,480,640,22,356,378,273,300,True,80
점,23,kaist_dataset/Mixed/Digital_Camera/(C.S)C-outdoor1/048.JPG,char_data/점/048.JPG_4.jpg,368,480,640,16,154,170,155,178,True,80
점,17,kaist_dataset/Mixed/Digital_Camera/(C.S)C-outdoor1/048.JPG,char_data/점/048.JPG_5.jpg,323,480,640,19,572,591,263,280,True,80
점,35,kaist_dataset/Mixed/Digital_Camera/(C.S)C-outdoor1/081.JPG,char_data/점/081.JPG_2.jpg,1085,480,640,31,606,637,257,292,True,80
점,53,kaist_dataset/Mixed/Digital_Camera/(C.S)C-outdoor1/2007-12-08-day-130.jpg,char_data/점/2007-12-08-day-130.jpg_2.jpg,2650,1200,1600,50,249,299,739,792,True,80
점,38,kaist_dataset/Mixed/Digital_Camera/(C.S)C-outdoor1/2007-12-09-day-exterior-037.jpg,char_data/점/2007-12-09-day-exterior-037.jpg_4.jpg,1368,1200,1600,36,154,190,713,751,True,80
점,132,kaist_dataset/Mixed/Digital_Camera/(C.S)C-outdoor1/2007-12-09-day-exterior-037.jpg,char_data/점/2007-12-09-day-exterior-037.jpg_5.jpg,6732,1200,1600,51,652,703,264,396,True,80
점,35,kaist_dataset/Mixed/Digital_Camera/(C.S)C-outdoor1/2007-12-09-day-exterior-051.jpg,char_data/점/2007-12-09-day-exterior-051.jpg_2.jpg,700,1200,1600,20,425,445,829,864,True,80
점,20,kaist_dataset/Mixed/Digital_Camera/(C.S)C-outdoor1/47.JPG,char_data/점/47.JPG_2.jpg,220,576,768,11,689,700,473,493,True,80
점,36,kaist_dataset/Mixed/Digital_Camera/(C.S)C-outdoor1/8.jpg,char_data/점/8.jpg_2.jpg,1080,400,766,30,666,696,280,316,True,80
점,32,kaist_dataset/Mixed/Digital_Camera/(C.S)C-outdoor1/DSC02240.JPG,char_data/점/DSC02240.JPG_2.jpg,800,480,640,25,553,578,299,331,True,80
점,35,kaist_dataset/Mixed/Digital_Camera/(C.S)C-outdoor1/DSC02344.JPG,char_data/점/DSC02344.JPG_2.jpg,1085,480,640,31,435,466,253,288,True,80
점,47,kaist_dataset/Mixed/Digital_Camera/(C.S)C-outdoor2/DSC02376.JPG,char_data/점/DSC02376.JPG_4.jpg,1692,480,640,36,244,280,135,182,True,80
점,45,kaist_dataset/Mixed/Digital_Camera/(C.S)C-outdoor2/DSC02376.JPG,char_data/점/DSC02376.JPG_5.jpg,1530,480,640,34,326,360,335,380,True,80
점,40,kaist_dataset/Mixed/Digital_Camera/(C.S)C-outdoor2/DSC02391.JPG,char_data/점/DSC02391.JPG_2.jpg,1200,480,640,30,584,614,326,366,True,80
점,31,kaist_dataset/Mixed/Digital_Camera/(C.S)C-outdoor2/DSC02397.JPG,char_data/점/DSC02397.JPG_2.jpg,899,480,640,29,381,410,210,241,True,80
점,82,kaist_dataset/Mixed/Digital_Camera/(C.S)C-outdoor2/DSC02407.JPG,char_data/점/DSC02407.JPG_2.jpg,6314,480,640,77,497,574,69,151,True,80
점,37,kaist_dataset/Mixed/Digital_Camera/(C.S)C-outdoor2/DSC02411.JPG,char_data/점/DSC02411.JPG_2.jpg,1406,480,640,38,262,300,158,195,True,80
점,24,kaist_dataset/Mixed/Digital_Camera/(C.S)C-outdoor2/DSC02430.JPG,char_data/점/DSC02430.JPG_2.jpg,840,480,640,35,295,330,181,205,True,80
점,40,kaist_dataset/Mixed/Digital_Camera/(C.S)C-outdoor2/DSC02433.JPG,char_data/점/DSC02433.JPG_2.jpg,840,480,640,21,497,518,262,302,True,80
점,43,kaist_dataset/Mixed/Digital_Camera/(C.S)C-outdoor2/DSC02434.JPG,char_data/점/DSC02434.JPG_2.jpg,2451,480,640,57,533,590,305,348,True,80
점,34,kaist_dataset/Mixed/Digital_Camera/(C.S)C-outdoor2/DSC02490.JPG,char_data/점/DSC02490.JPG_2.jpg,1258,480,640,37,299,336,43,77,True,80
점,60,kaist_dataset/Mixed/Digital_Camera/(C.S)C-outdoor2/DSC02912.JPG,char_data/점/DSC02912.JPG_2.jpg,2580,480,640,43,468,511,59,119,True,80
점,36,kaist_dataset/Mixed/Digital_Camera/(C.S)C-outdoor2/DSC02917.JPG,char_data/점/DSC02917.JPG_2.jpg,828,480,640,23,512,535,222,258,True,80
점,31,kaist_dataset/Mixed/Digital_Camera/(C.S)C-outdoor2/DSC02936.JPG,char_data/점/DSC02936.JPG_2.jpg,682,480,640,22,459,481,226,257,True,80
점,54,kaist_dataset/Mixed/Digital_Camera/(C.S)C-outdoor2/DSC02937.JPG,char_data/점/DSC02937.JPG_2.jpg,2160,480,640,40,543,583,184,238,True,80
점,23,kaist_dataset/Mixed/Digital_Camera/(C.S)C-outdoor2/P1010015.JPG,char_data/점/P1010015.JPG_2.jpg,391,480,640,17,292,309,187,210,True,80
점,48,kaist_dataset/Mixed/Digital_Camera/(C.S)C-outdoor3/DSC03177.JPG,char_data/점/DSC03177.JPG_2.jpg,1776,480,640,37,479,516,203,251,True,80
점,44,kaist_dataset/Mixed/Digital_Camera/(C.S)C-outdoor3/DSC03196.JPG,char_data/점/DSC03196.JPG_2.jpg,1716,480,640,39,572,611,394,438,True,80
점,54,kaist_dataset/Mixed/Digital_Camera/(C.S)C-outdoor3/DSC03227.JPG,char_data/점/DSC03227.JPG_2.jpg,2538,480,640,47,417,464,393,447,True,80
점,32,kaist_dataset/Mixed/Digital_Camera/(C.S)C-outdoor3/DSC03236.JPG,char_data/점/DSC03236.JPG_2.jpg,800,480,640,25,590,615,432,464,True,80
점,46,kaist_dataset/Mixed/Digital_Camera/(C.S)C-outdoor3/DSC03249.JPG,char_data/점/DSC03249.JPG_2.jpg,1748,480,640,38,393,431,238,284,True,80
점,71,kaist_dataset/Mixed/Digital_Camera/(C.S)C-outdoor3/DSC03269.JPG,char_data/점/DSC03269.JPG_2.jpg,4615,480,640,65,326,391,352,423,True,80
점,51,kaist_dataset/Mixed/Digital_Camera/(C.S)C-outdoor3/DSC03283.JPG,char_data/점/DSC03283.JPG_2.jpg,1683,480,640,33,412,445,150,201,True,80
점,90,kaist_dataset/Mixed/Digital_Camera/(C.S)C-outdoor3/DSC03299.JPG,char_data/점/DSC03299.JPG_2.jpg,6750,480,640,75,514,589,278,368,True,80
점,40,kaist_dataset/Mixed/Digital_Camera/(C.S)C-outdoor3/DSC03309.JPG,char_data/점/DSC03309.JPG_2.jpg,1000,480,640,25,123,148,263,303,True,80
점,53,kaist_dataset/Mixed/Digital_Camera/(C.S)C-outdoor3/DSC03332.JPG,char_data/점/DSC03332.JPG_4.jpg,2809,480,640,53,525,578,100,153,True,80
점,64,kaist_dataset/Mixed/Digital_Camera/(C.S)C-outdoor3/DSC03332.JPG,char_data/점/DSC03332.JPG_5.jpg,4224,480,640,66,510,576,328,392,True,80
점,77,kaist_dataset/Mixed/Digital_Camera/(C.S)C-outdoor4/DSC03552.JPG,char_data/점/DSC03552.JPG_2.jpg,7469,480,640,97,531,628,246,323,True,80
점,41,kaist_dataset/Mixed/Digital_Camera/(C.S)C-outdoor4/DSC03634.JPG,char_data/점/DSC03634.JPG_2.jpg,2050,480,640,50,549,599,371,412,True,80
점,33,kaist_dataset/Mixed/Digital_Camera/(C.S)C-outdoor4/DSC03672.JPG,char_data/점/DSC03672.JPG_4.jpg,924,480,640,28,458,486,83,116,True,80
점,40,kaist_dataset/Mixed/Digital_Camera/(C.S)C-outdoor4/DSC03672.JPG,char_data/점/DSC03672.JPG_5.jpg,1400,480,640,35,351,386,122,162,False,80
점,26,kaist_dataset/Mixed/Digital_Camera/(C.S)C-outdoor4/DSC03674.JPG,char_data/점/DSC03674.JPG_2.jpg,468,480,640,18,466,484,423,449,False,80
점,32,kaist_dataset/Mixed/Digital_Camera/(C.S)C-outdoor4/DSC03687.JPG,char_data/점/DSC03687.JPG_2.jpg,672,480,640,21,220,241,398,430,False,80
점,39,kaist_dataset/Mixed/Digital_Camera/(C.S)C-outdoor4/DSC03691.JPG,char_data/점/DSC03691.JPG_2.jpg,1443,480,640,37,291,328,223,262,False,80
점,36,kaist_dataset/Mixed/Digital_Camera/(C.S)C-outdoor4/DSC03735.JPG,char_data/점/DSC03735.JPG_2.jpg,720,480,640,20,350,370,194,230,False,80
점,28,kaist_dataset/Mixed/Digital_Camera/(C.S)C-outdoor5/DSC03822.JPG,char_data/점/DSC03822.JPG_2.jpg,476,480,640,17,578,595,150,178,False,80
점,37,kaist_dataset/Mixed/Digital_Camera/(C.S)C-outdoor5/DSC03823.JPG,char_data/점/DSC03823.JPG_2.jpg,1110,480,640,30,566,596,167,204,False,80
점,71,kaist_dataset/Mixed/Digital_Camera/(C.S)C-outdoor5/DSC03830.JPG,char_data/점/DSC03830.JPG_2.jpg,2982,480,640,42,579,621,26,97,False,80
점,35,kaist_dataset/Mixed/Digital_Camera/(C.S)C-outdoor5/DSC04056.JPG,char_data/점/DSC04056.JPG_4.jpg,1050,480,640,30,371,401,260,295,False,80
점,84,kaist_dataset/Mixed/Digital_Camera/(C.S)C-outdoor5/DSC04056.JPG,char_data/점/DSC04056.JPG_5.jpg,5796,480,640,69,534,603,332,416,False,80
점,59,kaist_dataset/Mixed/Digital_Camera/(C.S)C-outdoor5/DSC04111.JPG,char_data/점/DSC04111.JPG_2.jpg,2124,480,640,36,271,307,116,175,False,80
점,35,kaist_dataset/Mixed/Digital_Camera/(C.S)C-outdoor5/DSC04124.JPG,char_data/점/DSC04124.JPG_2.jpg,945,480,640,27,185,212,146,181,False,80
점,53,kaist_dataset/Mixed/Digital_Camera/(C.S)C-outdoor5/DSC04125.JPG,char_data/점/DSC04125.JPG_2.jpg,2120,480,640,40,376,416,410,463,False,80
점,76,kaist_dataset/Mixed/Digital_Camera/(C.S)C-outdoor5/P1010007.JPG,char_data/점/P1010007.JPG_2.jpg,4712,480,640,62,332,394,363,439,False,80
점,22,kaist_dataset/Mixed/Digital_Camera/(C.S)C-outdoor6/117.JPG,char_data/점/117.JPG_2.jpg,418,480,640,19,197,216,165,187,False,80
점,35,kaist_dataset/Mixed/Digital_Camera/(C.S)C-outdoor6/P1010073.JPG,char_data/점/P1010073.JPG_2.jpg,1050,480,640,30,185,215,235,270,False,80
점,30,kaist_dataset/Mixed/Digital_Camera/(C.S)C-outdoor6/P1010075.JPG,char_data/점/P1010075.JPG_4.jpg,660,480,640,22,362,384,310,340,False,80
점,35,kaist_dataset/Mixed/Digital_Camera/(C.S)C-outdoor6/P1010075.JPG,char_data/점/P1010075.JPG_5.jpg,735,480,640,21,520,541,131,166,False,80
점,55,kaist_dataset/Mixed/Digital_Camera/(C.S)C-outdoor6/P1010114.JPG,char_data/점/P1010114.JPG_2.jpg,3520,480,640,64,461,525,8,63,False,80
점,64,kaist_dataset/Mixed/Digital_Camera/(C.S)D-indoor1/DSC02733.JPG,char_data/점/DSC02733.JPG_2.jpg,2560,480,640,40,352,392,59,123,False,80
점,134,kaist_dataset/Mixed/Digital_Camera/(C.S)D-indoor1/DSC03460.JPG,char_data/점/DSC03460.JPG_2.jpg,19430,480,640,145,347,492,23,157,False,80
점,91,kaist_dataset/Mixed/Digital_Camera/(C.S)D-indoor2/DSC04443.JPG,char_data/점/DSC04443.JPG_2.jpg,5915,480,640,65,559,624,164,255,False,80
점,39,kaist_dataset/Mixed/Digital_Camera/(C.S)E-night/DSC02569.JPG,char_data/점/DSC02569.JPG_2.jpg,1560,480,640,40,441,481,366,405,False,80
점,114,kaist_dataset/Mixed/Digital_Camera/(C.S)E-night/DSC02571.JPG,char_data/점/DSC02571.JPG_2.jpg,7182,480,640,63,382,445,171,285,False,80
점,39,kaist_dataset/Mixed/Digital_Camera/(C.S)E-night/DSC02586.JPG,char_data/점/DSC02586.JPG_4.jpg,897,480,640,23,270,293,396,435,False,80
점,39,kaist_dataset/Mixed/Digital_Camera/(C.S)E-night/DSC02586.JPG,char_data/점/DSC02586.JPG_5.jpg,1404,480,640,36,413,449,166,205,False,80
점,58,kaist_dataset/Mixed/Digital_Camera/(C.S)E-night/DSC02602.JPG,char_data/점/DSC02602.JPG_2.jpg,3248,480,640,56,398,454,313,371,False,80
점,40,kaist_dataset/Mixed/Digital_Camera/(C.S)E-night/DSC02644.JPG,char_data/점/DSC02644.JPG_2.jpg,1040,480,640,26,223,249,397,437,False,80
점,35,kaist_dataset/Mixed/Digital_Camera/(C.S)E-night/DSC03561.JPG,char_data/점/DSC03561.JPG_2.jpg,1470,480,640,42,391,433,30,65,False,80
점,90,kaist_dataset/Mixed/Digital_Camera/(C.S)E-night/DSC03871.JPG,char_data/점/DSC03871.JPG_2.jpg,7200,480,640,80,506,586,106,196,False,80
점,71,kaist_dataset/Mixed/Digital_Camera/(C.S)E-night/P1010155.JPG,char_data/점/P1010155.JPG_2.jpg,5467,480,640,77,458,535,189,260,False,80
점,42,kaist_dataset/Mixed/Digital_Camera/(C.S)E-night/크기변환_P1010162.JPG,char_data/점/크기변환_P1010162.JPG_2.jpg,1722,480,640,41,546,587,157,199,False,80
점,31,kaist_dataset/Mixed/Digital_Camera/(C.S)F-others/085.jpg,char_data/점/085.jpg_2.jpg,403,480,640,13,445,458,235,266,False,80
점,37,kaist_dataset/Mixed/Digital_Camera/(C.S)F-others/097.jpg,char_data/점/097.jpg_2.jpg,1110,480,640,30,484,514,309,346,False,80
점,47,kaist_dataset/Mixed/Mobile_Phone/(C.M)A-outdoor/P090912038.jpg,char_data/점/P090912038.jpg_2.jpg,1551,480,640,33,148,181,152,199,False,80
점,66,kaist_dataset/Mixed/Mobile_Phone/(C.M)A-outdoor/P090912062.jpg,char_data/점/P090912062.jpg_2.jpg,4224,480,640,64,510,574,3,69,False,80
점,94,kaist_dataset/Mixed/Mobile_Phone/(C.M)C-bookCover/P090831062.jpg,char_data/점/P090831062.jpg_2.jpg,6956,480,640,74,476,550,354,448,False,80
H,51,kaist_dataset/English/Digital_Camera/(E.S)A-shadow/DSC02423.JPG,char_data/H/DSC02423.JPG_2.jpg,2550,480,640,50,137,187,233,284,True,19
H,97,kaist_dataset/English/Digital_Camera/(E.S)A-shadow/DSC02633.JPG,char_data/H/DSC02633.JPG_2.jpg,6596,480,640,68,305,373,181,278,True,19
H,60,kaist_dataset/English/Digital_Camera/(E.S)A-shadow/DSC03081.JPG,char_data/H/DSC03081.JPG_2.jpg,2700,480,640,45,237,282,397,457,True,19
H,128,kaist_dataset/English/Digital_Camera/(E.S)A-shadow/P1010035.JPG,char_data/H/P1010035.JPG_2.jpg,16512,480,640,129,81,210,154,282,True,19
H,35,kaist_dataset/English/Digital_Camera/(E.S)A-shadow/P1010044.JPG,char_data/H/P1010044.JPG_4.jpg,1015,480,640,29,277,306,120,155,True,19
H,28,kaist_dataset/English/Digital_Camera/(E.S)A-shadow/P1010044.JPG,char_data/H/P1010044.JPG_5.jpg,812,480,640,29,303,332,156,184,True,19
H,198,kaist_dataset/English/Digital_Camera/(E.S)B-light/080116-0059.jpg,char_data/H/080116-0059.jpg_8.jpg,30294,1200,1600,153,1063,1216,76,274,True,19
H,171,kaist_dataset/English/Digital_Camera/(E.S)B-light/080116-0059.jpg,char_data/H/080116-0059.jpg_9.jpg,14022,1200,1600,82,1138,1220,337,508,True,19
H,24,kaist_dataset/English/Digital_Camera/(E.S)B-light/080116-0059.jpg,char_data/H/080116-0059.jpg_10.jpg,336,1200,1600,14,978,992,826,850,True,19
H,26,kaist_dataset/English/Digital_Camera/(E.S)B-light/080116-0059.jpg,char_data/H/080116-0059.jpg_11.jpg,416,1200,1600,16,942,958,799,825,True,19
H,84,kaist_dataset/English/Digital_Camera/(E.S)B-light/080119-0038.jpg,char_data/H/080119-0038.jpg_2.jpg,5460,1200,1600,65,622,687,677,761,True,19
H,101,kaist_dataset/English/Digital_Camera/(E.S)B-light/DSC02587.JPG,char_data/H/DSC02587.JPG_4.jpg,6363,480,640,63,139,202,178,279,True,19
H,45,kaist_dataset/English/Digital_Camera/(E.S)B-light/DSC03007.JPG,char_data/H/DSC03007.JPG_2.jpg,1530,480,640,34,287,321,276,321,True,19
H,70,kaist_dataset/English/Digital_Camera/(E.S)B-light/DSC04200.JPG,char_data/H/DSC04200.JPG_2.jpg,4060,480,640,58,465,523,312,382,True,19
H,36,kaist_dataset/English/Digital_Camera/(E.S)B-light/v.jpg,char_data/H/v.jpg_4.jpg,612,240,320,17,54,71,48,84,True,19
H,22,kaist_dataset/English/Digital_Camera/(E.S)B-light/v.jpg,char_data/H/v.jpg_5.jpg,418,240,320,19,205,224,59,81,True,19
H,60,kaist_dataset/English/Digital_Camera/(E.S)C-outdoor1/031.JPG,char_data/H/031.JPG_8.jpg,2940,480,640,49,201,250,188,248,True,19
H,25,kaist_dataset/English/Digital_Camera/(E.S)C-outdoor1/031.JPG,char_data/H/031.JPG_9.jpg,300,480,640,12,121,133,318,343,True,19
H,21,kaist_dataset/English/Digital_Camera/(E.S)C-outdoor1/031.JPG,char_data/H/031.JPG_10.jpg,273,480,640,13,511,524,321,342,True,19
H,57,kaist_dataset/English/Digital_Camera/(E.S)C-outdoor1/034.JPG,char_data/H/034.JPG_2.jpg,3420,480,640,60,305,365,193,250,True,19
H,73,kaist_dataset/English/Digital_Camera/(E.S)C-outdoor1/080118-0011.jpg,char_data/H/080118-0011.jpg_4.jpg,4015,1200,1600,55,805,860,457,530,True,19
H,69,kaist_dataset/English/Digital_Camera/(E.S)C-outdoor1/080118-0011.jpg,char_data/H/080118-0011.jpg_5.jpg,3864,1200,1600,56,858,914,527,596,True,19
H,58,kaist_dataset/English/Digital_Camera/(E.S)C-outdoor1/080119-0012.jpg,char_data/H/080119-0012.jpg_2.jpg,1624,1200,1600,28,584,612,585,643,True,19
H,168,kaist_dataset/English/Digital_Camera/(E.S)C-outdoor1/080119-0020.jpg,char_data/H/080119-0020.jpg_2.jpg,26544,1200,1600,158,1125,1283,466,634,True,19
H,93,kaist_dataset/English/Digital_Camera/(E.S)C-outdoor1/083.JPG,char_data/H/083.JPG_2.jpg,6789,480,640,73,156,229,179,272,True,19
H,62,kaist_dataset/English/Digital_Camera/(E.S)C-outdoor1/107.jpg,char_data/H/107.jpg_2.jpg,3038,480,640,49,160,209,270,332,True,19
H,73,kaist_dataset/English/Digital_Camera/(E.S)C-outdoor1/DSC02243.JPG,char_data/H/DSC02243.JPG_2.jpg,3869,480,640,53,238,291,202,275,True,19
H,41,kaist_dataset/English/Digital_Camera/(E.S)C-outdoor1/DSC02345.JPG,char_data/H/DSC02345.JPG_2.jpg,861,480,640,21,110,131,237,278,True,19
H,110,kaist_dataset/English/Digital_Camera/(E.S)C-outdoor1/DSC02450.JPG,char_data/H/DSC02450.JPG_2.jpg,5940,480,640,54,367,421,75,185,True,19
H,100,kaist_dataset/English/Digital_Camera/(E.S)C-outdoor1/DSC02559.JPG,char_data/H/DSC02559.JPG_2.jpg,8900,480,640,89,288,377,75,175,True,19
H,79,kaist_dataset/English/Digital_Camera/(E.S)C-outdoor1/DSC02897.JPG,char_data/H/DSC02897.JPG_2.jpg,5135,480,640,65,140,205,294,373,True,19
H,67,kaist_dataset/English/Digital_Camera/(E.S)C-outdoor2/DSC03012.JPG,char_data/H/DSC03012.JPG_2.jpg,2881,480,640,43,336,379,215,282,True,19
H,68,kaist_dataset/English/Digital_Camera/(E.S)C-outdoor2/DSC03025.JPG,char_data/H/DSC03025.JPG_2.jpg,2516,480,640,37,251,288,125,193,True,19
H,67,kaist_dataset/English/Digital_Camera/(E.S)C-outdoor2/DSC03161.JPG,char_data/H/DSC03161.JPG_2.jpg,2144,480,640,32,486,518,202,269,True,19
H,79,kaist_dataset/English/Digital_Camera/(E.S)C-outdoor2/DSC03191.JPG,char_data/H/DSC03191.JPG_2.jpg,4898,480,640,62,468,530,133,212,True,19
H,43,kaist_dataset/English/Digital_Camera/(E.S)C-outdoor2/DSC03203.JPG,char_data/H/DSC03203.JPG_4.jpg,1505,480,640,35,248,283,313,356,True,19
H,28,kaist_dataset/English/Digital_Camera/(E.S)C-outdoor2/DSC03208.JPG,char_data/H/DSC03208.JPG_2.jpg,784,480,640,28,306,334,166,194,True,19
H,64,kaist_dataset/English/Digital_Camera/(E.S)C-outdoor2/DSC03264.JPG,char_data/H/DSC03264.JPG_4.jpg,3584,480,640,56,345,401,164,228,True,19
H,68,kaist_dataset/English/Digital_Camera/(E.S)C-outdoor2/DSC03264.JPG,char_data/H/DSC03264.JPG_5.jpg,3740,480,640,55,292,347,94,162,True,19
H,55,kaist_dataset/English/Digital_Camera/(E.S)C-outdoor2/DSC03413.JPG,char_data/H/DSC03413.JPG_4.jpg,2640,480,640,48,380,428,206,261,True,19
H,72,kaist_dataset/English/Digital_Camera/(E.S)C-outdoor2/DSC03413.JPG,char_data/H/DSC03413.JPG_5.jpg,4824,480,640,67,115,182,110,182,True,19
H,41,kaist_dataset/English/Digital_Camera/(E.S)C-outdoor2/DSC03575.JPG,char_data/H/DSC03575.JPG_2.jpg,1107,480,640,27,232,259,181,222,True,19
H,58,kaist_dataset/English/Digital_Camera/(E.S)C-outdoor2/DSC03650.JPG,char_data/H/DSC03650.JPG_2.jpg,1914,480,640,33,111,144,205,263,True,19
H,64,kaist_dataset/English/Digital_Camera/(E.S)C-outdoor2/DSC03684.JPG,char_data/H/DSC03684.JPG_2.jpg,3328,480,640,52,259,311,83,147,True,19
H,81,kaist_dataset/English/Digital_Camera/(E.S)C-outdoor2/DSC03705.JPG,char_data/H/DSC03705.JPG_4.jpg,4941,480,640,61,261,322,194,275,True,19
H,48,kaist_dataset/English/Digital_Camera/(E.S)C-outdoor2/DSC03705.JPG,char_data/H/DSC03705.JPG_5.jpg,1728,480,640,36,259,295,313,361,True,19
H,132,kaist_dataset/English/Digital_Camera/(E.S)C-outdoor2/DSC03786.JPG,char_data/H/DSC03786.JPG_4.jpg,17028,480,640,129,70,199,312,444,True,19
H,41,kaist_dataset/English/Digital_Camera/(E.S)C-outdoor2/DSC03831.JPG,char_data/H/DSC03831.JPG_2.jpg,1230,480,640,30,309,339,125,166,True,19
H,66,kaist_dataset/English/Digital_Camera/(E.S)C-outdoor2/DSC04047.JPG,char_data/H/DSC04047.JPG_2.jpg,3366,480,640,51,345,396,221,287,True,19
H,35,kaist_dataset/English/Digital_Camera/(E.S)C-outdoor2/DSC04080.JPG,char_data/H/DSC04080.JPG_2.jpg,1225,480,640,35,253,288,358,393,True,19
H,61,kaist_dataset/English/Digital_Camera/(E.S)C-outdoor2/DSC04120.JPG,char_data/H/DSC04120.JPG_4.jpg,2623,480,640,43,258,301,145,206,True,19
H,62,kaist_dataset/English/Digital_Camera/(E.S)C-outdoor2/DSC04120.JPG,char_data/H/DSC04120.JPG_5.jpg,2232,480,640,36,456,492,138,200,True,19
H,57,kaist_dataset/English/Digital_Camera/(E.S)C-outdoor2/DSC04163.JPG,char_data/H/DSC04163.JPG_2.jpg,2907,480,640,51,417,468,252,309,True,19
H,75,kaist_dataset/English/Digital_Camera/(E.S)C-outdoor2/DSC04313.JPG,char_data/H/DSC04313.JPG_2.jpg,3975,480,640,53,516,569,109,184,True,19
H,63,kaist_dataset/English/Digital_Camera/(E.S)C-outdoor3/DSC02788.JPG,char_data/H/DSC02788.JPG_2.jpg,2079,480,640,33,272,305,222,285,True,19
H,89,kaist_dataset/English/Digital_Camera/(E.S)C-outdoor3/P1010133.JPG,char_data/H/P1010133.JPG_2.jpg,6230,480,640,70,452,522,67,156,True,19
H,55,kaist_dataset/English/Digital_Camera/(E.S)C-outdoor3/크기변환_%B0%A3%C6%C718_m_starfirm.jpg,char_data/H/크기변환_%B0%A3%C6%C718_m_starfirm.jpg_2.jpg,2530,480,640,46,227,273,218,273,True,19
H,63,kaist_dataset/English/Digital_Camera/(E.S)C-outdoor3/크기변환_%C8%AD%C0%CC%C6%AE%C4%FE%C6%AE%B0%A3%C6%C7_%BA%B9%BB%E7_1-bona0007.jpg,char_data/H/크기변환_%C8%AD%C0%CC%C6%AE%C4%FE%C6%AE%B0%A3%C6%C7_%BA%B9%BB%E7_1-bona0007.jpg_2.jpg,3906,480,640,62,314,376,197,260,True,19
H,42,kaist_dataset/English/Digital_Camera/(E.S)D-indoor/080119-0015.jpg,char_data/H/080119-0015.jpg_2.jpg,1428,1200,1600,34,536,570,643,685,True,19
H,63,kaist_dataset/English/Digital_Camera/(E.S)D-indoor/DSC02719.JPG,char_data/H/DSC02719.JPG_4.jpg,3087,480,640,49,116,165,281,344,True,19
H,141,kaist_dataset/English/Digital_Camera/(E.S)D-indoor/DSC02719.JPG,char_data/H/DSC02719.JPG_5.jpg,18753,480,640,133,87,220,128,269,True,19
H,66,kaist_dataset/English/Digital_Camera/(E.S)D-indoor/DSC02769.JPG,char_data/H/DSC02769.JPG_2.jpg,2772,480,640,42,225,267,134,200,True,19
H,100,kaist_dataset/English/Digital_Camera/(E.S)D-indoor/DSC02842.JPG,char_data/H/DSC02842.JPG_2.jpg,9000,480,640,90,145,235,50,150,True,19
H,89,kaist_dataset/English/Digital_Camera/(E.S)D-indoor/DSC02850.JPG,char_data/H/DSC02850.JPG_2.jpg,7120,480,640,80,91,171,151,240,True,19
H,62,kaist_dataset/English/Digital_Camera/(E.S)D-indoor/DSC03078.JPG,char_data/H/DSC03078.JPG_8.jpg,2790,480,640,45,386,431,224,286,True,19
H,48,kaist_dataset/English/Digital_Camera/(E.S)D-indoor/DSC03149.JPG,char_data/H/DSC03149.JPG_2.jpg,1680,480,640,35,108,143,378,426,True,19
H,56,kaist_dataset/English/Digital_Camera/(E.S)D-indoor/DSC03532.JPG,char_data/H/DSC03532.JPG_2.jpg,3080,480,640,55,29,84,417,473,True,19
H,38,kaist_dataset/English/Digital_Camera/(E.S)D-indoor/DSC03901.JPG,char_data/H/DSC03901.JPG_2.jpg,1102,480,640,29,193,222,122,160,True,19
H,33,kaist_dataset/English/Digital_Camera/(E.S)D-indoor/DSC03935.JPG,char_data/H/DSC03935.JPG_2.jpg,990,480,640,30,240,270,45,78,True,19
H,69,kaist_dataset/English/Digital_Camera/(E.S)D-indoor/DSC03941.JPG,char_data/H/DSC03941.JPG_2.jpg,3381,480,640,49,216,265,222,291,True,19
H,18,kaist_dataset/English/Digital_Camera/(E.S)E-night/111.jpg,char_data/H/111.jpg_2.jpg,198,480,640,11,280,291,267,285,True,19
H,202,kaist_dataset/English/Digital_Camera/(E.S)F-others/080116-0058.jpg,char_data/H/080116-0058.jpg_6.jpg,21614,1200,1600,107,426,533,222,424,True,19
H,142,kaist_dataset/English/Digital_Camera/(E.S)F-others/080116-0058.jpg,char_data/H/080116-0058.jpg_7.jpg,6390,1200,1600,45,1001,1046,473,615,True,19
H,102,kaist_dataset/English/Digital_Camera/(E.S)F-others/080116-0058.jpg,char_data/H/080116-0058.jpg_8.jpg,3264,1200,1600,32,1003,1035,643,745,True,19
H,146,kaist_dataset/English/Digital_Camera/(E.S)F-others/080116-0060.jpg,char_data/H/080116-0060.jpg_2.jpg,18834,1200,1600,129,544,673,440,586,True,19
H,278,kaist_dataset/English/Digital_Camera/(E.S)F-others/080119-0016.jpg,char_data/H/080119-0016.jpg_2.jpg,63662,1200,1600,229,319,548,132,410,True,19
H,54,kaist_dataset/English/Digital_Camera/(E.S)F-others/086.jpg,char_data/H/086.jpg_2.jpg,1674,480,640,31,169,200,280,334,True,19
H,106,kaist_dataset/English/Digital_Camera/(E.S)F-others/DSC02646.JPG,char_data/H/DSC02646.JPG_2.jpg,5406,480,640,51,1,52,319,425,True,19
H,48,kaist_dataset/English/Digital_Camera/(E.S)F-others/DSC02884.JPG,char_data/H/DSC02884.JPG_2.jpg,2160,480,640,45,83,128,109,157,True,19
H,98,kaist_dataset/English/Digital_Camera/(E.S)F-others/DSC03291.JPG,char_data/H/DSC03291.JPG_2.jpg,6762,480,640,69,122,191,156,254,True,19
H,120,kaist_dataset/English/Mobile_Phone/(E.M)A-outdoor/P090911085.jpg,char_data/H/P090911085.jpg_2.jpg,10560,480,640,88,206,294,123,243,True,19
H,106,kaist_dataset/English/Mobile_Phone/(E.M)B-indoor/P090911086.jpg,char_data/H/P090911086.jpg_4.jpg,10176,480,640,96,331,427,344,450,True,19
H,75,kaist_dataset/English/Mobile_Phone/(E.M)C-bookCover/P090831042.jpg,char_data/H/P090831042.jpg_2.jpg,4800,480,640,64,106,170,199,274,True,19
H,76,kaist_dataset/English/Mobile_Phone/(E.M)C-bookCover/P090903050.jpg,char_data/H/P090903050.jpg_4.jpg,5016,480,640,66,252,318,8,84,True,19
H,108,kaist_dataset/English/Mobile_Phone/(E.M)C-bookCover/P090903050.jpg,char_data/H/P090903050.jpg_5.jpg,12636,480,640,117,130,247,79,187,True,19
H,57,kaist_dataset/English/Mobile_Phone/(E.M)C-bookCover/P090903054.jpg,char_data/H/P090903054.jpg_2.jpg,2280,480,640,40,100,140,354,411,True,19
H,38,kaist_dataset/English/Mobile_Phone/(E.M)C-bookCover/P090903055.jpg,char_data/H/P090903055.jpg_2.jpg,1520,480,640,40,177,217,411,449,True,19
H,100,kaist_dataset/English/Mobile_Phone/(E.M)C-bookCover/P090905007.jpg,char_data/H/P090905007.jpg_2.jpg,8000,480,640,80,271,351,29,129,True,19
H,37,kaist_dataset/Korean/Digital_Camera/indoor2/DSC03564.JPG,char_data/H/DSC03564.JPG_2.jpg,814,480,640,22,191,213,405,442,True,19
H,65,kaist_dataset/Korean/Digital_Camera/outdoor2/2007-12-08-day-101.jpg,char_data/H/2007-12-08-day-101.jpg_6.jpg,3055,1200,1600,47,141,188,1093,1158,True,19
H,35,kaist_dataset/Korean/Digital_Camera/outdoor2/2007-12-08-day-101.jpg,char_data/H/2007-12-08-day-101.jpg_8.jpg,665,1200,1600,19,122,141,1054,1089,True,19
H,35,kaist_dataset/Mixed/Digital_Camera/(C.S)A-shadow/DSC02568.JPG,char_data/H/DSC02568.JPG_8.jpg,1155,480,640,33,87,120,141,176,True,19
H,32,kaist_dataset/Mixed/Digital_Camera/(C.S)A-shadow/DSC02568.JPG,char_data/H/DSC02568.JPG_9.jpg,864,480,640,27,235,262,146,178,True,19
H,43,kaist_dataset/Mixed/Digital_Camera/(C.S)A-shadow/DSC02902.JPG,char_data/H/DSC02902.JPG_2.jpg,946,480,640,22,224,246,385,428,True,19
H,50,kaist_dataset/Mixed/Digital_Camera/(C.S)A-shadow/DSC04306.JPG,char_data/H/DSC04306.JPG_2.jpg,1900,480,640,38,122,160,330,380,True,19
H,78,kaist_dataset/Mixed/Digital_Camera/(C.S)C-outdoor1/046.JPG,char_data/H/046.JPG_2.jpg,4836,480,640,62,379,441,191,269,True,19
H,29,kaist_dataset/Mixed/Digital_Camera/(C.S)C-outdoor1/054.JPG,char_data/H/054.JPG_2.jpg,841,480,640,29,446,475,274,303,True,19
H,56,kaist_dataset/Mixed/Digital_Camera/(C.S)C-outdoor1/080116-0084.jpg,char_data/H/080116-0084.jpg_2.jpg,2408,600,800,43,357,400,294,350,True,19
H,275,kaist_dataset/Mixed/Digital_Camera/(C.S)C-outdoor1/080118-0007.jpg,char_data/H/080118-0007.jpg_2.jpg,77275,1200,1600,281,306,587,433,708,True,19
H,215,kaist_dataset/Mixed/Digital_Camera/(C.S)C-outdoor1/080119-0006.jpg,char_data/H/080119-0006.jpg_2.jpg,38915,1200,1600,181,862,1043,505,720,True,19
H,72,kaist_dataset/Mixed/Digital_Camera/(C.S)C-outdoor1/080119-0017.jpg,char_data/H/080119-0017.jpg_2.jpg,4392,1200,1600,61,1156,1217,1071,1143,True,19
H,88,kaist_dataset/Mixed/Digital_Camera/(C.S)C-outdoor1/080119-0027.jpg,char_data/H/080119-0027.jpg_2.jpg,4840,1200,1600,55,796,851,718,806,True,19
H,259,kaist_dataset/Mixed/Digital_Camera/(C.S)C-outdoor1/080119-0033.jpg,char_data/H/080119-0033.jpg_2.jpg,44030,1200,1600,170,567,737,443,702,True,19
H,57,kaist_dataset/Mixed/Digital_Camera/(C.S)C-outdoor1/1.JPG,char_data/H/1.JPG_11.jpg,2394,576,768,42,634,676,283,340,True,19
H,25,kaist_dataset/Mixed/Digital_Camera/(C.S)C-outdoor1/114.jpg,char_data/H/114.jpg_2.jpg,575,480,640,23,175,198,363,388,True,19
H,80,kaist_dataset/Mixed/Digital_Camera/(C.S)C-outdoor1/2.JPG,char_data/H/2.JPG_4.jpg,4160,576,768,52,245,297,199,279,True,19
H,64,kaist_dataset/Mixed/Digital_Camera/(C.S)C-outdoor1/2007-12-08-day-091.jpg,char_data/H/2007-12-08-day-091.jpg_2.jpg,3200,1200,1600,50,185,235,605,669,True,19
H,78,kaist_dataset/Mixed/Digital_Camera/(C.S)C-outdoor1/2007-12-08-day-106.jpg,char_data/H/2007-12-08-day-106.jpg_2.jpg,4368,1200,1600,56,695,751,733,811,True,19
H,51,kaist_dataset/Mixed/Digital_Camera/(C.S)C-outdoor1/2007-12-08-day-130.jpg,char_data/H/2007-12-08-day-130.jpg_2.jpg,2499,1200,1600,49,931,980,700,751,True,19
H,51,kaist_dataset/Mixed/Digital_Camera/(C.S)C-outdoor1/2007-12-09-day-exterior-051.jpg,char_data/H/2007-12-09-day-exterior-051.jpg_4.jpg,2142,1200,1600,42,241,283,923,974,True,19
H,66,kaist_dataset/Mixed/Digital_Camera/(C.S)C-outdoor1/2007-12-09-day-exterior-051.jpg,char_data/H/2007-12-09-day-exterior-051.jpg_5.jpg,3168,1200,1600,48,1375,1423,921,987,True,19
H,50,kaist_dataset/Mixed/Digital_Camera/(C.S)C-outdoor1/2007-12-09-day-exterior-078.jpg,char_data/H/2007-12-09-day-exterior-078.jpg_2.jpg,1350,1200,1600,27,641,668,588,638,True,19
H,92,kaist_dataset/Mixed/Digital_Camera/(C.S)C-outdoor1/DSC02344.JPG,char_data/H/DSC02344.JPG_2.jpg,6440,480,640,70,338,408,143,235,True,19
H,31,kaist_dataset/Mixed/Digital_Camera/(C.S)C-outdoor2/DSC02368.JPG,char_data/H/DSC02368.JPG_2.jpg,713,480,640,23,349,372,382,413,True,19
H,20,kaist_dataset/Mixed/Digital_Camera/(C.S)C-outdoor2/DSC02411.JPG,char_data/H/DSC02411.JPG_4.jpg,220,480,640,11,583,594,273,293,True,19
H,108,kaist_dataset/Mixed/Digital_Camera/(C.S)C-outdoor2/DSC02425.JPG,char_data/H/DSC02425.JPG_2.jpg,9180,480,640,85,242,327,132,240,True,19
H,30,kaist_dataset/Mixed/Digital_Camera/(C.S)C-outdoor2/DSC02483.JPG,char_data/H/DSC02483.JPG_6.jpg,1080,480,640,36,210,246,149,179,True,19
H,84,kaist_dataset/Mixed/Digital_Camera/(C.S)C-outdoor2/DSC02513.JPG,char_data/H/DSC02513.JPG_2.jpg,4200,480,640,50,263,313,237,321,True,19
H,35,kaist_dataset/Mixed/Digital_Camera/(C.S)C-outdoor2/DSC02568.JPG,char_data/H/DSC02568.JPG_10.jpg,1155,480,640,33,87,120,141,176,True,19
H,32,kaist_dataset/Mixed/Digital_Camera/(C.S)C-outdoor2/DSC02568.JPG,char_data/H/DSC02568.JPG_11.jpg,864,480,640,27,235,262,146,178,True,19
H,83,kaist_dataset/Mixed/Digital_Camera/(C.S)C-outdoor2/DSC02701.JPG,char_data/H/DSC02701.JPG_2.jpg,7553,480,640,91,45,136,84,167,True,19
H,32,kaist_dataset/Mixed/Digital_Camera/(C.S)C-outdoor2/DSC02886.JPG,char_data/H/DSC02886.JPG_4.jpg,1088,480,640,34,371,405,139,171,True,19
H,67,kaist_dataset/Mixed/Digital_Camera/(C.S)C-outdoor2/DSC02907.JPG,char_data/H/DSC02907.JPG_2.jpg,3216,480,640,48,227,275,91,158,True,19
H,37,kaist_dataset/Mixed/Digital_Camera/(C.S)C-outdoor2/DSC02954.JPG,char_data/H/DSC02954.JPG_2.jpg,999,480,640,27,332,359,262,299,True,19
H,42,kaist_dataset/Mixed/Digital_Camera/(C.S)C-outdoor3/DSC02989.JPG,char_data/H/DSC02989.JPG_4.jpg,1428,480,640,34,364,398,266,308,True,19
H,45,kaist_dataset/Mixed/Digital_Camera/(C.S)C-outdoor3/DSC02989.JPG,char_data/H/DSC02989.JPG_5.jpg,1620,480,640,36,528,564,269,314,True,19
H,19,kaist_dataset/Mixed/Digital_Camera/(C.S)C-outdoor3/DSC03033.JPG,char_data/H/DSC03033.JPG_2.jpg,228,480,640,12,129,141,151,170,True,19
H,35,kaist_dataset/Mixed/Digital_Camera/(C.S)C-outdoor3/DSC03035.JPG,char_data/H/DSC03035.JPG_2.jpg,840,480,640,24,320,344,368,403,True,19
H,71,kaist_dataset/Mixed/Digital_Camera/(C.S)C-outdoor3/DSC03060.JPG,char_data/H/DSC03060.JPG_4.jpg,3266,480,640,46,131,177,71,142,True,19
H,70,kaist_dataset/Mixed/Digital_Camera/(C.S)C-outdoor3/DSC03060.JPG,char_data/H/DSC03060.JPG_5.jpg,3220,480,640,46,222,268,72,142,True,19
H,48,kaist_dataset/Mixed/Digital_Camera/(C.S)C-outdoor3/DSC03223.JPG,char_data/H/DSC03223.JPG_2.jpg,2016,480,640,42,58,100,430,478,True,19
H,82,kaist_dataset/Mixed/Digital_Camera/(C.S)C-outdoor3/DSC03421.JPG,char_data/H/DSC03421.JPG_6.jpg,3854,480,640,47,348,395,232,314,True,19
H,126,kaist_dataset/Mixed/Digital_Camera/(C.S)C-outdoor3/DSC03421.JPG,char_data/H/DSC03421.JPG_8.jpg,11844,480,640,94,85,179,51,177,True,19
H,113,kaist_dataset/Mixed/Digital_Camera/(C.S)C-outdoor4/DSC03519.JPG,char_data/H/DSC03519.JPG_2.jpg,12769,480,640,113,228,341,255,368,True,19
H,54,kaist_dataset/Mixed/Digital_Camera/(C.S)C-outdoor4/DSC03531.JPG,char_data/H/DSC03531.JPG_2.jpg,2160,480,640,40,499,539,346,400,True,19
H,62,kaist_dataset/Mixed/Digital_Camera/(C.S)C-outdoor4/DSC03673.JPG,char_data/H/DSC03673.JPG_2.jpg,2604,480,640,42,293,335,182,244,True,19
H,38,kaist_dataset/Mixed/Digital_Camera/(C.S)C-outdoor4/DSC03679.JPG,char_data/H/DSC03679.JPG_4.jpg,1292,480,640,34,23,57,97,135,True,19
H,43,kaist_dataset/Mixed/Digital_Camera/(C.S)C-outdoor4/DSC03679.JPG,char_data/H/DSC03679.JPG_5.jpg,1032,480,640,24,149,173,96,139,True,19
H,38,kaist_dataset/Mixed/Digital_Camera/(C.S)C-outdoor4/DSC03711.JPG,char_data/H/DSC03711.JPG_4.jpg,912,480,640,24,329,353,389,427,True,19
H,41,kaist_dataset/Mixed/Digital_Camera/(C.S)C-outdoor4/DSC03711.JPG,char_data/H/DSC03711.JPG_5.jpg,1066,480,640,26,493,519,384,425,True,19
H,34,kaist_dataset/Mixed/Digital_Camera/(C.S)C-outdoor4/DSC03716.JPG,char_data/H/DSC03716.JPG_2.jpg,442,480,640,13,259,272,239,273,True,19
H,31,kaist_dataset/Mixed/Digital_Camera/(C.S)C-outdoor4/DSC03718.JPG,char_data/H/DSC03718.JPG_8.jpg,651,480,640,21,278,299,95,126,True,19
H,33,kaist_dataset/Mixed/Digital_Camera/(C.S)C-outdoor4/DSC03718.JPG,char_data/H/DSC03718.JPG_10.jpg,594,480,640,18,93,111,255,288,False,19
H,39,kaist_dataset/Mixed/Digital_Camera/(C.S)C-outdoor4/DSC03719.JPG,char_data/H/DSC03719.JPG_4.jpg,819,480,640,21,99,120,26,65,False,19
H,117,kaist_dataset/Mixed/Digital_Camera/(C.S)C-outdoor4/DSC03733.JPG,char_data/H/DSC03733.JPG_2.jpg,11232,480,640,96,202,298,188,305,False,19
H,47,kaist_dataset/Mixed/Digital_Camera/(C.S)C-outdoor4/DSC03781.JPG,char_data/H/DSC03781.JPG_4.jpg,2585,480,640,55,185,240,309,356,False,19
H,51,kaist_dataset/Mixed/Digital_Camera/(C.S)C-outdoor5/DSC04060.JPG,char_data/H/DSC04060.JPG_2.jpg,1989,480,640,39,372,411,102,153,False,19
H,58,kaist_dataset/Mixed/Digital_Camera/(C.S)C-outdoor5/DSC04119.JPG,char_data/H/DSC04119.JPG_4.jpg,2320,480,640,40,344,384,126,184,False,19
H,44,kaist_dataset/Mixed/Digital_Camera/(C.S)C-outdoor5/DSC04119.JPG,char_data/H/DSC04119.JPG_5.jpg,1452,480,640,33,512,545,142,186,False,19
H,51,kaist_dataset/Mixed/Digital_Camera/(C.S)C-outdoor5/DSC04305.JPG,char_data/H/DSC04305.JPG_2.jpg,2397,480,640,47,318,365,77,128,False,19
H,38,kaist_dataset/Mixed/Digital_Camera/(C.S)C-outdoor5/DSC04314.JPG,char_data/H/DSC04314.JPG_2.jpg,1178,480,640,31,527,558,167,205,False,19
H,35,kaist_dataset/Mixed/Digital_Camera/(C.S)C-outdoor5/DSC04360.JPG,char_data/H/DSC04360.JPG_4.jpg,595,480,640,17,139,156,344,379,False,19
H,32,kaist_dataset/Mixed/Digital_Camera/(C.S)C-outdoor5/DSC04360.JPG,char_data/H/DSC04360.JPG_5.jpg,480,480,640,15,87,102,381,413,False,19
H,36,kaist_dataset/Mixed/Digital_Camera/(C.S)C-outdoor5/DSC04434.JPG,char_data/H/DSC04434.JPG_6.jpg,1044,480,640,29,147,176,268,304,False,19
H,34,kaist_dataset/Mixed/Digital_Camera/(C.S)C-outdoor5/DSC04434.JPG,char_data/H/DSC04434.JPG_7.jpg,884,480,640,26,270,296,270,304,False,19
H,41,kaist_dataset/Mixed/Digital_Camera/(C.S)C-outdoor5/DSC04434.JPG,char_data/H/DSC04434.JPG_8.jpg,1353,480,640,33,179,212,386,427,False,19
H,33,kaist_dataset/Mixed/Digital_Camera/(C.S)C-outdoor6/P1010088.JPG,char_data/H/P1010088.JPG_4.jpg,825,480,640,25,241,266,177,210,False,19
H,23,kaist_dataset/Mixed/Digital_Camera/(C.S)C-outdoor6/P1010088.JPG,char_data/H/P1010088.JPG_5.jpg,575,480,640,25,362,387,180,203,False,19
H,37,kaist_dataset/Mixed/Digital_Camera/(C.S)C-outdoor6/P1010090.JPG,char_data/H/P1010090.JPG_2.jpg,962,480,640,26,294,320,199,236,False,19
H,27,kaist_dataset/Mixed/Digital_Camera/(C.S)C-outdoor6/P1010095.JPG,char_data/H/P1010095.JPG_2.jpg,297,480,640,11,120,131,183,210,False,19
H,38,kaist_dataset/Mixed/Digital_Camera/(C.S)D-indoor1/DSC02718.JPG,char_data/H/DSC02718.JPG_4.jpg,912,480,640,24,52,76,217,255,False,19
H,46,kaist_dataset/Mixed/Digital_Camera/(C.S)D-indoor1/DSC02718.JPG,char_data/H/DSC02718.JPG_5.jpg,1748,480,640,38,60,98,175,221,False,19
H,53,kaist_dataset/Mixed/Digital_Camera/(C.S)D-indoor1/DSC03123.JPG,char_data/H/DSC03123.JPG_4.jpg,2385,480,640,45,205,250,178,231,False,19
H,49,kaist_dataset/Mixed/Digital_Camera/(C.S)D-indoor1/DSC03125.JPG,char_data/H/DSC03125.JPG_2.jpg,1862,480,640,38,218,256,184,233,False,19
H,77,kaist_dataset/Mixed/Digital_Camera/(C.S)D-indoor1/DSC03959.JPG,char_data/H/DSC03959.JPG_2.jpg,4235,480,640,55,194,249,97,174,False,19
H,49,kaist_dataset/Mixed/Digital_Camera/(C.S)D-indoor1/DSC03986.JPG,char_data/H/DSC03986.JPG_2.jpg,1078,480,640,22,208,230,160,209,False,19
H,48,kaist_dataset/Mixed/Digital_Camera/(C.S)E-night/DSC02574.JPG,char_data/H/DSC02574.JPG_2.jpg,1296,480,640,27,232,259,148,196,False,19
H,68,kaist_dataset/Mixed/Digital_Camera/(C.S)E-night/DSC03031.JPG,char_data/H/DSC03031.JPG_2.jpg,3332,480,640,49,131,180,69,137,False,19
H,27,kaist_dataset/Mixed/Digital_Camera/(C.S)E-night/DSC03516.JPG,char_data/H/DSC03516.JPG_2.jpg,621,480,640,23,83,106,142,169,False,19
H,66,kaist_dataset/Mixed/Digital_Camera/(C.S)F-others/047.jpg,char_data/H/047.jpg_2.jpg,3366,252,339,51,76,127,65,131,False,19
H,34,kaist_dataset/Mixed/Digital_Camera/(C.S)F-others/097.jpg,char_data/H/097.jpg_4.jpg,578,480,640,17,223,240,161,195,False,19
H,31,kaist_dataset/Mixed/Digital_Camera/(C.S)F-others/097.jpg,char_data/H/097.jpg_5.jpg,403,480,640,13,297,310,163,194,False,19
H,82,kaist_dataset/Mixed/Digital_Camera/(C.S)F-others/DSC02696.JPG,char_data/H/DSC02696.JPG_2.jpg,6232,480,640,76,57,133,301,383,False,19
H,36,kaist_dataset/Mixed/Mobile_Phone/(C.M)A-outdoor/P090912036.jpg,char_data/H/P090912036.jpg_2.jpg,864,480,640,24,277,301,190,226,False,19
H,34,kaist_dataset/Mixed/Mobile_Phone/(C.M)A-outdoor/P090912038.jpg,char_data/H/P090912038.jpg_2.jpg,918,480,640,27,204,231,160,194,False,19
H,38,kaist_dataset/Mixed/Mobile_Phone/(C.M)B-indoor/P090831021.jpg,char_data/H/P090831021.jpg_2.jpg,1178,480,640,31,377,408,379,417,False,19
H,107,kaist_dataset/Mixed/Mobile_Phone/(C.M)C-bookCover/P090831136.jpg,char_data/H/P090831136.jpg_4.jpg,9951,480,640,93,123,216,224,331,False,19
H,111,kaist_dataset/Mixed/Mobile_Phone/(C.M)C-bookCover/P090831136.jpg,char_data/H/P090831136.jpg_5.jpg,10656,480,640,96,392,488,122,233,False,19
u,51,kaist_dataset/English/Digital_Camera/(E.S)A-shadow/DSC03026.JPG,char_data/u/DSC03026.JPG_4.jpg,2652,480,640,52,219,271,159,210,True,45
u,61,kaist_dataset/English/Digital_Camera/(E.S)A-shadow/DSC03026.JPG,char_data/u/DSC03026.JPG_5.jpg,3599,480,640,59,431,490,146,207,True,45
u,46,kaist_dataset/English/Digital_Camera/(E.S)A-shadow/DSC03075.JPG,char_data/u/DSC03075.JPG_2.jpg,1012,480,640,22,455,477,356,402,True,45
u,55,kaist_dataset/English/Digital_Camera/(E.S)A-shadow/DSC03084.JPG,char_data/u/DSC03084.JPG_2.jpg,1430,480,640,26,117,143,370,425,True,45
u,55,kaist_dataset/English/Digital_Camera/(E.S)C-outdoor1/027.jpg,char_data/u/027.jpg_2.jpg,3190,300,472,58,88,146,132,187,True,45
u,35,kaist_dataset/English/Digital_Camera/(E.S)C-outdoor1/036.jpg,char_data/u/036.jpg_2.jpg,1155,197,354,33,50,83,72,107,True,45
u,51,kaist_dataset/English/Digital_Camera/(E.S)C-outdoor1/076.JPG,char_data/u/076.JPG_4.jpg,1887,480,640,37,271,308,218,269,True,45
u,13,kaist_dataset/English/Digital_Camera/(E.S)C-outdoor1/076.JPG,char_data/u/076.JPG_5.jpg,130,480,640,10,562,572,322,335,True,45
u,45,kaist_dataset/English/Digital_Camera/(E.S)C-outdoor1/080116-0066.jpg,char_data/u/080116-0066.jpg_4.jpg,1440,600,800,32,352,384,352,397,True,45
u,46,kaist_dataset/English/Digital_Camera/(E.S)C-outdoor1/080116-0066.jpg,char_data/u/080116-0066.jpg_5.jpg,1656,600,800,36,478,514,352,398,True,45
u,36,kaist_dataset/English/Digital_Camera/(E.S)C-outdoor1/1.jpg,char_data/u/1.jpg_2.jpg,1368,480,640,38,491,529,150,186,True,45
u,122,kaist_dataset/English/Digital_Camera/(E.S)C-outdoor1/2007-12-08-day-015.jpg,char_data/u/2007-12-08-day-015.jpg_4.jpg,25498,1200,1600,209,465,674,651,773,True,45
u,35,kaist_dataset/English/Digital_Camera/(E.S)C-outdoor1/2007-12-08-day-015.jpg,char_data/u/2007-12-08-day-015.jpg_5.jpg,840,1200,1600,24,672,696,817,852,True,45
u,32,kaist_dataset/English/Digital_Camera/(E.S)C-outdoor1/DSC02352.JPG,char_data/u/DSC02352.JPG_2.jpg,672,480,640,21,482,503,325,357,True,45
u,80,kaist_dataset/English/Digital_Camera/(E.S)C-outdoor1/DSC02387.JPG,char_data/u/DSC02387.JPG_4.jpg,4880,480,640,61,149,210,230,310,True,45
u,35,kaist_dataset/English/Digital_Camera/(E.S)C-outdoor1/DSC02387.JPG,char_data/u/DSC02387.JPG_5.jpg,595,480,640,17,333,350,298,333,True,45
u,26,kaist_dataset/English/Digital_Camera/(E.S)C-outdoor1/DSC02417.JPG,char_data/u/DSC02417.JPG_2.jpg,468,480,640,18,517,535,143,169,True,45
u,25,kaist_dataset/English/Digital_Camera/(E.S)C-outdoor1/DSC02427.JPG,char_data/u/DSC02427.JPG_5.jpg,550,480,640,22,464,486,373,398,True,45
u,76,kaist_dataset/English/Digital_Camera/(E.S)C-outdoor1/DSC02491.JPG,char_data/u/DSC02491.JPG_2.jpg,4104,480,640,54,135,189,58,134,True,45
u,59,kaist_dataset/English/Digital_Camera/(E.S)C-outdoor1/DSC02514.JPG,char_data/u/DSC02514.JPG_2.jpg,1593,480,640,27,513,540,200,259,True,45
u,49,kaist_dataset/English/Digital_Camera/(E.S)C-outdoor2/DSC03001.JPG,char_data/u/DSC03001.JPG_2.jpg,2058,480,640,42,256,298,195,244,True,45
u,40,kaist_dataset/English/Digital_Camera/(E.S)C-outdoor2/DSC03167.JPG,char_data/u/DSC03167.JPG_2.jpg,1440,480,640,36,339,375,306,346,True,45
u,45,kaist_dataset/English/Digital_Camera/(E.S)C-outdoor2/DSC03201.JPG,char_data/u/DSC03201.JPG_6.jpg,1440,480,640,32,280,312,88,133,True,45
u,52,kaist_dataset/English/Digital_Camera/(E.S)C-outdoor2/DSC03201.JPG,char_data/u/DSC03201.JPG_7.jpg,1924,480,640,37,265,302,137,189,True,45
u,43,kaist_dataset/English/Digital_Camera/(E.S)C-outdoor2/DSC03201.JPG,char_data/u/DSC03201.JPG_8.jpg,1591,480,640,37,398,435,146,189,True,45
u,29,kaist_dataset/English/Digital_Camera/(E.S)C-outdoor2/DSC03208.JPG,char_data/u/DSC03208.JPG_2.jpg,696,480,640,24,228,252,168,197,True,45
u,54,kaist_dataset/English/Digital_Camera/(E.S)C-outdoor2/DSC03229.JPG,char_data/u/DSC03229.JPG_2.jpg,2646,480,640,49,298,347,169,223,True,45
u,34,kaist_dataset/English/Digital_Camera/(E.S)C-outdoor2/DSC03307.JPG,char_data/u/DSC03307.JPG_2.jpg,850,480,640,25,229,254,170,204,True,45
u,62,kaist_dataset/English/Digital_Camera/(E.S)C-outdoor2/DSC03761.JPG,char_data/u/DSC03761.JPG_2.jpg,3038,480,640,49,221,270,352,414,True,45
u,103,kaist_dataset/English/Digital_Camera/(E.S)C-outdoor2/DSC03786.JPG,char_data/u/DSC03786.JPG_2.jpg,9270,480,640,90,299,389,327,430,True,45
u,38,kaist_dataset/English/Digital_Camera/(E.S)C-outdoor2/DSC03865.JPG,char_data/u/DSC03865.JPG_2.jpg,1064,480,640,28,144,172,102,140,True,45
u,47,kaist_dataset/English/Digital_Camera/(E.S)C-outdoor2/DSC04035.JPG,char_data/u/DSC04035.JPG_4.jpg,1410,480,640,30,130,160,197,244,True,45
u,44,kaist_dataset/English/Digital_Camera/(E.S)C-outdoor2/DSC04035.JPG,char_data/u/DSC04035.JPG_5.jpg,1408,480,640,32,523,555,202,246,True,45
u,50,kaist_dataset/English/Digital_Camera/(E.S)C-outdoor2/DSC04047.JPG,char_data/u/DSC04047.JPG_2.jpg,2400,480,640,48,445,493,238,288,True,45
u,35,kaist_dataset/English/Digital_Camera/(E.S)C-outdoor2/DSC04079.JPG,char_data/u/DSC04079.JPG_11.jpg,945,480,640,27,365,392,122,157,True,45
u,126,kaist_dataset/English/Digital_Camera/(E.S)C-outdoor2/DSC04432.JPG,char_data/u/DSC04432.JPG_4.jpg,11214,480,640,89,104,193,202,328,True,45
u,30,kaist_dataset/English/Digital_Camera/(E.S)C-outdoor2/DSC04437.JPG,char_data/u/DSC04437.JPG_9.jpg,420,480,640,14,345,359,45,75,True,45
u,70,kaist_dataset/English/Digital_Camera/(E.S)C-outdoor2/DSC04437.JPG,char_data/u/DSC04437.JPG_11.jpg,3080,480,640,44,125,169,114,184,True,45
u,73,kaist_dataset/English/Digital_Camera/(E.S)C-outdoor2/P1010015.JPG,char_data/u/P1010015.JPG_2.jpg,3577,480,640,49,530,579,149,222,True,45
u,144,kaist_dataset/English/Digital_Camera/(E.S)C-outdoor2/P1010024.JPG,char_data/u/P1010024.JPG_2.jpg,13824,480,640,96,306,402,225,369,True,45
u,40,kaist_dataset/English/Digital_Camera/(E.S)C-outdoor3/DSC03038.JPG,char_data/u/DSC03038.JPG_2.jpg,1000,480,640,25,255,280,319,359,True,45
u,21,kaist_dataset/English/Digital_Camera/(E.S)C-outdoor3/P1010123.JPG,char_data/u/P1010123.JPG_4.jpg,357,480,640,17,543,560,135,156,True,45
u,25,kaist_dataset/English/Digital_Camera/(E.S)C-outdoor3/P1010123.JPG,char_data/u/P1010123.JPG_5.jpg,350,480,640,14,43,57,145,170,True,45
u,63,kaist_dataset/English/Digital_Camera/(E.S)C-outdoor3/크기변환_%B0%A3%C6%C71_fabdent.jpg,char_data/u/크기변환_%B0%A3%C6%C71_fabdent.jpg_4.jpg,2709,480,640,43,130,173,243,306,True,45
u,54,kaist_dataset/English/Digital_Camera/(E.S)C-outdoor3/크기변환_%B0%A3%C6%C71_fabdent.jpg,char_data/u/크기변환_%B0%A3%C6%C71_fabdent.jpg_5.jpg,2322,480,640,43,389,432,247,301,True,45
u,27,kaist_dataset/English/Digital_Camera/(E.S)C-outdoor3/크기변환_%B0%A3%C6%C71_m_starfirm.jpg,char_data/u/크기변환_%B0%A3%C6%C71_m_starfirm.jpg_4.jpg,810,480,640,30,393,423,288,315,True,45
u,27,kaist_dataset/English/Digital_Camera/(E.S)C-outdoor3/크기변환_%B0%A3%C6%C71_m_starfirm.jpg,char_data/u/크기변환_%B0%A3%C6%C71_m_starfirm.jpg_5.jpg,729,480,640,27,498,525,288,315,True,45
u,37,kaist_dataset/English/Digital_Camera/(E.S)D-indoor/080119-0009.jpg,char_data/u/080119-0009.jpg_4.jpg,592,1200,1600,16,712,728,1099,1136,True,45
u,39,kaist_dataset/English/Digital_Camera/(E.S)D-indoor/080119-0009.jpg,char_data/u/080119-0009.jpg_5.jpg,546,1200,1600,14,583,597,941,980,True,45
u,55,kaist_dataset/English/Digital_Camera/(E.S)D-indoor/DSC03078.JPG,char_data/u/DSC03078.JPG_2.jpg,1705,480,640,31,274,305,304,359,True,45
u,55,kaist_dataset/English/Digital_Camera/(E.S)D-indoor/DSC03085.JPG,char_data/u/DSC03085.JPG_2.jpg,1705,480,640,31,245,276,381,436,True,45
u,53,kaist_dataset/English/Digital_Camera/(E.S)D-indoor/DSC03091.JPG,char_data/u/DSC03091.JPG_2.jpg,2014,480,640,38,359,397,133,186,True,45
u,54,kaist_dataset/English/Digital_Camera/(E.S)D-indoor/DSC03093.JPG,char_data/u/DSC03093.JPG_2.jpg,1998,480,640,37,484,521,204,258,True,45
u,37,kaist_dataset/English/Digital_Camera/(E.S)D-indoor/DSC03112.JPG,char_data/u/DSC03112.JPG_6.jpg,962,480,640,26,214,240,212,249,True,45
u,36,kaist_dataset/English/Digital_Camera/(E.S)D-indoor/DSC03112.JPG,char_data/u/DSC03112.JPG_7.jpg,900,480,640,25,265,290,211,247,True,45
u,38,kaist_dataset/English/Digital_Camera/(E.S)D-indoor/DSC03112.JPG,char_data/u/DSC03112.JPG_8.jpg,988,480,640,26,387,413,210,248,True,45
u,78,kaist_dataset/English/Digital_Camera/(E.S)D-indoor/DSC03141.JPG,char_data/u/DSC03141.JPG_2.jpg,4836,480,640,62,371,433,201,279,True,45
u,30,kaist_dataset/English/Digital_Camera/(E.S)D-indoor/DSC03142.JPG,char_data/u/DSC03142.JPG_4.jpg,720,480,640,24,260,284,369,399,True,45
u,32,kaist_dataset/English/Digital_Camera/(E.S)D-indoor/DSC03142.JPG,char_data/u/DSC03142.JPG_5.jpg,896,480,640,28,344,372,372,404,True,45
u,32,kaist_dataset/English/Digital_Camera/(E.S)D-indoor/DSC03144.JPG,char_data/u/DSC03144.JPG_6.jpg,736,480,640,23,163,186,238,270,True,45
u,32,kaist_dataset/English/Digital_Camera/(E.S)D-indoor/DSC03144.JPG,char_data/u/DSC03144.JPG_7.jpg,672,480,640,21,398,419,239,271,True,45
u,35,kaist_dataset/English/Digital_Camera/(E.S)D-indoor/DSC03144.JPG,char_data/u/DSC03144.JPG_8.jpg,875,480,640,25,156,181,290,325,True,45
u,28,kaist_dataset/English/Digital_Camera/(E.S)D-indoor/DSC03145.JPG,char_data/u/DSC03145.JPG_2.jpg,588,480,640,21,290,311,127,155,True,45
u,31,kaist_dataset/English/Digital_Camera/(E.S)D-indoor/DSC03147.JPG,char_data/u/DSC03147.JPG_2.jpg,713,480,640,23,413,436,240,271,True,45
u,46,kaist_dataset/English/Digital_Camera/(E.S)D-indoor/DSC03376.JPG,char_data/u/DSC03376.JPG_2.jpg,1748,480,640,38,264,302,404,450,True,45
u,46,kaist_dataset/English/Digital_Camera/(E.S)D-indoor/DSC03395.JPG,char_data/u/DSC03395.JPG_2.jpg,1794,480,640,39,361,400,422,468,True,45
u,42,kaist_dataset/English/Digital_Camera/(E.S)D-indoor/DSC03532.JPG,char_data/u/DSC03532.JPG_4.jpg,1554,480,640,37,318,355,434,476,True,45
u,24,kaist_dataset/English/Digital_Camera/(E.S)D-indoor/DSC03532.JPG,char_data/u/DSC03532.JPG_5.jpg,408,480,640,17,454,471,385,409,True,45
u,78,kaist_dataset/English/Digital_Camera/(E.S)E-night/DSC02570.JPG,char_data/u/DSC02570.JPG_2.jpg,4134,480,640,53,150,203,250,328,True,45
u,123,kaist_dataset/English/Digital_Camera/(E.S)E-night/DSC02604.JPG,char_data/u/DSC02604.JPG_2.jpg,10578,480,640,86,187,273,230,353,True,45
u,87,kaist_dataset/English/Digital_Camera/(E.S)E-night/DSC02610.JPG,char_data/u/DSC02610.JPG_6.jpg,8787,480,640,101,338,439,173,260,True,45
u,44,kaist_dataset/English/Digital_Camera/(E.S)E-night/DSC02610.JPG,char_data/u/DSC02610.JPG_7.jpg,1144,480,640,26,253,279,268,312,True,45
u,34,kaist_dataset/English/Digital_Camera/(E.S)E-night/DSC02610.JPG,char_data/u/DSC02610.JPG_8.jpg,850,480,640,25,452,477,268,302,True,45
u,81,kaist_dataset/English/Digital_Camera/(E.S)E-night/크기변환_P1010163.JPG,char_data/u/크기변환_P1010163.JPG_2.jpg,6237,480,640,77,484,561,98,179,True,45
u,68,kaist_dataset/English/Digital_Camera/(E.S)F-others/080119-0007.jpg,char_data/u/080119-0007.jpg_4.jpg,2788,1200,1600,41,103,144,731,799,True,45
u,92,kaist_dataset/English/Digital_Camera/(E.S)F-others/DSC02923.JPG,char_data/u/DSC02923.JPG_2.jpg,7268,480,640,79,318,397,285,377,True,45
u,38,kaist_dataset/English/Digital_Camera/(E.S)F-others/DSC03218.JPG,char_data/u/DSC03218.JPG_2.jpg,1064,480,640,28,149,177,329,367,True,45
u,95,kaist_dataset/English/Digital_Camera/(E.S)F-others/크기변환_%B0%A3%C6%C72_ktimt007.jpg,char_data/u/크기변환_%B0%A3%C6%C72_ktimt007.jpg_2.jpg,6745,480,640,71,436,507,203,298,True,45
u,49,kaist_dataset/English/Mobile_Phone/(E.M)A-outdoor/P090911071.jpg,char_data/u/P090911071.jpg_2.jpg,2009,480,640,41,374,415,137,186,True,45
u,68,kaist_dataset/English/Mobile_Phone/(E.M)B-indoor/P090831011.jpg,char_data/u/P090831011.jpg_2.jpg,2924,480,640,43,521,564,138,206,True,45
u,53,kaist_dataset/English/Mobile_Phone/(E.M)B-indoor/P090902018.jpg,char_data/u/P090902018.jpg_2.jpg,1908,480,640,36,452,488,311,364,True,45
u,54,kaist_dataset/English/Mobile_Phone/(E.M)B-indoor/P090911060.jpg,char_data/u/P090911060.jpg_2.jpg,2160,480,640,40,188,228,19,73,True,45
u,74,kaist_dataset/English/Mobile_Phone/(E.M)B-indoor/P090911083.jpg,char_data/u/P090911083.jpg_2.jpg,4366,480,640,59,444,503,224,298,True,45
u,73,kaist_dataset/English/Mobile_Phone/(E.M)C-bookCover/P090831039.jpg,char_data/u/P090831039.jpg_2.jpg,3723,480,640,51,138,189,233,306,True,45
u,25,kaist_dataset/Korean/Digital_Camera/A-shadow/2007-12-09-day-exterior-031.jpg,char_data/u/2007-12-09-day-exterior-031.jpg_2.jpg,400,1200,1600,16,513,529,618,643,True,45
u,42,kaist_dataset/Korean/Digital_Camera/G-others/2007-12-08-day-112.jpg,char_data/u/2007-12-08-day-112.jpg_4.jpg,756,1200,1600,18,678,696,585,627,True,45
u,47,kaist_dataset/Korean/Digital_Camera/G-others/2007-12-08-day-112.jpg,char_data/u/2007-12-08-day-112.jpg_5.jpg,799,1200,1600,17,771,788,538,585,True,45
u,13,kaist_dataset/Korean/Digital_Camera/indoor1/080119-0029.jpg,char_data/u/080119-0029.jpg_6.jpg,169,1200,1600,13,281,294,591,604,True,45
u,22,kaist_dataset/Korean/Digital_Camera/indoor1/080119-0029.jpg,char_data/u/080119-0029.jpg_7.jpg,286,1200,1600,13,767,780,658,680,True,45
u,24,kaist_dataset/Korean/Digital_Camera/indoor1/080119-0029.jpg,char_data/u/080119-0029.jpg_8.jpg,360,1200,1600,15,866,881,659,683,True,45
u,49,kaist_dataset/Korean/Digital_Camera/outdoor1/2007-12-08-day-087.jpg,char_data/u/2007-12-08-day-087.jpg_2.jpg,1666,1200,1600,34,1194,1228,682,731,True,45
u,28,kaist_dataset/Korean/Digital_Camera/outdoor6/DSC04292.JPG,char_data/u/DSC04292.JPG_2.jpg,560,480,640,20,98,118,59,87,True,45
u,50,kaist_dataset/Mixed/Digital_Camera/(C.S)A-shadow/DSC03207.JPG,char_data/u/DSC03207.JPG_2.jpg,1850,480,640,37,444,481,211,261,True,45
u,35,kaist_dataset/Mixed/Digital_Camera/(C.S)B-light/134.JPG,char_data/u/134.JPG_2.jpg,630,480,640,18,211,229,293,328,True,45
u,20,kaist_dataset/Mixed/Digital_Camera/(C.S)C-outdoor1/003.JPG,char_data/u/003.JPG_2.jpg,160,480,640,8,181,189,266,286,True,45
u,117,kaist_dataset/Mixed/Digital_Camera/(C.S)C-outdoor1/080118-0014.jpg,char_data/u/080118-0014.jpg_2.jpg,11583,1200,1600,99,571,670,755,872,True,45
u,28,kaist_dataset/Mixed/Digital_Camera/(C.S)C-outdoor1/086.JPG,char_data/u/086.JPG_4.jpg,448,480,640,16,302,318,337,365,True,45
u,38,kaist_dataset/Mixed/Digital_Camera/(C.S)C-outdoor1/086.JPG,char_data/u/086.JPG_5.jpg,608,480,640,16,422,438,334,372,True,45
u,23,kaist_dataset/Mixed/Digital_Camera/(C.S)C-outdoor1/115.JPG,char_data/u/115.JPG_2.jpg,414,480,640,18,251,269,281,304,True,45
u,43,kaist_dataset/Mixed/Digital_Camera/(C.S)C-outdoor1/130.JPG,char_data/u/130.JPG_2.jpg,1376,480,640,32,257,289,296,339,True,45
u,20,kaist_dataset/Mixed/Digital_Camera/(C.S)C-outdoor1/2.JPG,char_data/u/2.JPG_7.jpg,120,576,768,6,108,114,384,404,True,45
u,58,kaist_dataset/Mixed/Digital_Camera/(C.S)C-outdoor1/2007-12-08-day-106.jpg,char_data/u/2007-12-08-day-106.jpg_2.jpg,2610,1200,1600,45,1001,1046,746,804,True,45
u,24,kaist_dataset/Mixed/Digital_Camera/(C.S)C-outdoor1/DSC02318.JPG,char_data/u/DSC02318.JPG_2.jpg,600,480,640,25,340,365,328,352,True,45
u,23,kaist_dataset/Mixed/Digital_Camera/(C.S)C-outdoor1/DSC02319.JPG,char_data/u/DSC02319.JPG_2.jpg,322,480,640,14,112,126,252,275,True,45
u,69,kaist_dataset/Mixed/Digital_Camera/(C.S)C-outdoor1/DSC02344.JPG,char_data/u/DSC02344.JPG_2.jpg,3105,480,640,45,469,514,164,233,True,45
u,62,kaist_dataset/Mixed/Digital_Camera/(C.S)C-outdoor2/DSC02416.JPG,char_data/u/DSC02416.JPG_2.jpg,3596,480,640,58,371,429,209,271,True,45
u,20,kaist_dataset/Mixed/Digital_Camera/(C.S)C-outdoor2/DSC02421.JPG,char_data/u/DSC02421.JPG_2.jpg,500,480,640,25,200,225,213,233,True,45
u,22,kaist_dataset/Mixed/Digital_Camera/(C.S)C-outdoor2/DSC02430.JPG,char_data/u/DSC02430.JPG_4.jpg,286,480,640,13,1,14,29,51,True,45
u,24,kaist_dataset/Mixed/Digital_Camera/(C.S)C-outdoor2/DSC02430.JPG,char_data/u/DSC02430.JPG_5.jpg,456,480,640,19,196,215,190,214,True,45
u,59,kaist_dataset/Mixed/Digital_Camera/(C.S)C-outdoor2/DSC02433.JPG,char_data/u/DSC02433.JPG_2.jpg,2124,480,640,36,78,114,191,250,True,45
u,67,kaist_dataset/Mixed/Digital_Camera/(C.S)C-outdoor2/DSC02436.JPG,char_data/u/DSC02436.JPG_2.jpg,2345,480,640,35,401,436,188,255,True,45
u,38,kaist_dataset/Mixed/Digital_Camera/(C.S)C-outdoor2/DSC02519.JPG,char_data/u/DSC02519.JPG_2.jpg,1368,480,640,36,174,210,234,272,True,45
u,73,kaist_dataset/Mixed/Digital_Camera/(C.S)C-outdoor2/DSC02701.JPG,char_data/u/DSC02701.JPG_2.jpg,4380,480,640,60,442,502,97,170,True,45
u,45,kaist_dataset/Mixed/Digital_Camera/(C.S)C-outdoor2/DSC02869.JPG,char_data/u/DSC02869.JPG_2.jpg,900,480,640,20,142,162,139,184,True,45
u,35,kaist_dataset/Mixed/Digital_Camera/(C.S)C-outdoor3/DSC03209.JPG,char_data/u/DSC03209.JPG_2.jpg,1050,480,640,30,390,420,417,452,True,45
u,32,kaist_dataset/Mixed/Digital_Camera/(C.S)C-outdoor3/DSC03227.JPG,char_data/u/DSC03227.JPG_2.jpg,640,480,640,20,177,197,106,138,True,45
u,78,kaist_dataset/Mixed/Digital_Camera/(C.S)C-outdoor3/DSC03260.JPG,char_data/u/DSC03260.JPG_2.jpg,4134,480,640,53,351,404,91,169,True,45
u,82,kaist_dataset/Mixed/Digital_Camera/(C.S)C-outdoor3/DSC03299.JPG,char_data/u/DSC03299.JPG_2.jpg,5166,480,640,63,341,404,385,467,True,45
u,82,kaist_dataset/Mixed/Digital_Camera/(C.S)C-outdoor3/DSC03421.JPG,char_data/u/DSC03421.JPG_2.jpg,3608,480,640,44,173,217,230,312,True,45
u,73,kaist_dataset/Mixed/Digital_Camera/(C.S)C-outdoor4/DSC03519.JPG,char_data/u/DSC03519.JPG_2.jpg,5548,480,640,76,339,415,237,310,True,45
u,30,kaist_dataset/Mixed/Digital_Camera/(C.S)C-outdoor4/DSC03556.JPG,char_data/u/DSC03556.JPG_2.jpg,390,480,640,13,448,461,321,351,True,45
u,79,kaist_dataset/Mixed/Digital_Camera/(C.S)C-outdoor4/DSC03572.JPG,char_data/u/DSC03572.JPG_4.jpg,4740,480,640,60,152,212,126,205,True,45
u,69,kaist_dataset/Mixed/Digital_Camera/(C.S)C-outdoor4/DSC03572.JPG,char_data/u/DSC03572.JPG_5.jpg,4416,480,640,64,337,401,134,203,True,45
u,41,kaist_dataset/Mixed/Digital_Camera/(C.S)C-outdoor4/DSC03642.JPG,char_data/u/DSC03642.JPG_2.jpg,820,480,640,20,230,250,253,294,True,45
u,52,kaist_dataset/Mixed/Digital_Camera/(C.S)C-outdoor4/DSC03643.JPG,char_data/u/DSC03643.JPG_2.jpg,1924,480,640,37,127,164,257,309,True,45
u,22,kaist_dataset/Mixed/Digital_Camera/(C.S)C-outdoor4/DSC03670.JPG,char_data/u/DSC03670.JPG_6.jpg,242,480,640,11,206,217,326,348,True,45
u,19,kaist_dataset/Mixed/Digital_Camera/(C.S)C-outdoor4/DSC03670.JPG,char_data/u/DSC03670.JPG_7.jpg,228,480,640,12,328,340,326,345,True,45
u,26,kaist_dataset/Mixed/Digital_Camera/(C.S)C-outdoor4/DSC03670.JPG,char_data/u/DSC03670.JPG_8.jpg,338,480,640,13,479,492,321,347,True,45
u,38,kaist_dataset/Mixed/Digital_Camera/(C.S)C-outdoor4/DSC03781.JPG,char_data/u/DSC03781.JPG_2.jpg,1748,480,640,46,295,341,320,358,True,45
u,59,kaist_dataset/Mixed/Digital_Camera/(C.S)C-outdoor4/DSC03784.JPG,char_data/u/DSC03784.JPG_2.jpg,1888,480,640,32,460,492,320,379,True,45
u,38,kaist_dataset/Mixed/Digital_Camera/(C.S)C-outdoor5/DSC03821.JPG,char_data/u/DSC03821.JPG_2.jpg,798,480,640,21,160,181,35,73,True,45
u,35,kaist_dataset/Mixed/Digital_Camera/(C.S)C-outdoor5/DSC03839.JPG,char_data/u/DSC03839.JPG_2.jpg,630,480,640,18,229,247,38,73,True,45
u,64,kaist_dataset/Mixed/Digital_Camera/(C.S)C-outdoor5/DSC04029.JPG,char_data/u/DSC04029.JPG_2.jpg,1920,480,640,30,239,269,170,234,True,45
u,28,kaist_dataset/Mixed/Digital_Camera/(C.S)C-outdoor5/DSC04057.JPG,char_data/u/DSC04057.JPG_2.jpg,616,480,640,22,282,304,120,148,True,45
u,32,kaist_dataset/Mixed/Digital_Camera/(C.S)C-outdoor5/DSC04069.JPG,char_data/u/DSC04069.JPG_6.jpg,608,480,640,19,249,268,423,455,True,45
u,33,kaist_dataset/Mixed/Digital_Camera/(C.S)C-outdoor5/DSC04069.JPG,char_data/u/DSC04069.JPG_7.jpg,627,480,640,19,425,444,420,453,True,45
u,31,kaist_dataset/Mixed/Digital_Camera/(C.S)C-outdoor5/DSC04069.JPG,char_data/u/DSC04069.JPG_8.jpg,651,480,640,21,463,484,382,413,True,45
u,30,kaist_dataset/Mixed/Digital_Camera/(C.S)C-outdoor5/DSC04290.JPG,char_data/u/DSC04290.JPG_2.jpg,600,480,640,20,97,117,382,412,True,45
u,40,kaist_dataset/Mixed/Digital_Camera/(C.S)C-outdoor5/DSC04321.JPG,char_data/u/DSC04321.JPG_4.jpg,880,480,640,22,79,101,189,229,True,45
u,109,kaist_dataset/Mixed/Digital_Camera/(C.S)C-outdoor5/DSC04349.JPG,char_data/u/DSC04349.JPG_2.jpg,7630,480,640,70,322,392,74,183,True,45
u,24,kaist_dataset/Mixed/Digital_Camera/(C.S)C-outdoor5/DSC04357.JPG,char_data/u/DSC04357.JPG_2.jpg,432,480,640,18,485,503,356,380,True,45
u,33,kaist_dataset/Mixed/Digital_Camera/(C.S)C-outdoor5/DSC04429.JPG,char_data/u/DSC04429.JPG_2.jpg,627,480,640,19,264,283,255,288,False,45
u,43,kaist_dataset/Mixed/Digital_Camera/(C.S)C-outdoor5/DSC04456.JPG,char_data/u/DSC04456.JPG_2.jpg,1204,480,640,28,389,417,173,216,False,45
u,26,kaist_dataset/Mixed/Digital_Camera/(C.S)C-outdoor6/P1010048.JPG,char_data/u/P1010048.JPG_2.jpg,468,480,640,18,535,553,173,199,False,45
u,43,kaist_dataset/Mixed/Digital_Camera/(C.S)C-outdoor6/P1010052.JPG,char_data/u/P1010052.JPG_2.jpg,1720,480,640,40,432,472,134,177,False,45
u,25,kaist_dataset/Mixed/Digital_Camera/(C.S)C-outdoor6/P1010138.JPG,char_data/u/P1010138.JPG_2.jpg,525,480,640,21,150,171,182,207,False,45
u,35,kaist_dataset/Mixed/Digital_Camera/(C.S)D-indoor1/082.JPG,char_data/u/082.JPG_2.jpg,1050,480,640,30,483,513,181,216,False,45
u,51,kaist_dataset/Mixed/Digital_Camera/(C.S)D-indoor1/DSC02770.JPG,char_data/u/DSC02770.JPG_2.jpg,1938,480,640,38,438,476,360,411,False,45
u,40,kaist_dataset/Mixed/Digital_Camera/(C.S)D-indoor1/DSC02787.JPG,char_data/u/DSC02787.JPG_2.jpg,760,480,640,19,516,535,358,398,False,45
u,32,kaist_dataset/Mixed/Digital_Camera/(C.S)D-indoor1/DSC02804.JPG,char_data/u/DSC02804.JPG_2.jpg,576,480,640,18,299,317,357,389,False,45
u,35,kaist_dataset/Mixed/Digital_Camera/(C.S)D-indoor1/DSC03118.JPG,char_data/u/DSC03118.JPG_2.jpg,980,480,640,28,410,438,231,266,False,45
u,48,kaist_dataset/Mixed/Digital_Camera/(C.S)D-indoor1/DSC03121.JPG,char_data/u/DSC03121.JPG_2.jpg,1536,480,640,32,235,267,202,250,False,45
u,29,kaist_dataset/Mixed/Digital_Camera/(C.S)D-indoor1/DSC03122.JPG,char_data/u/DSC03122.JPG_2.jpg,725,480,640,25,386,411,156,185,False,45
u,37,kaist_dataset/Mixed/Digital_Camera/(C.S)D-indoor1/DSC03124.JPG,char_data/u/DSC03124.JPG_2.jpg,1110,480,640,30,307,337,202,239,False,45
u,35,kaist_dataset/Mixed/Digital_Camera/(C.S)D-indoor1/DSC03132.JPG,char_data/u/DSC03132.JPG_4.jpg,945,480,640,27,170,197,181,216,False,45
u,42,kaist_dataset/Mixed/Digital_Camera/(C.S)D-indoor1/DSC03132.JPG,char_data/u/DSC03132.JPG_5.jpg,1134,480,640,27,246,273,245,287,False,45
u,48,kaist_dataset/Mixed/Digital_Camera/(C.S)D-indoor1/DSC03460.JPG,char_data/u/DSC03460.JPG_2.jpg,1536,480,640,32,307,339,395,443,False,45
u,71,kaist_dataset/Mixed/Digital_Camera/(C.S)D-indoor1/DSC03501.JPG,char_data/u/DSC03501.JPG_2.jpg,4118,480,640,58,420,478,224,295,False,45
u,42,kaist_dataset/Mixed/Digital_Camera/(C.S)D-indoor1/DSC04183.JPG,char_data/u/DSC04183.JPG_2.jpg,882,480,640,21,325,346,253,295,False,45
u,27,kaist_dataset/Mixed/Digital_Camera/(C.S)D-indoor2/DSC04254.JPG,char_data/u/DSC04254.JPG_7.jpg,540,480,640,20,244,264,348,375,False,45
u,34,kaist_dataset/Mixed/Digital_Camera/(C.S)D-indoor2/DSC04254.JPG,char_data/u/DSC04254.JPG_8.jpg,578,480,640,17,367,384,340,374,False,45
u,42,kaist_dataset/Mixed/Digital_Camera/(C.S)E-night/DSC02574.JPG,char_data/u/DSC02574.JPG_2.jpg,1218,480,640,29,473,502,151,193,False,45
u,31,kaist_dataset/Mixed/Digital_Camera/(C.S)E-night/DSC03031.JPG,char_data/u/DSC03031.JPG_2.jpg,496,480,640,16,222,238,26,57,False,45
u,17,kaist_dataset/Mixed/Digital_Camera/(C.S)E-night/DSC03516.JPG,char_data/u/DSC03516.JPG_2.jpg,306,480,640,18,106,124,142,159,False,45
u,35,kaist_dataset/Mixed/Digital_Camera/(C.S)F-others/2007-12-08-day-067.jpg,char_data/u/2007-12-08-day-067.jpg_4.jpg,1750,1600,1200,50,441,491,891,926,False,45
u,40,kaist_dataset/Mixed/Digital_Camera/(C.S)F-others/2007-12-08-day-067.jpg,char_data/u/2007-12-08-day-067.jpg_5.jpg,2000,1600,1200,50,443,493,806,846,False,45
u,61,kaist_dataset/Mixed/Digital_Camera/(C.S)F-others/DSC02696.JPG,char_data/u/DSC02696.JPG_2.jpg,3233,480,640,53,404,457,311,372,False,45
u,75,kaist_dataset/Mixed/Digital_Camera/(C.S)F-others/DSC03489.JPG,char_data/u/DSC03489.JPG_2.jpg,3525,480,640,47,447,494,362,437,False,45
u,34,kaist_dataset/Mixed/Mobile_Phone/(C.M)A-outdoor/P090912078.jpg,char_data/u/P090912078.jpg_2.jpg,918,480,640,27,59,86,318,352,False,45
u,33,kaist_dataset/Mixed/Mobile_Phone/(C.M)B-indoor/P090831005.jpg,char_data/u/P090831005.jpg_4.jpg,528,480,640,16,286,302,243,276,False,45
u,37,kaist_dataset/Mixed/Mobile_Phone/(C.M)B-indoor/P090831005.jpg,char_data/u/P090831005.jpg_5.jpg,555,480,640,15,164,179,234,271,False,45
u,83,kaist_dataset/Mixed/Mobile_Phone/(C.M)B-indoor/P090831008.jpg,char_data/u/P090831008.jpg_2.jpg,3984,480,640,48,163,211,308,391,False,45
u,44,kaist_dataset/Mixed/Mobile_Phone/(C.M)B-indoor/P090831012.jpg,char_data/u/P090831012.jpg_2.jpg,1540,480,640,35,316,351,183,227,False,45
u,43,kaist_dataset/Mixed/Mobile_Phone/(C.M)B-indoor/P090831013.jpg,char_data/u/P090831013.jpg_5.jpg,1806,480,640,42,413,455,201,244,False,45
u,33,kaist_dataset/Mixed/Mobile_Phone/(C.M)C-bookCover/P090831080.jpg,char_data/u/P090831080.jpg_2.jpg,924,480,640,28,335,363,412,445,False,45
u,32,kaist_dataset/Mixed/Mobile_Phone/(C.M)C-bookCover/P090903024.jpg,char_data/u/P090903024.jpg_2.jpg,1056,480,640,33,388,421,176,208,False,45
u,50,kaist_dataset/Mixed/Mobile_Phone/(C.M)C-bookCover/P090903083.jpg,char_data/u/P090903083.jpg_2.jpg,2050,480,640,41,317,358,176,226,False,45
주,29,kaist_dataset/English/Digital_Camera/(E.S)B-light/080116-0059.jpg,char_data/주/080116-0059.jpg_2.jpg,580,1200,1600,20,755,775,951,980,True,81
주,29,kaist_dataset/English/Digital_Camera/(E.S)C-outdoor1/109.jpg,char_data/주/109.jpg_2.jpg,870,480,640,30,17,47,245,274,True,81
주,104,kaist_dataset/Korean/Digital_Camera/A-shadow/DSC03342.JPG,char_data/주/DSC03342.JPG_2.jpg,9776,480,640,94,95,189,192,296,True,81
주,55,kaist_dataset/Korean/Digital_Camera/A-shadow/DSC03535.JPG,char_data/주/DSC03535.JPG_2.jpg,2035,480,640,37,43,80,264,319,True,81
주,89,kaist_dataset/Korean/Digital_Camera/A-shadow/DSC04320.JPG,char_data/주/DSC04320.JPG_2.jpg,3026,480,640,34,259,293,161,250,True,81
주,71,kaist_dataset/Korean/Digital_Camera/A-shadow/P1010034.JPG,char_data/주/P1010034.JPG_2.jpg,4828,480,640,68,361,429,313,384,True,81
주,58,kaist_dataset/Korean/Digital_Camera/A-shadow/P1010064.JPG,char_data/주/P1010064.JPG_2.jpg,2726,480,640,47,269,316,210,268,True,81
주,100,kaist_dataset/Korean/Digital_Camera/B-light/DSC03494.JPG,char_data/주/DSC03494.JPG_2.jpg,6500,480,640,65,160,225,299,399,True,81
주,42,kaist_dataset/Korean/Digital_Camera/E-night/074.jpg,char_data/주/074.jpg_4.jpg,1134,363,490,27,289,316,265,307,True,81
주,45,kaist_dataset/Korean/Digital_Camera/E-night/074.jpg,char_data/주/074.jpg_5.jpg,1125,363,490,25,210,235,261,306,True,81
주,113,kaist_dataset/Korean/Digital_Camera/E-night/DSC02615.JPG,char_data/주/DSC02615.JPG_4.jpg,15029,480,640,133,374,507,94,207,True,81
주,95,kaist_dataset/Korean/Digital_Camera/E-night/DSC02615.JPG,char_data/주/DSC02615.JPG_5.jpg,8645,480,640,91,382,473,259,354,True,81
주,134,kaist_dataset/Korean/Digital_Camera/E-night/DSC02642.JPG,char_data/주/DSC02642.JPG_2.jpg,11658,480,640,87,516,603,262,396,True,81
주,246,kaist_dataset/Korean/Digital_Camera/G-others/2007-12-09-day-exterior-028.jpg,char_data/주/2007-12-09-day-exterior-028.jpg_2.jpg,84378,1600,1200,343,452,795,287,533,True,81
주,55,kaist_dataset/Korean/Digital_Camera/G-others/DSC02584.JPG,char_data/주/DSC02584.JPG_4.jpg,3850,480,640,70,224,294,400,455,True,81
주,55,kaist_dataset/Korean/Digital_Camera/G-others/DSC02584.JPG,char_data/주/DSC02584.JPG_5.jpg,3630,480,640,66,405,471,407,462,True,81
주,47,kaist_dataset/Korean/Digital_Camera/G-others/DSC03065.JPG,char_data/주/DSC03065.JPG_2.jpg,3102,480,640,66,254,320,245,292,True,81
주,117,kaist_dataset/Korean/Digital_Camera/G-others/DSC03226.JPG,char_data/주/DSC03226.JPG_2.jpg,15912,480,640,136,132,268,82,199,True,81
주,93,kaist_dataset/Korean/Digital_Camera/indoor1/2007-12-08-day-139.jpg,char_data/주/2007-12-08-day-139.jpg_2.jpg,8463,1200,1600,91,891,982,635,728,True,81
주,105,kaist_dataset/Korean/Digital_Camera/indoor1/DSC02699.JPG,char_data/주/DSC02699.JPG_2.jpg,8820,480,640,84,154,238,93,198,True,81
주,121,kaist_dataset/Korean/Digital_Camera/indoor1/DSC02722.JPG,char_data/주/DSC02722.JPG_2.jpg,11011,480,640,91,197,288,211,332,True,81
주,126,kaist_dataset/Korean/Digital_Camera/indoor1/DSC02727.JPG,char_data/주/DSC02727.JPG_2.jpg,10836,480,640,86,181,267,98,224,True,81
주,138,kaist_dataset/Korean/Digital_Camera/indoor1/DSC02738.JPG,char_data/주/DSC02738.JPG_2.jpg,19872,480,640,144,37,181,222,360,True,81
주,101,kaist_dataset/Korean/Digital_Camera/indoor1/DSC02778.JPG,char_data/주/DSC02778.JPG_2.jpg,8787,480,640,87,44,131,282,383,True,81
주,50,kaist_dataset/Korean/Digital_Camera/indoor2/DSC03484.JPG,char_data/주/DSC03484.JPG_2.jpg,1900,480,640,38,397,435,124,174,True,81
주,59,kaist_dataset/Korean/Digital_Camera/indoor2/DSC03557.JPG,char_data/주/DSC03557.JPG_2.jpg,4248,480,640,72,66,138,109,168,True,81
주,55,kaist_dataset/Korean/Digital_Camera/indoor2/DSC03974.JPG,char_data/주/DSC03974.JPG_2.jpg,2640,480,640,48,348,396,207,262,True,81
주,34,kaist_dataset/Korean/Digital_Camera/indoor2/DSC03975.JPG,char_data/주/DSC03975.JPG_2.jpg,748,480,640,22,67,89,295,329,True,81
주,44,kaist_dataset/Korean/Digital_Camera/outdoor1/016.JPG,char_data/주/016.JPG_2.jpg,1980,480,640,45,154,199,196,240,True,81
주,36,kaist_dataset/Korean/Digital_Camera/outdoor1/057.JPG,char_data/주/057.JPG_2.jpg,684,480,640,19,450,469,300,336,True,81
주,50,kaist_dataset/Korean/Digital_Camera/outdoor1/061.JPG,char_data/주/061.JPG_2.jpg,2050,480,640,41,337,378,202,252,True,81
주,38,kaist_dataset/Korean/Digital_Camera/outdoor1/092.JPG,char_data/주/092.JPG_2.jpg,1786,480,640,47,4,51,245,283,True,81
주,57,kaist_dataset/Korean/Digital_Camera/outdoor1/2007-12-08-day-050.jpg,char_data/주/2007-12-08-day-050.jpg_2.jpg,1995,1200,1600,35,1157,1192,726,783,True,81
주,59,kaist_dataset/Korean/Digital_Camera/outdoor1/2007-12-08-day-056.jpg,char_data/주/2007-12-08-day-056.jpg_4.jpg,2714,1200,1600,46,642,688,406,465,True,81
주,50,kaist_dataset/Korean/Digital_Camera/outdoor1/2007-12-08-day-056.jpg,char_data/주/2007-12-08-day-056.jpg_5.jpg,2250,1200,1600,45,766,811,401,451,True,81
주,120,kaist_dataset/Korean/Digital_Camera/outdoor2/2007-12-08-day-114.jpg,char_data/주/2007-12-08-day-114.jpg_4.jpg,9480,1200,1600,79,345,424,163,283,True,81
주,113,kaist_dataset/Korean/Digital_Camera/outdoor2/2007-12-08-day-114.jpg,char_data/주/2007-12-08-day-114.jpg_5.jpg,9153,1200,1600,81,615,696,176,289,True,81
주,81,kaist_dataset/Korean/Digital_Camera/outdoor2/DSC02424.JPG,char_data/주/DSC02424.JPG_2.jpg,4536,480,640,56,83,139,164,245,True,81
주,99,kaist_dataset/Korean/Digital_Camera/outdoor2/DSC02453.JPG,char_data/주/DSC02453.JPG_2.jpg,7821,480,640,79,197,276,113,212,True,81
주,138,kaist_dataset/Korean/Digital_Camera/outdoor2/DSC02520.JPG,char_data/주/DSC02520.JPG_2.jpg,15042,480,640,109,100,209,146,284,True,81
주,105,kaist_dataset/Korean/Digital_Camera/outdoor3/DSC02541.JPG,char_data/주/DSC02541.JPG_2.jpg,7245,480,640,69,360,429,278,383,True,81
주,28,kaist_dataset/Korean/Digital_Camera/outdoor3/DSC02561.JPG,char_data/주/DSC02561.JPG_2.jpg,840,480,640,30,200,230,162,190,True,81
주,47,kaist_dataset/Korean/Digital_Camera/outdoor3/DSC02943.JPG,char_data/주/DSC02943.JPG_2.jpg,2303,480,640,49,177,226,368,415,True,81
주,52,kaist_dataset/Korean/Digital_Camera/outdoor3/DSC02944.JPG,char_data/주/DSC02944.JPG_2.jpg,3068,480,640,59,198,257,175,227,True,81
주,86,kaist_dataset/Korean/Digital_Camera/outdoor3/DSC02968.JPG,char_data/주/DSC02968.JPG_2.jpg,4988,480,640,58,259,317,86,172,True,81
주,68,kaist_dataset/Korean/Digital_Camera/outdoor3/DSC02999.JPG,char_data/주/DSC02999.JPG_2.jpg,4488,480,640,66,172,238,340,408,True,81
주,69,kaist_dataset/Korean/Digital_Camera/outdoor3/DSC03181.JPG,char_data/주/DSC03181.JPG_4.jpg,3864,480,640,56,315,371,155,224,True,81
주,78,kaist_dataset/Korean/Digital_Camera/outdoor3/DSC03181.JPG,char_data/주/DSC03181.JPG_5.jpg,4290,480,640,55,51,106,249,327,True,81
주,80,kaist_dataset/Korean/Digital_Camera/outdoor3/DSC03183.JPG,char_data/주/DSC03183.JPG_2.jpg,6160,480,640,77,238,315,329,409,True,81
주,92,kaist_dataset/Korean/Digital_Camera/outdoor3/DSC03213.JPG,char_data/주/DSC03213.JPG_2.jpg,7360,480,640,80,354,434,106,198,True,81
주,82,kaist_dataset/Korean/Digital_Camera/outdoor3/DSC03214.JPG,char_data/주/DSC03214.JPG_2.jpg,6150,480,640,75,251,326,78,160,True,81
주,139,kaist_dataset/Korean/Digital_Camera/outdoor3/DSC03240.JPG,char_data/주/DSC03240.JPG_2.jpg,17236,480,640,124,96,220,102,241,True,81
주,71,kaist_dataset/Korean/Digital_Camera/outdoor4/DSC03253.JPG,char_data/주/DSC03253.JPG_2.jpg,4331,480,640,61,553,614,304,375,True,81
주,106,kaist_dataset/Korean/Digital_Camera/outdoor4/DSC03405.JPG,char_data/주/DSC03405.JPG_2.jpg,9222,480,640,87,245,332,302,408,True,81
주,67,kaist_dataset/Korean/Digital_Camera/outdoor4/DSC03442.JPG,char_data/주/DSC03442.JPG_2.jpg,3350,480,640,50,192,242,71,138,True,81
주,144,kaist_dataset/Korean/Digital_Camera/outdoor4/DSC03452.JPG,char_data/주/DSC03452.JPG_2.jpg,4464,480,640,31,97,128,109,253,True,81
주,50,kaist_dataset/Korean/Digital_Camera/outdoor4/DSC03538.JPG,char_data/주/DSC03538.JPG_2.jpg,2200,480,640,44,491,535,112,162,True,81
주,52,kaist_dataset/Korean/Digital_Camera/outdoor4/DSC03578.JPG,char_data/주/DSC03578.JPG_2.jpg,884,480,640,17,448,465,144,196,True,81
주,42,kaist_dataset/Korean/Digital_Camera/outdoor4/DSC03588.JPG,char_data/주/DSC03588.JPG_8.jpg,1890,480,640,45,228,273,5,47,True,81
주,40,kaist_dataset/Korean/Digital_Camera/outdoor4/DSC03588.JPG,char_data/주/DSC03588.JPG_9.jpg,1560,480,640,39,413,452,10,50,True,81
주,44,kaist_dataset/Korean/Digital_Camera/outdoor4/DSC03588.JPG,char_data/주/DSC03588.JPG_10.jpg,1716,480,640,39,354,393,50,94,True,81
주,54,kaist_dataset/Korean/Digital_Camera/outdoor4/DSC03588.JPG,char_data/주/DSC03588.JPG_11.jpg,2268,480,640,42,179,221,160,214,True,81
주,59,kaist_dataset/Korean/Digital_Camera/outdoor4/DSC03605.JPG,char_data/주/DSC03605.JPG_2.jpg,2891,480,640,49,237,286,227,286,True,81
주,77,kaist_dataset/Korean/Digital_Camera/outdoor4/DSC03607.JPG,char_data/주/DSC03607.JPG_2.jpg,5313,480,640,69,236,305,354,431,True,81
주,93,kaist_dataset/Korean/Digital_Camera/outdoor5/DSC03623.JPG,char_data/주/DSC03623.JPG_2.jpg,9021,480,640,97,139,236,234,327,True,81
주,81,kaist_dataset/Korean/Digital_Camera/outdoor5/DSC03659.JPG,char_data/주/DSC03659.JPG_6.jpg,5265,480,640,65,146,211,33,114,True,81
주,92,kaist_dataset/Korean/Digital_Camera/outdoor5/DSC03659.JPG,char_data/주/DSC03659.JPG_7.jpg,8372,480,640,91,81,172,115,207,True,81
주,72,kaist_dataset/Korean/Digital_Camera/outdoor5/DSC03659.JPG,char_data/주/DSC03659.JPG_8.jpg,4968,480,640,69,411,480,233,305,True,81
주,124,kaist_dataset/Korean/Digital_Camera/outdoor5/DSC03713.JPG,char_data/주/DSC03713.JPG_2.jpg,10044,480,640,81,21,102,185,309,True,81
주,76,kaist_dataset/Korean/Digital_Camera/outdoor5/DSC03727.JPG,char_data/주/DSC03727.JPG_2.jpg,4636,480,640,61,63,124,394,470,True,81
주,64,kaist_dataset/Korean/Digital_Camera/outdoor5/DSC03739.JPG,char_data/주/DSC03739.JPG_2.jpg,4736,480,640,74,171,245,207,271,True,81
주,89,kaist_dataset/Korean/Digital_Camera/outdoor5/DSC03746.JPG,char_data/주/DSC03746.JPG_6.jpg,6764,480,640,76,192,268,42,131,True,81
주,145,kaist_dataset/Korean/Digital_Camera/outdoor5/DSC03746.JPG,char_data/주/DSC03746.JPG_7.jpg,17545,480,640,121,89,210,151,296,True,81
주,41,kaist_dataset/Korean/Digital_Camera/outdoor5/DSC03746.JPG,char_data/주/DSC03746.JPG_8.jpg,1845,480,640,45,275,320,362,403,True,81
주,118,kaist_dataset/Korean/Digital_Camera/outdoor5/DSC03832.JPG,char_data/주/DSC03832.JPG_2.jpg,14278,480,640,121,114,235,209,327,True,81
주,37,kaist_dataset/Korean/Digital_Camera/outdoor5/DSC03834.JPG,char_data/주/DSC03834.JPG_2.jpg,1702,480,640,46,348,394,299,336,True,81
주,52,kaist_dataset/Korean/Digital_Camera/outdoor5/DSC03844.JPG,char_data/주/DSC03844.JPG_2.jpg,2132,480,640,41,335,376,234,286,True,81
주,88,kaist_dataset/Korean/Digital_Camera/outdoor5/DSC03848.JPG,char_data/주/DSC03848.JPG_2.jpg,5456,480,640,62,324,386,80,168,True,81
주,157,kaist_dataset/Korean/Digital_Camera/outdoor5/DSC03860.JPG,char_data/주/DSC03860.JPG_2.jpg,19468,480,640,124,334,458,55,212,True,81
주,98,kaist_dataset/Korean/Digital_Camera/outdoor5/DSC03864.JPG,char_data/주/DSC03864.JPG_2.jpg,6076,480,640,62,329,391,53,151,True,81
주,112,kaist_dataset/Korean/Digital_Camera/outdoor5/DSC03868.JPG,char_data/주/DSC03868.JPG_2.jpg,8400,480,640,75,163,238,228,340,True,81
주,69,kaist_dataset/Korean/Digital_Camera/outdoor6/DSC04067.JPG,char_data/주/DSC04067.JPG_2.jpg,3519,480,640,51,124,175,184,253,True,81
주,64,kaist_dataset/Korean/Digital_Camera/outdoor6/DSC04073.JPG,char_data/주/DSC04073.JPG_2.jpg,3008,480,640,47,146,193,33,97,True,81
주,47,kaist_dataset/Korean/Digital_Camera/outdoor6/DSC04089.JPG,char_data/주/DSC04089.JPG_2.jpg,1269,480,640,27,105,132,266,313,True,81
주,82,kaist_dataset/Korean/Digital_Camera/outdoor6/DSC04093.JPG,char_data/주/DSC04093.JPG_2.jpg,5986,480,640,73,226,299,348,430,True,81
주,91,kaist_dataset/Korean/Digital_Camera/outdoor6/DSC04101.JPG,char_data/주/DSC04101.JPG_2.jpg,6916,480,640,76,117,193,367,458,True,81
주,101,kaist_dataset/Korean/Digital_Camera/outdoor6/DSC04114.JPG,char_data/주/DSC04114.JPG_4.jpg,6060,480,640,60,2,62,343,444,True,81
주,89,kaist_dataset/Korean/Digital_Camera/outdoor6/DSC04114.JPG,char_data/주/DSC04114.JPG_5.jpg,6497,480,640,73,453,526,337,426,True,81
주,43,kaist_dataset/Korean/Digital_Camera/outdoor6/DSC04148.JPG,char_data/주/DSC04148.JPG_2.jpg,1763,480,640,41,179,220,202,245,True,81
주,90,kaist_dataset/Korean/Digital_Camera/outdoor7/P1010013.JPG,char_data/주/P1010013.JPG_2.jpg,3420,480,640,38,47,85,99,189,True,81
주,172,kaist_dataset/Korean/Digital_Camera/outdoor7/P1010014.JPG,char_data/주/P1010014.JPG_2.jpg,9804,480,640,57,53,110,141,313,True,81
주,41,kaist_dataset/Korean/Digital_Camera/outdoor7/P1010019.JPG,char_data/주/P1010019.JPG_2.jpg,2050,480,640,50,255,305,246,287,True,81
주,118,kaist_dataset/Korean/Digital_Camera/outdoor7/P1010021.JPG,char_data/주/P1010021.JPG_2.jpg,17228,480,640,146,153,299,269,387,True,81
주,96,kaist_dataset/Korean/Digital_Camera/outdoor7/P1010043.JPG,char_data/주/P1010043.JPG_2.jpg,8064,480,640,84,191,275,198,294,True,81
주,61,kaist_dataset/Korean/Digital_Camera/outdoor7/P1010047.JPG,char_data/주/P1010047.JPG_2.jpg,3721,480,640,61,191,252,115,176,True,81
주,107,kaist_dataset/Korean/Digital_Camera/outdoor7/P1010056.JPG,char_data/주/P1010056.JPG_4.jpg,5136,480,640,48,127,175,145,252,True,81
주,117,kaist_dataset/Korean/Digital_Camera/outdoor7/P1010056.JPG,char_data/주/P1010056.JPG_5.jpg,5265,480,640,45,341,386,134,251,True,81
주,75,kaist_dataset/Korean/Digital_Camera/outdoor7/P1010122.JPG,char_data/주/P1010122.JPG_4.jpg,5325,480,640,71,1,71,102,177,True,81
주,112,kaist_dataset/Korean/Digital_Camera/outdoor7/P1010122.JPG,char_data/주/P1010122.JPG_5.jpg,7952,480,640,71,171,242,36,148,True,81
주,61,kaist_dataset/Korean/Digital_Camera/outdoor7/P1010124.JPG,char_data/주/P1010124.JPG_2.jpg,5978,480,640,98,224,322,89,150,True,81
주,209,kaist_dataset/Korean/Digital_Camera/outdoor8/2007-12-08-day-132.jpg,char_data/주/2007-12-08-day-132.jpg_2.jpg,21109,1200,1600,101,435,536,517,726,True,81
주,73,kaist_dataset/Korean/Digital_Camera/outdoor8/DSC02929.JPG,char_data/주/DSC02929.JPG_2.jpg,6059,480,640,83,257,340,125,198,True,81
주,60,"kaist_dataset/Korean/Mobile_Phone/(M,K)D-indoor/P090911065.jpg",char_data/주/P090911065.jpg_2.jpg,3780,480,640,63,327,390,12,72,True,81
주,39,"kaist_dataset/Korean/Mobile_Phone/(M,K)D-indoor/P090911066.jpg",char_data/주/P090911066.jpg_2.jpg,1521,480,640,39,83,122,389,428,True,81
주,43,"kaist_dataset/Korean/Mobile_Phone/(M,K)E-bookCover/P090831033.jpg",char_data/주/P090831033.jpg_2.jpg,1763,480,640,41,505,546,355,398,True,81
주,192,"kaist_dataset/Korean/Mobile_Phone/(M,K)E-bookCover/P090831072.jpg",char_data/주/P090831072.jpg_2.jpg,32256,480,640,168,312,480,177,369,True,81
주,40,"kaist_dataset/Korean/Mobile_Phone/(M,K)E-bookCover/P090831104.jpg",char_data/주/P090831104.jpg_2.jpg,1240,480,640,31,574,605,280,320,True,81
주,44,"kaist_dataset/Korean/Mobile_Phone/(M,K)E-bookCover/P090831108.jpg",char_data/주/P090831108.jpg_4.jpg,1188,480,640,27,28,55,266,310,True,81
주,30,"kaist_dataset/Korean/Mobile_Phone/(M,K)E-bookCover/P090831108.jpg",char_data/주/P090831108.jpg_5.jpg,1020,480,640,34,571,605,267,297,True,81
주,82,"kaist_dataset/Korean/Mobile_Phone/(M,K)E-bookCover/P090831155.jpg",char_data/주/P090831155.jpg_2.jpg,5494,480,640,67,268,335,184,266,True,81
주,131,"kaist_dataset/Korean/Mobile_Phone/(M,K)E-bookCover/P090911007.jpg",char_data/주/P090911007.jpg_2.jpg,10218,480,640,78,215,293,272,403,True,81
주,83,"kaist_dataset/Korean/Mobile_Phone/(M,K)E-bookCover/P090912005.jpg",char_data/주/P090912005.jpg_2.jpg,3403,480,640,41,232,273,22,105,True,81
주,99,kaist_dataset/Mixed/Digital_Camera/(C.S)A-shadow/DSC02609.JPG,char_data/주/DSC02609.JPG_4.jpg,5148,480,640,52,89,141,221,320,True,81
주,111,kaist_dataset/Mixed/Digital_Camera/(C.S)A-shadow/DSC03305.JPG,char_data/주/DSC03305.JPG_2.jpg,6549,480,640,59,367,426,200,311,True,81
주,64,kaist_dataset/Mixed/Digital_Camera/(C.S)C-outdoor1/014.JPG,char_data/주/014.JPG_2.jpg,2496,480,640,39,482,521,192,256,True,81
주,124,kaist_dataset/Mixed/Digital_Camera/(C.S)C-outdoor1/080119-0033.jpg,char_data/주/080119-0033.jpg_2.jpg,13268,1200,1600,107,1146,1253,141,265,True,81
주,32,kaist_dataset/Mixed/Digital_Camera/(C.S)C-outdoor1/090.JPG,char_data/주/090.JPG_2.jpg,1248,480,640,39,139,178,386,418,True,81
주,61,kaist_dataset/Mixed/Digital_Camera/(C.S)C-outdoor1/1.JPG,char_data/주/1.JPG_2.jpg,3965,576,768,65,495,560,345,406,True,81
주,123,kaist_dataset/Mixed/Digital_Camera/(C.S)C-outdoor1/105.jpg,char_data/주/105.jpg_2.jpg,8487,480,640,69,291,360,93,216,True,81
주,114,kaist_dataset/Mixed/Digital_Camera/(C.S)C-outdoor1/2007-12-09-day-exterior-037.jpg,char_data/주/2007-12-09-day-exterior-037.jpg_2.jpg,4560,1200,1600,40,612,652,232,346,True,81
주,52,kaist_dataset/Mixed/Digital_Camera/(C.S)C-outdoor1/2007-12-09-day-exterior-078.jpg,char_data/주/2007-12-09-day-exterior-078.jpg_2.jpg,2236,1200,1600,43,934,977,370,422,True,81
주,50,kaist_dataset/Mixed/Digital_Camera/(C.S)C-outdoor1/DSC02319.JPG,char_data/주/DSC02319.JPG_2.jpg,1950,480,640,39,391,430,68,118,True,81
주,97,kaist_dataset/Mixed/Digital_Camera/(C.S)C-outdoor1/DSC02323.JPG,char_data/주/DSC02323.JPG_6.jpg,8148,480,640,84,289,373,123,220,True,81
주,41,kaist_dataset/Mixed/Digital_Camera/(C.S)C-outdoor1/DSC02323.JPG,char_data/주/DSC02323.JPG_7.jpg,2173,480,640,53,64,117,352,393,True,81
주,47,kaist_dataset/Mixed/Digital_Camera/(C.S)C-outdoor1/DSC02323.JPG,char_data/주/DSC02323.JPG_8.jpg,1974,480,640,42,302,344,233,280,True,81
주,64,kaist_dataset/Mixed/Digital_Camera/(C.S)C-outdoor2/DSC02389.JPG,char_data/주/DSC02389.JPG_2.jpg,2304,480,640,36,404,440,321,385,True,81
주,71,kaist_dataset/Mixed/Digital_Camera/(C.S)C-outdoor2/DSC02869.JPG,char_data/주/DSC02869.JPG_2.jpg,2556,480,640,36,246,282,61,132,True,81
주,72,kaist_dataset/Mixed/Digital_Camera/(C.S)C-outdoor2/DSC02872.JPG,char_data/주/DSC02872.JPG_2.jpg,3528,480,640,49,240,289,141,213,True,81
주,100,kaist_dataset/Mixed/Digital_Camera/(C.S)C-outdoor2/DSC02907.JPG,char_data/주/DSC02907.JPG_2.jpg,7900,480,640,79,290,369,373,473,True,81
주,67,kaist_dataset/Mixed/Digital_Camera/(C.S)C-outdoor2/DSC02922.JPG,char_data/주/DSC02922.JPG_2.jpg,2613,480,640,39,209,248,248,315,True,81
주,56,kaist_dataset/Mixed/Digital_Camera/(C.S)C-outdoor3/DSC03010.JPG,char_data/주/DSC03010.JPG_2.jpg,1736,480,640,31,251,282,93,149,True,81
주,81,kaist_dataset/Mixed/Digital_Camera/(C.S)C-outdoor3/DSC03015.JPG,char_data/주/DSC03015.JPG_2.jpg,3726,480,640,46,459,505,166,247,True,81
주,58,kaist_dataset/Mixed/Digital_Camera/(C.S)C-outdoor3/DSC03035.JPG,char_data/주/DSC03035.JPG_2.jpg,2494,480,640,43,380,423,302,360,True,81
주,82,kaist_dataset/Mixed/Digital_Camera/(C.S)C-outdoor3/DSC03179.JPG,char_data/주/DSC03179.JPG_2.jpg,4346,480,640,53,294,347,250,332,True,81
주,45,kaist_dataset/Mixed/Digital_Camera/(C.S)C-outdoor3/DSC03196.JPG,char_data/주/DSC03196.JPG_2.jpg,1710,480,640,38,236,274,395,440,True,81
주,45,kaist_dataset/Mixed/Digital_Camera/(C.S)C-outdoor3/DSC03217.JPG,char_data/주/DSC03217.JPG_2.jpg,1710,480,640,38,477,515,336,381,True,81
주,45,kaist_dataset/Mixed/Digital_Camera/(C.S)C-outdoor3/DSC03223.JPG,char_data/주/DSC03223.JPG_2.jpg,1890,480,640,42,482,524,422,467,True,81
주,73,kaist_dataset/Mixed/Digital_Camera/(C.S)C-outdoor3/DSC03234.JPG,char_data/주/DSC03234.JPG_2.jpg,5329,480,640,73,390,463,90,163,True,81
주,116,kaist_dataset/Mixed/Digital_Camera/(C.S)C-outdoor3/DSC03254.JPG,char_data/주/DSC03254.JPG_2.jpg,10904,480,640,94,288,382,84,200,True,81
주,85,kaist_dataset/Mixed/Digital_Camera/(C.S)C-outdoor3/DSC03299.JPG,char_data/주/DSC03299.JPG_2.jpg,5780,480,640,68,448,516,283,368,True,81
주,111,kaist_dataset/Mixed/Digital_Camera/(C.S)C-outdoor3/DSC03309.JPG,char_data/주/DSC03309.JPG_2.jpg,8769,480,640,79,115,194,149,260,False,81
주,74,kaist_dataset/Mixed/Digital_Camera/(C.S)C-outdoor3/DSC03431.JPG,char_data/주/DSC03431.JPG_2.jpg,5106,480,640,69,221,290,28,102,False,81
주,68,kaist_dataset/Mixed/Digital_Camera/(C.S)C-outdoor4/DSC03439.JPG,char_data/주/DSC03439.JPG_2.jpg,3196,480,640,47,191,238,341,409,False,81
주,48,kaist_dataset/Mixed/Digital_Camera/(C.S)C-outdoor4/DSC03533.JPG,char_data/주/DSC03533.JPG_2.jpg,1536,480,640,32,81,113,44,92,False,81
주,36,kaist_dataset/Mixed/Digital_Camera/(C.S)C-outdoor4/DSC03556.JPG,char_data/주/DSC03556.JPG_2.jpg,1224,480,640,34,129,163,213,249,False,81
주,42,kaist_dataset/Mixed/Digital_Camera/(C.S)C-outdoor4/DSC03581.JPG,char_data/주/DSC03581.JPG_2.jpg,1428,480,640,34,312,346,197,239,False,81
주,73,kaist_dataset/Mixed/Digital_Camera/(C.S)C-outdoor4/DSC03582.JPG,char_data/주/DSC03582.JPG_2.jpg,5183,480,640,71,342,413,275,348,False,81
주,37,kaist_dataset/Mixed/Digital_Camera/(C.S)C-outdoor4/DSC03634.JPG,char_data/주/DSC03634.JPG_2.jpg,1887,480,640,51,404,455,372,409,False,81
주,151,kaist_dataset/Mixed/Digital_Camera/(C.S)C-outdoor4/DSC03662.JPG,char_data/주/DSC03662.JPG_2.jpg,17214,480,640,114,40,154,241,392,False,81
주,39,kaist_dataset/Mixed/Digital_Camera/(C.S)C-outdoor5/DSC03839.JPG,char_data/주/DSC03839.JPG_2.jpg,1053,480,640,27,210,237,406,445,False,81
주,93,kaist_dataset/Mixed/Digital_Camera/(C.S)C-outdoor5/DSC03867.JPG,char_data/주/DSC03867.JPG_2.jpg,7812,480,640,84,389,473,61,154,False,81
주,85,kaist_dataset/Mixed/Digital_Camera/(C.S)C-outdoor5/DSC04017.JPG,char_data/주/DSC04017.JPG_2.jpg,5525,480,640,65,127,192,244,329,False,81
주,49,kaist_dataset/Mixed/Digital_Camera/(C.S)C-outdoor5/DSC04069.JPG,char_data/주/DSC04069.JPG_2.jpg,2009,480,640,41,61,102,263,312,False,81
주,69,kaist_dataset/Mixed/Digital_Camera/(C.S)C-outdoor5/DSC04290.JPG,char_data/주/DSC04290.JPG_2.jpg,2898,480,640,42,199,241,209,278,False,81
주,99,kaist_dataset/Mixed/Digital_Camera/(C.S)C-outdoor5/DSC04312.JPG,char_data/주/DSC04312.JPG_2.jpg,7128,480,640,72,187,259,243,342,False,81
주,138,kaist_dataset/Mixed/Digital_Camera/(C.S)C-outdoor5/DSC04461.JPG,char_data/주/DSC04461.JPG_2.jpg,22080,480,640,160,430,590,203,341,False,81
주,106,kaist_dataset/Mixed/Digital_Camera/(C.S)C-outdoor6/P1010020.JPG,char_data/주/P1010020.JPG_2.jpg,7526,480,640,71,386,457,216,322,False,81
주,108,kaist_dataset/Mixed/Digital_Camera/(C.S)C-outdoor6/P1010025.JPG,char_data/주/P1010025.JPG_2.jpg,11988,480,640,111,533,639,176,284,False,81
주,106,kaist_dataset/Mixed/Digital_Camera/(C.S)C-outdoor6/P1010027.JPG,char_data/주/P1010027.JPG_2.jpg,11448,480,640,108,453,561,170,276,False,81
주,65,kaist_dataset/Mixed/Digital_Camera/(C.S)C-outdoor6/P1010094.JPG,char_data/주/P1010094.JPG_2.jpg,6630,480,640,102,237,339,146,211,False,81
주,53,kaist_dataset/Mixed/Digital_Camera/(C.S)C-outdoor6/크기변환_P1010029.JPG,char_data/주/크기변환_P1010029.JPG_2.jpg,1908,480,640,36,354,390,331,384,False,81
주,62,kaist_dataset/Mixed/Digital_Camera/(C.S)D-indoor1/DSC02794.JPG,char_data/주/DSC02794.JPG_2.jpg,3906,480,640,63,185,248,275,337,False,81
주,48,kaist_dataset/Mixed/Digital_Camera/(C.S)D-indoor1/DSC03124.JPG,char_data/주/DSC03124.JPG_2.jpg,2016,480,640,42,302,344,261,309,False,81
주,74,kaist_dataset/Mixed/Digital_Camera/(C.S)D-indoor1/DSC03483.JPG,char_data/주/DSC03483.JPG_2.jpg,3996,480,640,54,241,295,190,264,False,81
주,122,kaist_dataset/Mixed/Digital_Camera/(C.S)D-indoor1/DSC03999.JPG,char_data/주/DSC03999.JPG_2.jpg,9882,480,640,81,117,198,12,134,False,81
주,70,kaist_dataset/Mixed/Digital_Camera/(C.S)D-indoor2/DSC04442.JPG,char_data/주/DSC04442.JPG_4.jpg,4200,480,640,60,139,199,363,433,False,81
주,67,kaist_dataset/Mixed/Digital_Camera/(C.S)D-indoor2/DSC04442.JPG,char_data/주/DSC04442.JPG_5.jpg,3953,480,640,59,483,542,368,435,False,81
주,38,kaist_dataset/Mixed/Digital_Camera/(C.S)E-night/DSC02586.JPG,char_data/주/DSC02586.JPG_2.jpg,1216,480,640,32,257,289,180,218,False,81
주,83,kaist_dataset/Mixed/Digital_Camera/(C.S)E-night/DSC02600.JPG,char_data/주/DSC02600.JPG_4.jpg,8466,480,640,102,409,511,112,195,False,81
주,86,kaist_dataset/Mixed/Digital_Camera/(C.S)E-night/DSC02600.JPG,char_data/주/DSC02600.JPG_5.jpg,8170,480,640,95,412,507,312,398,False,81
주,55,kaist_dataset/Mixed/Digital_Camera/(C.S)E-night/DSC02602.JPG,char_data/주/DSC02602.JPG_2.jpg,2750,480,640,50,255,305,303,358,False,81
주,40,kaist_dataset/Mixed/Digital_Camera/(C.S)E-night/DSC03514.JPG,char_data/주/DSC03514.JPG_2.jpg,1360,480,640,34,325,359,152,192,False,81
주,76,kaist_dataset/Mixed/Digital_Camera/(C.S)E-night/DSC03516.JPG,char_data/주/DSC03516.JPG_2.jpg,4104,480,640,54,456,510,88,164,False,81
주,99,kaist_dataset/Mixed/Digital_Camera/(C.S)F-others/DSC02609.JPG,char_data/주/DSC02609.JPG_5.jpg,5148,480,640,52,89,141,221,320,False,81
주,41,kaist_dataset/Mixed/Mobile_Phone/(C.M)C-bookCover/P090903072.jpg,char_data/주/P090903072.jpg_2.jpg,1271,480,640,31,463,494,353,394,False,81
의,28,kaist_dataset/English/Digital_Camera/(E.S)B-light/080116-0059.jpg,char_data/의/080116-0059.jpg_8.jpg,504,1200,1600,18,962,980,946,974,True,74
의,31,kaist_dataset/English/Digital_Camera/(E.S)B-light/080116-0059.jpg,char_data/의/080116-0059.jpg_9.jpg,527,1200,1600,17,707,724,1035,1066,True,74
의,31,kaist_dataset/English/Digital_Camera/(E.S)B-light/080116-0059.jpg,char_data/의/080116-0059.jpg_10.jpg,713,1200,1600,23,1085,1108,1018,1049,True,74
의,30,kaist_dataset/English/Digital_Camera/(E.S)B-light/080116-0059.jpg,char_data/의/080116-0059.jpg_11.jpg,540,1200,1600,18,709,727,951,981,True,74
의,82,kaist_dataset/English/Digital_Camera/(E.S)C-outdoor1/080120-0001.jpg,char_data/의/080120-0001.jpg_2.jpg,5658,1200,1600,69,693,762,353,435,True,74
의,33,kaist_dataset/English/Digital_Camera/(E.S)F-others/080119-0007.jpg,char_data/의/080119-0007.jpg_2.jpg,561,1200,1600,17,1567,1584,206,239,True,74
의,39,kaist_dataset/Korean/Digital_Camera/A-shadow/2007-12-09-day-exterior-026.jpg,char_data/의/2007-12-09-day-exterior-026.jpg_2.jpg,1365,1200,1600,35,816,851,787,826,True,74
의,119,kaist_dataset/Korean/Digital_Camera/A-shadow/DSC03535.JPG,char_data/의/DSC03535.JPG_2.jpg,13090,480,640,110,455,565,64,183,True,74
의,45,kaist_dataset/Korean/Digital_Camera/A-shadow/DSC03755.JPG,char_data/의/DSC03755.JPG_2.jpg,2340,480,640,52,88,140,201,246,True,74
의,34,kaist_dataset/Korean/Digital_Camera/A-shadow/DSC04297.JPG,char_data/의/DSC04297.JPG_2.jpg,816,480,640,24,248,272,207,241,True,74
의,24,kaist_dataset/Korean/Digital_Camera/E-night/106.jpg,char_data/의/106.jpg_2.jpg,624,480,640,26,351,377,108,132,True,74
의,67,kaist_dataset/Korean/Digital_Camera/E-night/144.JPG,char_data/의/144.JPG_2.jpg,4623,480,640,69,250,319,229,296,True,74
의,94,kaist_dataset/Korean/Digital_Camera/E-night/DSC02596.JPG,char_data/의/DSC02596.JPG_2.jpg,7520,480,640,80,358,438,135,229,True,74
의,26,kaist_dataset/Korean/Digital_Camera/E-night/P1010149.JPG,char_data/의/P1010149.JPG_2.jpg,858,480,640,33,488,521,199,225,True,74
의,49,kaist_dataset/Korean/Digital_Camera/F-bookCover/DSC02806.JPG,char_data/의/DSC02806.JPG_2.jpg,1960,480,640,40,110,150,86,135,True,74
의,198,kaist_dataset/Korean/Digital_Camera/F-bookCover/DSC02812.JPG,char_data/의/DSC02812.JPG_2.jpg,29502,480,640,149,278,427,150,348,True,74
의,61,kaist_dataset/Korean/Digital_Camera/F-bookCover/DSC04218.JPG,char_data/의/DSC04218.JPG_2.jpg,2684,480,640,44,388,432,196,257,True,74
의,69,kaist_dataset/Korean/Digital_Camera/F-bookCover/DSC04219.JPG,char_data/의/DSC04219.JPG_2.jpg,3795,480,640,55,321,376,174,243,True,74
의,90,kaist_dataset/Korean/Digital_Camera/F-bookCover/DSC04224.JPG,char_data/의/DSC04224.JPG_2.jpg,7470,480,640,83,299,382,153,243,True,74
의,117,kaist_dataset/Korean/Digital_Camera/F-bookCover/DSC04228.JPG,char_data/의/DSC04228.JPG_2.jpg,7605,480,640,65,288,353,85,202,True,74
의,116,kaist_dataset/Korean/Digital_Camera/F-bookCover/DSC04229.JPG,char_data/의/DSC04229.JPG_2.jpg,11252,480,640,97,358,455,29,145,True,74
의,71,kaist_dataset/Korean/Digital_Camera/F-bookCover/DSC04230.JPG,char_data/의/DSC04230.JPG_2.jpg,3408,480,640,48,192,240,177,248,True,74
의,92,kaist_dataset/Korean/Digital_Camera/F-bookCover/DSC04232.JPG,char_data/의/DSC04232.JPG_2.jpg,6716,480,640,73,467,540,129,221,True,74
의,29,kaist_dataset/Korean/Digital_Camera/indoor1/145.JPG,char_data/의/145.JPG_2.jpg,783,480,640,27,37,64,287,316,True,74
의,21,kaist_dataset/Korean/Digital_Camera/indoor1/146.JPG,char_data/의/146.JPG_2.jpg,399,480,640,19,286,305,290,311,True,74
의,50,kaist_dataset/Korean/Digital_Camera/indoor1/DSC02720.JPG,char_data/의/DSC02720.JPG_2.jpg,2150,480,640,43,572,615,200,250,True,74
의,32,kaist_dataset/Korean/Digital_Camera/indoor1/DSC02766.JPG,char_data/의/DSC02766.JPG_2.jpg,896,480,640,28,476,504,95,127,True,74
의,41,kaist_dataset/Korean/Digital_Camera/indoor1/DSC02774.JPG,char_data/의/DSC02774.JPG_2.jpg,1271,480,640,31,503,534,210,251,True,74
의,73,kaist_dataset/Korean/Digital_Camera/indoor1/DSC03088.JPG,char_data/의/DSC03088.JPG_2.jpg,4599,480,640,63,380,443,254,327,True,74
의,180,kaist_dataset/Korean/Digital_Camera/indoor2/DSC03471.JPG,char_data/의/DSC03471.JPG_2.jpg,14220,480,640,79,327,406,51,231,True,74
의,99,kaist_dataset/Korean/Digital_Camera/indoor2/DSC03474.JPG,char_data/의/DSC03474.JPG_2.jpg,8316,480,640,84,305,389,46,145,True,74
의,53,kaist_dataset/Korean/Digital_Camera/indoor2/DSC03484.JPG,char_data/의/DSC03484.JPG_2.jpg,1908,480,640,36,436,472,123,176,True,74
의,85,kaist_dataset/Korean/Digital_Camera/indoor2/DSC03922.JPG,char_data/의/DSC03922.JPG_2.jpg,6035,480,640,71,264,335,199,284,True,74
의,92,kaist_dataset/Korean/Digital_Camera/indoor2/P071209063.jpg,char_data/의/P071209063.jpg_2.jpg,11868,1200,1600,129,617,746,329,421,True,74
의,34,kaist_dataset/Korean/Digital_Camera/outdoor1/102.JPG,char_data/의/102.JPG_2.jpg,680,480,640,20,462,482,306,340,True,74
의,67,kaist_dataset/Korean/Digital_Camera/outdoor1/2007-12-08-day-050.jpg,char_data/의/2007-12-08-day-050.jpg_2.jpg,5293,1200,1600,79,1097,1176,1035,1102,True,74
의,32,kaist_dataset/Korean/Digital_Camera/outdoor1/306.jpg,char_data/의/306.jpg_2.jpg,800,190,330,25,183,208,81,113,True,74
의,36,kaist_dataset/Korean/Digital_Camera/outdoor1/91.jpg,char_data/의/91.jpg_2.jpg,1044,480,640,29,399,428,307,343,True,74
의,117,kaist_dataset/Korean/Digital_Camera/outdoor2/080119-0032.jpg,char_data/의/080119-0032.jpg_2.jpg,13806,1200,1600,118,932,1050,284,401,True,74
의,112,kaist_dataset/Korean/Digital_Camera/outdoor2/2007-12-09-day-exterior-008.jpg,char_data/의/2007-12-09-day-exterior-008.jpg_2.jpg,13552,1200,1600,121,694,815,549,661,True,74
의,43,kaist_dataset/Korean/Digital_Camera/outdoor2/DSC02405.JPG,char_data/의/DSC02405.JPG_2.jpg,1849,480,640,43,592,635,180,223,True,74
의,41,kaist_dataset/Korean/Digital_Camera/outdoor2/DSC02426.JPG,char_data/의/DSC02426.JPG_2.jpg,1845,480,640,45,267,312,216,257,True,74
의,92,kaist_dataset/Korean/Digital_Camera/outdoor3/DSC02552.JPG,char_data/의/DSC02552.JPG_2.jpg,9568,480,640,104,384,488,260,352,True,74
의,51,kaist_dataset/Korean/Digital_Camera/outdoor3/DSC02686.JPG,char_data/의/DSC02686.JPG_2.jpg,2244,480,640,44,394,438,50,101,True,74
의,67,kaist_dataset/Korean/Digital_Camera/outdoor3/DSC02878.JPG,char_data/의/DSC02878.JPG_2.jpg,5494,480,640,82,416,498,160,227,True,74
의,45,kaist_dataset/Korean/Digital_Camera/outdoor3/DSC02888.JPG,char_data/의/DSC02888.JPG_2.jpg,2115,480,640,47,490,537,354,399,True,74
의,35,kaist_dataset/Korean/Digital_Camera/outdoor3/DSC02908.JPG,char_data/의/DSC02908.JPG_2.jpg,805,480,640,23,203,226,177,212,True,74
의,43,kaist_dataset/Korean/Digital_Camera/outdoor3/DSC02975.JPG,char_data/의/DSC02975.JPG_2.jpg,1462,480,640,34,213,247,3,46,True,74
의,44,kaist_dataset/Korean/Digital_Camera/outdoor3/DSC03049.JPG,char_data/의/DSC03049.JPG_2.jpg,2376,480,640,54,328,382,186,230,True,74
의,26,kaist_dataset/Korean/Digital_Camera/outdoor3/DSC03163.JPG,char_data/의/DSC03163.JPG_2.jpg,1040,480,640,40,511,551,163,189,True,74
의,34,kaist_dataset/Korean/Digital_Camera/outdoor3/DSC03206.JPG,char_data/의/DSC03206.JPG_2.jpg,952,480,640,28,315,343,165,199,True,74
의,30,kaist_dataset/Korean/Digital_Camera/outdoor3/DSC03232.JPG,char_data/의/DSC03232.JPG_2.jpg,1080,480,640,36,141,177,292,322,True,74
의,42,kaist_dataset/Korean/Digital_Camera/outdoor4/DSC03272.JPG,char_data/의/DSC03272.JPG_2.jpg,1428,480,640,34,137,171,246,288,True,74
의,97,kaist_dataset/Korean/Digital_Camera/outdoor4/DSC03445.JPG,char_data/의/DSC03445.JPG_2.jpg,9215,480,640,95,449,544,195,292,True,74
의,63,kaist_dataset/Korean/Digital_Camera/outdoor4/DSC03596.JPG,char_data/의/DSC03596.JPG_2.jpg,3087,480,640,49,395,444,140,203,True,74
의,55,kaist_dataset/Korean/Digital_Camera/outdoor4/DSC03615.JPG,char_data/의/DSC03615.JPG_2.jpg,3245,480,640,59,191,250,223,278,True,74
의,53,kaist_dataset/Korean/Digital_Camera/outdoor5/DSC03708.JPG,char_data/의/DSC03708.JPG_2.jpg,2491,480,640,47,264,311,261,314,True,74
의,38,kaist_dataset/Korean/Digital_Camera/outdoor5/DSC03740.JPG,char_data/의/DSC03740.JPG_2.jpg,1406,480,640,37,120,157,288,326,True,74
의,58,kaist_dataset/Korean/Digital_Camera/outdoor5/DSC03749.JPG,char_data/의/DSC03749.JPG_2.jpg,2146,480,640,37,411,448,90,148,True,74
의,51,kaist_dataset/Korean/Digital_Camera/outdoor5/DSC03844.JPG,char_data/의/DSC03844.JPG_2.jpg,2601,480,640,51,374,425,234,285,True,74
의,72,kaist_dataset/Korean/Digital_Camera/outdoor5/DSC03869.JPG,char_data/의/DSC03869.JPG_2.jpg,4176,480,640,58,267,325,170,242,True,74
의,82,kaist_dataset/Korean/Digital_Camera/outdoor5/DSC03970.JPG,char_data/의/DSC03970.JPG_2.jpg,5576,480,640,68,475,543,12,94,True,74
의,69,kaist_dataset/Korean/Digital_Camera/outdoor5/DSC03993.JPG,char_data/의/DSC03993.JPG_4.jpg,3588,480,640,52,173,225,112,181,True,74
의,40,kaist_dataset/Korean/Digital_Camera/outdoor5/DSC03993.JPG,char_data/의/DSC03993.JPG_5.jpg,1680,480,640,42,393,435,429,469,True,74
의,85,kaist_dataset/Korean/Digital_Camera/outdoor5/DSC04011.JPG,char_data/의/DSC04011.JPG_2.jpg,5780,480,640,68,375,443,98,183,True,74
의,49,kaist_dataset/Korean/Digital_Camera/outdoor6/DSC04044.JPG,char_data/의/DSC04044.JPG_2.jpg,2450,480,640,50,122,172,293,342,True,74
의,74,kaist_dataset/Korean/Digital_Camera/outdoor6/DSC04089.JPG,char_data/의/DSC04089.JPG_2.jpg,4144,480,640,56,451,507,188,262,True,74
의,67,kaist_dataset/Korean/Digital_Camera/outdoor6/DSC04333.JPG,char_data/의/DSC04333.JPG_2.jpg,5963,480,640,89,417,506,138,205,True,74
의,138,kaist_dataset/Korean/Digital_Camera/outdoor6/DSC04372.JPG,char_data/의/DSC04372.JPG_2.jpg,21666,480,640,157,234,391,210,348,True,74
의,84,kaist_dataset/Korean/Digital_Camera/outdoor7/P1010105.JPG,char_data/의/P1010105.JPG_2.jpg,6804,480,640,81,231,312,149,233,True,74
의,37,kaist_dataset/Korean/Digital_Camera/outdoor7/P1010136.JPG,char_data/의/P1010136.JPG_2.jpg,740,480,640,20,234,254,262,299,True,74
의,74,kaist_dataset/Korean/Digital_Camera/outdoor8/DSC02875.JPG,char_data/의/DSC02875.JPG_2.jpg,4218,480,640,57,500,557,144,218,True,74
의,40,kaist_dataset/Korean/Digital_Camera/outdoor8/P1011112.JPG,char_data/의/P1011112.JPG_2.jpg,960,480,640,24,155,179,198,238,True,74
의,73,"kaist_dataset/Korean/Mobile_Phone/(M,K)C-outdoor/P090912044.jpg",char_data/의/P090912044.jpg_2.jpg,5110,480,640,70,277,347,119,192,True,74
의,72,"kaist_dataset/Korean/Mobile_Phone/(M,K)D-indoor/P090911062.jpg",char_data/의/P090911062.jpg_2.jpg,6408,480,640,89,45,134,130,202,True,74
의,56,"kaist_dataset/Korean/Mobile_Phone/(M,K)D-indoor/P090911065.jpg",char_data/의/P090911065.jpg_2.jpg,3304,480,640,59,391,450,13,69,True,74
의,68,"kaist_dataset/Korean/Mobile_Phone/(M,K)E-bookCover/P090831034.jpg",char_data/의/P090831034.jpg_2.jpg,3264,480,640,48,450,498,87,155,True,74
의,71,"kaist_dataset/Korean/Mobile_Phone/(M,K)E-bookCover/P090831047.jpg",char_data/의/P090831047.jpg_2.jpg,4189,480,640,59,198,257,151,222,True,74
의,140,"kaist_dataset/Korean/Mobile_Phone/(M,K)E-bookCover/P090831055.jpg",char_data/의/P090831055.jpg_2.jpg,14420,480,640,103,471,574,137,277,True,74
의,59,"kaist_dataset/Korean/Mobile_Phone/(M,K)E-bookCover/P090831056.jpg",char_data/의/P090831056.jpg_2.jpg,2478,480,640,42,110,152,97,156,True,74
의,116,"kaist_dataset/Korean/Mobile_Phone/(M,K)E-bookCover/P090831063.jpg",char_data/의/P090831063.jpg_2.jpg,13340,480,640,115,194,309,197,313,True,74
의,158,"kaist_dataset/Korean/Mobile_Phone/(M,K)E-bookCover/P090831064.jpg",char_data/의/P090831064.jpg_2.jpg,18170,480,640,115,412,527,57,215,True,74
의,79,"kaist_dataset/Korean/Mobile_Phone/(M,K)E-bookCover/P090831073.jpg",char_data/의/P090831073.jpg_2.jpg,5214,480,640,66,351,417,14,93,True,74
의,168,"kaist_dataset/Korean/Mobile_Phone/(M,K)E-bookCover/P090831074.jpg",char_data/의/P090831074.jpg_2.jpg,24528,480,640,146,342,488,151,319,True,74
의,103,"kaist_dataset/Korean/Mobile_Phone/(M,K)E-bookCover/P090831076.jpg",char_data/의/P090831076.jpg_2.jpg,11742,480,640,114,243,357,217,320,True,74
의,124,"kaist_dataset/Korean/Mobile_Phone/(M,K)E-bookCover/P090831102.jpg",char_data/의/P090831102.jpg_2.jpg,13764,480,640,111,254,365,32,156,True,74
의,87,"kaist_dataset/Korean/Mobile_Phone/(M,K)E-bookCover/P090831103.jpg",char_data/의/P090831103.jpg_2.jpg,5655,480,640,65,397,462,42,129,True,74
의,169,"kaist_dataset/Korean/Mobile_Phone/(M,K)E-bookCover/P090831129.jpg",char_data/의/P090831129.jpg_4.jpg,18421,480,640,109,265,374,74,243,True,74
의,173,"kaist_dataset/Korean/Mobile_Phone/(M,K)E-bookCover/P090831129.jpg",char_data/의/P090831129.jpg_5.jpg,16954,480,640,98,278,376,268,441,True,74
의,137,"kaist_dataset/Korean/Mobile_Phone/(M,K)E-bookCover/P090831130.jpg",char_data/의/P090831130.jpg_2.jpg,10275,480,640,75,96,171,45,182,True,74
의,39,"kaist_dataset/Korean/Mobile_Phone/(M,K)E-bookCover/P090831140.jpg",char_data/의/P090831140.jpg_4.jpg,1014,480,640,26,318,344,12,51,True,74
의,66,"kaist_dataset/Korean/Mobile_Phone/(M,K)E-bookCover/P090831140.jpg",char_data/의/P090831140.jpg_5.jpg,3960,480,640,60,274,334,131,197,True,74
의,69,"kaist_dataset/Korean/Mobile_Phone/(M,K)E-bookCover/P090831144.jpg",char_data/의/P090831144.jpg_2.jpg,4623,480,640,67,345,412,17,86,True,74
의,80,"kaist_dataset/Korean/Mobile_Phone/(M,K)E-bookCover/P090831146.jpg",char_data/의/P090831146.jpg_2.jpg,5840,480,640,73,251,324,28,108,True,74
의,75,"kaist_dataset/Korean/Mobile_Phone/(M,K)E-bookCover/P090831147.jpg",char_data/의/P090831147.jpg_2.jpg,4200,480,640,56,355,411,64,139,True,74
의,47,"kaist_dataset/Korean/Mobile_Phone/(M,K)E-bookCover/P090831151.jpg",char_data/의/P090831151.jpg_2.jpg,1880,480,640,40,186,226,23,70,True,74
의,124,"kaist_dataset/Korean/Mobile_Phone/(M,K)E-bookCover/P090903017.jpg",char_data/의/P090903017.jpg_2.jpg,8432,480,640,68,318,386,316,440,True,74
의,66,"kaist_dataset/Korean/Mobile_Phone/(M,K)E-bookCover/P090903023.jpg",char_data/의/P090903023.jpg_2.jpg,3564,480,640,54,226,280,11,77,True,74
의,65,"kaist_dataset/Korean/Mobile_Phone/(M,K)E-bookCover/P090903025.jpg",char_data/의/P090903025.jpg_2.jpg,2990,480,640,46,556,602,88,153,True,74
의,110,"kaist_dataset/Korean/Mobile_Phone/(M,K)E-bookCover/P090903031.jpg",char_data/의/P090903031.jpg_2.jpg,7700,480,640,70,273,343,108,218,True,74
의,80,"kaist_dataset/Korean/Mobile_Phone/(M,K)E-bookCover/P090903039.jpg",char_data/의/P090903039.jpg_2.jpg,4640,480,640,58,296,354,21,101,True,74
의,53,"kaist_dataset/Korean/Mobile_Phone/(M,K)E-bookCover/P090903051.jpg",char_data/의/P090903051.jpg_2.jpg,2120,480,640,40,293,333,204,257,True,74
의,51,"kaist_dataset/Korean/Mobile_Phone/(M,K)E-bookCover/P090903060.jpg",char_data/의/P090903060.jpg_2.jpg,2040,480,640,40,583,623,300,351,True,74
의,120,"kaist_dataset/Korean/Mobile_Phone/(M,K)E-bookCover/P090903065.jpg",char_data/의/P090903065.jpg_2.jpg,12960,480,640,108,496,604,131,251,True,74
의,99,"kaist_dataset/Korean/Mobile_Phone/(M,K)E-bookCover/P090903090.jpg",char_data/의/P090903090.jpg_2.jpg,9801,480,640,99,508,607,58,157,True,74
의,86,"kaist_dataset/Korean/Mobile_Phone/(M,K)E-bookCover/P090903098.jpg",char_data/의/P090903098.jpg_2.jpg,7224,480,640,84,476,560,90,176,True,74
의,101,"kaist_dataset/Korean/Mobile_Phone/(M,K)E-bookCover/P090911028.jpg",char_data/의/P090911028.jpg_2.jpg,8686,480,640,86,491,577,134,235,True,74
의,76,"kaist_dataset/Korean/Mobile_Phone/(M,K)E-bookCover/P090911042.jpg",char_data/의/P090911042.jpg_2.jpg,7980,480,640,105,377,482,197,273,True,74
의,121,"kaist_dataset/Korean/Mobile_Phone/(M,K)E-bookCover/P090911054.jpg",char_data/의/P090911054.jpg_2.jpg,16093,480,640,133,325,458,108,229,True,74
의,77,"kaist_dataset/Korean/Mobile_Phone/(M,K)E-bookCover/P090912006.jpg",char_data/의/P090912006.jpg_2.jpg,4928,480,640,64,242,306,3,80,True,74
의,182,kaist_dataset/Mixed/Digital_Camera/(C.S)C-outdoor1/080118-0007.jpg,char_data/의/080118-0007.jpg_2.jpg,24388,1200,1600,134,973,1107,196,378,True,74
의,31,kaist_dataset/Mixed/Digital_Camera/(C.S)C-outdoor1/114.jpg,char_data/의/114.jpg_2.jpg,1023,480,640,33,284,317,109,140,True,74
의,109,kaist_dataset/Mixed/Digital_Camera/(C.S)C-outdoor1/118.JPG,char_data/의/118.JPG_2.jpg,12644,480,640,116,355,471,131,240,True,74
의,41,kaist_dataset/Mixed/Digital_Camera/(C.S)C-outdoor1/2.JPG,char_data/의/2.JPG_2.jpg,1640,576,768,40,385,425,16,57,True,74
의,45,kaist_dataset/Mixed/Digital_Camera/(C.S)C-outdoor1/2007-12-08-day-130.jpg,char_data/의/2007-12-08-day-130.jpg_2.jpg,1305,1200,1600,29,213,242,456,501,True,74
의,74,kaist_dataset/Mixed/Digital_Camera/(C.S)C-outdoor1/DSC02319.JPG,char_data/의/DSC02319.JPG_2.jpg,4292,480,640,58,384,442,251,325,True,74
의,34,kaist_dataset/Mixed/Digital_Camera/(C.S)C-outdoor2/DSC02379.JPG,char_data/의/DSC02379.JPG_2.jpg,782,480,640,23,316,339,290,324,True,74
의,76,kaist_dataset/Mixed/Digital_Camera/(C.S)C-outdoor2/DSC02407.JPG,char_data/의/DSC02407.JPG_2.jpg,5700,480,640,75,418,493,75,151,True,74
의,42,kaist_dataset/Mixed/Digital_Camera/(C.S)C-outdoor2/DSC02447.JPG,char_data/의/DSC02447.JPG_2.jpg,1218,480,640,29,111,140,172,214,True,74
의,51,kaist_dataset/Mixed/Digital_Camera/(C.S)C-outdoor2/DSC02519.JPG,char_data/의/DSC02519.JPG_2.jpg,3213,480,640,63,216,279,147,198,True,74
의,55,kaist_dataset/Mixed/Digital_Camera/(C.S)C-outdoor2/DSC02545.JPG,char_data/의/DSC02545.JPG_2.jpg,2970,480,640,54,475,529,297,352,True,74
의,71,kaist_dataset/Mixed/Digital_Camera/(C.S)C-outdoor2/DSC02879.JPG,char_data/의/DSC02879.JPG_2.jpg,4970,480,640,70,408,478,179,250,True,74
의,46,kaist_dataset/Mixed/Digital_Camera/(C.S)C-outdoor3/DSC02964.JPG,char_data/의/DSC02964.JPG_2.jpg,1932,480,640,42,113,155,90,136,True,74
의,60,kaist_dataset/Mixed/Digital_Camera/(C.S)C-outdoor3/DSC03035.JPG,char_data/의/DSC03035.JPG_2.jpg,2460,480,640,41,422,463,299,359,True,74
의,84,kaist_dataset/Mixed/Digital_Camera/(C.S)C-outdoor3/DSC03275.JPG,char_data/의/DSC03275.JPG_2.jpg,7812,480,640,93,442,535,61,145,True,74
의,37,kaist_dataset/Mixed/Digital_Camera/(C.S)C-outdoor4/DSC03435.JPG,char_data/의/DSC03435.JPG_2.jpg,1147,480,640,31,206,237,232,269,True,74
의,110,kaist_dataset/Mixed/Digital_Camera/(C.S)C-outdoor4/DSC03569.JPG,char_data/의/DSC03569.JPG_2.jpg,14630,480,640,133,360,493,31,141,True,74
의,88,kaist_dataset/Mixed/Digital_Camera/(C.S)C-outdoor4/DSC03616.JPG,char_data/의/DSC03616.JPG_2.jpg,7920,480,640,90,436,526,50,138,True,74
의,43,kaist_dataset/Mixed/Digital_Camera/(C.S)C-outdoor4/DSC03634.JPG,char_data/의/DSC03634.JPG_2.jpg,1376,480,640,32,359,391,419,462,True,74
의,63,kaist_dataset/Mixed/Digital_Camera/(C.S)C-outdoor4/DSC03676.JPG,char_data/의/DSC03676.JPG_2.jpg,3150,480,640,50,289,339,334,397,True,74
의,124,kaist_dataset/Mixed/Digital_Camera/(C.S)C-outdoor4/DSC03737.JPG,char_data/의/DSC03737.JPG_2.jpg,14508,480,640,117,369,486,37,161,True,74
의,53,kaist_dataset/Mixed/Digital_Camera/(C.S)C-outdoor4/DSC03758.JPG,char_data/의/DSC03758.JPG_2.jpg,3021,480,640,57,386,443,153,206,True,74
의,51,kaist_dataset/Mixed/Digital_Camera/(C.S)C-outdoor4/DSC03764.JPG,char_data/의/DSC03764.JPG_2.jpg,4641,480,640,91,262,353,107,158,True,74
의,59,kaist_dataset/Mixed/Digital_Camera/(C.S)C-outdoor4/DSC03785.JPG,char_data/의/DSC03785.JPG_2.jpg,3186,480,640,54,275,329,17,76,True,74
의,36,kaist_dataset/Mixed/Digital_Camera/(C.S)C-outdoor5/DSC03821.JPG,char_data/의/DSC03821.JPG_2.jpg,1008,480,640,28,107,135,80,116,True,74
의,46,kaist_dataset/Mixed/Digital_Camera/(C.S)C-outdoor5/DSC03837.JPG,char_data/의/DSC03837.JPG_2.jpg,1564,480,640,34,185,219,245,291,True,74
의,62,kaist_dataset/Mixed/Digital_Camera/(C.S)C-outdoor5/DSC03847.JPG,char_data/의/DSC03847.JPG_2.jpg,2418,480,640,39,183,222,16,78,False,74
의,93,kaist_dataset/Mixed/Digital_Camera/(C.S)C-outdoor5/DSC03867.JPG,char_data/의/DSC03867.JPG_2.jpg,7719,480,640,83,485,568,57,150,False,74
의,52,kaist_dataset/Mixed/Digital_Camera/(C.S)C-outdoor5/DSC04111.JPG,char_data/의/DSC04111.JPG_2.jpg,1872,480,640,36,236,272,118,170,False,74
의,71,kaist_dataset/Mixed/Digital_Camera/(C.S)C-outdoor6/080116-0057.jpg,char_data/의/080116-0057.jpg_4.jpg,3479,1200,1600,49,996,1045,812,883,False,74
의,64,kaist_dataset/Mixed/Digital_Camera/(C.S)C-outdoor6/080116-0057.jpg,char_data/의/080116-0057.jpg_5.jpg,3392,1200,1600,53,434,487,998,1062,False,74
의,21,kaist_dataset/Mixed/Digital_Camera/(C.S)C-outdoor6/117.JPG,char_data/의/117.JPG_2.jpg,420,480,640,20,177,197,166,187,False,74
의,58,kaist_dataset/Mixed/Digital_Camera/(C.S)C-outdoor6/P1010020.JPG,char_data/의/P1010020.JPG_2.jpg,3712,480,640,64,219,283,173,231,False,74
의,41,kaist_dataset/Mixed/Digital_Camera/(C.S)C-outdoor6/P1010048.JPG,char_data/의/P1010048.JPG_2.jpg,1189,480,640,29,278,307,110,151,False,74
의,87,kaist_dataset/Mixed/Digital_Camera/(C.S)C-outdoor6/P1010069.JPG,char_data/의/P1010069.JPG_2.jpg,9570,480,640,110,283,393,217,304,False,74
의,38,kaist_dataset/Mixed/Digital_Camera/(C.S)C-outdoor6/P1010073.JPG,char_data/의/P1010073.JPG_2.jpg,950,480,640,25,259,284,237,275,False,74
의,43,kaist_dataset/Mixed/Digital_Camera/(C.S)C-outdoor6/P1010097.JPG,char_data/의/P1010097.JPG_2.jpg,1505,480,640,35,507,542,42,85,False,74
의,36,kaist_dataset/Mixed/Digital_Camera/(C.S)C-outdoor6/P1010098.JPG,char_data/의/P1010098.JPG_2.jpg,1260,480,640,35,501,536,435,471,False,74
의,81,kaist_dataset/Mixed/Digital_Camera/(C.S)C-outdoor6/P1010129.JPG,char_data/의/P1010129.JPG_2.jpg,7614,480,640,94,355,449,140,221,False,74
의,47,kaist_dataset/Mixed/Digital_Camera/(C.S)D-indoor1/DSC02711.JPG,char_data/의/DSC02711.JPG_2.jpg,2303,480,640,49,143,192,293,340,False,74
의,46,kaist_dataset/Mixed/Digital_Camera/(C.S)D-indoor1/DSC02718.JPG,char_data/의/DSC02718.JPG_4.jpg,1656,480,640,36,146,182,15,61,False,74
의,115,kaist_dataset/Mixed/Digital_Camera/(C.S)D-indoor1/DSC02718.JPG,char_data/의/DSC02718.JPG_5.jpg,11385,480,640,99,215,314,319,434,False,74
의,80,kaist_dataset/Mixed/Digital_Camera/(C.S)D-indoor1/DSC03469.JPG,char_data/의/DSC03469.JPG_2.jpg,4880,480,640,61,192,253,237,317,False,74
의,46,kaist_dataset/Mixed/Digital_Camera/(C.S)D-indoor1/DSC03478.JPG,char_data/의/DSC03478.JPG_2.jpg,2208,480,640,48,285,333,153,199,False,74
의,65,kaist_dataset/Mixed/Digital_Camera/(C.S)D-indoor1/DSC03483.JPG,char_data/의/DSC03483.JPG_2.jpg,3315,480,640,51,348,399,34,99,False,74
의,109,kaist_dataset/Mixed/Digital_Camera/(C.S)D-indoor1/DSC04226.JPG,char_data/의/DSC04226.JPG_2.jpg,8393,480,640,77,452,529,157,266,False,74
의,92,kaist_dataset/Mixed/Digital_Camera/(C.S)D-indoor1/DSC04231.JPG,char_data/의/DSC04231.JPG_4.jpg,5980,480,640,65,184,249,273,365,False,74
의,110,kaist_dataset/Mixed/Digital_Camera/(C.S)D-indoor1/DSC04231.JPG,char_data/의/DSC04231.JPG_5.jpg,6820,480,640,62,439,501,265,375,False,74
의,90,kaist_dataset/Mixed/Digital_Camera/(C.S)D-indoor2/DSC04248.JPG,char_data/의/DSC04248.JPG_2.jpg,9270,480,640,103,274,377,111,201,False,74
의,85,kaist_dataset/Mixed/Digital_Camera/(C.S)D-indoor2/DSC04443.JPG,char_data/의/DSC04443.JPG_2.jpg,5950,480,640,70,492,562,165,250,False,74
의,119,kaist_dataset/Mixed/Digital_Camera/(C.S)E-night/DSC02571.JPG,char_data/의/DSC02571.JPG_2.jpg,6902,480,640,58,324,382,175,294,False,74
의,63,kaist_dataset/Mixed/Digital_Camera/(C.S)E-night/DSC02574.JPG,char_data/의/DSC02574.JPG_2.jpg,3150,480,640,50,213,263,407,470,False,74
의,50,kaist_dataset/Mixed/Digital_Camera/(C.S)E-night/DSC02585.JPG,char_data/의/DSC02585.JPG_2.jpg,1350,480,640,27,280,307,404,454,False,74
의,62,kaist_dataset/Mixed/Mobile_Phone/(C.M)A-outdoor/P090912040.jpg,char_data/의/P090912040.jpg_2.jpg,4960,480,640,80,334,414,126,188,False,74
의,52,kaist_dataset/Mixed/Mobile_Phone/(C.M)A-outdoor/P090912062.jpg,char_data/의/P090912062.jpg_2.jpg,2496,480,640,48,463,511,1,53,False,74
의,87,kaist_dataset/Mixed/Mobile_Phone/(C.M)C-bookCover/P090831062.jpg,char_data/의/P090831062.jpg_2.jpg,5655,480,640,65,313,378,363,450,False,74
의,181,kaist_dataset/Mixed/Mobile_Phone/(C.M)C-bookCover/P090831080.jpg,char_data/의/P090831080.jpg_2.jpg,20272,480,640,112,396,508,141,322,False,74
의,82,kaist_dataset/Mixed/Mobile_Phone/(C.M)C-bookCover/P090903022.jpg,char_data/의/P090903022.jpg_2.jpg,5740,480,640,70,288,358,149,231,False,74
의,173,kaist_dataset/Mixed/Mobile_Phone/(C.M)C-bookCover/P090903063.jpg,char_data/의/P090903063.jpg_2.jpg,18165,480,640,105,221,326,42,215,False,74
의,138,kaist_dataset/Mixed/Mobile_Phone/(C.M)C-bookCover/P090903072.jpg,char_data/의/P090903072.jpg_2.jpg,16146,480,640,117,314,431,198,336,False,74
어,32,kaist_dataset/English/Digital_Camera/(E.S)B-light/080116-0059.jpg,char_data/어/080116-0059.jpg_2.jpg,672,1200,1600,21,737,758,906,938,True,72
어,45,kaist_dataset/English/Digital_Camera/(E.S)C-outdoor1/080119-0020.jpg,char_data/어/080119-0020.jpg_2.jpg,1215,1200,1600,27,1116,1143,645,690,True,72
어,69,kaist_dataset/Korean/Digital_Camera/A-shadow/DSC02659.JPG,char_data/어/DSC02659.JPG_2.jpg,4140,480,640,60,488,548,232,301,True,72
어,31,kaist_dataset/Korean/Digital_Camera/B-light/DSC02987.JPG,char_data/어/DSC02987.JPG_2.jpg,1364,480,640,44,378,422,125,156,True,72
어,204,kaist_dataset/Korean/Digital_Camera/E-night/DSC02612.JPG,char_data/어/DSC02612.JPG_2.jpg,32028,480,640,157,171,328,187,391,True,72
어,51,kaist_dataset/Korean/Digital_Camera/E-night/DSC03849.JPG,char_data/어/DSC03849.JPG_2.jpg,2295,480,640,45,386,431,235,286,True,72
어,108,kaist_dataset/Korean/Digital_Camera/F-bookCover/DSC02820.JPG,char_data/어/DSC02820.JPG_4.jpg,11556,480,640,107,244,351,144,252,True,72
어,110,kaist_dataset/Korean/Digital_Camera/F-bookCover/DSC02820.JPG,char_data/어/DSC02820.JPG_5.jpg,12540,480,640,114,471,585,139,249,True,72
어,122,kaist_dataset/Korean/Digital_Camera/F-bookCover/DSC02821.JPG,char_data/어/DSC02821.JPG_2.jpg,15616,480,640,128,119,247,115,237,True,72
어,146,kaist_dataset/Korean/Digital_Camera/F-bookCover/DSC02831.JPG,char_data/어/DSC02831.JPG_2.jpg,17666,480,640,121,176,297,117,263,True,72
어,117,kaist_dataset/Korean/Digital_Camera/F-bookCover/DSC02838.JPG,char_data/어/DSC02838.JPG_2.jpg,10998,480,640,94,413,507,288,405,True,72
어,82,kaist_dataset/Korean/Digital_Camera/F-bookCover/DSC03926.JPG,char_data/어/DSC03926.JPG_2.jpg,4346,480,640,53,350,403,200,282,True,72
어,56,kaist_dataset/Korean/Digital_Camera/F-bookCover/DSC04218.JPG,char_data/어/DSC04218.JPG_4.jpg,2800,480,640,50,141,191,263,319,True,72
어,64,kaist_dataset/Korean/Digital_Camera/F-bookCover/DSC04218.JPG,char_data/어/DSC04218.JPG_5.jpg,3136,480,640,49,188,237,331,395,True,72
어,69,kaist_dataset/Korean/Digital_Camera/F-bookCover/DSC04227.JPG,char_data/어/DSC04227.JPG_2.jpg,3657,480,640,53,96,149,68,137,True,72
어,79,kaist_dataset/Korean/Digital_Camera/G-others/2007-12-08-day-112.jpg,char_data/어/2007-12-08-day-112.jpg_2.jpg,4819,1200,1600,61,606,667,515,594,True,72
어,267,kaist_dataset/Korean/Digital_Camera/G-others/2007-12-09-day-exterior-062.jpg,char_data/어/2007-12-09-day-exterior-062.jpg_2.jpg,69153,1600,1200,259,488,747,303,570,True,72
어,28,kaist_dataset/Korean/Digital_Camera/G-others/DSC03863.JPG,char_data/어/DSC03863.JPG_2.jpg,840,480,640,30,247,277,449,477,True,72
어,38,kaist_dataset/Korean/Digital_Camera/indoor1/DSC02742.JPG,char_data/어/DSC02742.JPG_2.jpg,1178,480,640,31,369,400,200,238,True,72
어,35,kaist_dataset/Korean/Digital_Camera/indoor1/DSC02743.JPG,char_data/어/DSC02743.JPG_2.jpg,1505,480,640,43,302,345,177,212,True,72
어,124,kaist_dataset/Korean/Digital_Camera/indoor1/DSC02744.JPG,char_data/어/DSC02744.JPG_2.jpg,15624,480,640,126,141,267,215,339,True,72
어,43,kaist_dataset/Korean/Digital_Camera/indoor1/DSC03113.JPG,char_data/어/DSC03113.JPG_2.jpg,1333,480,640,31,371,402,160,203,True,72
어,131,kaist_dataset/Korean/Digital_Camera/indoor1/DSC03344.JPG,char_data/어/DSC03344.JPG_2.jpg,13100,480,640,100,377,477,153,284,True,72
어,107,kaist_dataset/Korean/Digital_Camera/indoor2/DSC03476.JPG,char_data/어/DSC03476.JPG_2.jpg,10914,480,640,102,75,177,247,354,True,72
어,131,kaist_dataset/Korean/Digital_Camera/indoor2/DSC03994.JPG,char_data/어/DSC03994.JPG_2.jpg,8122,480,640,62,479,541,141,272,True,72
어,45,kaist_dataset/Korean/Digital_Camera/indoor2/DSC03995.JPG,char_data/어/DSC03995.JPG_2.jpg,1980,480,640,44,335,379,270,315,True,72
어,58,kaist_dataset/Korean/Digital_Camera/indoor2/DSC04422.JPG,char_data/어/DSC04422.JPG_2.jpg,2726,480,640,47,356,403,227,285,True,72
어,36,kaist_dataset/Korean/Digital_Camera/outdoor1/023.JPG,char_data/어/023.JPG_2.jpg,1044,480,640,29,358,387,264,300,True,72
어,34,kaist_dataset/Korean/Digital_Camera/outdoor1/029.JPG,char_data/어/029.JPG_2.jpg,1190,480,640,35,169,204,149,183,True,72
어,36,kaist_dataset/Korean/Digital_Camera/outdoor1/046.jpg,char_data/어/046.jpg_2.jpg,1008,256,363,28,140,168,113,149,True,72
어,38,kaist_dataset/Korean/Digital_Camera/outdoor1/128.JPG,char_data/어/128.JPG_2.jpg,1216,480,640,32,9,41,116,154,True,72
어,67,kaist_dataset/Korean/Digital_Camera/outdoor1/2007-12-08-day-050.jpg,char_data/어/2007-12-08-day-050.jpg_2.jpg,4958,1200,1600,74,562,636,926,993,True,72
어,52,kaist_dataset/Korean/Digital_Camera/outdoor1/39.jpg,char_data/어/39.jpg_2.jpg,1872,197,320,36,125,161,67,119,True,72
어,54,kaist_dataset/Korean/Digital_Camera/outdoor2/2007-12-09-day-exterior-008.jpg,char_data/어/2007-12-09-day-exterior-008.jpg_2.jpg,3510,1200,1600,65,1388,1453,533,587,True,72
어,46,kaist_dataset/Korean/Digital_Camera/outdoor2/2007-12-09-day-exterior-036.jpg,char_data/어/2007-12-09-day-exterior-036.jpg_2.jpg,1886,1200,1600,41,1305,1346,625,671,True,72
어,116,kaist_dataset/Korean/Digital_Camera/outdoor2/DSC02371.JPG,char_data/어/DSC02371.JPG_2.jpg,12644,480,640,109,401,510,123,239,True,72
어,98,kaist_dataset/Korean/Digital_Camera/outdoor2/DSC02372.JPG,char_data/어/DSC02372.JPG_2.jpg,4998,480,640,51,33,84,225,323,True,72
어,104,kaist_dataset/Korean/Digital_Camera/outdoor2/DSC02393.JPG,char_data/어/DSC02393.JPG_2.jpg,12272,480,640,118,303,421,164,268,True,72
어,105,kaist_dataset/Korean/Digital_Camera/outdoor2/DSC02424.JPG,char_data/어/DSC02424.JPG_2.jpg,9765,480,640,93,326,419,137,242,True,72
어,63,kaist_dataset/Korean/Digital_Camera/outdoor2/DSC02476.JPG,char_data/어/DSC02476.JPG_2.jpg,4662,480,640,74,302,376,212,275,True,72
어,73,kaist_dataset/Korean/Digital_Camera/outdoor2/DSC02485.JPG,char_data/어/DSC02485.JPG_4.jpg,8249,480,640,113,325,438,174,247,True,72
어,44,kaist_dataset/Korean/Digital_Camera/outdoor2/DSC02485.JPG,char_data/어/DSC02485.JPG_5.jpg,1804,480,640,41,447,488,272,316,True,72
어,136,kaist_dataset/Korean/Digital_Camera/outdoor2/DSC02497.JPG,char_data/어/DSC02497.JPG_2.jpg,14552,480,640,107,259,366,223,359,True,72
어,61,kaist_dataset/Korean/Digital_Camera/outdoor3/DSC02943.JPG,char_data/어/DSC02943.JPG_2.jpg,4758,480,640,78,518,596,383,444,True,72
어,60,kaist_dataset/Korean/Digital_Camera/outdoor3/DSC02944.JPG,char_data/어/DSC02944.JPG_2.jpg,2940,480,640,49,376,425,163,223,True,72
어,34,kaist_dataset/Korean/Digital_Camera/outdoor3/DSC03235.JPG,char_data/어/DSC03235.JPG_2.jpg,1088,480,640,32,253,285,370,404,True,72
어,96,kaist_dataset/Korean/Digital_Camera/outdoor3/DSC03237.JPG,char_data/어/DSC03237.JPG_2.jpg,11136,480,640,116,486,602,200,296,True,72
어,106,kaist_dataset/Korean/Digital_Camera/outdoor4/DSC03253.JPG,char_data/어/DSC03253.JPG_2.jpg,11130,480,640,105,67,172,338,444,True,72
어,126,kaist_dataset/Korean/Digital_Camera/outdoor4/DSC03261.JPG,char_data/어/DSC03261.JPG_2.jpg,14490,480,640,115,254,369,259,385,True,72
어,71,kaist_dataset/Korean/Digital_Camera/outdoor4/DSC03326.JPG,char_data/어/DSC03326.JPG_2.jpg,4828,480,640,68,420,488,188,259,True,72
어,46,kaist_dataset/Korean/Digital_Camera/outdoor4/DSC03443.JPG,char_data/어/DSC03443.JPG_2.jpg,1610,480,640,35,64,99,259,305,True,72
어,127,kaist_dataset/Korean/Digital_Camera/outdoor4/DSC03538.JPG,char_data/어/DSC03538.JPG_2.jpg,11430,480,640,90,30,120,174,301,True,72
어,41,kaist_dataset/Korean/Digital_Camera/outdoor4/DSC03578.JPG,char_data/어/DSC03578.JPG_2.jpg,820,480,640,20,426,446,147,188,True,72
어,68,kaist_dataset/Korean/Digital_Camera/outdoor4/DSC03580.JPG,char_data/어/DSC03580.JPG_2.jpg,4488,480,640,66,233,299,125,193,True,72
어,85,kaist_dataset/Korean/Digital_Camera/outdoor4/DSC03585.JPG,char_data/어/DSC03585.JPG_2.jpg,7140,480,640,84,91,175,343,428,True,72
어,80,kaist_dataset/Korean/Digital_Camera/outdoor4/DSC03590.JPG,char_data/어/DSC03590.JPG_2.jpg,5360,480,640,67,488,555,122,202,True,72
어,85,kaist_dataset/Korean/Digital_Camera/outdoor4/DSC03606.JPG,char_data/어/DSC03606.JPG_2.jpg,6460,480,640,76,240,316,333,418,True,72
어,87,kaist_dataset/Korean/Digital_Camera/outdoor4/DSC03608.JPG,char_data/어/DSC03608.JPG_2.jpg,5916,480,640,68,230,298,48,135,True,72
어,132,kaist_dataset/Korean/Digital_Camera/outdoor5/DSC03624.JPG,char_data/어/DSC03624.JPG_2.jpg,10428,480,640,79,192,271,282,414,True,72
어,131,kaist_dataset/Korean/Digital_Camera/outdoor5/DSC03625.JPG,char_data/어/DSC03625.JPG_2.jpg,8777,480,640,67,204,271,71,202,True,72
어,54,kaist_dataset/Korean/Digital_Camera/outdoor5/DSC03641.JPG,char_data/어/DSC03641.JPG_2.jpg,2538,480,640,47,70,117,329,383,True,72
어,90,kaist_dataset/Korean/Digital_Camera/outdoor5/DSC03714.JPG,char_data/어/DSC03714.JPG_2.jpg,7560,480,640,84,348,432,156,246,True,72
어,29,kaist_dataset/Korean/Digital_Camera/outdoor5/DSC03751.JPG,char_data/어/DSC03751.JPG_4.jpg,899,480,640,31,554,585,339,368,True,72
어,28,kaist_dataset/Korean/Digital_Camera/outdoor5/DSC03751.JPG,char_data/어/DSC03751.JPG_5.jpg,700,480,640,25,532,557,404,432,True,72
어,36,kaist_dataset/Korean/Digital_Camera/outdoor5/DSC03768.JPG,char_data/어/DSC03768.JPG_2.jpg,1332,480,640,37,325,362,239,275,True,72
어,25,kaist_dataset/Korean/Digital_Camera/outdoor5/DSC03777.JPG,char_data/어/DSC03777.JPG_2.jpg,575,480,640,23,105,128,275,300,True,72
어,42,kaist_dataset/Korean/Digital_Camera/outdoor5/DSC03794.JPG,char_data/어/DSC03794.JPG_2.jpg,1428,480,640,34,428,462,306,348,True,72
어,70,kaist_dataset/Korean/Digital_Camera/outdoor5/DSC03834.JPG,char_data/어/DSC03834.JPG_2.jpg,5390,480,640,77,103,180,122,192,True,72
어,60,kaist_dataset/Korean/Digital_Camera/outdoor5/DSC03996.JPG,char_data/어/DSC03996.JPG_2.jpg,2340,480,640,39,470,509,82,142,True,72
어,108,kaist_dataset/Korean/Digital_Camera/outdoor5/DSC04036.JPG,char_data/어/DSC04036.JPG_2.jpg,11124,480,640,103,291,394,66,174,True,72
어,61,kaist_dataset/Korean/Digital_Camera/outdoor6/DSC04062.JPG,char_data/어/DSC04062.JPG_2.jpg,4087,480,640,67,552,619,222,283,True,72
어,90,kaist_dataset/Korean/Digital_Camera/outdoor6/DSC04096.JPG,char_data/어/DSC04096.JPG_2.jpg,5670,480,640,63,290,353,104,194,True,72
어,59,kaist_dataset/Korean/Digital_Camera/outdoor6/DSC04118.JPG,char_data/어/DSC04118.JPG_2.jpg,2596,480,640,44,344,388,191,250,True,72
어,51,kaist_dataset/Korean/Digital_Camera/outdoor6/DSC04137.JPG,char_data/어/DSC04137.JPG_2.jpg,2907,480,640,57,518,575,400,451,True,72
어,75,kaist_dataset/Korean/Digital_Camera/outdoor6/DSC04138.JPG,char_data/어/DSC04138.JPG_4.jpg,7350,480,640,98,232,330,80,155,True,72
어,33,kaist_dataset/Korean/Digital_Camera/outdoor6/DSC04138.JPG,char_data/어/DSC04138.JPG_5.jpg,825,480,640,25,195,220,49,82,True,72
어,107,kaist_dataset/Korean/Digital_Camera/outdoor6/DSC04158.JPG,char_data/어/DSC04158.JPG_4.jpg,8988,480,640,84,227,311,310,417,True,72
어,87,kaist_dataset/Korean/Digital_Camera/outdoor6/DSC04158.JPG,char_data/어/DSC04158.JPG_5.jpg,6090,480,640,70,272,342,213,300,True,72
어,51,kaist_dataset/Korean/Digital_Camera/outdoor6/DSC04161.JPG,char_data/어/DSC04161.JPG_2.jpg,2499,480,640,49,247,296,116,167,True,72
어,87,kaist_dataset/Korean/Digital_Camera/outdoor6/DSC04295.JPG,char_data/어/DSC04295.JPG_2.jpg,6786,480,640,78,383,461,210,297,True,72
어,58,kaist_dataset/Korean/Digital_Camera/outdoor6/DSC04319.JPG,char_data/어/DSC04319.JPG_2.jpg,3480,480,640,60,66,126,110,168,True,72
어,77,kaist_dataset/Korean/Digital_Camera/outdoor6/DSC04328.JPG,char_data/어/DSC04328.JPG_2.jpg,3542,480,640,46,400,446,19,96,True,72
어,87,kaist_dataset/Korean/Digital_Camera/outdoor6/DSC04350.JPG,char_data/어/DSC04350.JPG_2.jpg,4263,480,640,49,465,514,321,408,True,72
어,89,kaist_dataset/Korean/Digital_Camera/outdoor6/DSC04359.JPG,char_data/어/DSC04359.JPG_2.jpg,5785,480,640,65,362,427,12,101,True,72
어,104,kaist_dataset/Korean/Digital_Camera/outdoor6/DSC04398.JPG,char_data/어/DSC04398.JPG_2.jpg,9464,480,640,91,254,345,243,347,True,72
어,107,kaist_dataset/Korean/Digital_Camera/outdoor6/DSC04435.JPG,char_data/어/DSC04435.JPG_2.jpg,9309,480,640,87,459,546,132,239,True,72
어,86,kaist_dataset/Korean/Digital_Camera/outdoor6/DSC04439.JPG,char_data/어/DSC04439.JPG_2.jpg,6278,480,640,73,221,294,55,141,True,72
어,99,kaist_dataset/Korean/Digital_Camera/outdoor6/DSC04441.JPG,char_data/어/DSC04441.JPG_2.jpg,9405,480,640,95,412,507,313,412,True,72
어,123,kaist_dataset/Korean/Digital_Camera/outdoor7/DSC04472.JPG,char_data/어/DSC04472.JPG_2.jpg,15621,480,640,127,461,588,182,305,True,72
어,66,kaist_dataset/Korean/Digital_Camera/outdoor7/P1010009.JPG,char_data/어/P1010009.JPG_2.jpg,4554,480,640,69,516,585,157,223,True,72
어,83,kaist_dataset/Korean/Digital_Camera/outdoor7/P1010013.JPG,char_data/어/P1010013.JPG_2.jpg,3486,480,640,42,221,263,100,183,True,72
어,80,kaist_dataset/Korean/Digital_Camera/outdoor7/P1010072.JPG,char_data/어/P1010072.JPG_2.jpg,4480,480,640,56,188,244,133,213,True,72
어,80,kaist_dataset/Korean/Digital_Camera/outdoor7/P1010101.JPG,char_data/어/P1010101.JPG_2.jpg,6240,480,640,78,517,595,129,209,True,72
어,81,kaist_dataset/Korean/Digital_Camera/outdoor7/P1010106.JPG,char_data/어/P1010106.JPG_2.jpg,6966,480,640,86,360,446,95,176,True,72
어,80,"kaist_dataset/Korean/Mobile_Phone/(M,K)A-shadow/P090912065.jpg",char_data/어/P090912065.jpg_2.jpg,5440,480,640,68,100,168,66,146,True,72
어,129,"kaist_dataset/Korean/Mobile_Phone/(M,K)C-outdoor/P090912033.jpg",char_data/어/P090912033.jpg_2.jpg,11739,480,640,91,95,186,168,297,True,72
어,111,"kaist_dataset/Korean/Mobile_Phone/(M,K)D-indoor/P090912025.jpg",char_data/어/P090912025.jpg_2.jpg,11322,480,640,102,111,213,99,210,True,72
어,104,"kaist_dataset/Korean/Mobile_Phone/(M,K)E-bookCover/P090831032.jpg",char_data/어/P090831032.jpg_2.jpg,9256,480,640,89,352,441,309,413,True,72
어,39,"kaist_dataset/Korean/Mobile_Phone/(M,K)E-bookCover/P090831033.jpg",char_data/어/P090831033.jpg_2.jpg,1365,480,640,35,469,504,354,393,True,72
어,85,"kaist_dataset/Korean/Mobile_Phone/(M,K)E-bookCover/P090831034.jpg",char_data/어/P090831034.jpg_2.jpg,5780,480,640,68,95,163,81,166,True,72
어,202,"kaist_dataset/Korean/Mobile_Phone/(M,K)E-bookCover/P090831061.jpg",char_data/어/P090831061.jpg_2.jpg,23836,480,640,118,133,251,36,238,True,72
어,127,"kaist_dataset/Korean/Mobile_Phone/(M,K)E-bookCover/P090831070.jpg",char_data/어/P090831070.jpg_2.jpg,11176,480,640,88,450,538,190,317,True,72
어,138,"kaist_dataset/Korean/Mobile_Phone/(M,K)E-bookCover/P090831071.jpg",char_data/어/P090831071.jpg_2.jpg,14628,480,640,106,13,119,303,441,True,72
어,123,"kaist_dataset/Korean/Mobile_Phone/(M,K)E-bookCover/P090831127.jpg",char_data/어/P090831127.jpg_2.jpg,9594,480,640,78,373,451,222,345,True,72
어,157,"kaist_dataset/Korean/Mobile_Phone/(M,K)E-bookCover/P090831153.jpg",char_data/어/P090831153.jpg_2.jpg,23079,480,640,147,168,315,215,372,True,72
어,33,"kaist_dataset/Korean/Mobile_Phone/(M,K)E-bookCover/P090903032.jpg",char_data/어/P090903032.jpg_2.jpg,858,480,640,26,216,242,261,294,True,72
어,67,"kaist_dataset/Korean/Mobile_Phone/(M,K)E-bookCover/P090903043.jpg",char_data/어/P090903043.jpg_2.jpg,3819,480,640,57,122,179,129,196,True,72
어,137,"kaist_dataset/Korean/Mobile_Phone/(M,K)E-bookCover/P090903091.jpg",char_data/어/P090903091.jpg_2.jpg,13015,480,640,95,233,328,233,370,True,72
어,126,"kaist_dataset/Korean/Mobile_Phone/(M,K)E-bookCover/P090903097.jpg",char_data/어/P090903097.jpg_2.jpg,14616,480,640,116,316,432,43,169,True,72
어,57,"kaist_dataset/Korean/Mobile_Phone/(M,K)E-bookCover/P090905008.jpg",char_data/어/P090905008.jpg_2.jpg,2679,480,640,47,205,252,58,115,True,72
어,82,kaist_dataset/Mixed/Digital_Camera/(C.S)A-shadow/DSC02902.JPG,char_data/어/DSC02902.JPG_2.jpg,4182,480,640,51,160,211,304,386,True,72
어,77,kaist_dataset/Mixed/Digital_Camera/(C.S)B-light/P090911079.jpg,char_data/어/P090911079.jpg_2.jpg,5236,480,640,68,281,349,266,343,True,72
어,20,kaist_dataset/Mixed/Digital_Camera/(C.S)C-outdoor1/014.JPG,char_data/어/014.JPG_2.jpg,400,480,640,20,546,566,277,297,True,72
어,23,kaist_dataset/Mixed/Digital_Camera/(C.S)C-outdoor1/027.JPG,char_data/어/027.JPG_2.jpg,391,480,640,17,273,290,277,300,True,72
어,53,kaist_dataset/Mixed/Digital_Camera/(C.S)C-outdoor1/066.JPG,char_data/어/066.JPG_2.jpg,2650,480,640,50,138,188,185,238,True,72
어,25,kaist_dataset/Mixed/Digital_Camera/(C.S)C-outdoor1/090.JPG,char_data/어/090.JPG_4.jpg,525,480,640,21,137,158,311,336,True,72
어,138,kaist_dataset/Mixed/Digital_Camera/(C.S)C-outdoor1/090.JPG,char_data/어/090.JPG_5.jpg,11868,480,640,86,540,626,176,314,True,72
어,82,kaist_dataset/Mixed/Digital_Camera/(C.S)C-outdoor1/112.JPG,char_data/어/112.JPG_2.jpg,6806,480,640,83,530,613,175,257,True,72
어,54,kaist_dataset/Mixed/Digital_Camera/(C.S)C-outdoor1/2.JPG,char_data/어/2.JPG_2.jpg,1998,576,768,37,192,229,222,276,True,72
어,74,kaist_dataset/Mixed/Digital_Camera/(C.S)C-outdoor2/DSC02382.JPG,char_data/어/DSC02382.JPG_2.jpg,5698,480,640,77,536,613,227,301,True,72
어,77,kaist_dataset/Mixed/Digital_Camera/(C.S)C-outdoor2/DSC02397.JPG,char_data/어/DSC02397.JPG_2.jpg,9548,480,640,124,356,480,100,177,True,72
어,88,kaist_dataset/Mixed/Digital_Camera/(C.S)C-outdoor2/DSC02429.JPG,char_data/어/DSC02429.JPG_2.jpg,9592,480,640,109,199,308,64,152,True,72
어,58,kaist_dataset/Mixed/Digital_Camera/(C.S)C-outdoor2/DSC02483.JPG,char_data/어/DSC02483.JPG_4.jpg,6206,480,640,107,340,447,180,238,True,72
어,52,kaist_dataset/Mixed/Digital_Camera/(C.S)C-outdoor2/DSC02483.JPG,char_data/어/DSC02483.JPG_5.jpg,2860,480,640,55,418,473,284,336,True,72
어,66,kaist_dataset/Mixed/Digital_Camera/(C.S)C-outdoor2/DSC02511.JPG,char_data/어/DSC02511.JPG_2.jpg,5280,480,640,80,287,367,141,207,True,72
어,102,kaist_dataset/Mixed/Digital_Camera/(C.S)C-outdoor2/DSC02556.JPG,char_data/어/DSC02556.JPG_2.jpg,6834,480,640,67,272,339,203,305,True,72
어,58,kaist_dataset/Mixed/Digital_Camera/(C.S)C-outdoor2/DSC02886.JPG,char_data/어/DSC02886.JPG_2.jpg,3770,480,640,65,338,403,79,137,True,72
어,80,kaist_dataset/Mixed/Digital_Camera/(C.S)C-outdoor2/DSC02887.JPG,char_data/어/DSC02887.JPG_4.jpg,9200,480,640,115,255,370,31,111,True,72
어,46,kaist_dataset/Mixed/Digital_Camera/(C.S)C-outdoor2/DSC02887.JPG,char_data/어/DSC02887.JPG_5.jpg,1748,480,640,38,261,299,239,285,True,72
어,96,kaist_dataset/Mixed/Digital_Camera/(C.S)C-outdoor3/DSC03187.JPG,char_data/어/DSC03187.JPG_2.jpg,10272,480,640,107,424,531,278,374,True,72
어,107,kaist_dataset/Mixed/Digital_Camera/(C.S)C-outdoor3/DSC03274.JPG,char_data/어/DSC03274.JPG_2.jpg,7704,480,640,72,270,342,254,361,True,72
어,109,kaist_dataset/Mixed/Digital_Camera/(C.S)C-outdoor3/DSC03308.JPG,char_data/어/DSC03308.JPG_2.jpg,11772,480,640,108,400,508,126,235,True,72
어,118,kaist_dataset/Mixed/Digital_Camera/(C.S)C-outdoor3/DSC03421.JPG,char_data/어/DSC03421.JPG_2.jpg,9204,480,640,78,486,564,344,462,True,72
어,56,kaist_dataset/Mixed/Digital_Camera/(C.S)C-outdoor4/DSC03579.JPG,char_data/어/DSC03579.JPG_2.jpg,3976,480,640,71,261,332,208,264,True,72
어,117,kaist_dataset/Mixed/Digital_Camera/(C.S)C-outdoor4/DSC03658.JPG,char_data/어/DSC03658.JPG_2.jpg,9594,480,640,82,404,486,285,402,True,72
어,43,kaist_dataset/Mixed/Digital_Camera/(C.S)C-outdoor4/DSC03678.JPG,char_data/어/DSC03678.JPG_4.jpg,1419,480,640,33,309,342,186,229,True,72
어,53,kaist_dataset/Mixed/Digital_Camera/(C.S)C-outdoor4/DSC03678.JPG,char_data/어/DSC03678.JPG_5.jpg,1855,480,640,35,490,525,178,231,False,72
어,67,kaist_dataset/Mixed/Digital_Camera/(C.S)C-outdoor4/DSC03679.JPG,char_data/어/DSC03679.JPG_2.jpg,5025,480,640,75,477,552,180,247,False,72
어,79,kaist_dataset/Mixed/Digital_Camera/(C.S)C-outdoor4/DSC03693.JPG,char_data/어/DSC03693.JPG_2.jpg,7742,480,640,98,267,365,243,322,False,72
어,60,kaist_dataset/Mixed/Digital_Camera/(C.S)C-outdoor4/DSC03707.JPG,char_data/어/DSC03707.JPG_2.jpg,2580,480,640,43,238,281,274,334,False,72
어,99,kaist_dataset/Mixed/Digital_Camera/(C.S)C-outdoor4/DSC03711.JPG,char_data/어/DSC03711.JPG_2.jpg,6237,480,640,63,314,377,238,337,False,72
어,58,kaist_dataset/Mixed/Digital_Camera/(C.S)C-outdoor4/DSC03718.JPG,char_data/어/DSC03718.JPG_4.jpg,2842,480,640,49,173,222,74,132,False,72
어,69,kaist_dataset/Mixed/Digital_Camera/(C.S)C-outdoor4/DSC03718.JPG,char_data/어/DSC03718.JPG_5.jpg,3726,480,640,54,435,489,308,377,False,72
어,81,kaist_dataset/Mixed/Digital_Camera/(C.S)C-outdoor4/DSC03719.JPG,char_data/어/DSC03719.JPG_2.jpg,4131,480,640,51,445,496,81,162,False,72
어,98,kaist_dataset/Mixed/Digital_Camera/(C.S)C-outdoor4/DSC03723.JPG,char_data/어/DSC03723.JPG_2.jpg,7448,480,640,76,414,490,66,164,False,72
어,106,kaist_dataset/Mixed/Digital_Camera/(C.S)C-outdoor4/DSC03769.JPG,char_data/어/DSC03769.JPG_2.jpg,6254,480,640,59,202,261,294,400,False,72
어,67,kaist_dataset/Mixed/Digital_Camera/(C.S)C-outdoor5/DSC04059.JPG,char_data/어/DSC04059.JPG_2.jpg,3149,480,640,47,211,258,116,183,False,72
어,49,kaist_dataset/Mixed/Digital_Camera/(C.S)C-outdoor5/DSC04061.JPG,char_data/어/DSC04061.JPG_2.jpg,3479,480,640,71,526,597,36,85,False,72
어,93,kaist_dataset/Mixed/Digital_Camera/(C.S)C-outdoor5/DSC04122.JPG,char_data/어/DSC04122.JPG_4.jpg,8556,480,640,92,514,606,293,386,False,72
어,36,kaist_dataset/Mixed/Digital_Camera/(C.S)C-outdoor5/DSC04122.JPG,char_data/어/DSC04122.JPG_5.jpg,684,480,640,19,526,545,414,450,False,72
어,95,kaist_dataset/Mixed/Digital_Camera/(C.S)C-outdoor5/DSC04349.JPG,char_data/어/DSC04349.JPG_2.jpg,6650,480,640,70,402,472,85,180,False,72
어,183,kaist_dataset/Mixed/Digital_Camera/(C.S)C-outdoor5/DSC04360.JPG,char_data/어/DSC04360.JPG_2.jpg,19947,480,640,109,289,398,275,458,False,72
어,71,kaist_dataset/Mixed/Digital_Camera/(C.S)C-outdoor5/P1010004.JPG,char_data/어/P1010004.JPG_2.jpg,4757,480,640,67,225,292,168,239,False,72
어,66,kaist_dataset/Mixed/Digital_Camera/(C.S)C-outdoor6/080116-0057.jpg,char_data/어/080116-0057.jpg_2.jpg,3300,1200,1600,50,752,802,906,972,False,72
어,70,kaist_dataset/Mixed/Digital_Camera/(C.S)C-outdoor6/P1010088.JPG,char_data/어/P1010088.JPG_2.jpg,5460,480,640,78,329,407,107,177,False,72
어,66,kaist_dataset/Mixed/Digital_Camera/(C.S)C-outdoor6/P1010090.JPG,char_data/어/P1010090.JPG_2.jpg,4554,480,640,69,527,596,128,194,False,72
어,32,kaist_dataset/Mixed/Digital_Camera/(C.S)C-outdoor6/P1010096.JPG,char_data/어/P1010096.JPG_2.jpg,768,480,640,24,455,479,155,187,False,72
어,78,kaist_dataset/Mixed/Digital_Camera/(C.S)D-indoor1/DSC02747.JPG,char_data/어/DSC02747.JPG_2.jpg,6162,480,640,79,520,599,287,365,False,72
어,56,kaist_dataset/Mixed/Digital_Camera/(C.S)D-indoor1/DSC02748.JPG,char_data/어/DSC02748.JPG_2.jpg,3808,480,640,68,466,534,308,364,False,72
어,84,kaist_dataset/Mixed/Digital_Camera/(C.S)D-indoor1/DSC02804.JPG,char_data/어/DSC02804.JPG_2.jpg,5964,480,640,71,420,491,252,336,False,72
어,41,kaist_dataset/Mixed/Digital_Camera/(C.S)D-indoor1/DSC03909.JPG,char_data/어/DSC03909.JPG_2.jpg,984,480,640,24,249,273,301,342,False,72
어,67,kaist_dataset/Mixed/Digital_Camera/(C.S)D-indoor2/DSC04254.JPG,char_data/어/DSC04254.JPG_2.jpg,2948,480,640,44,401,445,265,332,False,72
어,81,kaist_dataset/Mixed/Digital_Camera/(C.S)D-indoor2/P090911016.jpg,char_data/어/P090911016.jpg_4.jpg,5994,480,640,74,253,327,138,219,False,72
어,78,kaist_dataset/Mixed/Digital_Camera/(C.S)D-indoor2/P090911016.jpg,char_data/어/P090911016.jpg_5.jpg,6318,480,640,81,397,478,147,225,False,72
어,105,kaist_dataset/Mixed/Digital_Camera/(C.S)E-night/DSC02623.JPG,char_data/어/DSC02623.JPG_2.jpg,8610,480,640,82,196,278,275,380,False,72
어,57,kaist_dataset/Mixed/Digital_Camera/(C.S)E-night/DSC02644.JPG,char_data/어/DSC02644.JPG_2.jpg,5643,480,640,99,238,337,297,354,False,72
어,77,kaist_dataset/Mixed/Digital_Camera/(C.S)E-night/DSC02903.JPG,char_data/어/DSC02903.JPG_2.jpg,5544,480,640,72,388,460,174,251,False,72
어,38,kaist_dataset/Mixed/Digital_Camera/(C.S)E-night/DSC03561.JPG,char_data/어/DSC03561.JPG_2.jpg,1292,480,640,34,212,246,34,72,False,72
어,40,kaist_dataset/Mixed/Digital_Camera/(C.S)F-others/DSC02504.JPG,char_data/어/DSC02504.JPG_2.jpg,2160,480,640,54,47,101,100,140,False,72
어,50,kaist_dataset/Mixed/Mobile_Phone/(C.M)C-bookCover/P090904005.jpg,char_data/어/P090904005.jpg_2.jpg,2100,480,640,42,332,374,390,440,False,72
M,85,kaist_dataset/English/Digital_Camera/(E.S)A-shadow/DSC02423.JPG,char_data/M/DSC02423.JPG_2.jpg,6375,480,640,75,1,75,149,234,True,23
M,59,kaist_dataset/English/Digital_Camera/(E.S)A-shadow/DSC03082.JPG,char_data/M/DSC03082.JPG_2.jpg,2596,480,640,44,360,404,369,428,True,23
M,80,kaist_dataset/English/Digital_Camera/(E.S)A-shadow/DSC03084.JPG,char_data/M/DSC03084.JPG_2.jpg,3680,480,640,46,376,422,347,427,True,23
M,178,kaist_dataset/English/Digital_Camera/(E.S)B-light/080116-0059.jpg,char_data/M/080116-0059.jpg_12.jpg,23318,1200,1600,131,445,576,299,477,True,23
M,32,kaist_dataset/English/Digital_Camera/(E.S)B-light/080116-0059.jpg,char_data/M/080116-0059.jpg_13.jpg,736,1200,1600,23,855,878,825,857,True,23
M,30,kaist_dataset/English/Digital_Camera/(E.S)B-light/080116-0059.jpg,char_data/M/080116-0059.jpg_14.jpg,570,1200,1600,19,501,520,802,832,True,23
M,25,kaist_dataset/English/Digital_Camera/(E.S)B-light/080116-0059.jpg,char_data/M/080116-0059.jpg_15.jpg,475,1200,1600,19,661,680,801,826,True,23
M,26,kaist_dataset/English/Digital_Camera/(E.S)B-light/080116-0059.jpg,char_data/M/080116-0059.jpg_16.jpg,468,1200,1600,18,681,699,802,828,True,23
M,29,kaist_dataset/English/Digital_Camera/(E.S)B-light/080116-0059.jpg,char_data/M/080116-0059.jpg_17.jpg,493,1200,1600,17,972,989,797,826,True,23
M,53,kaist_dataset/English/Digital_Camera/(E.S)B-light/DSC02712.JPG,char_data/M/DSC02712.JPG_2.jpg,1802,480,640,34,272,306,218,271,True,23
M,51,kaist_dataset/English/Digital_Camera/(E.S)B-light/DSC03007.JPG,char_data/M/DSC03007.JPG_2.jpg,1683,480,640,33,245,278,271,322,True,23
M,80,kaist_dataset/English/Digital_Camera/(E.S)B-light/크기변환_%B0%A3%C6%C74_fabdent.jpg,char_data/M/크기변환_%B0%A3%C6%C74_fabdent.jpg_2.jpg,5120,480,640,64,279,343,148,228,True,23
M,45,kaist_dataset/English/Digital_Camera/(E.S)C-outdoor1/004.jpg,char_data/M/004.jpg_2.jpg,2295,269,413,51,47,98,33,78,True,23
M,20,kaist_dataset/English/Digital_Camera/(E.S)C-outdoor1/061.jpg,char_data/M/061.jpg_2.jpg,540,219,323,27,108,135,68,88,True,23
M,33,kaist_dataset/English/Digital_Camera/(E.S)C-outdoor1/065.jpg,char_data/M/065.jpg_8.jpg,1254,374,515,38,46,84,161,194,True,23
M,43,kaist_dataset/English/Digital_Camera/(E.S)C-outdoor1/065.jpg,char_data/M/065.jpg_9.jpg,1462,374,515,34,123,157,155,198,True,23
M,51,kaist_dataset/English/Digital_Camera/(E.S)C-outdoor1/065.jpg,char_data/M/065.jpg_10.jpg,2448,374,515,48,295,343,132,183,True,23
M,55,kaist_dataset/English/Digital_Camera/(E.S)C-outdoor1/065.jpg,char_data/M/065.jpg_11.jpg,2255,374,515,41,381,422,134,189,True,23
M,309,kaist_dataset/English/Digital_Camera/(E.S)C-outdoor1/080119-0004.jpg,char_data/M/080119-0004.jpg_2.jpg,101043,1200,1600,327,257,584,454,763,True,23
M,130,kaist_dataset/English/Digital_Camera/(E.S)C-outdoor1/108.JPG,char_data/M/108.JPG_2.jpg,18460,480,640,142,176,318,200,330,True,23
M,66,kaist_dataset/English/Digital_Camera/(E.S)C-outdoor1/109.jpg,char_data/M/109.jpg_2.jpg,3696,480,640,56,208,264,172,238,True,23
M,156,kaist_dataset/English/Digital_Camera/(E.S)C-outdoor1/142.JPG,char_data/M/142.JPG_2.jpg,19812,480,640,127,171,298,193,349,True,23
M,211,kaist_dataset/English/Digital_Camera/(E.S)C-outdoor1/2007-12-08-day-099.jpg,char_data/M/2007-12-08-day-099.jpg_2.jpg,35026,1200,1600,166,845,1011,453,664,True,23
M,144,kaist_dataset/English/Digital_Camera/(E.S)C-outdoor1/DSC02406.JPG,char_data/M/DSC02406.JPG_2.jpg,22752,480,640,158,75,233,119,263,True,23
M,81,kaist_dataset/English/Digital_Camera/(E.S)C-outdoor1/DSC02408.JPG,char_data/M/DSC02408.JPG_2.jpg,6885,480,640,85,58,143,260,341,True,23
M,92,kaist_dataset/English/Digital_Camera/(E.S)C-outdoor1/DSC02410.JPG,char_data/M/DSC02410.JPG_2.jpg,9476,480,640,103,494,597,118,210,True,23
M,71,kaist_dataset/English/Digital_Camera/(E.S)C-outdoor1/DSC02417.JPG,char_data/M/DSC02417.JPG_4.jpg,5751,480,640,81,197,278,135,206,True,23
M,79,kaist_dataset/English/Digital_Camera/(E.S)C-outdoor1/DSC02417.JPG,char_data/M/DSC02417.JPG_5.jpg,7189,480,640,91,280,371,132,211,True,23
M,112,kaist_dataset/English/Digital_Camera/(E.S)C-outdoor1/DSC02500.JPG,char_data/M/DSC02500.JPG_2.jpg,9744,480,640,87,312,399,173,285,True,23
M,60,kaist_dataset/English/Digital_Camera/(E.S)C-outdoor1/DSC02559.JPG,char_data/M/DSC02559.JPG_2.jpg,3300,480,640,55,424,479,104,164,True,23
M,70,kaist_dataset/English/Digital_Camera/(E.S)C-outdoor2/DSC03025.JPG,char_data/M/DSC03025.JPG_2.jpg,3430,480,640,49,166,215,123,193,True,23
M,163,kaist_dataset/English/Digital_Camera/(E.S)C-outdoor2/DSC03160.JPG,char_data/M/DSC03160.JPG_2.jpg,29340,480,640,180,12,192,216,379,True,23
M,68,kaist_dataset/English/Digital_Camera/(E.S)C-outdoor2/DSC03170.JPG,char_data/M/DSC03170.JPG_2.jpg,3740,480,640,55,278,333,298,366,True,23
M,33,kaist_dataset/English/Digital_Camera/(E.S)C-outdoor2/DSC03208.JPG,char_data/M/DSC03208.JPG_2.jpg,957,480,640,29,200,229,166,199,True,23
M,73,kaist_dataset/English/Digital_Camera/(E.S)C-outdoor2/DSC03277.JPG,char_data/M/DSC03277.JPG_2.jpg,4964,480,640,68,421,489,181,254,True,23
M,59,kaist_dataset/English/Digital_Camera/(E.S)C-outdoor2/DSC03412.JPG,char_data/M/DSC03412.JPG_2.jpg,4838,480,640,82,69,151,388,447,True,23
M,57,kaist_dataset/English/Digital_Camera/(E.S)C-outdoor2/DSC03414.JPG,char_data/M/DSC03414.JPG_2.jpg,3363,480,640,59,200,259,352,409,True,23
M,79,kaist_dataset/English/Digital_Camera/(E.S)C-outdoor2/DSC03432.JPG,char_data/M/DSC03432.JPG_2.jpg,4819,480,640,61,294,355,359,438,True,23
M,42,kaist_dataset/English/Digital_Camera/(E.S)C-outdoor2/DSC03575.JPG,char_data/M/DSC03575.JPG_2.jpg,1554,480,640,37,194,231,181,223,True,23
M,48,kaist_dataset/English/Digital_Camera/(E.S)C-outdoor2/DSC03650.JPG,char_data/M/DSC03650.JPG_4.jpg,1824,480,640,38,213,251,210,258,True,23
M,49,kaist_dataset/English/Digital_Camera/(E.S)C-outdoor2/DSC03650.JPG,char_data/M/DSC03650.JPG_5.jpg,2156,480,640,44,453,497,215,264,True,23
M,136,kaist_dataset/English/Digital_Camera/(E.S)C-outdoor2/DSC03663.JPG,char_data/M/DSC03663.JPG_2.jpg,13192,480,640,97,38,135,149,285,True,23
M,67,kaist_dataset/English/Digital_Camera/(E.S)C-outdoor2/DSC03865.JPG,char_data/M/DSC03865.JPG_2.jpg,4355,480,640,65,385,450,91,158,True,23
M,73,kaist_dataset/English/Digital_Camera/(E.S)C-outdoor2/DSC04079.JPG,char_data/M/DSC04079.JPG_4.jpg,4015,480,640,55,511,566,269,342,True,23
M,61,kaist_dataset/English/Digital_Camera/(E.S)C-outdoor2/DSC04079.JPG,char_data/M/DSC04079.JPG_5.jpg,3050,480,640,50,296,346,42,103,True,23
M,71,kaist_dataset/English/Digital_Camera/(E.S)C-outdoor2/DSC04080.JPG,char_data/M/DSC04080.JPG_2.jpg,5325,480,640,75,14,89,293,364,True,23
M,67,kaist_dataset/English/Digital_Camera/(E.S)C-outdoor2/DSC04087.JPG,char_data/M/DSC04087.JPG_2.jpg,4020,480,640,60,285,345,128,195,True,23
M,65,kaist_dataset/English/Digital_Camera/(E.S)C-outdoor2/DSC04120.JPG,char_data/M/DSC04120.JPG_2.jpg,3250,480,640,50,36,86,143,208,True,23
M,107,kaist_dataset/English/Digital_Camera/(E.S)C-outdoor2/DSC04160.JPG,char_data/M/DSC04160.JPG_5.jpg,14338,480,640,134,22,156,241,348,True,23
M,63,kaist_dataset/English/Digital_Camera/(E.S)C-outdoor2/DSC04163.JPG,char_data/M/DSC04163.JPG_2.jpg,3969,480,640,63,136,199,254,317,True,23
M,64,kaist_dataset/English/Digital_Camera/(E.S)C-outdoor2/DSC04313.JPG,char_data/M/DSC04313.JPG_2.jpg,3648,480,640,57,209,266,116,180,True,23
M,58,kaist_dataset/English/Digital_Camera/(E.S)C-outdoor2/DSC04464.JPG,char_data/M/DSC04464.JPG_4.jpg,2436,480,640,42,171,213,326,384,True,23
M,56,kaist_dataset/English/Digital_Camera/(E.S)C-outdoor2/DSC04464.JPG,char_data/M/DSC04464.JPG_5.jpg,2744,480,640,49,345,394,329,385,True,23
M,57,kaist_dataset/English/Digital_Camera/(E.S)C-outdoor2/f.jpg,char_data/M/f.jpg_2.jpg,3477,240,320,61,37,98,65,122,True,23
M,63,kaist_dataset/English/Digital_Camera/(E.S)C-outdoor2/P1010057.JPG,char_data/M/P1010057.JPG_5.jpg,3024,480,640,48,307,355,184,247,True,23
M,46,kaist_dataset/English/Digital_Camera/(E.S)C-outdoor3/s.jpg,char_data/M/s.jpg_2.jpg,2392,240,320,52,132,184,82,128,True,23
M,70,kaist_dataset/English/Digital_Camera/(E.S)C-outdoor3/크기변환_P1010028.JPG,char_data/M/크기변환_P1010028.JPG_2.jpg,4690,480,640,67,285,352,163,233,True,23
M,53,kaist_dataset/English/Digital_Camera/(E.S)D-indoor/080119-0009.jpg,char_data/M/080119-0009.jpg_6.jpg,2650,1200,1600,50,672,722,657,710,True,23
M,67,kaist_dataset/English/Digital_Camera/(E.S)D-indoor/DSC02850.JPG,char_data/M/DSC02850.JPG_2.jpg,4824,480,640,72,474,546,244,311,True,23
M,108,kaist_dataset/English/Digital_Camera/(E.S)D-indoor/DSC02852.JPG,char_data/M/DSC02852.JPG_2.jpg,8208,480,640,76,248,324,317,425,True,23
M,78,kaist_dataset/English/Digital_Camera/(E.S)D-indoor/DSC03074.JPG,char_data/M/DSC03074.JPG_7.jpg,2964,480,640,38,272,310,244,322,True,23
M,52,kaist_dataset/English/Digital_Camera/(E.S)D-indoor/DSC03151.JPG,char_data/M/DSC03151.JPG_2.jpg,2704,480,640,52,288,340,101,153,True,23
M,60,kaist_dataset/English/Digital_Camera/(E.S)D-indoor/DSC03345.JPG,char_data/M/DSC03345.JPG_4.jpg,3780,480,640,63,72,135,92,152,True,23
M,92,kaist_dataset/English/Digital_Camera/(E.S)D-indoor/DSC03365.JPG,char_data/M/DSC03365.JPG_2.jpg,8372,480,640,91,115,206,367,459,True,23
M,36,kaist_dataset/English/Digital_Camera/(E.S)D-indoor/DSC03532.JPG,char_data/M/DSC03532.JPG_5.jpg,936,480,640,26,374,400,377,413,True,23
M,68,kaist_dataset/English/Digital_Camera/(E.S)D-indoor/DSC03883.JPG,char_data/M/DSC03883.JPG_4.jpg,3876,480,640,57,282,339,308,376,True,23
M,58,kaist_dataset/English/Digital_Camera/(E.S)D-indoor/DSC03883.JPG,char_data/M/DSC03883.JPG_5.jpg,2900,480,640,50,560,610,307,365,True,23
M,60,kaist_dataset/English/Digital_Camera/(E.S)D-indoor/DSC03887.JPG,char_data/M/DSC03887.JPG_2.jpg,3780,480,640,63,458,521,169,229,True,23
M,32,kaist_dataset/English/Digital_Camera/(E.S)D-indoor/DSC03935.JPG,char_data/M/DSC03935.JPG_2.jpg,800,480,640,25,281,306,46,78,True,23
M,39,kaist_dataset/English/Digital_Camera/(E.S)D-indoor/DSC03942.JPG,char_data/M/DSC03942.JPG_2.jpg,1287,480,640,33,542,575,372,411,True,23
M,67,kaist_dataset/English/Digital_Camera/(E.S)E-night/111.jpg,char_data/M/111.jpg_2.jpg,4422,480,640,66,165,231,184,251,True,23
M,101,kaist_dataset/English/Digital_Camera/(E.S)E-night/DSC02641.JPG,char_data/M/DSC02641.JPG_2.jpg,7070,480,640,70,256,326,268,369,True,23
M,140,kaist_dataset/English/Digital_Camera/(E.S)E-night/DSC03003.JPG,char_data/M/DSC03003.JPG_2.jpg,25620,480,640,183,109,292,147,287,True,23
M,37,kaist_dataset/English/Digital_Camera/(E.S)E-night/t.jpg,char_data/M/t.jpg_2.jpg,1295,240,320,35,154,189,65,102,True,23
M,64,kaist_dataset/English/Digital_Camera/(E.S)F-others/032.jpg,char_data/M/032.jpg_2.jpg,3584,245,422,56,250,306,80,144,True,23
M,130,kaist_dataset/English/Digital_Camera/(E.S)F-others/080116-0058.jpg,char_data/M/080116-0058.jpg_2.jpg,5980,1200,1600,46,782,828,580,710,True,23
M,474,kaist_dataset/English/Digital_Camera/(E.S)F-others/080119-0011.jpg,char_data/M/080119-0011.jpg_2.jpg,159264,1200,1600,336,256,592,194,668,True,23
M,47,kaist_dataset/English/Digital_Camera/(E.S)F-others/m.jpg,char_data/M/m.jpg_2.jpg,2773,240,320,59,79,138,95,142,True,23
M,64,kaist_dataset/English/Digital_Camera/(E.S)F-others/크기변환_%B0%A3%C6%C77_m_starfirm.jpg,char_data/M/크기변환_%B0%A3%C6%C77_m_starfirm.jpg_4.jpg,4096,480,640,64,362,426,120,184,True,23
M,67,kaist_dataset/English/Digital_Camera/(E.S)F-others/크기변환_%B0%A3%C6%C77_m_starfirm.jpg,char_data/M/크기변환_%B0%A3%C6%C77_m_starfirm.jpg_5.jpg,3886,480,640,58,227,285,140,207,True,23
M,78,kaist_dataset/English/Mobile_Phone/(E.M)B-indoor/P090903007.jpg,char_data/M/P090903007.jpg_4.jpg,6240,480,640,80,219,299,256,334,True,23
M,145,kaist_dataset/English/Mobile_Phone/(E.M)C-bookCover/P090831022.jpg,char_data/M/P090831022.jpg_2.jpg,20445,480,640,141,5,146,125,270,True,23
M,80,kaist_dataset/English/Mobile_Phone/(E.M)C-bookCover/P090903055.jpg,char_data/M/P090903055.jpg_2.jpg,6880,480,640,86,304,390,165,245,True,23
M,92,kaist_dataset/English/Mobile_Phone/(E.M)C-bookCover/P090903056.jpg,char_data/M/P090903056.jpg_2.jpg,8464,480,640,92,291,383,311,403,True,23
M,102,kaist_dataset/English/Mobile_Phone/(E.M)C-bookCover/P090903076.jpg,char_data/M/P090903076.jpg_2.jpg,10710,480,640,105,371,476,288,390,True,23
M,143,kaist_dataset/English/Mobile_Phone/(E.M)C-bookCover/P090903081.jpg,char_data/M/P090903081.jpg_2.jpg,15301,480,640,107,224,331,103,246,True,23
M,38,kaist_dataset/Korean/Digital_Camera/G-others/DSC03065.JPG,char_data/M/DSC03065.JPG_2.jpg,2318,480,640,61,257,318,98,136,True,23
M,24,kaist_dataset/Korean/Digital_Camera/indoor1/080119-0029.jpg,char_data/M/080119-0029.jpg_2.jpg,480,1200,1600,20,261,281,582,606,True,23
M,18,kaist_dataset/Korean/Digital_Camera/indoor1/146.JPG,char_data/M/146.JPG_2.jpg,234,480,640,13,323,336,269,287,True,23
M,55,kaist_dataset/Korean/Digital_Camera/outdoor2/2007-12-09-day-exterior-035.jpg,char_data/M/2007-12-09-day-exterior-035.jpg_4.jpg,2255,1200,1600,41,973,1014,719,774,True,23
M,50,kaist_dataset/Korean/Digital_Camera/outdoor2/2007-12-09-day-exterior-035.jpg,char_data/M/2007-12-09-day-exterior-035.jpg_5.jpg,1800,1200,1600,36,1169,1205,722,772,True,23
M,57,kaist_dataset/Mixed/Digital_Camera/(C.S)A-shadow/DSC03305.JPG,char_data/M/DSC03305.JPG_2.jpg,2736,480,640,48,523,571,348,405,True,23
M,25,kaist_dataset/Mixed/Digital_Camera/(C.S)C-outdoor1/021.JPG,char_data/M/021.JPG_4.jpg,600,480,640,24,440,464,139,164,True,23
M,26,kaist_dataset/Mixed/Digital_Camera/(C.S)C-outdoor1/021.JPG,char_data/M/021.JPG_5.jpg,494,480,640,19,492,511,207,233,True,23
M,184,kaist_dataset/Mixed/Digital_Camera/(C.S)C-outdoor1/080119-0017.jpg,char_data/M/080119-0017.jpg_2.jpg,26864,1200,1600,146,730,876,555,739,True,23
M,50,kaist_dataset/Mixed/Digital_Camera/(C.S)C-outdoor1/080119-0027.jpg,char_data/M/080119-0027.jpg_2.jpg,2050,1200,1600,41,1069,1110,1050,1100,True,23
M,120,kaist_dataset/Mixed/Digital_Camera/(C.S)C-outdoor1/080119-0037.jpg,char_data/M/080119-0037.jpg_2.jpg,12240,1200,1600,102,863,965,853,973,True,23
M,136,kaist_dataset/Mixed/Digital_Camera/(C.S)C-outdoor1/113.JPG,char_data/M/113.JPG_4.jpg,8568,480,640,63,135,198,77,213,True,23
M,132,kaist_dataset/Mixed/Digital_Camera/(C.S)C-outdoor1/113.JPG,char_data/M/113.JPG_5.jpg,8712,480,640,66,479,545,80,212,True,23
M,31,kaist_dataset/Mixed/Digital_Camera/(C.S)C-outdoor1/121.JPG,char_data/M/121.JPG_2.jpg,775,480,640,25,92,117,214,245,True,23
M,23,kaist_dataset/Mixed/Digital_Camera/(C.S)C-outdoor1/135.JPG,char_data/M/135.JPG_4.jpg,644,480,640,28,356,384,175,198,True,23
M,23,kaist_dataset/Mixed/Digital_Camera/(C.S)C-outdoor1/135.JPG,char_data/M/135.JPG_5.jpg,483,480,640,21,231,252,174,197,True,23
M,67,kaist_dataset/Mixed/Digital_Camera/(C.S)C-outdoor1/2007-12-08-day-091.jpg,char_data/M/2007-12-08-day-091.jpg_2.jpg,3819,1200,1600,57,474,531,598,665,True,23
M,46,kaist_dataset/Mixed/Digital_Camera/(C.S)C-outdoor1/2007-12-08-day-103.jpg,char_data/M/2007-12-08-day-103.jpg_2.jpg,1840,1200,1600,40,588,628,608,654,True,23
M,35,kaist_dataset/Mixed/Digital_Camera/(C.S)C-outdoor1/DSC02240.JPG,char_data/M/DSC02240.JPG_2.jpg,1015,480,640,29,425,454,286,321,True,23
M,58,kaist_dataset/Mixed/Digital_Camera/(C.S)C-outdoor1/P1010009.JPG,char_data/M/P1010009.JPG_2.jpg,4408,480,640,76,78,154,178,236,True,23
M,53,kaist_dataset/Mixed/Digital_Camera/(C.S)C-outdoor2/DSC02365.JPG,char_data/M/DSC02365.JPG_2.jpg,2067,480,640,39,171,210,94,147,True,23
M,71,kaist_dataset/Mixed/Digital_Camera/(C.S)C-outdoor2/DSC02436.JPG,char_data/M/DSC02436.JPG_2.jpg,4615,480,640,65,268,333,180,251,True,23
M,108,kaist_dataset/Mixed/Digital_Camera/(C.S)C-outdoor2/DSC02493.JPG,char_data/M/DSC02493.JPG_4.jpg,9828,480,640,91,3,94,257,365,True,23
M,50,kaist_dataset/Mixed/Digital_Camera/(C.S)C-outdoor2/DSC02502.JPG,char_data/M/DSC02502.JPG_2.jpg,2550,480,640,51,22,73,88,138,True,23
M,48,kaist_dataset/Mixed/Digital_Camera/(C.S)C-outdoor2/DSC02519.JPG,char_data/M/DSC02519.JPG_2.jpg,2448,480,640,51,125,176,229,277,True,23
M,36,kaist_dataset/Mixed/Digital_Camera/(C.S)C-outdoor2/DSC02557.JPG,char_data/M/DSC02557.JPG_2.jpg,1008,480,640,28,1,28,226,262,True,23
M,70,kaist_dataset/Mixed/Digital_Camera/(C.S)C-outdoor2/DSC02866.JPG,char_data/M/DSC02866.JPG_2.jpg,2940,480,640,42,552,594,105,175,True,23
M,31,kaist_dataset/Mixed/Digital_Camera/(C.S)C-outdoor2/DSC02910.JPG,char_data/M/DSC02910.JPG_2.jpg,837,480,640,27,481,508,56,87,True,23
M,32,kaist_dataset/Mixed/Digital_Camera/(C.S)C-outdoor2/DSC02917.JPG,char_data/M/DSC02917.JPG_2.jpg,896,480,640,28,198,226,228,260,True,23
M,29,kaist_dataset/Mixed/Digital_Camera/(C.S)C-outdoor3/DSC02989.JPG,char_data/M/DSC02989.JPG_2.jpg,928,480,640,32,126,158,176,205,True,23
M,24,kaist_dataset/Mixed/Digital_Camera/(C.S)C-outdoor3/DSC03033.JPG,char_data/M/DSC03033.JPG_2.jpg,528,480,640,22,69,91,129,153,True,23
M,74,kaist_dataset/Mixed/Digital_Camera/(C.S)C-outdoor3/DSC03055.JPG,char_data/M/DSC03055.JPG_4.jpg,5846,480,640,79,278,357,258,332,True,23
M,74,kaist_dataset/Mixed/Digital_Camera/(C.S)C-outdoor3/DSC03055.JPG,char_data/M/DSC03055.JPG_5.jpg,6142,480,640,83,357,440,261,335,True,23
M,53,kaist_dataset/Mixed/Digital_Camera/(C.S)C-outdoor3/DSC03164.JPG,char_data/M/DSC03164.JPG_2.jpg,3127,480,640,59,449,508,207,260,True,23
M,101,kaist_dataset/Mixed/Digital_Camera/(C.S)C-outdoor3/DSC03189.JPG,char_data/M/DSC03189.JPG_2.jpg,8282,480,640,82,335,417,185,286,True,23
M,66,kaist_dataset/Mixed/Digital_Camera/(C.S)C-outdoor3/DSC03306.JPG,char_data/M/DSC03306.JPG_2.jpg,3102,480,640,47,377,424,384,450,True,23
M,73,kaist_dataset/Mixed/Digital_Camera/(C.S)C-outdoor3/DSC03415.JPG,char_data/M/DSC03415.JPG_2.jpg,3504,480,640,48,316,364,158,231,True,23
M,39,kaist_dataset/Mixed/Digital_Camera/(C.S)C-outdoor4/DSC03439.JPG,char_data/M/DSC03439.JPG_2.jpg,936,480,640,24,386,410,424,463,True,23
M,35,kaist_dataset/Mixed/Digital_Camera/(C.S)C-outdoor4/DSC03556.JPG,char_data/M/DSC03556.JPG_2.jpg,735,480,640,21,137,158,318,353,True,23
M,94,kaist_dataset/Mixed/Digital_Camera/(C.S)C-outdoor4/DSC03571.JPG,char_data/M/DSC03571.JPG_2.jpg,6392,480,640,68,348,416,185,279,True,23
M,45,kaist_dataset/Mixed/Digital_Camera/(C.S)C-outdoor4/DSC03586.JPG,char_data/M/DSC03586.JPG_2.jpg,1395,480,640,31,119,150,150,195,True,23
M,105,kaist_dataset/Mixed/Digital_Camera/(C.S)C-outdoor4/DSC03651.JPG,char_data/M/DSC03651.JPG_2.jpg,11655,480,640,111,77,188,147,252,True,23
M,38,kaist_dataset/Mixed/Digital_Camera/(C.S)C-outdoor4/DSC03661.JPG,char_data/M/DSC03661.JPG_2.jpg,1368,480,640,36,67,103,267,305,True,23
M,43,kaist_dataset/Mixed/Digital_Camera/(C.S)C-outdoor4/DSC03677.JPG,char_data/M/DSC03677.JPG_2.jpg,1075,480,640,25,92,117,290,333,True,23
M,76,kaist_dataset/Mixed/Digital_Camera/(C.S)C-outdoor4/DSC03687.JPG,char_data/M/DSC03687.JPG_2.jpg,5928,480,640,78,99,177,319,395,True,23
M,61,kaist_dataset/Mixed/Digital_Camera/(C.S)C-outdoor5/DSC04014.JPG,char_data/M/DSC04014.JPG_2.jpg,3782,480,640,62,401,463,97,158,True,23
M,110,kaist_dataset/Mixed/Digital_Camera/(C.S)C-outdoor5/DSC04055.JPG,char_data/M/DSC04055.JPG_2.jpg,11440,480,640,104,280,384,244,354,False,23
M,59,kaist_dataset/Mixed/Digital_Camera/(C.S)C-outdoor5/DSC04060.JPG,char_data/M/DSC04060.JPG_6.jpg,2891,480,640,49,65,114,97,156,False,23
M,53,kaist_dataset/Mixed/Digital_Camera/(C.S)C-outdoor5/DSC04060.JPG,char_data/M/DSC04060.JPG_7.jpg,2173,480,640,41,114,155,100,153,False,23
M,55,kaist_dataset/Mixed/Digital_Camera/(C.S)C-outdoor5/DSC04060.JPG,char_data/M/DSC04060.JPG_8.jpg,2255,480,640,41,495,536,93,148,False,23
M,81,kaist_dataset/Mixed/Digital_Camera/(C.S)C-outdoor5/DSC04097.JPG,char_data/M/DSC04097.JPG_2.jpg,6237,480,640,77,31,108,160,241,False,23
M,34,kaist_dataset/Mixed/Digital_Camera/(C.S)C-outdoor5/DSC04314.JPG,char_data/M/DSC04314.JPG_2.jpg,1122,480,640,33,337,370,171,205,False,23
M,28,kaist_dataset/Mixed/Digital_Camera/(C.S)C-outdoor5/DSC04357.JPG,char_data/M/DSC04357.JPG_2.jpg,672,480,640,24,276,300,351,379,False,23
M,75,kaist_dataset/Mixed/Digital_Camera/(C.S)C-outdoor5/DSC04368.JPG,char_data/M/DSC04368.JPG_2.jpg,4650,480,640,62,371,433,272,347,False,23
M,67,kaist_dataset/Mixed/Digital_Camera/(C.S)C-outdoor5/DSC04401.JPG,char_data/M/DSC04401.JPG_2.jpg,4087,480,640,61,31,92,7,74,False,23
M,78,kaist_dataset/Mixed/Digital_Camera/(C.S)C-outdoor6/P1010045.JPG,char_data/M/P1010045.JPG_2.jpg,6630,480,640,85,416,501,62,140,False,23
M,61,kaist_dataset/Mixed/Digital_Camera/(C.S)C-outdoor6/P1010052.JPG,char_data/M/P1010052.JPG_2.jpg,4453,480,640,73,359,432,120,181,False,23
M,23,kaist_dataset/Mixed/Digital_Camera/(C.S)C-outdoor6/P1010063.JPG,char_data/M/P1010063.JPG_8.jpg,368,480,640,16,247,263,426,449,False,23
M,23,kaist_dataset/Mixed/Digital_Camera/(C.S)C-outdoor6/P1010063.JPG,char_data/M/P1010063.JPG_9.jpg,437,480,640,19,261,280,422,445,False,23
M,23,kaist_dataset/Mixed/Digital_Camera/(C.S)C-outdoor6/P1010063.JPG,char_data/M/P1010063.JPG_10.jpg,322,480,640,14,341,355,388,411,False,23
M,22,kaist_dataset/Mixed/Digital_Camera/(C.S)C-outdoor6/P1010063.JPG,char_data/M/P1010063.JPG_11.jpg,396,480,640,18,373,391,376,398,False,23
M,45,kaist_dataset/Mixed/Digital_Camera/(C.S)D-indoor1/DSC02713.JPG,char_data/M/DSC02713.JPG_2.jpg,2160,480,640,48,294,342,155,200,False,23
M,52,kaist_dataset/Mixed/Digital_Camera/(C.S)D-indoor1/DSC03118.JPG,char_data/M/DSC03118.JPG_2.jpg,2288,480,640,44,277,321,218,270,False,23
M,38,kaist_dataset/Mixed/Digital_Camera/(C.S)D-indoor1/DSC03122.JPG,char_data/M/DSC03122.JPG_2.jpg,1254,480,640,33,224,257,199,237,False,23
M,67,kaist_dataset/Mixed/Digital_Camera/(C.S)D-indoor1/DSC03479.JPG,char_data/M/DSC03479.JPG_2.jpg,4020,480,640,60,89,149,285,352,False,23
M,39,kaist_dataset/Mixed/Digital_Camera/(C.S)D-indoor1/DSC03483.JPG,char_data/M/DSC03483.JPG_2.jpg,1443,480,640,37,279,316,376,415,False,23
M,43,kaist_dataset/Mixed/Digital_Camera/(C.S)D-indoor1/DSC03980.JPG,char_data/M/DSC03980.JPG_2.jpg,1204,480,640,28,314,342,137,180,False,23
M,157,kaist_dataset/Mixed/Digital_Camera/(C.S)D-indoor1/DSC04173.JPG,char_data/M/DSC04173.JPG_2.jpg,13973,480,640,89,11,100,315,472,False,23
M,47,kaist_dataset/Mixed/Digital_Camera/(C.S)D-indoor1/DSC04203.JPG,char_data/M/DSC04203.JPG_2.jpg,1316,480,640,28,113,141,285,332,False,23
M,27,kaist_dataset/Mixed/Digital_Camera/(C.S)E-night/DSC02660.JPG,char_data/M/DSC02660.JPG_2.jpg,783,480,640,29,196,225,389,416,False,23
M,64,kaist_dataset/Mixed/Digital_Camera/(C.S)E-night/DSC02672.JPG,char_data/M/DSC02672.JPG_2.jpg,3392,480,640,53,111,164,91,155,False,23
M,75,kaist_dataset/Mixed/Digital_Camera/(C.S)E-night/DSC03031.JPG,char_data/M/DSC03031.JPG_8.jpg,4875,480,640,65,407,472,69,144,False,23
M,117,kaist_dataset/Mixed/Digital_Camera/(C.S)E-night/P1010164.JPG,char_data/M/P1010164.JPG_6.jpg,13572,480,640,116,276,392,64,181,False,23
M,123,kaist_dataset/Mixed/Digital_Camera/(C.S)E-night/P1010164.JPG,char_data/M/P1010164.JPG_7.jpg,13161,480,640,107,393,500,62,185,False,23
M,139,kaist_dataset/Mixed/Digital_Camera/(C.S)E-night/P1010164.JPG,char_data/M/P1010164.JPG_8.jpg,13761,480,640,99,501,600,74,213,False,23
M,26,kaist_dataset/Mixed/Mobile_Phone/(C.M)A-outdoor/P090908006.jpg,char_data/M/P090908006.jpg_2.jpg,624,480,640,24,70,94,377,403,False,23
M,53,kaist_dataset/Mixed/Mobile_Phone/(C.M)C-bookCover/P090831080.jpg,char_data/M/P090831080.jpg_2.jpg,2438,480,640,46,234,280,334,387,False,23
M,53,kaist_dataset/Mixed/Mobile_Phone/(C.M)C-bookCover/P090831118.jpg,char_data/M/P090831118.jpg_4.jpg,2756,480,640,52,80,132,207,260,False,23
M,55,kaist_dataset/Mixed/Mobile_Phone/(C.M)C-bookCover/P090831118.jpg,char_data/M/P090831118.jpg_5.jpg,2750,480,640,50,344,394,206,261,False,23
구,23,kaist_dataset/English/Digital_Camera/(E.S)C-outdoor1/064.JPG,char_data/구/064.JPG_2.jpg,414,480,640,18,30,48,269,292,True,51
구,73,kaist_dataset/English/Digital_Camera/(E.S)C-outdoor1/2007-12-09-day-exterior-063.jpg,char_data/구/2007-12-09-day-exterior-063.jpg_2.jpg,3285,1200,1600,45,1065,1110,198,271,True,51
구,34,kaist_dataset/Korean/Digital_Camera/A-shadow/DSC03536.JPG,char_data/구/DSC03536.JPG_2.jpg,748,480,640,22,96,118,238,272,True,51
구,71,kaist_dataset/Korean/Digital_Camera/A-shadow/DSC04311.JPG,char_data/구/DSC04311.JPG_2.jpg,3124,480,640,44,550,594,143,214,True,51
구,47,kaist_dataset/Korean/Digital_Camera/A-shadow/P1010064.JPG,char_data/구/P1010064.JPG_4.jpg,1927,480,640,41,367,408,216,263,True,51
구,53,kaist_dataset/Korean/Digital_Camera/A-shadow/P1010064.JPG,char_data/구/P1010064.JPG_5.jpg,2385,480,640,45,12,57,407,460,True,51
구,99,kaist_dataset/Korean/Digital_Camera/E-night/DSC02596.JPG,char_data/구/DSC02596.JPG_2.jpg,8811,480,640,89,190,279,160,259,True,51
구,56,kaist_dataset/Korean/Digital_Camera/E-night/DSC02597.JPG,char_data/구/DSC02597.JPG_2.jpg,2968,480,640,53,187,240,18,74,True,51
구,33,kaist_dataset/Korean/Digital_Camera/E-night/DSC02626.JPG,char_data/구/DSC02626.JPG_2.jpg,1155,480,640,35,447,482,139,172,True,51
구,55,kaist_dataset/Korean/Digital_Camera/E-night/DSC03022.JPG,char_data/구/DSC03022.JPG_2.jpg,4950,480,640,90,323,413,182,237,True,51
구,53,kaist_dataset/Korean/Digital_Camera/F-bookCover/DSC04235.JPG,char_data/구/DSC04235.JPG_2.jpg,1908,480,640,36,564,600,181,234,True,51
구,231,kaist_dataset/Korean/Digital_Camera/G-others/2007-12-08-day-012.jpg,char_data/구/2007-12-08-day-012.jpg_2.jpg,47355,1600,1200,205,492,697,1129,1360,True,51
구,88,kaist_dataset/Korean/Digital_Camera/indoor1/080119-0029.jpg,char_data/구/080119-0029.jpg_2.jpg,7920,1200,1600,90,945,1035,570,658,True,51
구,35,kaist_dataset/Korean/Digital_Camera/indoor1/080119-0030.jpg,char_data/구/080119-0030.jpg_2.jpg,980,1200,1600,28,883,911,855,890,True,51
구,60,kaist_dataset/Korean/Digital_Camera/indoor1/DSC02706.JPG,char_data/구/DSC02706.JPG_2.jpg,3900,480,640,65,543,608,218,278,True,51
구,74,kaist_dataset/Korean/Digital_Camera/indoor1/DSC03368.JPG,char_data/구/DSC03368.JPG_2.jpg,5032,480,640,68,361,429,259,333,True,51
구,104,kaist_dataset/Korean/Digital_Camera/indoor2/DSC03564.JPG,char_data/구/DSC03564.JPG_2.jpg,11544,480,640,111,331,442,54,158,True,51
구,61,kaist_dataset/Korean/Digital_Camera/indoor2/DSC04196.JPG,char_data/구/DSC04196.JPG_2.jpg,3538,480,640,58,429,487,77,138,True,51
구,126,kaist_dataset/Korean/Digital_Camera/indoor2/DSC04207.JPG,char_data/구/DSC04207.JPG_2.jpg,13230,480,640,105,324,429,98,224,True,51
구,77,kaist_dataset/Korean/Digital_Camera/outdoor1/011.JPG,char_data/구/011.JPG_2.jpg,7007,480,640,91,433,524,178,255,True,51
구,59,kaist_dataset/Korean/Digital_Camera/outdoor1/015.JPG,char_data/구/015.JPG_2.jpg,4897,480,640,83,384,467,198,257,True,51
구,86,kaist_dataset/Korean/Digital_Camera/outdoor1/028.JPG,char_data/구/028.JPG_4.jpg,9288,480,640,108,211,319,177,263,True,51
구,94,kaist_dataset/Korean/Digital_Camera/outdoor1/028.JPG,char_data/구/028.JPG_5.jpg,10246,480,640,109,473,582,171,265,True,51
구,53,kaist_dataset/Korean/Digital_Camera/outdoor1/061.JPG,char_data/구/061.JPG_2.jpg,2173,480,640,41,413,454,202,255,True,51
구,16,kaist_dataset/Korean/Digital_Camera/outdoor1/096.JPG,char_data/구/096.JPG_2.jpg,304,480,640,19,68,87,280,296,True,51
구,20,kaist_dataset/Korean/Digital_Camera/outdoor1/100.jpg,char_data/구/100.jpg_2.jpg,380,480,640,19,229,248,213,233,True,51
구,97,kaist_dataset/Korean/Digital_Camera/outdoor1/106.JPG,char_data/구/106.JPG_2.jpg,11446,480,640,118,471,589,166,263,True,51
구,218,kaist_dataset/Korean/Digital_Camera/outdoor1/2007-12-08-day-047.jpg,char_data/구/2007-12-08-day-047.jpg_16.jpg,38368,1200,1600,176,1007,1183,492,710,True,51
구,57,kaist_dataset/Korean/Digital_Camera/outdoor1/2007-12-08-day-047.jpg,char_data/구/2007-12-08-day-047.jpg_17.jpg,2223,1200,1600,39,219,258,1054,1111,True,51
구,25,kaist_dataset/Korean/Digital_Camera/outdoor1/2007-12-08-day-047.jpg,char_data/구/2007-12-08-day-047.jpg_18.jpg,750,1200,1600,30,502,532,944,969,True,51
구,68,kaist_dataset/Korean/Digital_Camera/outdoor1/2007-12-08-day-047.jpg,char_data/구/2007-12-08-day-047.jpg_19.jpg,2380,1200,1600,35,385,420,1031,1099,True,51
구,62,kaist_dataset/Korean/Digital_Camera/outdoor1/2007-12-08-day-047.jpg,char_data/구/2007-12-08-day-047.jpg_20.jpg,2170,1200,1600,35,518,553,1032,1094,True,51
구,54,kaist_dataset/Korean/Digital_Camera/outdoor1/2007-12-08-day-047.jpg,char_data/구/2007-12-08-day-047.jpg_21.jpg,1674,1200,1600,31,1050,1081,1013,1067,True,51
구,46,kaist_dataset/Korean/Digital_Camera/outdoor1/2007-12-08-day-047.jpg,char_data/구/2007-12-08-day-047.jpg_22.jpg,1058,1200,1600,23,1402,1425,1016,1062,True,51
구,60,kaist_dataset/Korean/Digital_Camera/outdoor1/2007-12-08-day-047.jpg,char_data/구/2007-12-08-day-047.jpg_23.jpg,1680,1200,1600,28,947,975,1015,1075,True,51
구,34,kaist_dataset/Korean/Digital_Camera/outdoor1/2007-12-08-day-087.jpg,char_data/구/2007-12-08-day-087.jpg_2.jpg,1190,1200,1600,35,3,38,476,510,True,51
구,188,kaist_dataset/Korean/Digital_Camera/outdoor1/46.JPG,char_data/구/46.JPG_2.jpg,21996,576,768,117,443,560,154,342,True,51
구,113,kaist_dataset/Korean/Digital_Camera/outdoor1/50.JPG,char_data/구/50.JPG_2.jpg,11978,576,768,106,375,481,219,332,True,51
구,127,kaist_dataset/Korean/Digital_Camera/outdoor2/080116-0072.jpg,char_data/구/080116-0072.jpg_2.jpg,14478,600,800,114,450,564,132,259,True,51
구,73,kaist_dataset/Korean/Digital_Camera/outdoor2/2007-12-09-day-exterior-012.jpg,char_data/구/2007-12-09-day-exterior-012.jpg_6.jpg,4672,1200,1600,64,545,609,629,702,True,51
구,211,kaist_dataset/Korean/Digital_Camera/outdoor2/2007-12-09-day-exterior-012.jpg,char_data/구/2007-12-09-day-exterior-012.jpg_7.jpg,50429,1200,1600,239,1163,1402,376,587,True,51
구,51,kaist_dataset/Korean/Digital_Camera/outdoor2/2007-12-09-day-exterior-012.jpg,char_data/구/2007-12-09-day-exterior-012.jpg_8.jpg,2499,1200,1600,49,882,931,1067,1118,True,51
구,223,kaist_dataset/Korean/Digital_Camera/outdoor2/2007-12-09-day-exterior-033.jpg,char_data/구/2007-12-09-day-exterior-033.jpg_2.jpg,59095,1200,1600,265,955,1220,482,705,True,51
구,138,kaist_dataset/Korean/Digital_Camera/outdoor2/2007-12-09-day-exterior-055.jpg,char_data/구/2007-12-09-day-exterior-055.jpg_2.jpg,14076,1200,1600,102,873,975,472,610,True,51
구,36,kaist_dataset/Korean/Digital_Camera/outdoor2/DSC02313.JPG,char_data/구/DSC02313.JPG_4.jpg,1620,480,640,45,217,262,13,49,True,51
구,32,kaist_dataset/Korean/Digital_Camera/outdoor2/DSC02313.JPG,char_data/구/DSC02313.JPG_5.jpg,1376,480,640,43,435,478,11,43,True,51
구,36,kaist_dataset/Korean/Digital_Camera/outdoor2/DSC02326.JPG,char_data/구/DSC02326.JPG_2.jpg,936,480,640,26,411,437,166,202,True,51
구,94,kaist_dataset/Korean/Digital_Camera/outdoor2/DSC02380.JPG,char_data/구/DSC02380.JPG_2.jpg,9776,480,640,104,136,240,147,241,True,51
구,30,kaist_dataset/Korean/Digital_Camera/outdoor2/DSC02386.JPG,char_data/구/DSC02386.JPG_2.jpg,480,480,640,16,156,172,122,152,True,51
구,134,kaist_dataset/Korean/Digital_Camera/outdoor2/DSC02414.JPG,char_data/구/DSC02414.JPG_2.jpg,20904,480,640,156,32,188,91,225,True,51
구,98,kaist_dataset/Korean/Digital_Camera/outdoor2/DSC02470.JPG,char_data/구/DSC02470.JPG_2.jpg,6958,480,640,71,365,436,255,353,True,51
구,129,kaist_dataset/Korean/Digital_Camera/outdoor2/DSC02474.JPG,char_data/구/DSC02474.JPG_2.jpg,11739,480,640,91,215,306,157,286,True,51
구,125,kaist_dataset/Korean/Digital_Camera/outdoor2/DSC02478.JPG,char_data/구/DSC02478.JPG_2.jpg,10375,480,640,83,440,523,136,261,True,51
구,108,kaist_dataset/Korean/Digital_Camera/outdoor2/DSC02481.JPG,char_data/구/DSC02481.JPG_2.jpg,5724,480,640,53,581,634,143,251,True,51
구,67,kaist_dataset/Korean/Digital_Camera/outdoor2/DSC02498.JPG,char_data/구/DSC02498.JPG_2.jpg,4087,480,640,61,133,194,353,420,True,51
구,87,kaist_dataset/Korean/Digital_Camera/outdoor2/DSC02507.JPG,char_data/구/DSC02507.JPG_2.jpg,9135,480,640,105,330,435,103,190,True,51
구,211,kaist_dataset/Korean/Digital_Camera/outdoor2/DSC02512.JPG,char_data/구/DSC02512.JPG_2.jpg,35870,480,640,170,459,629,52,263,True,51
구,151,kaist_dataset/Korean/Digital_Camera/outdoor2/DSC02521.JPG,char_data/구/DSC02521.JPG_2.jpg,14798,480,640,98,402,500,172,323,True,51
구,107,kaist_dataset/Korean/Digital_Camera/outdoor3/DSC02528.JPG,char_data/구/DSC02528.JPG_2.jpg,10807,480,640,101,197,298,249,356,True,51
구,68,kaist_dataset/Korean/Digital_Camera/outdoor3/DSC02697.JPG,char_data/구/DSC02697.JPG_2.jpg,3740,480,640,55,337,392,152,220,True,51
구,128,kaist_dataset/Korean/Digital_Camera/outdoor3/DSC02911.JPG,char_data/구/DSC02911.JPG_2.jpg,9344,480,640,73,101,174,130,258,True,51
구,98,kaist_dataset/Korean/Digital_Camera/outdoor3/DSC02968.JPG,char_data/구/DSC02968.JPG_2.jpg,5586,480,640,57,406,463,86,184,True,51
구,50,kaist_dataset/Korean/Digital_Camera/outdoor3/DSC03213.JPG,char_data/구/DSC03213.JPG_2.jpg,2900,480,640,58,366,424,52,102,True,51
구,76,kaist_dataset/Korean/Digital_Camera/outdoor3/DSC03220.JPG,char_data/구/DSC03220.JPG_2.jpg,6688,480,640,88,141,229,160,236,True,51
구,150,kaist_dataset/Korean/Digital_Camera/outdoor3/DSC03240.JPG,char_data/구/DSC03240.JPG_2.jpg,19800,480,640,132,327,459,102,252,True,51
구,55,kaist_dataset/Korean/Digital_Camera/outdoor4/DSC03419.JPG,char_data/구/DSC03419.JPG_2.jpg,2750,480,640,50,392,442,211,266,True,51
구,75,kaist_dataset/Korean/Digital_Camera/outdoor4/DSC03448.JPG,char_data/구/DSC03448.JPG_2.jpg,7200,480,640,96,468,564,347,422,True,51
구,75,kaist_dataset/Korean/Digital_Camera/outdoor4/DSC03449.JPG,char_data/구/DSC03449.JPG_2.jpg,3000,480,640,40,442,482,297,372,True,51
구,55,kaist_dataset/Korean/Digital_Camera/outdoor4/DSC03540.JPG,char_data/구/DSC03540.JPG_2.jpg,2805,480,640,51,572,623,316,371,True,51
구,56,kaist_dataset/Korean/Digital_Camera/outdoor4/DSC03541.JPG,char_data/구/DSC03541.JPG_2.jpg,2688,480,640,48,575,623,376,432,True,51
구,45,kaist_dataset/Korean/Digital_Camera/outdoor4/DSC03576.JPG,char_data/구/DSC03576.JPG_2.jpg,1755,480,640,39,341,380,200,245,True,51
구,69,kaist_dataset/Korean/Digital_Camera/outdoor4/DSC03577.JPG,char_data/구/DSC03577.JPG_2.jpg,3726,480,640,54,334,388,90,159,True,51
구,50,kaist_dataset/Korean/Digital_Camera/outdoor4/DSC03578.JPG,char_data/구/DSC03578.JPG_2.jpg,2050,480,640,41,413,454,227,277,True,51
구,30,kaist_dataset/Korean/Digital_Camera/outdoor5/DSC03688.JPG,char_data/구/DSC03688.JPG_2.jpg,630,480,640,21,408,429,229,259,True,51
구,127,kaist_dataset/Korean/Digital_Camera/outdoor5/DSC03713.JPG,char_data/구/DSC03713.JPG_2.jpg,10922,480,640,86,403,489,192,319,True,51
구,119,kaist_dataset/Korean/Digital_Camera/outdoor5/DSC03770.JPG,char_data/구/DSC03770.JPG_2.jpg,8092,480,640,68,311,379,295,414,True,51
구,70,kaist_dataset/Korean/Digital_Camera/outdoor5/DSC03848.JPG,char_data/구/DSC03848.JPG_2.jpg,2590,480,640,37,272,309,192,262,True,51
구,98,kaist_dataset/Korean/Digital_Camera/outdoor5/DSC03858.JPG,char_data/구/DSC03858.JPG_2.jpg,10486,480,640,107,419,526,287,385,True,51
구,86,kaist_dataset/Korean/Digital_Camera/outdoor5/DSC04034.JPG,char_data/구/DSC04034.JPG_2.jpg,4988,480,640,58,370,428,297,383,True,51
구,40,kaist_dataset/Korean/Digital_Camera/outdoor5/DSC04040.JPG,char_data/구/DSC04040.JPG_4.jpg,1760,480,640,44,101,145,126,166,True,51
구,35,kaist_dataset/Korean/Digital_Camera/outdoor5/DSC04040.JPG,char_data/구/DSC04040.JPG_5.jpg,1365,480,640,39,265,304,188,223,True,51
구,65,kaist_dataset/Korean/Digital_Camera/outdoor6/DSC04074.JPG,char_data/구/DSC04074.JPG_2.jpg,3120,480,640,48,354,402,26,91,True,51
구,93,kaist_dataset/Korean/Digital_Camera/outdoor6/DSC04082.JPG,char_data/구/DSC04082.JPG_2.jpg,6417,480,640,69,42,111,222,315,True,51
구,76,kaist_dataset/Korean/Digital_Camera/outdoor6/DSC04083.JPG,char_data/구/DSC04083.JPG_2.jpg,5472,480,640,72,98,170,154,230,True,51
구,76,kaist_dataset/Korean/Digital_Camera/outdoor6/DSC04093.JPG,char_data/구/DSC04093.JPG_2.jpg,6384,480,640,84,429,513,346,422,True,51
구,85,kaist_dataset/Korean/Digital_Camera/outdoor6/DSC04117.JPG,char_data/구/DSC04117.JPG_2.jpg,6290,480,640,74,126,200,189,274,True,51
구,97,kaist_dataset/Korean/Digital_Camera/outdoor6/DSC04156.JPG,char_data/구/DSC04156.JPG_2.jpg,5238,480,640,54,510,564,164,261,True,51
구,61,kaist_dataset/Korean/Digital_Camera/outdoor6/DSC04319.JPG,char_data/구/DSC04319.JPG_2.jpg,3416,480,640,56,386,442,108,169,True,51
구,133,kaist_dataset/Korean/Digital_Camera/outdoor6/DSC04356.JPG,char_data/구/DSC04356.JPG_2.jpg,9709,480,640,73,385,458,287,420,True,51
구,72,kaist_dataset/Korean/Digital_Camera/outdoor6/DSC04362.JPG,char_data/구/DSC04362.JPG_2.jpg,5400,480,640,75,312,387,261,333,True,51
구,107,kaist_dataset/Korean/Digital_Camera/outdoor6/DSC04440.JPG,char_data/구/DSC04440.JPG_2.jpg,8132,480,640,76,318,394,305,412,True,51
구,50,kaist_dataset/Korean/Digital_Camera/outdoor7/DSC04455.JPG,char_data/구/DSC04455.JPG_2.jpg,2000,480,640,40,469,509,423,473,True,51
구,85,kaist_dataset/Korean/Digital_Camera/outdoor7/P1010017.JPG,char_data/구/P1010017.JPG_6.jpg,4335,480,640,51,171,222,229,314,True,51
구,82,kaist_dataset/Korean/Digital_Camera/outdoor7/P1010017.JPG,char_data/구/P1010017.JPG_7.jpg,2460,480,640,30,418,448,345,427,True,51
구,114,kaist_dataset/Korean/Digital_Camera/outdoor7/P1010056.JPG,char_data/구/P1010056.JPG_4.jpg,4902,480,640,43,448,491,130,244,True,51
구,84,kaist_dataset/Korean/Digital_Camera/outdoor7/P1010057.JPG,char_data/구/P1010057.JPG_2.jpg,8988,480,640,107,407,514,140,224,True,51
구,109,kaist_dataset/Korean/Digital_Camera/outdoor7/P1010106.JPG,char_data/구/P1010106.JPG_2.jpg,8502,480,640,78,450,528,91,200,True,51
구,78,kaist_dataset/Korean/Digital_Camera/outdoor7/P1010112.JPG,char_data/구/P1010112.JPG_2.jpg,4056,480,640,52,460,512,273,351,True,51
구,102,kaist_dataset/Korean/Digital_Camera/outdoor7/P1010115.JPG,char_data/구/P1010115.JPG_2.jpg,7140,480,640,70,170,240,299,401,True,51
구,75,"kaist_dataset/Korean/Mobile_Phone/(M,K)A-shadow/P090912052.jpg",char_data/구/P090912052.jpg_2.jpg,5700,480,640,76,307,383,73,148,True,51
구,70,"kaist_dataset/Korean/Mobile_Phone/(M,K)C-outdoor/P090912042.jpg",char_data/구/P090912042.jpg_2.jpg,3220,480,640,46,223,269,193,263,True,51
구,97,"kaist_dataset/Korean/Mobile_Phone/(M,K)E-bookCover/P090831151.jpg",char_data/구/P090831151.jpg_2.jpg,9409,480,640,97,430,527,14,111,True,51
구,67,"kaist_dataset/Korean/Mobile_Phone/(M,K)E-bookCover/P090903094.jpg",char_data/구/P090903094.jpg_2.jpg,3953,480,640,59,304,363,326,393,True,51
구,99,"kaist_dataset/Korean/Mobile_Phone/(M,K)E-bookCover/P090903095.jpg",char_data/구/P090903095.jpg_2.jpg,7722,480,640,78,306,384,134,233,True,51
구,77,kaist_dataset/Mixed/Digital_Camera/(C.S)A-shadow/DSC02902.JPG,char_data/구/DSC02902.JPG_2.jpg,3619,480,640,47,375,422,284,361,True,51
구,69,kaist_dataset/Mixed/Digital_Camera/(C.S)A-shadow/DSC03522.JPG,char_data/구/DSC03522.JPG_2.jpg,3588,480,640,52,216,268,14,83,True,51
구,55,kaist_dataset/Mixed/Digital_Camera/(C.S)C-outdoor1/003.JPG,char_data/구/003.JPG_2.jpg,2090,480,640,38,485,523,184,239,True,51
구,393,kaist_dataset/Mixed/Digital_Camera/(C.S)C-outdoor1/080118-0014.jpg,char_data/구/080118-0014.jpg_2.jpg,157593,1200,1600,401,309,710,331,724,True,51
구,37,kaist_dataset/Mixed/Digital_Camera/(C.S)C-outdoor1/080119-0027.jpg,char_data/구/080119-0027.jpg_2.jpg,888,1200,1600,24,1051,1075,1001,1038,True,51
구,73,kaist_dataset/Mixed/Digital_Camera/(C.S)C-outdoor1/086.JPG,char_data/구/086.JPG_2.jpg,5548,480,640,76,401,477,182,255,True,51
구,36,kaist_dataset/Mixed/Digital_Camera/(C.S)C-outdoor1/090.JPG,char_data/구/090.JPG_4.jpg,1260,480,640,35,97,132,348,384,True,51
구,31,kaist_dataset/Mixed/Digital_Camera/(C.S)C-outdoor1/090.JPG,char_data/구/090.JPG_5.jpg,961,480,640,31,277,308,355,386,True,51
구,51,kaist_dataset/Mixed/Digital_Camera/(C.S)C-outdoor1/2007-12-09-day-exterior-078.jpg,char_data/구/2007-12-09-day-exterior-078.jpg_4.jpg,2091,1200,1600,41,1060,1101,460,511,True,51
구,54,kaist_dataset/Mixed/Digital_Camera/(C.S)C-outdoor1/2007-12-09-day-exterior-078.jpg,char_data/구/2007-12-09-day-exterior-078.jpg_5.jpg,2646,1200,1600,49,1229,1278,448,502,True,51
구,140,kaist_dataset/Mixed/Digital_Camera/(C.S)C-outdoor1/DSC02312.JPG,char_data/구/DSC02312.JPG_2.jpg,20160,480,640,144,330,474,59,199,True,51
구,40,kaist_dataset/Mixed/Digital_Camera/(C.S)C-outdoor2/DSC02434.JPG,char_data/구/DSC02434.JPG_2.jpg,1880,480,640,47,554,601,131,171,True,51
구,91,kaist_dataset/Mixed/Digital_Camera/(C.S)C-outdoor2/DSC02513.JPG,char_data/구/DSC02513.JPG_2.jpg,4823,480,640,53,534,587,232,323,True,51
구,64,kaist_dataset/Mixed/Digital_Camera/(C.S)C-outdoor2/DSC02532.JPG,char_data/구/DSC02532.JPG_2.jpg,3328,480,640,52,345,397,136,200,True,51
구,57,kaist_dataset/Mixed/Digital_Camera/(C.S)C-outdoor3/DSC03199.JPG,char_data/구/DSC03199.JPG_2.jpg,1995,480,640,35,311,346,380,437,True,51
구,61,kaist_dataset/Mixed/Digital_Camera/(C.S)C-outdoor3/DSC03259.JPG,char_data/구/DSC03259.JPG_2.jpg,3050,480,640,50,280,330,400,461,True,51
구,119,kaist_dataset/Mixed/Digital_Camera/(C.S)C-outdoor3/DSC03284.JPG,char_data/구/DSC03284.JPG_2.jpg,8449,480,640,71,220,291,166,285,True,51
구,70,kaist_dataset/Mixed/Digital_Camera/(C.S)C-outdoor3/DSC03303.JPG,char_data/구/DSC03303.JPG_2.jpg,3150,480,640,45,35,80,107,177,True,51
구,58,kaist_dataset/Mixed/Digital_Camera/(C.S)C-outdoor3/DSC03331.JPG,char_data/구/DSC03331.JPG_2.jpg,2726,480,640,47,179,226,179,237,True,51
구,65,kaist_dataset/Mixed/Digital_Camera/(C.S)C-outdoor3/DSC03429.JPG,char_data/구/DSC03429.JPG_2.jpg,3900,480,640,60,316,376,133,198,True,51
구,39,kaist_dataset/Mixed/Digital_Camera/(C.S)C-outdoor4/DSC03435.JPG,char_data/구/DSC03435.JPG_2.jpg,702,480,640,18,474,492,413,452,True,51
구,69,kaist_dataset/Mixed/Digital_Camera/(C.S)C-outdoor4/DSC03439.JPG,char_data/구/DSC03439.JPG_2.jpg,3795,480,640,55,402,457,323,392,True,51
구,50,kaist_dataset/Mixed/Digital_Camera/(C.S)C-outdoor4/DSC03556.JPG,char_data/구/DSC03556.JPG_2.jpg,1750,480,640,35,263,298,252,302,True,51
구,54,kaist_dataset/Mixed/Digital_Camera/(C.S)C-outdoor4/DSC03613.JPG,char_data/구/DSC03613.JPG_2.jpg,2160,480,640,40,222,262,24,78,True,51
구,57,kaist_dataset/Mixed/Digital_Camera/(C.S)C-outdoor4/DSC03667.JPG,char_data/구/DSC03667.JPG_2.jpg,2679,480,640,47,387,434,283,340,True,51
구,34,kaist_dataset/Mixed/Digital_Camera/(C.S)C-outdoor4/DSC03672.JPG,char_data/구/DSC03672.JPG_2.jpg,1258,480,640,37,211,248,125,159,True,51
구,58,kaist_dataset/Mixed/Digital_Camera/(C.S)C-outdoor4/DSC03707.JPG,char_data/구/DSC03707.JPG_2.jpg,2494,480,640,43,382,425,334,392,True,51
구,62,kaist_dataset/Mixed/Digital_Camera/(C.S)C-outdoor4/DSC03756.JPG,char_data/구/DSC03756.JPG_2.jpg,2790,480,640,45,135,180,125,187,True,51
구,109,kaist_dataset/Mixed/Digital_Camera/(C.S)C-outdoor4/DSC03769.JPG,char_data/구/DSC03769.JPG_4.jpg,8284,480,640,76,261,337,299,408,False,51
구,54,kaist_dataset/Mixed/Digital_Camera/(C.S)C-outdoor4/DSC03769.JPG,char_data/구/DSC03769.JPG_5.jpg,3132,480,640,58,441,499,329,383,False,51
구,43,kaist_dataset/Mixed/Digital_Camera/(C.S)C-outdoor5/DSC03839.JPG,char_data/구/DSC03839.JPG_2.jpg,1505,480,640,35,370,405,147,190,False,51
구,52,kaist_dataset/Mixed/Digital_Camera/(C.S)C-outdoor5/DSC04014.JPG,char_data/구/DSC04014.JPG_2.jpg,4004,480,640,77,399,476,179,231,False,51
구,92,kaist_dataset/Mixed/Digital_Camera/(C.S)C-outdoor5/DSC04016.JPG,char_data/구/DSC04016.JPG_2.jpg,4784,480,640,52,479,531,8,100,False,51
구,76,kaist_dataset/Mixed/Digital_Camera/(C.S)C-outdoor5/DSC04072.JPG,char_data/구/DSC04072.JPG_2.jpg,3572,480,640,47,387,434,224,300,False,51
구,32,kaist_dataset/Mixed/Digital_Camera/(C.S)C-outdoor5/DSC04122.JPG,char_data/구/DSC04122.JPG_2.jpg,608,480,640,19,487,506,415,447,False,51
구,89,kaist_dataset/Mixed/Digital_Camera/(C.S)C-outdoor5/DSC04139.JPG,char_data/구/DSC04139.JPG_4.jpg,2937,480,640,33,383,416,199,288,False,51
구,68,kaist_dataset/Mixed/Digital_Camera/(C.S)C-outdoor5/DSC04139.JPG,char_data/구/DSC04139.JPG_5.jpg,1020,480,640,15,407,422,320,388,False,51
구,79,kaist_dataset/Mixed/Digital_Camera/(C.S)C-outdoor5/DSC04153.JPG,char_data/구/DSC04153.JPG_2.jpg,6004,480,640,76,362,438,192,271,False,51
구,59,kaist_dataset/Mixed/Digital_Camera/(C.S)C-outdoor5/DSC04349.JPG,char_data/구/DSC04349.JPG_2.jpg,2655,480,640,45,253,298,300,359,False,51
구,56,kaist_dataset/Mixed/Digital_Camera/(C.S)C-outdoor5/DSC04395.JPG,char_data/구/DSC04395.JPG_2.jpg,1904,480,640,34,430,464,279,335,False,51
구,77,kaist_dataset/Mixed/Digital_Camera/(C.S)C-outdoor5/P1010007.JPG,char_data/구/P1010007.JPG_2.jpg,4312,480,640,56,271,327,361,438,False,51
구,95,kaist_dataset/Mixed/Digital_Camera/(C.S)C-outdoor6/P1010017.JPG,char_data/구/P1010017.JPG_8.jpg,4465,480,640,47,173,220,59,154,False,51
구,54,kaist_dataset/Mixed/Digital_Camera/(C.S)C-outdoor6/P1010020.JPG,char_data/구/P1010020.JPG_2.jpg,3294,480,640,61,223,284,276,330,False,51
구,98,kaist_dataset/Mixed/Digital_Camera/(C.S)C-outdoor6/P1010056.JPG,char_data/구/P1010056.JPG_5.jpg,8134,480,640,83,406,489,125,223,False,51
구,60,kaist_dataset/Mixed/Digital_Camera/(C.S)C-outdoor6/P1010062.JPG,char_data/구/P1010062.JPG_2.jpg,5640,480,640,94,213,307,206,266,False,51
구,116,kaist_dataset/Mixed/Digital_Camera/(C.S)C-outdoor6/P1010074.JPG,char_data/구/P1010074.JPG_2.jpg,10556,480,640,91,322,413,173,289,False,51
구,64,kaist_dataset/Mixed/Digital_Camera/(C.S)C-outdoor6/P1010094.JPG,char_data/구/P1010094.JPG_2.jpg,6400,480,640,100,437,537,144,208,False,51
구,37,kaist_dataset/Mixed/Digital_Camera/(C.S)C-outdoor6/P1010097.JPG,char_data/구/P1010097.JPG_6.jpg,814,480,640,22,59,81,51,88,False,51
구,34,kaist_dataset/Mixed/Digital_Camera/(C.S)C-outdoor6/P1010097.JPG,char_data/구/P1010097.JPG_7.jpg,782,480,640,23,112,135,48,82,False,51
구,76,kaist_dataset/Mixed/Digital_Camera/(C.S)C-outdoor6/P1010097.JPG,char_data/구/P1010097.JPG_8.jpg,4028,480,640,53,249,302,88,164,False,51
구,38,kaist_dataset/Mixed/Digital_Camera/(C.S)C-outdoor6/P1010098.JPG,char_data/구/P1010098.JPG_4.jpg,836,480,640,22,53,75,433,471,False,51
구,32,kaist_dataset/Mixed/Digital_Camera/(C.S)C-outdoor6/P1010098.JPG,char_data/구/P1010098.JPG_5.jpg,672,480,640,21,109,130,437,469,False,51
구,84,kaist_dataset/Mixed/Digital_Camera/(C.S)C-outdoor6/P1010099.JPG,char_data/구/P1010099.JPG_2.jpg,5880,480,640,70,442,512,112,196,False,51
구,43,kaist_dataset/Mixed/Digital_Camera/(C.S)C-outdoor6/P1010111.JPG,char_data/구/P1010111.JPG_4.jpg,1075,480,640,25,232,257,331,374,False,51
구,93,kaist_dataset/Mixed/Digital_Camera/(C.S)C-outdoor6/P1010111.JPG,char_data/구/P1010111.JPG_5.jpg,9021,480,640,97,211,308,82,175,False,51
구,46,kaist_dataset/Mixed/Digital_Camera/(C.S)D-indoor1/DSC03478.JPG,char_data/구/DSC03478.JPG_4.jpg,2162,480,640,47,419,466,96,142,False,51
구,43,kaist_dataset/Mixed/Digital_Camera/(C.S)D-indoor1/DSC03478.JPG,char_data/구/DSC03478.JPG_5.jpg,2021,480,640,47,553,600,96,139,False,51
구,29,kaist_dataset/Mixed/Digital_Camera/(C.S)D-indoor1/DSC03959.JPG,char_data/구/DSC03959.JPG_2.jpg,319,480,640,11,476,487,398,427,False,51
구,112,kaist_dataset/Mixed/Digital_Camera/(C.S)E-night/DSC02644.JPG,char_data/구/DSC02644.JPG_2.jpg,7504,480,640,67,491,558,284,396,False,51
구,77,kaist_dataset/Mixed/Digital_Camera/(C.S)E-night/DSC03516.JPG,char_data/구/DSC03516.JPG_2.jpg,4928,480,640,64,275,339,200,277,False,51
구,83,kaist_dataset/Mixed/Digital_Camera/(C.S)E-night/DSC03517.JPG,char_data/구/DSC03517.JPG_2.jpg,5146,480,640,62,345,407,170,253,False,51
수,32,kaist_dataset/English/Digital_Camera/(E.S)B-light/080116-0059.jpg,char_data/수/080116-0059.jpg_2.jpg,672,1200,1600,21,983,1004,1023,1055,True,68
수,80,kaist_dataset/Korean/Digital_Camera/A-shadow/P1010036.JPG,char_data/수/P1010036.JPG_2.jpg,5280,480,640,66,287,353,1,80,True,68
수,91,kaist_dataset/Korean/Digital_Camera/E-night/DSC02615.JPG,char_data/수/DSC02615.JPG_2.jpg,8190,480,640,90,107,197,258,349,True,68
수,125,kaist_dataset/Korean/Digital_Camera/E-night/DSC03872.JPG,char_data/수/DSC03872.JPG_2.jpg,9625,480,640,77,175,252,181,306,True,68
수,204,kaist_dataset/Korean/Digital_Camera/F-bookCover/DSC02813.JPG,char_data/수/DSC02813.JPG_2.jpg,32028,480,640,157,7,164,161,365,True,68
수,166,kaist_dataset/Korean/Digital_Camera/F-bookCover/DSC02822.JPG,char_data/수/DSC02822.JPG_2.jpg,24568,480,640,148,259,407,72,238,True,68
수,141,kaist_dataset/Korean/Digital_Camera/F-bookCover/DSC02823.JPG,char_data/수/DSC02823.JPG_2.jpg,17907,480,640,127,249,376,166,307,True,68
수,180,kaist_dataset/Korean/Digital_Camera/F-bookCover/DSC02824.JPG,char_data/수/DSC02824.JPG_2.jpg,25560,480,640,142,279,421,151,331,True,68
수,128,kaist_dataset/Korean/Digital_Camera/F-bookCover/DSC02826.JPG,char_data/수/DSC02826.JPG_2.jpg,12032,480,640,94,355,449,203,331,True,68
수,121,kaist_dataset/Korean/Digital_Camera/F-bookCover/DSC04228.JPG,char_data/수/DSC04228.JPG_4.jpg,6897,480,640,57,362,419,80,201,True,68
수,125,kaist_dataset/Korean/Digital_Camera/F-bookCover/DSC04228.JPG,char_data/수/DSC04228.JPG_5.jpg,7125,480,640,57,418,475,81,206,True,68
수,120,kaist_dataset/Korean/Digital_Camera/G-others/2007-12-09-day-exterior-005.jpg,char_data/수/2007-12-09-day-exterior-005.jpg_2.jpg,24240,1600,1200,202,29,231,540,660,True,68
수,52,kaist_dataset/Korean/Digital_Camera/G-others/2007-12-09-day-exterior-062.jpg,char_data/수/2007-12-09-day-exterior-062.jpg_2.jpg,2184,1600,1200,42,631,673,219,271,True,68
수,87,kaist_dataset/Korean/Digital_Camera/G-others/2007-12-09-day-exterior-083.jpg,char_data/수/2007-12-09-day-exterior-083.jpg_2.jpg,10440,1600,1200,120,576,696,851,938,True,68
수,58,kaist_dataset/Korean/Digital_Camera/indoor1/080119-0018.jpg,char_data/수/080119-0018.jpg_2.jpg,3596,1200,1600,62,1176,1238,613,671,True,68
수,28,kaist_dataset/Korean/Digital_Camera/indoor1/145.JPG,char_data/수/145.JPG_4.jpg,588,480,640,21,24,45,242,270,True,68
수,27,kaist_dataset/Korean/Digital_Camera/indoor1/145.JPG,char_data/수/145.JPG_5.jpg,648,480,640,24,581,605,242,269,True,68
수,102,kaist_dataset/Korean/Digital_Camera/indoor1/2007-12-08-day-139.jpg,char_data/수/2007-12-08-day-139.jpg_2.jpg,10506,1200,1600,103,625,728,410,512,True,68
수,33,kaist_dataset/Korean/Digital_Camera/indoor1/DSC02700.JPG,char_data/수/DSC02700.JPG_2.jpg,891,480,640,27,314,341,425,458,True,68
수,154,kaist_dataset/Korean/Digital_Camera/indoor1/DSC02741.JPG,char_data/수/DSC02741.JPG_2.jpg,12628,480,640,82,7,89,266,420,True,68
수,41,kaist_dataset/Korean/Digital_Camera/indoor1/DSC03113.JPG,char_data/수/DSC03113.JPG_2.jpg,1476,480,640,36,287,323,162,203,True,68
수,92,kaist_dataset/Korean/Digital_Camera/indoor1/DSC03355.JPG,char_data/수/DSC03355.JPG_2.jpg,9200,480,640,100,135,235,52,144,True,68
수,97,kaist_dataset/Korean/Digital_Camera/indoor1/DSC03363.JPG,char_data/수/DSC03363.JPG_2.jpg,8439,480,640,87,398,485,155,252,True,68
수,62,kaist_dataset/Korean/Digital_Camera/indoor1/DSC03380.JPG,char_data/수/DSC03380.JPG_2.jpg,3038,480,640,49,211,260,202,264,True,68
수,124,kaist_dataset/Korean/Digital_Camera/indoor2/DSC03389.JPG,char_data/수/DSC03389.JPG_2.jpg,10044,480,640,81,154,235,229,353,True,68
수,53,kaist_dataset/Korean/Digital_Camera/indoor2/DSC03484.JPG,char_data/수/DSC03484.JPG_2.jpg,1802,480,640,34,188,222,113,166,True,68
수,173,kaist_dataset/Korean/Digital_Camera/indoor2/DSC03697.JPG,char_data/수/DSC03697.JPG_2.jpg,11072,480,640,64,253,317,194,367,True,68
수,80,kaist_dataset/Korean/Digital_Camera/indoor2/DSC03698.JPG,char_data/수/DSC03698.JPG_2.jpg,6080,480,640,76,359,435,136,216,True,68
수,79,kaist_dataset/Korean/Digital_Camera/indoor2/DSC03703.JPG,char_data/수/DSC03703.JPG_2.jpg,6241,480,640,79,344,423,124,203,True,68
수,58,kaist_dataset/Korean/Digital_Camera/indoor2/DSC03818.JPG,char_data/수/DSC03818.JPG_2.jpg,2494,480,640,43,575,618,390,448,True,68
수,165,kaist_dataset/Korean/Digital_Camera/indoor2/DSC04001.JPG,char_data/수/DSC04001.JPG_2.jpg,14685,480,640,89,373,462,165,330,True,68
수,102,kaist_dataset/Korean/Digital_Camera/indoor2/DSC04004.JPG,char_data/수/DSC04004.JPG_2.jpg,6732,480,640,66,405,471,303,405,True,68
수,108,kaist_dataset/Korean/Digital_Camera/outdoor1/023.JPG,char_data/수/023.JPG_2.jpg,14364,480,640,133,301,434,149,257,True,68
수,37,kaist_dataset/Korean/Digital_Camera/outdoor1/029.JPG,char_data/수/029.JPG_2.jpg,1036,480,640,28,216,244,147,184,True,68
수,26,kaist_dataset/Korean/Digital_Camera/outdoor1/033.JPG,char_data/수/033.JPG_2.jpg,858,480,640,33,72,105,239,265,True,68
수,97,kaist_dataset/Korean/Digital_Camera/outdoor1/035.JPG,char_data/수/035.JPG_2.jpg,6208,480,640,64,551,615,184,281,True,68
수,127,kaist_dataset/Korean/Digital_Camera/outdoor1/052.JPG,char_data/수/052.JPG_2.jpg,18288,480,640,144,80,224,185,312,True,68
수,64,kaist_dataset/Korean/Digital_Camera/outdoor1/070.JPG,char_data/수/070.JPG_2.jpg,4288,480,640,67,526,593,183,247,True,68
수,135,kaist_dataset/Korean/Digital_Camera/outdoor1/095.JPG,char_data/수/095.JPG_2.jpg,23760,480,640,176,40,216,173,308,True,68
수,25,kaist_dataset/Korean/Digital_Camera/outdoor1/100.jpg,char_data/수/100.jpg_2.jpg,625,480,640,25,342,367,207,232,True,68
수,84,kaist_dataset/Korean/Digital_Camera/outdoor1/125.JPG,char_data/수/125.JPG_2.jpg,6636,480,640,79,137,216,167,251,True,68
수,22,kaist_dataset/Korean/Digital_Camera/outdoor1/2007-12-08-day-047.jpg,char_data/수/2007-12-08-day-047.jpg_10.jpg,550,1200,1600,25,665,690,966,988,True,68
수,65,kaist_dataset/Korean/Digital_Camera/outdoor1/2007-12-08-day-047.jpg,char_data/수/2007-12-08-day-047.jpg_11.jpg,2730,1200,1600,42,606,648,1028,1093,True,68
수,63,kaist_dataset/Korean/Digital_Camera/outdoor1/2007-12-08-day-047.jpg,char_data/수/2007-12-08-day-047.jpg_12.jpg,1953,1200,1600,31,783,814,1020,1083,True,68
수,61,kaist_dataset/Korean/Digital_Camera/outdoor1/2007-12-08-day-047.jpg,char_data/수/2007-12-08-day-047.jpg_13.jpg,2196,1200,1600,36,1125,1161,1013,1074,True,68
수,64,kaist_dataset/Korean/Digital_Camera/outdoor1/2007-12-08-day-047.jpg,char_data/수/2007-12-08-day-047.jpg_14.jpg,1600,1200,1600,25,1266,1291,1001,1065,True,68
수,119,kaist_dataset/Korean/Digital_Camera/outdoor1/54.JPG,char_data/수/54.JPG_2.jpg,13209,523,767,111,28,139,246,365,True,68
수,153,kaist_dataset/Korean/Digital_Camera/outdoor2/2007-12-09-day-exterior-084.jpg,char_data/수/2007-12-09-day-exterior-084.jpg_2.jpg,22338,1200,1600,146,1038,1184,595,748,True,68
수,31,kaist_dataset/Korean/Digital_Camera/outdoor2/DSC02373.JPG,char_data/수/DSC02373.JPG_2.jpg,806,480,640,26,39,65,327,358,True,68
수,32,kaist_dataset/Korean/Digital_Camera/outdoor2/DSC02386.JPG,char_data/수/DSC02386.JPG_2.jpg,672,480,640,21,250,271,114,146,True,68
수,133,kaist_dataset/Korean/Digital_Camera/outdoor2/DSC02426.JPG,char_data/수/DSC02426.JPG_2.jpg,19684,480,640,148,165,313,76,209,True,68
수,165,kaist_dataset/Korean/Digital_Camera/outdoor2/DSC02432.JPG,char_data/수/DSC02432.JPG_2.jpg,27885,480,640,169,452,621,66,231,True,68
수,44,kaist_dataset/Korean/Digital_Camera/outdoor3/DSC02698.JPG,char_data/수/DSC02698.JPG_2.jpg,1364,480,640,31,391,422,401,445,True,68
수,70,kaist_dataset/Korean/Digital_Camera/outdoor3/DSC03172.JPG,char_data/수/DSC03172.JPG_2.jpg,3570,480,640,51,188,239,155,225,True,68
수,55,kaist_dataset/Korean/Digital_Camera/outdoor3/DSC03220.JPG,char_data/수/DSC03220.JPG_2.jpg,2750,480,640,50,255,305,72,127,True,68
수,99,kaist_dataset/Korean/Digital_Camera/outdoor3/DSC03243.JPG,char_data/수/DSC03243.JPG_2.jpg,7425,480,640,75,222,297,312,411,True,68
수,75,kaist_dataset/Korean/Digital_Camera/outdoor4/DSC03263.JPG,char_data/수/DSC03263.JPG_2.jpg,5475,480,640,73,47,120,57,132,True,68
수,119,kaist_dataset/Korean/Digital_Camera/outdoor4/DSC03268.JPG,char_data/수/DSC03268.JPG_4.jpg,19159,480,640,161,280,441,277,396,True,68
수,39,kaist_dataset/Korean/Digital_Camera/outdoor4/DSC03268.JPG,char_data/수/DSC03268.JPG_5.jpg,1443,480,640,37,362,399,201,240,True,68
수,39,kaist_dataset/Korean/Digital_Camera/outdoor4/DSC03272.JPG,char_data/수/DSC03272.JPG_4.jpg,1248,480,640,32,71,103,247,286,True,68
수,87,kaist_dataset/Korean/Digital_Camera/outdoor4/DSC03272.JPG,char_data/수/DSC03272.JPG_5.jpg,7482,480,640,86,256,342,298,385,True,68
수,103,kaist_dataset/Korean/Digital_Camera/outdoor4/DSC03450.JPG,char_data/수/DSC03450.JPG_2.jpg,6180,480,640,60,352,412,225,328,True,68
수,41,kaist_dataset/Korean/Digital_Camera/outdoor4/DSC03576.JPG,char_data/수/DSC03576.JPG_2.jpg,1394,480,640,34,340,374,317,358,True,68
수,57,kaist_dataset/Korean/Digital_Camera/outdoor4/DSC03577.JPG,char_data/수/DSC03577.JPG_2.jpg,2565,480,640,45,345,390,276,333,True,68
수,56,kaist_dataset/Korean/Digital_Camera/outdoor4/DSC03588.JPG,char_data/수/DSC03588.JPG_2.jpg,2128,480,640,38,486,524,160,216,True,68
수,59,kaist_dataset/Korean/Digital_Camera/outdoor4/DSC03595.JPG,char_data/수/DSC03595.JPG_2.jpg,2714,480,640,46,267,313,179,238,True,68
수,79,kaist_dataset/Korean/Digital_Camera/outdoor5/DSC03645.JPG,char_data/수/DSC03645.JPG_2.jpg,2133,480,640,27,125,152,211,290,True,68
수,80,kaist_dataset/Korean/Digital_Camera/outdoor5/DSC03671.JPG,char_data/수/DSC03671.JPG_6.jpg,4640,480,640,58,345,403,316,396,True,68
수,40,kaist_dataset/Korean/Digital_Camera/outdoor5/DSC03671.JPG,char_data/수/DSC03671.JPG_7.jpg,1240,480,640,31,377,408,263,303,True,68
수,36,kaist_dataset/Korean/Digital_Camera/outdoor5/DSC03671.JPG,char_data/수/DSC03671.JPG_8.jpg,1188,480,640,33,505,538,266,302,True,68
수,145,kaist_dataset/Korean/Digital_Camera/outdoor5/DSC03709.JPG,char_data/수/DSC03709.JPG_4.jpg,15950,480,640,110,333,443,210,355,True,68
수,66,kaist_dataset/Korean/Digital_Camera/outdoor5/DSC03709.JPG,char_data/수/DSC03709.JPG_5.jpg,2376,480,640,36,530,566,123,189,True,68
수,101,kaist_dataset/Korean/Digital_Camera/outdoor5/DSC03774.JPG,char_data/수/DSC03774.JPG_2.jpg,6666,480,640,66,476,542,38,139,True,68
수,66,kaist_dataset/Korean/Digital_Camera/outdoor5/DSC03791.JPG,char_data/수/DSC03791.JPG_2.jpg,4554,480,640,69,346,415,146,212,True,68
수,33,kaist_dataset/Korean/Digital_Camera/outdoor6/DSC04077.JPG,char_data/수/DSC04077.JPG_2.jpg,726,480,640,22,288,310,189,222,True,68
수,38,kaist_dataset/Korean/Digital_Camera/outdoor6/DSC04099.JPG,char_data/수/DSC04099.JPG_2.jpg,1140,480,640,30,282,312,172,210,True,68
수,45,kaist_dataset/Korean/Digital_Camera/outdoor6/DSC04116.JPG,char_data/수/DSC04116.JPG_2.jpg,1395,480,640,31,283,314,170,215,True,68
수,41,kaist_dataset/Korean/Digital_Camera/outdoor6/DSC04148.JPG,char_data/수/DSC04148.JPG_2.jpg,1312,480,640,32,175,207,252,293,True,68
수,93,kaist_dataset/Korean/Digital_Camera/outdoor6/DSC04303.JPG,char_data/수/DSC04303.JPG_2.jpg,8835,480,640,95,180,275,91,184,True,68
수,59,kaist_dataset/Korean/Digital_Camera/outdoor6/DSC04398.JPG,char_data/수/DSC04398.JPG_2.jpg,2183,480,640,37,196,233,377,436,True,68
수,121,kaist_dataset/Korean/Digital_Camera/outdoor7/P1010003.JPG,char_data/수/P1010003.JPG_2.jpg,14278,480,640,118,292,410,146,267,True,68
수,78,kaist_dataset/Korean/Digital_Camera/outdoor7/P1010005.JPG,char_data/수/P1010005.JPG_2.jpg,7410,480,640,95,353,448,97,175,True,68
수,37,kaist_dataset/Korean/Digital_Camera/outdoor7/P1010016.JPG,char_data/수/P1010016.JPG_2.jpg,1443,480,640,39,580,619,74,111,True,68
수,56,kaist_dataset/Korean/Digital_Camera/outdoor7/P1010023.JPG,char_data/수/P1010023.JPG_2.jpg,2016,480,640,36,164,200,227,283,True,68
수,88,kaist_dataset/Korean/Digital_Camera/outdoor7/P1010029.JPG,char_data/수/P1010029.JPG_2.jpg,7480,480,640,85,431,516,333,421,True,68
수,118,kaist_dataset/Korean/Digital_Camera/outdoor7/P1010054.JPG,char_data/수/P1010054.JPG_4.jpg,16284,480,640,138,235,373,103,221,True,68
수,34,kaist_dataset/Korean/Digital_Camera/outdoor7/P1010054.JPG,char_data/수/P1010054.JPG_5.jpg,816,480,640,24,321,345,227,261,True,68
수,69,kaist_dataset/Korean/Digital_Camera/outdoor7/P1010065.JPG,char_data/수/P1010065.JPG_2.jpg,5796,480,640,84,83,167,390,459,True,68
수,56,kaist_dataset/Korean/Digital_Camera/outdoor7/P1010067.JPG,char_data/수/P1010067.JPG_2.jpg,6328,480,640,113,352,465,57,113,True,68
수,155,kaist_dataset/Korean/Digital_Camera/outdoor7/P1010077.JPG,char_data/수/P1010077.JPG_2.jpg,15190,480,640,98,233,331,79,234,True,68
수,97,kaist_dataset/Korean/Digital_Camera/outdoor7/P1010121.JPG,char_data/수/P1010121.JPG_2.jpg,9700,480,640,100,521,621,110,207,True,68
수,85,kaist_dataset/Korean/Digital_Camera/outdoor7/P1010131.JPG,char_data/수/P1010131.JPG_2.jpg,5355,480,640,63,560,623,122,207,True,68
수,42,kaist_dataset/Korean/Digital_Camera/outdoor8/P090912069.jpg,char_data/수/P090912069.jpg_2.jpg,1974,480,640,47,283,330,173,215,True,68
수,134,kaist_dataset/Korean/Digital_Camera/outdoor8/P1010172.JPG,char_data/수/P1010172.JPG_2.jpg,19028,480,640,142,424,566,71,205,True,68
수,81,kaist_dataset/Korean/Digital_Camera/outdoor8/크기변환_P1010033.JPG,char_data/수/크기변환_P1010033.JPG_2.jpg,7209,480,640,89,124,213,59,140,True,68
수,34,"kaist_dataset/Korean/Mobile_Phone/(M,K)E-bookCover/P090831108.jpg",char_data/수/P090831108.jpg_2.jpg,952,480,640,28,511,539,265,299,True,68
수,96,"kaist_dataset/Korean/Mobile_Phone/(M,K)E-bookCover/P090831151.jpg",char_data/수/P090831151.jpg_2.jpg,9024,480,640,94,232,326,23,119,True,68
수,153,"kaist_dataset/Korean/Mobile_Phone/(M,K)E-bookCover/P090831153.jpg",char_data/수/P090831153.jpg_2.jpg,18666,480,640,122,473,595,223,376,True,68
수,221,"kaist_dataset/Korean/Mobile_Phone/(M,K)E-bookCover/P090911006.jpg",char_data/수/P090911006.jpg_2.jpg,46852,480,640,212,130,342,139,360,True,68
수,88,kaist_dataset/Mixed/Digital_Camera/(C.S)A-shadow/DSC04304.JPG,char_data/수/DSC04304.JPG_2.jpg,5632,480,640,64,162,226,147,235,True,68
수,52,kaist_dataset/Mixed/Digital_Camera/(C.S)C-outdoor1/080118-0007.jpg,char_data/수/080118-0007.jpg_2.jpg,1820,1200,1600,35,1470,1505,629,681,True,68
수,132,kaist_dataset/Mixed/Digital_Camera/(C.S)C-outdoor1/080118-0014.jpg,char_data/수/080118-0014.jpg_2.jpg,13860,1200,1600,105,1143,1248,89,221,True,68
수,32,kaist_dataset/Mixed/Digital_Camera/(C.S)C-outdoor1/090.JPG,char_data/수/090.JPG_2.jpg,416,480,640,13,553,566,319,351,True,68
수,37,kaist_dataset/Mixed/Digital_Camera/(C.S)C-outdoor1/2.JPG,char_data/수/2.JPG_2.jpg,444,576,768,12,523,535,57,94,True,68
수,89,kaist_dataset/Mixed/Digital_Camera/(C.S)C-outdoor1/2007-12-09-day-exterior-078.jpg,char_data/수/2007-12-09-day-exterior-078.jpg_16.jpg,5785,1200,1600,65,629,694,490,579,True,68
수,53,kaist_dataset/Mixed/Digital_Camera/(C.S)C-outdoor1/2007-12-09-day-exterior-078.jpg,char_data/수/2007-12-09-day-exterior-078.jpg_17.jpg,1961,1200,1600,37,941,978,498,551,True,68
수,53,kaist_dataset/Mixed/Digital_Camera/(C.S)C-outdoor1/2007-12-09-day-exterior-078.jpg,char_data/수/2007-12-09-day-exterior-078.jpg_18.jpg,1961,1200,1600,37,980,1017,431,484,True,68
수,49,kaist_dataset/Mixed/Digital_Camera/(C.S)C-outdoor1/2007-12-09-day-exterior-078.jpg,char_data/수/2007-12-09-day-exterior-078.jpg_19.jpg,1813,1200,1600,37,1022,1059,512,561,True,68
수,49,kaist_dataset/Mixed/Digital_Camera/(C.S)C-outdoor1/2007-12-09-day-exterior-078.jpg,char_data/수/2007-12-09-day-exterior-078.jpg_20.jpg,1862,1200,1600,38,1060,1098,412,461,True,68
수,60,kaist_dataset/Mixed/Digital_Camera/(C.S)C-outdoor1/2007-12-09-day-exterior-078.jpg,char_data/수/2007-12-09-day-exterior-078.jpg_21.jpg,2220,1200,1600,37,1146,1183,419,479,True,68
수,57,kaist_dataset/Mixed/Digital_Camera/(C.S)C-outdoor1/2007-12-09-day-exterior-078.jpg,char_data/수/2007-12-09-day-exterior-078.jpg_22.jpg,1938,1200,1600,34,1195,1229,487,544,True,68
수,54,kaist_dataset/Mixed/Digital_Camera/(C.S)C-outdoor1/2007-12-09-day-exterior-078.jpg,char_data/수/2007-12-09-day-exterior-078.jpg_23.jpg,2430,1200,1600,45,1226,1271,396,450,True,68
수,141,kaist_dataset/Mixed/Digital_Camera/(C.S)C-outdoor1/45.JPG,char_data/수/45.JPG_2.jpg,20868,576,768,148,389,537,217,358,True,68
수,25,kaist_dataset/Mixed/Digital_Camera/(C.S)C-outdoor1/55.JPG,char_data/수/55.JPG_4.jpg,675,576,768,27,325,352,238,263,True,68
수,97,kaist_dataset/Mixed/Digital_Camera/(C.S)C-outdoor1/55.JPG,char_data/수/55.JPG_5.jpg,10088,576,768,104,360,464,266,363,True,68
수,37,kaist_dataset/Mixed/Digital_Camera/(C.S)C-outdoor1/56.JPG,char_data/수/56.JPG_2.jpg,888,576,768,24,685,709,295,332,True,68
수,77,kaist_dataset/Mixed/Digital_Camera/(C.S)C-outdoor1/P1010011.JPG,char_data/수/P1010011.JPG_4.jpg,6083,480,640,79,130,209,217,294,True,68
수,50,kaist_dataset/Mixed/Digital_Camera/(C.S)C-outdoor1/P1010011.JPG,char_data/수/P1010011.JPG_5.jpg,2150,480,640,43,112,155,84,134,True,68
수,97,kaist_dataset/Mixed/Digital_Camera/(C.S)C-outdoor1/P1010012.JPG,char_data/수/P1010012.JPG_2.jpg,8730,480,640,90,144,234,119,216,True,68
수,101,kaist_dataset/Mixed/Digital_Camera/(C.S)C-outdoor2/DSC02389.JPG,char_data/수/DSC02389.JPG_2.jpg,9999,480,640,99,398,497,110,211,True,68
수,114,kaist_dataset/Mixed/Digital_Camera/(C.S)C-outdoor2/DSC02447.JPG,char_data/수/DSC02447.JPG_4.jpg,8436,480,640,74,358,432,51,165,True,68
수,39,kaist_dataset/Mixed/Digital_Camera/(C.S)C-outdoor2/DSC02447.JPG,char_data/수/DSC02447.JPG_5.jpg,975,480,640,25,174,199,177,216,True,68
수,107,kaist_dataset/Mixed/Digital_Camera/(C.S)C-outdoor2/DSC02489.JPG,char_data/수/DSC02489.JPG_2.jpg,11128,480,640,104,521,625,136,243,True,68
수,151,kaist_dataset/Mixed/Digital_Camera/(C.S)C-outdoor2/DSC02502.JPG,char_data/수/DSC02502.JPG_2.jpg,16912,480,640,112,235,347,137,288,True,68
수,91,kaist_dataset/Mixed/Digital_Camera/(C.S)C-outdoor2/DSC02511.JPG,char_data/수/DSC02511.JPG_2.jpg,7189,480,640,79,217,296,287,378,True,68
수,56,kaist_dataset/Mixed/Digital_Camera/(C.S)C-outdoor2/DSC02887.JPG,char_data/수/DSC02887.JPG_2.jpg,2632,480,640,47,114,161,282,338,True,68
수,108,kaist_dataset/Mixed/Digital_Camera/(C.S)C-outdoor3/DSC03273.JPG,char_data/수/DSC03273.JPG_2.jpg,10044,480,640,93,85,178,187,295,True,68
수,63,kaist_dataset/Mixed/Digital_Camera/(C.S)C-outdoor3/DSC03429.JPG,char_data/수/DSC03429.JPG_2.jpg,3276,480,640,52,262,314,136,199,True,68
수,66,kaist_dataset/Mixed/Digital_Camera/(C.S)C-outdoor4/DSC03570.JPG,char_data/수/DSC03570.JPG_2.jpg,2508,480,640,38,190,228,349,415,True,68
수,50,kaist_dataset/Mixed/Digital_Camera/(C.S)C-outdoor4/DSC03582.JPG,char_data/수/DSC03582.JPG_2.jpg,1800,480,640,36,346,382,85,135,True,68
수,70,kaist_dataset/Mixed/Digital_Camera/(C.S)C-outdoor4/DSC03631.JPG,char_data/수/DSC03631.JPG_2.jpg,1610,480,640,23,138,161,179,249,True,68
수,97,kaist_dataset/Mixed/Digital_Camera/(C.S)C-outdoor4/DSC03657.JPG,char_data/수/DSC03657.JPG_2.jpg,8051,480,640,83,483,566,317,414,True,68
수,52,kaist_dataset/Mixed/Digital_Camera/(C.S)C-outdoor4/DSC03667.JPG,char_data/수/DSC03667.JPG_2.jpg,2600,480,640,50,173,223,283,335,False,68
수,81,kaist_dataset/Mixed/Digital_Camera/(C.S)C-outdoor4/DSC03691.JPG,char_data/수/DSC03691.JPG_2.jpg,6480,480,640,80,300,380,128,209,False,68
수,53,kaist_dataset/Mixed/Digital_Camera/(C.S)C-outdoor4/DSC03693.JPG,char_data/수/DSC03693.JPG_2.jpg,2597,480,640,49,186,235,352,405,False,68
수,123,kaist_dataset/Mixed/Digital_Camera/(C.S)C-outdoor4/DSC03722.JPG,char_data/수/DSC03722.JPG_2.jpg,10701,480,640,87,193,280,65,188,False,68
수,108,kaist_dataset/Mixed/Digital_Camera/(C.S)C-outdoor4/DSC03723.JPG,char_data/수/DSC03723.JPG_2.jpg,6912,480,640,64,187,251,67,175,False,68
수,94,kaist_dataset/Mixed/Digital_Camera/(C.S)C-outdoor4/DSC03724.JPG,char_data/수/DSC03724.JPG_2.jpg,6486,480,640,69,206,275,144,238,False,68
수,88,kaist_dataset/Mixed/Digital_Camera/(C.S)C-outdoor4/DSC03730.JPG,char_data/수/DSC03730.JPG_2.jpg,6688,480,640,76,253,329,166,254,False,68
수,96,kaist_dataset/Mixed/Digital_Camera/(C.S)C-outdoor4/DSC03732.JPG,char_data/수/DSC03732.JPG_2.jpg,9696,480,640,101,226,327,290,386,False,68
수,83,kaist_dataset/Mixed/Digital_Camera/(C.S)C-outdoor4/DSC03757.JPG,char_data/수/DSC03757.JPG_2.jpg,5478,480,640,66,452,518,227,310,False,68
수,84,kaist_dataset/Mixed/Digital_Camera/(C.S)C-outdoor5/DSC03830.JPG,char_data/수/DSC03830.JPG_2.jpg,3780,480,640,45,271,316,29,113,False,68
수,60,kaist_dataset/Mixed/Digital_Camera/(C.S)C-outdoor5/DSC04094.JPG,char_data/수/DSC04094.JPG_2.jpg,2760,480,640,46,277,323,191,251,False,68
수,62,kaist_dataset/Mixed/Digital_Camera/(C.S)C-outdoor5/DSC04111.JPG,char_data/수/DSC04111.JPG_2.jpg,2666,480,640,43,68,111,122,184,False,68
수,91,kaist_dataset/Mixed/Digital_Camera/(C.S)C-outdoor5/DSC04149.JPG,char_data/수/DSC04149.JPG_2.jpg,6643,480,640,73,84,157,200,291,False,68
수,36,kaist_dataset/Mixed/Digital_Camera/(C.S)C-outdoor5/DSC04150.JPG,char_data/수/DSC04150.JPG_2.jpg,936,480,640,26,513,539,312,348,False,68
수,62,kaist_dataset/Mixed/Digital_Camera/(C.S)C-outdoor5/DSC04401.JPG,char_data/수/DSC04401.JPG_2.jpg,3782,480,640,61,20,81,244,306,False,68
수,40,kaist_dataset/Mixed/Digital_Camera/(C.S)C-outdoor5/DSC04456.JPG,char_data/수/DSC04456.JPG_2.jpg,1320,480,640,33,204,237,227,267,False,68
수,30,kaist_dataset/Mixed/Digital_Camera/(C.S)C-outdoor6/P1010075.JPG,char_data/수/P1010075.JPG_4.jpg,780,480,640,26,402,428,138,168,False,68
수,25,kaist_dataset/Mixed/Digital_Camera/(C.S)C-outdoor6/P1010075.JPG,char_data/수/P1010075.JPG_5.jpg,425,480,640,17,466,483,138,163,False,68
수,49,kaist_dataset/Mixed/Digital_Camera/(C.S)C-outdoor6/P1010097.JPG,char_data/수/P1010097.JPG_2.jpg,2450,480,640,50,367,417,46,95,False,68
수,38,kaist_dataset/Mixed/Digital_Camera/(C.S)C-outdoor6/P1010098.JPG,char_data/수/P1010098.JPG_2.jpg,1406,480,640,37,369,406,443,479,False,68
수,50,kaist_dataset/Mixed/Digital_Camera/(C.S)C-outdoor6/P1010127.JPG,char_data/수/P1010127.JPG_2.jpg,2100,480,640,42,377,419,105,155,False,68
수,110,kaist_dataset/Mixed/Digital_Camera/(C.S)D-indoor1/DSC02739.JPG,char_data/수/DSC02739.JPG_2.jpg,10010,480,640,91,206,297,39,149,False,68
수,38,kaist_dataset/Mixed/Digital_Camera/(C.S)D-indoor1/DSC02756.JPG,char_data/수/DSC02756.JPG_2.jpg,1178,480,640,31,271,302,146,184,False,68
수,109,kaist_dataset/Mixed/Digital_Camera/(C.S)D-indoor1/DSC02787.JPG,char_data/수/DSC02787.JPG_2.jpg,6431,480,640,59,186,245,246,355,False,68
수,43,kaist_dataset/Mixed/Digital_Camera/(C.S)D-indoor1/DSC03096.JPG,char_data/수/DSC03096.JPG_2.jpg,1677,480,640,39,468,507,349,392,False,68
수,70,kaist_dataset/Mixed/Digital_Camera/(C.S)D-indoor1/DSC03483.JPG,char_data/수/DSC03483.JPG_2.jpg,3570,480,640,51,284,335,114,184,False,68
수,108,kaist_dataset/Mixed/Digital_Camera/(C.S)D-indoor1/DSC03998.JPG,char_data/수/DSC03998.JPG_2.jpg,6696,480,640,62,164,226,253,361,False,68
수,80,kaist_dataset/Mixed/Digital_Camera/(C.S)E-night/DSC02600.JPG,char_data/수/DSC02600.JPG_2.jpg,8000,480,640,100,84,184,306,386,False,68
수,40,kaist_dataset/Mixed/Digital_Camera/(C.S)E-night/DSC03561.JPG,char_data/수/DSC03561.JPG_2.jpg,1400,480,640,35,290,325,29,69,False,68
수,41,kaist_dataset/Mixed/Mobile_Phone/(C.M)A-outdoor/P090908005.jpg,char_data/수/P090908005.jpg_2.jpg,1804,480,640,44,90,134,147,188,False,68
수,40,kaist_dataset/Mixed/Mobile_Phone/(C.M)A-outdoor/P090908006.jpg,char_data/수/P090908006.jpg_2.jpg,1920,480,640,48,73,121,275,315,False,68
수,91,kaist_dataset/Mixed/Mobile_Phone/(C.M)A-outdoor/P090912036.jpg,char_data/수/P090912036.jpg_2.jpg,8736,480,640,96,301,397,84,175,False,68
수,134,kaist_dataset/Mixed/Mobile_Phone/(C.M)A-outdoor/P090912047.jpg,char_data/수/P090912047.jpg_2.jpg,10720,480,640,80,524,604,128,262,False,68
학,86,kaist_dataset/Korean/Digital_Camera/A-shadow/DSC03536.JPG,char_data/학/DSC03536.JPG_2.jpg,7310,480,640,85,201,286,130,216,True,85
학,279,kaist_dataset/Korean/Digital_Camera/F-bookCover/DSC02822.JPG,char_data/학/DSC02822.JPG_2.jpg,53568,480,640,192,407,599,40,319,True,85
학,235,kaist_dataset/Korean/Digital_Camera/F-bookCover/DSC02823.JPG,char_data/학/DSC02823.JPG_2.jpg,38070,480,640,162,381,543,149,384,True,85
학,279,kaist_dataset/Korean/Digital_Camera/F-bookCover/DSC02824.JPG,char_data/학/DSC02824.JPG_2.jpg,51336,480,640,184,424,608,112,391,True,85
학,184,kaist_dataset/Korean/Digital_Camera/F-bookCover/DSC02826.JPG,char_data/학/DSC02826.JPG_2.jpg,25944,480,640,141,447,588,195,379,True,85
학,55,kaist_dataset/Korean/Digital_Camera/F-bookCover/DSC03933.JPG,char_data/학/DSC03933.JPG_2.jpg,2035,480,640,37,423,460,282,337,True,85
학,88,kaist_dataset/Korean/Digital_Camera/F-bookCover/DSC04217.JPG,char_data/학/DSC04217.JPG_2.jpg,7216,480,640,82,324,406,64,152,True,85
학,63,kaist_dataset/Korean/Digital_Camera/F-bookCover/DSC04218.JPG,char_data/학/DSC04218.JPG_2.jpg,3087,480,640,49,338,387,196,259,True,85
학,63,kaist_dataset/Korean/Digital_Camera/F-bookCover/DSC04219.JPG,char_data/학/DSC04219.JPG_2.jpg,3465,480,640,55,267,322,173,236,True,85
학,69,kaist_dataset/Korean/Digital_Camera/F-bookCover/DSC04222.JPG,char_data/학/DSC04222.JPG_2.jpg,3312,480,640,48,295,343,60,129,True,85
학,83,kaist_dataset/Korean/Digital_Camera/F-bookCover/DSC04230.JPG,char_data/학/DSC04230.JPG_2.jpg,4150,480,640,50,361,411,188,271,True,85
학,97,kaist_dataset/Korean/Digital_Camera/F-bookCover/DSC04232.JPG,char_data/학/DSC04232.JPG_2.jpg,7372,480,640,76,172,248,122,219,True,85
학,86,kaist_dataset/Korean/Digital_Camera/F-bookCover/DSC04240.JPG,char_data/학/DSC04240.JPG_2.jpg,4902,480,640,57,200,257,82,168,True,85
학,96,kaist_dataset/Korean/Digital_Camera/F-bookCover/DSC04241.JPG,char_data/학/DSC04241.JPG_2.jpg,6912,480,640,72,237,309,249,345,True,85
학,116,kaist_dataset/Korean/Digital_Camera/G-others/2007-12-09-day-exterior-005.jpg,char_data/학/2007-12-09-day-exterior-005.jpg_8.jpg,22968,1600,1200,198,24,222,676,792,True,85
학,121,kaist_dataset/Korean/Digital_Camera/G-others/2007-12-09-day-exterior-005.jpg,char_data/학/2007-12-09-day-exterior-005.jpg_9.jpg,23111,1600,1200,191,9,200,1074,1195,True,85
학,121,kaist_dataset/Korean/Digital_Camera/G-others/2007-12-09-day-exterior-005.jpg,char_data/학/2007-12-09-day-exterior-005.jpg_10.jpg,11979,1600,1200,99,641,740,341,462,True,85
학,118,kaist_dataset/Korean/Digital_Camera/G-others/2007-12-09-day-exterior-005.jpg,char_data/학/2007-12-09-day-exterior-005.jpg_11.jpg,11800,1600,1200,100,546,646,720,838,True,85
학,69,kaist_dataset/Korean/Digital_Camera/G-others/2007-12-09-day-exterior-062.jpg,char_data/학/2007-12-09-day-exterior-062.jpg_4.jpg,4485,1600,1200,65,675,740,208,277,True,85
학,252,kaist_dataset/Korean/Digital_Camera/G-others/2007-12-09-day-exterior-062.jpg,char_data/학/2007-12-09-day-exterior-062.jpg_5.jpg,71568,1600,1200,284,473,757,852,1104,True,85
학,66,kaist_dataset/Korean/Digital_Camera/indoor1/DSC02723.JPG,char_data/학/DSC02723.JPG_2.jpg,3564,480,640,54,255,309,145,211,True,85
학,133,kaist_dataset/Korean/Digital_Camera/indoor1/DSC02757.JPG,char_data/학/DSC02757.JPG_4.jpg,14364,480,640,108,83,191,185,318,True,85
학,44,kaist_dataset/Korean/Digital_Camera/indoor1/DSC02757.JPG,char_data/학/DSC02757.JPG_5.jpg,1364,480,640,31,314,345,153,197,True,85
학,98,kaist_dataset/Korean/Digital_Camera/indoor1/DSC02778.JPG,char_data/학/DSC02778.JPG_2.jpg,8722,480,640,89,166,255,282,380,True,85
학,69,kaist_dataset/Korean/Digital_Camera/indoor1/DSC03092.JPG,char_data/학/DSC03092.JPG_2.jpg,4416,480,640,64,500,564,90,159,True,85
학,82,kaist_dataset/Korean/Digital_Camera/indoor1/DSC03152.JPG,char_data/학/DSC03152.JPG_2.jpg,4592,480,640,56,153,209,218,300,True,85
학,107,kaist_dataset/Korean/Digital_Camera/indoor1/DSC03154.JPG,char_data/학/DSC03154.JPG_4.jpg,8560,480,640,80,139,219,187,294,True,85
학,108,kaist_dataset/Korean/Digital_Camera/indoor1/DSC03154.JPG,char_data/학/DSC03154.JPG_5.jpg,8424,480,640,78,387,465,181,289,True,85
학,103,kaist_dataset/Korean/Digital_Camera/indoor1/DSC03155.JPG,char_data/학/DSC03155.JPG_4.jpg,7622,480,640,74,94,168,127,230,True,85
학,93,kaist_dataset/Korean/Digital_Camera/indoor1/DSC03155.JPG,char_data/학/DSC03155.JPG_5.jpg,6696,480,640,72,248,320,131,224,True,85
학,164,kaist_dataset/Korean/Digital_Camera/indoor2/DSC04001.JPG,char_data/학/DSC04001.JPG_2.jpg,16892,480,640,103,471,574,169,333,True,85
학,105,kaist_dataset/Korean/Digital_Camera/indoor2/DSC04004.JPG,char_data/학/DSC04004.JPG_2.jpg,9135,480,640,87,471,558,296,401,True,85
학,68,kaist_dataset/Korean/Digital_Camera/indoor2/DSC04186.JPG,char_data/학/DSC04186.JPG_2.jpg,3740,480,640,55,285,340,74,142,True,85
학,41,kaist_dataset/Korean/Digital_Camera/indoor2/DSC04250.JPG,char_data/학/DSC04250.JPG_2.jpg,1640,480,640,40,384,424,252,293,True,85
학,106,kaist_dataset/Korean/Digital_Camera/indoor2/DSC04417.JPG,char_data/학/DSC04417.JPG_2.jpg,7420,480,640,70,495,565,124,230,True,85
학,72,kaist_dataset/Korean/Digital_Camera/indoor2/DSC04422.JPG,char_data/학/DSC04422.JPG_2.jpg,3384,480,640,47,404,451,225,297,True,85
학,79,kaist_dataset/Korean/Digital_Camera/indoor2/DSC04423.JPG,char_data/학/DSC04423.JPG_2.jpg,5609,480,640,71,359,430,231,310,True,85
학,52,kaist_dataset/Korean/Digital_Camera/outdoor1/001.JPG,char_data/학/001.JPG_2.jpg,3172,480,640,61,461,522,185,237,True,85
학,106,kaist_dataset/Korean/Digital_Camera/outdoor1/004.JPG,char_data/학/004.JPG_2.jpg,8374,480,640,79,354,433,145,251,True,85
학,39,kaist_dataset/Korean/Digital_Camera/outdoor1/029.JPG,char_data/학/029.JPG_4.jpg,1365,480,640,35,244,279,148,187,True,85
학,90,kaist_dataset/Korean/Digital_Camera/outdoor1/029.JPG,char_data/학/029.JPG_5.jpg,6030,480,640,67,449,516,200,290,True,85
학,106,kaist_dataset/Korean/Digital_Camera/outdoor1/54.JPG,char_data/학/54.JPG_4.jpg,11872,523,767,112,143,255,247,353,True,85
학,113,kaist_dataset/Korean/Digital_Camera/outdoor1/54.JPG,char_data/학/54.JPG_5.jpg,11413,523,767,101,471,572,243,356,True,85
학,96,kaist_dataset/Korean/Digital_Camera/outdoor2/DSC02467.JPG,char_data/학/DSC02467.JPG_2.jpg,8544,480,640,89,373,462,162,258,True,85
학,110,kaist_dataset/Korean/Digital_Camera/outdoor2/DSC02488.JPG,char_data/학/DSC02488.JPG_2.jpg,11880,480,640,108,284,392,312,422,True,85
학,97,kaist_dataset/Korean/Digital_Camera/outdoor2/DSC02506.JPG,char_data/학/DSC02506.JPG_2.jpg,8342,480,640,86,413,499,317,414,True,85
학,65,kaist_dataset/Korean/Digital_Camera/outdoor3/DSC02537.JPG,char_data/학/DSC02537.JPG_2.jpg,3510,480,640,54,416,470,352,417,True,85
학,84,kaist_dataset/Korean/Digital_Camera/outdoor3/DSC03232.JPG,char_data/학/DSC03232.JPG_2.jpg,7560,480,640,90,459,549,184,268,True,85
학,125,kaist_dataset/Korean/Digital_Camera/outdoor4/DSC03261.JPG,char_data/학/DSC03261.JPG_2.jpg,14500,480,640,116,368,484,271,396,True,85
학,78,kaist_dataset/Korean/Digital_Camera/outdoor4/DSC03263.JPG,char_data/학/DSC03263.JPG_4.jpg,6006,480,640,77,204,281,53,131,True,85
학,86,kaist_dataset/Korean/Digital_Camera/outdoor4/DSC03263.JPG,char_data/학/DSC03263.JPG_5.jpg,7568,480,640,88,536,624,44,130,True,85
학,153,kaist_dataset/Korean/Digital_Camera/outdoor4/DSC03268.JPG,char_data/학/DSC03268.JPG_4.jpg,25245,480,640,165,444,609,274,427,True,85
학,48,kaist_dataset/Korean/Digital_Camera/outdoor4/DSC03268.JPG,char_data/학/DSC03268.JPG_5.jpg,2256,480,640,47,402,449,199,247,True,85
학,42,kaist_dataset/Korean/Digital_Camera/outdoor4/DSC03272.JPG,char_data/학/DSC03272.JPG_6.jpg,1302,480,640,31,103,134,244,286,True,85
학,120,kaist_dataset/Korean/Digital_Camera/outdoor4/DSC03272.JPG,char_data/학/DSC03272.JPG_7.jpg,10800,480,640,90,341,431,297,417,True,85
학,104,kaist_dataset/Korean/Digital_Camera/outdoor4/DSC03272.JPG,char_data/학/DSC03272.JPG_8.jpg,8736,480,640,84,432,516,295,399,True,85
학,149,kaist_dataset/Korean/Digital_Camera/outdoor4/DSC03452.JPG,char_data/학/DSC03452.JPG_2.jpg,7003,480,640,47,446,493,112,261,True,85
학,90,kaist_dataset/Korean/Digital_Camera/outdoor4/DSC03537.JPG,char_data/학/DSC03537.JPG_2.jpg,7470,480,640,83,436,519,18,108,True,85
학,42,kaist_dataset/Korean/Digital_Camera/outdoor4/DSC03573.JPG,char_data/학/DSC03573.JPG_2.jpg,1806,480,640,43,183,226,156,198,True,85
학,78,kaist_dataset/Korean/Digital_Camera/outdoor4/DSC03598.JPG,char_data/학/DSC03598.JPG_2.jpg,5226,480,640,67,422,489,88,166,True,85
학,91,kaist_dataset/Korean/Digital_Camera/outdoor4/DSC03599.JPG,char_data/학/DSC03599.JPG_2.jpg,7007,480,640,77,386,463,108,199,True,85
학,70,kaist_dataset/Korean/Digital_Camera/outdoor4/DSC03600.JPG,char_data/학/DSC03600.JPG_2.jpg,3710,480,640,53,448,501,178,248,True,85
학,68,kaist_dataset/Korean/Digital_Camera/outdoor4/DSC03601.JPG,char_data/학/DSC03601.JPG_2.jpg,3944,480,640,58,410,468,157,225,True,85
학,88,kaist_dataset/Korean/Digital_Camera/outdoor4/DSC03610.JPG,char_data/학/DSC03610.JPG_2.jpg,6776,480,640,77,432,509,18,106,True,85
학,70,kaist_dataset/Korean/Digital_Camera/outdoor4/DSC03612.JPG,char_data/학/DSC03612.JPG_2.jpg,3990,480,640,57,394,451,33,103,True,85
학,51,kaist_dataset/Korean/Digital_Camera/outdoor4/DSC03615.JPG,char_data/학/DSC03615.JPG_2.jpg,2907,480,640,57,248,305,220,271,True,85
학,91,kaist_dataset/Korean/Digital_Camera/outdoor5/DSC03623.JPG,char_data/학/DSC03623.JPG_2.jpg,7462,480,640,82,112,194,115,206,True,85
학,61,kaist_dataset/Korean/Digital_Camera/outdoor5/DSC03681.JPG,char_data/학/DSC03681.JPG_2.jpg,2501,480,640,41,324,365,354,415,True,85
학,157,kaist_dataset/Korean/Digital_Camera/outdoor5/DSC03709.JPG,char_data/학/DSC03709.JPG_4.jpg,25434,480,640,162,447,609,199,356,True,85
학,58,kaist_dataset/Korean/Digital_Camera/outdoor5/DSC03709.JPG,char_data/학/DSC03709.JPG_5.jpg,2030,480,640,35,565,600,128,186,True,85
학,68,kaist_dataset/Korean/Digital_Camera/outdoor5/DSC03712.JPG,char_data/학/DSC03712.JPG_2.jpg,2992,480,640,44,258,302,42,110,True,85
학,83,kaist_dataset/Korean/Digital_Camera/outdoor5/DSC03739.JPG,char_data/학/DSC03739.JPG_4.jpg,5561,480,640,67,422,489,194,277,True,85
학,67,kaist_dataset/Korean/Digital_Camera/outdoor5/DSC03739.JPG,char_data/학/DSC03739.JPG_5.jpg,3484,480,640,52,456,508,374,441,True,85
학,59,kaist_dataset/Korean/Digital_Camera/outdoor5/DSC03740.JPG,char_data/학/DSC03740.JPG_2.jpg,3245,480,640,55,386,441,212,271,True,85
학,64,kaist_dataset/Korean/Digital_Camera/outdoor5/DSC03742.JPG,char_data/학/DSC03742.JPG_2.jpg,3776,480,640,59,311,370,377,441,True,85
학,63,kaist_dataset/Korean/Digital_Camera/outdoor5/DSC03744.JPG,char_data/학/DSC03744.JPG_2.jpg,6111,480,640,97,411,508,231,294,True,85
학,145,kaist_dataset/Korean/Digital_Camera/outdoor5/DSC03774.JPG,char_data/학/DSC03774.JPG_2.jpg,12470,480,640,86,543,629,39,184,True,85
학,117,kaist_dataset/Korean/Digital_Camera/outdoor5/DSC04000.JPG,char_data/학/DSC04000.JPG_2.jpg,11232,480,640,96,433,529,319,436,True,85
학,126,kaist_dataset/Korean/Digital_Camera/outdoor5/DSC04036.JPG,char_data/학/DSC04036.JPG_2.jpg,14238,480,640,113,389,502,65,191,True,85
학,101,kaist_dataset/Korean/Digital_Camera/outdoor5/DSC04038.JPG,char_data/학/DSC04038.JPG_2.jpg,7979,480,640,79,346,425,203,304,True,85
학,43,kaist_dataset/Korean/Digital_Camera/outdoor6/DSC04126.JPG,char_data/학/DSC04126.JPG_2.jpg,1376,480,640,32,162,194,212,255,True,85
학,37,kaist_dataset/Korean/Digital_Camera/outdoor6/DSC04157.JPG,char_data/학/DSC04157.JPG_2.jpg,1147,480,640,31,197,228,174,211,True,85
학,74,kaist_dataset/Korean/Digital_Camera/outdoor6/DSC04292.JPG,char_data/학/DSC04292.JPG_2.jpg,4440,480,640,60,394,454,18,92,True,85
학,78,kaist_dataset/Korean/Digital_Camera/outdoor6/DSC04328.JPG,char_data/학/DSC04328.JPG_2.jpg,3510,480,640,45,531,576,19,97,True,85
학,110,kaist_dataset/Korean/Digital_Camera/outdoor6/DSC04398.JPG,char_data/학/DSC04398.JPG_4.jpg,9460,480,640,86,362,448,243,353,True,85
학,60,kaist_dataset/Korean/Digital_Camera/outdoor6/DSC04398.JPG,char_data/학/DSC04398.JPG_5.jpg,2400,480,640,40,487,527,370,430,True,85
학,83,kaist_dataset/Korean/Digital_Camera/outdoor6/DSC04400.JPG,char_data/학/DSC04400.JPG_4.jpg,7138,480,640,86,398,484,136,219,True,85
학,80,kaist_dataset/Korean/Digital_Camera/outdoor6/DSC04400.JPG,char_data/학/DSC04400.JPG_5.jpg,5200,480,640,65,454,519,301,381,True,85
학,110,kaist_dataset/Korean/Digital_Camera/outdoor6/DSC04407.JPG,char_data/학/DSC04407.JPG_2.jpg,11000,480,640,100,436,536,85,195,True,85
학,94,kaist_dataset/Korean/Digital_Camera/outdoor6/DSC04439.JPG,char_data/학/DSC04439.JPG_4.jpg,9212,480,640,98,289,387,48,142,True,85
학,109,kaist_dataset/Korean/Digital_Camera/outdoor6/DSC04439.JPG,char_data/학/DSC04439.JPG_5.jpg,9810,480,640,90,303,393,285,394,True,85
학,54,kaist_dataset/Korean/Digital_Camera/outdoor7/DSC04455.JPG,char_data/학/DSC04455.JPG_2.jpg,2160,480,640,40,315,355,363,417,True,85
학,88,kaist_dataset/Korean/Digital_Camera/outdoor7/P1010091.JPG,char_data/학/P1010091.JPG_2.jpg,6160,480,640,70,439,509,149,237,True,85
학,94,kaist_dataset/Korean/Digital_Camera/outdoor8/크기변환_P1010027.JPG,char_data/학/크기변환_P1010027.JPG_2.jpg,6768,480,640,72,216,288,182,276,True,85
학,125,"kaist_dataset/Korean/Mobile_Phone/(M,K)E-bookCover/P090831031.jpg",char_data/학/P090831031.jpg_2.jpg,12125,480,640,97,317,414,164,289,True,85
학,157,"kaist_dataset/Korean/Mobile_Phone/(M,K)E-bookCover/P090831040.jpg",char_data/학/P090831040.jpg_2.jpg,16956,480,640,108,245,353,107,264,True,85
학,102,"kaist_dataset/Korean/Mobile_Phone/(M,K)E-bookCover/P090831087.jpg",char_data/학/P090831087.jpg_2.jpg,8874,480,640,87,256,343,8,110,True,85
학,103,"kaist_dataset/Korean/Mobile_Phone/(M,K)E-bookCover/P090831099.jpg",char_data/학/P090831099.jpg_2.jpg,9785,480,640,95,309,404,6,109,True,85
학,237,"kaist_dataset/Korean/Mobile_Phone/(M,K)E-bookCover/P090911006.jpg",char_data/학/P090911006.jpg_2.jpg,51192,480,640,216,342,558,121,358,True,85
학,63,kaist_dataset/Mixed/Digital_Camera/(C.S)C-outdoor1/003.JPG,char_data/학/003.JPG_2.jpg,3024,480,640,48,207,255,186,249,True,85
학,56,kaist_dataset/Mixed/Digital_Camera/(C.S)C-outdoor1/066.JPG,char_data/학/066.JPG_2.jpg,2744,480,640,49,365,414,176,232,True,85
학,28,kaist_dataset/Mixed/Digital_Camera/(C.S)C-outdoor1/55.JPG,char_data/학/55.JPG_2.jpg,896,576,768,32,353,385,237,265,True,85
학,61,kaist_dataset/Mixed/Digital_Camera/(C.S)C-outdoor1/DSC02242.JPG,char_data/학/DSC02242.JPG_2.jpg,3111,480,640,51,249,300,195,256,True,85
학,129,kaist_dataset/Mixed/Digital_Camera/(C.S)C-outdoor2/DSC02502.JPG,char_data/학/DSC02502.JPG_4.jpg,14835,480,640,115,350,465,133,262,True,85
학,61,kaist_dataset/Mixed/Digital_Camera/(C.S)C-outdoor2/DSC02502.JPG,char_data/학/DSC02502.JPG_5.jpg,4209,480,640,69,475,544,136,197,True,85
학,136,kaist_dataset/Mixed/Digital_Camera/(C.S)C-outdoor2/DSC02503.JPG,char_data/학/DSC02503.JPG_2.jpg,12240,480,640,90,437,527,146,282,True,85
학,75,kaist_dataset/Mixed/Digital_Camera/(C.S)C-outdoor2/DSC02511.JPG,char_data/학/DSC02511.JPG_6.jpg,6525,480,640,87,380,467,141,216,True,85
학,103,kaist_dataset/Mixed/Digital_Camera/(C.S)C-outdoor2/DSC02511.JPG,char_data/학/DSC02511.JPG_7.jpg,9167,480,640,89,310,399,285,388,True,85
학,109,kaist_dataset/Mixed/Digital_Camera/(C.S)C-outdoor2/DSC02511.JPG,char_data/학/DSC02511.JPG_8.jpg,9374,480,640,86,404,490,288,397,True,85
학,80,kaist_dataset/Mixed/Digital_Camera/(C.S)C-outdoor2/DSC02543.JPG,char_data/학/DSC02543.JPG_2.jpg,6160,480,640,77,420,497,267,347,True,85
학,58,kaist_dataset/Mixed/Digital_Camera/(C.S)C-outdoor2/DSC02869.JPG,char_data/학/DSC02869.JPG_4.jpg,2320,480,640,40,218,258,227,285,True,85
학,67,kaist_dataset/Mixed/Digital_Camera/(C.S)C-outdoor2/DSC02869.JPG,char_data/학/DSC02869.JPG_5.jpg,2144,480,640,32,124,156,65,132,True,85
학,54,kaist_dataset/Mixed/Digital_Camera/(C.S)C-outdoor3/DSC03233.JPG,char_data/학/DSC03233.JPG_2.jpg,3240,480,640,60,436,496,273,327,True,85
학,107,kaist_dataset/Mixed/Digital_Camera/(C.S)C-outdoor3/DSC03273.JPG,char_data/학/DSC03273.JPG_2.jpg,8239,480,640,77,180,257,188,295,True,85
학,108,kaist_dataset/Mixed/Digital_Camera/(C.S)C-outdoor3/DSC03274.JPG,char_data/학/DSC03274.JPG_2.jpg,8856,480,640,82,343,425,251,359,True,85
학,44,kaist_dataset/Mixed/Digital_Camera/(C.S)C-outdoor4/DSC03556.JPG,char_data/학/DSC03556.JPG_2.jpg,1408,480,640,32,379,411,255,299,True,85
학,69,kaist_dataset/Mixed/Digital_Camera/(C.S)C-outdoor4/DSC03586.JPG,char_data/학/DSC03586.JPG_2.jpg,4071,480,640,59,280,339,77,146,True,85
학,51,kaist_dataset/Mixed/Digital_Camera/(C.S)C-outdoor4/DSC03620.JPG,char_data/학/DSC03620.JPG_2.jpg,3723,480,640,73,158,231,69,120,True,85
학,81,kaist_dataset/Mixed/Digital_Camera/(C.S)C-outdoor4/DSC03644.JPG,char_data/학/DSC03644.JPG_2.jpg,5346,480,640,66,426,492,316,397,True,85
학,53,kaist_dataset/Mixed/Digital_Camera/(C.S)C-outdoor4/DSC03678.JPG,char_data/학/DSC03678.JPG_2.jpg,1696,480,640,32,97,129,231,284,True,85
학,118,kaist_dataset/Mixed/Digital_Camera/(C.S)C-outdoor4/DSC03757.JPG,char_data/학/DSC03757.JPG_2.jpg,9912,480,640,84,542,626,223,341,True,85
학,116,kaist_dataset/Mixed/Digital_Camera/(C.S)C-outdoor5/DSC04013.JPG,char_data/학/DSC04013.JPG_2.jpg,4872,480,640,42,538,580,318,434,True,85
학,98,kaist_dataset/Mixed/Digital_Camera/(C.S)C-outdoor5/DSC04016.JPG,char_data/학/DSC04016.JPG_2.jpg,7448,480,640,76,47,123,219,317,True,85
학,115,kaist_dataset/Mixed/Digital_Camera/(C.S)C-outdoor5/DSC04029.JPG,char_data/학/DSC04029.JPG_4.jpg,9890,480,640,86,60,146,35,150,True,85
학,36,kaist_dataset/Mixed/Digital_Camera/(C.S)C-outdoor5/DSC04029.JPG,char_data/학/DSC04029.JPG_5.jpg,1440,480,640,40,402,442,246,282,True,85
학,63,kaist_dataset/Mixed/Digital_Camera/(C.S)C-outdoor5/DSC04139.JPG,char_data/학/DSC04139.JPG_2.jpg,1071,480,640,17,280,297,321,384,True,85
학,103,kaist_dataset/Mixed/Digital_Camera/(C.S)C-outdoor5/DSC04290.JPG,char_data/학/DSC04290.JPG_6.jpg,6283,480,640,61,484,545,70,173,True,85
학,67,kaist_dataset/Mixed/Digital_Camera/(C.S)C-outdoor5/DSC04290.JPG,char_data/학/DSC04290.JPG_7.jpg,2948,480,640,44,438,482,210,277,True,85
학,75,kaist_dataset/Mixed/Digital_Camera/(C.S)C-outdoor5/DSC04290.JPG,char_data/학/DSC04290.JPG_8.jpg,4875,480,640,65,389,454,341,416,True,85
학,79,kaist_dataset/Mixed/Digital_Camera/(C.S)C-outdoor5/DSC04321.JPG,char_data/학/DSC04321.JPG_2.jpg,5846,480,640,74,347,421,114,193,True,85
학,84,kaist_dataset/Mixed/Digital_Camera/(C.S)C-outdoor5/DSC04322.JPG,char_data/학/DSC04322.JPG_2.jpg,6048,480,640,72,377,449,121,205,True,85
학,87,kaist_dataset/Mixed/Digital_Camera/(C.S)C-outdoor5/DSC04349.JPG,char_data/학/DSC04349.JPG_2.jpg,6177,480,640,71,467,538,88,175,False,85
학,78,kaist_dataset/Mixed/Digital_Camera/(C.S)C-outdoor5/DSC04401.JPG,char_data/학/DSC04401.JPG_2.jpg,4134,480,640,53,568,621,91,169,False,85
학,130,kaist_dataset/Mixed/Digital_Camera/(C.S)C-outdoor5/DSC04434.JPG,char_data/학/DSC04434.JPG_4.jpg,15210,480,640,117,340,457,160,290,False,85
학,36,kaist_dataset/Mixed/Digital_Camera/(C.S)C-outdoor5/DSC04434.JPG,char_data/학/DSC04434.JPG_5.jpg,1080,480,640,30,207,237,435,471,False,85
학,81,kaist_dataset/Mixed/Digital_Camera/(C.S)C-outdoor5/DSC04449.JPG,char_data/학/DSC04449.JPG_4.jpg,4050,480,640,50,304,354,215,296,False,85
학,79,kaist_dataset/Mixed/Digital_Camera/(C.S)C-outdoor5/DSC04449.JPG,char_data/학/DSC04449.JPG_5.jpg,4108,480,640,52,463,515,217,296,False,85
학,42,kaist_dataset/Mixed/Digital_Camera/(C.S)C-outdoor5/DSC04456.JPG,char_data/학/DSC04456.JPG_4.jpg,1218,480,640,29,342,371,225,267,False,85
학,95,kaist_dataset/Mixed/Digital_Camera/(C.S)C-outdoor5/DSC04456.JPG,char_data/학/DSC04456.JPG_5.jpg,9785,480,640,103,450,553,65,160,False,85
학,52,kaist_dataset/Mixed/Digital_Camera/(C.S)C-outdoor6/P1010054.JPG,char_data/학/P1010054.JPG_2.jpg,1872,480,640,36,374,410,220,272,False,85
학,60,kaist_dataset/Mixed/Digital_Camera/(C.S)D-indoor1/DSC02746.JPG,char_data/학/DSC02746.JPG_2.jpg,3600,480,640,60,353,413,242,302,False,85
학,51,kaist_dataset/Mixed/Digital_Camera/(C.S)D-indoor1/DSC02749.JPG,char_data/학/DSC02749.JPG_2.jpg,2958,480,640,58,349,407,340,391,False,85
학,37,kaist_dataset/Mixed/Digital_Camera/(C.S)D-indoor1/DSC02751.JPG,char_data/학/DSC02751.JPG_4.jpg,1850,480,640,50,302,352,248,285,False,85
학,41,kaist_dataset/Mixed/Digital_Camera/(C.S)D-indoor1/DSC02751.JPG,char_data/학/DSC02751.JPG_5.jpg,1763,480,640,43,300,343,197,238,False,85
학,66,kaist_dataset/Mixed/Digital_Camera/(C.S)D-indoor1/DSC02752.JPG,char_data/학/DSC02752.JPG_2.jpg,4158,480,640,63,242,305,219,285,False,85
학,61,kaist_dataset/Mixed/Digital_Camera/(C.S)D-indoor1/DSC02755.JPG,char_data/학/DSC02755.JPG_2.jpg,3294,480,640,54,301,355,210,271,False,85
학,163,kaist_dataset/Mixed/Digital_Camera/(C.S)D-indoor1/DSC02770.JPG,char_data/학/DSC02770.JPG_2.jpg,26569,480,640,163,370,533,163,326,False,85
학,85,kaist_dataset/Mixed/Digital_Camera/(C.S)D-indoor1/DSC02804.JPG,char_data/학/DSC02804.JPG_2.jpg,6035,480,640,71,129,200,268,353,False,85
학,107,kaist_dataset/Mixed/Digital_Camera/(C.S)D-indoor1/DSC03998.JPG,char_data/학/DSC03998.JPG_4.jpg,7918,480,640,74,224,298,253,360,False,85
학,82,kaist_dataset/Mixed/Digital_Camera/(C.S)D-indoor1/DSC03998.JPG,char_data/학/DSC03998.JPG_5.jpg,2214,480,640,27,563,590,306,388,False,85
학,138,kaist_dataset/Mixed/Digital_Camera/(C.S)D-indoor1/DSC04002.JPG,char_data/학/DSC04002.JPG_2.jpg,5796,480,640,42,437,479,139,277,False,85
학,96,kaist_dataset/Mixed/Digital_Camera/(C.S)D-indoor1/DSC04003.JPG,char_data/학/DSC04003.JPG_2.jpg,8544,480,640,89,423,512,206,302,False,85
학,111,kaist_dataset/Mixed/Digital_Camera/(C.S)D-indoor1/DSC04226.JPG,char_data/학/DSC04226.JPG_2.jpg,10323,480,640,93,322,415,282,393,False,85
학,139,kaist_dataset/Mixed/Digital_Camera/(C.S)D-indoor1/DSC04233.JPG,char_data/학/DSC04233.JPG_2.jpg,17097,480,640,123,335,458,178,317,False,85
학,70,kaist_dataset/Mixed/Digital_Camera/(C.S)D-indoor2/DSC04254.JPG,char_data/학/DSC04254.JPG_2.jpg,3360,480,640,48,237,285,271,341,False,85
학,133,kaist_dataset/Mixed/Digital_Camera/(C.S)D-indoor2/DSC04256.JPG,char_data/학/DSC04256.JPG_2.jpg,12768,480,640,96,161,257,53,186,False,85
학,91,kaist_dataset/Mixed/Digital_Camera/(C.S)D-indoor2/DSC04409.JPG,char_data/학/DSC04409.JPG_2.jpg,3913,480,640,43,382,425,146,237,False,85
학,104,kaist_dataset/Mixed/Digital_Camera/(C.S)D-indoor2/DSC04442.JPG,char_data/학/DSC04442.JPG_2.jpg,9568,480,640,92,321,413,21,125,False,85
학,72,kaist_dataset/Mixed/Digital_Camera/(C.S)D-indoor2/DSC04463.JPG,char_data/학/DSC04463.JPG_2.jpg,5256,480,640,73,288,361,36,108,False,85
학,55,kaist_dataset/Mixed/Mobile_Phone/(C.M)A-outdoor/P090912066.jpg,char_data/학/P090912066.jpg_2.jpg,1650,480,640,30,359,389,202,257,False,85
학,66,kaist_dataset/Mixed/Mobile_Phone/(C.M)B-indoor/P090831005.jpg,char_data/학/P090831005.jpg_2.jpg,4026,480,640,61,128,189,168,234,False,85
학,67,kaist_dataset/Mixed/Mobile_Phone/(C.M)B-indoor/P090831013.jpg,char_data/학/P090831013.jpg_2.jpg,5025,480,640,75,125,200,111,178,False,85
학,63,kaist_dataset/Mixed/Mobile_Phone/(C.M)B-indoor/P090831016.jpg,char_data/학/P090831016.jpg_2.jpg,4284,480,640,68,221,289,116,179,False,85
학,45,kaist_dataset/Mixed/Mobile_Phone/(C.M)C-bookCover/P090903009.jpg,char_data/학/P090903009.jpg_2.jpg,1305,480,640,29,341,370,352,397,False,85
한,31,kaist_dataset/English/Digital_Camera/(E.S)B-light/080116-0059.jpg,char_data/한/080116-0059.jpg_4.jpg,713,1200,1600,23,604,627,909,940,True,86
한,34,kaist_dataset/English/Digital_Camera/(E.S)B-light/080116-0059.jpg,char_data/한/080116-0059.jpg_5.jpg,748,1200,1600,22,848,870,1070,1104,True,86
한,79,kaist_dataset/Korean/Digital_Camera/A-shadow/DSC03755.JPG,char_data/한/DSC03755.JPG_4.jpg,5372,480,640,68,367,435,21,100,True,86
한,67,kaist_dataset/Korean/Digital_Camera/A-shadow/DSC03755.JPG,char_data/한/DSC03755.JPG_5.jpg,3618,480,640,54,57,111,120,187,True,86
한,63,kaist_dataset/Korean/Digital_Camera/A-shadow/DSC04105.JPG,char_data/한/DSC04105.JPG_2.jpg,4662,480,640,74,209,283,128,191,True,86
한,35,kaist_dataset/Korean/Digital_Camera/A-shadow/DSC04297.JPG,char_data/한/DSC04297.JPG_2.jpg,875,480,640,25,173,198,207,242,True,86
한,102,kaist_dataset/Korean/Digital_Camera/A-shadow/DSC04373.JPG,char_data/한/DSC04373.JPG_2.jpg,10710,480,640,105,177,282,252,354,True,86
한,273,kaist_dataset/Korean/Digital_Camera/B-light/080119-0026.jpg,char_data/한/080119-0026.jpg_2.jpg,74802,1200,1600,274,509,783,406,679,True,86
한,56,kaist_dataset/Korean/Digital_Camera/E-night/072.jpg,char_data/한/072.jpg_2.jpg,2632,192,486,47,292,339,49,105,True,86
한,118,kaist_dataset/Korean/Digital_Camera/E-night/DSC03850.JPG,char_data/한/DSC03850.JPG_4.jpg,17464,480,640,148,159,307,135,253,True,86
한,34,kaist_dataset/Korean/Digital_Camera/E-night/DSC03850.JPG,char_data/한/DSC03850.JPG_5.jpg,986,480,640,29,202,231,389,423,True,86
한,137,kaist_dataset/Korean/Digital_Camera/E-night/DSC03872.JPG,char_data/한/DSC03872.JPG_2.jpg,14111,480,640,103,59,162,156,293,True,86
한,204,kaist_dataset/Korean/Digital_Camera/F-bookCover/DSC02814.JPG,char_data/한/DSC02814.JPG_2.jpg,38760,480,640,190,13,203,135,339,True,86
한,166,kaist_dataset/Korean/Digital_Camera/F-bookCover/DSC02815.JPG,char_data/한/DSC02815.JPG_2.jpg,24402,480,640,147,3,150,141,307,True,86
한,200,kaist_dataset/Korean/Digital_Camera/F-bookCover/DSC02818.JPG,char_data/한/DSC02818.JPG_2.jpg,33400,480,640,167,306,473,74,274,True,86
한,213,kaist_dataset/Korean/Digital_Camera/F-bookCover/DSC02819.JPG,char_data/한/DSC02819.JPG_2.jpg,32589,480,640,153,274,427,136,349,True,86
한,198,kaist_dataset/Korean/Digital_Camera/F-bookCover/DSC02827.JPG,char_data/한/DSC02827.JPG_4.jpg,30690,480,640,155,311,466,278,476,True,86
한,128,kaist_dataset/Korean/Digital_Camera/F-bookCover/DSC02827.JPG,char_data/한/DSC02827.JPG_5.jpg,12544,480,640,98,367,465,34,162,True,86
한,134,kaist_dataset/Korean/Digital_Camera/F-bookCover/DSC02829.JPG,char_data/한/DSC02829.JPG_4.jpg,12730,480,640,95,239,334,304,438,True,86
한,165,kaist_dataset/Korean/Digital_Camera/F-bookCover/DSC02829.JPG,char_data/한/DSC02829.JPG_5.jpg,18810,480,640,114,380,494,29,194,True,86
한,53,kaist_dataset/Korean/Digital_Camera/F-bookCover/DSC02839.JPG,char_data/한/DSC02839.JPG_2.jpg,2120,480,640,40,160,200,89,142,True,86
한,68,kaist_dataset/Korean/Digital_Camera/F-bookCover/DSC03929.JPG,char_data/한/DSC03929.JPG_2.jpg,3808,480,640,56,107,163,123,191,True,86
한,116,kaist_dataset/Korean/Digital_Camera/F-bookCover/DSC04229.JPG,char_data/한/DSC04229.JPG_2.jpg,12644,480,640,109,455,564,30,146,True,86
한,146,kaist_dataset/Korean/Digital_Camera/G-others/2007-12-09-day-exterior-005.jpg,char_data/한/2007-12-09-day-exterior-005.jpg_2.jpg,17812,1600,1200,122,468,590,505,651,True,86
한,41,kaist_dataset/Korean/Digital_Camera/indoor1/057.jpg,char_data/한/057.jpg_2.jpg,1435,322,425,35,49,84,234,275,True,86
한,48,kaist_dataset/Korean/Digital_Camera/indoor1/DSC02720.JPG,char_data/한/DSC02720.JPG_2.jpg,2016,480,640,42,452,494,205,253,True,86
한,49,kaist_dataset/Korean/Digital_Camera/indoor1/DSC02736.JPG,char_data/한/DSC02736.JPG_2.jpg,1715,480,640,35,284,319,141,190,True,86
한,50,kaist_dataset/Korean/Digital_Camera/indoor1/DSC02740.JPG,char_data/한/DSC02740.JPG_2.jpg,1700,480,640,34,522,556,93,143,True,86
한,52,kaist_dataset/Korean/Digital_Camera/indoor1/DSC02741.JPG,char_data/한/DSC02741.JPG_2.jpg,1924,480,640,37,395,432,197,249,True,86
한,46,kaist_dataset/Korean/Digital_Camera/indoor1/DSC02766.JPG,char_data/한/DSC02766.JPG_2.jpg,1656,480,640,36,416,452,91,137,True,86
한,49,kaist_dataset/Korean/Digital_Camera/indoor1/DSC02774.JPG,char_data/한/DSC02774.JPG_2.jpg,2009,480,640,41,434,475,211,260,True,86
한,61,kaist_dataset/Korean/Digital_Camera/indoor1/DSC03092.JPG,char_data/한/DSC03092.JPG_2.jpg,3782,480,640,62,130,192,80,141,True,86
한,71,kaist_dataset/Korean/Digital_Camera/indoor2/DSC03963.JPG,char_data/한/DSC03963.JPG_2.jpg,4260,480,640,60,57,117,280,351,True,86
한,89,kaist_dataset/Korean/Digital_Camera/indoor2/DSC04193.JPG,char_data/한/DSC04193.JPG_2.jpg,6942,480,640,78,270,348,163,252,True,86
한,127,kaist_dataset/Korean/Digital_Camera/indoor2/DSC04207.JPG,char_data/한/DSC04207.JPG_2.jpg,11811,480,640,93,199,292,27,154,True,86
한,114,kaist_dataset/Korean/Digital_Camera/indoor2/DSC04417.JPG,char_data/한/DSC04417.JPG_2.jpg,10146,480,640,89,34,123,131,245,True,86
한,52,kaist_dataset/Korean/Digital_Camera/outdoor1/015.JPG,char_data/한/015.JPG_4.jpg,3848,480,640,74,71,145,213,265,True,86
한,36,kaist_dataset/Korean/Digital_Camera/outdoor1/015.JPG,char_data/한/015.JPG_5.jpg,1692,480,640,47,180,227,436,472,True,86
한,84,kaist_dataset/Korean/Digital_Camera/outdoor1/024.JPG,char_data/한/024.JPG_2.jpg,8316,480,640,99,38,137,182,266,True,86
한,28,kaist_dataset/Korean/Digital_Camera/outdoor1/026.jpg,char_data/한/026.jpg_2.jpg,1036,480,640,37,202,239,108,136,True,86
한,33,kaist_dataset/Korean/Digital_Camera/outdoor1/033.JPG,char_data/한/033.JPG_2.jpg,1188,480,640,36,505,541,197,230,True,86
한,88,kaist_dataset/Korean/Digital_Camera/outdoor1/069.JPG,char_data/한/069.JPG_2.jpg,7832,480,640,89,95,184,170,258,True,86
한,35,kaist_dataset/Korean/Digital_Camera/outdoor1/102.JPG,char_data/한/102.JPG_2.jpg,910,480,640,26,152,178,302,337,True,86
한,71,kaist_dataset/Korean/Digital_Camera/outdoor1/2007-12-08-day-065.jpg,char_data/한/2007-12-08-day-065.jpg_2.jpg,4828,1600,1200,68,394,462,421,492,True,86
한,192,kaist_dataset/Korean/Digital_Camera/outdoor2/2007-12-08-day-094.jpg,char_data/한/2007-12-08-day-094.jpg_2.jpg,37056,1600,1200,193,570,763,662,854,True,86
한,181,kaist_dataset/Korean/Digital_Camera/outdoor2/2007-12-09-day-exterior-009.jpg,char_data/한/2007-12-09-day-exterior-009.jpg_2.jpg,30046,1200,1600,166,388,554,529,710,True,86
한,78,kaist_dataset/Korean/Digital_Camera/outdoor2/2007-12-09-day-exterior-033.jpg,char_data/한/2007-12-09-day-exterior-033.jpg_4.jpg,6942,1200,1600,89,629,718,1126,1199,True,86
한,244,kaist_dataset/Korean/Digital_Camera/outdoor2/2007-12-09-day-exterior-033.jpg,char_data/한/2007-12-09-day-exterior-033.jpg_5.jpg,60512,1200,1600,248,110,358,478,722,True,86
한,137,kaist_dataset/Korean/Digital_Camera/outdoor2/2007-12-09-day-exterior-084.jpg,char_data/한/2007-12-09-day-exterior-084.jpg_2.jpg,16440,1200,1600,120,630,750,491,628,True,86
한,60,kaist_dataset/Korean/Digital_Camera/outdoor2/DSC02321.JPG,char_data/한/DSC02321.JPG_2.jpg,2940,480,640,49,477,526,307,367,True,86
한,135,kaist_dataset/Korean/Digital_Camera/outdoor2/DSC02412.JPG,char_data/한/DSC02412.JPG_2.jpg,9045,480,640,67,87,154,259,394,True,86
한,88,kaist_dataset/Korean/Digital_Camera/outdoor3/DSC02552.JPG,char_data/한/DSC02552.JPG_2.jpg,9856,480,640,112,268,380,266,354,True,86
한,72,kaist_dataset/Korean/Digital_Camera/outdoor3/DSC02878.JPG,char_data/한/DSC02878.JPG_2.jpg,5544,480,640,77,324,401,172,244,True,86
한,66,kaist_dataset/Korean/Digital_Camera/outdoor3/DSC02889.JPG,char_data/한/DSC02889.JPG_2.jpg,6270,480,640,95,35,130,396,462,True,86
한,67,kaist_dataset/Korean/Digital_Camera/outdoor3/DSC02901.JPG,char_data/한/DSC02901.JPG_2.jpg,3149,480,640,47,248,295,400,467,True,86
한,65,kaist_dataset/Korean/Digital_Camera/outdoor3/DSC03009.JPG,char_data/한/DSC03009.JPG_2.jpg,3380,480,640,52,100,152,85,150,True,86
한,50,kaist_dataset/Korean/Digital_Camera/outdoor4/DSC03268.JPG,char_data/한/DSC03268.JPG_2.jpg,2050,480,640,41,308,349,207,257,True,86
한,50,kaist_dataset/Korean/Digital_Camera/outdoor4/DSC03437.JPG,char_data/한/DSC03437.JPG_2.jpg,2700,480,640,54,98,152,30,80,True,86
한,102,kaist_dataset/Korean/Digital_Camera/outdoor4/DSC03445.JPG,char_data/한/DSC03445.JPG_2.jpg,10098,480,640,99,354,453,201,303,True,86
한,50,kaist_dataset/Korean/Digital_Camera/outdoor4/DSC03578.JPG,char_data/한/DSC03578.JPG_2.jpg,1150,480,640,23,175,198,144,194,True,86
한,98,kaist_dataset/Korean/Digital_Camera/outdoor5/DSC03626.JPG,char_data/한/DSC03626.JPG_2.jpg,9702,480,640,99,46,145,179,277,True,86
한,91,kaist_dataset/Korean/Digital_Camera/outdoor5/DSC03645.JPG,char_data/한/DSC03645.JPG_2.jpg,2275,480,640,25,74,99,202,293,True,86
한,106,kaist_dataset/Korean/Digital_Camera/outdoor5/DSC03681.JPG,char_data/한/DSC03681.JPG_2.jpg,10706,480,640,101,309,410,250,356,True,86
한,54,kaist_dataset/Korean/Digital_Camera/outdoor5/DSC03683.JPG,char_data/한/DSC03683.JPG_2.jpg,2538,480,640,47,377,424,47,101,True,86
한,34,kaist_dataset/Korean/Digital_Camera/outdoor5/DSC03736.JPG,char_data/한/DSC03736.JPG_2.jpg,578,480,640,17,188,205,404,438,True,86
한,63,kaist_dataset/Korean/Digital_Camera/outdoor5/DSC03749.JPG,char_data/한/DSC03749.JPG_2.jpg,2709,480,640,43,249,292,85,148,True,86
한,139,kaist_dataset/Korean/Digital_Camera/outdoor5/DSC03788.JPG,char_data/한/DSC03788.JPG_2.jpg,18487,480,640,133,234,367,22,161,True,86
한,79,kaist_dataset/Korean/Digital_Camera/outdoor5/DSC03790.JPG,char_data/한/DSC03790.JPG_2.jpg,5372,480,640,68,195,263,64,143,True,86
한,72,kaist_dataset/Korean/Digital_Camera/outdoor5/DSC03835.JPG,char_data/한/DSC03835.JPG_2.jpg,6480,480,640,90,150,240,295,367,True,86
한,68,kaist_dataset/Korean/Digital_Camera/outdoor5/DSC03838.JPG,char_data/한/DSC03838.JPG_4.jpg,6256,480,640,92,110,202,58,126,True,86
한,44,kaist_dataset/Korean/Digital_Camera/outdoor5/DSC03838.JPG,char_data/한/DSC03838.JPG_5.jpg,1672,480,640,38,148,186,133,177,True,86
한,42,kaist_dataset/Korean/Digital_Camera/outdoor5/DSC03858.JPG,char_data/한/DSC03858.JPG_2.jpg,1302,480,640,31,581,612,411,453,True,86
한,81,kaist_dataset/Korean/Digital_Camera/outdoor5/DSC03970.JPG,char_data/한/DSC03970.JPG_2.jpg,6318,480,640,78,396,474,13,94,True,86
한,55,kaist_dataset/Korean/Digital_Camera/outdoor6/DSC04043.JPG,char_data/한/DSC04043.JPG_4.jpg,1430,480,640,26,17,43,214,269,True,86
한,49,kaist_dataset/Korean/Digital_Camera/outdoor6/DSC04043.JPG,char_data/한/DSC04043.JPG_5.jpg,1225,480,640,25,392,417,225,274,True,86
한,49,kaist_dataset/Korean/Digital_Camera/outdoor6/DSC04051.JPG,char_data/한/DSC04051.JPG_2.jpg,1911,480,640,39,294,333,367,416,True,86
한,115,kaist_dataset/Korean/Digital_Camera/outdoor6/DSC04077.JPG,char_data/한/DSC04077.JPG_4.jpg,12880,480,640,112,205,317,225,340,True,86
한,34,kaist_dataset/Korean/Digital_Camera/outdoor6/DSC04077.JPG,char_data/한/DSC04077.JPG_5.jpg,884,480,640,26,237,263,188,222,True,86
한,38,kaist_dataset/Korean/Digital_Camera/outdoor6/DSC04099.JPG,char_data/한/DSC04099.JPG_2.jpg,1216,480,640,32,220,252,172,210,True,86
한,58,kaist_dataset/Korean/Digital_Camera/outdoor6/DSC04110.JPG,char_data/한/DSC04110.JPG_2.jpg,2842,480,640,49,98,147,174,232,True,86
한,41,kaist_dataset/Korean/Digital_Camera/outdoor6/DSC04116.JPG,char_data/한/DSC04116.JPG_2.jpg,1148,480,640,28,229,257,177,218,True,86
한,83,kaist_dataset/Korean/Digital_Camera/outdoor6/DSC04132.JPG,char_data/한/DSC04132.JPG_2.jpg,7221,480,640,87,343,430,65,148,True,86
한,79,kaist_dataset/Korean/Digital_Camera/outdoor6/DSC04333.JPG,char_data/한/DSC04333.JPG_2.jpg,7426,480,640,94,326,420,136,215,True,86
한,37,kaist_dataset/Korean/Digital_Camera/outdoor6/DSC04343.JPG,char_data/한/DSC04343.JPG_2.jpg,1702,480,640,46,517,563,129,166,True,86
한,88,kaist_dataset/Korean/Digital_Camera/outdoor6/DSC04400.JPG,char_data/한/DSC04400.JPG_2.jpg,5896,480,640,67,69,136,298,386,True,86
한,64,kaist_dataset/Korean/Digital_Camera/outdoor7/DSC04481.JPG,char_data/한/DSC04481.JPG_2.jpg,3392,480,640,53,300,353,231,295,True,86
한,77,kaist_dataset/Korean/Digital_Camera/outdoor7/P1010066.JPG,char_data/한/P1010066.JPG_2.jpg,7546,480,640,98,139,237,63,140,True,86
한,45,kaist_dataset/Korean/Digital_Camera/outdoor7/P1010069.JPG,char_data/한/P1010069.JPG_2.jpg,2880,480,640,64,217,281,61,106,True,86
한,93,kaist_dataset/Korean/Digital_Camera/outdoor7/P1010081.JPG,char_data/한/P1010081.JPG_2.jpg,9021,480,640,97,116,213,307,400,True,86
한,95,kaist_dataset/Korean/Digital_Camera/outdoor7/P1010082.JPG,char_data/한/P1010082.JPG_4.jpg,8170,480,640,86,81,167,102,197,True,86
한,39,kaist_dataset/Korean/Digital_Camera/outdoor7/P1010082.JPG,char_data/한/P1010082.JPG_5.jpg,1482,480,640,38,520,558,252,291,True,86
한,83,kaist_dataset/Korean/Digital_Camera/outdoor7/P1010114.JPG,char_data/한/P1010114.JPG_2.jpg,6142,480,640,74,245,319,133,216,True,86
한,68,kaist_dataset/Korean/Digital_Camera/outdoor8/DSC02896.JPG,char_data/한/DSC02896.JPG_2.jpg,4760,480,640,70,60,130,210,278,True,86
한,119,kaist_dataset/Korean/Digital_Camera/outdoor8/P1010189.JPG,char_data/한/P1010189.JPG_2.jpg,12733,480,640,107,79,186,102,221,True,86
한,103,"kaist_dataset/Korean/Mobile_Phone/(M,K)C-outdoor/P090912041.jpg",char_data/한/P090912041.jpg_2.jpg,8446,480,640,82,7,89,162,265,True,86
한,69,"kaist_dataset/Korean/Mobile_Phone/(M,K)C-outdoor/P090912044.jpg",char_data/한/P090912044.jpg_2.jpg,4761,480,640,69,77,146,123,192,True,86
한,47,"kaist_dataset/Korean/Mobile_Phone/(M,K)E-bookCover/P090831033.jpg",char_data/한/P090831033.jpg_2.jpg,1739,480,640,37,436,473,407,454,True,86
한,103,"kaist_dataset/Korean/Mobile_Phone/(M,K)E-bookCover/P090831034.jpg",char_data/한/P090831034.jpg_2.jpg,8858,480,640,86,211,297,171,274,True,86
한,56,"kaist_dataset/Korean/Mobile_Phone/(M,K)E-bookCover/P090831036.jpg",char_data/한/P090831036.jpg_2.jpg,2688,480,640,48,342,390,27,83,True,86
한,34,"kaist_dataset/Korean/Mobile_Phone/(M,K)E-bookCover/P090831074.jpg",char_data/한/P090831074.jpg_2.jpg,952,480,640,28,230,258,102,136,True,86
한,71,"kaist_dataset/Korean/Mobile_Phone/(M,K)E-bookCover/P090831081.jpg",char_data/한/P090831081.jpg_2.jpg,4473,480,640,63,352,415,34,105,True,86
한,56,"kaist_dataset/Korean/Mobile_Phone/(M,K)E-bookCover/P090831132.jpg",char_data/한/P090831132.jpg_2.jpg,2016,480,640,36,325,361,214,270,True,86
한,128,"kaist_dataset/Korean/Mobile_Phone/(M,K)E-bookCover/P090831150.jpg",char_data/한/P090831150.jpg_2.jpg,12672,480,640,99,184,283,45,173,True,86
한,92,"kaist_dataset/Korean/Mobile_Phone/(M,K)E-bookCover/P090903025.jpg",char_data/한/P090903025.jpg_2.jpg,6808,480,640,74,154,228,209,301,True,86
한,38,"kaist_dataset/Korean/Mobile_Phone/(M,K)E-bookCover/P090903032.jpg",char_data/한/P090903032.jpg_2.jpg,1026,480,640,27,325,352,255,293,True,86
한,156,"kaist_dataset/Korean/Mobile_Phone/(M,K)E-bookCover/P090903051.jpg",char_data/한/P090903051.jpg_2.jpg,21840,480,640,140,253,393,249,405,True,86
한,104,"kaist_dataset/Korean/Mobile_Phone/(M,K)E-bookCover/P090903086.jpg",char_data/한/P090903086.jpg_2.jpg,12168,480,640,117,219,336,76,180,True,86
한,259,"kaist_dataset/Korean/Mobile_Phone/(M,K)E-bookCover/P090911001.jpg",char_data/한/P090911001.jpg_2.jpg,63196,480,640,244,181,425,111,370,True,86
한,211,"kaist_dataset/Korean/Mobile_Phone/(M,K)E-bookCover/P090911011.jpg",char_data/한/P090911011.jpg_2.jpg,31861,480,640,151,160,311,24,235,True,86
한,202,"kaist_dataset/Korean/Mobile_Phone/(M,K)E-bookCover/P090911013.jpg",char_data/한/P090911013.jpg_2.jpg,30906,480,640,153,33,186,203,405,True,86
한,42,"kaist_dataset/Korean/Mobile_Phone/(M,K)E-bookCover/P090911024.jpg",char_data/한/P090911024.jpg_2.jpg,1344,480,640,32,198,230,49,91,True,86
한,83,"kaist_dataset/Korean/Mobile_Phone/(M,K)E-bookCover/P090911033.jpg",char_data/한/P090911033.jpg_2.jpg,7304,480,640,88,185,273,120,203,True,86
한,62,"kaist_dataset/Korean/Mobile_Phone/(M,K)E-bookCover/P090911074.jpg",char_data/한/P090911074.jpg_2.jpg,3286,480,640,53,170,223,92,154,True,86
한,72,kaist_dataset/Mixed/Digital_Camera/(C.S)A-shadow/DSC02579.JPG,char_data/한/DSC02579.JPG_2.jpg,5688,480,640,79,220,299,316,388,True,86
한,106,kaist_dataset/Mixed/Digital_Camera/(C.S)A-shadow/DSC02581.JPG,char_data/한/DSC02581.JPG_2.jpg,9646,480,640,91,17,108,276,382,True,86
한,63,kaist_dataset/Mixed/Digital_Camera/(C.S)C-outdoor1/003.JPG,char_data/한/003.JPG_2.jpg,3402,480,640,54,58,112,190,253,True,86
한,71,kaist_dataset/Mixed/Digital_Camera/(C.S)C-outdoor1/047.JPG,char_data/한/047.JPG_4.jpg,6461,480,640,91,104,195,143,214,True,86
한,45,kaist_dataset/Mixed/Digital_Camera/(C.S)C-outdoor1/133.JPG,char_data/한/133.JPG_2.jpg,1755,480,640,39,59,98,325,370,True,86
한,40,kaist_dataset/Mixed/Digital_Camera/(C.S)C-outdoor1/48.JPG,char_data/한/48.JPG_2.jpg,1640,576,768,41,162,203,177,217,True,86
한,53,kaist_dataset/Mixed/Digital_Camera/(C.S)C-outdoor1/DSC02322.JPG,char_data/한/DSC02322.JPG_2.jpg,3710,480,640,70,202,272,163,216,True,86
한,79,kaist_dataset/Mixed/Digital_Camera/(C.S)C-outdoor2/DSC02377.JPG,char_data/한/DSC02377.JPG_2.jpg,5135,480,640,65,427,492,246,325,True,86
한,103,kaist_dataset/Mixed/Digital_Camera/(C.S)C-outdoor2/DSC02389.JPG,char_data/한/DSC02389.JPG_2.jpg,9270,480,640,90,25,115,142,245,True,86
한,50,kaist_dataset/Mixed/Digital_Camera/(C.S)C-outdoor2/DSC02425.JPG,char_data/한/DSC02425.JPG_2.jpg,1700,480,640,34,465,499,102,152,True,86
한,64,kaist_dataset/Mixed/Digital_Camera/(C.S)C-outdoor2/DSC02533.JPG,char_data/한/DSC02533.JPG_2.jpg,3968,480,640,62,210,272,105,169,True,86
한,47,kaist_dataset/Mixed/Digital_Camera/(C.S)C-outdoor2/DSC02864.JPG,char_data/한/DSC02864.JPG_2.jpg,2021,480,640,43,260,303,80,127,False,86
한,46,kaist_dataset/Mixed/Digital_Camera/(C.S)C-outdoor2/DSC02866.JPG,char_data/한/DSC02866.JPG_2.jpg,2024,480,640,44,197,241,69,115,False,86
한,101,kaist_dataset/Mixed/Digital_Camera/(C.S)C-outdoor2/DSC02895.JPG,char_data/한/DSC02895.JPG_2.jpg,9191,480,640,91,117,208,234,335,False,86
한,86,kaist_dataset/Mixed/Digital_Camera/(C.S)C-outdoor2/DSC02927.JPG,char_data/한/DSC02927.JPG_2.jpg,5934,480,640,69,308,377,38,124,False,86
한,58,kaist_dataset/Mixed/Digital_Camera/(C.S)C-outdoor3/DSC03164.JPG,char_data/한/DSC03164.JPG_2.jpg,3074,480,640,53,206,259,206,264,False,86
한,62,kaist_dataset/Mixed/Digital_Camera/(C.S)C-outdoor3/DSC03227.JPG,char_data/한/DSC03227.JPG_2.jpg,2542,480,640,41,212,253,393,455,False,86
한,42,kaist_dataset/Mixed/Digital_Camera/(C.S)C-outdoor3/DSC03249.JPG,char_data/한/DSC03249.JPG_2.jpg,1638,480,640,39,243,282,238,280,False,86
한,118,kaist_dataset/Mixed/Digital_Camera/(C.S)C-outdoor3/DSC03275.JPG,char_data/한/DSC03275.JPG_2.jpg,12272,480,640,104,335,439,62,180,False,86
한,35,kaist_dataset/Mixed/Digital_Camera/(C.S)C-outdoor3/DSC03301.JPG,char_data/한/DSC03301.JPG_2.jpg,1190,480,640,34,168,202,152,187,False,86
한,38,kaist_dataset/Mixed/Digital_Camera/(C.S)C-outdoor4/DSC03439.JPG,char_data/한/DSC03439.JPG_2.jpg,1140,480,640,30,237,267,423,461,False,86
한,81,kaist_dataset/Mixed/Digital_Camera/(C.S)C-outdoor4/DSC03446.JPG,char_data/한/DSC03446.JPG_2.jpg,3807,480,640,47,63,110,212,293,False,86
한,36,kaist_dataset/Mixed/Digital_Camera/(C.S)C-outdoor4/DSC03531.JPG,char_data/한/DSC03531.JPG_2.jpg,1404,480,640,39,145,184,430,466,False,86
한,56,kaist_dataset/Mixed/Digital_Camera/(C.S)C-outdoor4/DSC03604.JPG,char_data/한/DSC03604.JPG_2.jpg,2912,480,640,52,67,119,257,313,False,86
한,63,kaist_dataset/Mixed/Digital_Camera/(C.S)C-outdoor4/DSC03620.JPG,char_data/한/DSC03620.JPG_2.jpg,5040,480,640,80,194,274,390,453,False,86
한,80,kaist_dataset/Mixed/Digital_Camera/(C.S)C-outdoor4/DSC03631.JPG,char_data/한/DSC03631.JPG_2.jpg,2480,480,640,31,76,107,173,253,False,86
한,57,kaist_dataset/Mixed/Digital_Camera/(C.S)C-outdoor4/DSC03662.JPG,char_data/한/DSC03662.JPG_2.jpg,1710,480,640,30,154,184,156,213,False,86
한,121,kaist_dataset/Mixed/Digital_Camera/(C.S)C-outdoor4/DSC03737.JPG,char_data/한/DSC03737.JPG_2.jpg,11737,480,640,97,268,365,37,158,False,86
한,56,kaist_dataset/Mixed/Digital_Camera/(C.S)C-outdoor5/DSC04094.JPG,char_data/한/DSC04094.JPG_2.jpg,3136,480,640,56,176,232,191,247,False,86
한,44,kaist_dataset/Mixed/Digital_Camera/(C.S)C-outdoor5/DSC04109.JPG,char_data/한/DSC04109.JPG_2.jpg,1496,480,640,34,51,85,149,193,False,86
한,42,kaist_dataset/Mixed/Digital_Camera/(C.S)C-outdoor5/DSC04115.JPG,char_data/한/DSC04115.JPG_2.jpg,1344,480,640,32,195,227,360,402,False,86
한,32,kaist_dataset/Mixed/Digital_Camera/(C.S)C-outdoor5/DSC04150.JPG,char_data/한/DSC04150.JPG_2.jpg,1504,480,640,47,20,67,296,328,False,86
한,151,kaist_dataset/Mixed/Digital_Camera/(C.S)C-outdoor5/DSC04401.JPG,char_data/한/DSC04401.JPG_2.jpg,14345,480,640,95,18,113,80,231,False,86
한,70,kaist_dataset/Mixed/Digital_Camera/(C.S)C-outdoor6/080116-0057.jpg,char_data/한/080116-0057.jpg_2.jpg,3570,1200,1600,51,981,1032,902,972,False,86
한,61,kaist_dataset/Mixed/Digital_Camera/(C.S)C-outdoor6/P1010020.JPG,char_data/한/P1010020.JPG_2.jpg,3782,480,640,62,156,218,171,232,False,86
한,67,kaist_dataset/Mixed/Digital_Camera/(C.S)C-outdoor6/P1010055.JPG,char_data/한/P1010055.JPG_2.jpg,4757,480,640,71,73,144,43,110,False,86
한,49,kaist_dataset/Mixed/Digital_Camera/(C.S)D-indoor1/DSC03125.JPG,char_data/한/DSC03125.JPG_2.jpg,2156,480,640,44,269,313,259,308,False,86
한,97,kaist_dataset/Mixed/Digital_Camera/(C.S)D-indoor1/DSC03472.JPG,char_data/한/DSC03472.JPG_2.jpg,8730,480,640,90,277,367,305,402,False,86
한,104,kaist_dataset/Mixed/Digital_Camera/(C.S)D-indoor1/DSC03980.JPG,char_data/한/DSC03980.JPG_2.jpg,9776,480,640,94,250,344,36,140,False,86
한,93,kaist_dataset/Mixed/Digital_Camera/(C.S)E-night/DSC03871.JPG,char_data/한/DSC03871.JPG_2.jpg,7626,480,640,82,119,201,81,174,False,86
한,37,kaist_dataset/Mixed/Digital_Camera/(C.S)F-others/047.jpg,char_data/한/047.jpg_5.jpg,1184,252,339,32,167,199,132,169,False,86
한,68,kaist_dataset/Mixed/Mobile_Phone/(C.M)A-outdoor/P090912040.jpg,char_data/한/P090912040.jpg_2.jpg,5304,480,640,78,241,319,126,194,False,86
시,42,kaist_dataset/English/Digital_Camera/(E.S)C-outdoor1/080119-0020.jpg,char_data/시/080119-0020.jpg_2.jpg,1554,1200,1600,37,1216,1253,646,688,True,70
시,80,kaist_dataset/Korean/Digital_Camera/A-shadow/DSC03792.JPG,char_data/시/DSC03792.JPG_2.jpg,4800,480,640,60,450,510,263,343,True,70
시,88,kaist_dataset/Korean/Digital_Camera/A-shadow/DSC03793.JPG,char_data/시/DSC03793.JPG_2.jpg,6600,480,640,75,305,380,162,250,True,70
시,73,kaist_dataset/Korean/Digital_Camera/A-shadow/DSC04311.JPG,char_data/시/DSC04311.JPG_2.jpg,3723,480,640,51,313,364,136,209,True,70
시,60,kaist_dataset/Korean/Digital_Camera/A-shadow/P090911038.jpg,char_data/시/P090911038.jpg_2.jpg,4320,480,640,72,164,236,142,202,True,70
시,67,kaist_dataset/Korean/Digital_Camera/E-night/DSC03032.JPG,char_data/시/DSC03032.JPG_2.jpg,3417,480,640,51,270,321,72,139,True,70
시,50,kaist_dataset/Korean/Digital_Camera/E-night/DSC03849.JPG,char_data/시/DSC03849.JPG_2.jpg,2600,480,640,52,212,264,369,419,True,70
시,69,kaist_dataset/Korean/Digital_Camera/E-night/사진14.jpg 수정.jpg,char_data/시/사진14.jpg 수정.jpg_2.jpg,6624,300,400,96,148,244,81,150,True,70
시,93,kaist_dataset/Korean/Digital_Camera/F-bookCover/DSC02807.JPG,char_data/시/DSC02807.JPG_2.jpg,8277,480,640,89,348,437,337,430,True,70
시,152,kaist_dataset/Korean/Digital_Camera/F-bookCover/DSC02838.JPG,char_data/시/DSC02838.JPG_2.jpg,20064,480,640,132,15,147,30,182,True,70
시,75,kaist_dataset/Korean/Digital_Camera/F-bookCover/DSC03934.JPG,char_data/시/DSC03934.JPG_2.jpg,5100,480,640,68,333,401,29,104,True,70
시,33,kaist_dataset/Korean/Digital_Camera/indoor1/057.jpg,char_data/시/057.jpg_2.jpg,825,322,425,25,226,251,240,273,True,70
시,70,kaist_dataset/Korean/Digital_Camera/indoor1/DSC02706.JPG,char_data/시/DSC02706.JPG_2.jpg,4060,480,640,58,328,386,223,293,True,70
시,201,kaist_dataset/Korean/Digital_Camera/indoor1/DSC02740.JPG,char_data/시/DSC02740.JPG_4.jpg,32361,480,640,161,2,163,151,352,True,70
시,45,kaist_dataset/Korean/Digital_Camera/indoor1/DSC02740.JPG,char_data/시/DSC02740.JPG_5.jpg,2250,480,640,50,98,148,92,137,True,70
시,83,kaist_dataset/Korean/Digital_Camera/indoor1/DSC03089.JPG,char_data/시/DSC03089.JPG_2.jpg,5810,480,640,70,400,470,333,416,True,70
시,80,kaist_dataset/Korean/Digital_Camera/indoor1/DSC03361.JPG,char_data/시/DSC03361.JPG_2.jpg,5200,480,640,65,170,235,169,249,True,70
시,85,kaist_dataset/Korean/Digital_Camera/indoor1/DSC03378.JPG,char_data/시/DSC03378.JPG_2.jpg,5355,480,640,63,76,139,117,202,True,70
시,61,kaist_dataset/Korean/Digital_Camera/indoor2/DSC03394.JPG,char_data/시/DSC03394.JPG_2.jpg,2806,480,640,46,335,381,386,447,True,70
시,65,kaist_dataset/Korean/Digital_Camera/indoor2/DSC03481.JPG,char_data/시/DSC03481.JPG_2.jpg,3445,480,640,53,468,521,28,93,True,70
시,56,kaist_dataset/Korean/Digital_Camera/indoor2/DSC03484.JPG,char_data/시/DSC03484.JPG_2.jpg,2128,480,640,38,350,388,120,176,True,70
시,48,kaist_dataset/Korean/Digital_Camera/indoor2/DSC03564.JPG,char_data/시/DSC03564.JPG_2.jpg,2688,480,640,56,533,589,162,210,True,70
시,56,kaist_dataset/Korean/Digital_Camera/indoor2/DSC03974.JPG,char_data/시/DSC03974.JPG_2.jpg,2632,480,640,47,496,543,203,259,True,70
시,95,kaist_dataset/Korean/Digital_Camera/indoor2/DSC04006.JPG,char_data/시/DSC04006.JPG_2.jpg,4275,480,640,45,187,232,15,110,True,70
시,84,kaist_dataset/Korean/Digital_Camera/indoor2/DSC04179.JPG,char_data/시/DSC04179.JPG_2.jpg,4872,480,640,58,399,457,137,221,True,70
시,76,kaist_dataset/Korean/Digital_Camera/indoor2/DSC04423.JPG,char_data/시/DSC04423.JPG_2.jpg,5396,480,640,71,289,360,230,306,True,70
시,90,kaist_dataset/Korean/Digital_Camera/outdoor1/004.JPG,char_data/시/004.JPG_2.jpg,6750,480,640,75,57,132,153,243,True,70
시,58,kaist_dataset/Korean/Digital_Camera/outdoor1/007.JPG,char_data/시/007.JPG_6.jpg,2958,480,640,51,478,529,396,454,True,70
시,69,kaist_dataset/Korean/Digital_Camera/outdoor1/007.JPG,char_data/시/007.JPG_7.jpg,7590,480,640,110,268,378,184,253,True,70
시,60,kaist_dataset/Korean/Digital_Camera/outdoor1/007.JPG,char_data/시/007.JPG_8.jpg,3300,480,640,55,27,82,399,459,True,70
시,68,kaist_dataset/Korean/Digital_Camera/outdoor1/126.JPG,char_data/시/126.JPG_2.jpg,6052,480,640,89,49,138,188,256,True,70
시,66,kaist_dataset/Korean/Digital_Camera/outdoor1/2007-12-08-day-050.jpg,char_data/시/2007-12-08-day-050.jpg_2.jpg,3630,1200,1600,55,819,874,925,991,True,70
시,40,kaist_dataset/Korean/Digital_Camera/outdoor1/39.jpg,char_data/시/39.jpg_2.jpg,1280,197,320,32,125,157,115,155,True,70
시,43,kaist_dataset/Korean/Digital_Camera/outdoor2/2007-12-09-day-exterior-035.jpg,char_data/시/2007-12-09-day-exterior-035.jpg_4.jpg,1505,1200,1600,35,1063,1098,725,768,True,70
시,45,kaist_dataset/Korean/Digital_Camera/outdoor2/2007-12-09-day-exterior-035.jpg,char_data/시/2007-12-09-day-exterior-035.jpg_5.jpg,1620,1200,1600,36,1263,1299,724,769,True,70
시,34,kaist_dataset/Korean/Digital_Camera/outdoor2/DSC02326.JPG,char_data/시/DSC02326.JPG_2.jpg,1020,480,640,30,59,89,324,358,True,70
시,103,kaist_dataset/Korean/Digital_Camera/outdoor2/DSC02486.JPG,char_data/시/DSC02486.JPG_2.jpg,6386,480,640,62,318,380,118,221,True,70
시,104,kaist_dataset/Korean/Digital_Camera/outdoor2/DSC02523.JPG,char_data/시/DSC02523.JPG_2.jpg,14040,480,640,135,227,362,227,331,True,70
시,106,kaist_dataset/Korean/Digital_Camera/outdoor3/DSC02541.JPG,char_data/시/DSC02541.JPG_2.jpg,7632,480,640,72,123,195,279,385,True,70
시,56,kaist_dataset/Korean/Digital_Camera/outdoor3/DSC02546.JPG,char_data/시/DSC02546.JPG_16.jpg,2856,480,640,51,298,349,20,76,True,70
시,55,kaist_dataset/Korean/Digital_Camera/outdoor3/DSC02546.JPG,char_data/시/DSC02546.JPG_17.jpg,1925,480,640,35,252,287,121,176,True,70
시,42,kaist_dataset/Korean/Digital_Camera/outdoor3/DSC02546.JPG,char_data/시/DSC02546.JPG_18.jpg,2016,480,640,48,410,458,126,168,True,70
시,50,kaist_dataset/Korean/Digital_Camera/outdoor3/DSC02546.JPG,char_data/시/DSC02546.JPG_19.jpg,2200,480,640,44,243,287,233,283,True,70
시,49,kaist_dataset/Korean/Digital_Camera/outdoor3/DSC02546.JPG,char_data/시/DSC02546.JPG_20.jpg,2254,480,640,46,420,466,236,285,True,70
시,55,kaist_dataset/Korean/Digital_Camera/outdoor3/DSC02546.JPG,char_data/시/DSC02546.JPG_21.jpg,2420,480,640,44,246,290,360,415,True,70
시,57,kaist_dataset/Korean/Digital_Camera/outdoor3/DSC02546.JPG,char_data/시/DSC02546.JPG_22.jpg,2565,480,640,45,474,519,356,413,True,70
시,40,kaist_dataset/Korean/Digital_Camera/outdoor3/DSC02546.JPG,char_data/시/DSC02546.JPG_23.jpg,1000,480,640,25,127,152,421,461,True,70
시,48,kaist_dataset/Korean/Digital_Camera/outdoor3/DSC02686.JPG,char_data/시/DSC02686.JPG_4.jpg,1968,480,640,41,167,208,52,100,True,70
시,49,kaist_dataset/Korean/Digital_Camera/outdoor3/DSC02686.JPG,char_data/시/DSC02686.JPG_5.jpg,1813,480,640,37,275,312,50,99,True,70
시,145,kaist_dataset/Korean/Digital_Camera/outdoor3/DSC02900.JPG,char_data/시/DSC02900.JPG_2.jpg,15515,480,640,107,123,230,192,337,True,70
시,86,kaist_dataset/Korean/Digital_Camera/outdoor3/DSC02931.JPG,char_data/시/DSC02931.JPG_2.jpg,5934,480,640,69,295,364,43,129,True,70
시,96,kaist_dataset/Korean/Digital_Camera/outdoor3/DSC02972.JPG,char_data/시/DSC02972.JPG_2.jpg,12192,480,640,127,148,275,115,211,True,70
시,87,kaist_dataset/Korean/Digital_Camera/outdoor3/DSC02991.JPG,char_data/시/DSC02991.JPG_2.jpg,9831,480,640,113,427,540,187,274,True,70
시,48,kaist_dataset/Korean/Digital_Camera/outdoor3/DSC02994.JPG,char_data/시/DSC02994.JPG_2.jpg,2064,480,640,43,117,160,61,109,True,70
시,80,kaist_dataset/Korean/Digital_Camera/outdoor3/DSC03181.JPG,char_data/시/DSC03181.JPG_2.jpg,3360,480,640,42,107,149,248,328,True,70
시,54,kaist_dataset/Korean/Digital_Camera/outdoor3/DSC03183.JPG,char_data/시/DSC03183.JPG_2.jpg,1890,480,640,35,331,366,77,131,True,70
시,45,kaist_dataset/Korean/Digital_Camera/outdoor4/DSC03416.JPG,char_data/시/DSC03416.JPG_2.jpg,1125,480,640,25,90,115,286,331,True,70
시,52,kaist_dataset/Korean/Digital_Camera/outdoor4/DSC03419.JPG,char_data/시/DSC03419.JPG_2.jpg,2548,480,640,49,229,278,212,264,True,70
시,137,kaist_dataset/Korean/Digital_Camera/outdoor4/DSC03420.JPG,char_data/시/DSC03420.JPG_2.jpg,17947,480,640,131,351,482,202,339,True,70
시,70,kaist_dataset/Korean/Digital_Camera/outdoor4/DSC03449.JPG,char_data/시/DSC03449.JPG_2.jpg,2730,480,640,39,354,393,295,365,True,70
시,56,kaist_dataset/Korean/Digital_Camera/outdoor4/DSC03505.JPG,char_data/시/DSC03505.JPG_2.jpg,2912,480,640,52,412,464,237,293,True,70
시,49,kaist_dataset/Korean/Digital_Camera/outdoor4/DSC03578.JPG,char_data/시/DSC03578.JPG_2.jpg,1960,480,640,40,314,354,229,278,True,70
시,73,kaist_dataset/Korean/Digital_Camera/outdoor4/DSC03583.JPG,char_data/시/DSC03583.JPG_2.jpg,4453,480,640,61,342,403,259,332,True,70
시,42,kaist_dataset/Korean/Digital_Camera/outdoor4/DSC03588.JPG,char_data/시/DSC03588.JPG_4.jpg,1680,480,640,40,221,261,49,91,True,70
시,51,kaist_dataset/Korean/Digital_Camera/outdoor4/DSC03588.JPG,char_data/시/DSC03588.JPG_5.jpg,2193,480,640,43,346,389,161,212,True,70
시,59,kaist_dataset/Korean/Digital_Camera/outdoor5/DSC03690.JPG,char_data/시/DSC03690.JPG_2.jpg,3186,480,640,54,317,371,177,236,True,70
시,58,kaist_dataset/Korean/Digital_Camera/outdoor5/DSC03713.JPG,char_data/시/DSC03713.JPG_4.jpg,2378,480,640,41,374,415,335,393,True,70
시,63,kaist_dataset/Korean/Digital_Camera/outdoor5/DSC03713.JPG,char_data/시/DSC03713.JPG_5.jpg,2205,480,640,35,263,298,396,459,True,70
시,38,kaist_dataset/Korean/Digital_Camera/outdoor5/DSC03834.JPG,char_data/시/DSC03834.JPG_2.jpg,1444,480,640,38,185,223,301,339,True,70
시,109,kaist_dataset/Korean/Digital_Camera/outdoor5/DSC03857.JPG,char_data/시/DSC03857.JPG_2.jpg,8502,480,640,78,214,292,286,395,True,70
시,119,kaist_dataset/Korean/Digital_Camera/outdoor5/DSC03868.JPG,char_data/시/DSC03868.JPG_2.jpg,10115,480,640,85,384,469,353,472,True,70
시,53,kaist_dataset/Korean/Digital_Camera/outdoor6/DSC04044.JPG,char_data/시/DSC04044.JPG_2.jpg,2650,480,640,50,107,157,419,472,True,70
시,70,kaist_dataset/Korean/Digital_Camera/outdoor6/DSC04045.JPG,char_data/시/DSC04045.JPG_2.jpg,3920,480,640,56,183,239,102,172,True,70
시,64,kaist_dataset/Korean/Digital_Camera/outdoor6/DSC04074.JPG,char_data/시/DSC04074.JPG_2.jpg,3392,480,640,53,227,280,23,87,True,70
시,97,kaist_dataset/Korean/Digital_Camera/outdoor6/DSC04081.JPG,char_data/시/DSC04081.JPG_2.jpg,8536,480,640,88,426,514,205,302,True,70
시,98,kaist_dataset/Korean/Digital_Camera/outdoor6/DSC04082.JPG,char_data/시/DSC04082.JPG_2.jpg,6958,480,640,71,428,499,102,200,True,70
시,77,kaist_dataset/Korean/Digital_Camera/outdoor6/DSC04085.JPG,char_data/시/DSC04085.JPG_2.jpg,5390,480,640,70,285,355,249,326,True,70
시,96,kaist_dataset/Korean/Digital_Camera/outdoor6/DSC04090.JPG,char_data/시/DSC04090.JPG_2.jpg,10080,480,640,105,343,448,73,169,True,70
시,65,kaist_dataset/Korean/Digital_Camera/outdoor6/DSC04123.JPG,char_data/시/DSC04123.JPG_2.jpg,3575,480,640,55,37,92,260,325,True,70
시,55,kaist_dataset/Korean/Digital_Camera/outdoor6/DSC04148.JPG,char_data/시/DSC04148.JPG_10.jpg,3355,480,640,61,334,395,114,169,True,70
시,48,kaist_dataset/Korean/Digital_Camera/outdoor6/DSC04148.JPG,char_data/시/DSC04148.JPG_11.jpg,1968,480,640,41,434,475,200,248,True,70
시,47,kaist_dataset/Korean/Digital_Camera/outdoor6/DSC04148.JPG,char_data/시/DSC04148.JPG_12.jpg,1316,480,640,28,418,446,251,298,True,70
시,53,kaist_dataset/Korean/Digital_Camera/outdoor6/DSC04148.JPG,char_data/시/DSC04148.JPG_13.jpg,1908,480,640,36,471,507,305,358,True,70
시,45,kaist_dataset/Korean/Digital_Camera/outdoor6/DSC04148.JPG,char_data/시/DSC04148.JPG_14.jpg,1710,480,640,38,471,509,409,454,True,70
시,63,kaist_dataset/Korean/Digital_Camera/outdoor6/DSC04152.JPG,char_data/시/DSC04152.JPG_2.jpg,3465,480,640,55,123,178,98,161,True,70
시,85,kaist_dataset/Korean/Digital_Camera/outdoor6/DSC04400.JPG,char_data/시/DSC04400.JPG_2.jpg,7225,480,640,85,315,400,136,221,True,70
시,110,kaist_dataset/Korean/Digital_Camera/outdoor6/DSC04407.JPG,char_data/시/DSC04407.JPG_2.jpg,11000,480,640,100,336,436,85,195,True,70
시,77,kaist_dataset/Korean/Digital_Camera/outdoor7/DSC04454.JPG,char_data/시/DSC04454.JPG_2.jpg,3850,480,640,50,195,245,392,469,True,70
시,90,kaist_dataset/Korean/Digital_Camera/outdoor7/DSC04455.JPG,char_data/시/DSC04455.JPG_2.jpg,7920,480,640,88,11,99,206,296,True,70
시,155,kaist_dataset/Korean/Digital_Camera/outdoor7/DSC04470.JPG,char_data/시/DSC04470.JPG_2.jpg,13020,480,640,84,253,337,139,294,True,70
시,82,kaist_dataset/Korean/Digital_Camera/outdoor7/P1010013.JPG,char_data/시/P1010013.JPG_2.jpg,4018,480,640,49,454,503,104,186,True,70
시,105,kaist_dataset/Korean/Digital_Camera/outdoor8/P1011112.JPG,char_data/시/P1011112.JPG_4.jpg,7455,480,640,71,553,624,116,221,True,70
시,41,kaist_dataset/Korean/Digital_Camera/outdoor8/P1011112.JPG,char_data/시/P1011112.JPG_5.jpg,861,480,640,21,133,154,196,237,True,70
시,92,"kaist_dataset/Korean/Mobile_Phone/(M,K)D-indoor/P090912028.jpg",char_data/시/P090912028.jpg_2.jpg,11592,480,640,126,349,475,193,285,True,70
시,107,"kaist_dataset/Korean/Mobile_Phone/(M,K)E-bookCover/P090831069.jpg",char_data/시/P090831069.jpg_2.jpg,10914,480,640,102,287,389,170,277,True,70
시,140,"kaist_dataset/Korean/Mobile_Phone/(M,K)E-bookCover/P090831140.jpg",char_data/시/P090831140.jpg_2.jpg,21280,480,640,152,334,486,128,268,True,70
시,73,"kaist_dataset/Korean/Mobile_Phone/(M,K)E-bookCover/P090831154.jpg",char_data/시/P090831154.jpg_2.jpg,5621,480,640,77,22,99,59,132,True,70
시,88,"kaist_dataset/Korean/Mobile_Phone/(M,K)E-bookCover/P090831155.jpg",char_data/시/P090831155.jpg_2.jpg,6336,480,640,72,399,471,185,273,True,70
시,107,"kaist_dataset/Korean/Mobile_Phone/(M,K)E-bookCover/P090903025.jpg",char_data/시/P090903025.jpg_2.jpg,8453,480,640,79,219,298,63,170,True,70
시,66,"kaist_dataset/Korean/Mobile_Phone/(M,K)E-bookCover/P090903026.jpg",char_data/시/P090903026.jpg_2.jpg,3498,480,640,53,316,369,102,168,True,70
시,56,"kaist_dataset/Korean/Mobile_Phone/(M,K)E-bookCover/P090903057.jpg",char_data/시/P090903057.jpg_2.jpg,2688,480,640,48,387,435,47,103,True,70
시,108,"kaist_dataset/Korean/Mobile_Phone/(M,K)E-bookCover/P090903090.jpg",char_data/시/P090903090.jpg_2.jpg,9288,480,640,86,206,292,186,294,True,70
시,80,"kaist_dataset/Korean/Mobile_Phone/(M,K)E-bookCover/P090903098.jpg",char_data/시/P090903098.jpg_2.jpg,6480,480,640,81,3,84,169,249,True,70
시,68,"kaist_dataset/Korean/Mobile_Phone/(M,K)E-bookCover/P090912006.jpg",char_data/시/P090912006.jpg_2.jpg,4080,480,640,60,61,121,3,71,True,70
시,62,kaist_dataset/Mixed/Digital_Camera/(C.S)A-shadow/P090912075.jpg,char_data/시/P090912075.jpg_2.jpg,4402,480,640,71,443,514,64,126,True,70
시,50,kaist_dataset/Mixed/Digital_Camera/(C.S)C-outdoor1/025.JPG,char_data/시/025.JPG_2.jpg,1700,480,640,34,247,281,75,125,True,70
시,235,kaist_dataset/Mixed/Digital_Camera/(C.S)C-outdoor1/080118-0007.jpg,char_data/시/080118-0007.jpg_2.jpg,42065,1200,1600,179,412,591,776,1011,True,70
시,120,kaist_dataset/Mixed/Digital_Camera/(C.S)C-outdoor1/080119-0033.jpg,char_data/시/080119-0033.jpg_2.jpg,12720,1200,1600,106,595,701,147,267,True,70
시,47,kaist_dataset/Mixed/Digital_Camera/(C.S)C-outdoor1/1.JPG,char_data/시/1.JPG_2.jpg,1645,576,768,35,591,626,460,507,True,70
시,50,kaist_dataset/Mixed/Digital_Camera/(C.S)C-outdoor1/133.JPG,char_data/시/133.JPG_2.jpg,2250,480,640,45,64,109,219,269,True,70
시,50,kaist_dataset/Mixed/Digital_Camera/(C.S)C-outdoor1/2007-12-09-day-exterior-037.jpg,char_data/시/2007-12-09-day-exterior-037.jpg_4.jpg,1150,1200,1600,23,655,678,1064,1114,True,70
시,73,kaist_dataset/Mixed/Digital_Camera/(C.S)C-outdoor1/2007-12-09-day-exterior-037.jpg,char_data/시/2007-12-09-day-exterior-037.jpg_5.jpg,4380,1200,1600,60,497,557,618,691,True,70
시,135,kaist_dataset/Mixed/Digital_Camera/(C.S)C-outdoor1/47.JPG,char_data/시/47.JPG_2.jpg,10665,576,768,79,196,275,258,393,True,70
시,116,kaist_dataset/Mixed/Digital_Camera/(C.S)C-outdoor1/DSC02244.JPG,char_data/시/DSC02244.JPG_2.jpg,13340,480,640,115,417,532,115,231,True,70
시,72,kaist_dataset/Mixed/Digital_Camera/(C.S)C-outdoor2/DSC02407.JPG,char_data/시/DSC02407.JPG_2.jpg,5184,480,640,72,160,232,77,149,True,70
시,43,kaist_dataset/Mixed/Digital_Camera/(C.S)C-outdoor2/DSC02425.JPG,char_data/시/DSC02425.JPG_2.jpg,1505,480,640,35,542,577,103,146,True,70
시,109,kaist_dataset/Mixed/Digital_Camera/(C.S)C-outdoor2/DSC02430.JPG,char_data/시/DSC02430.JPG_6.jpg,14279,480,640,131,183,314,55,164,True,70
시,34,kaist_dataset/Mixed/Digital_Camera/(C.S)C-outdoor2/DSC02430.JPG,char_data/시/DSC02430.JPG_7.jpg,986,480,640,29,265,294,179,213,True,70
시,39,kaist_dataset/Mixed/Digital_Camera/(C.S)C-outdoor2/DSC02430.JPG,char_data/시/DSC02430.JPG_8.jpg,936,480,640,24,527,551,309,348,True,70
시,42,kaist_dataset/Mixed/Digital_Camera/(C.S)C-outdoor2/DSC02434.JPG,char_data/시/DSC02434.JPG_2.jpg,1764,480,640,42,390,432,105,147,True,70
시,83,kaist_dataset/Mixed/Digital_Camera/(C.S)C-outdoor2/DSC02527.JPG,char_data/시/DSC02527.JPG_2.jpg,4648,480,640,56,270,326,134,217,True,70
시,41,kaist_dataset/Mixed/Digital_Camera/(C.S)C-outdoor2/DSC02954.JPG,char_data/시/DSC02954.JPG_2.jpg,1476,480,640,36,91,127,91,132,True,70
시,58,kaist_dataset/Mixed/Digital_Camera/(C.S)C-outdoor3/DSC02964.JPG,char_data/시/DSC02964.JPG_2.jpg,3074,480,640,53,13,66,71,129,False,70
시,44,kaist_dataset/Mixed/Digital_Camera/(C.S)C-outdoor3/DSC02969.JPG,char_data/시/DSC02969.JPG_2.jpg,1276,480,640,29,386,415,20,64,False,70
시,90,kaist_dataset/Mixed/Digital_Camera/(C.S)C-outdoor3/DSC03062.JPG,char_data/시/DSC03062.JPG_2.jpg,6750,480,640,75,337,412,142,232,False,70
시,52,kaist_dataset/Mixed/Digital_Camera/(C.S)C-outdoor3/DSC03190.JPG,char_data/시/DSC03190.JPG_2.jpg,1976,480,640,38,546,584,325,377,False,70
시,54,kaist_dataset/Mixed/Digital_Camera/(C.S)C-outdoor3/DSC03199.JPG,char_data/시/DSC03199.JPG_2.jpg,2160,480,640,40,384,424,383,437,False,70
시,39,kaist_dataset/Mixed/Digital_Camera/(C.S)C-outdoor3/DSC03236.JPG,char_data/시/DSC03236.JPG_2.jpg,1326,480,640,34,106,140,188,227,False,70
시,75,kaist_dataset/Mixed/Digital_Camera/(C.S)C-outdoor3/DSC03245.JPG,char_data/시/DSC03245.JPG_2.jpg,5700,480,640,76,327,403,363,438,False,70
시,51,kaist_dataset/Mixed/Digital_Camera/(C.S)C-outdoor4/DSC03556.JPG,char_data/시/DSC03556.JPG_2.jpg,1989,480,640,39,183,222,253,304,False,70
시,56,kaist_dataset/Mixed/Digital_Camera/(C.S)C-outdoor4/DSC03678.JPG,char_data/시/DSC03678.JPG_4.jpg,2016,480,640,36,241,277,233,289,False,70
시,58,kaist_dataset/Mixed/Digital_Camera/(C.S)C-outdoor4/DSC03678.JPG,char_data/시/DSC03678.JPG_5.jpg,2320,480,640,40,540,580,236,294,False,70
시,97,kaist_dataset/Mixed/Digital_Camera/(C.S)C-outdoor4/DSC03758.JPG,char_data/시/DSC03758.JPG_2.jpg,9603,480,640,99,164,263,102,199,False,70
시,67,kaist_dataset/Mixed/Digital_Camera/(C.S)C-outdoor4/DSC03764.JPG,char_data/시/DSC03764.JPG_2.jpg,7437,480,640,111,164,275,44,111,False,70
시,41,kaist_dataset/Mixed/Digital_Camera/(C.S)C-outdoor5/DSC03839.JPG,char_data/시/DSC03839.JPG_4.jpg,1230,480,640,30,245,275,403,444,False,70
시,42,kaist_dataset/Mixed/Digital_Camera/(C.S)C-outdoor5/DSC03839.JPG,char_data/시/DSC03839.JPG_5.jpg,1470,480,640,35,337,372,148,190,False,70
시,51,kaist_dataset/Mixed/Digital_Camera/(C.S)C-outdoor5/DSC04014.JPG,char_data/시/DSC04014.JPG_2.jpg,2499,480,640,49,344,393,242,293,False,70
시,48,kaist_dataset/Mixed/Digital_Camera/(C.S)C-outdoor5/DSC04063.JPG,char_data/시/DSC04063.JPG_2.jpg,960,480,640,20,508,528,298,346,False,70
시,66,kaist_dataset/Mixed/Digital_Camera/(C.S)C-outdoor5/DSC04065.JPG,char_data/시/DSC04065.JPG_2.jpg,3696,480,640,56,247,303,119,185,False,70
시,69,kaist_dataset/Mixed/Digital_Camera/(C.S)C-outdoor5/DSC04091.JPG,char_data/시/DSC04091.JPG_2.jpg,3381,480,640,49,401,450,326,395,False,70
시,136,kaist_dataset/Mixed/Digital_Camera/(C.S)C-outdoor5/DSC04330.JPG,char_data/시/DSC04330.JPG_2.jpg,9520,480,640,70,166,236,235,371,False,70
시,58,kaist_dataset/Mixed/Digital_Camera/(C.S)C-outdoor5/DSC04395.JPG,char_data/시/DSC04395.JPG_2.jpg,2436,480,640,42,499,541,280,338,False,70
시,70,kaist_dataset/Mixed/Digital_Camera/(C.S)C-outdoor5/DSC04401.JPG,char_data/시/DSC04401.JPG_2.jpg,4060,480,640,58,358,416,19,89,False,70
시,48,kaist_dataset/Mixed/Digital_Camera/(C.S)C-outdoor6/크기변환_P1010029.JPG,char_data/시/크기변환_P1010029.JPG_2.jpg,1776,480,640,37,390,427,337,385,False,70
시,78,kaist_dataset/Mixed/Digital_Camera/(C.S)D-indoor1/DSC03466.JPG,char_data/시/DSC03466.JPG_4.jpg,6162,480,640,79,256,335,13,91,False,70
시,86,kaist_dataset/Mixed/Digital_Camera/(C.S)D-indoor1/DSC03466.JPG,char_data/시/DSC03466.JPG_5.jpg,9030,480,640,105,193,298,132,218,False,70
시,64,kaist_dataset/Mixed/Digital_Camera/(C.S)D-indoor1/DSC03469.JPG,char_data/시/DSC03469.JPG_2.jpg,3200,480,640,50,387,437,245,309,False,70
시,67,kaist_dataset/Mixed/Digital_Camera/(C.S)D-indoor1/DSC03483.JPG,char_data/시/DSC03483.JPG_2.jpg,3484,480,640,52,337,389,196,263,False,70
시,45,kaist_dataset/Mixed/Digital_Camera/(C.S)D-indoor1/DSC03909.JPG,char_data/시/DSC03909.JPG_2.jpg,1035,480,640,23,321,344,300,345,False,70
시,35,kaist_dataset/Mixed/Digital_Camera/(C.S)D-indoor1/DSC03925.JPG,char_data/시/DSC03925.JPG_2.jpg,840,480,640,24,276,300,345,380,False,70
시,48,kaist_dataset/Mixed/Digital_Camera/(C.S)F-others/58.JPG,char_data/시/58.JPG_2.jpg,1296,764,499,27,161,188,597,645,False,70
시,198,kaist_dataset/Mixed/Mobile_Phone/(C.M)C-bookCover/P090831122.jpg,char_data/시/P090831122.jpg_2.jpg,39600,480,640,200,141,341,32,230,False,70
시,39,kaist_dataset/Mixed/Mobile_Phone/(C.M)C-bookCover/P090904005.jpg,char_data/시/P090904005.jpg_2.jpg,1521,480,640,39,566,605,398,437,False,70
아,35,kaist_dataset/English/Digital_Camera/(E.S)B-light/080116-0059.jpg,char_data/아/080116-0059.jpg_4.jpg,700,1200,1600,20,1087,1107,938,973,True,71
아,31,kaist_dataset/English/Digital_Camera/(E.S)B-light/080116-0059.jpg,char_data/아/080116-0059.jpg_5.jpg,775,1200,1600,25,539,564,1083,1114,True,71
아,37,kaist_dataset/English/Digital_Camera/(E.S)C-outdoor1/034.JPG,char_data/아/034.JPG_2.jpg,1184,480,640,32,499,531,117,154,True,71
아,107,kaist_dataset/Korean/Digital_Camera/A-shadow/DSC02688.JPG,char_data/아/DSC02688.JPG_2.jpg,12947,480,640,121,469,590,242,349,True,71
아,69,kaist_dataset/Korean/Digital_Camera/E-night/DSC02608.JPG,char_data/아/DSC02608.JPG_4.jpg,3588,480,640,52,2,54,353,422,True,71
아,67,kaist_dataset/Korean/Digital_Camera/E-night/DSC02608.JPG,char_data/아/DSC02608.JPG_5.jpg,3685,480,640,55,84,139,245,312,True,71
아,122,kaist_dataset/Korean/Digital_Camera/E-night/DSC02621.JPG,char_data/아/DSC02621.JPG_4.jpg,22692,480,640,186,16,202,271,393,True,71
아,148,kaist_dataset/Korean/Digital_Camera/E-night/DSC02621.JPG,char_data/아/DSC02621.JPG_5.jpg,32264,480,640,218,420,638,244,392,True,71
아,49,kaist_dataset/Korean/Digital_Camera/E-night/DSC03022.JPG,char_data/아/DSC03022.JPG_2.jpg,4214,480,640,86,219,305,187,236,True,71
아,71,kaist_dataset/Korean/Digital_Camera/E-night/DSC03032.JPG,char_data/아/DSC03032.JPG_2.jpg,3621,480,640,51,369,420,66,137,True,71
아,97,kaist_dataset/Korean/Digital_Camera/F-bookCover/DSC02806.JPG,char_data/아/DSC02806.JPG_4.jpg,11058,480,640,114,156,270,62,159,True,71
아,52,kaist_dataset/Korean/Digital_Camera/F-bookCover/DSC02806.JPG,char_data/아/DSC02806.JPG_5.jpg,2184,480,640,42,405,447,220,272,True,71
아,74,kaist_dataset/Korean/Digital_Camera/F-bookCover/DSC04227.JPG,char_data/아/DSC04227.JPG_2.jpg,3774,480,640,51,481,532,60,134,True,71
아,178,kaist_dataset/Korean/Digital_Camera/F-bookCover/P090911030.jpg,char_data/아/P090911030.jpg_2.jpg,24386,480,640,137,53,190,284,462,True,71
아,164,kaist_dataset/Korean/Digital_Camera/F-bookCover/P090911047.jpg,char_data/아/P090911047.jpg_2.jpg,23288,480,640,142,146,288,239,403,True,71
아,96,kaist_dataset/Korean/Digital_Camera/indoor1/2007-12-08-day-139.jpg,char_data/아/2007-12-08-day-139.jpg_2.jpg,9504,1200,1600,99,754,853,634,730,True,71
아,35,kaist_dataset/Korean/Digital_Camera/indoor1/DSC02742.JPG,char_data/아/DSC02742.JPG_2.jpg,875,480,640,25,310,335,200,235,True,71
아,88,kaist_dataset/Korean/Digital_Camera/indoor1/DSC02759.JPG,char_data/아/DSC02759.JPG_2.jpg,12584,480,640,143,39,182,181,269,True,71
아,80,kaist_dataset/Korean/Digital_Camera/indoor1/DSC02760.JPG,char_data/아/DSC02760.JPG_2.jpg,8160,480,640,102,55,157,210,290,True,71
아,83,kaist_dataset/Korean/Digital_Camera/indoor1/DSC02765.JPG,char_data/아/DSC02765.JPG_2.jpg,7885,480,640,95,472,567,193,276,True,71
아,137,kaist_dataset/Korean/Digital_Camera/indoor1/DSC02768.JPG,char_data/아/DSC02768.JPG_2.jpg,13015,480,640,95,13,108,140,277,True,71
아,119,kaist_dataset/Korean/Digital_Camera/indoor1/DSC03351.JPG,char_data/아/DSC03351.JPG_2.jpg,12376,480,640,104,194,298,147,266,True,71
아,47,kaist_dataset/Korean/Digital_Camera/indoor1/DSC03364.JPG,char_data/아/DSC03364.JPG_2.jpg,1269,480,640,27,293,320,166,213,True,71
아,108,kaist_dataset/Korean/Digital_Camera/indoor2/DSC03476.JPG,char_data/아/DSC03476.JPG_2.jpg,11232,480,640,104,206,310,108,216,True,71
아,59,kaist_dataset/Korean/Digital_Camera/indoor2/DSC03974.JPG,char_data/아/DSC03974.JPG_2.jpg,2950,480,640,50,176,226,204,263,True,71
아,71,kaist_dataset/Korean/Digital_Camera/indoor2/DSC03985.JPG,char_data/아/DSC03985.JPG_2.jpg,3550,480,640,50,387,437,252,323,True,71
아,70,kaist_dataset/Korean/Digital_Camera/outdoor1/024.JPG,char_data/아/024.JPG_2.jpg,6580,480,640,94,275,369,186,256,True,71
아,83,kaist_dataset/Korean/Digital_Camera/outdoor1/029.JPG,char_data/아/029.JPG_2.jpg,5810,480,640,70,199,269,202,285,True,71
아,223,kaist_dataset/Korean/Digital_Camera/outdoor1/2007-12-08-day-047.jpg,char_data/아/2007-12-08-day-047.jpg_14.jpg,43931,1200,1600,197,830,1027,472,695,True,71
아,49,kaist_dataset/Korean/Digital_Camera/outdoor1/2007-12-08-day-047.jpg,char_data/아/2007-12-08-day-047.jpg_15.jpg,1960,1200,1600,40,178,218,1051,1100,True,71
아,26,kaist_dataset/Korean/Digital_Camera/outdoor1/2007-12-08-day-047.jpg,char_data/아/2007-12-08-day-047.jpg_16.jpg,910,1200,1600,35,499,534,920,946,True,71
아,65,kaist_dataset/Korean/Digital_Camera/outdoor1/2007-12-08-day-047.jpg,char_data/아/2007-12-08-day-047.jpg_17.jpg,2665,1200,1600,41,346,387,1031,1096,True,71
아,66,kaist_dataset/Korean/Digital_Camera/outdoor1/2007-12-08-day-047.jpg,char_data/아/2007-12-08-day-047.jpg_18.jpg,2508,1200,1600,38,480,518,1030,1096,True,71
아,72,kaist_dataset/Korean/Digital_Camera/outdoor1/2007-12-08-day-047.jpg,char_data/아/2007-12-08-day-047.jpg_19.jpg,2376,1200,1600,33,1017,1050,1004,1076,True,71
아,44,kaist_dataset/Korean/Digital_Camera/outdoor1/2007-12-08-day-047.jpg,char_data/아/2007-12-08-day-047.jpg_20.jpg,1232,1200,1600,28,1374,1402,1014,1058,True,71
아,40,kaist_dataset/Korean/Digital_Camera/outdoor1/39.jpg,char_data/아/39.jpg_2.jpg,920,197,320,23,253,276,123,163,True,71
아,97,kaist_dataset/Korean/Digital_Camera/outdoor1/53.JPG,char_data/아/53.JPG_2.jpg,8148,401,766,84,415,499,57,154,True,71
아,308,kaist_dataset/Korean/Digital_Camera/outdoor2/2007-12-09-day-exterior-036.jpg,char_data/아/2007-12-09-day-exterior-036.jpg_4.jpg,80388,1200,1600,261,767,1028,414,722,True,71
아,61,kaist_dataset/Korean/Digital_Camera/outdoor2/2007-12-09-day-exterior-036.jpg,char_data/아/2007-12-09-day-exterior-036.jpg_5.jpg,2867,1200,1600,47,1509,1556,1098,1159,True,71
아,70,kaist_dataset/Korean/Digital_Camera/outdoor2/DSC02360.JPG,char_data/아/DSC02360.JPG_2.jpg,5040,480,640,72,86,158,237,307,True,71
아,133,kaist_dataset/Korean/Digital_Camera/outdoor2/DSC02366.JPG,char_data/아/DSC02366.JPG_2.jpg,29260,480,640,220,12,232,248,381,True,71
아,29,kaist_dataset/Korean/Digital_Camera/outdoor2/DSC02380.JPG,char_data/아/DSC02380.JPG_2.jpg,696,480,640,24,5,29,255,284,True,71
아,74,kaist_dataset/Korean/Digital_Camera/outdoor2/DSC02424.JPG,char_data/아/DSC02424.JPG_2.jpg,4810,480,640,65,145,210,154,228,True,71
아,110,kaist_dataset/Korean/Digital_Camera/outdoor2/DSC02470.JPG,char_data/아/DSC02470.JPG_2.jpg,8910,480,640,81,459,540,33,143,True,71
아,65,kaist_dataset/Korean/Digital_Camera/outdoor2/DSC02476.JPG,char_data/아/DSC02476.JPG_2.jpg,4355,480,640,67,384,451,203,268,True,71
아,120,kaist_dataset/Korean/Digital_Camera/outdoor2/DSC02521.JPG,char_data/아/DSC02521.JPG_2.jpg,15120,480,640,126,272,398,167,287,True,71
아,106,kaist_dataset/Korean/Digital_Camera/outdoor3/DSC02536.JPG,char_data/아/DSC02536.JPG_2.jpg,7950,480,640,75,403,478,174,280,True,71
아,66,kaist_dataset/Korean/Digital_Camera/outdoor3/DSC02889.JPG,char_data/아/DSC02889.JPG_2.jpg,6600,480,640,100,138,238,400,466,True,71
아,119,kaist_dataset/Korean/Digital_Camera/outdoor3/DSC02899.JPG,char_data/아/DSC02899.JPG_2.jpg,20349,480,640,171,403,574,76,195,True,71
아,63,kaist_dataset/Korean/Digital_Camera/outdoor3/DSC02901.JPG,char_data/아/DSC02901.JPG_2.jpg,2898,480,640,46,293,339,400,463,True,71
아,120,kaist_dataset/Korean/Digital_Camera/outdoor3/DSC02953.JPG,char_data/아/DSC02953.JPG_2.jpg,16200,480,640,135,297,432,156,276,True,71
아,46,kaist_dataset/Korean/Digital_Camera/outdoor3/DSC02973.JPG,char_data/아/DSC02973.JPG_2.jpg,2944,480,640,64,387,451,270,316,True,71
아,69,kaist_dataset/Korean/Digital_Camera/outdoor3/DSC03172.JPG,char_data/아/DSC03172.JPG_2.jpg,4002,480,640,58,379,437,236,305,True,71
아,68,kaist_dataset/Korean/Digital_Camera/outdoor3/DSC03214.JPG,char_data/아/DSC03214.JPG_2.jpg,2720,480,640,40,294,334,176,244,True,71
아,96,kaist_dataset/Korean/Digital_Camera/outdoor3/DSC03219.JPG,char_data/아/DSC03219.JPG_2.jpg,21120,480,640,220,108,328,245,341,True,71
아,97,kaist_dataset/Korean/Digital_Camera/outdoor3/DSC03228.JPG,char_data/아/DSC03228.JPG_2.jpg,10476,480,640,108,163,271,190,287,True,71
아,28,kaist_dataset/Korean/Digital_Camera/outdoor3/DSC03232.JPG,char_data/아/DSC03232.JPG_2.jpg,924,480,640,33,409,442,279,307,True,71
아,112,kaist_dataset/Korean/Digital_Camera/outdoor4/DSC03538.JPG,char_data/아/DSC03538.JPG_2.jpg,8848,480,640,79,426,505,183,295,True,71
아,86,kaist_dataset/Korean/Digital_Camera/outdoor4/DSC03543.JPG,char_data/아/DSC03543.JPG_2.jpg,6966,480,640,81,243,324,41,127,True,71
아,85,kaist_dataset/Korean/Digital_Camera/outdoor4/DSC03546.JPG,char_data/아/DSC03546.JPG_2.jpg,7820,480,640,92,413,505,319,404,True,71
아,67,kaist_dataset/Korean/Digital_Camera/outdoor4/DSC03567.JPG,char_data/아/DSC03567.JPG_2.jpg,3417,480,640,51,276,327,157,224,True,71
아,144,kaist_dataset/Korean/Digital_Camera/outdoor4/DSC03574.JPG,char_data/아/DSC03574.JPG_2.jpg,12528,480,640,87,284,371,177,321,True,71
아,60,kaist_dataset/Korean/Digital_Camera/outdoor4/DSC03584.JPG,char_data/아/DSC03584.JPG_2.jpg,2940,480,640,49,159,208,168,228,True,71
아,77,kaist_dataset/Korean/Digital_Camera/outdoor4/DSC03602.JPG,char_data/아/DSC03602.JPG_2.jpg,5313,480,640,69,232,301,158,235,True,71
아,70,kaist_dataset/Korean/Digital_Camera/outdoor4/DSC03603.JPG,char_data/아/DSC03603.JPG_4.jpg,4970,480,640,71,239,310,147,217,True,71
아,76,kaist_dataset/Korean/Digital_Camera/outdoor4/DSC03603.JPG,char_data/아/DSC03603.JPG_5.jpg,5624,480,640,74,306,380,147,223,True,71
아,51,kaist_dataset/Korean/Digital_Camera/outdoor4/DSC03615.JPG,char_data/아/DSC03615.JPG_2.jpg,2958,480,640,58,306,364,132,183,True,71
아,72,kaist_dataset/Korean/Digital_Camera/outdoor5/DSC03688.JPG,char_data/아/DSC03688.JPG_2.jpg,7704,480,640,107,68,175,147,219,True,71
아,152,kaist_dataset/Korean/Digital_Camera/outdoor5/DSC03742.JPG,char_data/아/DSC03742.JPG_2.jpg,21736,480,640,143,186,329,62,214,True,71
아,95,kaist_dataset/Korean/Digital_Camera/outdoor5/DSC03762.JPG,char_data/아/DSC03762.JPG_2.jpg,6745,480,640,71,240,311,173,268,True,71
아,98,kaist_dataset/Korean/Digital_Camera/outdoor5/DSC03763.JPG,char_data/아/DSC03763.JPG_2.jpg,7154,480,640,73,275,348,137,235,True,71
아,131,kaist_dataset/Korean/Digital_Camera/outdoor5/DSC03768.JPG,char_data/아/DSC03768.JPG_2.jpg,11397,480,640,87,215,302,96,227,True,71
아,82,kaist_dataset/Korean/Digital_Camera/outdoor5/DSC03789.JPG,char_data/아/DSC03789.JPG_4.jpg,6970,480,640,85,79,164,48,130,True,71
아,31,kaist_dataset/Korean/Digital_Camera/outdoor5/DSC03789.JPG,char_data/아/DSC03789.JPG_5.jpg,806,480,640,26,342,368,220,251,True,71
아,64,kaist_dataset/Korean/Digital_Camera/outdoor5/DSC03979.JPG,char_data/아/DSC03979.JPG_2.jpg,5056,480,640,79,409,488,318,382,True,71
아,68,kaist_dataset/Korean/Digital_Camera/outdoor5/DSC03993.JPG,char_data/아/DSC03993.JPG_2.jpg,3808,480,640,56,253,309,188,256,True,71
아,96,kaist_dataset/Korean/Digital_Camera/outdoor5/DSC04039.JPG,char_data/아/DSC04039.JPG_2.jpg,10176,480,640,106,166,272,200,296,True,71
아,71,kaist_dataset/Korean/Digital_Camera/outdoor6/DSC04049.JPG,char_data/아/DSC04049.JPG_2.jpg,4189,480,640,59,156,215,115,186,True,71
아,67,kaist_dataset/Korean/Digital_Camera/outdoor7/P1010007.JPG,char_data/아/P1010007.JPG_2.jpg,6097,480,640,91,381,472,151,218,True,71
아,98,kaist_dataset/Korean/Digital_Camera/outdoor7/P1010039.JPG,char_data/아/P1010039.JPG_2.jpg,6566,480,640,67,279,346,108,206,True,71
아,94,kaist_dataset/Korean/Digital_Camera/outdoor8/DSC02880.JPG,char_data/아/DSC02880.JPG_2.jpg,7238,480,640,77,144,221,241,335,True,71
아,61,kaist_dataset/Korean/Digital_Camera/outdoor8/DSC02896.JPG,char_data/아/DSC02896.JPG_2.jpg,4697,480,640,77,132,209,207,268,True,71
아,88,"kaist_dataset/Korean/Mobile_Phone/(M,K)A-shadow/P090912067.jpg",char_data/아/P090912067.jpg_2.jpg,8800,480,640,100,126,226,186,274,True,71
아,52,"kaist_dataset/Korean/Mobile_Phone/(M,K)C-outdoor/P090912033.jpg",char_data/아/P090912033.jpg_2.jpg,3068,480,640,59,198,257,97,149,True,71
아,58,"kaist_dataset/Korean/Mobile_Phone/(M,K)D-indoor/P090912028.jpg",char_data/아/P090912028.jpg_2.jpg,3596,480,640,62,135,197,404,462,True,71
아,68,"kaist_dataset/Korean/Mobile_Phone/(M,K)E-bookCover/P090831034.jpg",char_data/아/P090831034.jpg_2.jpg,3536,480,640,52,285,337,89,157,True,71
아,93,"kaist_dataset/Korean/Mobile_Phone/(M,K)E-bookCover/P090831035.jpg",char_data/아/P090831035.jpg_2.jpg,7254,480,640,78,253,331,37,130,True,71
아,93,"kaist_dataset/Korean/Mobile_Phone/(M,K)E-bookCover/P090831050.jpg",char_data/아/P090831050.jpg_2.jpg,7440,480,640,80,322,402,380,473,True,71
아,201,"kaist_dataset/Korean/Mobile_Phone/(M,K)E-bookCover/P090831061.jpg",char_data/아/P090831061.jpg_2.jpg,29547,480,640,147,301,448,263,464,True,71
아,78,"kaist_dataset/Korean/Mobile_Phone/(M,K)E-bookCover/P090831155.jpg",char_data/아/P090831155.jpg_2.jpg,4446,480,640,57,160,217,186,264,True,71
아,78,"kaist_dataset/Korean/Mobile_Phone/(M,K)E-bookCover/P090903028.jpg",char_data/아/P090903028.jpg_2.jpg,5772,480,640,74,444,518,248,326,True,71
아,112,"kaist_dataset/Korean/Mobile_Phone/(M,K)E-bookCover/P090903048.jpg",char_data/아/P090903048.jpg_2.jpg,8960,480,640,80,336,416,78,190,True,71
아,80,"kaist_dataset/Korean/Mobile_Phone/(M,K)E-bookCover/P090903049.jpg",char_data/아/P090903049.jpg_2.jpg,6320,480,640,79,399,478,374,454,True,71
아,81,"kaist_dataset/Korean/Mobile_Phone/(M,K)E-bookCover/P090903078.jpg",char_data/아/P090903078.jpg_2.jpg,6804,480,640,84,253,337,140,221,True,71
아,46,"kaist_dataset/Korean/Mobile_Phone/(M,K)E-bookCover/P090911007.jpg",char_data/아/P090911007.jpg_2.jpg,1794,480,640,39,141,180,121,167,True,71
아,111,"kaist_dataset/Korean/Mobile_Phone/(M,K)E-bookCover/P090911019.jpg",char_data/아/P090911019.jpg_2.jpg,13098,480,640,118,303,421,316,427,True,71
아,133,"kaist_dataset/Korean/Mobile_Phone/(M,K)E-bookCover/P090911028.jpg",char_data/아/P090911028.jpg_2.jpg,19684,480,640,148,117,265,68,201,True,71
아,57,"kaist_dataset/Korean/Mobile_Phone/(M,K)E-bookCover/P090911082.jpg",char_data/아/P090911082.jpg_2.jpg,4389,480,640,77,438,515,236,293,True,71
아,92,"kaist_dataset/Korean/Mobile_Phone/(M,K)E-bookCover/P090912006.jpg",char_data/아/P090912006.jpg_2.jpg,5244,480,640,57,439,496,93,185,True,71
아,48,kaist_dataset/Mixed/Digital_Camera/(C.S)B-light/DSC03298.JPG,char_data/아/DSC03298.JPG_2.jpg,3360,480,640,70,381,451,216,264,True,71
아,18,kaist_dataset/Mixed/Digital_Camera/(C.S)C-outdoor1/048.JPG,char_data/아/048.JPG_2.jpg,252,480,640,14,94,108,157,175,True,71
아,64,kaist_dataset/Mixed/Digital_Camera/(C.S)C-outdoor1/080.JPG,char_data/아/080.JPG_2.jpg,4480,480,640,70,276,346,200,264,True,71
아,107,kaist_dataset/Mixed/Digital_Camera/(C.S)C-outdoor1/080119-0033.jpg,char_data/아/080119-0033.jpg_2.jpg,10914,1200,1600,102,1184,1286,833,940,True,71
아,59,kaist_dataset/Mixed/Digital_Camera/(C.S)C-outdoor1/1.JPG,char_data/아/1.JPG_2.jpg,2006,576,768,34,405,439,462,521,True,71
아,111,kaist_dataset/Mixed/Digital_Camera/(C.S)C-outdoor1/51.JPG,char_data/아/51.JPG_2.jpg,9768,576,768,88,504,592,207,318,True,71
아,41,kaist_dataset/Mixed/Digital_Camera/(C.S)C-outdoor1/8.jpg,char_data/아/8.jpg_2.jpg,1230,400,766,30,464,494,275,316,True,71
아,32,kaist_dataset/Mixed/Digital_Camera/(C.S)C-outdoor1/P1010008.JPG,char_data/아/P1010008.JPG_2.jpg,640,480,640,20,501,521,198,230,True,71
아,114,kaist_dataset/Mixed/Digital_Camera/(C.S)C-outdoor2/DSC02379.JPG,char_data/아/DSC02379.JPG_2.jpg,15162,480,640,133,140,273,153,267,True,71
아,107,kaist_dataset/Mixed/Digital_Camera/(C.S)C-outdoor2/DSC02416.JPG,char_data/아/DSC02416.JPG_2.jpg,12840,480,640,120,12,132,105,212,True,71
아,41,kaist_dataset/Mixed/Digital_Camera/(C.S)C-outdoor2/DSC02429.JPG,char_data/아/DSC02429.JPG_2.jpg,2255,480,640,55,281,336,248,289,True,71
아,49,kaist_dataset/Mixed/Digital_Camera/(C.S)C-outdoor2/DSC02471.JPG,char_data/아/DSC02471.JPG_2.jpg,2695,480,640,55,115,170,172,221,True,71
아,76,kaist_dataset/Mixed/Digital_Camera/(C.S)C-outdoor2/DSC02479.JPG,char_data/아/DSC02479.JPG_2.jpg,8056,480,640,106,68,174,153,229,True,71
아,72,kaist_dataset/Mixed/Digital_Camera/(C.S)C-outdoor2/DSC02482.JPG,char_data/아/DSC02482.JPG_2.jpg,3672,480,640,51,223,274,177,249,True,71
아,110,kaist_dataset/Mixed/Digital_Camera/(C.S)C-outdoor2/DSC02556.JPG,char_data/아/DSC02556.JPG_2.jpg,7480,480,640,68,361,429,202,312,True,71
아,77,kaist_dataset/Mixed/Digital_Camera/(C.S)C-outdoor2/DSC02560.JPG,char_data/아/DSC02560.JPG_2.jpg,6237,480,640,81,407,488,185,262,True,71
아,60,kaist_dataset/Mixed/Digital_Camera/(C.S)C-outdoor2/DSC02894.JPG,char_data/아/DSC02894.JPG_2.jpg,5460,480,640,91,378,469,142,202,True,71
아,26,kaist_dataset/Mixed/Digital_Camera/(C.S)C-outdoor2/DSC02940.JPG,char_data/아/DSC02940.JPG_2.jpg,780,480,640,30,244,274,314,340,True,71
아,39,kaist_dataset/Mixed/Digital_Camera/(C.S)C-outdoor3/DSC02962.JPG,char_data/아/DSC02962.JPG_2.jpg,1755,480,640,45,98,143,362,401,True,71
아,51,kaist_dataset/Mixed/Digital_Camera/(C.S)C-outdoor3/DSC03015.JPG,char_data/아/DSC03015.JPG_2.jpg,2295,480,640,45,191,236,147,198,True,71
아,98,kaist_dataset/Mixed/Digital_Camera/(C.S)C-outdoor3/DSC03048.JPG,char_data/아/DSC03048.JPG_2.jpg,9702,480,640,99,355,454,29,127,True,71
아,43,kaist_dataset/Mixed/Digital_Camera/(C.S)C-outdoor3/DSC03283.JPG,char_data/아/DSC03283.JPG_2.jpg,2279,480,640,53,220,273,156,199,True,71
아,109,kaist_dataset/Mixed/Digital_Camera/(C.S)C-outdoor3/DSC03422.JPG,char_data/아/DSC03422.JPG_2.jpg,8066,480,640,74,244,318,335,444,False,71
아,74,kaist_dataset/Mixed/Digital_Camera/(C.S)C-outdoor4/DSC03539.JPG,char_data/아/DSC03539.JPG_2.jpg,7104,480,640,96,282,378,147,221,False,71
아,60,kaist_dataset/Mixed/Digital_Camera/(C.S)C-outdoor4/DSC03544.JPG,char_data/아/DSC03544.JPG_2.jpg,2940,480,640,49,208,257,264,324,False,71
아,93,kaist_dataset/Mixed/Digital_Camera/(C.S)C-outdoor4/DSC03616.JPG,char_data/아/DSC03616.JPG_2.jpg,8370,480,640,90,346,436,42,135,False,71
아,114,kaist_dataset/Mixed/Digital_Camera/(C.S)C-outdoor4/DSC03628.JPG,char_data/아/DSC03628.JPG_2.jpg,13224,480,640,116,206,322,207,321,False,71
아,118,kaist_dataset/Mixed/Digital_Camera/(C.S)C-outdoor4/DSC03702.JPG,char_data/아/DSC03702.JPG_2.jpg,12272,480,640,104,383,487,212,330,False,71
아,76,kaist_dataset/Mixed/Digital_Camera/(C.S)C-outdoor4/DSC03730.JPG,char_data/아/DSC03730.JPG_2.jpg,6308,480,640,83,417,500,164,240,False,71
아,101,kaist_dataset/Mixed/Digital_Camera/(C.S)C-outdoor4/DSC03732.JPG,char_data/아/DSC03732.JPG_2.jpg,10605,480,640,105,417,522,286,387,False,71
아,56,kaist_dataset/Mixed/Digital_Camera/(C.S)C-outdoor4/DSC03769.JPG,char_data/아/DSC03769.JPG_2.jpg,3640,480,640,65,441,506,273,329,False,71
아,131,kaist_dataset/Mixed/Digital_Camera/(C.S)C-outdoor4/DSC03785.JPG,char_data/아/DSC03785.JPG_2.jpg,11266,480,640,86,278,364,128,259,False,71
아,37,kaist_dataset/Mixed/Digital_Camera/(C.S)C-outdoor5/DSC03839.JPG,char_data/아/DSC03839.JPG_2.jpg,1110,480,640,30,374,404,410,447,False,71
아,83,kaist_dataset/Mixed/Digital_Camera/(C.S)C-outdoor5/DSC04056.JPG,char_data/아/DSC04056.JPG_2.jpg,5893,480,640,71,167,238,327,410,False,71
아,62,kaist_dataset/Mixed/Digital_Camera/(C.S)C-outdoor6/P1010054.JPG,char_data/아/P1010054.JPG_2.jpg,3162,480,640,51,108,159,214,276,False,71
아,111,kaist_dataset/Mixed/Digital_Camera/(C.S)C-outdoor6/P1010063.JPG,char_data/아/P1010063.JPG_2.jpg,14763,480,640,133,50,183,6,117,False,71
아,70,kaist_dataset/Mixed/Digital_Camera/(C.S)C-outdoor6/P1010075.JPG,char_data/아/P1010075.JPG_2.jpg,5180,480,640,74,199,273,179,249,False,71
아,43,kaist_dataset/Mixed/Digital_Camera/(C.S)D-indoor1/DSC02733.JPG,char_data/아/DSC02733.JPG_2.jpg,1806,480,640,42,158,200,65,108,False,71
아,67,kaist_dataset/Mixed/Digital_Camera/(C.S)D-indoor1/DSC02782.JPG,char_data/아/DSC02782.JPG_2.jpg,5159,480,640,77,239,316,184,251,False,71
아,59,kaist_dataset/Mixed/Digital_Camera/(C.S)D-indoor1/DSC02785.JPG,char_data/아/DSC02785.JPG_2.jpg,4189,480,640,71,237,308,238,297,False,71
아,76,kaist_dataset/Mixed/Digital_Camera/(C.S)D-indoor1/DSC02801.JPG,char_data/아/DSC02801.JPG_2.jpg,7676,480,640,101,329,430,204,280,False,71
아,121,kaist_dataset/Mixed/Digital_Camera/(C.S)D-indoor1/DSC03472.JPG,char_data/아/DSC03472.JPG_2.jpg,9680,480,640,80,95,175,174,295,False,71
아,65,kaist_dataset/Mixed/Digital_Camera/(C.S)D-indoor1/DSC03483.JPG,char_data/아/DSC03483.JPG_2.jpg,3120,480,640,48,192,240,194,259,False,71
아,69,kaist_dataset/Mixed/Digital_Camera/(C.S)D-indoor2/DSC04442.JPG,char_data/아/DSC04442.JPG_2.jpg,4692,480,640,68,70,138,362,431,False,71
아,215,kaist_dataset/Mixed/Digital_Camera/(C.S)F-others/2007-12-08-day-044.jpg,char_data/아/2007-12-08-day-044.jpg_2.jpg,25370,1200,1600,118,721,839,560,775,False,71
아,176,kaist_dataset/Mixed/Digital_Camera/(C.S)F-others/2007-12-08-day-113.jpg,char_data/아/2007-12-08-day-113.jpg_2.jpg,23232,1200,1600,132,833,965,490,666,False,71
아,60,kaist_dataset/Mixed/Digital_Camera/(C.S)F-others/DSC02881.JPG,char_data/아/DSC02881.JPG_6.jpg,3720,480,640,62,12,74,184,244,False,71
아,40,kaist_dataset/Mixed/Digital_Camera/(C.S)F-others/DSC02881.JPG,char_data/아/DSC02881.JPG_7.jpg,1360,480,640,34,122,156,300,340,False,71
아,33,kaist_dataset/Mixed/Digital_Camera/(C.S)F-others/DSC02881.JPG,char_data/아/DSC02881.JPG_8.jpg,1056,480,640,32,477,509,219,252,False,71
아,85,kaist_dataset/Mixed/Mobile_Phone/(C.M)A-outdoor/P090912038.jpg,char_data/아/P090912038.jpg_2.jpg,8160,480,640,96,63,159,65,150,False,71
아,43,kaist_dataset/Mixed/Mobile_Phone/(C.M)A-outdoor/P090912068.jpg,char_data/아/P090912068.jpg_2.jpg,2021,480,640,47,69,116,130,173,False,71
아,120,kaist_dataset/Mixed/Mobile_Phone/(C.M)C-bookCover/P090831115.jpg,char_data/아/P090831115.jpg_2.jpg,13320,480,640,111,496,607,34,154,False,71
아,38,kaist_dataset/Mixed/Mobile_Phone/(C.M)C-bookCover/P090904005.jpg,char_data/아/P090904005.jpg_2.jpg,1824,480,640,48,131,179,387,425,False,71
하,34,kaist_dataset/English/Digital_Camera/(E.S)B-light/080116-0059.jpg,char_data/하/080116-0059.jpg_4.jpg,544,1200,1600,16,913,929,903,937,True,84
하,34,kaist_dataset/English/Digital_Camera/(E.S)B-light/080116-0059.jpg,char_data/하/080116-0059.jpg_5.jpg,782,1200,1600,23,544,567,1141,1175,True,84
하,59,kaist_dataset/Korean/Digital_Camera/A-shadow/DSC03755.JPG,char_data/하/DSC03755.JPG_2.jpg,3186,480,640,54,532,586,126,185,True,84
하,29,kaist_dataset/Korean/Digital_Camera/E-night/DSC02648.JPG,char_data/하/DSC02648.JPG_2.jpg,1073,480,640,37,412,449,405,434,True,84
하,87,kaist_dataset/Korean/Digital_Camera/F-bookCover/DSC03926.JPG,char_data/하/DSC03926.JPG_2.jpg,5394,480,640,62,398,460,281,368,True,84
하,46,kaist_dataset/Korean/Digital_Camera/F-bookCover/DSC04230.JPG,char_data/하/DSC04230.JPG_2.jpg,1748,480,640,38,551,589,227,273,True,84
하,58,kaist_dataset/Korean/Digital_Camera/G-others/2007-12-08-day-112.jpg,char_data/하/2007-12-08-day-112.jpg_2.jpg,2494,1200,1600,43,179,222,1025,1083,True,84
하,86,kaist_dataset/Korean/Digital_Camera/G-others/5.jpg,char_data/하/5.jpg_2.jpg,4988,553,798,58,190,248,188,274,True,84
하,54,kaist_dataset/Korean/Digital_Camera/indoor1/080118-0017.jpg,char_data/하/080118-0017.jpg_2.jpg,2430,1200,1600,45,1360,1405,491,545,True,84
하,23,kaist_dataset/Korean/Digital_Camera/indoor1/146.JPG,char_data/하/146.JPG_2.jpg,437,480,640,19,398,417,291,314,True,84
하,57,kaist_dataset/Korean/Digital_Camera/indoor1/DSC02720.JPG,char_data/하/DSC02720.JPG_2.jpg,3078,480,640,54,13,67,89,146,True,84
하,38,kaist_dataset/Korean/Digital_Camera/indoor1/DSC03113.JPG,char_data/하/DSC03113.JPG_2.jpg,1292,480,640,34,342,376,289,327,True,84
하,34,kaist_dataset/Korean/Digital_Camera/indoor2/DSC03530.JPG,char_data/하/DSC03530.JPG_2.jpg,1190,480,640,35,359,394,215,249,True,84
하,90,kaist_dataset/Korean/Digital_Camera/indoor2/DSC03704.JPG,char_data/하/DSC03704.JPG_2.jpg,8730,480,640,97,304,401,223,313,True,84
하,60,kaist_dataset/Korean/Digital_Camera/indoor2/DSC03994.JPG,char_data/하/DSC03994.JPG_2.jpg,2820,480,640,47,200,247,277,337,True,84
하,66,kaist_dataset/Korean/Digital_Camera/indoor2/DSC04006.JPG,char_data/하/DSC04006.JPG_2.jpg,2640,480,640,40,439,479,155,221,True,84
하,36,kaist_dataset/Korean/Digital_Camera/outdoor1/026.jpg,char_data/하/026.jpg_2.jpg,1008,480,640,28,389,417,107,143,True,84
하,60,kaist_dataset/Korean/Digital_Camera/outdoor1/045.JPG,char_data/하/045.JPG_2.jpg,4620,480,640,77,240,317,178,238,True,84
하,43,kaist_dataset/Korean/Digital_Camera/outdoor1/128.JPG,char_data/하/128.JPG_2.jpg,1462,480,640,34,238,272,104,147,True,84
하,154,kaist_dataset/Korean/Digital_Camera/outdoor1/2007-12-08-day-050.jpg,char_data/하/2007-12-08-day-050.jpg_4.jpg,14014,1200,1600,91,833,924,292,446,True,84
하,247,kaist_dataset/Korean/Digital_Camera/outdoor1/2007-12-08-day-050.jpg,char_data/하/2007-12-08-day-050.jpg_5.jpg,55081,1200,1600,223,798,1021,468,715,True,84
하,79,kaist_dataset/Korean/Digital_Camera/outdoor1/2007-12-08-day-056.jpg,char_data/하/2007-12-08-day-056.jpg_2.jpg,6162,1200,1600,78,965,1043,783,862,True,84
하,82,kaist_dataset/Korean/Digital_Camera/outdoor1/2007-12-08-day-065.jpg,char_data/하/2007-12-08-day-065.jpg_2.jpg,5904,1600,1200,72,796,868,1242,1324,True,84
하,128,kaist_dataset/Korean/Digital_Camera/outdoor2/080118-0018.jpg,char_data/하/080118-0018.jpg_2.jpg,12160,1200,1600,95,365,460,1082,1199,True,84
하,92,kaist_dataset/Korean/Digital_Camera/outdoor2/2007-12-08-day-129.jpg,char_data/하/2007-12-08-day-129.jpg_2.jpg,6072,1200,1600,66,963,1029,667,759,True,84
하,53,kaist_dataset/Korean/Digital_Camera/outdoor2/DSC02305.JPG,char_data/하/DSC02305.JPG_4.jpg,4558,480,640,86,111,197,242,295,True,84
하,75,kaist_dataset/Korean/Digital_Camera/outdoor2/DSC02305.JPG,char_data/하/DSC02305.JPG_5.jpg,2100,480,640,28,6,34,310,385,True,84
하,70,kaist_dataset/Korean/Digital_Camera/outdoor2/DSC02388.JPG,char_data/하/DSC02388.JPG_2.jpg,5320,480,640,76,128,204,373,443,True,84
하,150,kaist_dataset/Korean/Digital_Camera/outdoor2/DSC02432.JPG,char_data/하/DSC02432.JPG_2.jpg,25500,480,640,170,249,419,77,227,True,84
하,41,kaist_dataset/Korean/Digital_Camera/outdoor2/DSC02453.JPG,char_data/하/DSC02453.JPG_2.jpg,1271,480,640,31,452,483,236,277,True,84
하,50,kaist_dataset/Korean/Digital_Camera/outdoor2/DSC02512.JPG,char_data/하/DSC02512.JPG_2.jpg,2700,480,640,54,320,374,229,279,True,84
하,68,kaist_dataset/Korean/Digital_Camera/outdoor3/DSC02913.JPG,char_data/하/DSC02913.JPG_2.jpg,3332,480,640,49,121,170,323,391,True,84
하,45,kaist_dataset/Korean/Digital_Camera/outdoor3/DSC02951.JPG,char_data/하/DSC02951.JPG_2.jpg,2070,480,640,46,396,442,47,92,True,84
하,39,kaist_dataset/Korean/Digital_Camera/outdoor3/DSC03064.JPG,char_data/하/DSC03064.JPG_2.jpg,1638,480,640,42,297,339,240,279,True,84
하,71,kaist_dataset/Korean/Digital_Camera/outdoor3/DSC03181.JPG,char_data/하/DSC03181.JPG_2.jpg,3337,480,640,47,424,471,159,230,True,84
하,31,kaist_dataset/Korean/Digital_Camera/outdoor4/DSC03319.JPG,char_data/하/DSC03319.JPG_2.jpg,1519,480,640,49,195,244,130,161,True,84
하,64,kaist_dataset/Korean/Digital_Camera/outdoor4/DSC03543.JPG,char_data/하/DSC03543.JPG_2.jpg,4160,480,640,65,417,482,273,337,True,84
하,92,kaist_dataset/Korean/Digital_Camera/outdoor5/DSC03629.JPG,char_data/하/DSC03629.JPG_2.jpg,2668,480,640,29,599,628,57,149,True,84
하,55,kaist_dataset/Korean/Digital_Camera/outdoor5/DSC03653.JPG,char_data/하/DSC03653.JPG_2.jpg,1210,480,640,22,518,540,83,138,True,84
하,41,kaist_dataset/Korean/Digital_Camera/outdoor5/DSC03669.JPG,char_data/하/DSC03669.JPG_2.jpg,1927,480,640,47,475,522,310,351,True,84
하,54,kaist_dataset/Korean/Digital_Camera/outdoor5/DSC03683.JPG,char_data/하/DSC03683.JPG_2.jpg,1512,480,640,28,504,532,231,285,True,84
하,69,kaist_dataset/Korean/Digital_Camera/outdoor5/DSC03713.JPG,char_data/하/DSC03713.JPG_2.jpg,2967,480,640,43,221,264,394,463,True,84
하,56,kaist_dataset/Korean/Digital_Camera/outdoor5/DSC03749.JPG,char_data/하/DSC03749.JPG_2.jpg,2016,480,640,36,306,342,87,143,True,84
하,56,kaist_dataset/Korean/Digital_Camera/outdoor5/DSC03750.JPG,char_data/하/DSC03750.JPG_4.jpg,2520,480,640,45,430,475,410,466,True,84
하,74,kaist_dataset/Korean/Digital_Camera/outdoor5/DSC03750.JPG,char_data/하/DSC03750.JPG_5.jpg,5920,480,640,80,113,193,291,365,True,84
하,30,kaist_dataset/Korean/Digital_Camera/outdoor5/DSC03751.JPG,char_data/하/DSC03751.JPG_2.jpg,1050,480,640,35,18,53,400,430,True,84
하,41,kaist_dataset/Korean/Digital_Camera/outdoor5/DSC03766.JPG,char_data/하/DSC03766.JPG_2.jpg,2419,480,640,59,543,602,94,135,True,84
하,52,kaist_dataset/Korean/Digital_Camera/outdoor5/DSC03777.JPG,char_data/하/DSC03777.JPG_2.jpg,3900,480,640,75,246,321,287,339,True,84
하,68,kaist_dataset/Korean/Digital_Camera/outdoor5/DSC03993.JPG,char_data/하/DSC03993.JPG_2.jpg,3468,480,640,51,123,174,112,180,True,84
하,89,kaist_dataset/Korean/Digital_Camera/outdoor5/DSC03997.JPG,char_data/하/DSC03997.JPG_2.jpg,7120,480,640,80,507,587,221,310,True,84
하,25,kaist_dataset/Korean/Digital_Camera/outdoor5/DSC04028.JPG,char_data/하/DSC04028.JPG_2.jpg,800,480,640,32,520,552,344,369,True,84
하,85,kaist_dataset/Korean/Digital_Camera/outdoor5/DSC04034.JPG,char_data/하/DSC04034.JPG_2.jpg,6885,480,640,81,101,182,291,376,True,84
하,69,kaist_dataset/Korean/Digital_Camera/outdoor6/DSC04084.JPG,char_data/하/DSC04084.JPG_2.jpg,5106,480,640,74,309,383,185,254,True,84
하,96,kaist_dataset/Korean/Digital_Camera/outdoor6/DSC04085.JPG,char_data/하/DSC04085.JPG_2.jpg,9984,480,640,104,144,248,140,236,True,84
하,50,kaist_dataset/Korean/Digital_Camera/outdoor6/DSC04099.JPG,char_data/하/DSC04099.JPG_2.jpg,2050,480,640,41,99,140,405,455,True,84
하,83,kaist_dataset/Korean/Digital_Camera/outdoor6/DSC04103.JPG,char_data/하/DSC04103.JPG_4.jpg,5727,480,640,69,85,154,50,133,True,84
하,74,kaist_dataset/Korean/Digital_Camera/outdoor6/DSC04103.JPG,char_data/하/DSC04103.JPG_5.jpg,4662,480,640,63,261,324,155,229,True,84
하,87,kaist_dataset/Korean/Digital_Camera/outdoor6/DSC04141.JPG,char_data/하/DSC04141.JPG_2.jpg,7221,480,640,83,35,118,249,336,True,84
하,140,kaist_dataset/Korean/Digital_Camera/outdoor6/DSC04143.JPG,char_data/하/DSC04143.JPG_2.jpg,19460,480,640,139,26,165,219,359,True,84
하,44,kaist_dataset/Korean/Digital_Camera/outdoor6/DSC04156.JPG,char_data/하/DSC04156.JPG_2.jpg,2068,480,640,47,123,170,51,95,True,84
하,73,kaist_dataset/Korean/Digital_Camera/outdoor6/DSC04317.JPG,char_data/하/DSC04317.JPG_2.jpg,5402,480,640,74,276,350,170,243,True,84
하,102,kaist_dataset/Korean/Digital_Camera/outdoor6/DSC04350.JPG,char_data/하/DSC04350.JPG_2.jpg,4590,480,640,45,96,141,309,411,True,84
하,83,kaist_dataset/Korean/Digital_Camera/outdoor6/DSC04396.JPG,char_data/하/DSC04396.JPG_2.jpg,4814,480,640,58,364,422,148,231,True,84
하,92,kaist_dataset/Korean/Digital_Camera/outdoor6/DSC04435.JPG,char_data/하/DSC04435.JPG_2.jpg,7820,480,640,85,206,291,143,235,True,84
하,108,kaist_dataset/Korean/Digital_Camera/outdoor6/DSC04441.JPG,char_data/하/DSC04441.JPG_4.jpg,9072,480,640,84,267,351,40,148,True,84
하,113,kaist_dataset/Korean/Digital_Camera/outdoor6/DSC04441.JPG,char_data/하/DSC04441.JPG_5.jpg,12317,480,640,109,106,215,314,427,True,84
하,46,kaist_dataset/Korean/Digital_Camera/outdoor7/DSC04455.JPG,char_data/하/DSC04455.JPG_2.jpg,1426,480,640,31,219,250,425,471,True,84
하,108,kaist_dataset/Korean/Digital_Camera/outdoor7/DSC04472.JPG,char_data/하/DSC04472.JPG_2.jpg,13716,480,640,127,111,238,185,293,True,84
하,63,kaist_dataset/Korean/Digital_Camera/outdoor7/k.jpg,char_data/하/k.jpg_2.jpg,2205,240,320,35,94,129,54,117,True,84
하,41,kaist_dataset/Korean/Digital_Camera/outdoor7/P1010067.JPG,char_data/하/P1010067.JPG_4.jpg,1722,480,640,42,470,512,313,354,True,84
하,69,kaist_dataset/Korean/Digital_Camera/outdoor7/P1010068.JPG,char_data/하/P1010068.JPG_2.jpg,3243,480,640,47,95,142,266,335,True,84
하,40,kaist_dataset/Korean/Digital_Camera/outdoor7/P1010069.JPG,char_data/하/P1010069.JPG_2.jpg,1040,480,640,26,516,542,317,357,True,84
하,52,kaist_dataset/Korean/Digital_Camera/outdoor7/P1010077.JPG,char_data/하/P1010077.JPG_2.jpg,2548,480,640,49,340,389,308,360,True,84
하,55,kaist_dataset/Korean/Digital_Camera/outdoor8/DSC02950.JPG,char_data/하/DSC02950.JPG_2.jpg,3025,480,640,55,494,549,165,220,True,84
하,33,kaist_dataset/Korean/Digital_Camera/outdoor8/P1010170.JPG,char_data/하/P1010170.JPG_2.jpg,990,480,640,30,582,612,268,301,True,84
하,73,kaist_dataset/Korean/Digital_Camera/outdoor8/크기변환_P1010025.JPG,char_data/하/크기변환_P1010025.JPG_4.jpg,4891,480,640,67,69,136,97,170,True,84
하,41,kaist_dataset/Korean/Digital_Camera/outdoor8/크기변환_P1010025.JPG,char_data/하/크기변환_P1010025.JPG_5.jpg,1312,480,640,32,46,78,259,300,True,84
하,103,kaist_dataset/Korean/Digital_Camera/outdoor8/크기변환_P1010027.JPG,char_data/하/크기변환_P1010027.JPG_2.jpg,8343,480,640,81,136,217,76,179,True,84
하,37,"kaist_dataset/Korean/Mobile_Phone/(M,K)A-shadow/P090912067.jpg",char_data/하/P090912067.jpg_2.jpg,1184,480,640,32,442,474,399,436,True,84
하,64,"kaist_dataset/Korean/Mobile_Phone/(M,K)C-outdoor/P090903101.jpg",char_data/하/P090903101.jpg_2.jpg,3584,480,640,56,233,289,166,230,True,84
하,137,"kaist_dataset/Korean/Mobile_Phone/(M,K)E-bookCover/P090831052.jpg",char_data/하/P090831052.jpg_2.jpg,16577,480,640,121,266,387,142,279,True,84
하,129,"kaist_dataset/Korean/Mobile_Phone/(M,K)E-bookCover/P090831070.jpg",char_data/하/P090831070.jpg_2.jpg,14190,480,640,110,28,138,70,199,True,84
하,135,"kaist_dataset/Korean/Mobile_Phone/(M,K)E-bookCover/P090831127.jpg",char_data/하/P090831127.jpg_2.jpg,13635,480,640,101,14,115,80,215,True,84
하,145,"kaist_dataset/Korean/Mobile_Phone/(M,K)E-bookCover/P090831130.jpg",char_data/하/P090831130.jpg_2.jpg,14210,480,640,98,14,112,200,345,True,84
하,148,"kaist_dataset/Korean/Mobile_Phone/(M,K)E-bookCover/P090831131.jpg",char_data/하/P090831131.jpg_2.jpg,12432,480,640,84,104,188,90,238,True,84
하,134,"kaist_dataset/Korean/Mobile_Phone/(M,K)E-bookCover/P090903023.jpg",char_data/하/P090903023.jpg_2.jpg,12998,480,640,97,145,242,81,215,True,84
하,76,"kaist_dataset/Korean/Mobile_Phone/(M,K)E-bookCover/P090903038.jpg",char_data/하/P090903038.jpg_2.jpg,5244,480,640,69,226,295,197,273,True,84
하,59,"kaist_dataset/Korean/Mobile_Phone/(M,K)E-bookCover/P090903057.jpg",char_data/하/P090903057.jpg_2.jpg,3009,480,640,51,1,52,53,112,True,84
하,78,"kaist_dataset/Korean/Mobile_Phone/(M,K)E-bookCover/P090903078.jpg",char_data/하/P090903078.jpg_2.jpg,6552,480,640,84,296,380,16,94,True,84
하,73,"kaist_dataset/Korean/Mobile_Phone/(M,K)E-bookCover/P090903094.jpg",char_data/하/P090903094.jpg_2.jpg,3869,480,640,53,363,416,310,383,True,84
하,101,"kaist_dataset/Korean/Mobile_Phone/(M,K)E-bookCover/P090903095.jpg",char_data/하/P090903095.jpg_2.jpg,8484,480,640,84,375,459,111,212,True,84
하,63,"kaist_dataset/Korean/Mobile_Phone/(M,K)E-bookCover/P090905008.jpg",char_data/하/P090905008.jpg_2.jpg,3465,480,640,55,510,565,59,122,True,84
하,80,kaist_dataset/Mixed/Digital_Camera/(C.S)A-shadow/DSC03258.JPG,char_data/하/DSC03258.JPG_2.jpg,5280,480,640,66,73,139,358,438,True,84
하,72,kaist_dataset/Mixed/Digital_Camera/(C.S)B-light/134.JPG,char_data/하/134.JPG_2.jpg,4032,480,640,56,209,265,218,290,True,84
하,61,kaist_dataset/Mixed/Digital_Camera/(C.S)C-outdoor1/021.JPG,char_data/하/021.JPG_2.jpg,3233,480,640,53,250,303,175,236,True,84
하,111,kaist_dataset/Mixed/Digital_Camera/(C.S)C-outdoor1/080119-0008.jpg,char_data/하/080119-0008.jpg_2.jpg,7770,1200,1600,70,1209,1279,343,454,True,84
하,36,kaist_dataset/Mixed/Digital_Camera/(C.S)C-outdoor1/135.JPG,char_data/하/135.JPG_2.jpg,1044,480,640,29,233,262,254,290,True,84
하,41,kaist_dataset/Mixed/Digital_Camera/(C.S)C-outdoor1/2.JPG,char_data/하/2.JPG_2.jpg,1394,576,768,34,85,119,226,267,True,84
하,74,kaist_dataset/Mixed/Digital_Camera/(C.S)C-outdoor1/2007-12-09-day-exterior-037.jpg,char_data/하/2007-12-09-day-exterior-037.jpg_2.jpg,5624,1200,1600,76,866,942,599,673,True,84
하,111,kaist_dataset/Mixed/Digital_Camera/(C.S)C-outdoor1/2007-12-09-day-exterior-044.jpg,char_data/하/2007-12-09-day-exterior-044.jpg_2.jpg,12765,1200,1600,115,115,230,1092,1199,True,84
하,50,kaist_dataset/Mixed/Digital_Camera/(C.S)C-outdoor1/2007-12-09-day-exterior-051.jpg,char_data/하/2007-12-09-day-exterior-051.jpg_2.jpg,2350,1200,1600,47,1164,1211,787,837,True,84
하,52,kaist_dataset/Mixed/Digital_Camera/(C.S)C-outdoor1/2007-12-09-day-exterior-078.jpg,char_data/하/2007-12-09-day-exterior-078.jpg_6.jpg,2184,1200,1600,42,1058,1100,362,414,True,84
하,60,kaist_dataset/Mixed/Digital_Camera/(C.S)C-outdoor1/2007-12-09-day-exterior-078.jpg,char_data/하/2007-12-09-day-exterior-078.jpg_7.jpg,2460,1200,1600,41,1186,1227,427,487,True,84
하,53,kaist_dataset/Mixed/Digital_Camera/(C.S)C-outdoor1/2007-12-09-day-exterior-078.jpg,char_data/하/2007-12-09-day-exterior-078.jpg_8.jpg,2491,1200,1600,47,1224,1271,344,397,True,84
하,49,kaist_dataset/Mixed/Digital_Camera/(C.S)C-outdoor1/DSC02320.JPG,char_data/하/DSC02320.JPG_2.jpg,1862,480,640,38,71,109,347,396,True,84
하,45,kaist_dataset/Mixed/Digital_Camera/(C.S)C-outdoor1/DSC02322.JPG,char_data/하/DSC02322.JPG_2.jpg,2745,480,640,61,462,523,363,408,True,84
하,35,kaist_dataset/Mixed/Digital_Camera/(C.S)C-outdoor1/DSC02344.JPG,char_data/하/DSC02344.JPG_2.jpg,1085,480,640,31,250,281,244,279,True,84
하,40,kaist_dataset/Mixed/Digital_Camera/(C.S)C-outdoor2/DSC02389.JPG,char_data/하/DSC02389.JPG_2.jpg,1840,480,640,46,547,593,237,277,True,84
하,32,kaist_dataset/Mixed/Digital_Camera/(C.S)C-outdoor2/DSC02460.JPG,char_data/하/DSC02460.JPG_2.jpg,960,480,640,30,104,134,308,340,True,84
하,105,kaist_dataset/Mixed/Digital_Camera/(C.S)C-outdoor2/DSC02907.JPG,char_data/하/DSC02907.JPG_2.jpg,11025,480,640,105,153,258,201,306,True,84
하,37,kaist_dataset/Mixed/Digital_Camera/(C.S)C-outdoor3/DSC02969.JPG,char_data/하/DSC02969.JPG_2.jpg,1332,480,640,36,455,491,22,59,True,84
하,77,kaist_dataset/Mixed/Digital_Camera/(C.S)C-outdoor3/DSC03242.JPG,char_data/하/DSC03242.JPG_2.jpg,6776,480,640,88,316,404,234,311,True,84
하,79,kaist_dataset/Mixed/Digital_Camera/(C.S)C-outdoor3/DSC03250.JPG,char_data/하/DSC03250.JPG_2.jpg,7663,480,640,97,261,358,347,426,True,84
하,84,kaist_dataset/Mixed/Digital_Camera/(C.S)C-outdoor3/DSC03275.JPG,char_data/하/DSC03275.JPG_2.jpg,8988,480,640,107,48,155,82,166,True,84
하,117,kaist_dataset/Mixed/Digital_Camera/(C.S)C-outdoor3/DSC03302.JPG,char_data/하/DSC03302.JPG_2.jpg,11583,480,640,99,74,173,177,294,True,84
하,30,kaist_dataset/Mixed/Digital_Camera/(C.S)C-outdoor3/DSC03312.JPG,char_data/하/DSC03312.JPG_2.jpg,1230,480,640,41,498,539,296,326,True,84
하,41,kaist_dataset/Mixed/Digital_Camera/(C.S)C-outdoor4/DSC03581.JPG,char_data/하/DSC03581.JPG_2.jpg,1722,480,640,42,270,312,195,236,True,84
하,45,kaist_dataset/Mixed/Digital_Camera/(C.S)C-outdoor4/DSC03582.JPG,char_data/하/DSC03582.JPG_4.jpg,1530,480,640,34,415,449,88,133,False,84
하,72,kaist_dataset/Mixed/Digital_Camera/(C.S)C-outdoor4/DSC03582.JPG,char_data/하/DSC03582.JPG_5.jpg,5544,480,640,77,266,343,273,345,False,84
하,54,kaist_dataset/Mixed/Digital_Camera/(C.S)C-outdoor4/DSC03628.JPG,char_data/하/DSC03628.JPG_2.jpg,2916,480,640,54,363,417,354,408,False,84
하,38,kaist_dataset/Mixed/Digital_Camera/(C.S)C-outdoor4/DSC03633.JPG,char_data/하/DSC03633.JPG_2.jpg,1672,480,640,44,424,468,270,308,False,84
하,61,kaist_dataset/Mixed/Digital_Camera/(C.S)C-outdoor4/DSC03662.JPG,char_data/하/DSC03662.JPG_2.jpg,1952,480,640,32,184,216,152,213,False,84
하,35,kaist_dataset/Mixed/Digital_Camera/(C.S)C-outdoor4/DSC03733.JPG,char_data/하/DSC03733.JPG_2.jpg,1085,480,640,31,269,300,287,322,False,84
하,26,kaist_dataset/Mixed/Digital_Camera/(C.S)C-outdoor4/DSC03764.JPG,char_data/하/DSC03764.JPG_2.jpg,754,480,640,29,406,435,260,286,False,84
하,70,kaist_dataset/Mixed/Digital_Camera/(C.S)C-outdoor5/DSC04091.JPG,char_data/하/DSC04091.JPG_2.jpg,4270,480,640,61,128,189,164,234,False,84
하,104,kaist_dataset/Mixed/Digital_Camera/(C.S)C-outdoor5/DSC04124.JPG,char_data/하/DSC04124.JPG_2.jpg,11024,480,640,106,232,338,187,291,False,84
하,121,kaist_dataset/Mixed/Digital_Camera/(C.S)C-outdoor5/DSC04434.JPG,char_data/하/DSC04434.JPG_2.jpg,14036,480,640,116,23,139,153,274,False,84
하,44,kaist_dataset/Mixed/Digital_Camera/(C.S)C-outdoor5/DSC04456.JPG,char_data/하/DSC04456.JPG_2.jpg,1188,480,640,27,79,106,224,268,False,84
하,94,kaist_dataset/Mixed/Digital_Camera/(C.S)C-outdoor5/DSC04461.JPG,char_data/하/DSC04461.JPG_2.jpg,8272,480,640,88,311,399,106,200,False,84
하,64,kaist_dataset/Mixed/Digital_Camera/(C.S)C-outdoor6/080116-0057.jpg,char_data/하/080116-0057.jpg_2.jpg,3584,1200,1600,56,660,716,997,1061,False,84
하,34,kaist_dataset/Mixed/Digital_Camera/(C.S)C-outdoor6/P1010056.JPG,char_data/하/P1010056.JPG_2.jpg,850,480,640,25,581,606,230,264,False,84
하,50,kaist_dataset/Mixed/Digital_Camera/(C.S)C-outdoor6/P1010067.JPG,char_data/하/P1010067.JPG_5.jpg,2550,480,640,51,100,151,316,366,False,84
하,115,kaist_dataset/Mixed/Digital_Camera/(C.S)C-outdoor6/P1010074.JPG,char_data/하/P1010074.JPG_2.jpg,9660,480,640,84,63,147,179,294,False,84
하,17,kaist_dataset/Mixed/Digital_Camera/(C.S)C-outdoor6/P1010097.JPG,char_data/하/P1010097.JPG_2.jpg,340,480,640,20,605,625,137,154,False,84
하,65,kaist_dataset/Mixed/Digital_Camera/(C.S)C-outdoor6/크기변환_20040626112330924_im_orz6564_netdkwk.jpg,char_data/하/크기변환_20040626112330924_im_orz6564_netdkwk.jpg_2.jpg,3055,480,640,47,329,376,229,294,False,84
하,73,kaist_dataset/Mixed/Digital_Camera/(C.S)D-indoor1/DSC02772.JPG,char_data/하/DSC02772.JPG_2.jpg,4234,480,640,58,313,371,285,358,False,84
하,59,kaist_dataset/Mixed/Digital_Camera/(C.S)D-indoor1/DSC03123.JPG,char_data/하/DSC03123.JPG_2.jpg,2714,480,640,46,257,303,250,309,False,84
하,37,kaist_dataset/Mixed/Digital_Camera/(C.S)D-indoor1/DSC03909.JPG,char_data/하/DSC03909.JPG_2.jpg,666,480,640,18,370,388,301,338,False,84
하,104,kaist_dataset/Mixed/Digital_Camera/(C.S)D-indoor1/DSC03986.JPG,char_data/하/DSC03986.JPG_2.jpg,7592,480,640,73,90,163,18,122,False,84
하,52,kaist_dataset/Mixed/Digital_Camera/(C.S)D-indoor2/DSC04421.JPG,char_data/하/DSC04421.JPG_2.jpg,1560,480,640,30,548,578,216,268,False,84
하,43,kaist_dataset/Mixed/Digital_Camera/(C.S)D-indoor2/크기변환_P1010030.JPG,char_data/하/크기변환_P1010030.JPG_2.jpg,1677,480,640,39,100,139,74,117,False,84
하,42,kaist_dataset/Mixed/Digital_Camera/(C.S)E-night/DSC02678.JPG,char_data/하/DSC02678.JPG_2.jpg,2142,480,640,51,518,569,383,425,False,84
하,42,kaist_dataset/Mixed/Digital_Camera/(C.S)E-night/DSC03514.JPG,char_data/하/DSC03514.JPG_2.jpg,2226,480,640,53,248,301,102,144,False,84
하,101,kaist_dataset/Mixed/Digital_Camera/(C.S)F-others/2007-12-09-day-exterior-032.jpg,char_data/하/2007-12-09-day-exterior-032.jpg_2.jpg,9191,1600,1200,91,635,726,1176,1277,False,84
하,108,kaist_dataset/Mixed/Mobile_Phone/(C.M)C-bookCover/P090831062.jpg,char_data/하/P090831062.jpg_2.jpg,10908,480,640,101,53,154,355,463,False,84
하,108,kaist_dataset/Mixed/Mobile_Phone/(C.M)C-bookCover/P090903009.jpg,char_data/하/P090903009.jpg_2.jpg,7452,480,640,69,330,399,237,345,False,84
하,179,kaist_dataset/Mixed/Mobile_Phone/(C.M)C-bookCover/P090903022.jpg,char_data/하/P090903022.jpg_2.jpg,29356,480,640,164,151,315,246,425,False,84
m,84,kaist_dataset/English/Digital_Camera/(E.S)B-light/DSC02587.JPG,char_data/m/DSC02587.JPG_4.jpg,7140,480,640,85,301,386,339,423,True,39
m,87,kaist_dataset/English/Digital_Camera/(E.S)B-light/DSC02587.JPG,char_data/m/DSC02587.JPG_5.jpg,7134,480,640,82,388,470,340,427,True,39
m,98,kaist_dataset/English/Digital_Camera/(E.S)B-light/크기변환_%B0%A3%C6%C7_ktimt007.jpg,char_data/m/크기변환_%B0%A3%C6%C7_ktimt007.jpg_2.jpg,8428,480,640,86,65,151,206,304,True,39
m,252,kaist_dataset/English/Digital_Camera/(E.S)C-outdoor1/080119-0035.jpg,char_data/m/080119-0035.jpg_2.jpg,76104,1200,1600,302,410,712,791,1043,True,39
m,226,kaist_dataset/English/Digital_Camera/(E.S)C-outdoor1/080119-0036.jpg,char_data/m/080119-0036.jpg_2.jpg,50398,1200,1600,223,793,1016,344,570,True,39
m,69,kaist_dataset/English/Digital_Camera/(E.S)C-outdoor1/104.jpg,char_data/m/104.jpg_4.jpg,7245,480,640,105,141,246,124,193,True,39
m,74,kaist_dataset/English/Digital_Camera/(E.S)C-outdoor1/104.jpg,char_data/m/104.jpg_5.jpg,7474,480,640,101,380,481,121,195,True,39
m,77,kaist_dataset/English/Digital_Camera/(E.S)C-outdoor1/129.JPG,char_data/m/129.JPG_2.jpg,5852,480,640,76,550,626,217,294,True,39
m,36,kaist_dataset/English/Digital_Camera/(E.S)C-outdoor1/137.JPG,char_data/m/137.JPG_2.jpg,1224,480,640,34,380,414,262,298,True,39
m,124,kaist_dataset/English/Digital_Camera/(E.S)C-outdoor1/2007-12-08-day-015.jpg,char_data/m/2007-12-08-day-015.jpg_4.jpg,35712,1200,1600,288,192,480,647,771,True,39
m,35,kaist_dataset/English/Digital_Camera/(E.S)C-outdoor1/2007-12-08-day-015.jpg,char_data/m/2007-12-08-day-015.jpg_5.jpg,1575,1200,1600,45,793,838,819,854,True,39
m,9,kaist_dataset/English/Digital_Camera/(E.S)C-outdoor1/7.jpg,char_data/m/7.jpg_2.jpg,162,574,680,18,183,201,109,118,True,39
m,77,kaist_dataset/English/Digital_Camera/(E.S)C-outdoor1/DSC02387.JPG,char_data/m/DSC02387.JPG_4.jpg,8162,480,640,106,378,484,209,286,True,39
m,29,kaist_dataset/English/Digital_Camera/(E.S)C-outdoor1/DSC02387.JPG,char_data/m/DSC02387.JPG_5.jpg,754,480,640,26,393,419,300,329,True,39
m,46,kaist_dataset/English/Digital_Camera/(E.S)C-outdoor1/DSC02442.JPG,char_data/m/DSC02442.JPG_2.jpg,3128,480,640,68,391,459,172,218,True,39
m,34,kaist_dataset/English/Digital_Camera/(E.S)C-outdoor2/DSC03162.JPG,char_data/m/DSC03162.JPG_2.jpg,1190,480,640,35,318,353,147,181,True,39
m,81,kaist_dataset/English/Digital_Camera/(E.S)C-outdoor2/DSC03408.JPG,char_data/m/DSC03408.JPG_2.jpg,7857,480,640,97,534,631,341,422,True,39
m,63,kaist_dataset/English/Digital_Camera/(E.S)C-outdoor2/DSC03413.JPG,char_data/m/DSC03413.JPG_2.jpg,5544,480,640,88,235,323,130,193,True,39
m,43,kaist_dataset/English/Digital_Camera/(E.S)C-outdoor2/DSC03440.JPG,char_data/m/DSC03440.JPG_2.jpg,2064,480,640,48,415,463,34,77,True,39
m,44,kaist_dataset/English/Digital_Camera/(E.S)C-outdoor2/DSC04035.JPG,char_data/m/DSC04035.JPG_2.jpg,2288,480,640,52,320,372,201,245,True,39
m,37,kaist_dataset/English/Digital_Camera/(E.S)C-outdoor2/DSC04052.JPG,char_data/m/DSC04052.JPG_2.jpg,1554,480,640,42,538,580,187,224,True,39
m,44,kaist_dataset/English/Digital_Camera/(E.S)C-outdoor2/DSC04064.JPG,char_data/m/DSC04064.JPG_2.jpg,2024,480,640,46,269,315,135,179,True,39
m,66,kaist_dataset/English/Digital_Camera/(E.S)C-outdoor2/DSC04160.JPG,char_data/m/DSC04160.JPG_4.jpg,4818,480,640,73,361,434,343,409,True,39
m,59,kaist_dataset/English/Digital_Camera/(E.S)C-outdoor2/DSC04251.JPG,char_data/m/DSC04251.JPG_2.jpg,4307,480,640,73,275,348,81,140,True,39
m,55,kaist_dataset/English/Digital_Camera/(E.S)C-outdoor2/DSC04397.JPG,char_data/m/DSC04397.JPG_2.jpg,2585,480,640,47,321,368,140,195,True,39
m,130,kaist_dataset/English/Digital_Camera/(E.S)C-outdoor2/DSC04432.JPG,char_data/m/DSC04432.JPG_2.jpg,17030,480,640,131,191,322,200,330,True,39
m,131,kaist_dataset/English/Digital_Camera/(E.S)C-outdoor2/DSC04433.JPG,char_data/m/DSC04433.JPG_2.jpg,20305,480,640,155,295,450,145,276,True,39
m,81,kaist_dataset/English/Digital_Camera/(E.S)C-outdoor2/IMG_2618.JPG,char_data/m/IMG_2618.JPG_6.jpg,7290,279,640,90,93,183,181,262,True,39
m,86,kaist_dataset/English/Digital_Camera/(E.S)C-outdoor2/IMG_2618.JPG,char_data/m/IMG_2618.JPG_7.jpg,8084,279,640,94,382,476,183,269,True,39
m,80,kaist_dataset/English/Digital_Camera/(E.S)C-outdoor2/IMG_2618.JPG,char_data/m/IMG_2618.JPG_8.jpg,6800,279,640,85,474,559,186,266,True,39
m,44,kaist_dataset/English/Digital_Camera/(E.S)C-outdoor2/P1010057.JPG,char_data/m/P1010057.JPG_4.jpg,2024,480,640,46,208,254,198,242,True,39
m,72,kaist_dataset/English/Digital_Camera/(E.S)C-outdoor3/P1010086.JPG,char_data/m/P1010086.JPG_2.jpg,6048,480,640,84,96,180,77,149,True,39
m,24,kaist_dataset/English/Digital_Camera/(E.S)C-outdoor3/크기변환_%B0%A3%C6%C71_m_starfirm.jpg,char_data/m/크기변환_%B0%A3%C6%C71_m_starfirm.jpg_2.jpg,792,480,640,33,428,461,291,315,True,39
m,30,kaist_dataset/English/Digital_Camera/(E.S)D-indoor/080119-0009.jpg,char_data/m/080119-0009.jpg_7.jpg,1380,1200,1600,46,1026,1072,701,731,True,39
m,43,kaist_dataset/English/Digital_Camera/(E.S)D-indoor/080119-0009.jpg,char_data/m/080119-0009.jpg_8.jpg,1204,1200,1600,28,565,593,1046,1089,True,39
m,55,kaist_dataset/English/Digital_Camera/(E.S)D-indoor/DSC03074.JPG,char_data/m/DSC03074.JPG_6.jpg,1870,480,640,34,206,240,266,321,True,39
m,65,kaist_dataset/English/Digital_Camera/(E.S)D-indoor/DSC03074.JPG,char_data/m/DSC03074.JPG_8.jpg,2405,480,640,37,417,454,259,324,True,39
m,40,kaist_dataset/English/Digital_Camera/(E.S)D-indoor/DSC03090.JPG,char_data/m/DSC03090.JPG_2.jpg,1040,480,640,26,495,521,291,331,True,39
m,28,kaist_dataset/English/Digital_Camera/(E.S)D-indoor/DSC03144.JPG,char_data/m/DSC03144.JPG_2.jpg,784,480,640,28,417,445,296,324,True,39
m,33,kaist_dataset/English/Digital_Camera/(E.S)D-indoor/DSC03145.JPG,char_data/m/DSC03145.JPG_2.jpg,957,480,640,29,310,339,180,213,True,39
m,36,kaist_dataset/English/Digital_Camera/(E.S)D-indoor/DSC03147.JPG,char_data/m/DSC03147.JPG_2.jpg,1152,480,640,32,432,464,296,332,True,39
m,47,kaist_dataset/English/Digital_Camera/(E.S)D-indoor/DSC03345.JPG,char_data/m/DSC03345.JPG_5.jpg,2303,480,640,49,441,490,103,150,True,39
m,53,kaist_dataset/English/Digital_Camera/(E.S)D-indoor/DSC03395.JPG,char_data/m/DSC03395.JPG_2.jpg,3021,480,640,57,404,461,419,472,True,39
m,25,kaist_dataset/English/Digital_Camera/(E.S)D-indoor/DSC03532.JPG,char_data/m/DSC03532.JPG_4.jpg,625,480,640,25,93,118,380,405,True,39
m,104,kaist_dataset/English/Digital_Camera/(E.S)E-night/080116-0056.jpg,char_data/m/080116-0056.jpg_2.jpg,15080,1200,1600,145,1031,1176,512,616,True,39
m,82,kaist_dataset/English/Digital_Camera/(E.S)E-night/DSC02570.JPG,char_data/m/DSC02570.JPG_2.jpg,6642,480,640,81,302,383,254,336,True,39
m,45,kaist_dataset/English/Digital_Camera/(E.S)E-night/DSC02610.JPG,char_data/m/DSC02610.JPG_2.jpg,1530,480,640,34,122,156,272,317,True,39
m,185,kaist_dataset/English/Digital_Camera/(E.S)F-others/080119-0007.jpg,char_data/m/080119-0007.jpg_2.jpg,51060,1200,1600,276,876,1152,473,658,True,39
m,64,kaist_dataset/English/Mobile_Phone/(E.M)B-indoor/P090903007.jpg,char_data/m/P090903007.jpg_5.jpg,5504,480,640,86,349,435,262,326,True,39
m,84,kaist_dataset/English/Mobile_Phone/(E.M)B-indoor/P090911086.jpg,char_data/m/P090911086.jpg_2.jpg,8316,480,640,99,484,583,371,455,True,39
m,65,kaist_dataset/English/Mobile_Phone/(E.M)C-bookCover/P090831039.jpg,char_data/m/P090831039.jpg_2.jpg,5915,480,640,91,414,505,238,303,True,39
m,39,kaist_dataset/English/Mobile_Phone/(E.M)C-bookCover/P090903030.jpg,char_data/m/P090903030.jpg_2.jpg,1443,480,640,37,316,353,74,113,True,39
m,47,kaist_dataset/Korean/Digital_Camera/G-others/080119-0005.jpg,char_data/m/080119-0005.jpg_2.jpg,2115,1600,1200,45,666,711,1160,1207,True,39
m,38,kaist_dataset/Korean/Digital_Camera/indoor1/080119-0018.jpg,char_data/m/080119-0018.jpg_2.jpg,1216,1200,1600,32,1200,1232,713,751,True,39
m,75,kaist_dataset/Korean/Digital_Camera/indoor1/080119-0030.jpg,char_data/m/080119-0030.jpg_2.jpg,5700,1200,1600,76,1061,1137,449,524,True,39
m,20,kaist_dataset/Korean/Digital_Camera/outdoor1/001.JPG,char_data/m/001.JPG_2.jpg,300,480,640,15,270,285,245,265,True,39
m,33,kaist_dataset/Korean/Digital_Camera/outdoor1/54.JPG,char_data/m/54.JPG_2.jpg,1617,523,767,49,417,466,115,148,True,39
m,44,kaist_dataset/Korean/Digital_Camera/outdoor2/080118-0018.jpg,char_data/m/080118-0018.jpg_2.jpg,3124,1200,1600,71,893,964,689,733,True,39
m,41,kaist_dataset/Korean/Digital_Camera/outdoor2/2007-12-09-day-exterior-036.jpg,char_data/m/2007-12-09-day-exterior-036.jpg_2.jpg,1599,1200,1600,39,1323,1362,549,590,True,39
m,22,kaist_dataset/Mixed/Digital_Camera/(C.S)C-outdoor1/003.JPG,char_data/m/003.JPG_2.jpg,352,480,640,16,506,522,253,275,True,39
m,62,kaist_dataset/Mixed/Digital_Camera/(C.S)C-outdoor1/080116-0084.jpg,char_data/m/080116-0084.jpg_2.jpg,5394,600,800,87,642,729,216,278,True,39
m,132,kaist_dataset/Mixed/Digital_Camera/(C.S)C-outdoor1/080118-0014.jpg,char_data/m/080118-0014.jpg_2.jpg,16500,1200,1600,125,967,1092,755,887,True,39
m,23,kaist_dataset/Mixed/Digital_Camera/(C.S)C-outdoor1/115.JPG,char_data/m/115.JPG_2.jpg,874,480,640,38,520,558,273,296,True,39
m,29,kaist_dataset/Mixed/Digital_Camera/(C.S)C-outdoor1/2.JPG,char_data/m/2.JPG_2.jpg,377,576,768,13,141,154,379,408,True,39
m,54,kaist_dataset/Mixed/Digital_Camera/(C.S)C-outdoor1/2007-12-09-day-exterior-004.jpg,char_data/m/2007-12-09-day-exterior-004.jpg_2.jpg,3564,1200,1600,66,512,578,672,726,True,39
m,30,kaist_dataset/Mixed/Digital_Camera/(C.S)C-outdoor1/55.JPG,char_data/m/55.JPG_4.jpg,1680,576,768,56,408,464,165,195,True,39
m,20,kaist_dataset/Mixed/Digital_Camera/(C.S)C-outdoor1/55.JPG,char_data/m/55.JPG_5.jpg,700,576,768,35,180,215,191,211,True,39
m,23,kaist_dataset/Mixed/Digital_Camera/(C.S)C-outdoor1/DSC02319.JPG,char_data/m/DSC02319.JPG_2.jpg,667,480,640,29,148,177,281,304,True,39
m,19,kaist_dataset/Mixed/Digital_Camera/(C.S)C-outdoor1/DSC02320.JPG,char_data/m/DSC02320.JPG_2.jpg,456,480,640,24,595,619,258,277,True,39
m,69,kaist_dataset/Mixed/Digital_Camera/(C.S)C-outdoor1/P1010008.JPG,char_data/m/P1010008.JPG_2.jpg,5658,480,640,82,429,511,250,319,True,39
m,24,kaist_dataset/Mixed/Digital_Camera/(C.S)C-outdoor2/DSC02385.JPG,char_data/m/DSC02385.JPG_2.jpg,528,480,640,22,401,423,151,175,True,39
m,48,kaist_dataset/Mixed/Digital_Camera/(C.S)C-outdoor2/DSC02407.JPG,char_data/m/DSC02407.JPG_2.jpg,2688,480,640,56,172,228,183,231,True,39
m,26,kaist_dataset/Mixed/Digital_Camera/(C.S)C-outdoor2/DSC02421.JPG,char_data/m/DSC02421.JPG_2.jpg,936,480,640,36,522,558,208,234,True,39
m,19,kaist_dataset/Mixed/Digital_Camera/(C.S)C-outdoor2/DSC02430.JPG,char_data/m/DSC02430.JPG_2.jpg,342,480,640,18,108,126,33,52,True,39
m,52,kaist_dataset/Mixed/Digital_Camera/(C.S)C-outdoor2/DSC02433.JPG,char_data/m/DSC02433.JPG_2.jpg,2860,480,640,55,182,237,197,249,True,39
m,20,kaist_dataset/Mixed/Digital_Camera/(C.S)C-outdoor2/DSC02439.JPG,char_data/m/DSC02439.JPG_2.jpg,480,480,640,24,337,361,113,133,True,39
m,78,kaist_dataset/Mixed/Digital_Camera/(C.S)C-outdoor2/DSC02493.JPG,char_data/m/DSC02493.JPG_5.jpg,7488,480,640,96,164,260,294,372,True,39
m,71,kaist_dataset/Mixed/Digital_Camera/(C.S)C-outdoor2/DSC02701.JPG,char_data/m/DSC02701.JPG_2.jpg,6106,480,640,86,196,282,98,169,True,39
m,50,kaist_dataset/Mixed/Digital_Camera/(C.S)C-outdoor2/DSC02907.JPG,char_data/m/DSC02907.JPG_2.jpg,2900,480,640,58,305,363,97,147,True,39
m,28,kaist_dataset/Mixed/Digital_Camera/(C.S)C-outdoor2/DSC02936.JPG,char_data/m/DSC02936.JPG_2.jpg,784,480,640,28,314,342,89,117,True,39
m,47,kaist_dataset/Mixed/Digital_Camera/(C.S)C-outdoor3/DSC02978.JPG,char_data/m/DSC02978.JPG_4.jpg,1551,480,640,33,52,85,162,209,True,39
m,38,kaist_dataset/Mixed/Digital_Camera/(C.S)C-outdoor3/DSC02978.JPG,char_data/m/DSC02978.JPG_5.jpg,912,480,640,24,231,255,165,203,True,39
m,32,kaist_dataset/Mixed/Digital_Camera/(C.S)C-outdoor3/DSC03020.JPG,char_data/m/DSC03020.JPG_2.jpg,768,480,640,24,512,536,305,337,True,39
m,44,kaist_dataset/Mixed/Digital_Camera/(C.S)C-outdoor3/DSC03063.JPG,char_data/m/DSC03063.JPG_2.jpg,1628,480,640,37,261,298,290,334,True,39
m,42,kaist_dataset/Mixed/Digital_Camera/(C.S)C-outdoor3/DSC03177.JPG,char_data/m/DSC03177.JPG_2.jpg,2226,480,640,53,462,515,150,192,True,39
m,46,kaist_dataset/Mixed/Digital_Camera/(C.S)C-outdoor3/DSC03199.JPG,char_data/m/DSC03199.JPG_4.jpg,2438,480,640,53,94,147,339,385,True,39
m,47,kaist_dataset/Mixed/Digital_Camera/(C.S)C-outdoor3/DSC03199.JPG,char_data/m/DSC03199.JPG_5.jpg,2585,480,640,55,393,448,331,378,True,39
m,33,kaist_dataset/Mixed/Digital_Camera/(C.S)C-outdoor3/DSC03227.JPG,char_data/m/DSC03227.JPG_2.jpg,693,480,640,21,126,147,108,141,True,39
m,52,kaist_dataset/Mixed/Digital_Camera/(C.S)C-outdoor3/DSC03267.JPG,char_data/m/DSC03267.JPG_2.jpg,4316,480,640,83,379,462,63,115,True,39
m,64,kaist_dataset/Mixed/Digital_Camera/(C.S)C-outdoor3/DSC03409.JPG,char_data/m/DSC03409.JPG_2.jpg,4800,480,640,75,528,603,149,213,True,39
m,56,kaist_dataset/Mixed/Digital_Camera/(C.S)C-outdoor3/DSC03422.JPG,char_data/m/DSC03422.JPG_2.jpg,2184,480,640,39,424,463,265,321,True,39
m,28,kaist_dataset/Mixed/Digital_Camera/(C.S)C-outdoor3/DSC03429.JPG,char_data/m/DSC03429.JPG_2.jpg,784,480,640,28,483,511,210,238,True,39
m,52,kaist_dataset/Mixed/Digital_Camera/(C.S)C-outdoor4/DSC03533.JPG,char_data/m/DSC03533.JPG_2.jpg,2912,480,640,56,129,185,308,360,True,39
m,38,kaist_dataset/Mixed/Digital_Camera/(C.S)C-outdoor4/DSC03534.JPG,char_data/m/DSC03534.JPG_2.jpg,1748,480,640,46,349,395,298,336,True,39
m,70,kaist_dataset/Mixed/Digital_Camera/(C.S)C-outdoor4/DSC03572.JPG,char_data/m/DSC03572.JPG_2.jpg,6300,480,640,90,247,337,135,205,True,39
m,28,kaist_dataset/Mixed/Digital_Camera/(C.S)C-outdoor4/DSC03581.JPG,char_data/m/DSC03581.JPG_2.jpg,700,480,640,25,563,588,124,152,True,39
m,77,kaist_dataset/Mixed/Digital_Camera/(C.S)C-outdoor4/DSC03630.JPG,char_data/m/DSC03630.JPG_2.jpg,5775,480,640,75,265,340,351,428,True,39
m,27,kaist_dataset/Mixed/Digital_Camera/(C.S)C-outdoor4/DSC03667.JPG,char_data/m/DSC03667.JPG_2.jpg,567,480,640,21,231,252,383,410,True,39
m,55,kaist_dataset/Mixed/Digital_Camera/(C.S)C-outdoor4/DSC03733.JPG,char_data/m/DSC03733.JPG_2.jpg,4180,480,640,76,376,452,223,278,True,39
m,40,kaist_dataset/Mixed/Digital_Camera/(C.S)C-outdoor4/DSC03773.JPG,char_data/m/DSC03773.JPG_2.jpg,2280,480,640,57,507,564,292,332,True,39
m,32,kaist_dataset/Mixed/Digital_Camera/(C.S)C-outdoor5/DSC03821.JPG,char_data/m/DSC03821.JPG_2.jpg,1120,480,640,35,181,216,37,69,True,39
m,28,kaist_dataset/Mixed/Digital_Camera/(C.S)C-outdoor5/DSC04069.JPG,char_data/m/DSC04069.JPG_2.jpg,840,480,640,30,201,231,392,420,True,39
m,30,kaist_dataset/Mixed/Digital_Camera/(C.S)C-outdoor5/DSC04070.JPG,char_data/m/DSC04070.JPG_2.jpg,720,480,640,24,184,208,112,142,True,39
m,35,kaist_dataset/Mixed/Digital_Camera/(C.S)C-outdoor5/DSC04104.JPG,char_data/m/DSC04104.JPG_2.jpg,1330,480,640,38,420,458,47,82,True,39
m,68,kaist_dataset/Mixed/Digital_Camera/(C.S)C-outdoor5/DSC04115.JPG,char_data/m/DSC04115.JPG_2.jpg,4624,480,640,68,177,245,208,276,True,39
m,29,kaist_dataset/Mixed/Digital_Camera/(C.S)C-outdoor5/DSC04125.JPG,char_data/m/DSC04125.JPG_2.jpg,667,480,640,23,274,297,431,460,True,39
m,39,kaist_dataset/Mixed/Digital_Camera/(C.S)C-outdoor5/DSC04154.JPG,char_data/m/DSC04154.JPG_2.jpg,1794,480,640,46,448,494,239,278,True,39
m,36,kaist_dataset/Mixed/Digital_Camera/(C.S)C-outdoor5/DSC04321.JPG,char_data/m/DSC04321.JPG_2.jpg,1152,480,640,32,193,225,195,231,True,39
m,34,kaist_dataset/Mixed/Digital_Camera/(C.S)C-outdoor5/DSC04322.JPG,char_data/m/DSC04322.JPG_2.jpg,986,480,640,29,275,304,226,260,True,39
m,39,kaist_dataset/Mixed/Digital_Camera/(C.S)C-outdoor5/DSC04338.JPG,char_data/m/DSC04338.JPG_4.jpg,1287,480,640,33,350,383,197,236,True,39
m,35,kaist_dataset/Mixed/Digital_Camera/(C.S)C-outdoor5/DSC04338.JPG,char_data/m/DSC04338.JPG_5.jpg,1085,480,640,31,520,551,201,236,True,39
m,52,kaist_dataset/Mixed/Digital_Camera/(C.S)C-outdoor5/DSC04399.JPG,char_data/m/DSC04399.JPG_2.jpg,2392,480,640,46,550,596,208,260,True,39
m,34,kaist_dataset/Mixed/Digital_Camera/(C.S)C-outdoor5/DSC04429.JPG,char_data/m/DSC04429.JPG_2.jpg,952,480,640,28,219,247,257,291,True,39
m,42,kaist_dataset/Mixed/Digital_Camera/(C.S)C-outdoor5/DSC04456.JPG,char_data/m/DSC04456.JPG_2.jpg,1932,480,640,46,589,635,175,217,True,39
m,47,kaist_dataset/Mixed/Digital_Camera/(C.S)C-outdoor6/117.JPG,char_data/m/117.JPG_2.jpg,4136,480,640,88,479,567,199,246,True,39
m,35,kaist_dataset/Mixed/Digital_Camera/(C.S)C-outdoor6/P1010048.JPG,char_data/m/P1010048.JPG_2.jpg,945,480,640,27,479,506,168,203,True,39
m,107,kaist_dataset/Mixed/Digital_Camera/(C.S)C-outdoor6/P1010093.JPG,char_data/m/P1010093.JPG_2.jpg,17334,480,640,162,103,265,109,216,False,39
m,34,kaist_dataset/Mixed/Digital_Camera/(C.S)D-indoor1/DSC02787.JPG,char_data/m/DSC02787.JPG_4.jpg,952,480,640,28,279,307,379,413,False,39
m,40,kaist_dataset/Mixed/Digital_Camera/(C.S)D-indoor1/DSC02787.JPG,char_data/m/DSC02787.JPG_5.jpg,960,480,640,24,470,494,362,402,False,39
m,42,kaist_dataset/Mixed/Digital_Camera/(C.S)D-indoor1/DSC03119.JPG,char_data/m/DSC03119.JPG_2.jpg,1722,480,640,41,361,402,168,210,False,39
m,35,kaist_dataset/Mixed/Digital_Camera/(C.S)D-indoor1/DSC03124.JPG,char_data/m/DSC03124.JPG_2.jpg,1295,480,640,37,338,375,203,238,False,39
m,42,kaist_dataset/Mixed/Digital_Camera/(C.S)D-indoor1/DSC03134.JPG,char_data/m/DSC03134.JPG_2.jpg,1638,480,640,39,405,444,169,211,False,39
m,57,kaist_dataset/Mixed/Digital_Camera/(C.S)D-indoor1/DSC03460.JPG,char_data/m/DSC03460.JPG_4.jpg,2622,480,640,46,243,289,388,445,False,39
m,48,kaist_dataset/Mixed/Digital_Camera/(C.S)D-indoor1/DSC03460.JPG,char_data/m/DSC03460.JPG_5.jpg,2400,480,640,50,339,389,395,443,False,39
m,37,kaist_dataset/Mixed/Digital_Camera/(C.S)D-indoor1/DSC03466.JPG,char_data/m/DSC03466.JPG_2.jpg,1184,480,640,32,305,337,233,270,False,39
m,44,kaist_dataset/Mixed/Digital_Camera/(C.S)D-indoor1/DSC03912.JPG,char_data/m/DSC03912.JPG_2.jpg,2156,480,640,49,269,318,46,90,False,39
m,34,kaist_dataset/Mixed/Digital_Camera/(C.S)D-indoor1/DSC04183.JPG,char_data/m/DSC04183.JPG_2.jpg,1360,480,640,40,481,521,261,295,False,39
m,34,kaist_dataset/Mixed/Digital_Camera/(C.S)D-indoor1/DSC04206.JPG,char_data/m/DSC04206.JPG_4.jpg,884,480,640,26,171,197,285,319,False,39
m,35,kaist_dataset/Mixed/Digital_Camera/(C.S)D-indoor1/DSC04206.JPG,char_data/m/DSC04206.JPG_5.jpg,980,480,640,28,504,532,293,328,False,39
m,32,kaist_dataset/Mixed/Digital_Camera/(C.S)D-indoor1/DSC04246.JPG,char_data/m/DSC04246.JPG_2.jpg,928,480,640,29,156,185,250,282,False,39
m,36,kaist_dataset/Mixed/Digital_Camera/(C.S)D-indoor2/DSC04248.JPG,char_data/m/DSC04248.JPG_2.jpg,1188,480,640,33,453,486,224,260,False,39
m,36,kaist_dataset/Mixed/Digital_Camera/(C.S)D-indoor2/DSC04249.JPG,char_data/m/DSC04249.JPG_2.jpg,1620,480,640,45,407,452,219,255,False,39
m,37,kaist_dataset/Mixed/Digital_Camera/(C.S)E-night/DSC02647.JPG,char_data/m/DSC02647.JPG_2.jpg,2812,480,640,76,210,286,211,248,False,39
m,29,kaist_dataset/Mixed/Digital_Camera/(C.S)E-night/DSC03031.JPG,char_data/m/DSC03031.JPG_6.jpg,667,480,640,23,188,211,26,55,False,39
m,27,kaist_dataset/Mixed/Digital_Camera/(C.S)E-night/DSC03031.JPG,char_data/m/DSC03031.JPG_7.jpg,621,480,640,23,239,262,28,55,False,39
m,62,kaist_dataset/Mixed/Digital_Camera/(C.S)F-others/DSC02696.JPG,char_data/m/DSC02696.JPG_2.jpg,4836,480,640,78,184,262,314,376,False,39
m,67,kaist_dataset/Mixed/Mobile_Phone/(C.M)A-outdoor/P090912037.jpg,char_data/m/P090912037.jpg_2.jpg,4958,480,640,74,203,277,166,233,False,39
m,72,kaist_dataset/Mixed/Mobile_Phone/(C.M)B-indoor/P090831008.jpg,char_data/m/P090831008.jpg_2.jpg,5904,480,640,82,475,557,316,388,False,39
m,46,kaist_dataset/Mixed/Mobile_Phone/(C.M)B-indoor/P090831010.jpg,char_data/m/P090831010.jpg_2.jpg,2714,480,640,59,499,558,296,342,False,39
m,47,kaist_dataset/Mixed/Mobile_Phone/(C.M)B-indoor/P090831017.jpg,char_data/m/P090831017.jpg_2.jpg,2585,480,640,55,250,305,244,291,False,39
m,41,kaist_dataset/Mixed/Mobile_Phone/(C.M)C-bookCover/P090831124.jpg,char_data/m/P090831124.jpg_2.jpg,1517,480,640,37,281,318,404,445,False,39
m,32,kaist_dataset/Mixed/Mobile_Phone/(C.M)C-bookCover/P090902016.jpg,char_data/m/P090902016.jpg_2.jpg,1184,480,640,37,329,366,278,310,False,39
m,50,kaist_dataset/Mixed/Mobile_Phone/(C.M)C-bookCover/P090902019.jpg,char_data/m/P090902019.jpg_4.jpg,2700,480,640,54,245,299,292,342,False,39
m,51,kaist_dataset/Mixed/Mobile_Phone/(C.M)C-bookCover/P090902019.jpg,char_data/m/P090902019.jpg_5.jpg,3060,480,640,60,544,604,300,351,False,39
m,36,kaist_dataset/Mixed/Mobile_Phone/(C.M)C-bookCover/P090903024.jpg,char_data/m/P090903024.jpg_2.jpg,1692,480,640,47,448,495,173,209,False,39
m,29,kaist_dataset/Mixed/Mobile_Phone/(C.M)C-bookCover/P090904005.jpg,char_data/m/P090904005.jpg_2.jpg,1073,480,640,37,341,378,122,151,False,39
인,30,kaist_dataset/English/Digital_Camera/(E.S)B-light/080116-0059.jpg,char_data/인/080116-0059.jpg_4.jpg,570,1200,1600,19,1022,1041,941,971,True,76
인,30,kaist_dataset/English/Digital_Camera/(E.S)B-light/080116-0059.jpg,char_data/인/080116-0059.jpg_5.jpg,600,1200,1600,20,740,760,993,1023,True,76
인,100,kaist_dataset/Korean/Digital_Camera/A-shadow/DSC03792.JPG,char_data/인/DSC03792.JPG_2.jpg,5900,480,640,59,263,322,256,356,True,76
인,99,kaist_dataset/Korean/Digital_Camera/A-shadow/DSC04315.JPG,char_data/인/DSC04315.JPG_2.jpg,6633,480,640,67,346,413,314,413,True,76
인,86,kaist_dataset/Korean/Digital_Camera/A-shadow/DSC04320.JPG,char_data/인/DSC04320.JPG_2.jpg,3096,480,640,36,232,268,288,374,True,76
인,100,kaist_dataset/Korean/Digital_Camera/B-light/080119-0026.jpg,char_data/인/080119-0026.jpg_2.jpg,7400,1200,1600,74,554,628,1031,1131,True,76
인,29,kaist_dataset/Korean/Digital_Camera/E-night/106.jpg,char_data/인/106.jpg_2.jpg,812,480,640,28,231,259,109,138,True,76
인,64,kaist_dataset/Korean/Digital_Camera/F-bookCover/DSC04218.JPG,char_data/인/DSC04218.JPG_2.jpg,3264,480,640,51,381,432,332,396,True,76
인,93,kaist_dataset/Korean/Digital_Camera/F-bookCover/DSC04232.JPG,char_data/인/DSC04232.JPG_4.jpg,6510,480,640,70,35,105,129,222,True,76
인,85,kaist_dataset/Korean/Digital_Camera/F-bookCover/DSC04232.JPG,char_data/인/DSC04232.JPG_5.jpg,6290,480,640,74,328,402,129,214,True,76
인,57,kaist_dataset/Korean/Digital_Camera/F-bookCover/DSC04235.JPG,char_data/인/DSC04235.JPG_2.jpg,1938,480,640,34,134,168,96,153,True,76
인,83,kaist_dataset/Korean/Digital_Camera/F-bookCover/DSC04240.JPG,char_data/인/DSC04240.JPG_2.jpg,4648,480,640,56,81,137,83,166,True,76
인,92,kaist_dataset/Korean/Digital_Camera/F-bookCover/DSC04241.JPG,char_data/인/DSC04241.JPG_2.jpg,6716,480,640,73,98,171,248,340,True,76
인,113,kaist_dataset/Korean/Digital_Camera/F-bookCover/P090911043.jpg,char_data/인/P090911043.jpg_2.jpg,10170,480,640,90,374,464,197,310,True,76
인,28,kaist_dataset/Korean/Digital_Camera/indoor1/145.JPG,char_data/인/145.JPG_2.jpg,728,480,640,26,83,109,243,271,True,76
인,104,kaist_dataset/Korean/Digital_Camera/indoor1/DSC02705.JPG,char_data/인/DSC02705.JPG_2.jpg,6968,480,640,67,127,194,201,305,True,76
인,62,kaist_dataset/Korean/Digital_Camera/indoor1/DSC02710.JPG,char_data/인/DSC02710.JPG_2.jpg,3534,480,640,57,224,281,402,464,True,76
인,41,kaist_dataset/Korean/Digital_Camera/indoor1/DSC02729.JPG,char_data/인/DSC02729.JPG_2.jpg,1271,480,640,31,350,381,249,290,True,76
인,114,kaist_dataset/Korean/Digital_Camera/indoor1/DSC03348.JPG,char_data/인/DSC03348.JPG_2.jpg,11400,480,640,100,187,287,166,280,True,76
인,63,kaist_dataset/Korean/Digital_Camera/indoor2/DSC03383.JPG,char_data/인/DSC03383.JPG_2.jpg,3843,480,640,61,329,390,321,384,True,76
인,120,kaist_dataset/Korean/Digital_Camera/indoor2/DSC03387.JPG,char_data/인/DSC03387.JPG_2.jpg,8880,480,640,74,232,306,208,328,True,76
인,106,kaist_dataset/Korean/Digital_Camera/indoor2/DSC03700.JPG,char_data/인/DSC03700.JPG_2.jpg,7950,480,640,75,278,353,338,444,True,76
인,114,kaist_dataset/Korean/Digital_Camera/indoor2/DSC03703.JPG,char_data/인/DSC03703.JPG_2.jpg,10602,480,640,93,193,286,224,338,True,76
인,125,kaist_dataset/Korean/Digital_Camera/indoor2/DSC03994.JPG,char_data/인/DSC03994.JPG_2.jpg,8750,480,640,70,293,363,142,267,True,76
인,43,kaist_dataset/Korean/Digital_Camera/indoor2/DSC03995.JPG,char_data/인/DSC03995.JPG_2.jpg,1720,480,640,40,203,243,273,316,True,76
인,45,kaist_dataset/Korean/Digital_Camera/indoor2/DSC04250.JPG,char_data/인/DSC04250.JPG_2.jpg,1755,480,640,39,332,371,254,299,True,76
인,55,kaist_dataset/Korean/Digital_Camera/outdoor1/061.JPG,char_data/인/061.JPG_2.jpg,2035,480,640,37,232,269,204,259,True,76
인,166,kaist_dataset/Korean/Digital_Camera/outdoor2/2007-12-09-day-exterior-008.jpg,char_data/인/2007-12-09-day-exterior-008.jpg_2.jpg,33532,1200,1600,202,801,1003,351,517,True,76
인,37,kaist_dataset/Korean/Digital_Camera/outdoor2/DSC02383.JPG,char_data/인/DSC02383.JPG_2.jpg,666,480,640,18,435,453,279,316,True,76
인,145,kaist_dataset/Korean/Digital_Camera/outdoor2/DSC02412.JPG,char_data/인/DSC02412.JPG_2.jpg,10005,480,640,69,292,361,259,404,True,76
인,40,kaist_dataset/Korean/Digital_Camera/outdoor2/DSC02426.JPG,char_data/인/DSC02426.JPG_2.jpg,1680,480,640,42,58,100,225,265,True,76
인,60,kaist_dataset/Korean/Digital_Camera/outdoor2/DSC02470.JPG,char_data/인/DSC02470.JPG_2.jpg,2100,480,640,35,59,94,377,437,True,76
인,78,kaist_dataset/Korean/Digital_Camera/outdoor3/DSC02900.JPG,char_data/인/DSC02900.JPG_2.jpg,4446,480,640,57,312,369,165,243,True,76
인,87,kaist_dataset/Korean/Digital_Camera/outdoor3/DSC02908.JPG,char_data/인/DSC02908.JPG_2.jpg,7482,480,640,86,311,397,220,307,True,76
인,116,kaist_dataset/Korean/Digital_Camera/outdoor3/DSC02911.JPG,char_data/인/DSC02911.JPG_2.jpg,7772,480,640,67,425,492,150,266,True,76
인,92,kaist_dataset/Korean/Digital_Camera/outdoor3/DSC02951.JPG,char_data/인/DSC02951.JPG_2.jpg,6256,480,640,68,335,403,291,383,True,76
인,105,kaist_dataset/Korean/Digital_Camera/outdoor3/DSC03034.JPG,char_data/인/DSC03034.JPG_2.jpg,7455,480,640,71,373,444,192,297,True,76
인,59,kaist_dataset/Korean/Digital_Camera/outdoor4/DSC03419.JPG,char_data/인/DSC03419.JPG_2.jpg,3245,480,640,55,563,618,213,272,True,76
인,53,kaist_dataset/Korean/Digital_Camera/outdoor4/DSC03538.JPG,char_data/인/DSC03538.JPG_2.jpg,1166,480,640,22,195,217,111,164,True,76
인,82,kaist_dataset/Korean/Digital_Camera/outdoor4/DSC03550.JPG,char_data/인/DSC03550.JPG_2.jpg,5084,480,640,62,335,397,190,272,True,76
인,86,kaist_dataset/Korean/Digital_Camera/outdoor4/DSC03553.JPG,char_data/인/DSC03553.JPG_2.jpg,4558,480,640,53,393,446,48,134,True,76
인,65,kaist_dataset/Korean/Digital_Camera/outdoor4/DSC03566.JPG,char_data/인/DSC03566.JPG_2.jpg,4875,480,640,75,291,366,15,80,True,76
인,67,kaist_dataset/Korean/Digital_Camera/outdoor4/DSC03567.JPG,char_data/인/DSC03567.JPG_2.jpg,4221,480,640,63,266,329,86,153,True,76
인,77,kaist_dataset/Korean/Digital_Camera/outdoor4/DSC03583.JPG,char_data/인/DSC03583.JPG_2.jpg,5005,480,640,65,160,225,253,330,True,76
인,41,kaist_dataset/Korean/Digital_Camera/outdoor4/DSC03588.JPG,char_data/인/DSC03588.JPG_2.jpg,1763,480,640,43,297,340,98,139,True,76
인,65,kaist_dataset/Korean/Digital_Camera/outdoor5/DSC03694.JPG,char_data/인/DSC03694.JPG_2.jpg,3185,480,640,49,449,498,42,107,True,76
인,64,kaist_dataset/Korean/Digital_Camera/outdoor5/DSC03715.JPG,char_data/인/DSC03715.JPG_2.jpg,2560,480,640,40,367,407,175,239,True,76
인,76,kaist_dataset/Korean/Digital_Camera/outdoor5/DSC03727.JPG,char_data/인/DSC03727.JPG_2.jpg,4560,480,640,60,537,597,392,468,True,76
인,41,kaist_dataset/Korean/Digital_Camera/outdoor5/DSC03746.JPG,char_data/인/DSC03746.JPG_2.jpg,1640,480,640,40,344,384,319,360,True,76
인,39,kaist_dataset/Korean/Digital_Camera/outdoor5/DSC03768.JPG,char_data/인/DSC03768.JPG_2.jpg,1443,480,640,37,219,256,236,275,True,76
인,35,kaist_dataset/Korean/Digital_Camera/outdoor5/DSC03777.JPG,char_data/인/DSC03777.JPG_4.jpg,805,480,640,23,34,57,276,311,True,76
인,93,kaist_dataset/Korean/Digital_Camera/outdoor5/DSC03777.JPG,char_data/인/DSC03777.JPG_5.jpg,5859,480,640,63,472,535,289,382,True,76
인,104,kaist_dataset/Korean/Digital_Camera/outdoor5/DSC03833.JPG,char_data/인/DSC03833.JPG_2.jpg,7384,480,640,71,108,179,110,214,True,76
인,86,kaist_dataset/Korean/Digital_Camera/outdoor6/DSC04062.JPG,char_data/인/DSC04062.JPG_2.jpg,5246,480,640,61,372,433,227,313,True,76
인,68,kaist_dataset/Korean/Digital_Camera/outdoor6/DSC04067.JPG,char_data/인/DSC04067.JPG_2.jpg,3468,480,640,51,276,327,179,247,True,76
인,52,kaist_dataset/Korean/Digital_Camera/outdoor6/DSC04089.JPG,char_data/인/DSC04089.JPG_2.jpg,1508,480,640,29,133,162,269,321,True,76
인,43,kaist_dataset/Korean/Digital_Camera/outdoor6/DSC04126.JPG,char_data/인/DSC04126.JPG_2.jpg,1290,480,640,30,376,406,227,270,True,76
인,50,kaist_dataset/Korean/Digital_Camera/outdoor6/DSC04137.JPG,char_data/인/DSC04137.JPG_2.jpg,3200,480,640,64,307,371,403,453,True,76
인,87,kaist_dataset/Korean/Digital_Camera/outdoor6/DSC04308.JPG,char_data/인/DSC04308.JPG_2.jpg,7743,480,640,89,477,566,288,375,True,76
인,62,kaist_dataset/Korean/Digital_Camera/outdoor6/DSC04332.JPG,char_data/인/DSC04332.JPG_2.jpg,3224,480,640,52,140,192,168,230,True,76
인,69,kaist_dataset/Korean/Digital_Camera/outdoor6/DSC04363.JPG,char_data/인/DSC04363.JPG_2.jpg,3864,480,640,56,358,414,183,252,True,76
인,66,kaist_dataset/Korean/Digital_Camera/outdoor7/P1010009.JPG,char_data/인/P1010009.JPG_2.jpg,4422,480,640,67,321,388,155,221,True,76
인,87,kaist_dataset/Korean/Digital_Camera/outdoor7/P1010015.JPG,char_data/인/P1010015.JPG_2.jpg,4524,480,640,52,530,582,207,294,True,76
인,63,kaist_dataset/Korean/Digital_Camera/outdoor7/P1010047.JPG,char_data/인/P1010047.JPG_2.jpg,3654,480,640,58,259,317,191,254,True,76
인,47,kaist_dataset/Korean/Digital_Camera/outdoor7/P1010082.JPG,char_data/인/P1010082.JPG_2.jpg,3243,480,640,69,249,318,143,190,True,76
인,48,kaist_dataset/Korean/Digital_Camera/outdoor7/P1010085.JPG,char_data/인/P1010085.JPG_6.jpg,1392,480,640,29,328,357,61,109,True,76
인,45,kaist_dataset/Korean/Digital_Camera/outdoor7/P1010085.JPG,char_data/인/P1010085.JPG_7.jpg,1305,480,640,29,371,400,61,106,True,76
인,44,kaist_dataset/Korean/Digital_Camera/outdoor7/P1010085.JPG,char_data/인/P1010085.JPG_8.jpg,1364,480,640,31,442,473,60,104,True,76
인,154,kaist_dataset/Korean/Digital_Camera/outdoor7/P1010087.JPG,char_data/인/P1010087.JPG_2.jpg,17710,480,640,115,458,573,278,432,True,76
인,111,kaist_dataset/Korean/Digital_Camera/outdoor7/P1010088.JPG,char_data/인/P1010088.JPG_2.jpg,8769,480,640,79,331,410,31,142,True,76
인,80,kaist_dataset/Korean/Digital_Camera/outdoor7/P1010100.JPG,char_data/인/P1010100.JPG_2.jpg,4640,480,640,58,280,338,125,205,True,76
인,45,kaist_dataset/Korean/Digital_Camera/outdoor7/P1010111.JPG,char_data/인/P1010111.JPG_2.jpg,1440,480,640,32,183,215,218,263,True,76
인,70,kaist_dataset/Korean/Digital_Camera/outdoor8/P1010147.JPG,char_data/인/P1010147.JPG_2.jpg,3990,480,640,57,238,295,208,278,True,76
인,81,kaist_dataset/Korean/Digital_Camera/outdoor8/P1010160.JPG,char_data/인/P1010160.JPG_2.jpg,3807,480,640,47,390,437,54,135,True,76
인,126,"kaist_dataset/Korean/Mobile_Phone/(M,K)E-bookCover/P090831032.jpg",char_data/인/P090831032.jpg_2.jpg,11466,480,640,91,17,108,39,165,True,76
인,200,"kaist_dataset/Korean/Mobile_Phone/(M,K)E-bookCover/P090831064.jpg",char_data/인/P090831064.jpg_2.jpg,28000,480,640,140,106,246,52,252,True,76
인,143,"kaist_dataset/Korean/Mobile_Phone/(M,K)E-bookCover/P090831071.jpg",char_data/인/P090831071.jpg_2.jpg,14586,480,640,102,221,323,299,442,True,76
인,106,"kaist_dataset/Korean/Mobile_Phone/(M,K)E-bookCover/P090831081.jpg",char_data/인/P090831081.jpg_2.jpg,11342,480,640,107,17,124,6,112,True,76
인,181,"kaist_dataset/Korean/Mobile_Phone/(M,K)E-bookCover/P090831129.jpg",char_data/인/P090831129.jpg_2.jpg,19367,480,640,107,61,168,265,446,True,76
인,144,"kaist_dataset/Korean/Mobile_Phone/(M,K)E-bookCover/P090903014.jpg",char_data/인/P090903014.jpg_2.jpg,13824,480,640,96,133,229,165,309,True,76
인,85,"kaist_dataset/Korean/Mobile_Phone/(M,K)E-bookCover/P090912010.jpg",char_data/인/P090912010.jpg_2.jpg,4760,480,640,56,126,182,186,271,True,76
인,103,kaist_dataset/Mixed/Digital_Camera/(C.S)A-shadow/DSC02567.JPG,char_data/인/DSC02567.JPG_4.jpg,4841,480,640,47,335,382,33,136,True,76
인,81,kaist_dataset/Mixed/Digital_Camera/(C.S)A-shadow/DSC03258.JPG,char_data/인/DSC03258.JPG_2.jpg,3888,480,640,48,293,341,357,438,True,76
인,92,kaist_dataset/Mixed/Digital_Camera/(C.S)A-shadow/DSC04304.JPG,char_data/인/DSC04304.JPG_2.jpg,5244,480,640,57,282,339,146,238,True,76
인,148,kaist_dataset/Mixed/Digital_Camera/(C.S)A-shadow/DSC04318.JPG,char_data/인/DSC04318.JPG_2.jpg,11988,480,640,81,276,357,204,352,True,76
인,112,kaist_dataset/Mixed/Digital_Camera/(C.S)C-outdoor1/118.JPG,char_data/인/118.JPG_2.jpg,13104,480,640,117,227,344,121,233,True,76
인,70,kaist_dataset/Mixed/Digital_Camera/(C.S)C-outdoor1/56.JPG,char_data/인/56.JPG_2.jpg,3710,576,768,53,323,376,222,292,True,76
인,71,kaist_dataset/Mixed/Digital_Camera/(C.S)C-outdoor1/DSC02244.JPG,char_data/인/DSC02244.JPG_2.jpg,3550,480,640,50,75,125,247,318,True,76
인,140,kaist_dataset/Mixed/Digital_Camera/(C.S)C-outdoor1/DSC02309.JPG,char_data/인/DSC02309.JPG_6.jpg,17920,480,640,128,239,367,60,200,True,76
인,63,kaist_dataset/Mixed/Digital_Camera/(C.S)C-outdoor1/DSC02309.JPG,char_data/인/DSC02309.JPG_7.jpg,2835,480,640,45,117,162,234,297,True,76
인,39,kaist_dataset/Mixed/Digital_Camera/(C.S)C-outdoor1/DSC02309.JPG,char_data/인/DSC02309.JPG_8.jpg,1443,480,640,37,288,325,390,429,True,76
인,46,kaist_dataset/Mixed/Digital_Camera/(C.S)C-outdoor1/DSC02320.JPG,char_data/인/DSC02320.JPG_4.jpg,1748,480,640,38,295,333,347,393,True,76
인,43,kaist_dataset/Mixed/Digital_Camera/(C.S)C-outdoor1/DSC02320.JPG,char_data/인/DSC02320.JPG_5.jpg,1376,480,640,32,602,634,345,388,True,76
인,42,kaist_dataset/Mixed/Digital_Camera/(C.S)C-outdoor1/DSC02350.JPG,char_data/인/DSC02350.JPG_2.jpg,1722,480,640,41,482,523,271,313,True,76
인,49,kaist_dataset/Mixed/Digital_Camera/(C.S)C-outdoor1/P1010010.JPG,char_data/인/P1010010.JPG_2.jpg,1666,480,640,34,390,424,155,204,True,76
인,74,kaist_dataset/Mixed/Digital_Camera/(C.S)C-outdoor1/P1010012.JPG,char_data/인/P1010012.JPG_2.jpg,4810,480,640,65,554,619,127,201,True,76
인,92,kaist_dataset/Mixed/Digital_Camera/(C.S)C-outdoor2/DSC02422.JPG,char_data/인/DSC02422.JPG_2.jpg,5704,480,640,62,251,313,98,190,True,76
인,72,kaist_dataset/Mixed/Digital_Camera/(C.S)C-outdoor2/DSC02461.JPG,char_data/인/DSC02461.JPG_2.jpg,3816,480,640,53,394,447,185,257,True,76
인,80,kaist_dataset/Mixed/Digital_Camera/(C.S)C-outdoor2/DSC02527.JPG,char_data/인/DSC02527.JPG_2.jpg,5120,480,640,64,82,146,138,218,True,76
인,103,kaist_dataset/Mixed/Digital_Camera/(C.S)C-outdoor2/DSC02567.JPG,char_data/인/DSC02567.JPG_5.jpg,4841,480,640,47,335,382,33,136,True,76
인,100,kaist_dataset/Mixed/Digital_Camera/(C.S)C-outdoor2/DSC02874.JPG,char_data/인/DSC02874.JPG_2.jpg,8300,480,640,83,305,388,209,309,True,76
인,82,kaist_dataset/Mixed/Digital_Camera/(C.S)C-outdoor2/DSC02947.JPG,char_data/인/DSC02947.JPG_2.jpg,6150,480,640,75,191,266,131,213,True,76
인,58,kaist_dataset/Mixed/Digital_Camera/(C.S)C-outdoor3/DSC03185.JPG,char_data/인/DSC03185.JPG_2.jpg,4292,480,640,74,301,375,90,148,True,76
인,49,kaist_dataset/Mixed/Digital_Camera/(C.S)C-outdoor3/DSC03199.JPG,char_data/인/DSC03199.JPG_2.jpg,1715,480,640,35,543,578,380,429,True,76
인,67,kaist_dataset/Mixed/Digital_Camera/(C.S)C-outdoor3/DSC03267.JPG,char_data/인/DSC03267.JPG_2.jpg,5226,480,640,78,276,354,183,250,True,76
인,67,kaist_dataset/Mixed/Digital_Camera/(C.S)C-outdoor3/DSC03303.JPG,char_data/인/DSC03303.JPG_4.jpg,2546,480,640,38,311,349,113,180,True,76
인,83,kaist_dataset/Mixed/Digital_Camera/(C.S)C-outdoor3/DSC03303.JPG,char_data/인/DSC03303.JPG_5.jpg,5644,480,640,68,155,223,203,286,True,76
인,65,kaist_dataset/Mixed/Digital_Camera/(C.S)C-outdoor3/DSC03311.JPG,char_data/인/DSC03311.JPG_2.jpg,3510,480,640,54,220,274,311,376,True,76
인,67,kaist_dataset/Mixed/Digital_Camera/(C.S)C-outdoor4/DSC03433.JPG,char_data/인/DSC03433.JPG_2.jpg,4288,480,640,64,341,405,140,207,True,76
인,127,kaist_dataset/Mixed/Digital_Camera/(C.S)C-outdoor4/DSC03435.JPG,char_data/인/DSC03435.JPG_2.jpg,8382,480,640,66,325,391,277,404,True,76
인,67,kaist_dataset/Mixed/Digital_Camera/(C.S)C-outdoor4/DSC03531.JPG,char_data/인/DSC03531.JPG_2.jpg,3752,480,640,56,151,207,342,409,True,76
인,41,kaist_dataset/Mixed/Digital_Camera/(C.S)C-outdoor4/DSC03634.JPG,char_data/인/DSC03634.JPG_2.jpg,1189,480,640,29,298,327,423,464,True,76
인,38,kaist_dataset/Mixed/Digital_Camera/(C.S)C-outdoor4/DSC03644.JPG,char_data/인/DSC03644.JPG_2.jpg,1330,480,640,35,71,106,275,313,True,76
인,36,kaist_dataset/Mixed/Digital_Camera/(C.S)C-outdoor4/DSC03691.JPG,char_data/인/DSC03691.JPG_2.jpg,1152,480,640,32,259,291,223,259,True,76
인,78,kaist_dataset/Mixed/Digital_Camera/(C.S)C-outdoor4/DSC03718.JPG,char_data/인/DSC03718.JPG_2.jpg,3900,480,640,50,542,592,305,383,True,76
인,80,kaist_dataset/Mixed/Digital_Camera/(C.S)C-outdoor4/DSC03719.JPG,char_data/인/DSC03719.JPG_2.jpg,4880,480,640,61,549,610,80,160,True,76
인,90,kaist_dataset/Mixed/Digital_Camera/(C.S)C-outdoor4/DSC03758.JPG,char_data/인/DSC03758.JPG_2.jpg,9540,480,640,106,267,373,117,207,False,76
인,70,kaist_dataset/Mixed/Digital_Camera/(C.S)C-outdoor4/DSC03764.JPG,char_data/인/DSC03764.JPG_2.jpg,8330,480,640,119,318,437,45,115,False,76
인,39,kaist_dataset/Mixed/Digital_Camera/(C.S)C-outdoor5/DSC04057.JPG,char_data/인/DSC04057.JPG_2.jpg,1560,480,640,40,234,274,328,367,False,76
인,74,kaist_dataset/Mixed/Digital_Camera/(C.S)C-outdoor5/DSC04061.JPG,char_data/인/DSC04061.JPG_2.jpg,4884,480,640,66,249,315,32,106,False,76
인,75,kaist_dataset/Mixed/Digital_Camera/(C.S)C-outdoor5/DSC04091.JPG,char_data/인/DSC04091.JPG_2.jpg,4050,480,640,54,169,223,323,398,False,76
인,51,kaist_dataset/Mixed/Digital_Camera/(C.S)C-outdoor5/DSC04108.JPG,char_data/인/DSC04108.JPG_2.jpg,2244,480,640,44,319,363,185,236,False,76
인,75,kaist_dataset/Mixed/Digital_Camera/(C.S)C-outdoor5/DSC04140.JPG,char_data/인/DSC04140.JPG_2.jpg,5400,480,640,72,235,307,322,397,False,76
인,65,kaist_dataset/Mixed/Digital_Camera/(C.S)C-outdoor5/DSC04290.JPG,char_data/인/DSC04290.JPG_2.jpg,3055,480,640,47,344,391,212,277,False,76
인,68,kaist_dataset/Mixed/Digital_Camera/(C.S)C-outdoor5/DSC04395.JPG,char_data/인/DSC04395.JPG_2.jpg,3196,480,640,47,308,355,341,409,False,76
인,76,kaist_dataset/Mixed/Digital_Camera/(C.S)C-outdoor5/DSC04401.JPG,char_data/인/DSC04401.JPG_2.jpg,4864,480,640,64,293,357,13,89,False,76
인,75,kaist_dataset/Mixed/Digital_Camera/(C.S)C-outdoor5/DSC04450.JPG,char_data/인/DSC04450.JPG_2.jpg,4350,480,640,58,515,573,132,207,False,76
인,49,kaist_dataset/Mixed/Digital_Camera/(C.S)C-outdoor6/P1010021.JPG,char_data/인/P1010021.JPG_2.jpg,1715,480,640,35,246,281,351,400,False,76
인,93,kaist_dataset/Mixed/Digital_Camera/(C.S)C-outdoor6/P1010045.JPG,char_data/인/P1010045.JPG_2.jpg,6882,480,640,74,206,280,284,377,False,76
인,109,kaist_dataset/Mixed/Digital_Camera/(C.S)C-outdoor6/P1010055.JPG,char_data/인/P1010055.JPG_2.jpg,10355,480,640,95,269,364,121,230,False,76
인,35,kaist_dataset/Mixed/Digital_Camera/(C.S)C-outdoor6/P1010073.JPG,char_data/인/P1010073.JPG_2.jpg,910,480,640,26,157,183,235,270,False,76
인,69,kaist_dataset/Mixed/Digital_Camera/(C.S)C-outdoor6/P1010090.JPG,char_data/인/P1010090.JPG_2.jpg,5106,480,640,74,291,365,124,193,False,76
인,67,kaist_dataset/Mixed/Digital_Camera/(C.S)C-outdoor6/크기변환_20040626112330924_im_orz6564_netdkwk.jpg,char_data/인/크기변환_20040626112330924_im_orz6564_netdkwk.jpg_2.jpg,3283,480,640,49,279,328,224,291,False,76
인,70,kaist_dataset/Mixed/Digital_Camera/(C.S)D-indoor1/DSC02776.JPG,char_data/인/DSC02776.JPG_2.jpg,5110,480,640,73,274,347,216,286,False,76
인,68,kaist_dataset/Mixed/Digital_Camera/(C.S)D-indoor1/DSC03986.JPG,char_data/인/DSC03986.JPG_2.jpg,3128,480,640,46,348,394,58,126,False,76
인,56,kaist_dataset/Mixed/Digital_Camera/(C.S)D-indoor1/DSC04223.JPG,char_data/인/DSC04223.JPG_2.jpg,3528,480,640,63,192,255,284,340,False,76
인,147,kaist_dataset/Mixed/Digital_Camera/(C.S)D-indoor1/DSC04233.JPG,char_data/인/DSC04233.JPG_2.jpg,16611,480,640,113,97,210,179,326,False,76
인,47,kaist_dataset/Mixed/Digital_Camera/(C.S)E-night/DSC02585.JPG,char_data/인/DSC02585.JPG_2.jpg,1551,480,640,33,214,247,404,451,False,76
인,41,kaist_dataset/Mixed/Digital_Camera/(C.S)E-night/DSC03561.JPG,char_data/인/DSC03561.JPG_2.jpg,1353,480,640,33,109,142,35,76,False,76
인,104,kaist_dataset/Mixed/Digital_Camera/(C.S)E-night/P1010151.JPG,char_data/인/P1010151.JPG_2.jpg,3744,480,640,36,451,487,243,347,False,76
인,64,kaist_dataset/Mixed/Digital_Camera/(C.S)E-night/P1010152.JPG,char_data/인/P1010152.JPG_2.jpg,3520,480,640,55,115,170,65,129,False,76
인,65,kaist_dataset/Mixed/Digital_Camera/(C.S)F-others/2007-12-08-day-113.jpg,char_data/인/2007-12-08-day-113.jpg_2.jpg,3250,1200,1600,50,427,477,835,900,False,76
인,72,kaist_dataset/Mixed/Digital_Camera/(C.S)F-others/DSC02893.JPG,char_data/인/DSC02893.JPG_2.jpg,5184,480,640,72,250,322,184,256,False,76
인,178,kaist_dataset/Mixed/Mobile_Phone/(C.M)C-bookCover/P090831119.jpg,char_data/인/P090831119.jpg_2.jpg,24920,480,640,140,359,499,11,189,False,76
인,135,kaist_dataset/Mixed/Mobile_Phone/(C.M)C-bookCover/P090903083.jpg,char_data/인/P090903083.jpg_2.jpg,12690,480,640,94,116,210,25,160,False,76
h,58,kaist_dataset/English/Digital_Camera/(E.S)A-shadow/DSC03075.JPG,char_data/h/DSC03075.JPG_2.jpg,1450,480,640,25,123,148,342,400,True,36
h,65,kaist_dataset/English/Digital_Camera/(E.S)A-shadow/DSC03079.JPG,char_data/h/DSC03079.JPG_2.jpg,1690,480,640,26,279,305,321,386,True,36
h,57,kaist_dataset/English/Digital_Camera/(E.S)A-shadow/DSC03082.JPG,char_data/h/DSC03082.JPG_2.jpg,1539,480,640,27,294,321,371,428,True,36
h,92,kaist_dataset/English/Digital_Camera/(E.S)B-light/DSC02587.JPG,char_data/h/DSC02587.JPG_5.jpg,5796,480,640,63,434,497,195,287,True,36
h,39,kaist_dataset/English/Digital_Camera/(E.S)C-outdoor1/031.JPG,char_data/h/031.JPG_11.jpg,1560,480,640,40,302,342,397,436,True,36
h,59,kaist_dataset/English/Digital_Camera/(E.S)C-outdoor1/076.JPG,char_data/h/076.JPG_4.jpg,2360,480,640,40,382,422,207,266,True,36
h,20,kaist_dataset/English/Digital_Camera/(E.S)C-outdoor1/076.JPG,char_data/h/076.JPG_5.jpg,120,480,640,6,592,598,318,338,True,36
h,110,kaist_dataset/English/Digital_Camera/(E.S)C-outdoor1/080116-0064.jpg,char_data/h/080116-0064.jpg_2.jpg,4510,600,800,41,422,463,227,337,True,36
h,76,kaist_dataset/English/Digital_Camera/(E.S)C-outdoor1/1.jpg,char_data/h/1.jpg_8.jpg,3876,480,640,51,445,496,111,187,True,36
h,140,kaist_dataset/English/Digital_Camera/(E.S)C-outdoor1/2007-12-08-day-111.jpg,char_data/h/2007-12-08-day-111.jpg_2.jpg,12460,1200,1600,89,868,957,461,601,True,36
h,81,kaist_dataset/English/Digital_Camera/(E.S)C-outdoor1/7.jpg,char_data/h/7.jpg_2.jpg,4374,574,680,54,261,315,250,331,True,36
h,54,kaist_dataset/English/Digital_Camera/(E.S)C-outdoor1/DSC02355.JPG,char_data/h/DSC02355.JPG_2.jpg,1350,480,640,25,105,130,297,351,True,36
h,50,kaist_dataset/English/Digital_Camera/(E.S)C-outdoor1/DSC02356.JPG,char_data/h/DSC02356.JPG_2.jpg,1200,480,640,24,345,369,298,348,True,36
h,55,kaist_dataset/English/Digital_Camera/(E.S)C-outdoor1/DSC02500.JPG,char_data/h/DSC02500.JPG_2.jpg,1870,480,640,34,557,591,285,340,True,36
h,132,kaist_dataset/English/Digital_Camera/(E.S)C-outdoor1/DSC02914.JPG,char_data/h/DSC02914.JPG_2.jpg,13860,480,640,105,354,459,183,315,True,36
h,91,kaist_dataset/English/Digital_Camera/(E.S)C-outdoor2/DSC02990.JPG,char_data/h/DSC02990.JPG_2.jpg,6279,480,640,69,125,194,148,239,True,36
h,41,kaist_dataset/English/Digital_Camera/(E.S)C-outdoor2/DSC03162.JPG,char_data/h/DSC03162.JPG_2.jpg,984,480,640,24,202,226,144,185,True,36
h,47,kaist_dataset/English/Digital_Camera/(E.S)C-outdoor2/DSC03203.JPG,char_data/h/DSC03203.JPG_5.jpg,1457,480,640,31,133,164,421,468,True,36
h,45,kaist_dataset/English/Digital_Camera/(E.S)C-outdoor2/DSC03225.JPG,char_data/h/DSC03225.JPG_2.jpg,1260,480,640,28,424,452,77,122,True,36
h,59,kaist_dataset/English/Digital_Camera/(E.S)C-outdoor2/DSC03262.JPG,char_data/h/DSC03262.JPG_2.jpg,2124,480,640,36,195,231,128,187,True,36
h,101,kaist_dataset/English/Digital_Camera/(E.S)C-outdoor2/DSC03276.JPG,char_data/h/DSC03276.JPG_2.jpg,7878,480,640,78,512,590,310,411,True,36
h,58,kaist_dataset/English/Digital_Camera/(E.S)C-outdoor2/DSC03290.JPG,char_data/h/DSC03290.JPG_2.jpg,1798,480,640,31,226,257,196,254,True,36
h,127,kaist_dataset/English/Digital_Camera/(E.S)C-outdoor2/DSC03300.JPG,char_data/h/DSC03300.JPG_2.jpg,7366,480,640,58,244,302,118,245,True,36
h,57,kaist_dataset/English/Digital_Camera/(E.S)C-outdoor2/DSC03440.JPG,char_data/h/DSC03440.JPG_2.jpg,2223,480,640,39,344,383,20,77,True,36
h,45,kaist_dataset/English/Digital_Camera/(E.S)C-outdoor2/DSC03664.JPG,char_data/h/DSC03664.JPG_2.jpg,1440,480,640,32,141,173,21,66,True,36
h,139,kaist_dataset/English/Digital_Camera/(E.S)C-outdoor2/DSC03786.JPG,char_data/h/DSC03786.JPG_5.jpg,11120,480,640,80,528,608,163,302,True,36
h,58,kaist_dataset/English/Digital_Camera/(E.S)C-outdoor2/DSC04035.JPG,char_data/h/DSC04035.JPG_4.jpg,1972,480,640,34,93,127,187,245,True,36
h,51,kaist_dataset/English/Digital_Camera/(E.S)C-outdoor2/DSC04035.JPG,char_data/h/DSC04035.JPG_5.jpg,1632,480,640,32,289,321,192,243,True,36
h,70,kaist_dataset/English/Digital_Camera/(E.S)C-outdoor2/DSC04052.JPG,char_data/h/DSC04052.JPG_2.jpg,2800,480,640,40,266,306,159,229,True,36
h,55,kaist_dataset/English/Digital_Camera/(E.S)C-outdoor2/DSC04064.JPG,char_data/h/DSC04064.JPG_2.jpg,1595,480,640,29,71,100,121,176,True,36
h,37,kaist_dataset/English/Digital_Camera/(E.S)C-outdoor2/DSC04079.JPG,char_data/h/DSC04079.JPG_2.jpg,962,480,640,26,165,191,158,195,True,36
h,93,kaist_dataset/English/Digital_Camera/(E.S)C-outdoor2/DSC04160.JPG,char_data/h/DSC04160.JPG_2.jpg,5394,480,640,58,116,174,345,438,True,36
h,84,kaist_dataset/English/Digital_Camera/(E.S)C-outdoor2/DSC04397.JPG,char_data/h/DSC04397.JPG_2.jpg,4452,480,640,53,163,216,106,190,True,36
h,27,kaist_dataset/English/Digital_Camera/(E.S)C-outdoor2/DSC04437.JPG,char_data/h/DSC04437.JPG_2.jpg,351,480,640,13,254,267,77,104,True,36
h,160,kaist_dataset/English/Digital_Camera/(E.S)C-outdoor2/DSC04458.JPG,char_data/h/DSC04458.JPG_2.jpg,15040,480,640,94,346,440,113,273,True,36
h,25,kaist_dataset/English/Digital_Camera/(E.S)C-outdoor3/P1010123.JPG,char_data/h/P1010123.JPG_4.jpg,450,480,640,18,564,582,103,128,True,36
h,36,kaist_dataset/English/Digital_Camera/(E.S)C-outdoor3/P1010123.JPG,char_data/h/P1010123.JPG_5.jpg,684,480,640,19,68,87,105,141,True,36
h,28,kaist_dataset/English/Digital_Camera/(E.S)C-outdoor3/크기변환_P1010076.JPG,char_data/h/크기변환_P1010076.JPG_2.jpg,308,480,640,11,293,304,99,127,True,36
h,101,kaist_dataset/English/Digital_Camera/(E.S)D-indoor/DSC02862.JPG,char_data/h/DSC02862.JPG_2.jpg,6666,480,640,66,426,492,221,322,True,36
h,58,kaist_dataset/English/Digital_Camera/(E.S)D-indoor/DSC03078.JPG,char_data/h/DSC03078.JPG_6.jpg,1856,480,640,32,103,135,225,283,True,36
h,54,kaist_dataset/English/Digital_Camera/(E.S)D-indoor/DSC03078.JPG,char_data/h/DSC03078.JPG_7.jpg,1782,480,640,33,299,332,226,280,True,36
h,99,kaist_dataset/English/Digital_Camera/(E.S)D-indoor/DSC03080.JPG,char_data/h/DSC03080.JPG_4.jpg,5346,480,640,54,128,182,340,439,True,36
h,93,kaist_dataset/English/Digital_Camera/(E.S)D-indoor/DSC03080.JPG,char_data/h/DSC03080.JPG_5.jpg,6045,480,640,65,444,509,344,437,True,36
h,78,kaist_dataset/English/Digital_Camera/(E.S)D-indoor/DSC03087.JPG,char_data/h/DSC03087.JPG_2.jpg,3432,480,640,44,255,299,358,436,True,36
h,41,kaist_dataset/English/Digital_Camera/(E.S)D-indoor/DSC03090.JPG,char_data/h/DSC03090.JPG_2.jpg,861,480,640,21,227,248,237,278,True,36
h,74,kaist_dataset/English/Digital_Camera/(E.S)D-indoor/DSC03091.JPG,char_data/h/DSC03091.JPG_2.jpg,3256,480,640,44,134,178,113,187,True,36
h,40,kaist_dataset/English/Digital_Camera/(E.S)D-indoor/DSC03144.JPG,char_data/h/DSC03144.JPG_8.jpg,880,480,640,22,141,163,233,273,True,36
h,42,kaist_dataset/English/Digital_Camera/(E.S)D-indoor/DSC03144.JPG,char_data/h/DSC03144.JPG_9.jpg,882,480,640,21,262,283,233,275,True,36
h,39,kaist_dataset/English/Digital_Camera/(E.S)D-indoor/DSC03144.JPG,char_data/h/DSC03144.JPG_10.jpg,936,480,640,24,134,158,285,324,True,36
h,40,kaist_dataset/English/Digital_Camera/(E.S)D-indoor/DSC03144.JPG,char_data/h/DSC03144.JPG_11.jpg,880,480,640,22,258,280,286,326,True,36
h,66,kaist_dataset/English/Digital_Camera/(E.S)D-indoor/DSC03441.JPG,char_data/h/DSC03441.JPG_2.jpg,2970,480,640,45,379,424,378,444,True,36
h,37,kaist_dataset/English/Digital_Camera/(E.S)D-indoor/DSC04023.JPG,char_data/h/DSC04023.JPG_6.jpg,962,480,640,26,68,94,301,338,True,36
h,33,kaist_dataset/English/Digital_Camera/(E.S)D-indoor/DSC04023.JPG,char_data/h/DSC04023.JPG_7.jpg,957,480,640,29,140,169,309,342,True,36
h,37,kaist_dataset/English/Digital_Camera/(E.S)D-indoor/DSC04023.JPG,char_data/h/DSC04023.JPG_8.jpg,925,480,640,25,507,532,326,363,True,36
h,132,kaist_dataset/English/Digital_Camera/(E.S)E-night/080116-0056.jpg,char_data/h/080116-0056.jpg_2.jpg,10956,1200,1600,83,852,935,516,648,True,36
h,43,kaist_dataset/English/Digital_Camera/(E.S)F-others/080119-0007.jpg,char_data/h/080119-0007.jpg_4.jpg,1032,1200,1600,24,762,786,910,953,True,36
h,43,kaist_dataset/English/Digital_Camera/(E.S)F-others/080119-0007.jpg,char_data/h/080119-0007.jpg_5.jpg,1032,1200,1600,24,834,858,895,938,True,36
h,40,kaist_dataset/English/Digital_Camera/(E.S)F-others/DSC03218.JPG,char_data/h/DSC03218.JPG_2.jpg,1040,480,640,26,201,227,320,360,True,36
h,101,kaist_dataset/English/Digital_Camera/(E.S)F-others/크기변환_%B0%A3%C6%C72_ktimt007.jpg,char_data/h/크기변환_%B0%A3%C6%C72_ktimt007.jpg_2.jpg,4848,480,640,48,87,135,228,329,True,36
h,68,kaist_dataset/English/Mobile_Phone/(E.M)B-indoor/P090902018.jpg,char_data/h/P090902018.jpg_2.jpg,2652,480,640,39,412,451,300,368,True,36
h,62,kaist_dataset/English/Mobile_Phone/(E.M)B-indoor/P090911067.jpg,char_data/h/P090911067.jpg_2.jpg,2170,480,640,35,314,349,219,281,True,36
h,118,kaist_dataset/English/Mobile_Phone/(E.M)B-indoor/P090911086.jpg,char_data/h/P090911086.jpg_5.jpg,7906,480,640,67,156,223,210,328,True,36
h,90,kaist_dataset/English/Mobile_Phone/(E.M)C-bookCover/P090831039.jpg,char_data/h/P090831039.jpg_2.jpg,5670,480,640,63,143,206,20,110,True,36
h,132,kaist_dataset/English/Mobile_Phone/(E.M)C-bookCover/P090831077.jpg,char_data/h/P090831077.jpg_2.jpg,9768,480,640,74,108,182,238,370,True,36
h,143,kaist_dataset/Korean/Digital_Camera/A-shadow/2007-12-09-day-exterior-025.jpg,char_data/h/2007-12-09-day-exterior-025.jpg_2.jpg,11583,1200,1600,81,97,178,638,781,True,36
h,57,kaist_dataset/Korean/Digital_Camera/G-others/080119-0005.jpg,char_data/h/080119-0005.jpg_2.jpg,1824,1600,1200,32,580,612,1142,1199,True,36
h,23,kaist_dataset/Korean/Digital_Camera/outdoor1/001.JPG,char_data/h/001.JPG_2.jpg,276,480,640,12,106,118,244,267,True,36
h,86,kaist_dataset/Korean/Digital_Camera/outdoor2/2007-12-08-day-101.jpg,char_data/h/2007-12-08-day-101.jpg_7.jpg,4300,1200,1600,50,453,503,353,439,True,36
h,34,kaist_dataset/Korean/Digital_Camera/outdoor6/DSC04292.JPG,char_data/h/DSC04292.JPG_2.jpg,748,480,640,22,116,138,53,87,True,36
h,43,kaist_dataset/Mixed/Digital_Camera/(C.S)A-shadow/DSC02609.JPG,char_data/h/DSC02609.JPG_4.jpg,860,480,640,20,288,308,306,349,True,36
h,62,kaist_dataset/Mixed/Digital_Camera/(C.S)A-shadow/DSC03207.JPG,char_data/h/DSC03207.JPG_2.jpg,2418,480,640,39,556,595,202,264,True,36
h,30,kaist_dataset/Mixed/Digital_Camera/(C.S)C-outdoor1/003.JPG,char_data/h/003.JPG_2.jpg,300,480,640,10,387,397,251,281,True,36
h,44,kaist_dataset/Mixed/Digital_Camera/(C.S)C-outdoor1/1.JPG,char_data/h/1.JPG_9.jpg,1144,576,768,26,425,451,2,46,True,36
h,39,kaist_dataset/Mixed/Digital_Camera/(C.S)C-outdoor1/1.JPG,char_data/h/1.JPG_10.jpg,975,576,768,25,716,741,7,46,True,36
h,36,kaist_dataset/Mixed/Digital_Camera/(C.S)C-outdoor1/115.JPG,char_data/h/115.JPG_2.jpg,756,480,640,21,206,227,274,310,True,36
h,34,kaist_dataset/Mixed/Digital_Camera/(C.S)C-outdoor1/133.JPG,char_data/h/133.JPG_2.jpg,850,480,640,25,516,541,338,372,True,36
h,32,kaist_dataset/Mixed/Digital_Camera/(C.S)C-outdoor1/2.JPG,char_data/h/2.JPG_5.jpg,256,576,768,8,62,70,379,411,True,36
h,63,kaist_dataset/Mixed/Digital_Camera/(C.S)C-outdoor1/2007-12-09-day-exterior-004.jpg,char_data/h/2007-12-09-day-exterior-004.jpg_2.jpg,2898,1200,1600,46,387,433,662,725,True,36
h,78,kaist_dataset/Mixed/Digital_Camera/(C.S)C-outdoor1/2007-12-09-day-exterior-044.jpg,char_data/h/2007-12-09-day-exterior-044.jpg_2.jpg,4836,1200,1600,62,1018,1080,811,889,True,36
h,33,kaist_dataset/Mixed/Digital_Camera/(C.S)C-outdoor1/DSC02242.JPG,char_data/h/DSC02242.JPG_2.jpg,561,480,640,17,237,254,164,197,True,36
h,24,kaist_dataset/Mixed/Digital_Camera/(C.S)C-outdoor1/DSC02319.JPG,char_data/h/DSC02319.JPG_2.jpg,432,480,640,18,101,119,276,300,True,36
h,56,kaist_dataset/Mixed/Digital_Camera/(C.S)C-outdoor2/DSC02400.JPG,char_data/h/DSC02400.JPG_2.jpg,2128,480,640,38,279,317,312,368,True,36
h,48,kaist_dataset/Mixed/Digital_Camera/(C.S)C-outdoor2/DSC02411.JPG,char_data/h/DSC02411.JPG_5.jpg,1056,480,640,22,165,187,349,397,True,36
h,20,kaist_dataset/Mixed/Digital_Camera/(C.S)C-outdoor2/DSC02430.JPG,char_data/h/DSC02430.JPG_2.jpg,300,480,640,15,24,39,29,49,True,36
h,23,kaist_dataset/Mixed/Digital_Camera/(C.S)C-outdoor2/DSC02483.JPG,char_data/h/DSC02483.JPG_7.jpg,414,480,640,18,358,376,152,175,True,36
h,29,kaist_dataset/Mixed/Digital_Camera/(C.S)C-outdoor2/DSC02483.JPG,char_data/h/DSC02483.JPG_8.jpg,522,480,640,18,419,437,147,176,True,36
h,34,kaist_dataset/Mixed/Digital_Camera/(C.S)C-outdoor2/DSC02511.JPG,char_data/h/DSC02511.JPG_2.jpg,782,480,640,23,187,210,205,239,True,36
h,34,kaist_dataset/Mixed/Digital_Camera/(C.S)C-outdoor2/DSC02545.JPG,char_data/h/DSC02545.JPG_2.jpg,884,480,640,26,249,275,365,399,True,36
h,30,kaist_dataset/Mixed/Digital_Camera/(C.S)C-outdoor2/DSC02886.JPG,char_data/h/DSC02886.JPG_5.jpg,780,480,640,26,436,462,136,166,True,36
h,51,kaist_dataset/Mixed/Digital_Camera/(C.S)C-outdoor3/DSC02962.JPG,char_data/h/DSC02962.JPG_2.jpg,1887,480,640,37,171,208,206,257,True,36
h,68,kaist_dataset/Mixed/Digital_Camera/(C.S)C-outdoor3/DSC03047.JPG,char_data/h/DSC03047.JPG_2.jpg,1768,480,640,26,278,304,186,254,True,36
h,30,kaist_dataset/Mixed/Digital_Camera/(C.S)C-outdoor3/DSC03271.JPG,char_data/h/DSC03271.JPG_2.jpg,600,480,640,20,298,318,113,143,True,36
h,59,kaist_dataset/Mixed/Digital_Camera/(C.S)C-outdoor3/DSC03310.JPG,char_data/h/DSC03310.JPG_2.jpg,1298,480,640,22,267,289,112,171,True,36
h,87,kaist_dataset/Mixed/Digital_Camera/(C.S)C-outdoor3/DSC03421.JPG,char_data/h/DSC03421.JPG_7.jpg,3045,480,640,35,514,549,238,325,True,36
h,38,kaist_dataset/Mixed/Digital_Camera/(C.S)C-outdoor4/DSC03556.JPG,char_data/h/DSC03556.JPG_2.jpg,608,480,640,16,239,255,316,354,True,36
h,48,kaist_dataset/Mixed/Digital_Camera/(C.S)C-outdoor4/DSC03586.JPG,char_data/h/DSC03586.JPG_2.jpg,1104,480,640,23,302,325,150,198,True,36
h,99,kaist_dataset/Mixed/Digital_Camera/(C.S)C-outdoor4/DSC03635.JPG,char_data/h/DSC03635.JPG_2.jpg,5940,480,640,60,271,331,149,248,True,36
h,102,kaist_dataset/Mixed/Digital_Camera/(C.S)C-outdoor4/DSC03638.JPG,char_data/h/DSC03638.JPG_2.jpg,5100,480,640,50,281,331,108,210,True,36
h,30,kaist_dataset/Mixed/Digital_Camera/(C.S)C-outdoor4/DSC03667.JPG,char_data/h/DSC03667.JPG_2.jpg,540,480,640,18,164,182,380,410,True,36
h,39,kaist_dataset/Mixed/Digital_Camera/(C.S)C-outdoor4/DSC03682.JPG,char_data/h/DSC03682.JPG_2.jpg,897,480,640,23,351,374,319,358,True,36
h,35,kaist_dataset/Mixed/Digital_Camera/(C.S)C-outdoor4/DSC03718.JPG,char_data/h/DSC03718.JPG_9.jpg,525,480,640,15,353,368,94,129,True,36
h,33,kaist_dataset/Mixed/Digital_Camera/(C.S)C-outdoor4/DSC03718.JPG,char_data/h/DSC03718.JPG_11.jpg,561,480,640,17,192,209,256,289,True,36
h,36,kaist_dataset/Mixed/Digital_Camera/(C.S)C-outdoor4/DSC03719.JPG,char_data/h/DSC03719.JPG_5.jpg,540,480,640,15,201,216,29,65,True,36
h,49,kaist_dataset/Mixed/Digital_Camera/(C.S)C-outdoor4/DSC03781.JPG,char_data/h/DSC03781.JPG_5.jpg,1911,480,640,39,411,450,264,313,True,36
h,74,kaist_dataset/Mixed/Digital_Camera/(C.S)C-outdoor4/DSC03784.JPG,char_data/h/DSC03784.JPG_2.jpg,2738,480,640,37,83,120,309,383,True,36
h,43,kaist_dataset/Mixed/Digital_Camera/(C.S)C-outdoor5/DSC03821.JPG,char_data/h/DSC03821.JPG_2.jpg,1032,480,640,24,347,371,33,76,True,36
h,29,kaist_dataset/Mixed/Digital_Camera/(C.S)C-outdoor5/DSC04076.JPG,char_data/h/DSC04076.JPG_2.jpg,696,480,640,24,380,404,396,425,True,36
h,64,kaist_dataset/Mixed/Digital_Camera/(C.S)C-outdoor5/DSC04097.JPG,char_data/h/DSC04097.JPG_2.jpg,2048,480,640,32,210,242,174,238,True,36
h,30,kaist_dataset/Mixed/Digital_Camera/(C.S)C-outdoor5/DSC04125.JPG,char_data/h/DSC04125.JPG_2.jpg,480,480,640,16,154,170,428,458,True,36
h,129,kaist_dataset/Mixed/Digital_Camera/(C.S)C-outdoor5/DSC04128.JPG,char_data/h/DSC04128.JPG_2.jpg,9159,480,640,71,212,283,159,288,True,36
h,33,kaist_dataset/Mixed/Digital_Camera/(C.S)C-outdoor5/DSC04290.JPG,char_data/h/DSC04290.JPG_2.jpg,594,480,640,18,117,135,379,412,True,36
h,42,kaist_dataset/Mixed/Digital_Camera/(C.S)C-outdoor5/DSC04321.JPG,char_data/h/DSC04321.JPG_2.jpg,1092,480,640,26,53,79,185,227,True,36
h,41,kaist_dataset/Mixed/Digital_Camera/(C.S)C-outdoor5/DSC04322.JPG,char_data/h/DSC04322.JPG_2.jpg,984,480,640,24,482,506,222,263,True,36
h,96,kaist_dataset/Mixed/Digital_Camera/(C.S)C-outdoor5/DSC04349.JPG,char_data/h/DSC04349.JPG_2.jpg,6240,480,640,65,117,182,83,179,True,36
h,27,kaist_dataset/Mixed/Digital_Camera/(C.S)C-outdoor5/DSC04357.JPG,char_data/h/DSC04357.JPG_2.jpg,459,480,640,17,201,218,353,380,False,36
h,36,kaist_dataset/Mixed/Digital_Camera/(C.S)C-outdoor5/DSC04429.JPG,char_data/h/DSC04429.JPG_2.jpg,756,480,640,21,299,320,254,290,False,36
h,50,kaist_dataset/Mixed/Digital_Camera/(C.S)C-outdoor5/DSC04456.JPG,char_data/h/DSC04456.JPG_4.jpg,1650,480,640,33,176,209,169,219,False,36
h,45,kaist_dataset/Mixed/Digital_Camera/(C.S)C-outdoor5/DSC04456.JPG,char_data/h/DSC04456.JPG_5.jpg,1440,480,640,32,417,449,170,215,False,36
h,26,kaist_dataset/Mixed/Digital_Camera/(C.S)C-outdoor6/P1010065.JPG,char_data/h/P1010065.JPG_2.jpg,338,480,640,13,255,268,229,255,False,36
h,43,kaist_dataset/Mixed/Digital_Camera/(C.S)C-outdoor6/P1010085.JPG,char_data/h/P1010085.JPG_2.jpg,903,480,640,21,77,98,126,169,False,36
h,34,kaist_dataset/Mixed/Digital_Camera/(C.S)C-outdoor6/P1010138.JPG,char_data/h/P1010138.JPG_2.jpg,748,480,640,22,224,246,175,209,False,36
h,59,kaist_dataset/Mixed/Digital_Camera/(C.S)D-indoor1/082.JPG,char_data/h/082.JPG_2.jpg,1652,480,640,28,387,415,166,225,False,36
h,49,kaist_dataset/Mixed/Digital_Camera/(C.S)D-indoor1/DSC02787.JPG,char_data/h/DSC02787.JPG_2.jpg,980,480,640,20,99,119,378,427,False,36
h,46,kaist_dataset/Mixed/Digital_Camera/(C.S)D-indoor1/DSC03118.JPG,char_data/h/DSC03118.JPG_2.jpg,1288,480,640,28,361,389,219,265,False,36
h,50,kaist_dataset/Mixed/Digital_Camera/(C.S)D-indoor1/DSC03121.JPG,char_data/h/DSC03121.JPG_2.jpg,1500,480,640,30,297,327,198,248,False,36
h,46,kaist_dataset/Mixed/Digital_Camera/(C.S)D-indoor1/DSC03123.JPG,char_data/h/DSC03123.JPG_5.jpg,1610,480,640,35,281,316,180,226,False,36
h,48,kaist_dataset/Mixed/Digital_Camera/(C.S)D-indoor1/DSC03129.JPG,char_data/h/DSC03129.JPG_2.jpg,1104,480,640,23,287,310,201,249,False,36
h,48,kaist_dataset/Mixed/Digital_Camera/(C.S)D-indoor1/DSC03131.JPG,char_data/h/DSC03131.JPG_2.jpg,1248,480,640,26,257,283,125,173,False,36
h,40,kaist_dataset/Mixed/Digital_Camera/(C.S)D-indoor1/DSC03132.JPG,char_data/h/DSC03132.JPG_2.jpg,1000,480,640,25,312,337,177,217,False,36
h,49,kaist_dataset/Mixed/Digital_Camera/(C.S)D-indoor1/DSC03133.JPG,char_data/h/DSC03133.JPG_2.jpg,1764,480,640,36,384,420,146,195,False,36
h,43,kaist_dataset/Mixed/Digital_Camera/(C.S)D-indoor1/DSC03134.JPG,char_data/h/DSC03134.JPG_2.jpg,1075,480,640,25,354,379,168,211,False,36
h,66,kaist_dataset/Mixed/Digital_Camera/(C.S)D-indoor1/DSC03135.JPG,char_data/h/DSC03135.JPG_2.jpg,2442,480,640,37,208,245,169,235,False,36
h,82,kaist_dataset/Mixed/Digital_Camera/(C.S)D-indoor1/DSC03472.JPG,char_data/h/DSC03472.JPG_2.jpg,3116,480,640,38,240,278,22,104,False,36
h,97,kaist_dataset/Mixed/Digital_Camera/(C.S)D-indoor1/DSC03909.JPG,char_data/h/DSC03909.JPG_2.jpg,5335,480,640,55,461,516,182,279,False,36
h,30,kaist_dataset/Mixed/Digital_Camera/(C.S)E-night/DSC02569.JPG,char_data/h/DSC02569.JPG_2.jpg,720,480,640,24,387,411,271,301,False,36
h,49,kaist_dataset/Mixed/Digital_Camera/(C.S)E-night/DSC02600.JPG,char_data/h/DSC02600.JPG_2.jpg,2156,480,640,44,238,282,27,76,False,36
h,39,kaist_dataset/Mixed/Digital_Camera/(C.S)F-others/2007-12-09-day-exterior-032.jpg,char_data/h/2007-12-09-day-exterior-032.jpg_2.jpg,1092,1600,1200,28,559,587,280,319,False,36
h,43,kaist_dataset/Mixed/Digital_Camera/(C.S)F-others/DSC02609.JPG,char_data/h/DSC02609.JPG_5.jpg,860,480,640,20,288,308,306,349,False,36
h,71,kaist_dataset/Mixed/Mobile_Phone/(C.M)C-bookCover/P090831114.jpg,char_data/h/P090831114.jpg_2.jpg,2698,480,640,38,376,414,251,322,False,36
h,61,kaist_dataset/Mixed/Mobile_Phone/(C.M)C-bookCover/P090831118.jpg,char_data/h/P090831118.jpg_2.jpg,1220,480,640,20,433,453,203,264,False,36
h,75,kaist_dataset/Mixed/Mobile_Phone/(C.M)C-bookCover/P090831126.jpg,char_data/h/P090831126.jpg_2.jpg,2700,480,640,36,233,269,274,349,False,36
h,52,kaist_dataset/Mixed/Mobile_Phone/(C.M)C-bookCover/P090903024.jpg,char_data/h/P090903024.jpg_4.jpg,2132,480,640,41,434,475,41,93,False,36
h,39,kaist_dataset/Mixed/Mobile_Phone/(C.M)C-bookCover/P090903024.jpg,char_data/h/P090903024.jpg_5.jpg,1209,480,640,31,407,438,221,260,False,36
가,20,kaist_dataset/English/Digital_Camera/(E.S)C-outdoor1/041.JPG,char_data/가/041.JPG_2.jpg,420,480,640,21,213,234,319,339,True,48
가,193,kaist_dataset/Korean/Digital_Camera/A-shadow/2007-12-09-day-exterior-031.jpg,char_data/가/2007-12-09-day-exterior-031.jpg_2.jpg,31845,1200,1600,165,281,446,405,598,True,48
가,94,kaist_dataset/Korean/Digital_Camera/A-shadow/DSC03462.JPG,char_data/가/DSC03462.JPG_2.jpg,8930,480,640,95,134,229,92,186,True,48
가,94,kaist_dataset/Korean/Digital_Camera/A-shadow/DSC03463.JPG,char_data/가/DSC03463.JPG_2.jpg,7708,480,640,82,301,383,345,439,True,48
가,73,kaist_dataset/Korean/Digital_Camera/E-night/DSC03523.JPG,char_data/가/DSC03523.JPG_4.jpg,4672,480,640,64,219,283,280,353,True,48
가,46,kaist_dataset/Korean/Digital_Camera/E-night/DSC03523.JPG,char_data/가/DSC03523.JPG_5.jpg,1564,480,640,34,603,637,332,378,True,48
가,110,kaist_dataset/Korean/Digital_Camera/E-night/DSC03850.JPG,char_data/가/DSC03850.JPG_2.jpg,17490,480,640,159,143,302,276,386,True,48
가,64,kaist_dataset/Korean/Digital_Camera/E-night/DSC03861.JPG,char_data/가/DSC03861.JPG_2.jpg,4096,480,640,64,200,264,41,105,True,48
가,97,kaist_dataset/Korean/Digital_Camera/F-bookCover/DSC02833.JPG,char_data/가/DSC02833.JPG_2.jpg,7663,480,640,79,395,474,35,132,True,48
가,67,kaist_dataset/Korean/Digital_Camera/F-bookCover/DSC03926.JPG,char_data/가/DSC03926.JPG_2.jpg,3685,480,640,55,239,294,204,271,True,48
가,140,kaist_dataset/Korean/Digital_Camera/F-bookCover/DSC03929.JPG,char_data/가/DSC03929.JPG_2.jpg,24360,480,640,174,269,443,63,203,True,48
가,66,kaist_dataset/Korean/Digital_Camera/F-bookCover/DSC04218.JPG,char_data/가/DSC04218.JPG_2.jpg,3366,480,640,51,431,482,332,398,True,48
가,112,kaist_dataset/Korean/Digital_Camera/F-bookCover/DSC04229.JPG,char_data/가/DSC04229.JPG_4.jpg,11200,480,640,100,164,264,32,144,True,48
가,131,kaist_dataset/Korean/Digital_Camera/F-bookCover/DSC04229.JPG,char_data/가/DSC04229.JPG_5.jpg,12969,480,640,99,376,475,164,295,True,48
가,77,kaist_dataset/Korean/Digital_Camera/F-bookCover/P090911044.jpg,char_data/가/P090911044.jpg_2.jpg,8701,480,640,113,308,421,103,180,True,48
가,52,kaist_dataset/Korean/Digital_Camera/indoor1/080118-0017.jpg,char_data/가/080118-0017.jpg_2.jpg,2548,1200,1600,49,878,927,474,526,True,48
가,58,kaist_dataset/Korean/Digital_Camera/indoor1/DSC02715.JPG,char_data/가/DSC02715.JPG_4.jpg,2784,480,640,48,383,431,239,297,True,48
가,59,kaist_dataset/Korean/Digital_Camera/indoor1/DSC02715.JPG,char_data/가/DSC02715.JPG_5.jpg,2714,480,640,46,477,523,178,237,True,48
가,59,kaist_dataset/Korean/Digital_Camera/indoor1/DSC02720.JPG,char_data/가/DSC02720.JPG_2.jpg,3304,480,640,56,161,217,85,144,True,48
가,68,kaist_dataset/Korean/Digital_Camera/indoor1/DSC02723.JPG,char_data/가/DSC02723.JPG_2.jpg,4080,480,640,60,134,194,142,210,True,48
가,87,kaist_dataset/Korean/Digital_Camera/indoor1/DSC02728.JPG,char_data/가/DSC02728.JPG_2.jpg,6612,480,640,76,209,285,267,354,True,48
가,84,kaist_dataset/Korean/Digital_Camera/indoor1/DSC02731.JPG,char_data/가/DSC02731.JPG_2.jpg,6804,480,640,81,185,266,305,389,True,48
가,40,kaist_dataset/Korean/Digital_Camera/indoor1/DSC02742.JPG,char_data/가/DSC02742.JPG_2.jpg,1320,480,640,33,472,505,200,240,True,48
가,30,kaist_dataset/Korean/Digital_Camera/indoor1/DSC02743.JPG,char_data/가/DSC02743.JPG_2.jpg,1200,480,640,40,438,478,179,209,True,48
가,69,kaist_dataset/Korean/Digital_Camera/indoor1/DSC03368.JPG,char_data/가/DSC03368.JPG_2.jpg,4761,480,640,69,240,309,255,324,True,48
가,76,kaist_dataset/Korean/Digital_Camera/indoor1/DSC03371.JPG,char_data/가/DSC03371.JPG_2.jpg,5396,480,640,71,317,388,129,205,True,48
가,178,kaist_dataset/Korean/Digital_Camera/indoor2/DSC03471.JPG,char_data/가/DSC03471.JPG_2.jpg,16020,480,640,90,166,256,54,232,True,48
가,79,kaist_dataset/Korean/Digital_Camera/indoor2/DSC04193.JPG,char_data/가/DSC04193.JPG_2.jpg,6557,480,640,83,232,315,265,344,True,48
가,27,kaist_dataset/Korean/Digital_Camera/outdoor1/026.jpg,char_data/가/026.jpg_2.jpg,918,480,640,34,302,336,108,135,True,48
가,25,kaist_dataset/Korean/Digital_Camera/outdoor1/033.JPG,char_data/가/033.JPG_6.jpg,900,480,640,36,108,144,189,214,True,48
가,22,kaist_dataset/Korean/Digital_Camera/outdoor1/033.JPG,char_data/가/033.JPG_7.jpg,770,480,640,35,115,150,215,237,True,48
가,20,kaist_dataset/Korean/Digital_Camera/outdoor1/033.JPG,char_data/가/033.JPG_8.jpg,540,480,640,27,120,147,241,261,True,48
가,70,kaist_dataset/Korean/Digital_Camera/outdoor1/060.JPG,char_data/가/060.JPG_2.jpg,4410,480,640,63,144,207,209,279,True,48
가,98,kaist_dataset/Korean/Digital_Camera/outdoor1/088.JPG,char_data/가/088.JPG_2.jpg,9604,480,640,98,259,357,184,282,True,48
가,107,kaist_dataset/Korean/Digital_Camera/outdoor1/50.JPG,char_data/가/50.JPG_2.jpg,10486,576,768,98,275,373,221,328,True,48
가,359,kaist_dataset/Korean/Digital_Camera/outdoor2/2007-12-08-day-109.jpg,char_data/가/2007-12-08-day-109.jpg_2.jpg,72159,1200,1600,201,743,944,388,747,True,48
가,44,kaist_dataset/Korean/Digital_Camera/outdoor2/2007-12-09-day-exterior-006.jpg,char_data/가/2007-12-09-day-exterior-006.jpg_2.jpg,1452,1200,1600,33,1,34,578,622,True,48
가,38,kaist_dataset/Korean/Digital_Camera/outdoor2/2007-12-09-day-exterior-035.jpg,char_data/가/2007-12-09-day-exterior-035.jpg_2.jpg,1444,1200,1600,38,619,657,505,543,True,48
가,29,kaist_dataset/Korean/Digital_Camera/outdoor2/DSC02327.JPG,char_data/가/DSC02327.JPG_4.jpg,1798,480,640,62,566,628,216,245,True,48
가,94,kaist_dataset/Korean/Digital_Camera/outdoor2/DSC02327.JPG,char_data/가/DSC02327.JPG_5.jpg,9306,480,640,99,428,527,262,356,True,48
가,93,kaist_dataset/Korean/Digital_Camera/outdoor2/DSC02380.JPG,char_data/가/DSC02380.JPG_2.jpg,11160,480,640,120,6,126,151,244,True,48
가,24,kaist_dataset/Korean/Digital_Camera/outdoor2/DSC02470.JPG,char_data/가/DSC02470.JPG_2.jpg,744,480,640,31,488,519,165,189,True,48
가,56,kaist_dataset/Korean/Digital_Camera/outdoor3/DSC02686.JPG,char_data/가/DSC02686.JPG_2.jpg,2744,480,640,49,428,477,134,190,True,48
가,92,kaist_dataset/Korean/Digital_Camera/outdoor3/DSC02693.JPG,char_data/가/DSC02693.JPG_2.jpg,7084,480,640,77,417,494,276,368,True,48
가,209,kaist_dataset/Korean/Digital_Camera/outdoor3/DSC02698.JPG,char_data/가/DSC02698.JPG_2.jpg,39501,480,640,189,393,582,166,375,True,48
가,63,kaist_dataset/Korean/Digital_Camera/outdoor3/DSC02889.JPG,char_data/가/DSC02889.JPG_2.jpg,6300,480,640,100,494,594,406,469,True,48
가,65,kaist_dataset/Korean/Digital_Camera/outdoor3/DSC02932.JPG,char_data/가/DSC02932.JPG_2.jpg,3315,480,640,51,535,586,156,221,True,48
가,95,kaist_dataset/Korean/Digital_Camera/outdoor3/DSC02968.JPG,char_data/가/DSC02968.JPG_2.jpg,5320,480,640,56,205,261,84,179,True,48
가,44,kaist_dataset/Korean/Digital_Camera/outdoor3/DSC02975.JPG,char_data/가/DSC02975.JPG_2.jpg,1892,480,640,43,278,321,15,59,True,48
가,125,kaist_dataset/Korean/Digital_Camera/outdoor3/DSC02994.JPG,char_data/가/DSC02994.JPG_2.jpg,18250,480,640,146,189,335,115,240,True,48
가,64,kaist_dataset/Korean/Digital_Camera/outdoor3/DSC03009.JPG,char_data/가/DSC03009.JPG_2.jpg,3264,480,640,51,481,532,89,153,True,48
가,78,kaist_dataset/Korean/Digital_Camera/outdoor3/DSC03159.JPG,char_data/가/DSC03159.JPG_2.jpg,4992,480,640,64,348,412,75,153,True,48
가,64,kaist_dataset/Korean/Digital_Camera/outdoor3/DSC03172.JPG,char_data/가/DSC03172.JPG_2.jpg,3648,480,640,57,322,379,237,301,True,48
가,69,kaist_dataset/Korean/Digital_Camera/outdoor3/DSC03214.JPG,char_data/가/DSC03214.JPG_2.jpg,2829,480,640,41,343,384,174,243,True,48
가,41,kaist_dataset/Korean/Digital_Camera/outdoor4/DSC03272.JPG,char_data/가/DSC03272.JPG_2.jpg,1312,480,640,32,333,365,246,287,True,48
가,53,kaist_dataset/Korean/Digital_Camera/outdoor4/DSC03288.JPG,char_data/가/DSC03288.JPG_2.jpg,3816,480,640,72,331,403,89,142,True,48
가,177,kaist_dataset/Korean/Digital_Camera/outdoor4/DSC03319.JPG,char_data/가/DSC03319.JPG_4.jpg,22302,480,640,126,92,218,188,365,True,48
가,76,kaist_dataset/Korean/Digital_Camera/outdoor4/DSC03319.JPG,char_data/가/DSC03319.JPG_5.jpg,3572,480,640,47,96,143,9,85,True,48
가,55,kaist_dataset/Korean/Digital_Camera/outdoor4/DSC03416.JPG,char_data/가/DSC03416.JPG_2.jpg,2090,480,640,38,135,173,289,344,True,48
가,83,kaist_dataset/Korean/Digital_Camera/outdoor4/DSC03452.JPG,char_data/가/DSC03452.JPG_2.jpg,5229,480,640,63,206,269,280,363,True,48
가,62,kaist_dataset/Korean/Digital_Camera/outdoor4/DSC03540.JPG,char_data/가/DSC03540.JPG_2.jpg,2976,480,640,48,367,415,315,377,True,48
가,54,kaist_dataset/Korean/Digital_Camera/outdoor4/DSC03541.JPG,char_data/가/DSC03541.JPG_2.jpg,2376,480,640,44,369,413,377,431,True,48
가,64,kaist_dataset/Korean/Digital_Camera/outdoor4/DSC03615.JPG,char_data/가/DSC03615.JPG_2.jpg,3712,480,640,58,89,147,223,287,True,48
가,58,kaist_dataset/Korean/Digital_Camera/outdoor5/DSC03690.JPG,char_data/가/DSC03690.JPG_2.jpg,3190,480,640,55,371,426,181,239,True,48
가,85,kaist_dataset/Korean/Digital_Camera/outdoor5/DSC03766.JPG,char_data/가/DSC03766.JPG_2.jpg,8755,480,640,103,68,171,101,186,True,48
가,117,kaist_dataset/Korean/Digital_Camera/outdoor5/DSC03770.JPG,char_data/가/DSC03770.JPG_2.jpg,8307,480,640,71,237,308,299,416,True,48
가,69,kaist_dataset/Korean/Digital_Camera/outdoor5/DSC03834.JPG,char_data/가/DSC03834.JPG_4.jpg,5106,480,640,74,185,259,218,287,True,48
가,64,kaist_dataset/Korean/Digital_Camera/outdoor5/DSC03834.JPG,char_data/가/DSC03834.JPG_5.jpg,4032,480,640,63,416,479,223,287,True,48
가,68,kaist_dataset/Korean/Digital_Camera/outdoor5/DSC03835.JPG,char_data/가/DSC03835.JPG_2.jpg,5780,480,640,85,352,437,304,372,True,48
가,64,kaist_dataset/Korean/Digital_Camera/outdoor5/DSC03838.JPG,char_data/가/DSC03838.JPG_2.jpg,6016,480,640,94,295,389,58,122,True,48
가,69,kaist_dataset/Korean/Digital_Camera/outdoor5/DSC03856.JPG,char_data/가/DSC03856.JPG_2.jpg,6624,480,640,96,365,461,78,147,True,48
가,52,kaist_dataset/Korean/Digital_Camera/outdoor6/DSC04051.JPG,char_data/가/DSC04051.JPG_4.jpg,1924,480,640,37,171,208,363,415,True,48
가,91,kaist_dataset/Korean/Digital_Camera/outdoor6/DSC04051.JPG,char_data/가/DSC04051.JPG_5.jpg,8554,480,640,94,280,374,263,354,True,48
가,87,kaist_dataset/Korean/Digital_Camera/outdoor6/DSC04081.JPG,char_data/가/DSC04081.JPG_2.jpg,7569,480,640,87,172,259,218,305,True,48
가,28,kaist_dataset/Korean/Digital_Camera/outdoor6/DSC04138.JPG,char_data/가/DSC04138.JPG_2.jpg,784,480,640,28,228,256,50,78,True,48
가,82,kaist_dataset/Korean/Digital_Camera/outdoor6/DSC04158.JPG,char_data/가/DSC04158.JPG_2.jpg,5576,480,640,68,344,412,213,295,True,48
가,62,kaist_dataset/Korean/Digital_Camera/outdoor7/P1010065.JPG,char_data/가/P1010065.JPG_2.jpg,5146,480,640,83,178,261,321,383,True,48
가,40,kaist_dataset/Korean/Digital_Camera/outdoor8/DSC02929.JPG,char_data/가/DSC02929.JPG_2.jpg,1400,480,640,35,443,478,226,266,True,48
가,127,kaist_dataset/Korean/Digital_Camera/outdoor8/P1010160.JPG,char_data/가/P1010160.JPG_4.jpg,11176,480,640,88,171,259,58,185,True,48
가,137,kaist_dataset/Korean/Digital_Camera/outdoor8/P1010160.JPG,char_data/가/P1010160.JPG_5.jpg,12193,480,640,89,256,345,55,192,True,48
가,71,"kaist_dataset/Korean/Mobile_Phone/(M,K)A-shadow/P090912065.jpg",char_data/가/P090912065.jpg_2.jpg,5325,480,640,75,179,254,73,144,True,48
가,61,"kaist_dataset/Korean/Mobile_Phone/(M,K)D-indoor/P090912028.jpg",char_data/가/P090912028.jpg_2.jpg,3782,480,640,62,361,423,401,462,True,48
가,128,"kaist_dataset/Korean/Mobile_Phone/(M,K)E-bookCover/P090831028.jpg",char_data/가/P090831028.jpg_2.jpg,11904,480,640,93,134,227,186,314,True,48
가,97,"kaist_dataset/Korean/Mobile_Phone/(M,K)E-bookCover/P090831029.jpg",char_data/가/P090831029.jpg_2.jpg,7275,480,640,75,263,338,209,306,True,48
가,46,"kaist_dataset/Korean/Mobile_Phone/(M,K)E-bookCover/P090831033.jpg",char_data/가/P090831033.jpg_2.jpg,1656,480,640,36,285,321,407,453,True,48
가,84,"kaist_dataset/Korean/Mobile_Phone/(M,K)E-bookCover/P090831035.jpg",char_data/가/P090831035.jpg_2.jpg,5880,480,640,70,167,237,38,122,True,48
가,78,"kaist_dataset/Korean/Mobile_Phone/(M,K)E-bookCover/P090831058.jpg",char_data/가/P090831058.jpg_4.jpg,5616,480,640,72,1,72,197,275,True,48
가,81,"kaist_dataset/Korean/Mobile_Phone/(M,K)E-bookCover/P090831058.jpg",char_data/가/P090831058.jpg_5.jpg,5508,480,640,68,2,70,293,374,True,48
가,144,"kaist_dataset/Korean/Mobile_Phone/(M,K)E-bookCover/P090831071.jpg",char_data/가/P090831071.jpg_4.jpg,16416,480,640,114,120,234,152,296,True,48
가,132,"kaist_dataset/Korean/Mobile_Phone/(M,K)E-bookCover/P090831071.jpg",char_data/가/P090831071.jpg_5.jpg,14388,480,640,109,321,430,301,433,True,48
가,156,"kaist_dataset/Korean/Mobile_Phone/(M,K)E-bookCover/P090831140.jpg",char_data/가/P090831140.jpg_2.jpg,21060,480,640,135,486,621,125,281,True,48
가,102,"kaist_dataset/Korean/Mobile_Phone/(M,K)E-bookCover/P090903048.jpg",char_data/가/P090903048.jpg_2.jpg,8160,480,640,80,421,501,76,178,True,48
가,94,"kaist_dataset/Korean/Mobile_Phone/(M,K)E-bookCover/P090903049.jpg",char_data/가/P090903049.jpg_2.jpg,7332,480,640,78,522,600,287,381,True,48
가,87,"kaist_dataset/Korean/Mobile_Phone/(M,K)E-bookCover/P090903077.jpg",char_data/가/P090903077.jpg_2.jpg,9048,480,640,104,517,621,292,379,True,48
가,137,"kaist_dataset/Korean/Mobile_Phone/(M,K)E-bookCover/P090903091.jpg",char_data/가/P090903091.jpg_2.jpg,15481,480,640,113,436,549,78,215,True,48
가,82,"kaist_dataset/Korean/Mobile_Phone/(M,K)E-bookCover/P090911013.jpg",char_data/가/P090911013.jpg_2.jpg,9184,480,640,112,82,194,137,219,True,48
가,35,kaist_dataset/Mixed/Digital_Camera/(C.S)C-outdoor1/090.JPG,char_data/가/090.JPG_4.jpg,1225,480,640,35,527,562,361,396,True,48
가,31,kaist_dataset/Mixed/Digital_Camera/(C.S)C-outdoor1/090.JPG,char_data/가/090.JPG_5.jpg,961,480,640,31,214,245,387,418,True,48
가,56,kaist_dataset/Mixed/Digital_Camera/(C.S)C-outdoor1/1.JPG,char_data/가/1.JPG_2.jpg,2968,576,768,53,166,219,520,575,True,48
가,80,kaist_dataset/Mixed/Digital_Camera/(C.S)C-outdoor1/130.JPG,char_data/가/130.JPG_2.jpg,7600,480,640,95,201,296,196,276,True,48
가,41,kaist_dataset/Mixed/Digital_Camera/(C.S)C-outdoor1/135.JPG,char_data/가/135.JPG_2.jpg,1312,480,640,32,377,409,257,298,True,48
가,79,kaist_dataset/Mixed/Digital_Camera/(C.S)C-outdoor1/2007-12-08-day-091.jpg,char_data/가/2007-12-08-day-091.jpg_4.jpg,6320,1200,1600,80,998,1078,516,595,True,48
가,68,kaist_dataset/Mixed/Digital_Camera/(C.S)C-outdoor1/2007-12-08-day-091.jpg,char_data/가/2007-12-08-day-091.jpg_5.jpg,6052,1200,1600,89,282,371,961,1029,True,48
가,124,kaist_dataset/Mixed/Digital_Camera/(C.S)C-outdoor1/2007-12-08-day-092.jpg,char_data/가/2007-12-08-day-092.jpg_4.jpg,15252,1200,1600,123,405,528,473,597,True,48
가,91,kaist_dataset/Mixed/Digital_Camera/(C.S)C-outdoor1/2007-12-08-day-092.jpg,char_data/가/2007-12-08-day-092.jpg_5.jpg,3367,1200,1600,37,1440,1477,737,828,True,48
가,43,kaist_dataset/Mixed/Digital_Camera/(C.S)C-outdoor1/3.JPG,char_data/가/3.JPG_2.jpg,1333,576,768,31,252,283,413,456,True,48
가,38,kaist_dataset/Mixed/Digital_Camera/(C.S)C-outdoor1/8.jpg,char_data/가/8.jpg_2.jpg,1216,400,766,32,494,526,276,314,True,48
가,44,kaist_dataset/Mixed/Digital_Camera/(C.S)C-outdoor1/DSC02323.JPG,char_data/가/DSC02323.JPG_4.jpg,2684,480,640,61,233,294,347,391,True,48
가,41,kaist_dataset/Mixed/Digital_Camera/(C.S)C-outdoor1/DSC02323.JPG,char_data/가/DSC02323.JPG_5.jpg,2173,480,640,53,299,352,353,394,True,48
가,62,kaist_dataset/Mixed/Digital_Camera/(C.S)C-outdoor2/DSC02377.JPG,char_data/가/DSC02377.JPG_2.jpg,4712,480,640,76,302,378,248,310,True,48
가,34,kaist_dataset/Mixed/Digital_Camera/(C.S)C-outdoor2/DSC02422.JPG,char_data/가/DSC02422.JPG_2.jpg,850,480,640,25,73,98,223,257,True,48
가,64,kaist_dataset/Mixed/Digital_Camera/(C.S)C-outdoor2/DSC02436.JPG,char_data/가/DSC02436.JPG_2.jpg,3072,480,640,48,409,457,112,176,True,48
가,69,kaist_dataset/Mixed/Digital_Camera/(C.S)C-outdoor2/DSC02527.JPG,char_data/가/DSC02527.JPG_2.jpg,4071,480,640,59,438,497,137,206,False,48
가,90,kaist_dataset/Mixed/Digital_Camera/(C.S)C-outdoor2/DSC02927.JPG,char_data/가/DSC02927.JPG_2.jpg,6480,480,640,72,376,448,35,125,False,48
가,35,kaist_dataset/Mixed/Digital_Camera/(C.S)C-outdoor3/DSC02969.JPG,char_data/가/DSC02969.JPG_2.jpg,1085,480,640,31,530,561,26,61,False,48
가,39,kaist_dataset/Mixed/Digital_Camera/(C.S)C-outdoor3/DSC03217.JPG,char_data/가/DSC03217.JPG_2.jpg,1365,480,640,35,328,363,333,372,False,48
가,50,kaist_dataset/Mixed/Digital_Camera/(C.S)C-outdoor4/DSC03544.JPG,char_data/가/DSC03544.JPG_2.jpg,1750,480,640,35,394,429,269,319,False,48
가,40,kaist_dataset/Mixed/Digital_Camera/(C.S)C-outdoor4/DSC03569.JPG,char_data/가/DSC03569.JPG_2.jpg,1440,480,640,36,104,140,179,219,False,48
가,41,kaist_dataset/Mixed/Digital_Camera/(C.S)C-outdoor4/DSC03571.JPG,char_data/가/DSC03571.JPG_2.jpg,943,480,640,23,590,613,299,340,False,48
가,85,kaist_dataset/Mixed/Digital_Camera/(C.S)C-outdoor4/DSC03621.JPG,char_data/가/DSC03621.JPG_2.jpg,6885,480,640,81,174,255,191,276,False,48
가,42,kaist_dataset/Mixed/Digital_Camera/(C.S)C-outdoor4/DSC03634.JPG,char_data/가/DSC03634.JPG_2.jpg,1638,480,640,39,478,517,242,284,False,48
가,78,kaist_dataset/Mixed/Digital_Camera/(C.S)C-outdoor4/DSC03676.JPG,char_data/가/DSC03676.JPG_2.jpg,3744,480,640,48,455,503,330,408,False,48
가,32,kaist_dataset/Mixed/Digital_Camera/(C.S)C-outdoor4/DSC03687.JPG,char_data/가/DSC03687.JPG_2.jpg,1056,480,640,33,314,347,395,427,False,48
가,38,kaist_dataset/Mixed/Digital_Camera/(C.S)C-outdoor5/DSC03819.JPG,char_data/가/DSC03819.JPG_2.jpg,836,480,640,22,480,502,370,408,False,48
가,52,kaist_dataset/Mixed/Digital_Camera/(C.S)C-outdoor5/DSC04063.JPG,char_data/가/DSC04063.JPG_2.jpg,1092,480,640,21,529,550,296,348,False,48
가,61,kaist_dataset/Mixed/Digital_Camera/(C.S)C-outdoor5/DSC04065.JPG,char_data/가/DSC04065.JPG_2.jpg,3843,480,640,63,302,365,122,183,False,48
가,131,kaist_dataset/Mixed/Digital_Camera/(C.S)C-outdoor5/DSC04098.JPG,char_data/가/DSC04098.JPG_2.jpg,14672,480,640,112,187,299,156,287,False,48
가,28,kaist_dataset/Mixed/Digital_Camera/(C.S)C-outdoor5/DSC04150.JPG,char_data/가/DSC04150.JPG_2.jpg,1232,480,640,44,21,65,329,357,False,48
가,44,kaist_dataset/Mixed/Digital_Camera/(C.S)C-outdoor5/DSC04357.JPG,char_data/가/DSC04357.JPG_2.jpg,1804,480,640,41,297,338,295,339,False,48
가,61,kaist_dataset/Mixed/Digital_Camera/(C.S)C-outdoor6/080116-0057.jpg,char_data/가/080116-0057.jpg_2.jpg,3294,1200,1600,54,852,906,1082,1143,False,48
가,18,kaist_dataset/Mixed/Digital_Camera/(C.S)C-outdoor6/117.JPG,char_data/가/117.JPG_2.jpg,360,480,640,20,87,107,166,184,False,48
가,34,kaist_dataset/Mixed/Digital_Camera/(C.S)C-outdoor6/P1010097.JPG,char_data/가/P1010097.JPG_2.jpg,612,480,640,18,224,242,176,210,False,48
가,50,kaist_dataset/Mixed/Digital_Camera/(C.S)D-indoor1/DSC02711.JPG,char_data/가/DSC02711.JPG_2.jpg,2400,480,640,48,54,102,297,347,False,48
가,39,kaist_dataset/Mixed/Digital_Camera/(C.S)D-indoor1/DSC03129.JPG,char_data/가/DSC03129.JPG_2.jpg,1404,480,640,36,314,350,258,297,False,48
가,54,kaist_dataset/Mixed/Digital_Camera/(C.S)D-indoor1/DSC03460.JPG,char_data/가/DSC03460.JPG_2.jpg,2268,480,640,42,2,44,261,315,False,48
가,90,kaist_dataset/Mixed/Digital_Camera/(C.S)D-indoor1/DSC03912.JPG,char_data/가/DSC03912.JPG_2.jpg,6300,480,640,70,348,418,176,266,False,48
가,112,kaist_dataset/Mixed/Digital_Camera/(C.S)D-indoor1/DSC04231.JPG,char_data/가/DSC04231.JPG_2.jpg,6496,480,640,58,325,383,268,380,False,48
가,65,kaist_dataset/Mixed/Mobile_Phone/(C.M)A-outdoor/P090908005.jpg,char_data/가/P090908005.jpg_2.jpg,6175,480,640,95,395,490,147,212,False,48
가,57,kaist_dataset/Mixed/Mobile_Phone/(C.M)A-outdoor/P090908006.jpg,char_data/가/P090908006.jpg_2.jpg,5586,480,640,98,374,472,281,338,False,48
가,209,kaist_dataset/Mixed/Mobile_Phone/(C.M)C-bookCover/P090831122.jpg,char_data/가/P090831122.jpg_2.jpg,38456,480,640,184,359,543,28,237,False,48
D,89,kaist_dataset/English/Digital_Camera/(E.S)A-shadow/DSC02317.JPG,char_data/D/DSC02317.JPG_2.jpg,7031,480,640,79,328,407,223,312,True,15
D,52,kaist_dataset/English/Digital_Camera/(E.S)A-shadow/DSC02423.JPG,char_data/D/DSC02423.JPG_2.jpg,2288,480,640,44,272,316,238,290,True,15
D,72,kaist_dataset/English/Digital_Camera/(E.S)A-shadow/DSC03082.JPG,char_data/D/DSC03082.JPG_2.jpg,5040,480,640,70,274,344,202,274,True,15
D,62,kaist_dataset/English/Digital_Camera/(E.S)A-shadow/P090912074.jpg,char_data/D/P090912074.jpg_2.jpg,2294,480,640,37,394,431,82,144,True,15
D,208,kaist_dataset/English/Digital_Camera/(E.S)B-light/080116-0059.jpg,char_data/D/080116-0059.jpg_10.jpg,35776,1200,1600,172,537,709,21,229,True,15
D,174,kaist_dataset/English/Digital_Camera/(E.S)B-light/080116-0059.jpg,char_data/D/080116-0059.jpg_11.jpg,16530,1200,1600,95,683,778,313,487,True,15
D,29,kaist_dataset/English/Digital_Camera/(E.S)B-light/080116-0059.jpg,char_data/D/080116-0059.jpg_12.jpg,435,1200,1600,15,674,689,827,856,True,15
D,29,kaist_dataset/English/Digital_Camera/(E.S)B-light/080116-0059.jpg,char_data/D/080116-0059.jpg_13.jpg,609,1200,1600,21,937,958,770,799,True,15
D,34,kaist_dataset/English/Digital_Camera/(E.S)B-light/080116-0059.jpg,char_data/D/080116-0059.jpg_14.jpg,510,1200,1600,15,1017,1032,771,805,True,15
D,87,kaist_dataset/English/Digital_Camera/(E.S)B-light/080119-0038.jpg,char_data/D/080119-0038.jpg_2.jpg,6177,1200,1600,71,137,208,677,764,True,15
D,32,kaist_dataset/English/Digital_Camera/(E.S)B-light/v.jpg,char_data/D/v.jpg_4.jpg,608,240,320,19,74,93,50,82,True,15
D,26,kaist_dataset/English/Digital_Camera/(E.S)B-light/v.jpg,char_data/D/v.jpg_5.jpg,468,240,320,18,144,162,60,86,True,15
D,38,kaist_dataset/English/Digital_Camera/(E.S)B-light/x.jpg,char_data/D/x.jpg_6.jpg,1520,240,320,40,172,212,64,102,True,15
D,40,kaist_dataset/English/Digital_Camera/(E.S)B-light/x.jpg,char_data/D/x.jpg_7.jpg,2040,240,320,51,216,267,59,99,True,15
D,19,kaist_dataset/English/Digital_Camera/(E.S)B-light/x.jpg,char_data/D/x.jpg_8.jpg,399,240,320,21,242,263,103,122,True,15
D,92,kaist_dataset/English/Digital_Camera/(E.S)B-light/크기변환_%B0%A3%C6%C7_ktimt007.jpg,char_data/D/크기변환_%B0%A3%C6%C7_ktimt007.jpg_2.jpg,6532,480,640,71,524,595,205,297,True,15
D,44,kaist_dataset/English/Digital_Camera/(E.S)C-outdoor1/004.jpg,char_data/D/004.jpg_2.jpg,1364,269,413,31,139,170,36,80,True,15
D,57,kaist_dataset/English/Digital_Camera/(E.S)C-outdoor1/034.JPG,char_data/D/034.JPG_4.jpg,3021,480,640,53,400,453,194,251,True,15
D,56,kaist_dataset/English/Digital_Camera/(E.S)C-outdoor1/034.JPG,char_data/D/034.JPG_5.jpg,2744,480,640,49,571,620,198,254,True,15
D,36,kaist_dataset/English/Digital_Camera/(E.S)C-outdoor1/036.jpg,char_data/D/036.jpg_2.jpg,1476,197,354,41,11,52,71,107,True,15
D,84,kaist_dataset/English/Digital_Camera/(E.S)C-outdoor1/041.JPG,char_data/D/041.JPG_2.jpg,4116,480,640,49,122,171,208,292,True,15
D,68,kaist_dataset/English/Digital_Camera/(E.S)C-outdoor1/055.JPG,char_data/D/055.JPG_2.jpg,3808,480,640,56,170,226,185,253,True,15
D,27,kaist_dataset/English/Digital_Camera/(E.S)C-outdoor1/056.JPG,char_data/D/056.JPG_4.jpg,540,480,640,20,82,102,242,269,True,15
D,27,kaist_dataset/English/Digital_Camera/(E.S)C-outdoor1/056.JPG,char_data/D/056.JPG_5.jpg,351,480,640,13,241,254,239,266,True,15
D,45,kaist_dataset/English/Digital_Camera/(E.S)C-outdoor1/080116-0066.jpg,char_data/D/080116-0066.jpg_4.jpg,1800,600,800,40,277,317,351,396,True,15
D,45,kaist_dataset/English/Digital_Camera/(E.S)C-outdoor1/080116-0066.jpg,char_data/D/080116-0066.jpg_5.jpg,1620,600,800,36,514,550,355,400,True,15
D,43,kaist_dataset/English/Digital_Camera/(E.S)C-outdoor1/089.jpg,char_data/D/089.jpg_2.jpg,1075,480,640,25,207,232,284,327,True,15
D,161,kaist_dataset/English/Digital_Camera/(E.S)C-outdoor1/100.JPG,char_data/D/100.JPG_2.jpg,22057,480,640,137,59,196,32,193,True,15
D,31,kaist_dataset/English/Digital_Camera/(E.S)C-outdoor1/113.jpg,char_data/D/113.jpg_2.jpg,651,480,640,21,386,407,226,257,True,15
D,223,kaist_dataset/English/Digital_Camera/(E.S)C-outdoor1/2007-12-08-day-099.jpg,char_data/D/2007-12-08-day-099.jpg_2.jpg,28098,1200,1600,126,712,838,443,666,True,15
D,35,kaist_dataset/English/Digital_Camera/(E.S)C-outdoor1/DSC02345.JPG,char_data/D/DSC02345.JPG_2.jpg,665,480,640,19,373,392,235,270,True,15
D,120,kaist_dataset/English/Digital_Camera/(E.S)C-outdoor1/DSC02427.JPG,char_data/D/DSC02427.JPG_2.jpg,9240,480,640,77,495,572,112,232,True,15
D,58,kaist_dataset/English/Digital_Camera/(E.S)C-outdoor1/DSC02480.JPG,char_data/D/DSC02480.JPG_2.jpg,2378,480,640,41,257,298,391,449,True,15
D,116,kaist_dataset/English/Digital_Camera/(E.S)C-outdoor1/DSC02500.JPG,char_data/D/DSC02500.JPG_2.jpg,7076,480,640,61,251,312,173,289,True,15
D,67,kaist_dataset/English/Digital_Camera/(E.S)C-outdoor1/DSC02501.JPG,char_data/D/DSC02501.JPG_2.jpg,3685,480,640,55,93,148,292,359,True,15
D,42,kaist_dataset/English/Digital_Camera/(E.S)C-outdoor1/DSC02918.JPG,char_data/D/DSC02918.JPG_2.jpg,1974,480,640,47,384,431,228,270,True,15
D,75,kaist_dataset/English/Digital_Camera/(E.S)C-outdoor2/DSC03050.JPG,char_data/D/DSC03050.JPG_2.jpg,6450,480,640,86,397,483,208,283,True,15
D,47,kaist_dataset/English/Digital_Camera/(E.S)C-outdoor2/DSC03160.JPG,char_data/D/DSC03160.JPG_2.jpg,1222,480,640,26,220,246,400,447,True,15
D,65,kaist_dataset/English/Digital_Camera/(E.S)C-outdoor2/DSC03191.JPG,char_data/D/DSC03191.JPG_2.jpg,3770,480,640,58,251,309,139,204,True,15
D,66,kaist_dataset/English/Digital_Camera/(E.S)C-outdoor2/DSC03208.JPG,char_data/D/DSC03208.JPG_2.jpg,5874,480,640,89,405,494,192,258,True,15
D,64,kaist_dataset/English/Digital_Camera/(E.S)C-outdoor2/DSC03290.JPG,char_data/D/DSC03290.JPG_2.jpg,2752,480,640,43,172,215,395,459,True,15
D,68,kaist_dataset/English/Digital_Camera/(E.S)C-outdoor2/DSC03413.JPG,char_data/D/DSC03413.JPG_2.jpg,3536,480,640,52,41,93,186,254,True,15
D,74,kaist_dataset/English/Digital_Camera/(E.S)C-outdoor2/DSC03440.JPG,char_data/D/DSC03440.JPG_2.jpg,3922,480,640,53,203,256,126,200,True,15
D,84,kaist_dataset/English/Digital_Camera/(E.S)C-outdoor2/DSC03705.JPG,char_data/D/DSC03705.JPG_2.jpg,6804,480,640,81,53,134,184,268,True,15
D,61,kaist_dataset/English/Digital_Camera/(E.S)C-outdoor2/DSC03759.JPG,char_data/D/DSC03759.JPG_2.jpg,6405,480,640,105,213,318,116,177,True,15
D,59,kaist_dataset/English/Digital_Camera/(E.S)C-outdoor2/DSC04120.JPG,char_data/D/DSC04120.JPG_2.jpg,2183,480,640,37,120,157,147,206,True,15
D,74,kaist_dataset/English/Digital_Camera/(E.S)C-outdoor2/DSC04251.JPG,char_data/D/DSC04251.JPG_2.jpg,4218,480,640,57,112,169,66,140,True,15
D,61,kaist_dataset/English/Digital_Camera/(E.S)C-outdoor2/DSC04313.JPG,char_data/D/DSC04313.JPG_2.jpg,2989,480,640,49,308,357,117,178,True,15
D,69,kaist_dataset/English/Digital_Camera/(E.S)C-outdoor2/DSC04410.JPG,char_data/D/DSC04410.JPG_2.jpg,4347,480,640,63,396,459,144,213,True,15
D,62,kaist_dataset/English/Digital_Camera/(E.S)C-outdoor2/DSC04464.JPG,char_data/D/DSC04464.JPG_2.jpg,3596,480,640,58,15,73,317,379,True,15
D,50,kaist_dataset/English/Digital_Camera/(E.S)C-outdoor3/DSC02690.JPG,char_data/D/DSC02690.JPG_4.jpg,2400,480,640,48,190,238,176,226,True,15
D,50,kaist_dataset/English/Digital_Camera/(E.S)C-outdoor3/DSC02690.JPG,char_data/D/DSC02690.JPG_5.jpg,2450,480,640,49,186,235,229,279,True,15
D,64,kaist_dataset/English/Digital_Camera/(E.S)C-outdoor3/DSC02788.JPG,char_data/D/DSC02788.JPG_2.jpg,2432,480,640,38,167,205,232,296,True,15
D,58,kaist_dataset/English/Digital_Camera/(E.S)D-indoor/080119-0009.jpg,char_data/D/080119-0009.jpg_17.jpg,1740,1200,1600,30,714,744,972,1030,True,15
D,38,kaist_dataset/English/Digital_Camera/(E.S)D-indoor/308.jpg,char_data/D/308.jpg_2.jpg,1026,212,385,27,168,195,45,83,True,15
D,63,kaist_dataset/English/Digital_Camera/(E.S)D-indoor/DSC02769.JPG,char_data/D/DSC02769.JPG_2.jpg,3465,480,640,55,84,139,135,198,True,15
D,67,kaist_dataset/English/Digital_Camera/(E.S)D-indoor/DSC02850.JPG,char_data/D/DSC02850.JPG_2.jpg,4087,480,640,61,280,341,240,307,True,15
D,44,kaist_dataset/English/Digital_Camera/(E.S)D-indoor/DSC03142.JPG,char_data/D/DSC03142.JPG_2.jpg,1848,480,640,42,219,261,418,462,True,15
D,47,kaist_dataset/English/Digital_Camera/(E.S)D-indoor/DSC03151.JPG,char_data/D/DSC03151.JPG_2.jpg,1880,480,640,40,453,493,105,152,True,15
D,89,kaist_dataset/English/Digital_Camera/(E.S)D-indoor/DSC03365.JPG,char_data/D/DSC03365.JPG_2.jpg,7832,480,640,88,286,374,366,455,True,15
D,91,kaist_dataset/English/Digital_Camera/(E.S)D-indoor/DSC03366.JPG,char_data/D/DSC03366.JPG_2.jpg,7462,480,640,82,140,222,351,442,True,15
D,50,kaist_dataset/English/Digital_Camera/(E.S)D-indoor/DSC03401.JPG,char_data/D/DSC03401.JPG_2.jpg,1800,480,640,36,434,470,233,283,True,15
D,97,kaist_dataset/English/Digital_Camera/(E.S)D-indoor/DSC03402.JPG,char_data/D/DSC03402.JPG_2.jpg,8536,480,640,88,455,543,179,276,True,15
D,71,kaist_dataset/English/Digital_Camera/(E.S)D-indoor/DSC03403.JPG,char_data/D/DSC03403.JPG_2.jpg,4757,480,640,67,396,463,196,267,True,15
D,55,kaist_dataset/English/Digital_Camera/(E.S)D-indoor/DSC03467.JPG,char_data/D/DSC03467.JPG_2.jpg,2475,480,640,45,109,154,150,205,True,15
D,37,kaist_dataset/English/Digital_Camera/(E.S)D-indoor/DSC03901.JPG,char_data/D/DSC03901.JPG_2.jpg,1184,480,640,32,381,413,121,158,True,15
D,78,kaist_dataset/English/Digital_Camera/(E.S)D-indoor/DSC03943.JPG,char_data/D/DSC03943.JPG_4.jpg,5148,480,640,66,441,507,208,286,True,15
D,33,kaist_dataset/English/Digital_Camera/(E.S)D-indoor/DSC03943.JPG,char_data/D/DSC03943.JPG_5.jpg,660,480,640,20,278,298,312,345,True,15
D,41,kaist_dataset/English/Digital_Camera/(E.S)E-night/t.jpg,char_data/D/t.jpg_2.jpg,1271,240,320,31,54,85,66,107,True,15
D,154,kaist_dataset/English/Digital_Camera/(E.S)F-others/080116-0058.jpg,char_data/D/080116-0058.jpg_4.jpg,10164,1200,1600,66,833,899,399,553,True,15
D,111,kaist_dataset/English/Digital_Camera/(E.S)F-others/080116-0058.jpg,char_data/D/080116-0058.jpg_5.jpg,3441,1200,1600,31,864,895,603,714,True,15
D,165,kaist_dataset/English/Digital_Camera/(E.S)F-others/080116-0060.jpg,char_data/D/080116-0060.jpg_4.jpg,30690,1200,1600,186,9,195,473,638,True,15
D,146,kaist_dataset/English/Digital_Camera/(E.S)F-others/080116-0060.jpg,char_data/D/080116-0060.jpg_5.jpg,20294,1200,1600,139,776,915,419,565,True,15
D,44,kaist_dataset/English/Digital_Camera/(E.S)F-others/크기변환_%B0%A3%C6%C716_m_starfirm.jpg,char_data/D/크기변환_%B0%A3%C6%C716_m_starfirm.jpg_2.jpg,1672,480,640,38,260,298,199,243,True,15
D,70,kaist_dataset/English/Mobile_Phone/(E.M)C-bookCover/P090903071.jpg,char_data/D/P090903071.jpg_4.jpg,4410,480,640,63,332,395,227,297,True,15
D,34,kaist_dataset/English/Mobile_Phone/(E.M)C-bookCover/P090903071.jpg,char_data/D/P090903071.jpg_5.jpg,986,480,640,29,310,339,301,335,True,15
D,106,kaist_dataset/English/Mobile_Phone/(E.M)C-bookCover/P090903076.jpg,char_data/D/P090903076.jpg_4.jpg,10388,480,640,98,53,151,278,384,True,15
D,49,kaist_dataset/English/Mobile_Phone/(E.M)C-bookCover/P090903076.jpg,char_data/D/P090903076.jpg_5.jpg,1911,480,640,39,289,328,390,439,True,15
D,82,kaist_dataset/English/Mobile_Phone/(E.M)C-bookCover/P090905007.jpg,char_data/D/P090905007.jpg_2.jpg,5412,480,640,66,360,426,171,253,True,15
D,22,kaist_dataset/Korean/Digital_Camera/G-others/5.jpg,char_data/D/5.jpg_2.jpg,330,553,798,15,70,85,37,59,True,15
D,73,kaist_dataset/Korean/Digital_Camera/outdoor2/080118-0018.jpg,char_data/D/080118-0018.jpg_4.jpg,7957,1200,1600,109,740,849,660,733,True,15
D,26,kaist_dataset/Korean/Digital_Camera/outdoor2/2007-12-08-day-094.jpg,char_data/D/2007-12-08-day-094.jpg_2.jpg,676,1600,1200,26,672,698,1422,1448,True,15
D,51,kaist_dataset/Korean/Digital_Camera/outdoor2/2007-12-08-day-101.jpg,char_data/D/2007-12-08-day-101.jpg_2.jpg,2499,1200,1600,49,1440,1489,1077,1128,True,15
D,100,kaist_dataset/Mixed/Digital_Camera/(C.S)A-shadow/DSC02609.JPG,char_data/D/DSC02609.JPG_12.jpg,7800,480,640,78,275,353,191,291,True,15
D,36,kaist_dataset/Mixed/Digital_Camera/(C.S)A-shadow/DSC02609.JPG,char_data/D/DSC02609.JPG_13.jpg,864,480,640,24,198,222,317,353,True,15
D,139,kaist_dataset/Mixed/Digital_Camera/(C.S)C-outdoor1/080119-0037.jpg,char_data/D/080119-0037.jpg_2.jpg,12232,1200,1600,88,425,513,869,1008,True,15
D,32,kaist_dataset/Mixed/Digital_Camera/(C.S)C-outdoor1/1.JPG,char_data/D/1.JPG_8.jpg,576,576,768,18,752,767,171,203,True,15
D,38,kaist_dataset/Mixed/Digital_Camera/(C.S)C-outdoor1/114.jpg,char_data/D/114.jpg_2.jpg,1178,480,640,31,169,200,308,346,True,15
D,26,kaist_dataset/Mixed/Digital_Camera/(C.S)C-outdoor1/2.JPG,char_data/D/2.JPG_2.jpg,468,576,768,18,550,568,370,396,True,15
D,83,kaist_dataset/Mixed/Digital_Camera/(C.S)C-outdoor1/2007-12-09-day-exterior-044.jpg,char_data/D/2007-12-09-day-exterior-044.jpg_2.jpg,6557,1200,1600,79,691,770,818,901,True,15
D,28,kaist_dataset/Mixed/Digital_Camera/(C.S)C-outdoor1/2007-12-09-day-exterior-051.jpg,char_data/D/2007-12-09-day-exterior-051.jpg_2.jpg,672,1200,1600,24,494,518,681,709,True,15
D,29,kaist_dataset/Mixed/Digital_Camera/(C.S)C-outdoor1/DSC02242.JPG,char_data/D/DSC02242.JPG_4.jpg,580,480,640,20,205,225,168,197,True,15
D,112,kaist_dataset/Mixed/Digital_Camera/(C.S)C-outdoor1/DSC02322.JPG,char_data/D/DSC02322.JPG_4.jpg,6160,480,640,55,329,384,226,338,True,15
D,112,kaist_dataset/Mixed/Digital_Camera/(C.S)C-outdoor1/DSC02322.JPG,char_data/D/DSC02322.JPG_5.jpg,5936,480,640,53,415,468,227,339,True,15
D,58,kaist_dataset/Mixed/Digital_Camera/(C.S)C-outdoor1/DSC02325.JPG,char_data/D/DSC02325.JPG_2.jpg,2958,480,640,51,427,478,230,288,True,15
D,27,kaist_dataset/Mixed/Digital_Camera/(C.S)C-outdoor2/DSC02411.JPG,char_data/D/DSC02411.JPG_4.jpg,270,480,640,10,606,616,269,296,True,15
D,28,kaist_dataset/Mixed/Digital_Camera/(C.S)C-outdoor2/DSC02421.JPG,char_data/D/DSC02421.JPG_4.jpg,980,480,640,35,263,298,208,236,True,15
D,52,kaist_dataset/Mixed/Digital_Camera/(C.S)C-outdoor2/DSC02502.JPG,char_data/D/DSC02502.JPG_2.jpg,1768,480,640,34,109,143,83,135,True,15
D,32,kaist_dataset/Mixed/Digital_Camera/(C.S)C-outdoor2/DSC02890.JPG,char_data/D/DSC02890.JPG_2.jpg,864,480,640,27,164,191,406,438,True,15
D,40,kaist_dataset/Mixed/Digital_Camera/(C.S)C-outdoor3/DSC02970.JPG,char_data/D/DSC02970.JPG_2.jpg,1360,480,640,34,293,327,301,341,True,15
D,37,kaist_dataset/Mixed/Digital_Camera/(C.S)C-outdoor3/DSC02986.JPG,char_data/D/DSC02986.JPG_2.jpg,1184,480,640,32,414,446,281,318,True,15
D,81,kaist_dataset/Mixed/Digital_Camera/(C.S)C-outdoor3/DSC02989.JPG,char_data/D/DSC02989.JPG_4.jpg,5427,480,640,67,247,314,169,250,True,15
D,43,kaist_dataset/Mixed/Digital_Camera/(C.S)C-outdoor3/DSC02989.JPG,char_data/D/DSC02989.JPG_5.jpg,1935,480,640,45,132,177,261,304,True,15
D,164,kaist_dataset/Mixed/Digital_Camera/(C.S)C-outdoor3/DSC03006.JPG,char_data/D/DSC03006.JPG_2.jpg,15744,480,640,96,160,256,101,265,True,15
D,41,kaist_dataset/Mixed/Digital_Camera/(C.S)C-outdoor3/DSC03233.JPG,char_data/D/DSC03233.JPG_2.jpg,902,480,640,22,102,124,282,323,True,15
D,39,kaist_dataset/Mixed/Digital_Camera/(C.S)C-outdoor3/DSC03242.JPG,char_data/D/DSC03242.JPG_2.jpg,1365,480,640,35,156,191,320,359,True,15
D,27,kaist_dataset/Mixed/Digital_Camera/(C.S)C-outdoor3/DSC03250.JPG,char_data/D/DSC03250.JPG_2.jpg,675,480,640,25,418,443,370,397,True,15
D,31,kaist_dataset/Mixed/Digital_Camera/(C.S)C-outdoor4/DSC03556.JPG,char_data/D/DSC03556.JPG_2.jpg,465,480,640,15,473,488,320,351,True,15
D,96,kaist_dataset/Mixed/Digital_Camera/(C.S)C-outdoor4/DSC03630.JPG,char_data/D/DSC03630.JPG_2.jpg,6624,480,640,69,152,221,327,423,True,15
D,55,kaist_dataset/Mixed/Digital_Camera/(C.S)C-outdoor4/DSC03707.JPG,char_data/D/DSC03707.JPG_2.jpg,1650,480,640,30,428,458,91,146,True,15
D,42,kaist_dataset/Mixed/Digital_Camera/(C.S)C-outdoor4/DSC03711.JPG,char_data/D/DSC03711.JPG_2.jpg,1302,480,640,31,137,168,390,432,True,15
D,66,kaist_dataset/Mixed/Digital_Camera/(C.S)C-outdoor4/DSC03756.JPG,char_data/D/DSC03756.JPG_2.jpg,2904,480,640,44,151,195,387,453,False,15
D,37,kaist_dataset/Mixed/Digital_Camera/(C.S)C-outdoor5/DSC04069.JPG,char_data/D/DSC04069.JPG_2.jpg,1295,480,640,35,53,88,390,427,False,15
D,47,kaist_dataset/Mixed/Digital_Camera/(C.S)C-outdoor5/DSC04312.JPG,char_data/D/DSC04312.JPG_2.jpg,1692,480,640,36,327,363,104,151,False,15
D,36,kaist_dataset/Mixed/Digital_Camera/(C.S)C-outdoor5/DSC04314.JPG,char_data/D/DSC04314.JPG_2.jpg,1152,480,640,32,398,430,170,206,False,15
D,32,kaist_dataset/Mixed/Digital_Camera/(C.S)C-outdoor5/DSC04338.JPG,char_data/D/DSC04338.JPG_2.jpg,864,480,640,27,93,120,197,229,False,15
D,43,kaist_dataset/Mixed/Digital_Camera/(C.S)C-outdoor6/P1010085.JPG,char_data/D/P1010085.JPG_2.jpg,1763,480,640,41,12,53,87,130,False,15
D,25,kaist_dataset/Mixed/Digital_Camera/(C.S)C-outdoor6/P1010095.JPG,char_data/D/P1010095.JPG_2.jpg,525,480,640,21,174,195,184,209,False,15
D,50,kaist_dataset/Mixed/Digital_Camera/(C.S)C-outdoor6/P1010132.JPG,char_data/D/P1010132.JPG_4.jpg,1750,480,640,35,67,102,162,212,False,15
D,47,kaist_dataset/Mixed/Digital_Camera/(C.S)C-outdoor6/P1010132.JPG,char_data/D/P1010132.JPG_5.jpg,1880,480,640,40,331,371,155,202,False,15
D,72,kaist_dataset/Mixed/Digital_Camera/(C.S)D-indoor1/DSC02714.JPG,char_data/D/DSC02714.JPG_2.jpg,5256,480,640,73,300,373,116,188,False,15
D,47,kaist_dataset/Mixed/Digital_Camera/(C.S)D-indoor1/DSC02789.JPG,char_data/D/DSC02789.JPG_2.jpg,2585,480,640,55,86,141,172,219,False,15
D,44,kaist_dataset/Mixed/Digital_Camera/(C.S)D-indoor1/DSC02791.JPG,char_data/D/DSC02791.JPG_2.jpg,2772,480,640,63,88,151,262,306,False,15
D,40,kaist_dataset/Mixed/Digital_Camera/(C.S)D-indoor1/DSC02794.JPG,char_data/D/DSC02794.JPG_2.jpg,2440,480,640,61,85,146,275,315,False,15
D,51,kaist_dataset/Mixed/Digital_Camera/(C.S)D-indoor1/DSC02796.JPG,char_data/D/DSC02796.JPG_2.jpg,3060,480,640,60,65,125,300,351,False,15
D,42,kaist_dataset/Mixed/Digital_Camera/(C.S)D-indoor1/DSC03094.JPG,char_data/D/DSC03094.JPG_2.jpg,1428,480,640,34,236,270,149,191,False,15
D,37,kaist_dataset/Mixed/Digital_Camera/(C.S)D-indoor1/DSC03122.JPG,char_data/D/DSC03122.JPG_5.jpg,1147,480,640,31,356,387,145,182,False,15
D,41,kaist_dataset/Mixed/Digital_Camera/(C.S)D-indoor1/DSC03372.JPG,char_data/D/DSC03372.JPG_2.jpg,1476,480,640,36,154,190,418,459,False,15
D,51,kaist_dataset/Mixed/Digital_Camera/(C.S)D-indoor1/DSC03953.JPG,char_data/D/DSC03953.JPG_2.jpg,1530,480,640,30,219,249,383,434,False,15
D,35,kaist_dataset/Mixed/Digital_Camera/(C.S)D-indoor1/DSC03980.JPG,char_data/D/DSC03980.JPG_2.jpg,595,480,640,17,343,360,139,174,False,15
D,54,kaist_dataset/Mixed/Digital_Camera/(C.S)D-indoor1/DSC04009.JPG,char_data/D/DSC04009.JPG_2.jpg,2160,480,640,40,163,203,400,454,False,15
D,29,kaist_dataset/Mixed/Digital_Camera/(C.S)E-night/DSC02660.JPG,char_data/D/DSC02660.JPG_2.jpg,551,480,640,19,246,265,384,413,False,15
D,43,kaist_dataset/Mixed/Digital_Camera/(C.S)E-night/사진9.jpg수정.jpg,char_data/D/사진9.jpg수정.jpg_4.jpg,1806,480,680,42,130,172,207,250,False,15
D,49,kaist_dataset/Mixed/Digital_Camera/(C.S)E-night/사진9.jpg수정.jpg,char_data/D/사진9.jpg수정.jpg_5.jpg,2401,480,680,49,120,169,253,302,False,15
D,100,kaist_dataset/Mixed/Digital_Camera/(C.S)F-others/DSC02609.JPG,char_data/D/DSC02609.JPG_15.jpg,7800,480,640,78,275,353,191,291,False,15
D,36,kaist_dataset/Mixed/Digital_Camera/(C.S)F-others/DSC02609.JPG,char_data/D/DSC02609.JPG_16.jpg,864,480,640,24,198,222,317,353,False,15
D,51,kaist_dataset/Mixed/Digital_Camera/(C.S)F-others/DSC02793.JPG,char_data/D/DSC02793.JPG_2.jpg,2652,480,640,52,101,153,286,337,False,15
D,35,kaist_dataset/Mixed/Mobile_Phone/(C.M)C-bookCover/P090831062.jpg,char_data/D/P090831062.jpg_2.jpg,1225,480,640,35,102,137,309,344,False,15
D,53,kaist_dataset/Mixed/Mobile_Phone/(C.M)C-bookCover/P090903092.jpg,char_data/D/P090903092.jpg_2.jpg,2438,480,640,46,526,572,199,252,False,15
U,92,kaist_dataset/English/Digital_Camera/(E.S)A-shadow/DSC02633.JPG,char_data/U/DSC02633.JPG_2.jpg,5888,480,640,64,434,498,182,274,True,30
U,29,kaist_dataset/English/Digital_Camera/(E.S)B-light/080116-0059.jpg,char_data/U/080116-0059.jpg_8.jpg,406,1200,1600,14,698,712,802,831,True,30
U,28,kaist_dataset/English/Digital_Camera/(E.S)B-light/080116-0059.jpg,char_data/U/080116-0059.jpg_9.jpg,364,1200,1600,13,1105,1118,798,826,True,30
U,25,kaist_dataset/English/Digital_Camera/(E.S)B-light/080116-0059.jpg,char_data/U/080116-0059.jpg_10.jpg,300,1200,1600,12,959,971,800,825,True,30
U,32,kaist_dataset/English/Digital_Camera/(E.S)B-light/080116-0059.jpg,char_data/U/080116-0059.jpg_11.jpg,512,1200,1600,16,646,662,769,801,True,30
U,89,kaist_dataset/English/Digital_Camera/(E.S)B-light/080119-0038.jpg,char_data/U/080119-0038.jpg_4.jpg,6230,1200,1600,70,377,447,675,764,True,30
U,73,kaist_dataset/English/Digital_Camera/(E.S)B-light/080119-0038.jpg,char_data/U/080119-0038.jpg_5.jpg,5329,1200,1600,73,865,938,677,750,True,30
U,44,kaist_dataset/English/Digital_Camera/(E.S)B-light/DSC03007.JPG,char_data/U/DSC03007.JPG_4.jpg,1452,480,640,33,469,502,276,320,True,30
U,85,kaist_dataset/English/Digital_Camera/(E.S)B-light/DSC03007.JPG,char_data/U/DSC03007.JPG_5.jpg,4335,480,640,51,230,281,168,253,True,30
U,80,kaist_dataset/English/Digital_Camera/(E.S)B-light/크기변환_%B0%A3%C6%C74_fabdent.jpg,char_data/U/크기변환_%B0%A3%C6%C74_fabdent.jpg_2.jpg,5280,480,640,66,351,417,147,227,True,30
U,40,kaist_dataset/English/Digital_Camera/(E.S)C-outdoor1/001.jpg,char_data/U/001.jpg_2.jpg,960,257,470,24,175,199,23,63,True,30
U,44,kaist_dataset/English/Digital_Camera/(E.S)C-outdoor1/064.JPG,char_data/U/064.JPG_2.jpg,1188,480,640,27,422,449,185,229,True,30
U,93,kaist_dataset/English/Digital_Camera/(E.S)C-outdoor1/080116-0065.jpg,char_data/U/080116-0065.jpg_2.jpg,5208,600,800,56,399,455,244,337,True,30
U,42,kaist_dataset/English/Digital_Camera/(E.S)C-outdoor1/089.jpg,char_data/U/089.jpg_2.jpg,966,480,640,23,416,439,289,331,True,30
U,59,kaist_dataset/English/Digital_Camera/(E.S)C-outdoor1/139.JPG,char_data/U/139.JPG_2.jpg,2655,480,640,45,134,179,255,314,True,30
U,133,kaist_dataset/English/Digital_Camera/(E.S)C-outdoor1/2007-12-09-day-exterior-063.jpg,char_data/U/2007-12-09-day-exterior-063.jpg_2.jpg,12502,1200,1600,94,800,894,424,557,True,30
U,42,kaist_dataset/English/Digital_Camera/(E.S)C-outdoor1/6.jpg,char_data/U/6.jpg_2.jpg,1806,255,731,43,390,433,96,138,True,30
U,67,kaist_dataset/English/Digital_Camera/(E.S)C-outdoor1/DSC02243.JPG,char_data/U/DSC02243.JPG_2.jpg,2077,480,640,31,462,493,220,287,True,30
U,82,kaist_dataset/English/Digital_Camera/(E.S)C-outdoor1/DSC02384.JPG,char_data/U/DSC02384.JPG_2.jpg,4920,480,640,60,225,285,225,307,True,30
U,70,kaist_dataset/English/Digital_Camera/(E.S)C-outdoor1/DSC02394.JPG,char_data/U/DSC02394.JPG_2.jpg,3780,480,640,54,207,261,254,324,True,30
U,72,kaist_dataset/English/Digital_Camera/(E.S)C-outdoor1/DSC02398.JPG,char_data/U/DSC02398.JPG_2.jpg,4464,480,640,62,228,290,232,304,True,30
U,82,kaist_dataset/English/Digital_Camera/(E.S)C-outdoor1/DSC02410.JPG,char_data/U/DSC02410.JPG_2.jpg,6396,480,640,78,402,480,121,203,True,30
U,117,kaist_dataset/English/Digital_Camera/(E.S)C-outdoor1/DSC02427.JPG,char_data/U/DSC02427.JPG_4.jpg,8541,480,640,73,420,493,105,222,True,30
U,136,kaist_dataset/English/Digital_Camera/(E.S)C-outdoor1/DSC02448.JPG,char_data/U/DSC02448.JPG_2.jpg,11152,480,640,82,217,299,35,171,True,30
U,109,kaist_dataset/English/Digital_Camera/(E.S)C-outdoor1/DSC02450.JPG,char_data/U/DSC02450.JPG_4.jpg,6758,480,640,62,283,345,79,188,True,30
U,116,kaist_dataset/English/Digital_Camera/(E.S)C-outdoor1/DSC02450.JPG,char_data/U/DSC02450.JPG_5.jpg,5916,480,640,51,473,524,74,190,True,30
U,58,kaist_dataset/English/Digital_Camera/(E.S)C-outdoor1/DSC02501.JPG,char_data/U/DSC02501.JPG_2.jpg,2900,480,640,50,161,211,298,356,True,30
U,65,kaist_dataset/English/Digital_Camera/(E.S)C-outdoor1/DSC02619.JPG,char_data/U/DSC02619.JPG_4.jpg,2795,480,640,43,78,121,220,285,True,30
U,65,kaist_dataset/English/Digital_Camera/(E.S)C-outdoor1/DSC02619.JPG,char_data/U/DSC02619.JPG_5.jpg,2925,480,640,45,493,538,210,275,True,30
U,87,kaist_dataset/English/Digital_Camera/(E.S)C-outdoor1/DSC02897.JPG,char_data/U/DSC02897.JPG_2.jpg,6090,480,640,70,429,499,269,356,True,30
U,105,kaist_dataset/English/Digital_Camera/(E.S)C-outdoor2/DSC02984.JPG,char_data/U/DSC02984.JPG_2.jpg,7245,480,640,69,216,285,100,205,True,30
U,82,kaist_dataset/English/Digital_Camera/(E.S)C-outdoor2/DSC02993.JPG,char_data/U/DSC02993.JPG_4.jpg,4920,480,640,60,288,348,227,309,True,30
U,75,kaist_dataset/English/Digital_Camera/(E.S)C-outdoor2/DSC02993.JPG,char_data/U/DSC02993.JPG_5.jpg,4575,480,640,61,329,390,126,201,True,30
U,41,kaist_dataset/English/Digital_Camera/(E.S)C-outdoor2/DSC03279.JPG,char_data/U/DSC03279.JPG_2.jpg,1230,480,640,30,265,295,214,255,True,30
U,43,kaist_dataset/English/Digital_Camera/(E.S)C-outdoor2/DSC03317.JPG,char_data/U/DSC03317.JPG_2.jpg,774,480,640,18,455,473,198,241,True,30
U,56,kaist_dataset/English/Digital_Camera/(E.S)C-outdoor2/DSC03414.JPG,char_data/U/DSC03414.JPG_2.jpg,2688,480,640,48,313,361,352,408,True,30
U,44,kaist_dataset/English/Digital_Camera/(E.S)C-outdoor2/DSC03575.JPG,char_data/U/DSC03575.JPG_2.jpg,1408,480,640,32,163,195,181,225,True,30
U,96,kaist_dataset/English/Digital_Camera/(E.S)C-outdoor2/DSC03705.JPG,char_data/U/DSC03705.JPG_2.jpg,6144,480,640,64,135,199,182,278,True,30
U,98,kaist_dataset/English/Digital_Camera/(E.S)C-outdoor2/DSC03831.JPG,char_data/U/DSC03831.JPG_4.jpg,6566,480,640,67,283,350,16,114,True,30
U,42,kaist_dataset/English/Digital_Camera/(E.S)C-outdoor2/DSC03831.JPG,char_data/U/DSC03831.JPG_5.jpg,1050,480,640,25,471,496,125,167,True,30
U,74,kaist_dataset/English/Digital_Camera/(E.S)C-outdoor2/DSC04079.JPG,char_data/U/DSC04079.JPG_8.jpg,2960,480,640,40,311,351,265,339,True,30
U,61,kaist_dataset/English/Digital_Camera/(E.S)C-outdoor2/DSC04079.JPG,char_data/U/DSC04079.JPG_9.jpg,2379,480,640,39,106,145,35,96,True,30
U,59,kaist_dataset/English/Digital_Camera/(E.S)C-outdoor2/DSC04079.JPG,char_data/U/DSC04079.JPG_10.jpg,2419,480,640,41,389,430,43,102,True,30
U,68,kaist_dataset/English/Digital_Camera/(E.S)C-outdoor2/DSC04080.JPG,char_data/U/DSC04080.JPG_2.jpg,4692,480,640,69,90,159,291,359,True,30
U,73,kaist_dataset/English/Digital_Camera/(E.S)C-outdoor2/DSC04251.JPG,char_data/U/DSC04251.JPG_2.jpg,4015,480,640,55,461,516,66,139,True,30
U,133,kaist_dataset/English/Digital_Camera/(E.S)C-outdoor2/DSC04432.JPG,char_data/U/DSC04432.JPG_5.jpg,13699,480,640,103,410,513,190,323,True,30
U,32,kaist_dataset/English/Digital_Camera/(E.S)C-outdoor2/DSC04437.JPG,char_data/U/DSC04437.JPG_8.jpg,512,480,640,16,92,108,39,71,True,30
U,31,kaist_dataset/English/Digital_Camera/(E.S)C-outdoor2/DSC04437.JPG,char_data/U/DSC04437.JPG_10.jpg,558,480,640,18,92,110,74,105,True,30
U,64,kaist_dataset/English/Digital_Camera/(E.S)C-outdoor2/DSC04464.JPG,char_data/U/DSC04464.JPG_2.jpg,2368,480,640,37,519,556,322,386,True,30
U,52,kaist_dataset/English/Digital_Camera/(E.S)C-outdoor3/DSC02690.JPG,char_data/U/DSC02690.JPG_4.jpg,2184,480,640,42,239,281,167,219,True,30
U,63,kaist_dataset/English/Digital_Camera/(E.S)C-outdoor3/DSC02690.JPG,char_data/U/DSC02690.JPG_5.jpg,3087,480,640,49,327,376,209,272,True,30
U,73,kaist_dataset/English/Digital_Camera/(E.S)C-outdoor3/DSC03046.JPG,char_data/U/DSC03046.JPG_2.jpg,4234,480,640,58,244,302,130,203,True,30
U,51,kaist_dataset/English/Digital_Camera/(E.S)C-outdoor3/s.jpg,char_data/U/s.jpg_2.jpg,1632,240,320,32,102,134,79,130,True,30
U,65,kaist_dataset/English/Digital_Camera/(E.S)C-outdoor3/크기변환_%C8%AD%C0%CC%C6%AE%C4%FE%C6%AE%B0%A3%C6%C7_%BA%B9%BB%E7_1-bona0007.jpg,char_data/U/크기변환_%C8%AD%C0%CC%C6%AE%C4%FE%C6%AE%B0%A3%C6%C7_%BA%B9%BB%E7_1-bona0007.jpg_2.jpg,3315,480,640,51,372,423,274,339,True,30
U,32,kaist_dataset/English/Digital_Camera/(E.S)D-indoor/080119-0015.jpg,char_data/U/080119-0015.jpg_2.jpg,1088,1200,1600,34,593,627,642,674,True,30
U,86,kaist_dataset/English/Digital_Camera/(E.S)D-indoor/DSC03367.JPG,char_data/U/DSC03367.JPG_2.jpg,6536,480,640,76,306,382,31,117,True,30
U,69,kaist_dataset/English/Digital_Camera/(E.S)D-indoor/DSC03887.JPG,char_data/U/DSC03887.JPG_2.jpg,3933,480,640,57,154,211,167,236,True,30
U,80,kaist_dataset/English/Digital_Camera/(E.S)D-indoor/DSC04255.JPG,char_data/U/DSC04255.JPG_2.jpg,5920,480,640,74,368,442,298,378,True,30
U,90,kaist_dataset/English/Digital_Camera/(E.S)E-night/DSC02675.JPG,char_data/U/DSC02675.JPG_2.jpg,6390,480,640,71,278,349,179,269,True,30
U,62,kaist_dataset/English/Digital_Camera/(E.S)F-others/032.jpg,char_data/U/032.jpg_2.jpg,2356,245,422,38,213,251,63,125,True,30
U,137,kaist_dataset/English/Digital_Camera/(E.S)F-others/080116-0060.jpg,char_data/U/080116-0060.jpg_2.jpg,13015,1200,1600,95,1304,1399,378,515,True,30
U,178,kaist_dataset/English/Digital_Camera/(E.S)F-others/080119-0007.jpg,char_data/U/080119-0007.jpg_5.jpg,39872,1200,1600,224,655,879,513,691,True,30
U,91,kaist_dataset/English/Digital_Camera/(E.S)F-others/2007-12-09-day-exterior-047.jpg,char_data/U/2007-12-09-day-exterior-047.jpg_2.jpg,2912,1200,1600,32,23,55,458,549,True,30
U,141,kaist_dataset/English/Mobile_Phone/(E.M)C-bookCover/P090831037.jpg,char_data/U/P090831037.jpg_2.jpg,17766,480,640,126,392,518,187,328,True,30
U,63,kaist_dataset/English/Mobile_Phone/(E.M)C-bookCover/P090903041.jpg,char_data/U/P090903041.jpg_2.jpg,4032,480,640,64,90,154,17,80,True,30
U,32,kaist_dataset/English/Mobile_Phone/(E.M)C-bookCover/P090903055.jpg,char_data/U/P090903055.jpg_2.jpg,1120,480,640,35,439,474,410,442,True,30
U,19,kaist_dataset/Korean/Digital_Camera/G-others/5.jpg,char_data/U/5.jpg_2.jpg,266,553,798,14,186,200,39,58,True,30
U,30,kaist_dataset/Korean/Digital_Camera/indoor1/2007-12-08-day-139.jpg,char_data/U/2007-12-08-day-139.jpg_2.jpg,630,1200,1600,21,450,471,355,385,True,30
U,53,kaist_dataset/Korean/Digital_Camera/indoor1/DSC03092.JPG,char_data/U/DSC03092.JPG_2.jpg,2385,480,640,45,76,121,78,131,True,30
U,78,kaist_dataset/Korean/Digital_Camera/outdoor6/DSC04439.JPG,char_data/U/DSC04439.JPG_2.jpg,5148,480,640,66,59,125,55,133,True,30
U,67,kaist_dataset/Mixed/Digital_Camera/(C.S)A-shadow/DSC03520.JPG,char_data/U/DSC03520.JPG_2.jpg,2613,480,640,39,313,352,44,111,True,30
U,70,kaist_dataset/Mixed/Digital_Camera/(C.S)C-outdoor1/046.JPG,char_data/U/046.JPG_2.jpg,3570,480,640,51,483,534,194,264,True,30
U,277,kaist_dataset/Mixed/Digital_Camera/(C.S)C-outdoor1/080118-0007.jpg,char_data/U/080118-0007.jpg_2.jpg,74236,1200,1600,268,588,856,427,704,True,30
U,47,kaist_dataset/Mixed/Digital_Camera/(C.S)C-outdoor1/119.JPG,char_data/U/119.JPG_2.jpg,1786,480,640,38,383,421,191,238,True,30
U,29,kaist_dataset/Mixed/Digital_Camera/(C.S)C-outdoor1/121.JPG,char_data/U/121.JPG_2.jpg,435,480,640,15,138,153,217,246,True,30
U,22,kaist_dataset/Mixed/Digital_Camera/(C.S)C-outdoor1/135.JPG,char_data/U/135.JPG_2.jpg,330,480,640,15,343,358,175,197,True,30
U,68,kaist_dataset/Mixed/Digital_Camera/(C.S)C-outdoor1/2.JPG,char_data/U/2.JPG_6.jpg,3128,576,768,46,510,556,205,273,True,30
U,26,kaist_dataset/Mixed/Digital_Camera/(C.S)C-outdoor1/2.JPG,char_data/U/2.JPG_8.jpg,390,576,768,15,617,632,371,397,True,30
U,50,kaist_dataset/Mixed/Digital_Camera/(C.S)C-outdoor1/3.JPG,char_data/U/3.JPG_6.jpg,2050,576,768,41,396,437,229,279,True,30
U,23,kaist_dataset/Mixed/Digital_Camera/(C.S)C-outdoor1/3.JPG,char_data/U/3.JPG_7.jpg,253,576,768,11,600,611,294,317,True,30
U,15,kaist_dataset/Mixed/Digital_Camera/(C.S)C-outdoor1/3.JPG,char_data/U/3.JPG_8.jpg,135,576,768,9,125,134,294,309,True,30
U,58,kaist_dataset/Mixed/Digital_Camera/(C.S)C-outdoor2/DSC02365.JPG,char_data/U/DSC02365.JPG_2.jpg,1508,480,640,26,209,235,90,148,True,30
U,33,kaist_dataset/Mixed/Digital_Camera/(C.S)C-outdoor2/DSC02418.JPG,char_data/U/DSC02418.JPG_2.jpg,759,480,640,23,79,102,87,120,True,30
U,34,kaist_dataset/Mixed/Digital_Camera/(C.S)C-outdoor2/DSC02429.JPG,char_data/U/DSC02429.JPG_2.jpg,1088,480,640,32,549,581,117,151,True,30
U,37,kaist_dataset/Mixed/Digital_Camera/(C.S)C-outdoor2/DSC02557.JPG,char_data/U/DSC02557.JPG_2.jpg,888,480,640,24,28,52,224,261,True,30
U,114,kaist_dataset/Mixed/Digital_Camera/(C.S)C-outdoor2/DSC02917.JPG,char_data/U/DSC02917.JPG_4.jpg,8208,480,640,72,139,211,69,183,True,30
U,35,kaist_dataset/Mixed/Digital_Camera/(C.S)C-outdoor2/DSC02917.JPG,char_data/U/DSC02917.JPG_5.jpg,840,480,640,24,20,44,221,256,True,30
U,39,kaist_dataset/Mixed/Digital_Camera/(C.S)C-outdoor3/DSC02986.JPG,char_data/U/DSC02986.JPG_2.jpg,1092,480,640,28,386,414,278,317,True,30
U,38,kaist_dataset/Mixed/Digital_Camera/(C.S)C-outdoor3/DSC02989.JPG,char_data/U/DSC02989.JPG_2.jpg,950,480,640,25,23,48,169,207,True,30
U,29,kaist_dataset/Mixed/Digital_Camera/(C.S)C-outdoor3/DSC03035.JPG,char_data/U/DSC03035.JPG_2.jpg,609,480,640,21,377,398,371,400,True,30
U,99,kaist_dataset/Mixed/Digital_Camera/(C.S)C-outdoor3/DSC03217.JPG,char_data/U/DSC03217.JPG_2.jpg,9108,480,640,92,422,514,238,337,True,30
U,37,kaist_dataset/Mixed/Digital_Camera/(C.S)C-outdoor3/DSC03233.JPG,char_data/U/DSC03233.JPG_2.jpg,777,480,640,21,82,103,285,322,True,30
U,94,kaist_dataset/Mixed/Digital_Camera/(C.S)C-outdoor3/DSC03247.JPG,char_data/U/DSC03247.JPG_2.jpg,4982,480,640,53,473,526,166,260,True,30
U,38,kaist_dataset/Mixed/Digital_Camera/(C.S)C-outdoor3/DSC03254.JPG,char_data/U/DSC03254.JPG_2.jpg,1558,480,640,41,147,188,226,264,True,30
U,74,kaist_dataset/Mixed/Digital_Camera/(C.S)C-outdoor3/DSC03274.JPG,char_data/U/DSC03274.JPG_2.jpg,5180,480,640,70,270,340,84,158,True,30
U,62,kaist_dataset/Mixed/Digital_Camera/(C.S)C-outdoor3/DSC03283.JPG,char_data/U/DSC03283.JPG_4.jpg,2728,480,640,44,282,326,66,128,True,30
U,69,kaist_dataset/Mixed/Digital_Camera/(C.S)C-outdoor3/DSC03283.JPG,char_data/U/DSC03283.JPG_5.jpg,3105,480,640,45,380,425,65,134,True,30
U,32,kaist_dataset/Mixed/Digital_Camera/(C.S)C-outdoor3/DSC03328.JPG,char_data/U/DSC03328.JPG_2.jpg,736,480,640,23,413,436,232,264,True,30
U,39,kaist_dataset/Mixed/Digital_Camera/(C.S)C-outdoor4/DSC03581.JPG,char_data/U/DSC03581.JPG_2.jpg,1404,480,640,36,87,123,193,232,True,30
U,81,kaist_dataset/Mixed/Digital_Camera/(C.S)C-outdoor4/DSC03666.JPG,char_data/U/DSC03666.JPG_2.jpg,5103,480,640,63,227,290,160,241,True,30
U,26,kaist_dataset/Mixed/Digital_Camera/(C.S)C-outdoor4/DSC03687.JPG,char_data/U/DSC03687.JPG_2.jpg,390,480,640,15,189,204,294,320,True,30
U,77,kaist_dataset/Mixed/Digital_Camera/(C.S)C-outdoor5/DSC03820.JPG,char_data/U/DSC03820.JPG_2.jpg,3927,480,640,51,278,329,359,436,True,30
U,136,kaist_dataset/Mixed/Digital_Camera/(C.S)C-outdoor5/DSC03830.JPG,char_data/U/DSC03830.JPG_2.jpg,17272,480,640,127,163,290,129,265,True,30
U,116,kaist_dataset/Mixed/Digital_Camera/(C.S)C-outdoor5/DSC04055.JPG,char_data/U/DSC04055.JPG_4.jpg,9976,480,640,86,384,470,243,359,True,30
U,39,kaist_dataset/Mixed/Digital_Camera/(C.S)C-outdoor5/DSC04055.JPG,char_data/U/DSC04055.JPG_5.jpg,507,480,640,13,239,252,371,410,True,30
U,97,kaist_dataset/Mixed/Digital_Camera/(C.S)C-outdoor5/DSC04151.JPG,char_data/U/DSC04151.JPG_2.jpg,7275,480,640,75,261,336,238,335,True,30
U,38,kaist_dataset/Mixed/Digital_Camera/(C.S)C-outdoor5/DSC04321.JPG,char_data/U/DSC04321.JPG_5.jpg,1064,480,640,28,402,430,199,237,True,30
U,44,kaist_dataset/Mixed/Digital_Camera/(C.S)C-outdoor5/DSC04338.JPG,char_data/U/DSC04338.JPG_2.jpg,968,480,640,22,46,68,193,237,True,30
U,40,kaist_dataset/Mixed/Digital_Camera/(C.S)C-outdoor5/DSC04434.JPG,char_data/U/DSC04434.JPG_4.jpg,1160,480,640,29,239,268,271,311,False,30
U,39,kaist_dataset/Mixed/Digital_Camera/(C.S)C-outdoor5/DSC04434.JPG,char_data/U/DSC04434.JPG_5.jpg,1131,480,640,29,337,366,387,426,False,30
U,59,kaist_dataset/Mixed/Digital_Camera/(C.S)C-outdoor5/DSC04447.JPG,char_data/U/DSC04447.JPG_2.jpg,2183,480,640,37,231,268,347,406,False,30
U,25,kaist_dataset/Mixed/Digital_Camera/(C.S)C-outdoor6/P1010063.JPG,char_data/U/P1010063.JPG_4.jpg,325,480,640,13,234,247,431,456,False,30
U,21,kaist_dataset/Mixed/Digital_Camera/(C.S)C-outdoor6/P1010063.JPG,char_data/U/P1010063.JPG_5.jpg,231,480,640,11,363,374,384,405,False,30
U,22,kaist_dataset/Mixed/Digital_Camera/(C.S)C-outdoor6/P1010065.JPG,char_data/U/P1010065.JPG_2.jpg,264,480,640,12,201,213,108,130,False,30
U,50,kaist_dataset/Mixed/Digital_Camera/(C.S)C-outdoor6/P1010132.JPG,char_data/U/P1010132.JPG_4.jpg,1700,480,640,34,99,133,157,207,False,30
U,45,kaist_dataset/Mixed/Digital_Camera/(C.S)C-outdoor6/P1010132.JPG,char_data/U/P1010132.JPG_5.jpg,1665,480,640,37,461,498,153,198,False,30
U,37,kaist_dataset/Mixed/Digital_Camera/(C.S)D-indoor1/DSC02714.JPG,char_data/U/DSC02714.JPG_2.jpg,1369,480,640,37,291,328,75,112,False,30
U,42,kaist_dataset/Mixed/Digital_Camera/(C.S)D-indoor1/DSC03372.JPG,char_data/U/DSC03372.JPG_2.jpg,1764,480,640,42,505,547,390,432,False,30
U,82,kaist_dataset/Mixed/Digital_Camera/(C.S)D-indoor1/DSC03500.JPG,char_data/U/DSC03500.JPG_2.jpg,6150,480,640,75,399,474,97,179,False,30
U,34,kaist_dataset/Mixed/Digital_Camera/(C.S)D-indoor1/DSC03904.JPG,char_data/U/DSC03904.JPG_2.jpg,680,480,640,20,359,379,216,250,False,30
U,46,kaist_dataset/Mixed/Digital_Camera/(C.S)D-indoor1/DSC03980.JPG,char_data/U/DSC03980.JPG_2.jpg,966,480,640,21,293,314,134,180,False,30
U,40,kaist_dataset/Mixed/Digital_Camera/(C.S)D-indoor2/DSC04254.JPG,char_data/U/DSC04254.JPG_6.jpg,1000,480,640,25,134,159,340,380,False,30
U,64,kaist_dataset/Mixed/Digital_Camera/(C.S)D-indoor2/DSC04487.JPG,char_data/U/DSC04487.JPG_2.jpg,2816,480,640,44,110,154,152,216,False,30
U,178,kaist_dataset/Mixed/Digital_Camera/(C.S)E-night/DSC02602.JPG,char_data/U/DSC02602.JPG_2.jpg,17978,480,640,101,108,209,116,294,False,30
U,67,kaist_dataset/Mixed/Digital_Camera/(C.S)E-night/DSC02672.JPG,char_data/U/DSC02672.JPG_4.jpg,3149,480,640,47,200,247,95,162,False,30
U,50,kaist_dataset/Mixed/Digital_Camera/(C.S)E-night/DSC02672.JPG,char_data/U/DSC02672.JPG_5.jpg,1300,480,640,26,427,453,173,223,False,30
U,56,kaist_dataset/Mixed/Digital_Camera/(C.S)E-night/DSC03517.JPG,char_data/U/DSC03517.JPG_2.jpg,1736,480,640,31,468,499,189,245,False,30
U,31,kaist_dataset/Mixed/Digital_Camera/(C.S)E-night/DSC03871.JPG,char_data/U/DSC03871.JPG_2.jpg,806,480,640,26,425,451,192,223,False,30
U,43,kaist_dataset/Mixed/Digital_Camera/(C.S)E-night/사진9.jpg수정.jpg,char_data/U/사진9.jpg수정.jpg_4.jpg,1892,480,680,44,172,216,206,249,False,30
U,44,kaist_dataset/Mixed/Digital_Camera/(C.S)E-night/사진9.jpg수정.jpg,char_data/U/사진9.jpg수정.jpg_5.jpg,2112,480,680,48,258,306,249,293,False,30
U,45,kaist_dataset/Mixed/Digital_Camera/(C.S)F-others/085.jpg,char_data/U/085.jpg_2.jpg,1305,480,640,29,340,369,182,227,False,30
U,25,kaist_dataset/Mixed/Digital_Camera/(C.S)F-others/097.jpg,char_data/U/097.jpg_2.jpg,400,480,640,16,322,338,171,196,False,30
U,122,kaist_dataset/Mixed/Digital_Camera/(C.S)F-others/DSC02504.JPG,char_data/U/DSC02504.JPG_4.jpg,12810,480,640,105,312,417,197,319,False,30
U,49,kaist_dataset/Mixed/Digital_Camera/(C.S)F-others/DSC02504.JPG,char_data/U/DSC02504.JPG_5.jpg,1470,480,640,30,393,423,323,372,False,30
U,54,kaist_dataset/Mixed/Mobile_Phone/(C.M)B-indoor/P090831013.jpg,char_data/U/P090831013.jpg_4.jpg,2862,480,640,53,86,139,184,238,False,30
U,44,kaist_dataset/Mixed/Mobile_Phone/(C.M)B-indoor/P090831021.jpg,char_data/U/P090831021.jpg_2.jpg,1408,480,640,32,297,329,374,418,False,30
동,135,kaist_dataset/Korean/Digital_Camera/A-shadow/DSC02653.JPG,char_data/동/DSC02653.JPG_2.jpg,18630,480,640,138,247,385,33,168,True,57
동,82,kaist_dataset/Korean/Digital_Camera/A-shadow/DSC02670.JPG,char_data/동/DSC02670.JPG_2.jpg,6068,480,640,74,401,475,181,263,True,57
동,92,kaist_dataset/Korean/Digital_Camera/A-shadow/DSC03216.JPG,char_data/동/DSC03216.JPG_2.jpg,7268,480,640,79,147,226,70,162,True,57
동,35,kaist_dataset/Korean/Digital_Camera/A-shadow/DSC03536.JPG,char_data/동/DSC03536.JPG_4.jpg,840,480,640,24,163,187,239,274,True,57
동,88,kaist_dataset/Korean/Digital_Camera/A-shadow/DSC03536.JPG,char_data/동/DSC03536.JPG_5.jpg,6776,480,640,77,325,402,46,134,True,57
동,62,kaist_dataset/Korean/Digital_Camera/A-shadow/DSC03755.JPG,char_data/동/DSC03755.JPG_2.jpg,3472,480,640,56,289,345,124,186,True,57
동,58,kaist_dataset/Korean/Digital_Camera/A-shadow/DSC04297.JPG,char_data/동/DSC04297.JPG_2.jpg,4582,480,640,79,195,274,148,206,True,57
동,109,kaist_dataset/Korean/Digital_Camera/A-shadow/DSC04311.JPG,char_data/동/DSC04311.JPG_2.jpg,5123,480,640,47,93,140,261,370,True,57
동,143,kaist_dataset/Korean/Digital_Camera/E-night/DSC03503.JPG,char_data/동/DSC03503.JPG_2.jpg,16445,480,640,115,295,410,92,235,True,57
동,135,kaist_dataset/Korean/Digital_Camera/E-night/DSC03849.JPG,char_data/동/DSC03849.JPG_2.jpg,14580,480,640,108,93,201,38,173,True,57
동,38,kaist_dataset/Korean/Digital_Camera/G-others/003.jpg,char_data/동/003.jpg_2.jpg,1178,286,413,31,164,195,154,192,True,57
동,204,kaist_dataset/Korean/Digital_Camera/G-others/2007-12-08-day-045.jpg,char_data/동/2007-12-08-day-045.jpg_2.jpg,26724,1200,1600,131,18,149,568,772,True,57
동,98,kaist_dataset/Korean/Digital_Camera/G-others/DSC03434.JPG,char_data/동/DSC03434.JPG_2.jpg,11564,480,640,118,281,399,208,306,True,57
동,101,kaist_dataset/Korean/Digital_Camera/indoor1/DSC02708.JPG,char_data/동/DSC02708.JPG_2.jpg,5454,480,640,54,436,490,256,357,True,57
동,115,kaist_dataset/Korean/Digital_Camera/indoor1/DSC02737.JPG,char_data/동/DSC02737.JPG_2.jpg,7820,480,640,68,126,194,246,361,True,57
동,110,kaist_dataset/Korean/Digital_Camera/indoor1/DSC02759.JPG,char_data/동/DSC02759.JPG_2.jpg,12540,480,640,114,181,295,182,292,True,57
동,114,kaist_dataset/Korean/Digital_Camera/indoor1/DSC02760.JPG,char_data/동/DSC02760.JPG_2.jpg,10830,480,640,95,158,253,201,315,True,57
동,58,kaist_dataset/Korean/Digital_Camera/indoor1/DSC03364.JPG,char_data/동/DSC03364.JPG_2.jpg,1392,480,640,24,321,345,169,227,True,57
동,86,kaist_dataset/Korean/Digital_Camera/indoor2/DSC03392.JPG,char_data/동/DSC03392.JPG_2.jpg,6020,480,640,70,291,361,365,451,True,57
동,57,kaist_dataset/Korean/Digital_Camera/indoor2/DSC03475.JPG,char_data/동/DSC03475.JPG_2.jpg,2907,480,640,51,227,278,26,83,True,57
동,126,kaist_dataset/Korean/Digital_Camera/indoor2/DSC03480.JPG,char_data/동/DSC03480.JPG_2.jpg,10458,480,640,83,428,511,321,447,True,57
동,113,kaist_dataset/Korean/Digital_Camera/indoor2/DSC03565.JPG,char_data/동/DSC03565.JPG_2.jpg,11187,480,640,99,410,509,131,244,True,57
동,86,kaist_dataset/Korean/Digital_Camera/indoor2/DSC03698.JPG,char_data/동/DSC03698.JPG_2.jpg,8686,480,640,101,258,359,238,324,True,57
동,178,kaist_dataset/Korean/Digital_Camera/indoor2/DSC03700.JPG,char_data/동/DSC03700.JPG_2.jpg,15664,480,640,88,158,246,126,304,True,57
동,92,kaist_dataset/Korean/Digital_Camera/indoor2/DSC04179.JPG,char_data/동/DSC04179.JPG_2.jpg,5520,480,640,60,212,272,132,224,True,57
동,79,kaist_dataset/Korean/Digital_Camera/indoor2/DSC04195.JPG,char_data/동/DSC04195.JPG_2.jpg,5293,480,640,67,322,389,65,144,True,57
동,31,kaist_dataset/Korean/Digital_Camera/outdoor1/045.JPG,char_data/동/045.JPG_2.jpg,806,480,640,26,394,420,261,292,True,57
동,64,kaist_dataset/Korean/Digital_Camera/outdoor1/100.jpg,char_data/동/100.jpg_4.jpg,3776,480,640,59,264,323,136,200,True,57
동,24,kaist_dataset/Korean/Digital_Camera/outdoor1/100.jpg,char_data/동/100.jpg_5.jpg,528,480,640,22,279,301,212,236,True,57
동,147,kaist_dataset/Korean/Digital_Camera/outdoor1/105.JPG,char_data/동/105.JPG_2.jpg,14847,480,640,101,397,498,144,291,True,57
동,23,kaist_dataset/Korean/Digital_Camera/outdoor1/109.JPG,char_data/동/109.JPG_6.jpg,391,480,640,17,344,361,2,25,True,57
동,37,kaist_dataset/Korean/Digital_Camera/outdoor1/109.JPG,char_data/동/109.JPG_7.jpg,1221,480,640,33,122,155,106,143,True,57
동,94,kaist_dataset/Korean/Digital_Camera/outdoor1/109.JPG,char_data/동/109.JPG_8.jpg,5264,480,640,56,147,203,168,262,True,57
동,59,kaist_dataset/Korean/Digital_Camera/outdoor2/2007-12-08-day-101.jpg,char_data/동/2007-12-08-day-101.jpg_2.jpg,1947,1200,1600,33,655,688,641,700,True,57
동,36,kaist_dataset/Korean/Digital_Camera/outdoor2/DSC02311.JPG,char_data/동/DSC02311.JPG_2.jpg,792,480,640,22,387,409,255,291,True,57
동,86,kaist_dataset/Korean/Digital_Camera/outdoor2/DSC02314.JPG,char_data/동/DSC02314.JPG_2.jpg,5332,480,640,62,141,203,92,178,True,57
동,98,kaist_dataset/Korean/Digital_Camera/outdoor2/DSC02343.JPG,char_data/동/DSC02343.JPG_2.jpg,7154,480,640,73,442,515,123,221,True,57
동,39,kaist_dataset/Korean/Digital_Camera/outdoor2/DSC02366.JPG,char_data/동/DSC02366.JPG_2.jpg,1248,480,640,32,208,240,406,445,True,57
동,26,kaist_dataset/Korean/Digital_Camera/outdoor2/DSC02380.JPG,char_data/동/DSC02380.JPG_2.jpg,468,480,640,18,29,47,256,282,True,57
동,103,kaist_dataset/Korean/Digital_Camera/outdoor2/DSC02383.JPG,char_data/동/DSC02383.JPG_2.jpg,11227,480,640,109,336,445,160,263,True,57
동,35,kaist_dataset/Korean/Digital_Camera/outdoor2/DSC02453.JPG,char_data/동/DSC02453.JPG_2.jpg,1015,480,640,29,579,608,240,275,True,57
동,96,kaist_dataset/Korean/Digital_Camera/outdoor2/DSC02470.JPG,char_data/동/DSC02470.JPG_2.jpg,6432,480,640,67,114,181,266,362,True,57
동,44,kaist_dataset/Korean/Digital_Camera/outdoor2/DSC02506.JPG,char_data/동/DSC02506.JPG_2.jpg,968,480,640,22,157,179,54,98,True,57
동,105,kaist_dataset/Korean/Digital_Camera/outdoor3/DSC02525.JPG,char_data/동/DSC02525.JPG_2.jpg,10290,480,640,98,164,262,146,251,True,57
동,176,kaist_dataset/Korean/Digital_Camera/outdoor3/DSC02983.JPG,char_data/동/DSC02983.JPG_2.jpg,22352,480,640,127,233,360,117,293,True,57
동,99,kaist_dataset/Korean/Digital_Camera/outdoor3/DSC03058.JPG,char_data/동/DSC03058.JPG_2.jpg,8910,480,640,90,356,446,82,181,True,57
동,75,kaist_dataset/Korean/Digital_Camera/outdoor3/DSC03188.JPG,char_data/동/DSC03188.JPG_2.jpg,8925,480,640,119,229,348,159,234,True,57
동,152,kaist_dataset/Korean/Digital_Camera/outdoor4/DSC03253.JPG,char_data/동/DSC03253.JPG_2.jpg,12464,480,640,82,306,388,306,458,True,57
동,154,kaist_dataset/Korean/Digital_Camera/outdoor4/DSC03452.JPG,char_data/동/DSC03452.JPG_4.jpg,6930,480,640,45,271,316,111,265,True,57
동,87,kaist_dataset/Korean/Digital_Camera/outdoor4/DSC03452.JPG,char_data/동/DSC03452.JPG_5.jpg,5481,480,640,63,106,169,274,361,True,57
동,52,kaist_dataset/Korean/Digital_Camera/outdoor4/DSC03589.JPG,char_data/동/DSC03589.JPG_2.jpg,1716,480,640,33,274,307,196,248,True,57
동,52,kaist_dataset/Korean/Digital_Camera/outdoor4/DSC03603.JPG,char_data/동/DSC03603.JPG_4.jpg,3068,480,640,59,292,351,53,105,True,57
동,62,kaist_dataset/Korean/Digital_Camera/outdoor4/DSC03603.JPG,char_data/동/DSC03603.JPG_5.jpg,4030,480,640,65,305,370,383,445,True,57
동,78,kaist_dataset/Korean/Digital_Camera/outdoor4/DSC03607.JPG,char_data/동/DSC03607.JPG_4.jpg,5850,480,640,75,163,238,265,343,True,57
동,81,kaist_dataset/Korean/Digital_Camera/outdoor4/DSC03607.JPG,char_data/동/DSC03607.JPG_5.jpg,5751,480,640,71,164,235,355,436,True,57
동,63,kaist_dataset/Korean/Digital_Camera/outdoor4/DSC03611.JPG,char_data/동/DSC03611.JPG_2.jpg,3780,480,640,60,164,224,404,467,True,57
동,77,kaist_dataset/Korean/Digital_Camera/outdoor5/DSC03626.JPG,char_data/동/DSC03626.JPG_2.jpg,4851,480,640,63,327,390,199,276,True,57
동,118,kaist_dataset/Korean/Digital_Camera/outdoor5/DSC03692.JPG,char_data/동/DSC03692.JPG_2.jpg,11446,480,640,97,212,309,55,173,True,57
동,284,kaist_dataset/Korean/Digital_Camera/outdoor5/DSC03742.JPG,char_data/동/DSC03742.JPG_2.jpg,36352,480,640,128,66,194,83,367,True,57
동,129,kaist_dataset/Korean/Digital_Camera/outdoor5/DSC03768.JPG,char_data/동/DSC03768.JPG_2.jpg,11610,480,640,90,128,218,97,226,True,57
동,113,kaist_dataset/Korean/Digital_Camera/outdoor5/DSC03789.JPG,char_data/동/DSC03789.JPG_4.jpg,8249,480,640,73,146,219,18,131,True,57
동,35,kaist_dataset/Korean/Digital_Camera/outdoor5/DSC03789.JPG,char_data/동/DSC03789.JPG_5.jpg,840,480,640,24,368,392,219,254,True,57
동,114,kaist_dataset/Korean/Digital_Camera/outdoor5/DSC03833.JPG,char_data/동/DSC03833.JPG_2.jpg,7866,480,640,69,488,557,104,218,True,57
동,72,kaist_dataset/Korean/Digital_Camera/outdoor5/DSC03834.JPG,char_data/동/DSC03834.JPG_2.jpg,5688,480,640,79,92,171,23,95,True,57
동,72,kaist_dataset/Korean/Digital_Camera/outdoor5/DSC03835.JPG,char_data/동/DSC03835.JPG_2.jpg,5184,480,640,72,145,217,401,473,True,57
동,46,kaist_dataset/Korean/Digital_Camera/outdoor5/DSC03993.JPG,char_data/동/DSC03993.JPG_2.jpg,1840,480,640,40,221,261,427,473,True,57
동,74,kaist_dataset/Korean/Digital_Camera/outdoor6/DSC04067.JPG,char_data/동/DSC04067.JPG_2.jpg,4144,480,640,56,209,265,175,249,True,57
동,61,kaist_dataset/Korean/Digital_Camera/outdoor6/DSC04073.JPG,char_data/동/DSC04073.JPG_2.jpg,3294,480,640,54,45,99,33,94,True,57
동,74,kaist_dataset/Korean/Digital_Camera/outdoor6/DSC04074.JPG,char_data/동/DSC04074.JPG_2.jpg,3330,480,640,45,518,563,22,96,True,57
동,75,kaist_dataset/Korean/Digital_Camera/outdoor6/DSC04083.JPG,char_data/동/DSC04083.JPG_2.jpg,5175,480,640,69,321,390,156,231,True,57
동,76,kaist_dataset/Korean/Digital_Camera/outdoor6/DSC04113.JPG,char_data/동/DSC04113.JPG_2.jpg,7220,480,640,95,391,486,361,437,True,57
동,52,kaist_dataset/Korean/Digital_Camera/outdoor6/DSC04136.JPG,char_data/동/DSC04136.JPG_2.jpg,1820,480,640,35,295,330,327,379,True,57
동,80,kaist_dataset/Korean/Digital_Camera/outdoor6/DSC04307.JPG,char_data/동/DSC04307.JPG_2.jpg,5040,480,640,63,144,207,260,340,True,57
동,90,kaist_dataset/Korean/Digital_Camera/outdoor6/DSC04440.JPG,char_data/동/DSC04440.JPG_2.jpg,6930,480,640,77,136,213,42,132,True,57
동,133,kaist_dataset/Korean/Digital_Camera/outdoor7/DSC04448.JPG,char_data/동/DSC04448.JPG_2.jpg,14364,480,640,108,34,142,145,278,True,57
동,83,kaist_dataset/Korean/Digital_Camera/outdoor7/P1010032.JPG,char_data/동/P1010032.JPG_2.jpg,4980,480,640,60,453,513,224,307,True,57
동,126,kaist_dataset/Korean/Digital_Camera/outdoor7/P1010081.JPG,char_data/동/P1010081.JPG_2.jpg,15120,480,640,120,268,388,72,198,True,57
동,37,kaist_dataset/Korean/Digital_Camera/outdoor7/P1010082.JPG,char_data/동/P1010082.JPG_2.jpg,1850,480,640,50,537,587,323,360,True,57
동,118,kaist_dataset/Korean/Digital_Camera/outdoor7/P1010085.JPG,char_data/동/P1010085.JPG_4.jpg,14986,480,640,127,286,413,138,256,True,57
동,76,kaist_dataset/Korean/Digital_Camera/outdoor7/P1010111.JPG,char_data/동/P1010111.JPG_2.jpg,6080,480,640,80,267,347,110,186,True,57
동,100,kaist_dataset/Korean/Digital_Camera/outdoor7/P1010115.JPG,char_data/동/P1010115.JPG_2.jpg,8000,480,640,80,418,498,187,287,True,57
동,109,kaist_dataset/Korean/Digital_Camera/outdoor7/P1010122.JPG,char_data/동/P1010122.JPG_2.jpg,8393,480,640,77,248,325,36,145,True,57
동,76,kaist_dataset/Korean/Digital_Camera/outdoor7/P1010131.JPG,char_data/동/P1010131.JPG_2.jpg,3952,480,640,52,94,146,116,192,True,57
동,92,"kaist_dataset/Korean/Mobile_Phone/(M,K)D-indoor/P090912028.jpg",char_data/동/P090912028.jpg_2.jpg,10488,480,640,114,162,276,194,286,True,57
동,115,"kaist_dataset/Korean/Mobile_Phone/(M,K)E-bookCover/P090831105.jpg",char_data/동/P090831105.jpg_2.jpg,9315,480,640,81,80,161,99,214,True,57
동,53,"kaist_dataset/Korean/Mobile_Phone/(M,K)E-bookCover/P090912015.jpg",char_data/동/P090912015.jpg_2.jpg,2491,480,640,47,295,342,64,117,True,57
동,119,kaist_dataset/Mixed/Digital_Camera/(C.S)A-shadow/DSC03305.JPG,char_data/동/DSC03305.JPG_2.jpg,7973,480,640,67,159,226,194,313,True,57
동,38,kaist_dataset/Mixed/Digital_Camera/(C.S)C-outdoor1/008.JPG,char_data/동/008.JPG_2.jpg,798,480,640,21,563,584,350,388,True,57
동,28,kaist_dataset/Mixed/Digital_Camera/(C.S)C-outdoor1/027.JPG,char_data/동/027.JPG_2.jpg,504,480,640,18,307,325,274,302,True,57
동,22,kaist_dataset/Mixed/Digital_Camera/(C.S)C-outdoor1/048.JPG,char_data/동/048.JPG_4.jpg,198,480,640,9,109,118,155,177,True,57
동,17,kaist_dataset/Mixed/Digital_Camera/(C.S)C-outdoor1/048.JPG,char_data/동/048.JPG_5.jpg,272,480,640,16,555,571,264,281,True,57
동,45,kaist_dataset/Mixed/Digital_Camera/(C.S)C-outdoor1/2007-12-08-day-130.jpg,char_data/동/2007-12-08-day-130.jpg_2.jpg,2475,1200,1600,55,193,248,737,782,True,57
동,37,kaist_dataset/Mixed/Digital_Camera/(C.S)C-outdoor1/56.JPG,char_data/동/56.JPG_2.jpg,925,576,768,25,708,733,295,332,True,57
동,49,kaist_dataset/Mixed/Digital_Camera/(C.S)C-outdoor1/57.JPG,char_data/동/57.JPG_4.jpg,2842,500,766,58,171,229,272,321,True,57
동,29,kaist_dataset/Mixed/Digital_Camera/(C.S)C-outdoor1/57.JPG,char_data/동/57.JPG_5.jpg,580,500,766,20,232,252,452,481,True,57
동,81,kaist_dataset/Mixed/Digital_Camera/(C.S)C-outdoor1/DSC02349.JPG,char_data/동/DSC02349.JPG_4.jpg,5022,480,640,62,216,278,115,196,True,57
동,72,kaist_dataset/Mixed/Digital_Camera/(C.S)C-outdoor1/DSC02349.JPG,char_data/동/DSC02349.JPG_5.jpg,4680,480,640,65,390,455,353,425,True,57
동,43,kaist_dataset/Mixed/Digital_Camera/(C.S)C-outdoor2/DSC02411.JPG,char_data/동/DSC02411.JPG_2.jpg,860,480,640,20,618,638,342,385,True,57
동,37,kaist_dataset/Mixed/Digital_Camera/(C.S)C-outdoor2/DSC02433.JPG,char_data/동/DSC02433.JPG_2.jpg,777,480,640,21,475,496,263,300,True,57
동,41,kaist_dataset/Mixed/Digital_Camera/(C.S)C-outdoor2/DSC02434.JPG,char_data/동/DSC02434.JPG_2.jpg,1927,480,640,47,449,496,307,348,True,57
동,84,kaist_dataset/Mixed/Digital_Camera/(C.S)C-outdoor2/DSC02527.JPG,char_data/동/DSC02527.JPG_2.jpg,4116,480,640,49,500,549,133,217,True,57
동,99,kaist_dataset/Mixed/Digital_Camera/(C.S)C-outdoor2/DSC02933.JPG,char_data/동/DSC02933.JPG_2.jpg,6336,480,640,64,320,384,116,215,True,57
동,115,kaist_dataset/Mixed/Digital_Camera/(C.S)C-outdoor3/DSC03047.JPG,char_data/동/DSC03047.JPG_2.jpg,13455,480,640,117,401,518,65,180,True,57
동,85,kaist_dataset/Mixed/Digital_Camera/(C.S)C-outdoor3/DSC03067.JPG,char_data/동/DSC03067.JPG_2.jpg,6885,480,640,81,368,449,94,179,True,57
동,64,kaist_dataset/Mixed/Digital_Camera/(C.S)C-outdoor3/DSC03303.JPG,char_data/동/DSC03303.JPG_2.jpg,3264,480,640,51,408,459,117,181,False,57
동,52,kaist_dataset/Mixed/Digital_Camera/(C.S)C-outdoor3/DSC03315.JPG,char_data/동/DSC03315.JPG_2.jpg,3744,480,640,72,265,337,65,117,False,57
동,78,kaist_dataset/Mixed/Digital_Camera/(C.S)C-outdoor3/DSC03329.JPG,char_data/동/DSC03329.JPG_2.jpg,4290,480,640,55,372,427,182,260,False,57
동,65,kaist_dataset/Mixed/Digital_Camera/(C.S)C-outdoor4/DSC03433.JPG,char_data/동/DSC03433.JPG_2.jpg,4095,480,640,63,280,343,141,206,False,57
동,38,kaist_dataset/Mixed/Digital_Camera/(C.S)C-outdoor4/DSC03435.JPG,char_data/동/DSC03435.JPG_2.jpg,1140,480,640,30,271,301,235,273,False,57
동,45,kaist_dataset/Mixed/Digital_Camera/(C.S)C-outdoor4/DSC03556.JPG,char_data/동/DSC03556.JPG_2.jpg,1485,480,640,33,589,622,255,300,False,57
동,38,kaist_dataset/Mixed/Digital_Camera/(C.S)C-outdoor4/DSC03581.JPG,char_data/동/DSC03581.JPG_2.jpg,1026,480,640,27,397,424,135,173,False,57
동,73,kaist_dataset/Mixed/Digital_Camera/(C.S)C-outdoor4/DSC03582.JPG,char_data/동/DSC03582.JPG_2.jpg,3869,480,640,53,500,553,154,227,False,57
동,47,kaist_dataset/Mixed/Digital_Camera/(C.S)C-outdoor4/DSC03673.JPG,char_data/동/DSC03673.JPG_2.jpg,1927,480,640,41,90,131,261,308,False,57
동,215,kaist_dataset/Mixed/Digital_Camera/(C.S)C-outdoor4/DSC03785.JPG,char_data/동/DSC03785.JPG_2.jpg,16555,480,640,77,198,275,166,381,False,57
동,50,kaist_dataset/Mixed/Digital_Camera/(C.S)C-outdoor5/DSC03837.JPG,char_data/동/DSC03837.JPG_2.jpg,1700,480,640,34,277,311,375,425,False,57
동,69,kaist_dataset/Mixed/Digital_Camera/(C.S)C-outdoor5/DSC04059.JPG,char_data/동/DSC04059.JPG_2.jpg,3450,480,640,50,113,163,115,184,False,57
동,68,kaist_dataset/Mixed/Digital_Camera/(C.S)C-outdoor5/DSC04091.JPG,char_data/동/DSC04091.JPG_2.jpg,3468,480,640,51,349,400,329,397,False,57
동,64,kaist_dataset/Mixed/Digital_Camera/(C.S)C-outdoor5/DSC04399.JPG,char_data/동/DSC04399.JPG_2.jpg,4160,480,640,65,22,87,276,340,False,57
동,101,kaist_dataset/Mixed/Digital_Camera/(C.S)C-outdoor5/DSC04449.JPG,char_data/동/DSC04449.JPG_2.jpg,8787,480,640,87,149,236,348,449,False,57
동,85,kaist_dataset/Mixed/Digital_Camera/(C.S)C-outdoor6/P1010065.JPG,char_data/동/P1010065.JPG_2.jpg,6630,480,640,78,23,101,131,216,False,57
동,78,kaist_dataset/Mixed/Digital_Camera/(C.S)C-outdoor6/P1010085.JPG,char_data/동/P1010085.JPG_5.jpg,6318,480,640,81,231,312,75,153,False,57
동,70,kaist_dataset/Mixed/Digital_Camera/(C.S)D-indoor1/DSC02782.JPG,char_data/동/DSC02782.JPG_2.jpg,5320,480,640,76,316,392,179,249,False,57
동,62,kaist_dataset/Mixed/Digital_Camera/(C.S)D-indoor1/DSC02785.JPG,char_data/동/DSC02785.JPG_2.jpg,3968,480,640,64,432,496,216,278,False,57
동,42,kaist_dataset/Mixed/Digital_Camera/(C.S)D-indoor1/DSC02796.JPG,char_data/동/DSC02796.JPG_2.jpg,1806,480,640,43,417,460,267,309,False,57
동,76,kaist_dataset/Mixed/Digital_Camera/(C.S)D-indoor1/DSC04173.JPG,char_data/동/DSC04173.JPG_2.jpg,3268,480,640,43,389,432,399,475,False,57
동,99,kaist_dataset/Mixed/Digital_Camera/(C.S)D-indoor1/DSC04197.JPG,char_data/동/DSC04197.JPG_2.jpg,7920,480,640,80,94,174,213,312,False,57
동,84,kaist_dataset/Mixed/Digital_Camera/(C.S)D-indoor1/DSC04203.JPG,char_data/동/DSC04203.JPG_2.jpg,7056,480,640,84,284,368,163,247,False,57
동,128,kaist_dataset/Mixed/Digital_Camera/(C.S)E-night/P1010156.JPG,char_data/동/P1010156.JPG_2.jpg,10496,480,640,82,209,291,110,238,False,57
동,90,kaist_dataset/Mixed/Mobile_Phone/(C.M)A-outdoor/P090912066.jpg,char_data/동/P090912066.jpg_2.jpg,4140,480,640,46,227,273,97,187,False,57
동,46,kaist_dataset/Mixed/Mobile_Phone/(C.M)C-bookCover/P090903009.jpg,char_data/동/P090903009.jpg_2.jpg,1518,480,640,33,368,401,351,397,False,57
자,27,kaist_dataset/English/Digital_Camera/(E.S)B-light/080116-0059.jpg,char_data/자/080116-0059.jpg_4.jpg,432,1200,1600,16,929,945,948,975,True,77
자,33,kaist_dataset/English/Digital_Camera/(E.S)B-light/080116-0059.jpg,char_data/자/080116-0059.jpg_5.jpg,693,1200,1600,21,872,893,1069,1102,True,77
자,171,kaist_dataset/English/Digital_Camera/(E.S)F-others/2007-12-09-day-exterior-047.jpg,char_data/자/2007-12-09-day-exterior-047.jpg_2.jpg,14364,1200,1600,84,23,107,284,455,True,77
자,72,kaist_dataset/Korean/Digital_Camera/A-shadow/DSC03536.JPG,char_data/자/DSC03536.JPG_2.jpg,5616,480,640,78,249,327,53,125,True,77
자,94,kaist_dataset/Korean/Digital_Camera/A-shadow/DSC03792.JPG,char_data/자/DSC03792.JPG_2.jpg,6768,480,640,72,1,73,257,351,True,77
자,99,kaist_dataset/Korean/Digital_Camera/A-shadow/DSC04298.JPG,char_data/자/DSC04298.JPG_2.jpg,11088,480,640,112,185,297,122,221,True,77
자,126,kaist_dataset/Korean/Digital_Camera/E-night/DSC02642.JPG,char_data/자/DSC02642.JPG_2.jpg,10332,480,640,82,27,109,312,438,True,77
자,96,kaist_dataset/Korean/Digital_Camera/E-night/DSC02645.JPG,char_data/자/DSC02645.JPG_2.jpg,13152,480,640,137,415,552,170,266,True,77
자,57,kaist_dataset/Korean/Digital_Camera/E-night/DSC03849.JPG,char_data/자/DSC03849.JPG_2.jpg,3021,480,640,53,97,150,232,289,True,77
자,130,kaist_dataset/Korean/Digital_Camera/F-bookCover/DSC02818.JPG,char_data/자/DSC02818.JPG_2.jpg,19890,480,640,153,470,623,78,208,True,77
자,122,kaist_dataset/Korean/Digital_Camera/F-bookCover/DSC02819.JPG,char_data/자/DSC02819.JPG_2.jpg,18422,480,640,151,427,578,163,285,True,77
자,78,kaist_dataset/Korean/Digital_Camera/F-bookCover/DSC04220.JPG,char_data/자/DSC04220.JPG_2.jpg,4524,480,640,58,410,468,103,181,True,77
자,201,kaist_dataset/Korean/Digital_Camera/G-others/2007-12-08-day-012.jpg,char_data/자/2007-12-08-day-012.jpg_2.jpg,42813,1600,1200,213,499,712,740,941,True,77
자,30,kaist_dataset/Korean/Digital_Camera/indoor1/DSC02737.JPG,char_data/자/DSC02737.JPG_2.jpg,780,480,640,26,525,551,192,222,True,77
자,114,kaist_dataset/Korean/Digital_Camera/indoor1/DSC02738.JPG,char_data/자/DSC02738.JPG_4.jpg,19266,480,640,169,447,616,237,351,True,77
자,39,kaist_dataset/Korean/Digital_Camera/indoor1/DSC02738.JPG,char_data/자/DSC02738.JPG_5.jpg,1170,480,640,30,559,589,179,218,True,77
자,107,kaist_dataset/Korean/Digital_Camera/indoor1/DSC02742.JPG,char_data/자/DSC02742.JPG_2.jpg,17762,480,640,166,44,210,250,357,True,77
자,51,kaist_dataset/Korean/Digital_Camera/indoor1/DSC03116.JPG,char_data/자/DSC03116.JPG_2.jpg,2346,480,640,46,448,494,248,299,True,77
자,86,kaist_dataset/Korean/Digital_Camera/indoor1/DSC03347.JPG,char_data/자/DSC03347.JPG_2.jpg,5762,480,640,67,309,376,130,216,True,77
자,80,kaist_dataset/Korean/Digital_Camera/indoor2/DSC03392.JPG,char_data/자/DSC03392.JPG_2.jpg,6960,480,640,87,204,291,368,448,True,77
자,69,kaist_dataset/Korean/Digital_Camera/indoor2/DSC03399.JPG,char_data/자/DSC03399.JPG_2.jpg,2691,480,640,39,254,293,252,321,True,77
자,92,kaist_dataset/Korean/Digital_Camera/indoor2/DSC03470.JPG,char_data/자/DSC03470.JPG_2.jpg,5152,480,640,56,100,156,139,231,True,77
자,94,kaist_dataset/Korean/Digital_Camera/indoor2/DSC03922.JPG,char_data/자/DSC03922.JPG_2.jpg,8930,480,640,95,172,267,156,250,True,77
자,71,kaist_dataset/Korean/Digital_Camera/indoor2/DSC03985.JPG,char_data/자/DSC03985.JPG_2.jpg,3692,480,640,52,293,345,252,323,True,77
자,91,kaist_dataset/Korean/Digital_Camera/indoor2/DSC04179.JPG,char_data/자/DSC04179.JPG_2.jpg,5460,480,640,60,153,213,129,220,True,77
자,70,kaist_dataset/Korean/Digital_Camera/indoor2/DSC04195.JPG,char_data/자/DSC04195.JPG_2.jpg,4900,480,640,70,253,323,67,137,True,77
자,58,kaist_dataset/Korean/Digital_Camera/outdoor1/001.JPG,char_data/자/001.JPG_2.jpg,3306,480,640,57,297,354,183,241,True,77
자,30,kaist_dataset/Korean/Digital_Camera/outdoor1/017.JPG,char_data/자/017.JPG_2.jpg,1050,480,640,35,451,486,219,249,True,77
자,58,kaist_dataset/Korean/Digital_Camera/outdoor1/100.jpg,char_data/자/100.jpg_2.jpg,4002,480,640,69,424,493,139,197,True,77
자,19,kaist_dataset/Korean/Digital_Camera/outdoor1/109.JPG,char_data/자/109.JPG_2.jpg,342,480,640,18,406,424,3,22,True,77
자,99,kaist_dataset/Korean/Digital_Camera/outdoor1/110.JPG,char_data/자/110.JPG_2.jpg,8514,480,640,86,180,266,156,255,True,77
자,101,kaist_dataset/Korean/Digital_Camera/outdoor2/2007-12-08-day-094.jpg,char_data/자/2007-12-08-day-094.jpg_2.jpg,8888,1600,1200,88,662,750,323,424,True,77
자,119,kaist_dataset/Korean/Digital_Camera/outdoor2/2007-12-08-day-101.jpg,char_data/자/2007-12-08-day-101.jpg_2.jpg,19278,1200,1600,162,898,1060,474,593,True,77
자,183,kaist_dataset/Korean/Digital_Camera/outdoor2/2007-12-09-day-exterior-035.jpg,char_data/자/2007-12-09-day-exterior-035.jpg_4.jpg,42456,1200,1600,232,678,910,544,727,True,77
자,66,kaist_dataset/Korean/Digital_Camera/outdoor2/2007-12-09-day-exterior-035.jpg,char_data/자/2007-12-09-day-exterior-035.jpg_5.jpg,1980,1200,1600,30,909,939,853,919,True,77
자,132,kaist_dataset/Korean/Digital_Camera/outdoor2/DSC02304.JPG,char_data/자/DSC02304.JPG_2.jpg,12804,480,640,97,354,451,106,238,True,77
자,85,kaist_dataset/Korean/Digital_Camera/outdoor2/DSC02308.JPG,char_data/자/DSC02308.JPG_2.jpg,13175,480,640,155,266,421,147,232,True,77
자,88,kaist_dataset/Korean/Digital_Camera/outdoor2/DSC02372.JPG,char_data/자/DSC02372.JPG_2.jpg,5544,480,640,63,207,270,223,311,True,77
자,115,kaist_dataset/Korean/Digital_Camera/outdoor2/DSC02464.JPG,char_data/자/DSC02464.JPG_2.jpg,11385,480,640,99,18,117,199,314,True,77
자,102,kaist_dataset/Korean/Digital_Camera/outdoor2/DSC02470.JPG,char_data/자/DSC02470.JPG_2.jpg,7650,480,640,75,309,384,60,162,True,77
자,74,kaist_dataset/Korean/Digital_Camera/outdoor2/DSC02518.JPG,char_data/자/DSC02518.JPG_2.jpg,6068,480,640,82,535,617,77,151,True,77
자,126,kaist_dataset/Korean/Digital_Camera/outdoor3/DSC02525.JPG,char_data/자/DSC02525.JPG_2.jpg,12474,480,640,99,53,152,137,263,True,77
자,84,kaist_dataset/Korean/Digital_Camera/outdoor3/DSC02531.JPG,char_data/자/DSC02531.JPG_2.jpg,9492,480,640,113,485,598,237,321,True,77
자,76,kaist_dataset/Korean/Digital_Camera/outdoor3/DSC02693.JPG,char_data/자/DSC02693.JPG_2.jpg,6156,480,640,81,40,121,284,360,True,77
자,57,kaist_dataset/Korean/Digital_Camera/outdoor4/DSC03443.JPG,char_data/자/DSC03443.JPG_2.jpg,3477,480,640,61,270,331,330,387,True,77
자,150,kaist_dataset/Korean/Digital_Camera/outdoor4/DSC03452.JPG,char_data/자/DSC03452.JPG_2.jpg,7200,480,640,48,224,272,103,253,True,77
자,90,kaist_dataset/Korean/Digital_Camera/outdoor4/DSC03458.JPG,char_data/자/DSC03458.JPG_2.jpg,6930,480,640,77,180,257,178,268,True,77
자,75,kaist_dataset/Korean/Digital_Camera/outdoor4/DSC03590.JPG,char_data/자/DSC03590.JPG_2.jpg,5025,480,640,67,77,144,114,189,True,77
자,63,kaist_dataset/Korean/Digital_Camera/outdoor4/DSC03605.JPG,char_data/자/DSC03605.JPG_2.jpg,3654,480,640,58,290,348,308,371,True,77
자,77,kaist_dataset/Korean/Digital_Camera/outdoor4/DSC03607.JPG,char_data/자/DSC03607.JPG_2.jpg,5467,480,640,71,366,437,351,428,True,77
자,53,kaist_dataset/Korean/Digital_Camera/outdoor5/DSC03641.JPG,char_data/자/DSC03641.JPG_2.jpg,2385,480,640,45,419,464,331,384,True,77
자,75,kaist_dataset/Korean/Digital_Camera/outdoor5/DSC03659.JPG,char_data/자/DSC03659.JPG_2.jpg,5250,480,640,70,212,282,36,111,True,77
자,102,kaist_dataset/Korean/Digital_Camera/outdoor5/DSC03681.JPG,char_data/자/DSC03681.JPG_2.jpg,9486,480,640,93,409,502,256,358,True,77
자,88,kaist_dataset/Korean/Digital_Camera/outdoor5/DSC03746.JPG,char_data/자/DSC03746.JPG_2.jpg,7744,480,640,88,282,370,42,130,True,77
자,31,kaist_dataset/Korean/Digital_Camera/outdoor5/DSC03832.JPG,char_data/자/DSC03832.JPG_2.jpg,620,480,640,20,285,305,61,92,True,77
자,60,kaist_dataset/Korean/Digital_Camera/outdoor5/DSC03844.JPG,char_data/자/DSC03844.JPG_2.jpg,3180,480,640,53,250,303,159,219,True,77
자,57,kaist_dataset/Korean/Digital_Camera/outdoor5/DSC03979.JPG,char_data/자/DSC03979.JPG_2.jpg,4845,480,640,85,223,308,143,200,True,77
자,99,kaist_dataset/Korean/Digital_Camera/outdoor5/DSC04027.JPG,char_data/자/DSC04027.JPG_2.jpg,9009,480,640,91,430,521,278,377,True,77
자,104,kaist_dataset/Korean/Digital_Camera/outdoor6/DSC04088.JPG,char_data/자/DSC04088.JPG_2.jpg,8424,480,640,81,380,461,203,307,True,77
자,71,kaist_dataset/Korean/Digital_Camera/outdoor6/DSC04339.JPG,char_data/자/DSC04339.JPG_2.jpg,5254,480,640,74,396,470,111,182,True,77
자,79,kaist_dataset/Korean/Digital_Camera/outdoor6/DSC04345.JPG,char_data/자/DSC04345.JPG_2.jpg,5451,480,640,69,503,572,172,251,True,77
자,79,kaist_dataset/Korean/Digital_Camera/outdoor6/DSC04346.JPG,char_data/자/DSC04346.JPG_2.jpg,5451,480,640,69,496,565,334,413,True,77
자,56,kaist_dataset/Korean/Digital_Camera/outdoor6/DSC04398.JPG,char_data/자/DSC04398.JPG_2.jpg,2296,480,640,41,142,183,377,433,True,77
자,148,kaist_dataset/Korean/Digital_Camera/outdoor7/P1010006.JPG,char_data/자/P1010006.JPG_2.jpg,18944,480,640,128,195,323,103,251,True,77
자,94,kaist_dataset/Korean/Digital_Camera/outdoor7/P1010053.JPG,char_data/자/P1010053.JPG_2.jpg,10810,480,640,115,481,596,141,235,True,77
자,103,kaist_dataset/Korean/Digital_Camera/outdoor7/P1010078.JPG,char_data/자/P1010078.JPG_2.jpg,14214,480,640,138,228,366,107,210,True,77
자,98,kaist_dataset/Korean/Digital_Camera/outdoor7/P1010088.JPG,char_data/자/P1010088.JPG_2.jpg,8134,480,640,83,410,493,318,416,True,77
자,81,kaist_dataset/Korean/Digital_Camera/outdoor8/크기변환_P1010025.JPG,char_data/자/크기변환_P1010025.JPG_2.jpg,6318,480,640,78,470,548,88,169,True,77
자,183,"kaist_dataset/Korean/Mobile_Phone/(M,K)E-bookCover/P090831027.jpg",char_data/자/P090831027.jpg_2.jpg,24156,480,640,132,339,471,165,348,True,77
자,35,"kaist_dataset/Korean/Mobile_Phone/(M,K)E-bookCover/P090831103.jpg",char_data/자/P090831103.jpg_2.jpg,875,480,640,25,220,245,191,226,True,77
자,139,"kaist_dataset/Korean/Mobile_Phone/(M,K)E-bookCover/P090831104.jpg",char_data/자/P090831104.jpg_2.jpg,16958,480,640,122,255,377,95,234,True,77
자,180,"kaist_dataset/Korean/Mobile_Phone/(M,K)E-bookCover/P090831129.jpg",char_data/자/P090831129.jpg_2.jpg,22680,480,640,126,42,168,66,246,True,77
자,92,"kaist_dataset/Korean/Mobile_Phone/(M,K)E-bookCover/P090903049.jpg",char_data/자/P090903049.jpg_2.jpg,8740,480,640,95,425,520,252,344,True,77
자,86,"kaist_dataset/Korean/Mobile_Phone/(M,K)E-bookCover/P090903089.jpg",char_data/자/P090903089.jpg_4.jpg,6536,480,640,76,529,605,51,137,True,77
자,85,"kaist_dataset/Korean/Mobile_Phone/(M,K)E-bookCover/P090903089.jpg",char_data/자/P090903089.jpg_5.jpg,7735,480,640,91,445,536,168,253,True,77
자,120,"kaist_dataset/Korean/Mobile_Phone/(M,K)E-bookCover/P090903096.jpg",char_data/자/P090903096.jpg_2.jpg,10560,480,640,88,444,532,185,305,True,77
자,106,"kaist_dataset/Korean/Mobile_Phone/(M,K)E-bookCover/P090903097.jpg",char_data/자/P090903097.jpg_2.jpg,12402,480,640,117,266,383,202,308,True,77
자,75,"kaist_dataset/Korean/Mobile_Phone/(M,K)E-bookCover/P090903098.jpg",char_data/자/P090903098.jpg_2.jpg,6525,480,640,87,167,254,102,177,True,77
자,123,"kaist_dataset/Korean/Mobile_Phone/(M,K)E-bookCover/P090905008.jpg",char_data/자/P090905008.jpg_2.jpg,15744,480,640,128,23,151,143,266,True,77
자,140,"kaist_dataset/Korean/Mobile_Phone/(M,K)E-bookCover/P090911010.jpg",char_data/자/P090911010.jpg_2.jpg,21980,480,640,157,209,366,254,394,True,77
자,32,kaist_dataset/Mixed/Digital_Camera/(C.S)C-outdoor1/027.JPG,char_data/자/027.JPG_2.jpg,640,480,640,20,215,235,268,300,True,77
자,91,kaist_dataset/Mixed/Digital_Camera/(C.S)C-outdoor1/101.JPG,char_data/자/101.JPG_2.jpg,12922,480,640,142,426,568,138,229,True,77
자,77,kaist_dataset/Mixed/Digital_Camera/(C.S)C-outdoor1/121.JPG,char_data/자/121.JPG_2.jpg,5852,480,640,76,476,552,187,264,True,77
자,40,kaist_dataset/Mixed/Digital_Camera/(C.S)C-outdoor1/DSC02323.JPG,char_data/자/DSC02323.JPG_2.jpg,2640,480,640,66,299,365,395,435,True,77
자,109,kaist_dataset/Mixed/Digital_Camera/(C.S)C-outdoor2/DSC02361.JPG,char_data/자/DSC02361.JPG_2.jpg,11227,480,640,103,340,443,236,345,True,77
자,110,kaist_dataset/Mixed/Digital_Camera/(C.S)C-outdoor2/DSC02379.JPG,char_data/자/DSC02379.JPG_2.jpg,10230,480,640,93,414,507,162,272,True,77
자,65,kaist_dataset/Mixed/Digital_Camera/(C.S)C-outdoor2/DSC02389.JPG,char_data/자/DSC02389.JPG_2.jpg,6695,480,640,103,170,273,325,390,True,77
자,29,kaist_dataset/Mixed/Digital_Camera/(C.S)C-outdoor2/DSC02411.JPG,char_data/자/DSC02411.JPG_2.jpg,1015,480,640,35,139,174,158,187,True,77
자,61,kaist_dataset/Mixed/Digital_Camera/(C.S)C-outdoor2/DSC02436.JPG,char_data/자/DSC02436.JPG_2.jpg,2806,480,640,46,319,365,114,175,True,77
자,60,kaist_dataset/Mixed/Digital_Camera/(C.S)C-outdoor2/DSC02886.JPG,char_data/자/DSC02886.JPG_2.jpg,4260,480,640,71,155,226,95,155,True,77
자,85,kaist_dataset/Mixed/Digital_Camera/(C.S)C-outdoor3/DSC03054.JPG,char_data/자/DSC03054.JPG_2.jpg,6375,480,640,75,484,559,232,317,True,77
자,43,kaist_dataset/Mixed/Digital_Camera/(C.S)C-outdoor3/DSC03212.JPG,char_data/자/DSC03212.JPG_2.jpg,1333,480,640,31,97,128,250,293,True,77
자,40,kaist_dataset/Mixed/Digital_Camera/(C.S)C-outdoor3/DSC03217.JPG,char_data/자/DSC03217.JPG_2.jpg,1600,480,640,40,288,328,334,374,True,77
자,65,kaist_dataset/Mixed/Digital_Camera/(C.S)C-outdoor3/DSC03234.JPG,char_data/자/DSC03234.JPG_2.jpg,4810,480,640,74,294,368,98,163,True,77
자,37,kaist_dataset/Mixed/Digital_Camera/(C.S)C-outdoor3/DSC03236.JPG,char_data/자/DSC03236.JPG_2.jpg,888,480,640,24,566,590,427,464,True,77
자,120,kaist_dataset/Mixed/Digital_Camera/(C.S)C-outdoor3/DSC03260.JPG,char_data/자/DSC03260.JPG_2.jpg,15120,480,640,126,366,492,179,299,True,77
자,67,kaist_dataset/Mixed/Digital_Camera/(C.S)C-outdoor4/DSC03433.JPG,char_data/자/DSC03433.JPG_2.jpg,4690,480,640,70,211,281,139,206,True,77
자,40,kaist_dataset/Mixed/Digital_Camera/(C.S)C-outdoor4/DSC03519.JPG,char_data/자/DSC03519.JPG_2.jpg,2000,480,640,50,224,274,426,466,True,77
자,52,kaist_dataset/Mixed/Digital_Camera/(C.S)C-outdoor4/DSC03531.JPG,char_data/자/DSC03531.JPG_2.jpg,3328,480,640,64,372,436,350,402,True,77
자,38,kaist_dataset/Mixed/Digital_Camera/(C.S)C-outdoor4/DSC03630.JPG,char_data/자/DSC03630.JPG_2.jpg,798,480,640,21,603,624,395,433,True,77
자,48,kaist_dataset/Mixed/Digital_Camera/(C.S)C-outdoor4/DSC03655.JPG,char_data/자/DSC03655.JPG_2.jpg,1392,480,640,29,390,419,389,437,True,77
자,68,kaist_dataset/Mixed/Digital_Camera/(C.S)C-outdoor4/DSC03676.JPG,char_data/자/DSC03676.JPG_2.jpg,3468,480,640,51,149,200,331,399,False,77
자,40,kaist_dataset/Mixed/Digital_Camera/(C.S)C-outdoor5/DSC03839.JPG,char_data/자/DSC03839.JPG_2.jpg,1320,480,640,33,199,232,148,188,False,77
자,46,kaist_dataset/Mixed/Digital_Camera/(C.S)C-outdoor5/DSC04014.JPG,char_data/자/DSC04014.JPG_2.jpg,3588,480,640,78,167,245,181,227,False,77
자,56,kaist_dataset/Mixed/Digital_Camera/(C.S)C-outdoor5/DSC04015.JPG,char_data/자/DSC04015.JPG_2.jpg,2744,480,640,49,267,316,172,228,False,77
자,74,kaist_dataset/Mixed/Digital_Camera/(C.S)C-outdoor5/DSC04017.JPG,char_data/자/DSC04017.JPG_2.jpg,4514,480,640,61,223,284,347,421,False,77
자,114,kaist_dataset/Mixed/Digital_Camera/(C.S)C-outdoor5/DSC04033.JPG,char_data/자/DSC04033.JPG_2.jpg,14022,480,640,123,37,160,149,263,False,77
자,65,kaist_dataset/Mixed/Digital_Camera/(C.S)C-outdoor5/DSC04059.JPG,char_data/자/DSC04059.JPG_2.jpg,3055,480,640,47,68,115,117,182,False,77
자,36,kaist_dataset/Mixed/Digital_Camera/(C.S)C-outdoor5/DSC04434.JPG,char_data/자/DSC04434.JPG_2.jpg,936,480,640,26,306,332,430,466,False,77
자,49,kaist_dataset/Mixed/Digital_Camera/(C.S)D-indoor1/DSC02750.JPG,char_data/자/DSC02750.JPG_2.jpg,2940,480,640,60,348,408,232,281,False,77
자,43,kaist_dataset/Mixed/Digital_Camera/(C.S)D-indoor1/DSC02751.JPG,char_data/자/DSC02751.JPG_2.jpg,2107,480,640,49,393,442,191,234,False,77
자,68,kaist_dataset/Mixed/Digital_Camera/(C.S)D-indoor1/DSC02752.JPG,char_data/자/DSC02752.JPG_2.jpg,3808,480,640,56,370,426,218,286,False,77
자,34,kaist_dataset/Mixed/Digital_Camera/(C.S)D-indoor1/DSC02756.JPG,char_data/자/DSC02756.JPG_2.jpg,1122,480,640,33,469,502,142,176,False,77
자,56,kaist_dataset/Mixed/Digital_Camera/(C.S)D-indoor1/DSC03130.JPG,char_data/자/DSC03130.JPG_2.jpg,3136,480,640,56,325,381,254,310,False,77
자,55,kaist_dataset/Mixed/Digital_Camera/(C.S)D-indoor1/DSC03131.JPG,char_data/자/DSC03131.JPG_2.jpg,2640,480,640,48,321,369,196,251,False,77
자,56,kaist_dataset/Mixed/Digital_Camera/(C.S)D-indoor1/DSC03135.JPG,char_data/자/DSC03135.JPG_2.jpg,3024,480,640,54,282,336,253,309,False,77
자,23,kaist_dataset/Mixed/Digital_Camera/(C.S)D-indoor1/DSC03959.JPG,char_data/자/DSC03959.JPG_2.jpg,368,480,640,16,438,454,409,432,False,77
자,71,kaist_dataset/Mixed/Digital_Camera/(C.S)D-indoor1/DSC04173.JPG,char_data/자/DSC04173.JPG_2.jpg,3337,480,640,47,342,389,401,472,False,77
자,85,kaist_dataset/Mixed/Digital_Camera/(C.S)D-indoor1/DSC04197.JPG,char_data/자/DSC04197.JPG_2.jpg,7310,480,640,86,10,96,214,299,False,77
자,83,kaist_dataset/Mixed/Digital_Camera/(C.S)D-indoor1/DSC04203.JPG,char_data/자/DSC04203.JPG_2.jpg,7719,480,640,93,193,286,161,244,False,77
자,70,kaist_dataset/Mixed/Digital_Camera/(C.S)D-indoor1/DSC04206.JPG,char_data/자/DSC04206.JPG_2.jpg,4620,480,640,66,302,368,186,256,False,77
자,56,kaist_dataset/Mixed/Digital_Camera/(C.S)E-night/DSC03516.JPG,char_data/자/DSC03516.JPG_2.jpg,2520,480,640,45,229,274,100,156,False,77
자,57,kaist_dataset/Mixed/Digital_Camera/(C.S)E-night/DSC03840.JPG,char_data/자/DSC03840.JPG_2.jpg,2850,480,640,50,487,537,130,187,False,77
자,66,kaist_dataset/Mixed/Digital_Camera/(C.S)E-night/P1010155.JPG,char_data/자/P1010155.JPG_2.jpg,3300,480,640,50,335,385,116,182,False,77
자,95,kaist_dataset/Mixed/Mobile_Phone/(C.M)B-indoor/P090831010.jpg,char_data/자/P090831010.jpg_2.jpg,9120,480,640,96,108,204,75,170,False,77
자,41,kaist_dataset/Mixed/Mobile_Phone/(C.M)C-bookCover/P090831045.jpg,char_data/자/P090831045.jpg_2.jpg,1845,480,640,45,205,250,305,346,False,77
자,44,kaist_dataset/Mixed/Mobile_Phone/(C.M)C-bookCover/P090903009.jpg,char_data/자/P090903009.jpg_2.jpg,1540,480,640,35,248,283,353,397,False,77
g,54,kaist_dataset/English/Digital_Camera/(E.S)A-shadow/DSC03075.JPG,char_data/g/DSC03075.JPG_2.jpg,1404,480,640,26,237,263,358,412,True,35
g,72,kaist_dataset/English/Digital_Camera/(E.S)A-shadow/DSC03079.JPG,char_data/g/DSC03079.JPG_2.jpg,1800,480,640,25,392,417,331,403,True,35
g,58,kaist_dataset/English/Digital_Camera/(E.S)A-shadow/DSC03082.JPG,char_data/g/DSC03082.JPG_5.jpg,1334,480,640,23,210,233,384,442,True,35
g,63,kaist_dataset/English/Digital_Camera/(E.S)A-shadow/IMG_2647.JPG,char_data/g/IMG_2647.JPG_2.jpg,3213,480,640,51,158,209,185,248,True,35
g,82,kaist_dataset/English/Digital_Camera/(E.S)C-outdoor1/001.jpg,char_data/g/001.jpg_2.jpg,5248,257,470,64,378,442,96,178,True,35
g,59,kaist_dataset/English/Digital_Camera/(E.S)C-outdoor1/033.jpg,char_data/g/033.jpg_2.jpg,2596,232,354,44,138,182,60,119,True,35
g,19,kaist_dataset/English/Digital_Camera/(E.S)C-outdoor1/056.JPG,char_data/g/056.JPG_4.jpg,190,480,640,10,107,117,246,265,True,35
g,160,kaist_dataset/English/Digital_Camera/(E.S)C-outdoor1/100.JPG,char_data/g/100.JPG_4.jpg,16160,480,640,101,250,351,66,226,True,35
g,71,kaist_dataset/English/Digital_Camera/(E.S)C-outdoor1/109.jpg,char_data/g/109.jpg_2.jpg,3195,480,640,45,409,454,187,258,True,35
g,44,kaist_dataset/English/Digital_Camera/(E.S)C-outdoor1/2007-12-08-day-015.jpg,char_data/g/2007-12-08-day-015.jpg_2.jpg,1100,1200,1600,25,767,792,820,864,True,35
g,113,kaist_dataset/English/Digital_Camera/(E.S)C-outdoor1/DSC02387.JPG,char_data/g/DSC02387.JPG_4.jpg,6667,480,640,59,247,306,213,326,True,35
g,37,kaist_dataset/English/Digital_Camera/(E.S)C-outdoor1/DSC02387.JPG,char_data/g/DSC02387.JPG_5.jpg,518,480,640,14,361,375,301,338,True,35
g,86,kaist_dataset/English/Digital_Camera/(E.S)C-outdoor1/DSC02491.JPG,char_data/g/DSC02491.JPG_2.jpg,5848,480,640,68,433,501,61,147,True,35
g,46,kaist_dataset/English/Digital_Camera/(E.S)C-outdoor1/DSC02500.JPG,char_data/g/DSC02500.JPG_5.jpg,1794,480,640,39,460,499,304,350,True,35
g,52,kaist_dataset/English/Digital_Camera/(E.S)C-outdoor1/DSC02868.JPG,char_data/g/DSC02868.JPG_2.jpg,1144,480,640,22,339,361,399,451,True,35
g,48,kaist_dataset/English/Digital_Camera/(E.S)C-outdoor1/DSC02918.JPG,char_data/g/DSC02918.JPG_2.jpg,1344,480,640,28,489,517,230,278,True,35
g,56,kaist_dataset/English/Digital_Camera/(E.S)C-outdoor2/DSC02998.JPG,char_data/g/DSC02998.JPG_2.jpg,2296,480,640,41,387,428,423,479,True,35
g,59,kaist_dataset/English/Digital_Camera/(E.S)C-outdoor2/DSC03001.JPG,char_data/g/DSC03001.JPG_2.jpg,2360,480,640,40,296,336,193,252,True,35
g,49,kaist_dataset/English/Digital_Camera/(E.S)C-outdoor2/DSC03225.JPG,char_data/g/DSC03225.JPG_2.jpg,1078,480,640,22,358,380,82,131,True,35
g,66,kaist_dataset/English/Digital_Camera/(E.S)C-outdoor2/DSC03262.JPG,char_data/g/DSC03262.JPG_2.jpg,2310,480,640,35,86,121,125,191,True,35
g,59,kaist_dataset/English/Digital_Camera/(E.S)C-outdoor2/DSC03290.JPG,char_data/g/DSC03290.JPG_2.jpg,2065,480,640,35,248,283,308,367,True,35
g,58,kaist_dataset/English/Digital_Camera/(E.S)C-outdoor2/DSC03440.JPG,char_data/g/DSC03440.JPG_2.jpg,1972,480,640,34,279,313,32,90,True,35
g,135,kaist_dataset/English/Digital_Camera/(E.S)C-outdoor2/DSC03786.JPG,char_data/g/DSC03786.JPG_2.jpg,12960,480,640,96,269,365,181,316,True,35
g,59,kaist_dataset/English/Digital_Camera/(E.S)C-outdoor2/DSC04035.JPG,char_data/g/DSC04035.JPG_2.jpg,2065,480,640,35,192,227,200,259,True,35
g,72,kaist_dataset/English/Digital_Camera/(E.S)C-outdoor2/DSC04052.JPG,char_data/g/DSC04052.JPG_4.jpg,2376,480,640,33,380,413,176,248,True,35
g,71,kaist_dataset/English/Digital_Camera/(E.S)C-outdoor2/DSC04052.JPG,char_data/g/DSC04052.JPG_5.jpg,2556,480,640,36,412,448,155,226,True,35
g,61,kaist_dataset/English/Digital_Camera/(E.S)C-outdoor2/DSC04064.JPG,char_data/g/DSC04064.JPG_4.jpg,1830,480,640,30,185,215,132,193,True,35
g,55,kaist_dataset/English/Digital_Camera/(E.S)C-outdoor2/DSC04064.JPG,char_data/g/DSC04064.JPG_5.jpg,1540,480,640,28,409,437,136,191,True,35
g,43,kaist_dataset/English/Digital_Camera/(E.S)C-outdoor2/DSC04079.JPG,char_data/g/DSC04079.JPG_5.jpg,1333,480,640,31,114,145,120,163,True,35
g,33,kaist_dataset/English/Digital_Camera/(E.S)C-outdoor2/DSC04437.JPG,char_data/g/DSC04437.JPG_2.jpg,660,480,640,20,225,245,44,77,True,35
g,47,kaist_dataset/English/Digital_Camera/(E.S)C-outdoor3/DSC03038.JPG,char_data/g/DSC03038.JPG_2.jpg,1175,480,640,25,301,326,320,367,True,35
g,52,kaist_dataset/English/Digital_Camera/(E.S)D-indoor/080119-0009.jpg,char_data/g/080119-0009.jpg_5.jpg,1196,1200,1600,23,392,415,1111,1163,True,35
g,76,kaist_dataset/English/Digital_Camera/(E.S)D-indoor/DSC03074.JPG,char_data/g/DSC03074.JPG_2.jpg,1824,480,640,24,374,398,265,341,True,35
g,82,kaist_dataset/English/Digital_Camera/(E.S)D-indoor/DSC03087.JPG,char_data/g/DSC03087.JPG_2.jpg,3608,480,640,44,451,495,375,457,True,35
g,39,kaist_dataset/English/Digital_Camera/(E.S)D-indoor/DSC03144.JPG,char_data/g/DSC03144.JPG_8.jpg,975,480,640,25,208,233,242,281,True,35
g,41,kaist_dataset/English/Digital_Camera/(E.S)D-indoor/DSC03144.JPG,char_data/g/DSC03144.JPG_9.jpg,902,480,640,22,349,371,238,279,True,35
g,43,kaist_dataset/English/Digital_Camera/(E.S)D-indoor/DSC03144.JPG,char_data/g/DSC03144.JPG_10.jpg,989,480,640,23,204,227,295,338,True,35
g,44,kaist_dataset/English/Digital_Camera/(E.S)D-indoor/DSC03144.JPG,char_data/g/DSC03144.JPG_11.jpg,924,480,640,21,347,368,291,335,True,35
g,44,kaist_dataset/English/Digital_Camera/(E.S)D-indoor/DSC03146.JPG,char_data/g/DSC03146.JPG_11.jpg,1100,480,640,25,423,448,237,281,True,35
g,43,kaist_dataset/English/Digital_Camera/(E.S)D-indoor/DSC03146.JPG,char_data/g/DSC03146.JPG_12.jpg,989,480,640,23,450,473,237,280,True,35
g,39,kaist_dataset/English/Digital_Camera/(E.S)D-indoor/DSC03146.JPG,char_data/g/DSC03146.JPG_14.jpg,936,480,640,24,382,406,179,218,True,35
g,41,kaist_dataset/English/Digital_Camera/(E.S)D-indoor/DSC03147.JPG,char_data/g/DSC03147.JPG_13.jpg,984,480,640,24,259,283,300,341,True,35
g,41,kaist_dataset/English/Digital_Camera/(E.S)D-indoor/DSC03147.JPG,char_data/g/DSC03147.JPG_14.jpg,1066,480,640,26,356,382,299,340,True,35
g,44,kaist_dataset/English/Digital_Camera/(E.S)D-indoor/DSC03147.JPG,char_data/g/DSC03147.JPG_16.jpg,1144,480,640,26,262,288,242,286,True,35
g,39,kaist_dataset/English/Digital_Camera/(E.S)D-indoor/DSC03147.JPG,char_data/g/DSC03147.JPG_17.jpg,1014,480,640,26,362,388,244,283,True,35
g,29,kaist_dataset/English/Digital_Camera/(E.S)D-indoor/DSC03532.JPG,char_data/g/DSC03532.JPG_6.jpg,551,480,640,19,246,265,388,417,True,35
g,32,kaist_dataset/English/Digital_Camera/(E.S)D-indoor/DSC03532.JPG,char_data/g/DSC03532.JPG_7.jpg,640,480,640,20,342,362,386,418,True,35
g,31,kaist_dataset/English/Digital_Camera/(E.S)D-indoor/DSC03532.JPG,char_data/g/DSC03532.JPG_8.jpg,589,480,640,19,546,565,382,413,True,35
g,64,kaist_dataset/English/Digital_Camera/(E.S)D-indoor/DSC03936.JPG,char_data/g/DSC03936.JPG_2.jpg,2432,480,640,38,330,368,90,154,True,35
g,38,kaist_dataset/English/Digital_Camera/(E.S)D-indoor/DSC04023.JPG,char_data/g/DSC04023.JPG_2.jpg,836,480,640,22,436,458,326,364,True,35
g,101,kaist_dataset/English/Digital_Camera/(E.S)E-night/크기변환_P1010163.JPG,char_data/g/크기변환_P1010163.JPG_2.jpg,6363,480,640,63,173,236,91,192,True,35
g,70,kaist_dataset/English/Digital_Camera/(E.S)F-others/080119-0007.jpg,char_data/g/080119-0007.jpg_4.jpg,3010,1200,1600,43,61,104,734,804,True,35
g,81,kaist_dataset/English/Mobile_Phone/(E.M)B-indoor/P090831011.jpg,char_data/g/P090831011.jpg_5.jpg,3969,480,640,49,192,241,137,218,True,35
g,154,kaist_dataset/English/Mobile_Phone/(E.M)C-bookCover/P090831077.jpg,char_data/g/P090831077.jpg_2.jpg,12474,480,640,81,513,594,275,429,True,35
g,44,kaist_dataset/English/Mobile_Phone/(E.M)C-bookCover/P090903030.jpg,char_data/g/P090903030.jpg_2.jpg,1012,480,640,23,568,591,77,121,True,35
g,36,kaist_dataset/Korean/Digital_Camera/G-others/080119-0005.jpg,char_data/g/080119-0005.jpg_5.jpg,972,1600,1200,27,786,813,619,655,True,35
g,59,kaist_dataset/Korean/Digital_Camera/G-others/2007-12-08-day-112.jpg,char_data/g/2007-12-08-day-112.jpg_2.jpg,1357,1200,1600,23,835,858,505,564,True,35
g,27,kaist_dataset/Korean/Digital_Camera/indoor1/080119-0029.jpg,char_data/g/080119-0029.jpg_6.jpg,405,1200,1600,15,720,735,656,683,True,35
g,27,kaist_dataset/Korean/Digital_Camera/indoor1/080119-0029.jpg,char_data/g/080119-0029.jpg_7.jpg,351,1200,1600,13,795,808,659,686,True,35
g,30,kaist_dataset/Korean/Digital_Camera/indoor1/080119-0029.jpg,char_data/g/080119-0029.jpg_8.jpg,360,1200,1600,12,853,865,657,687,True,35
g,88,kaist_dataset/Korean/Digital_Camera/indoor1/080119-0030.jpg,char_data/g/080119-0030.jpg_2.jpg,5104,1200,1600,58,1138,1196,449,537,True,35
g,33,kaist_dataset/Mixed/Digital_Camera/(C.S)A-shadow/DSC02624.JPG,char_data/g/DSC02624.JPG_8.jpg,528,480,640,16,177,193,402,435,True,35
g,39,kaist_dataset/Mixed/Digital_Camera/(C.S)A-shadow/DSC02624.JPG,char_data/g/DSC02624.JPG_9.jpg,624,480,640,16,227,243,400,439,True,35
g,21,kaist_dataset/Mixed/Digital_Camera/(C.S)C-outdoor1/003.JPG,char_data/g/003.JPG_2.jpg,210,480,640,10,439,449,258,279,True,35
g,35,kaist_dataset/Mixed/Digital_Camera/(C.S)C-outdoor1/021.JPG,char_data/g/021.JPG_2.jpg,595,480,640,17,475,492,138,173,True,35
g,30,kaist_dataset/Mixed/Digital_Camera/(C.S)C-outdoor1/086.JPG,char_data/g/086.JPG_6.jpg,510,480,640,17,249,266,338,368,True,35
g,35,kaist_dataset/Mixed/Digital_Camera/(C.S)C-outdoor1/086.JPG,char_data/g/086.JPG_7.jpg,560,480,640,16,336,352,335,370,True,35
g,38,kaist_dataset/Mixed/Digital_Camera/(C.S)C-outdoor1/086.JPG,char_data/g/086.JPG_8.jpg,532,480,640,14,407,421,335,373,True,35
g,55,kaist_dataset/Mixed/Digital_Camera/(C.S)C-outdoor1/101.JPG,char_data/g/101.JPG_5.jpg,2420,480,640,44,280,324,254,309,True,35
g,127,kaist_dataset/Mixed/Digital_Camera/(C.S)C-outdoor1/8.jpg,char_data/g/8.jpg_4.jpg,7239,400,766,57,86,143,166,293,True,35
g,110,kaist_dataset/Mixed/Digital_Camera/(C.S)C-outdoor1/8.jpg,char_data/g/8.jpg_5.jpg,7590,400,766,69,364,433,173,283,True,35
g,29,kaist_dataset/Mixed/Digital_Camera/(C.S)C-outdoor2/DSC02385.JPG,char_data/g/DSC02385.JPG_2.jpg,522,480,640,18,476,494,146,175,True,35
g,70,kaist_dataset/Mixed/Digital_Camera/(C.S)C-outdoor2/DSC02436.JPG,char_data/g/DSC02436.JPG_4.jpg,2590,480,640,37,469,506,183,253,True,35
g,73,kaist_dataset/Mixed/Digital_Camera/(C.S)C-outdoor2/DSC02436.JPG,char_data/g/DSC02436.JPG_5.jpg,2482,480,640,34,506,540,182,255,True,35
g,28,kaist_dataset/Mixed/Digital_Camera/(C.S)C-outdoor2/DSC02439.JPG,char_data/g/DSC02439.JPG_2.jpg,448,480,640,16,418,434,111,139,True,35
g,31,kaist_dataset/Mixed/Digital_Camera/(C.S)C-outdoor2/DSC02483.JPG,char_data/g/DSC02483.JPG_2.jpg,527,480,640,17,312,329,152,183,True,35
g,33,kaist_dataset/Mixed/Digital_Camera/(C.S)C-outdoor2/DSC02624.JPG,char_data/g/DSC02624.JPG_10.jpg,528,480,640,16,177,193,402,435,True,35
g,39,kaist_dataset/Mixed/Digital_Camera/(C.S)C-outdoor2/DSC02624.JPG,char_data/g/DSC02624.JPG_11.jpg,624,480,640,16,227,243,400,439,True,35
g,33,kaist_dataset/Mixed/Digital_Camera/(C.S)C-outdoor2/DSC02886.JPG,char_data/g/DSC02886.JPG_2.jpg,792,480,640,24,339,363,144,177,True,35
g,83,kaist_dataset/Mixed/Digital_Camera/(C.S)C-outdoor3/DSC03047.JPG,char_data/g/DSC03047.JPG_2.jpg,2988,480,640,36,480,516,192,275,True,35
g,53,kaist_dataset/Mixed/Digital_Camera/(C.S)C-outdoor3/DSC03063.JPG,char_data/g/DSC03063.JPG_2.jpg,1325,480,640,25,439,464,302,355,True,35
g,51,kaist_dataset/Mixed/Digital_Camera/(C.S)C-outdoor3/DSC03177.JPG,char_data/g/DSC03177.JPG_2.jpg,1581,480,640,31,301,332,144,195,True,35
g,37,kaist_dataset/Mixed/Digital_Camera/(C.S)C-outdoor3/DSC03271.JPG,char_data/g/DSC03271.JPG_2.jpg,888,480,640,24,334,358,81,118,True,35
g,55,kaist_dataset/Mixed/Digital_Camera/(C.S)C-outdoor3/DSC03332.JPG,char_data/g/DSC03332.JPG_2.jpg,2200,480,640,40,294,334,231,286,True,35
g,111,kaist_dataset/Mixed/Digital_Camera/(C.S)C-outdoor3/DSC03421.JPG,char_data/g/DSC03421.JPG_2.jpg,9324,480,640,84,459,543,108,219,True,35
g,29,kaist_dataset/Mixed/Digital_Camera/(C.S)C-outdoor4/DSC03556.JPG,char_data/g/DSC03556.JPG_6.jpg,319,480,640,11,277,288,324,353,True,35
g,29,kaist_dataset/Mixed/Digital_Camera/(C.S)C-outdoor4/DSC03556.JPG,char_data/g/DSC03556.JPG_7.jpg,406,480,640,14,321,335,322,351,True,35
g,35,kaist_dataset/Mixed/Digital_Camera/(C.S)C-outdoor4/DSC03556.JPG,char_data/g/DSC03556.JPG_8.jpg,525,480,640,15,433,448,321,356,True,35
g,46,kaist_dataset/Mixed/Digital_Camera/(C.S)C-outdoor4/DSC03586.JPG,char_data/g/DSC03586.JPG_4.jpg,1104,480,640,24,367,391,157,203,True,35
g,46,kaist_dataset/Mixed/Digital_Camera/(C.S)C-outdoor4/DSC03586.JPG,char_data/g/DSC03586.JPG_5.jpg,1058,480,640,23,445,468,165,211,True,35
g,27,kaist_dataset/Mixed/Digital_Camera/(C.S)C-outdoor4/DSC03670.JPG,char_data/g/DSC03670.JPG_6.jpg,351,480,640,13,225,238,322,349,True,35
g,29,kaist_dataset/Mixed/Digital_Camera/(C.S)C-outdoor4/DSC03670.JPG,char_data/g/DSC03670.JPG_7.jpg,551,480,640,19,235,254,321,350,True,35
g,29,kaist_dataset/Mixed/Digital_Camera/(C.S)C-outdoor4/DSC03670.JPG,char_data/g/DSC03670.JPG_8.jpg,580,480,640,20,283,303,323,352,True,35
g,45,kaist_dataset/Mixed/Digital_Camera/(C.S)C-outdoor4/DSC03672.JPG,char_data/g/DSC03672.JPG_2.jpg,1260,480,640,28,178,206,410,455,True,35
g,44,kaist_dataset/Mixed/Digital_Camera/(C.S)C-outdoor4/DSC03773.JPG,char_data/g/DSC03773.JPG_2.jpg,1540,480,640,35,152,187,274,318,True,35
g,46,kaist_dataset/Mixed/Digital_Camera/(C.S)C-outdoor4/DSC03781.JPG,char_data/g/DSC03781.JPG_2.jpg,2116,480,640,46,281,327,270,316,True,35
g,36,kaist_dataset/Mixed/Digital_Camera/(C.S)C-outdoor5/DSC03821.JPG,char_data/g/DSC03821.JPG_2.jpg,756,480,640,21,327,348,43,79,True,35
g,41,kaist_dataset/Mixed/Digital_Camera/(C.S)C-outdoor5/DSC04069.JPG,char_data/g/DSC04069.JPG_4.jpg,861,480,640,21,321,342,421,462,True,35
g,40,kaist_dataset/Mixed/Digital_Camera/(C.S)C-outdoor5/DSC04321.JPG,char_data/g/DSC04321.JPG_2.jpg,840,480,640,21,126,147,194,234,True,35
g,50,kaist_dataset/Mixed/Digital_Camera/(C.S)C-outdoor5/DSC04322.JPG,char_data/g/DSC04322.JPG_2.jpg,1250,480,640,25,108,133,215,265,True,35
g,42,kaist_dataset/Mixed/Digital_Camera/(C.S)C-outdoor5/DSC04323.JPG,char_data/g/DSC04323.JPG_4.jpg,882,480,640,21,169,190,201,243,False,35
g,41,kaist_dataset/Mixed/Digital_Camera/(C.S)C-outdoor5/DSC04323.JPG,char_data/g/DSC04323.JPG_5.jpg,943,480,640,23,303,326,207,248,False,35
g,119,kaist_dataset/Mixed/Digital_Camera/(C.S)C-outdoor5/DSC04395.JPG,char_data/g/DSC04395.JPG_2.jpg,8330,480,640,70,229,299,158,277,False,35
g,60,kaist_dataset/Mixed/Digital_Camera/(C.S)C-outdoor5/DSC04456.JPG,char_data/g/DSC04456.JPG_2.jpg,2220,480,640,37,272,309,166,226,False,35
g,39,kaist_dataset/Mixed/Digital_Camera/(C.S)D-indoor1/DSC02787.JPG,char_data/g/DSC02787.JPG_2.jpg,819,480,640,21,175,196,384,423,False,35
g,41,kaist_dataset/Mixed/Digital_Camera/(C.S)D-indoor1/DSC02804.JPG,char_data/g/DSC02804.JPG_2.jpg,861,480,640,21,445,466,349,390,False,35
g,36,kaist_dataset/Mixed/Digital_Camera/(C.S)D-indoor1/DSC03096.JPG,char_data/g/DSC03096.JPG_4.jpg,540,480,640,15,161,176,423,459,False,35
g,34,kaist_dataset/Mixed/Digital_Camera/(C.S)D-indoor1/DSC03096.JPG,char_data/g/DSC03096.JPG_5.jpg,612,480,640,18,205,223,429,463,False,35
g,51,kaist_dataset/Mixed/Digital_Camera/(C.S)D-indoor1/DSC03119.JPG,char_data/g/DSC03119.JPG_2.jpg,1530,480,640,30,257,287,169,220,False,35
g,51,kaist_dataset/Mixed/Digital_Camera/(C.S)D-indoor1/DSC03126.JPG,char_data/g/DSC03126.JPG_2.jpg,1428,480,640,28,309,337,226,277,False,35
g,42,kaist_dataset/Mixed/Digital_Camera/(C.S)D-indoor1/DSC03129.JPG,char_data/g/DSC03129.JPG_2.jpg,1050,480,640,25,333,358,211,253,False,35
g,56,kaist_dataset/Mixed/Digital_Camera/(C.S)D-indoor1/DSC03131.JPG,char_data/g/DSC03131.JPG_2.jpg,1792,480,640,32,368,400,136,192,False,35
g,59,kaist_dataset/Mixed/Digital_Camera/(C.S)D-indoor1/DSC03133.JPG,char_data/g/DSC03133.JPG_2.jpg,1947,480,640,33,444,477,152,211,False,35
g,67,kaist_dataset/Mixed/Digital_Camera/(C.S)D-indoor1/DSC03135.JPG,char_data/g/DSC03135.JPG_2.jpg,2881,480,640,43,335,378,184,251,False,35
g,96,kaist_dataset/Mixed/Digital_Camera/(C.S)D-indoor1/DSC03909.JPG,char_data/g/DSC03909.JPG_4.jpg,5856,480,640,61,525,586,107,203,False,35
g,95,kaist_dataset/Mixed/Digital_Camera/(C.S)D-indoor1/DSC03909.JPG,char_data/g/DSC03909.JPG_5.jpg,4465,480,640,47,585,632,194,289,False,35
g,45,kaist_dataset/Mixed/Digital_Camera/(C.S)D-indoor1/DSC04246.JPG,char_data/g/DSC04246.JPG_2.jpg,900,480,640,20,383,403,248,293,False,35
g,51,kaist_dataset/Mixed/Digital_Camera/(C.S)D-indoor2/DSC04249.JPG,char_data/g/DSC04249.JPG_2.jpg,1479,480,640,29,288,317,216,267,False,35
g,39,kaist_dataset/Mixed/Digital_Camera/(C.S)D-indoor2/DSC04254.JPG,char_data/g/DSC04254.JPG_4.jpg,936,480,640,24,220,244,348,387,False,35
g,35,kaist_dataset/Mixed/Digital_Camera/(C.S)D-indoor2/DSC04254.JPG,char_data/g/DSC04254.JPG_5.jpg,700,480,640,20,281,301,350,385,False,35
g,62,kaist_dataset/Mixed/Digital_Camera/(C.S)E-night/DSC02647.JPG,char_data/g/DSC02647.JPG_2.jpg,4526,480,640,73,383,456,181,243,False,35
g,28,kaist_dataset/Mixed/Mobile_Phone/(C.M)A-outdoor/P090912078.jpg,char_data/g/P090912078.jpg_2.jpg,812,480,640,29,189,218,315,343,False,35
g,35,kaist_dataset/Mixed/Mobile_Phone/(C.M)B-indoor/P090831005.jpg,char_data/g/P090831005.jpg_2.jpg,490,480,640,14,320,334,244,279,False,35
g,53,kaist_dataset/Mixed/Mobile_Phone/(C.M)B-indoor/P090831013.jpg,char_data/g/P090831013.jpg_2.jpg,1855,480,640,35,280,315,199,252,False,35
g,72,kaist_dataset/Mixed/Mobile_Phone/(C.M)C-bookCover/P090831122.jpg,char_data/g/P090831122.jpg_2.jpg,2160,480,640,30,337,367,267,339,False,35
g,78,kaist_dataset/Mixed/Mobile_Phone/(C.M)C-bookCover/P090831126.jpg,char_data/g/P090831126.jpg_2.jpg,2730,480,640,35,305,340,292,370,False,35
고,31,kaist_dataset/English/Digital_Camera/(E.S)B-light/080116-0059.jpg,char_data/고/080116-0059.jpg_8.jpg,558,1200,1600,18,932,950,902,933,True,49
고,34,kaist_dataset/English/Digital_Camera/(E.S)B-light/080116-0059.jpg,char_data/고/080116-0059.jpg_9.jpg,680,1200,1600,20,1184,1204,1012,1046,True,49
고,30,kaist_dataset/English/Digital_Camera/(E.S)B-light/080116-0059.jpg,char_data/고/080116-0059.jpg_10.jpg,540,1200,1600,18,1027,1045,1064,1094,True,49
고,30,kaist_dataset/English/Digital_Camera/(E.S)B-light/080116-0059.jpg,char_data/고/080116-0059.jpg_11.jpg,630,1200,1600,21,948,969,986,1016,True,49
고,84,kaist_dataset/English/Digital_Camera/(E.S)C-outdoor1/080120-0001.jpg,char_data/고/080120-0001.jpg_2.jpg,7812,1200,1600,93,609,702,355,439,True,49
고,263,kaist_dataset/Korean/Digital_Camera/A-shadow/2007-12-09-day-exterior-031.jpg,char_data/고/2007-12-09-day-exterior-031.jpg_2.jpg,70484,1200,1600,268,893,1161,327,590,True,49
고,118,kaist_dataset/Korean/Digital_Camera/A-shadow/DSC03535.JPG,char_data/고/DSC03535.JPG_2.jpg,13452,480,640,114,232,346,63,181,True,49
고,76,kaist_dataset/Korean/Digital_Camera/A-shadow/P1010034.JPG,char_data/고/P1010034.JPG_2.jpg,5320,480,640,70,30,100,304,380,True,49
고,69,kaist_dataset/Korean/Digital_Camera/E-night/144.JPG,char_data/고/144.JPG_2.jpg,4554,480,640,66,111,177,228,297,True,49
고,50,kaist_dataset/Korean/Digital_Camera/F-bookCover/DSC02839.JPG,char_data/고/DSC02839.JPG_2.jpg,2000,480,640,40,283,323,91,141,True,49
고,101,kaist_dataset/Korean/Digital_Camera/G-others/2007-12-08-day-045.jpg,char_data/고/2007-12-08-day-045.jpg_6.jpg,7878,1200,1600,78,655,733,1042,1143,True,49
고,127,kaist_dataset/Korean/Digital_Camera/G-others/2007-12-08-day-045.jpg,char_data/고/2007-12-08-day-045.jpg_7.jpg,13208,1200,1600,104,1100,1204,1048,1175,True,49
고,243,kaist_dataset/Korean/Digital_Camera/G-others/2007-12-08-day-045.jpg,char_data/고/2007-12-08-day-045.jpg_8.jpg,104490,1200,1600,430,515,945,492,735,True,49
고,144,kaist_dataset/Korean/Digital_Camera/G-others/2007-12-09-day-exterior-005.jpg,char_data/고/2007-12-09-day-exterior-005.jpg_2.jpg,18000,1600,1200,125,702,827,496,640,True,49
고,67,kaist_dataset/Korean/Digital_Camera/G-others/5.jpg,char_data/고/5.jpg_2.jpg,2948,553,798,44,302,346,186,253,True,49
고,47,kaist_dataset/Korean/Digital_Camera/indoor1/080118-0017.jpg,char_data/고/080118-0017.jpg_2.jpg,2021,1200,1600,43,1174,1217,489,536,True,49
고,109,kaist_dataset/Korean/Digital_Camera/indoor1/DSC02722.JPG,char_data/고/DSC02722.JPG_2.jpg,11336,480,640,104,13,117,215,324,True,49
고,107,kaist_dataset/Korean/Digital_Camera/indoor1/DSC02727.JPG,char_data/고/DSC02727.JPG_2.jpg,8988,480,640,84,9,93,100,207,True,49
고,35,kaist_dataset/Korean/Digital_Camera/indoor1/DSC02737.JPG,char_data/고/DSC02737.JPG_2.jpg,805,480,640,23,433,456,187,222,True,49
고,42,kaist_dataset/Korean/Digital_Camera/indoor1/DSC02738.JPG,char_data/고/DSC02738.JPG_2.jpg,1092,480,640,26,462,488,179,221,True,49
고,95,kaist_dataset/Korean/Digital_Camera/indoor1/DSC02811.JPG,char_data/고/DSC02811.JPG_2.jpg,8835,480,640,93,16,109,243,338,True,49
고,63,kaist_dataset/Korean/Digital_Camera/indoor1/DSC03362.JPG,char_data/고/DSC03362.JPG_2.jpg,3339,480,640,53,395,448,269,332,True,49
고,71,kaist_dataset/Korean/Digital_Camera/indoor2/DSC04423.JPG,char_data/고/DSC04423.JPG_2.jpg,5325,480,640,75,217,292,228,299,True,49
고,22,kaist_dataset/Korean/Digital_Camera/outdoor1/011.JPG,char_data/고/011.JPG_2.jpg,396,480,640,18,126,144,261,283,True,49
고,23,kaist_dataset/Korean/Digital_Camera/outdoor1/033.JPG,char_data/고/033.JPG_2.jpg,736,480,640,32,38,70,215,238,True,49
고,40,kaist_dataset/Korean/Digital_Camera/outdoor1/037.jpg,char_data/고/037.jpg_2.jpg,1800,244,360,45,293,338,179,219,True,49
고,78,kaist_dataset/Korean/Digital_Camera/outdoor1/116.JPG,char_data/고/116.JPG_2.jpg,7878,480,640,101,372,473,187,265,True,49
고,245,kaist_dataset/Korean/Digital_Camera/outdoor1/2007-12-08-day-047.jpg,char_data/고/2007-12-08-day-047.jpg_6.jpg,60515,1200,1600,247,414,661,448,693,True,49
고,51,kaist_dataset/Korean/Digital_Camera/outdoor1/2007-12-08-day-047.jpg,char_data/고/2007-12-08-day-047.jpg_7.jpg,2091,1200,1600,41,94,135,1057,1108,True,49
고,43,kaist_dataset/Korean/Digital_Camera/outdoor1/2007-12-08-day-047.jpg,char_data/고/2007-12-08-day-047.jpg_8.jpg,1247,1200,1600,29,1319,1348,1017,1060,True,49
고,39,kaist_dataset/Korean/Digital_Camera/outdoor1/54.JPG,char_data/고/54.JPG_2.jpg,1404,523,767,36,154,190,199,238,True,49
고,62,kaist_dataset/Korean/Digital_Camera/outdoor2/2007-12-08-day-094.jpg,char_data/고/2007-12-08-day-094.jpg_2.jpg,3720,1600,1200,60,739,799,551,613,True,49
고,142,kaist_dataset/Korean/Digital_Camera/outdoor2/2007-12-09-day-exterior-006.jpg,char_data/고/2007-12-09-day-exterior-006.jpg_4.jpg,23430,1200,1600,165,11,176,124,266,True,49
고,125,kaist_dataset/Korean/Digital_Camera/outdoor2/2007-12-09-day-exterior-006.jpg,char_data/고/2007-12-09-day-exterior-006.jpg_5.jpg,15500,1200,1600,124,1355,1479,280,405,True,49
고,110,kaist_dataset/Korean/Digital_Camera/outdoor2/2007-12-09-day-exterior-008.jpg,char_data/고/2007-12-09-day-exterior-008.jpg_2.jpg,21010,1200,1600,191,1236,1427,152,262,True,49
고,55,kaist_dataset/Korean/Digital_Camera/outdoor2/2007-12-09-day-exterior-012.jpg,char_data/고/2007-12-09-day-exterior-012.jpg_2.jpg,3135,1200,1600,57,200,257,644,699,True,49
고,74,kaist_dataset/Korean/Digital_Camera/outdoor2/2007-12-09-day-exterior-016.jpg,char_data/고/2007-12-09-day-exterior-016.jpg_2.jpg,3996,1200,1600,54,260,314,236,310,True,49
고,100,kaist_dataset/Korean/Digital_Camera/outdoor2/DSC02305.JPG,char_data/고/DSC02305.JPG_2.jpg,14000,480,640,140,350,490,120,220,True,49
고,98,kaist_dataset/Korean/Digital_Camera/outdoor2/DSC02451.JPG,char_data/고/DSC02451.JPG_2.jpg,12642,480,640,129,131,260,114,212,True,49
고,60,kaist_dataset/Korean/Digital_Camera/outdoor2/DSC02520.JPG,char_data/고/DSC02520.JPG_2.jpg,3780,480,640,63,119,182,302,362,True,49
고,40,kaist_dataset/Korean/Digital_Camera/outdoor3/DSC02686.JPG,char_data/고/DSC02686.JPG_2.jpg,1400,480,640,35,124,159,56,96,True,49
고,34,kaist_dataset/Korean/Digital_Camera/outdoor3/DSC02908.JPG,char_data/고/DSC02908.JPG_2.jpg,714,480,640,21,262,283,179,213,True,49
고,49,kaist_dataset/Korean/Digital_Camera/outdoor3/DSC03220.JPG,char_data/고/DSC03220.JPG_2.jpg,2254,480,640,46,104,150,97,146,True,49
고,106,kaist_dataset/Korean/Digital_Camera/outdoor4/DSC03405.JPG,char_data/고/DSC03405.JPG_2.jpg,9116,480,640,86,65,151,303,409,True,49
고,92,kaist_dataset/Korean/Digital_Camera/outdoor4/DSC03513.JPG,char_data/고/DSC03513.JPG_2.jpg,8464,480,640,92,363,455,40,132,True,49
고,60,kaist_dataset/Korean/Digital_Camera/outdoor4/DSC03540.JPG,char_data/고/DSC03540.JPG_2.jpg,3060,480,640,51,221,272,315,375,True,49
고,46,kaist_dataset/Korean/Digital_Camera/outdoor4/DSC03541.JPG,char_data/고/DSC03541.JPG_2.jpg,2438,480,640,53,216,269,378,424,True,49
고,85,kaist_dataset/Korean/Digital_Camera/outdoor4/DSC03542.JPG,char_data/고/DSC03542.JPG_2.jpg,4845,480,640,57,195,252,126,211,True,49
고,60,kaist_dataset/Korean/Digital_Camera/outdoor4/DSC03600.JPG,char_data/고/DSC03600.JPG_2.jpg,3420,480,640,57,331,388,185,245,True,49
고,103,kaist_dataset/Korean/Digital_Camera/outdoor5/DSC03646.JPG,char_data/고/DSC03646.JPG_2.jpg,10197,480,640,99,76,175,226,329,True,49
고,57,kaist_dataset/Korean/Digital_Camera/outdoor5/DSC03681.JPG,char_data/고/DSC03681.JPG_2.jpg,2565,480,640,45,132,177,352,409,True,49
고,49,kaist_dataset/Korean/Digital_Camera/outdoor5/DSC03709.JPG,char_data/고/DSC03709.JPG_2.jpg,1666,480,640,34,429,463,136,185,True,49
고,68,kaist_dataset/Korean/Digital_Camera/outdoor5/DSC03712.JPG,char_data/고/DSC03712.JPG_2.jpg,2720,480,640,40,115,155,39,107,True,49
고,35,kaist_dataset/Korean/Digital_Camera/outdoor5/DSC03736.JPG,char_data/고/DSC03736.JPG_2.jpg,595,480,640,17,210,227,403,438,True,49
고,37,kaist_dataset/Korean/Digital_Camera/outdoor5/DSC03789.JPG,char_data/고/DSC03789.JPG_4.jpg,1221,480,640,33,372,405,174,211,True,49
고,29,kaist_dataset/Korean/Digital_Camera/outdoor5/DSC03789.JPG,char_data/고/DSC03789.JPG_5.jpg,812,480,640,28,420,448,223,252,True,49
고,66,kaist_dataset/Korean/Digital_Camera/outdoor5/DSC03790.JPG,char_data/고/DSC03790.JPG_2.jpg,3894,480,640,59,324,383,74,140,True,49
고,102,kaist_dataset/Korean/Digital_Camera/outdoor5/DSC03853.JPG,char_data/고/DSC03853.JPG_2.jpg,11526,480,640,113,243,356,198,300,True,49
고,70,kaist_dataset/Korean/Digital_Camera/outdoor5/DSC03856.JPG,char_data/고/DSC03856.JPG_2.jpg,6650,480,640,95,166,261,77,147,True,49
고,52,kaist_dataset/Korean/Digital_Camera/outdoor5/DSC04038.JPG,char_data/고/DSC04038.JPG_2.jpg,1768,480,640,34,109,143,246,298,True,49
고,41,kaist_dataset/Korean/Digital_Camera/outdoor5/DSC04040.JPG,char_data/고/DSC04040.JPG_4.jpg,1599,480,640,39,479,518,136,177,True,49
고,40,kaist_dataset/Korean/Digital_Camera/outdoor5/DSC04040.JPG,char_data/고/DSC04040.JPG_5.jpg,1560,480,640,39,354,393,184,224,True,49
고,82,kaist_dataset/Korean/Digital_Camera/outdoor6/DSC04400.JPG,char_data/고/DSC04400.JPG_2.jpg,6888,480,640,84,236,320,135,217,True,49
고,114,kaist_dataset/Korean/Digital_Camera/outdoor6/DSC04407.JPG,char_data/고/DSC04407.JPG_2.jpg,11286,480,640,99,236,335,74,188,True,49
고,72,kaist_dataset/Korean/Digital_Camera/outdoor7/P1010015.JPG,char_data/고/P1010015.JPG_2.jpg,4824,480,640,67,134,201,197,269,True,49
고,44,kaist_dataset/Korean/Digital_Camera/outdoor7/P1010085.JPG,char_data/고/P1010085.JPG_2.jpg,1276,480,640,29,268,297,62,106,True,49
고,155,kaist_dataset/Korean/Digital_Camera/outdoor7/P1010087.JPG,char_data/고/P1010087.JPG_2.jpg,19530,480,640,126,99,225,272,427,True,49
고,122,kaist_dataset/Korean/Digital_Camera/outdoor7/P1010088.JPG,char_data/고/P1010088.JPG_2.jpg,9394,480,640,77,166,243,193,315,True,49
고,79,"kaist_dataset/Korean/Mobile_Phone/(M,K)C-outdoor/P090912034.jpg",char_data/고/P090912034.jpg_2.jpg,4424,480,640,56,145,201,151,230,True,49
고,42,"kaist_dataset/Korean/Mobile_Phone/(M,K)D-indoor/P090911066.jpg",char_data/고/P090911066.jpg_2.jpg,1554,480,640,37,6,43,383,425,True,49
고,110,"kaist_dataset/Korean/Mobile_Phone/(M,K)E-bookCover/P090831031.jpg",char_data/고/P090831031.jpg_2.jpg,11990,480,640,109,511,620,168,278,True,49
고,105,"kaist_dataset/Korean/Mobile_Phone/(M,K)E-bookCover/P090831127.jpg",char_data/고/P090831127.jpg_2.jpg,9030,480,640,86,524,610,220,325,True,49
고,116,"kaist_dataset/Korean/Mobile_Phone/(M,K)E-bookCover/P090831131.jpg",char_data/고/P090831131.jpg_2.jpg,9744,480,640,84,188,272,93,209,True,49
고,153,"kaist_dataset/Korean/Mobile_Phone/(M,K)E-bookCover/P090831133.jpg",char_data/고/P090831133.jpg_2.jpg,16524,480,640,108,469,577,263,416,True,49
고,94,"kaist_dataset/Korean/Mobile_Phone/(M,K)E-bookCover/P090831134.jpg",char_data/고/P090831134.jpg_2.jpg,6204,480,640,66,369,435,253,347,True,49
고,118,"kaist_dataset/Korean/Mobile_Phone/(M,K)E-bookCover/P090903010.jpg",char_data/고/P090903010.jpg_2.jpg,9086,480,640,77,57,134,306,424,True,49
고,61,"kaist_dataset/Korean/Mobile_Phone/(M,K)E-bookCover/P090905008.jpg",char_data/고/P090905008.jpg_2.jpg,3538,480,640,58,81,139,59,120,True,49
고,56,kaist_dataset/Mixed/Digital_Camera/(C.S)C-outdoor1/080118-0007.jpg,char_data/고/080118-0007.jpg_4.jpg,3248,1200,1600,58,879,937,18,74,True,49
고,184,kaist_dataset/Mixed/Digital_Camera/(C.S)C-outdoor1/080118-0007.jpg,char_data/고/080118-0007.jpg_5.jpg,32016,1200,1600,174,1330,1504,778,962,True,49
고,53,kaist_dataset/Mixed/Digital_Camera/(C.S)C-outdoor1/1.JPG,char_data/고/1.JPG_2.jpg,2915,576,768,55,111,166,520,573,True,49
고,31,kaist_dataset/Mixed/Digital_Camera/(C.S)C-outdoor1/2.JPG,char_data/고/2.JPG_4.jpg,434,576,768,14,554,568,30,61,True,49
고,32,kaist_dataset/Mixed/Digital_Camera/(C.S)C-outdoor1/2.JPG,char_data/고/2.JPG_5.jpg,608,576,768,19,495,514,60,92,True,49
고,74,kaist_dataset/Mixed/Digital_Camera/(C.S)C-outdoor1/2007-12-09-day-exterior-037.jpg,char_data/고/2007-12-09-day-exterior-037.jpg_2.jpg,4070,1200,1600,55,556,611,618,692,True,49
고,109,kaist_dataset/Mixed/Digital_Camera/(C.S)C-outdoor2/DSC02391.JPG,char_data/고/DSC02391.JPG_2.jpg,14388,480,640,132,104,236,234,343,True,49
고,36,kaist_dataset/Mixed/Digital_Camera/(C.S)C-outdoor2/DSC02503.JPG,char_data/고/DSC02503.JPG_2.jpg,1260,480,640,35,102,137,42,78,True,49
고,40,kaist_dataset/Mixed/Digital_Camera/(C.S)C-outdoor2/DSC02543.JPG,char_data/고/DSC02543.JPG_2.jpg,1600,480,640,40,56,96,274,314,True,49
고,74,kaist_dataset/Mixed/Digital_Camera/(C.S)C-outdoor2/DSC02560.JPG,char_data/고/DSC02560.JPG_2.jpg,5328,480,640,72,247,319,183,257,True,49
고,43,kaist_dataset/Mixed/Digital_Camera/(C.S)C-outdoor2/DSC02864.JPG,char_data/고/DSC02864.JPG_2.jpg,1720,480,640,40,123,163,81,124,True,49
고,44,kaist_dataset/Mixed/Digital_Camera/(C.S)C-outdoor2/DSC02866.JPG,char_data/고/DSC02866.JPG_2.jpg,1760,480,640,40,83,123,73,117,True,49
고,48,kaist_dataset/Mixed/Digital_Camera/(C.S)C-outdoor2/DSC02887.JPG,char_data/고/DSC02887.JPG_2.jpg,1968,480,640,41,133,174,233,281,True,49
고,90,kaist_dataset/Mixed/Digital_Camera/(C.S)C-outdoor2/DSC02907.JPG,char_data/고/DSC02907.JPG_2.jpg,6120,480,640,68,146,214,377,467,True,49
고,90,kaist_dataset/Mixed/Digital_Camera/(C.S)C-outdoor3/DSC03209.JPG,char_data/고/DSC03209.JPG_2.jpg,11070,480,640,123,134,257,280,370,True,49
고,40,kaist_dataset/Mixed/Digital_Camera/(C.S)C-outdoor3/DSC03223.JPG,char_data/고/DSC03223.JPG_2.jpg,1440,480,640,36,322,358,424,464,True,49
고,51,kaist_dataset/Mixed/Digital_Camera/(C.S)C-outdoor4/DSC03582.JPG,char_data/고/DSC03582.JPG_2.jpg,1581,480,640,31,384,415,86,137,True,49
고,73,kaist_dataset/Mixed/Digital_Camera/(C.S)C-outdoor4/DSC03642.JPG,char_data/고/DSC03642.JPG_2.jpg,3212,480,640,44,101,145,356,429,True,49
고,50,kaist_dataset/Mixed/Digital_Camera/(C.S)C-outdoor5/DSC04014.JPG,char_data/고/DSC04014.JPG_2.jpg,2750,480,640,55,152,207,241,291,True,49
고,78,kaist_dataset/Mixed/Digital_Camera/(C.S)C-outdoor5/DSC04017.JPG,char_data/고/DSC04017.JPG_2.jpg,4992,480,640,64,307,371,240,318,True,49
고,36,kaist_dataset/Mixed/Digital_Camera/(C.S)C-outdoor5/DSC04029.JPG,char_data/고/DSC04029.JPG_2.jpg,1440,480,640,40,319,359,247,283,True,49
고,66,kaist_dataset/Mixed/Digital_Camera/(C.S)C-outdoor5/DSC04072.JPG,char_data/고/DSC04072.JPG_2.jpg,3498,480,640,53,334,387,225,291,False,49
고,64,kaist_dataset/Mixed/Digital_Camera/(C.S)C-outdoor5/DSC04091.JPG,char_data/고/DSC04091.JPG_2.jpg,2688,480,640,42,502,544,327,391,False,49
고,71,kaist_dataset/Mixed/Digital_Camera/(C.S)C-outdoor5/DSC04149.JPG,char_data/고/DSC04149.JPG_2.jpg,4118,480,640,58,296,354,211,282,False,49
고,80,kaist_dataset/Mixed/Digital_Camera/(C.S)C-outdoor5/DSC04450.JPG,char_data/고/DSC04450.JPG_2.jpg,4720,480,640,59,177,236,336,416,False,49
고,41,kaist_dataset/Mixed/Digital_Camera/(C.S)C-outdoor5/DSC04456.JPG,char_data/고/DSC04456.JPG_2.jpg,1271,480,640,31,104,135,226,267,False,49
고,66,kaist_dataset/Mixed/Digital_Camera/(C.S)C-outdoor6/080116-0057.jpg,char_data/고/080116-0057.jpg_2.jpg,3630,1200,1600,55,716,771,997,1063,False,49
고,37,kaist_dataset/Mixed/Digital_Camera/(C.S)C-outdoor6/P1010048.JPG,char_data/고/P1010048.JPG_2.jpg,962,480,640,26,252,278,111,148,False,49
고,80,kaist_dataset/Mixed/Digital_Camera/(C.S)C-outdoor6/P1010069.JPG,char_data/고/P1010069.JPG_2.jpg,8960,480,640,112,157,269,214,294,False,49
고,87,kaist_dataset/Mixed/Digital_Camera/(C.S)C-outdoor6/P1010137.JPG,char_data/고/P1010137.JPG_4.jpg,8352,480,640,96,139,235,93,180,False,49
고,57,kaist_dataset/Mixed/Digital_Camera/(C.S)C-outdoor6/P1010137.JPG,char_data/고/P1010137.JPG_5.jpg,3249,480,640,57,152,209,249,306,False,49
고,35,kaist_dataset/Mixed/Digital_Camera/(C.S)D-indoor1/082.JPG,char_data/고/082.JPG_2.jpg,1050,480,640,30,292,322,254,289,False,49
고,54,kaist_dataset/Mixed/Digital_Camera/(C.S)D-indoor1/DSC02746.JPG,char_data/고/DSC02746.JPG_2.jpg,2916,480,640,54,218,272,255,309,False,49
고,74,kaist_dataset/Mixed/Digital_Camera/(C.S)D-indoor1/DSC02747.JPG,char_data/고/DSC02747.JPG_2.jpg,5550,480,640,75,294,369,288,362,False,49
고,54,kaist_dataset/Mixed/Digital_Camera/(C.S)D-indoor1/DSC02748.JPG,char_data/고/DSC02748.JPG_2.jpg,3456,480,640,64,278,342,311,365,False,49
고,49,kaist_dataset/Mixed/Digital_Camera/(C.S)D-indoor1/DSC02749.JPG,char_data/고/DSC02749.JPG_2.jpg,2989,480,640,61,208,269,336,385,False,49
고,41,kaist_dataset/Mixed/Digital_Camera/(C.S)D-indoor1/DSC02750.JPG,char_data/고/DSC02750.JPG_2.jpg,2419,480,640,59,203,262,240,281,False,49
고,41,kaist_dataset/Mixed/Digital_Camera/(C.S)D-indoor1/DSC02751.JPG,char_data/고/DSC02751.JPG_4.jpg,1968,480,640,48,203,251,252,293,False,49
고,47,kaist_dataset/Mixed/Digital_Camera/(C.S)D-indoor1/DSC02751.JPG,char_data/고/DSC02751.JPG_5.jpg,1974,480,640,42,206,248,195,242,False,49
고,71,kaist_dataset/Mixed/Digital_Camera/(C.S)D-indoor1/DSC03483.JPG,char_data/고/DSC03483.JPG_2.jpg,4047,480,640,57,57,114,23,94,False,49
고,77,kaist_dataset/Mixed/Digital_Camera/(C.S)D-indoor1/DSC04246.JPG,char_data/고/DSC04246.JPG_2.jpg,7084,480,640,92,452,544,129,206,False,49
고,44,kaist_dataset/Mixed/Digital_Camera/(C.S)E-night/DSC03514.JPG,char_data/고/DSC03514.JPG_2.jpg,1980,480,640,45,248,293,149,193,False,49
고,105,kaist_dataset/Mixed/Digital_Camera/(C.S)F-others/2007-12-08-day-113.jpg,char_data/고/2007-12-08-day-113.jpg_4.jpg,7140,1200,1600,68,528,596,694,799,False,49
고,84,kaist_dataset/Mixed/Digital_Camera/(C.S)F-others/2007-12-08-day-113.jpg,char_data/고/2007-12-08-day-113.jpg_5.jpg,4956,1200,1600,59,879,938,746,830,False,49
고,31,kaist_dataset/Mixed/Digital_Camera/(C.S)F-others/DSC02793.JPG,char_data/고/DSC02793.JPG_2.jpg,992,480,640,32,424,456,291,322,False,49
고,147,kaist_dataset/Mixed/Mobile_Phone/(C.M)C-bookCover/P090903092.jpg,char_data/고/P090903092.jpg_2.jpg,18963,480,640,129,239,368,43,190,False,49
G,59,kaist_dataset/English/Digital_Camera/(E.S)A-shadow/DSC03082.JPG,char_data/G/DSC03082.JPG_4.jpg,2124,480,640,36,131,167,368,427,True,18
G,37,kaist_dataset/English/Digital_Camera/(E.S)A-shadow/P1010044.JPG,char_data/G/P1010044.JPG_2.jpg,1184,480,640,32,536,568,353,390,True,18
G,33,kaist_dataset/English/Digital_Camera/(E.S)B-light/080116-0059.jpg,char_data/G/080116-0059.jpg_6.jpg,792,1200,1600,24,541,565,827,860,True,18
G,27,kaist_dataset/English/Digital_Camera/(E.S)B-light/080116-0059.jpg,char_data/G/080116-0059.jpg_7.jpg,378,1200,1600,14,963,977,825,852,True,18
G,31,kaist_dataset/English/Digital_Camera/(E.S)B-light/080116-0059.jpg,char_data/G/080116-0059.jpg_8.jpg,496,1200,1600,16,480,496,771,802,True,18
G,75,kaist_dataset/English/Digital_Camera/(E.S)B-light/080119-0038.jpg,char_data/G/080119-0038.jpg_2.jpg,6450,1200,1600,86,495,581,672,747,True,18
G,102,kaist_dataset/English/Digital_Camera/(E.S)B-light/크기변환_%B0%A3%C6%C7_ktimt007.jpg,char_data/G/크기변환_%B0%A3%C6%C7_ktimt007.jpg_2.jpg,9078,480,640,89,312,401,197,299,True,18
G,54,kaist_dataset/English/Digital_Camera/(E.S)C-outdoor1/034.JPG,char_data/G/034.JPG_2.jpg,3186,480,640,59,210,269,197,251,True,18
G,71,kaist_dataset/English/Digital_Camera/(E.S)C-outdoor1/055.JPG,char_data/G/055.JPG_2.jpg,3763,480,640,53,253,306,186,257,True,18
G,23,kaist_dataset/English/Digital_Camera/(E.S)C-outdoor1/056.JPG,char_data/G/056.JPG_5.jpg,414,480,640,18,463,481,253,276,True,18
G,50,kaist_dataset/English/Digital_Camera/(E.S)C-outdoor1/064.JPG,char_data/G/064.JPG_2.jpg,1500,480,640,30,391,421,185,235,True,18
G,49,kaist_dataset/English/Digital_Camera/(E.S)C-outdoor1/077.JPG,char_data/G/077.JPG_2.jpg,2597,480,640,53,144,197,199,248,True,18
G,66,kaist_dataset/English/Digital_Camera/(E.S)C-outdoor1/080118-0011.jpg,char_data/G/080118-0011.jpg_2.jpg,3102,1200,1600,47,1262,1309,920,986,True,18
G,241,kaist_dataset/English/Digital_Camera/(E.S)C-outdoor1/080119-0004.jpg,char_data/G/080119-0004.jpg_2.jpg,65793,1200,1600,273,743,1016,520,761,True,18
G,50,kaist_dataset/English/Digital_Camera/(E.S)C-outdoor1/089.jpg,char_data/G/089.jpg_2.jpg,1200,480,640,24,148,172,284,334,True,18
G,155,kaist_dataset/English/Digital_Camera/(E.S)C-outdoor1/100.JPG,char_data/G/100.JPG_5.jpg,23405,480,640,151,187,338,239,394,True,18
G,83,kaist_dataset/English/Digital_Camera/(E.S)C-outdoor1/110.jpg,char_data/G/110.jpg_2.jpg,5561,480,640,67,435,502,191,274,True,18
G,60,kaist_dataset/English/Digital_Camera/(E.S)C-outdoor1/139.JPG,char_data/G/139.JPG_4.jpg,3060,480,640,51,222,273,254,314,True,18
G,73,kaist_dataset/English/Digital_Camera/(E.S)C-outdoor1/139.JPG,char_data/G/139.JPG_5.jpg,3942,480,640,54,487,541,249,322,True,18
G,195,kaist_dataset/English/Digital_Camera/(E.S)C-outdoor1/2007-12-08-day-099.jpg,char_data/G/2007-12-08-day-099.jpg_2.jpg,21840,1200,1600,112,1266,1378,459,654,True,18
G,141,kaist_dataset/English/Digital_Camera/(E.S)C-outdoor1/2007-12-09-day-exterior-063.jpg,char_data/G/2007-12-09-day-exterior-063.jpg_2.jpg,13254,1200,1600,94,706,800,412,553,True,18
G,42,kaist_dataset/English/Digital_Camera/(E.S)C-outdoor1/6.jpg,char_data/G/6.jpg_2.jpg,1806,255,731,43,347,390,98,140,True,18
G,106,kaist_dataset/English/Digital_Camera/(E.S)C-outdoor1/DSC02352.JPG,char_data/G/DSC02352.JPG_2.jpg,11236,480,640,106,259,365,214,320,True,18
G,70,kaist_dataset/English/Digital_Camera/(E.S)C-outdoor1/DSC02394.JPG,char_data/G/DSC02394.JPG_2.jpg,5250,480,640,75,129,204,258,328,True,18
G,20,kaist_dataset/English/Digital_Camera/(E.S)C-outdoor1/DSC02500.JPG,char_data/G/DSC02500.JPG_4.jpg,460,480,640,23,99,122,103,123,True,18
G,72,kaist_dataset/English/Digital_Camera/(E.S)C-outdoor2/DSC03012.JPG,char_data/G/DSC03012.JPG_2.jpg,3816,480,640,53,584,637,210,282,True,18
G,71,kaist_dataset/English/Digital_Camera/(E.S)C-outdoor2/DSC03413.JPG,char_data/G/DSC03413.JPG_2.jpg,3763,480,640,53,115,168,186,257,True,18
G,55,kaist_dataset/English/Digital_Camera/(E.S)C-outdoor2/DSC03705.JPG,char_data/G/DSC03705.JPG_2.jpg,1870,480,640,34,225,259,314,369,True,18
G,71,kaist_dataset/English/Digital_Camera/(E.S)C-outdoor2/DSC03865.JPG,char_data/G/DSC03865.JPG_2.jpg,3905,480,640,55,285,340,82,153,True,18
G,72,kaist_dataset/English/Digital_Camera/(E.S)C-outdoor2/DSC04047.JPG,char_data/G/DSC04047.JPG_2.jpg,5256,480,640,73,24,97,217,289,True,18
G,73,kaist_dataset/English/Digital_Camera/(E.S)C-outdoor2/DSC04079.JPG,char_data/G/DSC04079.JPG_4.jpg,4380,480,640,60,403,463,271,344,True,18
G,74,kaist_dataset/English/Digital_Camera/(E.S)C-outdoor2/DSC04131.JPG,char_data/G/DSC04131.JPG_2.jpg,7104,480,640,96,197,293,130,204,True,18
G,54,kaist_dataset/English/Digital_Camera/(E.S)C-outdoor2/DSC04163.JPG,char_data/G/DSC04163.JPG_2.jpg,2268,480,640,42,235,277,260,314,True,18
G,56,kaist_dataset/English/Digital_Camera/(E.S)C-outdoor2/f.jpg,char_data/G/f.jpg_4.jpg,3528,240,320,63,151,214,67,123,True,18
G,58,kaist_dataset/English/Digital_Camera/(E.S)C-outdoor2/f.jpg,char_data/G/f.jpg_5.jpg,3886,240,320,67,218,285,67,125,True,18
G,74,kaist_dataset/English/Digital_Camera/(E.S)C-outdoor3/P1010123.JPG,char_data/G/P1010123.JPG_2.jpg,4884,480,640,66,153,219,74,148,True,18
G,47,kaist_dataset/English/Digital_Camera/(E.S)D-indoor/080119-0009.jpg,char_data/G/080119-0009.jpg_4.jpg,2632,1200,1600,56,914,970,681,728,True,18
G,37,kaist_dataset/English/Digital_Camera/(E.S)D-indoor/080119-0015.jpg,char_data/G/080119-0015.jpg_2.jpg,1221,1200,1600,33,653,686,637,674,True,18
G,92,kaist_dataset/English/Digital_Camera/(E.S)D-indoor/DSC02850.JPG,char_data/G/DSC02850.JPG_2.jpg,6992,480,640,76,346,422,147,239,True,18
G,69,kaist_dataset/English/Digital_Camera/(E.S)D-indoor/DSC03083.JPG,char_data/G/DSC03083.JPG_2.jpg,5106,480,640,74,290,364,223,292,True,18
G,46,kaist_dataset/English/Digital_Camera/(E.S)D-indoor/DSC03090.JPG,char_data/G/DSC03090.JPG_2.jpg,1702,480,640,37,94,131,235,281,True,18
G,39,kaist_dataset/English/Digital_Camera/(E.S)D-indoor/DSC03112.JPG,char_data/G/DSC03112.JPG_2.jpg,1404,480,640,36,351,387,204,243,True,18
G,46,kaist_dataset/English/Digital_Camera/(E.S)D-indoor/DSC03146.JPG,char_data/G/DSC03146.JPG_10.jpg,1656,480,640,36,293,329,222,268,True,18
G,51,kaist_dataset/English/Digital_Camera/(E.S)D-indoor/DSC03146.JPG,char_data/G/DSC03146.JPG_13.jpg,2040,480,640,40,291,331,160,211,True,18
G,44,kaist_dataset/English/Digital_Camera/(E.S)D-indoor/DSC03147.JPG,char_data/G/DSC03147.JPG_12.jpg,2112,480,640,48,114,162,287,331,True,18
G,40,kaist_dataset/English/Digital_Camera/(E.S)D-indoor/DSC03147.JPG,char_data/G/DSC03147.JPG_15.jpg,1440,480,640,36,129,165,231,271,True,18
G,59,kaist_dataset/English/Digital_Camera/(E.S)D-indoor/DSC03345.JPG,char_data/G/DSC03345.JPG_2.jpg,3068,480,640,52,328,380,89,148,True,18
G,99,kaist_dataset/English/Digital_Camera/(E.S)D-indoor/DSC03366.JPG,char_data/G/DSC03366.JPG_2.jpg,7821,480,640,79,399,478,349,448,True,18
G,51,kaist_dataset/English/Digital_Camera/(E.S)D-indoor/DSC03918.JPG,char_data/G/DSC03918.JPG_2.jpg,1632,480,640,32,266,298,407,458,True,18
G,39,kaist_dataset/English/Digital_Camera/(E.S)D-indoor/DSC03935.JPG,char_data/G/DSC03935.JPG_2.jpg,858,480,640,22,512,534,53,92,True,18
G,112,kaist_dataset/English/Digital_Camera/(E.S)E-night/080116-0056.jpg,char_data/G/080116-0056.jpg_2.jpg,11984,1200,1600,107,620,727,556,668,True,18
G,95,kaist_dataset/English/Digital_Camera/(E.S)E-night/DSC02675.JPG,char_data/G/DSC02675.JPG_2.jpg,7030,480,640,74,204,278,173,268,True,18
G,178,kaist_dataset/English/Digital_Camera/(E.S)F-others/080119-0007.jpg,char_data/G/080119-0007.jpg_5.jpg,44856,1200,1600,252,407,659,560,738,True,18
G,310,kaist_dataset/English/Digital_Camera/(E.S)F-others/080119-0011.jpg,char_data/G/080119-0011.jpg_2.jpg,47430,1200,1600,153,1020,1173,500,810,True,18
G,45,kaist_dataset/English/Digital_Camera/(E.S)F-others/m.jpg,char_data/G/m.jpg_2.jpg,1485,240,320,33,169,202,95,140,True,18
G,96,kaist_dataset/English/Mobile_Phone/(E.M)B-indoor/P090831011.jpg,char_data/G/P090831011.jpg_4.jpg,6144,480,640,64,9,73,109,205,True,18
G,76,kaist_dataset/English/Mobile_Phone/(E.M)B-indoor/P090911067.jpg,char_data/G/P090911067.jpg_2.jpg,4332,480,640,57,128,185,198,274,True,18
G,116,kaist_dataset/English/Mobile_Phone/(E.M)B-indoor/P090911086.jpg,char_data/G/P090911086.jpg_2.jpg,11252,480,640,97,156,253,343,459,True,18
G,45,kaist_dataset/English/Mobile_Phone/(E.M)C-bookCover/P090903015.jpg,char_data/G/P090903015.jpg_2.jpg,1575,480,640,35,304,339,145,190,True,18
G,84,kaist_dataset/English/Mobile_Phone/(E.M)C-bookCover/P090903071.jpg,char_data/G/P090903071.jpg_2.jpg,6300,480,640,75,101,176,134,218,True,18
G,100,kaist_dataset/English/Mobile_Phone/(E.M)C-bookCover/P090905007.jpg,char_data/G/P090905007.jpg_2.jpg,8200,480,640,82,190,272,29,129,True,18
G,35,kaist_dataset/Korean/Digital_Camera/G-others/080119-0005.jpg,char_data/G/080119-0005.jpg_4.jpg,1120,1600,1200,32,531,563,583,618,True,18
G,20,kaist_dataset/Korean/Digital_Camera/indoor1/146.JPG,char_data/G/146.JPG_2.jpg,320,480,640,16,377,393,269,289,True,18
G,31,kaist_dataset/Korean/Digital_Camera/indoor1/2007-12-08-day-139.jpg,char_data/G/2007-12-08-day-139.jpg_4.jpg,744,1200,1600,24,493,517,355,386,True,18
G,37,kaist_dataset/Korean/Digital_Camera/indoor1/2007-12-08-day-139.jpg,char_data/G/2007-12-08-day-139.jpg_5.jpg,1073,1200,1600,29,620,649,354,391,True,18
G,156,kaist_dataset/Mixed/Digital_Camera/(C.S)A-shadow/DSC04318.JPG,char_data/G/DSC04318.JPG_2.jpg,18096,480,640,116,34,150,193,349,True,18
G,25,kaist_dataset/Mixed/Digital_Camera/(C.S)C-outdoor1/047.JPG,char_data/G/047.JPG_4.jpg,425,480,640,17,202,219,237,262,True,18
G,31,kaist_dataset/Mixed/Digital_Camera/(C.S)C-outdoor1/047.JPG,char_data/G/047.JPG_5.jpg,372,480,640,12,68,80,240,271,True,18
G,77,kaist_dataset/Mixed/Digital_Camera/(C.S)C-outdoor1/1.JPG,char_data/G/1.JPG_2.jpg,3311,576,768,43,174,217,197,274,True,18
G,109,kaist_dataset/Mixed/Digital_Camera/(C.S)C-outdoor1/101.JPG,char_data/G/101.JPG_4.jpg,11881,480,640,109,193,302,138,247,True,18
G,27,kaist_dataset/Mixed/Digital_Camera/(C.S)C-outdoor1/121.JPG,char_data/G/121.JPG_2.jpg,540,480,640,20,177,197,220,247,True,18
G,41,kaist_dataset/Mixed/Digital_Camera/(C.S)C-outdoor1/2007-12-08-day-103.jpg,char_data/G/2007-12-08-day-103.jpg_2.jpg,1845,1200,1600,45,726,771,622,663,True,18
G,35,kaist_dataset/Mixed/Digital_Camera/(C.S)C-outdoor2/DSC02418.JPG,char_data/G/DSC02418.JPG_4.jpg,665,480,640,19,1,20,89,124,True,18
G,34,kaist_dataset/Mixed/Digital_Camera/(C.S)C-outdoor2/DSC02418.JPG,char_data/G/DSC02418.JPG_5.jpg,918,480,640,27,128,155,89,123,True,18
G,53,kaist_dataset/Mixed/Digital_Camera/(C.S)C-outdoor2/DSC02872.JPG,char_data/G/DSC02872.JPG_2.jpg,1113,480,640,21,373,394,216,269,True,18
G,33,kaist_dataset/Mixed/Digital_Camera/(C.S)C-outdoor2/DSC02890.JPG,char_data/G/DSC02890.JPG_2.jpg,792,480,640,24,87,111,408,441,True,18
G,35,kaist_dataset/Mixed/Digital_Camera/(C.S)C-outdoor2/DSC02910.JPG,char_data/G/DSC02910.JPG_2.jpg,665,480,640,19,374,393,56,91,True,18
G,61,kaist_dataset/Mixed/Digital_Camera/(C.S)C-outdoor3/DSC02962.JPG,char_data/G/DSC02962.JPG_2.jpg,2928,480,640,48,27,75,286,347,True,18
G,39,kaist_dataset/Mixed/Digital_Camera/(C.S)C-outdoor3/DSC02989.JPG,char_data/G/DSC02989.JPG_2.jpg,1209,480,640,31,192,223,263,302,True,18
G,110,kaist_dataset/Mixed/Digital_Camera/(C.S)C-outdoor3/DSC03017.JPG,char_data/G/DSC03017.JPG_2.jpg,13420,480,640,122,72,194,125,235,True,18
G,105,kaist_dataset/Mixed/Digital_Camera/(C.S)C-outdoor3/DSC03054.JPG,char_data/G/DSC03054.JPG_2.jpg,6825,480,640,65,346,411,218,323,True,18
G,94,kaist_dataset/Mixed/Digital_Camera/(C.S)C-outdoor3/DSC03164.JPG,char_data/G/DSC03164.JPG_2.jpg,8272,480,640,88,478,566,75,169,True,18
G,98,kaist_dataset/Mixed/Digital_Camera/(C.S)C-outdoor3/DSC03176.JPG,char_data/G/DSC03176.JPG_2.jpg,9702,480,640,99,213,312,266,364,True,18
G,153,kaist_dataset/Mixed/Digital_Camera/(C.S)C-outdoor3/DSC03210.JPG,char_data/G/DSC03210.JPG_2.jpg,10251,480,640,67,206,273,201,354,True,18
G,30,kaist_dataset/Mixed/Digital_Camera/(C.S)C-outdoor3/DSC03242.JPG,char_data/G/DSC03242.JPG_4.jpg,840,480,640,28,283,311,323,353,True,18
G,36,kaist_dataset/Mixed/Digital_Camera/(C.S)C-outdoor3/DSC03242.JPG,char_data/G/DSC03242.JPG_5.jpg,1080,480,640,30,323,353,316,352,True,18
G,31,kaist_dataset/Mixed/Digital_Camera/(C.S)C-outdoor3/DSC03250.JPG,char_data/G/DSC03250.JPG_4.jpg,558,480,640,18,511,529,370,401,True,18
G,26,kaist_dataset/Mixed/Digital_Camera/(C.S)C-outdoor3/DSC03250.JPG,char_data/G/DSC03250.JPG_5.jpg,572,480,640,22,540,562,377,403,True,18
G,21,kaist_dataset/Mixed/Digital_Camera/(C.S)C-outdoor3/DSC03255.JPG,char_data/G/DSC03255.JPG_2.jpg,399,480,640,19,590,609,181,202,True,18
G,87,kaist_dataset/Mixed/Digital_Camera/(C.S)C-outdoor3/DSC03409.JPG,char_data/G/DSC03409.JPG_2.jpg,5133,480,640,59,181,240,112,199,True,18
G,32,kaist_dataset/Mixed/Digital_Camera/(C.S)C-outdoor3/DSC03429.JPG,char_data/G/DSC03429.JPG_2.jpg,768,480,640,24,426,450,204,236,True,18
G,100,kaist_dataset/Mixed/Digital_Camera/(C.S)C-outdoor3/P1010016.JPG,char_data/G/P1010016.JPG_2.jpg,6500,480,640,65,233,298,157,257,True,18
G,75,kaist_dataset/Mixed/Digital_Camera/(C.S)C-outdoor4/DSC03687.JPG,char_data/G/DSC03687.JPG_2.jpg,3675,480,640,49,230,279,323,398,True,18
G,52,kaist_dataset/Mixed/Digital_Camera/(C.S)C-outdoor4/DSC03707.JPG,char_data/G/DSC03707.JPG_2.jpg,1820,480,640,35,139,174,91,143,True,18
G,38,kaist_dataset/Mixed/Digital_Camera/(C.S)C-outdoor4/DSC03711.JPG,char_data/G/DSC03711.JPG_2.jpg,1140,480,640,30,250,280,390,428,True,18
G,35,kaist_dataset/Mixed/Digital_Camera/(C.S)C-outdoor4/DSC03716.JPG,char_data/G/DSC03716.JPG_2.jpg,560,480,640,16,303,319,237,272,True,18
G,31,kaist_dataset/Mixed/Digital_Camera/(C.S)C-outdoor5/DSC03829.JPG,char_data/G/DSC03829.JPG_2.jpg,589,480,640,19,284,303,174,205,True,18
G,36,kaist_dataset/Mixed/Digital_Camera/(C.S)C-outdoor5/DSC04069.JPG,char_data/G/DSC04069.JPG_5.jpg,1116,480,640,31,354,385,418,454,True,18
G,41,kaist_dataset/Mixed/Digital_Camera/(C.S)C-outdoor5/DSC04098.JPG,char_data/G/DSC04098.JPG_2.jpg,1722,480,640,42,173,215,81,122,False,18
G,55,kaist_dataset/Mixed/Digital_Camera/(C.S)C-outdoor5/DSC04111.JPG,char_data/G/DSC04111.JPG_2.jpg,2310,480,640,42,402,444,116,171,False,18
G,35,kaist_dataset/Mixed/Digital_Camera/(C.S)C-outdoor5/DSC04129.JPG,char_data/G/DSC04129.JPG_4.jpg,1225,480,640,35,53,88,416,451,False,18
G,49,kaist_dataset/Mixed/Digital_Camera/(C.S)C-outdoor5/DSC04129.JPG,char_data/G/DSC04129.JPG_5.jpg,1862,480,640,38,185,223,373,422,False,18
G,42,kaist_dataset/Mixed/Digital_Camera/(C.S)C-outdoor5/DSC04139.JPG,char_data/G/DSC04139.JPG_2.jpg,1260,480,640,30,334,364,92,134,False,18
G,100,kaist_dataset/Mixed/Digital_Camera/(C.S)C-outdoor5/DSC04151.JPG,char_data/G/DSC04151.JPG_2.jpg,9100,480,640,91,169,260,238,338,False,18
G,47,kaist_dataset/Mixed/Digital_Camera/(C.S)C-outdoor5/DSC04305.JPG,char_data/G/DSC04305.JPG_2.jpg,1504,480,640,32,440,472,80,127,False,18
G,32,kaist_dataset/Mixed/Digital_Camera/(C.S)C-outdoor5/DSC04360.JPG,char_data/G/DSC04360.JPG_2.jpg,448,480,640,14,93,107,346,378,False,18
G,56,kaist_dataset/Mixed/Digital_Camera/(C.S)C-outdoor6/080116-0057.jpg,char_data/G/080116-0057.jpg_2.jpg,2856,1200,1600,51,193,244,910,966,False,18
G,31,kaist_dataset/Mixed/Digital_Camera/(C.S)C-outdoor6/P1010088.JPG,char_data/G/P1010088.JPG_2.jpg,775,480,640,25,326,351,178,209,False,18
G,30,kaist_dataset/Mixed/Digital_Camera/(C.S)C-outdoor6/P1010090.JPG,char_data/G/P1010090.JPG_2.jpg,720,480,640,24,265,289,198,228,False,18
G,37,kaist_dataset/Mixed/Digital_Camera/(C.S)C-outdoor6/크기변환_P1010029.JPG,char_data/G/크기변환_P1010029.JPG_2.jpg,740,480,640,20,80,100,10,47,False,18
G,59,kaist_dataset/Mixed/Digital_Camera/(C.S)D-indoor1/131.JPG,char_data/G/131.JPG_2.jpg,2891,480,640,49,254,303,212,271,False,18
G,54,kaist_dataset/Mixed/Digital_Camera/(C.S)D-indoor1/DSC03132.JPG,char_data/G/DSC03132.JPG_2.jpg,1890,480,640,35,106,141,235,289,False,18
G,39,kaist_dataset/Mixed/Digital_Camera/(C.S)D-indoor1/DSC03904.JPG,char_data/G/DSC03904.JPG_2.jpg,858,480,640,22,249,271,210,249,False,18
G,71,kaist_dataset/Mixed/Digital_Camera/(C.S)D-indoor1/DSC03913.JPG,char_data/G/DSC03913.JPG_2.jpg,3550,480,640,50,230,280,93,164,False,18
G,88,kaist_dataset/Mixed/Digital_Camera/(C.S)D-indoor2/DSC04443.JPG,char_data/G/DSC04443.JPG_2.jpg,5368,480,640,61,110,171,45,133,False,18
G,126,kaist_dataset/Mixed/Digital_Camera/(C.S)E-night/DSC02586.JPG,char_data/G/DSC02586.JPG_2.jpg,15498,480,640,123,65,188,249,375,False,18
G,67,kaist_dataset/Mixed/Digital_Camera/(C.S)E-night/DSC02672.JPG,char_data/G/DSC02672.JPG_2.jpg,3283,480,640,49,287,336,89,156,False,18
G,37,kaist_dataset/Mixed/Digital_Camera/(C.S)F-others/097.jpg,char_data/G/097.jpg_2.jpg,481,480,640,13,213,226,161,198,False,18
G,57,kaist_dataset/Mixed/Mobile_Phone/(C.M)B-indoor/P090831012.jpg,char_data/G/P090831012.jpg_2.jpg,3192,480,640,56,159,215,170,227,False,18
G,43,kaist_dataset/Mixed/Mobile_Phone/(C.M)B-indoor/P090831021.jpg,char_data/G/P090831021.jpg_2.jpg,1548,480,640,36,260,296,376,419,False,18
G,41,kaist_dataset/Mixed/Mobile_Phone/(C.M)C-bookCover/P090831062.jpg,char_data/G/P090831062.jpg_2.jpg,1271,480,640,31,6,37,305,346,False,18
G,111,kaist_dataset/Mixed/Mobile_Phone/(C.M)C-bookCover/P090831136.jpg,char_data/G/P090831136.jpg_2.jpg,10212,480,640,92,138,230,114,225,False,18
G,53,kaist_dataset/Mixed/Mobile_Phone/(C.M)C-bookCover/P090903092.jpg,char_data/G/P090903092.jpg_2.jpg,2067,480,640,39,448,487,202,255,False,18
소,31,kaist_dataset/English/Digital_Camera/(E.S)B-light/080116-0059.jpg,char_data/소/080116-0059.jpg_2.jpg,527,1200,1600,17,1111,1128,1017,1048,True,67
소,38,kaist_dataset/English/Digital_Camera/(E.S)C-outdoor1/034.JPG,char_data/소/034.JPG_2.jpg,608,480,640,16,133,149,108,146,True,67
소,96,kaist_dataset/Korean/Digital_Camera/A-shadow/DSC03793.JPG,char_data/소/DSC03793.JPG_2.jpg,7488,480,640,78,164,242,34,130,True,67
소,46,kaist_dataset/Korean/Digital_Camera/A-shadow/DSC04315.JPG,char_data/소/DSC04315.JPG_2.jpg,1564,480,640,34,566,600,418,464,True,67
소,43,kaist_dataset/Korean/Digital_Camera/E-night/074.jpg,char_data/소/074.jpg_2.jpg,1075,363,490,25,261,286,265,308,True,67
소,67,kaist_dataset/Korean/Digital_Camera/E-night/DSC02648.JPG,char_data/소/DSC02648.JPG_2.jpg,4958,480,640,74,256,330,120,187,True,67
소,33,kaist_dataset/Korean/Digital_Camera/E-night/DSC03850.JPG,char_data/소/DSC03850.JPG_2.jpg,825,480,640,25,286,311,391,424,True,67
소,48,kaist_dataset/Korean/Digital_Camera/F-bookCover/DSC03931.JPG,char_data/소/DSC03931.JPG_2.jpg,1056,480,640,22,201,223,82,130,True,67
소,217,kaist_dataset/Korean/Digital_Camera/G-others/2007-12-08-day-012.jpg,char_data/소/2007-12-08-day-012.jpg_2.jpg,42966,1600,1200,198,504,702,1359,1576,True,67
소,35,kaist_dataset/Korean/Digital_Camera/indoor1/057.jpg,char_data/소/057.jpg_2.jpg,1120,322,425,32,335,367,240,275,True,67
소,46,kaist_dataset/Korean/Digital_Camera/indoor1/080118-0017.jpg,char_data/소/080118-0017.jpg_2.jpg,1886,1200,1600,41,1269,1310,491,537,True,67
소,76,kaist_dataset/Korean/Digital_Camera/indoor1/080119-0018.jpg,char_data/소/080119-0018.jpg_2.jpg,5928,1200,1600,78,579,657,422,498,True,67
소,90,kaist_dataset/Korean/Digital_Camera/indoor1/DSC02766.JPG,char_data/소/DSC02766.JPG_2.jpg,9090,480,640,101,163,264,149,239,True,67
소,117,kaist_dataset/Korean/Digital_Camera/indoor1/DSC02767.JPG,char_data/소/DSC02767.JPG_4.jpg,15444,480,640,132,1,132,197,314,True,67
소,40,kaist_dataset/Korean/Digital_Camera/indoor1/DSC02767.JPG,char_data/소/DSC02767.JPG_5.jpg,1120,480,640,28,419,447,126,166,True,67
소,99,kaist_dataset/Korean/Digital_Camera/indoor1/DSC02774.JPG,char_data/소/DSC02774.JPG_2.jpg,8910,480,640,90,131,221,282,381,True,67
소,60,kaist_dataset/Korean/Digital_Camera/indoor1/DSC03358.JPG,char_data/소/DSC03358.JPG_2.jpg,3420,480,640,57,329,386,101,161,True,67
소,79,kaist_dataset/Korean/Digital_Camera/indoor1/DSC03370.JPG,char_data/소/DSC03370.JPG_2.jpg,3476,480,640,44,562,606,114,193,True,67
소,47,kaist_dataset/Korean/Digital_Camera/indoor1/DSC03375.JPG,char_data/소/DSC03375.JPG_2.jpg,2256,480,640,48,46,94,33,80,True,67
소,77,kaist_dataset/Korean/Digital_Camera/indoor2/DSC03382.JPG,char_data/소/DSC03382.JPG_2.jpg,4851,480,640,63,289,352,277,354,True,67
소,53,kaist_dataset/Korean/Digital_Camera/indoor2/DSC03468.JPG,char_data/소/DSC03468.JPG_2.jpg,2438,480,640,46,361,407,127,180,True,67
소,34,kaist_dataset/Korean/Digital_Camera/outdoor1/037.jpg,char_data/소/037.jpg_2.jpg,1530,244,360,45,127,172,180,214,True,67
소,54,kaist_dataset/Korean/Digital_Camera/outdoor1/051.JPG,char_data/소/051.JPG_2.jpg,3510,480,640,65,521,586,201,255,True,67
소,23,kaist_dataset/Korean/Digital_Camera/outdoor1/109.JPG,char_data/소/109.JPG_2.jpg,345,480,640,15,297,312,35,58,True,67
소,28,kaist_dataset/Korean/Digital_Camera/outdoor1/123.JPG,char_data/소/123.JPG_2.jpg,560,480,640,20,576,596,275,303,True,67
소,47,kaist_dataset/Korean/Digital_Camera/outdoor1/2007-12-08-day-056.jpg,char_data/소/2007-12-08-day-056.jpg_2.jpg,2162,1200,1600,46,715,761,402,449,True,67
소,46,kaist_dataset/Korean/Digital_Camera/outdoor1/306.jpg,char_data/소/306.jpg_2.jpg,1288,190,330,28,154,182,76,122,True,67
소,108,kaist_dataset/Korean/Digital_Camera/outdoor2/2007-12-08-day-094.jpg,char_data/소/2007-12-08-day-094.jpg_2.jpg,9720,1600,1200,90,781,871,337,445,True,67
소,151,kaist_dataset/Korean/Digital_Camera/outdoor2/DSC02366.JPG,char_data/소/DSC02366.JPG_2.jpg,28841,480,640,191,253,444,226,377,True,67
소,30,kaist_dataset/Korean/Digital_Camera/outdoor2/DSC02380.JPG,char_data/소/DSC02380.JPG_2.jpg,510,480,640,17,232,249,245,275,True,67
소,40,kaist_dataset/Korean/Digital_Camera/outdoor2/DSC02383.JPG,char_data/소/DSC02383.JPG_2.jpg,1080,480,640,27,550,577,277,317,True,67
소,43,kaist_dataset/Korean/Digital_Camera/outdoor2/DSC02412.JPG,char_data/소/DSC02412.JPG_2.jpg,2838,480,640,66,565,631,357,400,True,67
소,34,kaist_dataset/Korean/Digital_Camera/outdoor2/DSC02485.JPG,char_data/소/DSC02485.JPG_2.jpg,1156,480,640,34,568,602,277,311,True,67
소,113,kaist_dataset/Korean/Digital_Camera/outdoor2/DSC02507.JPG,char_data/소/DSC02507.JPG_2.jpg,11300,480,640,100,42,142,95,208,True,67
소,108,kaist_dataset/Korean/Digital_Camera/outdoor3/DSC02536.JPG,char_data/소/DSC02536.JPG_2.jpg,9288,480,640,86,25,111,179,287,True,67
소,27,kaist_dataset/Korean/Digital_Camera/outdoor3/DSC02900.JPG,char_data/소/DSC02900.JPG_2.jpg,837,480,640,31,577,608,195,222,True,67
소,52,kaist_dataset/Korean/Digital_Camera/outdoor3/DSC03064.JPG,char_data/소/DSC03064.JPG_2.jpg,4420,480,640,85,191,276,287,339,True,67
소,68,kaist_dataset/Korean/Digital_Camera/outdoor4/DSC03253.JPG,char_data/소/DSC03253.JPG_2.jpg,5508,480,640,81,472,553,306,374,True,67
소,89,kaist_dataset/Korean/Digital_Camera/outdoor4/DSC03293.JPG,char_data/소/DSC03293.JPG_2.jpg,7654,480,640,86,161,247,173,262,True,67
소,57,kaist_dataset/Korean/Digital_Camera/outdoor4/DSC03327.JPG,char_data/소/DSC03327.JPG_2.jpg,3591,480,640,63,530,593,289,346,True,67
소,62,kaist_dataset/Korean/Digital_Camera/outdoor4/DSC03443.JPG,char_data/소/DSC03443.JPG_2.jpg,2852,480,640,46,555,601,331,393,True,67
소,90,kaist_dataset/Korean/Digital_Camera/outdoor4/DSC03450.JPG,char_data/소/DSC03450.JPG_2.jpg,5490,480,640,61,187,248,227,317,True,67
소,32,kaist_dataset/Korean/Digital_Camera/outdoor4/DSC03547.JPG,char_data/소/DSC03547.JPG_2.jpg,1344,480,640,42,254,296,172,204,True,67
소,28,kaist_dataset/Korean/Digital_Camera/outdoor4/DSC03550.JPG,char_data/소/DSC03550.JPG_2.jpg,896,480,640,32,585,617,236,264,True,67
소,40,kaist_dataset/Korean/Digital_Camera/outdoor4/DSC03553.JPG,char_data/소/DSC03553.JPG_2.jpg,1400,480,640,35,566,601,129,169,True,67
소,62,kaist_dataset/Korean/Digital_Camera/outdoor4/DSC03567.JPG,char_data/소/DSC03567.JPG_2.jpg,4030,480,640,65,141,206,160,222,True,67
소,50,kaist_dataset/Korean/Digital_Camera/outdoor4/DSC03605.JPG,char_data/소/DSC03605.JPG_2.jpg,2650,480,640,53,285,338,233,283,True,67
소,61,kaist_dataset/Korean/Digital_Camera/outdoor4/DSC03607.JPG,char_data/소/DSC03607.JPG_2.jpg,4270,480,640,70,363,433,272,333,True,67
소,57,kaist_dataset/Korean/Digital_Camera/outdoor4/DSC03615.JPG,char_data/소/DSC03615.JPG_4.jpg,2850,480,640,50,257,307,134,191,True,67
소,53,kaist_dataset/Korean/Digital_Camera/outdoor4/DSC03615.JPG,char_data/소/DSC03615.JPG_5.jpg,2756,480,640,52,415,467,122,175,True,67
소,58,kaist_dataset/Korean/Digital_Camera/outdoor5/DSC03626.JPG,char_data/소/DSC03626.JPG_2.jpg,3654,480,640,63,570,633,205,263,True,67
소,107,kaist_dataset/Korean/Digital_Camera/outdoor5/DSC03629.JPG,char_data/소/DSC03629.JPG_2.jpg,6099,480,640,57,306,363,55,162,True,67
소,67,kaist_dataset/Korean/Digital_Camera/outdoor5/DSC03653.JPG,char_data/소/DSC03653.JPG_2.jpg,2948,480,640,44,282,326,71,138,True,67
소,34,kaist_dataset/Korean/Digital_Camera/outdoor5/DSC03671.JPG,char_data/소/DSC03671.JPG_2.jpg,918,480,640,27,478,505,268,302,True,67
소,60,kaist_dataset/Korean/Digital_Camera/outdoor5/DSC03715.JPG,char_data/소/DSC03715.JPG_2.jpg,2640,480,640,44,548,592,174,234,True,67
소,46,kaist_dataset/Korean/Digital_Camera/outdoor5/DSC03838.JPG,char_data/소/DSC03838.JPG_2.jpg,1334,480,640,29,255,284,136,182,True,67
소,48,kaist_dataset/Korean/Digital_Camera/outdoor6/DSC04043.JPG,char_data/소/DSC04043.JPG_2.jpg,1056,480,640,22,473,495,222,270,True,67
소,75,kaist_dataset/Korean/Digital_Camera/outdoor6/DSC04049.JPG,char_data/소/DSC04049.JPG_2.jpg,4950,480,640,66,217,283,113,188,True,67
소,91,kaist_dataset/Korean/Digital_Camera/outdoor6/DSC04088.JPG,char_data/소/DSC04088.JPG_2.jpg,7007,480,640,77,227,304,207,298,True,67
소,80,kaist_dataset/Korean/Digital_Camera/outdoor6/DSC04095.JPG,char_data/소/DSC04095.JPG_2.jpg,5840,480,640,73,182,255,210,290,True,67
소,77,kaist_dataset/Korean/Digital_Camera/outdoor6/DSC04114.JPG,char_data/소/DSC04114.JPG_2.jpg,4543,480,640,59,131,190,339,416,True,67
소,69,kaist_dataset/Korean/Digital_Camera/outdoor6/DSC04332.JPG,char_data/소/DSC04332.JPG_2.jpg,3726,480,640,54,439,493,161,230,True,67
소,76,kaist_dataset/Korean/Digital_Camera/outdoor7/DSC04481.JPG,char_data/소/DSC04481.JPG_4.jpg,3800,480,640,50,14,64,227,303,True,67
소,64,kaist_dataset/Korean/Digital_Camera/outdoor7/DSC04481.JPG,char_data/소/DSC04481.JPG_5.jpg,2880,480,640,45,389,434,229,293,True,67
소,95,kaist_dataset/Korean/Digital_Camera/outdoor7/P1010039.JPG,char_data/소/P1010039.JPG_4.jpg,5985,480,640,63,219,282,109,204,True,67
소,97,kaist_dataset/Korean/Digital_Camera/outdoor7/P1010039.JPG,char_data/소/P1010039.JPG_5.jpg,5626,480,640,58,420,478,105,202,True,67
소,61,kaist_dataset/Korean/Digital_Camera/outdoor7/P1010075.JPG,char_data/소/P1010075.JPG_4.jpg,3416,480,640,56,551,607,255,316,True,67
소,48,kaist_dataset/Korean/Digital_Camera/outdoor7/P1010075.JPG,char_data/소/P1010075.JPG_5.jpg,3360,480,640,70,518,588,188,236,True,67
소,90,kaist_dataset/Korean/Digital_Camera/outdoor7/P1010076.JPG,char_data/소/P1010076.JPG_2.jpg,10170,480,640,113,501,614,193,283,True,67
소,30,kaist_dataset/Korean/Digital_Camera/outdoor7/P1010100.JPG,char_data/소/P1010100.JPG_2.jpg,1440,480,640,48,547,595,173,203,True,67
소,19,kaist_dataset/Korean/Digital_Camera/outdoor7/P1010111.JPG,char_data/소/P1010111.JPG_2.jpg,456,480,640,24,321,345,255,274,True,67
소,207,kaist_dataset/Korean/Digital_Camera/outdoor8/2007-12-08-day-132.jpg,char_data/소/2007-12-08-day-132.jpg_2.jpg,21114,1200,1600,102,552,654,532,739,True,67
소,67,kaist_dataset/Korean/Digital_Camera/outdoor8/DSC02896.JPG,char_data/소/DSC02896.JPG_2.jpg,5159,480,640,77,478,555,170,237,True,67
소,41,kaist_dataset/Korean/Digital_Camera/outdoor8/P1010147.JPG,char_data/소/P1010147.JPG_2.jpg,1312,480,640,32,532,564,258,299,True,67
소,35,kaist_dataset/Korean/Digital_Camera/outdoor8/P1010160.JPG,char_data/소/P1010160.JPG_2.jpg,1225,480,640,35,538,573,142,177,True,67
소,55,"kaist_dataset/Korean/Mobile_Phone/(M,K)E-bookCover/P090831132.jpg",char_data/소/P090831132.jpg_2.jpg,2035,480,640,37,88,125,146,201,True,67
소,127,"kaist_dataset/Korean/Mobile_Phone/(M,K)E-bookCover/P090903060.jpg",char_data/소/P090903060.jpg_2.jpg,20066,480,640,158,260,418,202,329,True,67
소,36,"kaist_dataset/Korean/Mobile_Phone/(M,K)E-bookCover/P090903087.jpg",char_data/소/P090903087.jpg_2.jpg,1080,480,640,30,488,518,132,168,True,67
소,62,"kaist_dataset/Korean/Mobile_Phone/(M,K)E-bookCover/P090903093.jpg",char_data/소/P090903093.jpg_2.jpg,2294,480,640,37,520,557,321,383,True,67
소,118,"kaist_dataset/Korean/Mobile_Phone/(M,K)E-bookCover/P090905008.jpg",char_data/소/P090905008.jpg_2.jpg,14160,480,640,120,260,380,135,253,True,67
소,85,"kaist_dataset/Korean/Mobile_Phone/(M,K)E-bookCover/P090907004.jpg",char_data/소/P090907004.jpg_2.jpg,5440,480,640,64,426,490,65,150,True,67
소,35,"kaist_dataset/Korean/Mobile_Phone/(M,K)E-bookCover/P090911024.jpg",char_data/소/P090911024.jpg_2.jpg,1120,480,640,32,318,350,46,81,True,67
소,51,kaist_dataset/Mixed/Digital_Camera/(C.S)A-shadow/DSC04304.JPG,char_data/소/DSC04304.JPG_2.jpg,1734,480,640,34,570,604,202,253,True,67
소,65,kaist_dataset/Mixed/Digital_Camera/(C.S)C-outdoor1/062.JPG,char_data/소/062.JPG_2.jpg,5070,480,640,78,238,316,214,279,True,67
소,124,kaist_dataset/Mixed/Digital_Camera/(C.S)C-outdoor1/105.jpg,char_data/소/105.jpg_2.jpg,10788,480,640,87,205,292,79,203,True,67
소,44,kaist_dataset/Mixed/Digital_Camera/(C.S)C-outdoor1/2007-12-09-day-exterior-078.jpg,char_data/소/2007-12-09-day-exterior-078.jpg_2.jpg,2376,1200,1600,54,1232,1286,502,546,True,67
소,66,kaist_dataset/Mixed/Digital_Camera/(C.S)C-outdoor1/56.JPG,char_data/소/56.JPG_2.jpg,4026,576,768,61,675,736,207,273,True,67
소,61,kaist_dataset/Mixed/Digital_Camera/(C.S)C-outdoor1/DSC02244.JPG,char_data/소/DSC02244.JPG_2.jpg,3294,480,640,54,497,551,256,317,True,67
소,40,kaist_dataset/Mixed/Digital_Camera/(C.S)C-outdoor1/DSC02319.JPG,char_data/소/DSC02319.JPG_2.jpg,1560,480,640,39,350,389,68,108,True,67
소,44,kaist_dataset/Mixed/Digital_Camera/(C.S)C-outdoor1/DSC02323.JPG,char_data/소/DSC02323.JPG_2.jpg,1980,480,640,45,244,289,228,272,True,67
소,72,kaist_dataset/Mixed/Digital_Camera/(C.S)C-outdoor1/DSC02349.JPG,char_data/소/DSC02349.JPG_2.jpg,3672,480,640,51,588,639,118,190,True,67
소,49,kaist_dataset/Mixed/Digital_Camera/(C.S)C-outdoor2/DSC02389.JPG,char_data/소/DSC02389.JPG_2.jpg,2401,480,640,49,352,401,326,375,True,67
소,45,kaist_dataset/Mixed/Digital_Camera/(C.S)C-outdoor2/DSC02483.JPG,char_data/소/DSC02483.JPG_2.jpg,2025,480,640,45,556,601,290,335,True,67
소,80,kaist_dataset/Mixed/Digital_Camera/(C.S)C-outdoor2/DSC02513.JPG,char_data/소/DSC02513.JPG_2.jpg,5200,480,640,65,407,472,236,316,True,67
소,28,kaist_dataset/Mixed/Digital_Camera/(C.S)C-outdoor2/DSC02933.JPG,char_data/소/DSC02933.JPG_2.jpg,644,480,640,23,315,338,241,269,True,67
소,99,kaist_dataset/Mixed/Digital_Camera/(C.S)C-outdoor2/DSC02938.JPG,char_data/소/DSC02938.JPG_2.jpg,8712,480,640,88,334,422,123,222,True,67
소,60,kaist_dataset/Mixed/Digital_Camera/(C.S)C-outdoor3/DSC03303.JPG,char_data/소/DSC03303.JPG_4.jpg,2880,480,640,48,553,601,122,182,False,67
소,66,kaist_dataset/Mixed/Digital_Camera/(C.S)C-outdoor3/DSC03303.JPG,char_data/소/DSC03303.JPG_5.jpg,6072,480,640,92,540,632,211,277,False,67
소,50,kaist_dataset/Mixed/Digital_Camera/(C.S)C-outdoor3/DSC03315.JPG,char_data/소/DSC03315.JPG_2.jpg,3100,480,640,62,550,612,65,115,False,67
소,59,kaist_dataset/Mixed/Digital_Camera/(C.S)C-outdoor3/DSC03316.JPG,char_data/소/DSC03316.JPG_2.jpg,5133,480,640,87,511,598,7,66,False,67
소,41,kaist_dataset/Mixed/Digital_Camera/(C.S)C-outdoor4/DSC03435.JPG,char_data/소/DSC03435.JPG_2.jpg,1968,480,640,48,541,589,235,276,False,67
소,73,kaist_dataset/Mixed/Digital_Camera/(C.S)C-outdoor4/DSC03446.JPG,char_data/소/DSC03446.JPG_2.jpg,3577,480,640,49,579,628,217,290,False,67
소,34,kaist_dataset/Mixed/Digital_Camera/(C.S)C-outdoor4/DSC03556.JPG,char_data/소/DSC03556.JPG_2.jpg,782,480,640,23,164,187,214,248,False,67
소,70,kaist_dataset/Mixed/Digital_Camera/(C.S)C-outdoor4/DSC03618.JPG,char_data/소/DSC03618.JPG_2.jpg,5320,480,640,76,526,602,338,408,False,67
소,65,kaist_dataset/Mixed/Digital_Camera/(C.S)C-outdoor4/DSC03673.JPG,char_data/소/DSC03673.JPG_2.jpg,4160,480,640,64,89,153,112,177,False,67
소,76,kaist_dataset/Mixed/Digital_Camera/(C.S)C-outdoor5/DSC03830.JPG,char_data/소/DSC03830.JPG_2.jpg,3496,480,640,46,360,406,25,101,False,67
소,56,kaist_dataset/Mixed/Digital_Camera/(C.S)C-outdoor5/DSC04015.JPG,char_data/소/DSC04015.JPG_2.jpg,2968,480,640,53,512,565,171,227,False,67
소,41,kaist_dataset/Mixed/Digital_Camera/(C.S)C-outdoor5/DSC04108.JPG,char_data/소/DSC04108.JPG_2.jpg,1435,480,640,35,553,588,190,231,False,67
소,51,kaist_dataset/Mixed/Digital_Camera/(C.S)C-outdoor5/DSC04330.JPG,char_data/소/DSC04330.JPG_2.jpg,1887,480,640,37,252,289,374,425,False,67
소,116,kaist_dataset/Mixed/Digital_Camera/(C.S)C-outdoor5/DSC04364.JPG,char_data/소/DSC04364.JPG_2.jpg,14848,480,640,128,193,321,257,373,False,67
소,95,kaist_dataset/Mixed/Digital_Camera/(C.S)C-outdoor6/P1010025.JPG,char_data/소/P1010025.JPG_2.jpg,12350,480,640,130,401,531,175,270,False,67
소,103,kaist_dataset/Mixed/Digital_Camera/(C.S)C-outdoor6/P1010027.JPG,char_data/소/P1010027.JPG_2.jpg,9785,480,640,95,356,451,170,273,False,67
소,65,kaist_dataset/Mixed/Digital_Camera/(C.S)C-outdoor6/P1010080.JPG,char_data/소/P1010080.JPG_2.jpg,3705,480,640,57,110,167,163,228,False,67
소,68,kaist_dataset/Mixed/Digital_Camera/(C.S)D-indoor1/DSC02772.JPG,char_data/소/DSC02772.JPG_2.jpg,4148,480,640,61,481,542,284,352,False,67
소,72,kaist_dataset/Mixed/Digital_Camera/(C.S)D-indoor1/DSC02775.JPG,char_data/소/DSC02775.JPG_2.jpg,7128,480,640,99,333,432,214,286,False,67
소,33,kaist_dataset/Mixed/Digital_Camera/(C.S)E-night/DSC03840.JPG,char_data/소/DSC03840.JPG_2.jpg,1056,480,640,32,215,247,185,218,False,67
소,49,kaist_dataset/Mixed/Digital_Camera/(C.S)E-night/P1010152.JPG,char_data/소/P1010152.JPG_2.jpg,2646,480,640,54,249,303,140,189,False,67
소,43,kaist_dataset/Mixed/Digital_Camera/(C.S)F-others/DSC02893.JPG,char_data/소/DSC02893.JPG_2.jpg,2150,480,640,50,553,603,239,282,False,67
소,60,kaist_dataset/Mixed/Mobile_Phone/(C.M)B-indoor/P090831016.jpg,char_data/소/P090831016.jpg_2.jpg,4200,480,640,70,381,451,121,181,False,67
소,78,kaist_dataset/Mixed/Mobile_Phone/(C.M)B-indoor/P090831021.jpg,char_data/소/P090831021.jpg_2.jpg,7488,480,640,96,133,229,128,206,False,67
트,32,kaist_dataset/English/Digital_Camera/(E.S)B-light/080116-0059.jpg,char_data/트/080116-0059.jpg_6.jpg,672,1200,1600,21,799,820,946,978,True,83
트,30,kaist_dataset/English/Digital_Camera/(E.S)B-light/080116-0059.jpg,char_data/트/080116-0059.jpg_7.jpg,630,1200,1600,21,590,611,997,1027,True,83
트,30,kaist_dataset/English/Digital_Camera/(E.S)B-light/080116-0059.jpg,char_data/트/080116-0059.jpg_8.jpg,600,1200,1600,20,783,803,991,1021,True,83
트,63,kaist_dataset/Korean/Digital_Camera/A-shadow/DSC03463.JPG,char_data/트/DSC03463.JPG_2.jpg,4347,480,640,69,221,290,355,418,True,83
트,75,kaist_dataset/Korean/Digital_Camera/A-shadow/DSC04105.JPG,char_data/트/DSC04105.JPG_2.jpg,6675,480,640,89,361,450,194,269,True,83
트,94,kaist_dataset/Korean/Digital_Camera/E-night/DSC02649.JPG,char_data/트/DSC02649.JPG_2.jpg,7332,480,640,78,388,466,302,396,True,83
트,81,kaist_dataset/Korean/Digital_Camera/indoor1/DSC02700.JPG,char_data/트/DSC02700.JPG_2.jpg,5832,480,640,72,466,538,81,162,True,83
트,65,kaist_dataset/Korean/Digital_Camera/indoor1/DSC02716.JPG,char_data/트/DSC02716.JPG_2.jpg,3445,480,640,53,277,330,142,207,True,83
트,92,kaist_dataset/Korean/Digital_Camera/indoor1/DSC02734.JPG,char_data/트/DSC02734.JPG_2.jpg,7820,480,640,85,307,392,242,334,True,83
트,111,kaist_dataset/Korean/Digital_Camera/indoor1/DSC02741.JPG,char_data/트/DSC02741.JPG_2.jpg,10323,480,640,93,541,634,279,390,True,83
트,95,kaist_dataset/Korean/Digital_Camera/indoor1/DSC02757.JPG,char_data/트/DSC02757.JPG_2.jpg,8835,480,640,93,458,551,205,300,True,83
트,79,kaist_dataset/Korean/Digital_Camera/indoor1/DSC02760.JPG,char_data/트/DSC02760.JPG_2.jpg,7426,480,640,94,459,553,202,281,True,83
트,115,kaist_dataset/Korean/Digital_Camera/indoor1/DSC02774.JPG,char_data/트/DSC02774.JPG_2.jpg,12190,480,640,106,535,639,274,389,True,83
트,88,kaist_dataset/Korean/Digital_Camera/indoor1/DSC03359.JPG,char_data/트/DSC03359.JPG_2.jpg,6248,480,640,71,231,302,256,344,True,83
트,54,kaist_dataset/Korean/Digital_Camera/indoor1/DSC03360.JPG,char_data/트/DSC03360.JPG_2.jpg,3510,480,640,65,239,304,306,360,True,83
트,77,kaist_dataset/Korean/Digital_Camera/indoor1/DSC03361.JPG,char_data/트/DSC03361.JPG_2.jpg,5698,480,640,74,235,309,170,247,True,83
트,89,kaist_dataset/Korean/Digital_Camera/indoor1/DSC03363.JPG,char_data/트/DSC03363.JPG_2.jpg,8099,480,640,91,484,575,62,151,True,83
트,77,kaist_dataset/Korean/Digital_Camera/indoor1/DSC03370.JPG,char_data/트/DSC03370.JPG_4.jpg,2849,480,640,37,239,276,111,188,True,83
트,74,kaist_dataset/Korean/Digital_Camera/indoor1/DSC03370.JPG,char_data/트/DSC03370.JPG_5.jpg,3034,480,640,41,399,440,116,190,True,83
트,103,kaist_dataset/Korean/Digital_Camera/indoor1/DSC03374.JPG,char_data/트/DSC03374.JPG_2.jpg,7828,480,640,76,410,486,116,219,True,83
트,103,kaist_dataset/Korean/Digital_Camera/indoor2/DSC03387.JPG,char_data/트/DSC03387.JPG_2.jpg,8240,480,640,80,337,417,213,316,True,83
트,62,kaist_dataset/Korean/Digital_Camera/indoor2/DSC03394.JPG,char_data/트/DSC03394.JPG_2.jpg,3534,480,640,57,378,435,384,446,True,83
트,46,kaist_dataset/Korean/Digital_Camera/indoor2/DSC03468.JPG,char_data/트/DSC03468.JPG_2.jpg,2300,480,640,50,357,407,67,113,True,83
트,50,kaist_dataset/Korean/Digital_Camera/indoor2/DSC03474.JPG,char_data/트/DSC03474.JPG_2.jpg,2400,480,640,48,292,340,209,259,True,83
트,123,kaist_dataset/Korean/Digital_Camera/indoor2/DSC03703.JPG,char_data/트/DSC03703.JPG_2.jpg,12546,480,640,102,415,517,218,341,True,83
트,54,kaist_dataset/Korean/Digital_Camera/indoor2/DSC03974.JPG,char_data/트/DSC03974.JPG_2.jpg,2970,480,640,55,280,335,205,259,True,83
트,72,kaist_dataset/Korean/Digital_Camera/indoor2/DSC04012.JPG,char_data/트/DSC04012.JPG_2.jpg,8496,480,640,118,434,552,108,180,True,83
트,57,kaist_dataset/Korean/Digital_Camera/indoor2/DSC04020.JPG,char_data/트/DSC04020.JPG_2.jpg,2736,480,640,48,411,459,189,246,True,83
트,57,kaist_dataset/Korean/Digital_Camera/indoor2/DSC04021.JPG,char_data/트/DSC04021.JPG_2.jpg,3420,480,640,60,424,484,119,176,True,83
트,78,kaist_dataset/Korean/Digital_Camera/outdoor1/016.JPG,char_data/트/016.JPG_2.jpg,7878,480,640,101,510,611,179,257,True,83
트,68,kaist_dataset/Korean/Digital_Camera/outdoor1/024.JPG,char_data/트/024.JPG_2.jpg,7140,480,640,105,512,617,187,255,True,83
트,90,kaist_dataset/Korean/Digital_Camera/outdoor1/029.JPG,char_data/트/029.JPG_2.jpg,5490,480,640,61,390,451,201,291,True,83
트,58,kaist_dataset/Korean/Digital_Camera/outdoor1/045.JPG,char_data/트/045.JPG_2.jpg,3944,480,640,68,541,609,188,246,True,83
트,153,kaist_dataset/Korean/Digital_Camera/outdoor2/080118-0018.jpg,char_data/트/080118-0018.jpg_2.jpg,26469,1200,1600,173,265,438,470,623,True,83
트,48,kaist_dataset/Korean/Digital_Camera/outdoor2/2007-12-08-day-109.jpg,char_data/트/2007-12-08-day-109.jpg_2.jpg,768,1200,1600,16,710,726,1144,1192,True,83
트,124,kaist_dataset/Korean/Digital_Camera/outdoor2/DSC02313.JPG,char_data/트/DSC02313.JPG_2.jpg,15748,480,640,127,489,616,111,235,True,83
트,68,kaist_dataset/Korean/Digital_Camera/outdoor2/DSC02386.JPG,char_data/트/DSC02386.JPG_2.jpg,3876,480,640,57,120,177,173,241,True,83
트,53,kaist_dataset/Korean/Digital_Camera/outdoor2/DSC02420.JPG,char_data/트/DSC02420.JPG_2.jpg,2438,480,640,46,11,57,286,339,True,83
트,58,kaist_dataset/Korean/Digital_Camera/outdoor2/DSC02441.JPG,char_data/트/DSC02441.JPG_2.jpg,2958,480,640,51,159,210,109,167,True,83
트,65,kaist_dataset/Korean/Digital_Camera/outdoor2/DSC02476.JPG,char_data/트/DSC02476.JPG_2.jpg,5135,480,640,79,459,538,203,268,True,83
트,66,kaist_dataset/Korean/Digital_Camera/outdoor3/DSC02686.JPG,char_data/트/DSC02686.JPG_2.jpg,4224,480,640,64,232,296,117,183,True,83
트,100,kaist_dataset/Korean/Digital_Camera/outdoor3/DSC02698.JPG,char_data/트/DSC02698.JPG_2.jpg,9900,480,640,99,380,479,54,154,True,83
트,62,kaist_dataset/Korean/Digital_Camera/outdoor3/DSC02943.JPG,char_data/트/DSC02943.JPG_2.jpg,3286,480,640,53,392,445,373,435,True,83
트,116,kaist_dataset/Korean/Digital_Camera/outdoor3/DSC02953.JPG,char_data/트/DSC02953.JPG_2.jpg,15080,480,640,130,434,564,156,272,True,83
트,85,kaist_dataset/Korean/Digital_Camera/outdoor4/DSC03280.JPG,char_data/트/DSC03280.JPG_2.jpg,9180,480,640,108,480,588,195,280,True,83
트,137,kaist_dataset/Korean/Digital_Camera/outdoor4/DSC03286.JPG,char_data/트/DSC03286.JPG_2.jpg,22742,480,640,166,446,612,217,354,True,83
트,102,kaist_dataset/Korean/Digital_Camera/outdoor4/DSC03296.JPG,char_data/트/DSC03296.JPG_2.jpg,9996,480,640,98,235,333,215,317,True,83
트,43,kaist_dataset/Korean/Digital_Camera/outdoor4/DSC03443.JPG,char_data/트/DSC03443.JPG_2.jpg,1204,480,640,28,330,358,260,303,True,83
트,83,kaist_dataset/Korean/Digital_Camera/outdoor4/DSC03448.JPG,char_data/트/DSC03448.JPG_2.jpg,8466,480,640,102,256,358,329,412,True,83
트,78,kaist_dataset/Korean/Digital_Camera/outdoor4/DSC03461.JPG,char_data/트/DSC03461.JPG_2.jpg,4680,480,640,60,442,502,77,155,True,83
트,85,kaist_dataset/Korean/Digital_Camera/outdoor4/DSC03545.JPG,char_data/트/DSC03545.JPG_2.jpg,9605,480,640,113,455,568,363,448,True,83
트,148,kaist_dataset/Korean/Digital_Camera/outdoor4/DSC03574.JPG,char_data/트/DSC03574.JPG_2.jpg,13764,480,640,93,458,551,176,324,True,83
트,69,kaist_dataset/Korean/Digital_Camera/outdoor4/DSC03584.JPG,char_data/트/DSC03584.JPG_2.jpg,3795,480,640,55,258,313,171,240,True,83
트,69,kaist_dataset/Korean/Digital_Camera/outdoor4/DSC03602.JPG,char_data/트/DSC03602.JPG_2.jpg,5589,480,640,81,360,441,165,234,True,83
트,63,kaist_dataset/Korean/Digital_Camera/outdoor4/DSC03603.JPG,char_data/트/DSC03603.JPG_2.jpg,5040,480,640,80,450,530,152,215,True,83
트,69,kaist_dataset/Korean/Digital_Camera/outdoor5/DSC03688.JPG,char_data/트/DSC03688.JPG_2.jpg,7452,480,640,108,186,294,142,211,True,83
트,59,kaist_dataset/Korean/Digital_Camera/outdoor5/DSC03777.JPG,char_data/트/DSC03777.JPG_2.jpg,3304,480,640,56,540,596,292,351,True,83
트,121,kaist_dataset/Korean/Digital_Camera/outdoor6/DSC04043.JPG,char_data/트/DSC04043.JPG_4.jpg,11132,480,640,92,533,625,90,211,True,83
트,42,kaist_dataset/Korean/Digital_Camera/outdoor6/DSC04043.JPG,char_data/트/DSC04043.JPG_5.jpg,882,480,640,21,167,188,220,262,True,83
트,93,kaist_dataset/Korean/Digital_Camera/outdoor6/DSC04053.JPG,char_data/트/DSC04053.JPG_2.jpg,12555,480,640,135,499,634,223,316,True,83
트,97,kaist_dataset/Korean/Digital_Camera/outdoor6/DSC04085.JPG,char_data/트/DSC04085.JPG_2.jpg,9797,480,640,101,428,529,130,227,True,83
트,97,kaist_dataset/Korean/Digital_Camera/outdoor6/DSC04088.JPG,char_data/트/DSC04088.JPG_2.jpg,7857,480,640,81,540,621,198,295,True,83
트,81,kaist_dataset/Korean/Digital_Camera/outdoor6/DSC04141.JPG,char_data/트/DSC04141.JPG_2.jpg,6804,480,640,84,263,347,255,336,True,83
트,133,kaist_dataset/Korean/Digital_Camera/outdoor6/DSC04143.JPG,char_data/트/DSC04143.JPG_2.jpg,17024,480,640,128,465,593,236,369,True,83
트,98,kaist_dataset/Korean/Digital_Camera/outdoor6/DSC04350.JPG,char_data/트/DSC04350.JPG_2.jpg,4900,480,640,50,508,558,320,418,True,83
트,60,kaist_dataset/Korean/Digital_Camera/outdoor6/DSC04435.JPG,char_data/트/DSC04435.JPG_2.jpg,3180,480,640,53,328,381,379,439,True,83
트,135,kaist_dataset/Korean/Digital_Camera/outdoor7/P1010012.JPG,char_data/트/P1010012.JPG_2.jpg,16740,480,640,124,465,589,48,183,True,83
트,42,kaist_dataset/Korean/Digital_Camera/outdoor8/P090912069.jpg,char_data/트/P090912069.jpg_2.jpg,1428,480,640,34,78,112,223,265,True,83
트,101,"kaist_dataset/Korean/Mobile_Phone/(M,K)B-light/P090911072.jpg",char_data/트/P090911072.jpg_2.jpg,7676,480,640,76,388,464,215,316,True,83
트,86,"kaist_dataset/Korean/Mobile_Phone/(M,K)C-outdoor/P090912042.jpg",char_data/트/P090912042.jpg_2.jpg,5676,480,640,66,510,576,156,242,True,83
트,40,"kaist_dataset/Korean/Mobile_Phone/(M,K)D-indoor/P090911066.jpg",char_data/트/P090911066.jpg_2.jpg,1760,480,640,44,143,187,341,381,True,83
트,39,"kaist_dataset/Korean/Mobile_Phone/(M,K)D-indoor/P090911069.jpg",char_data/트/P090911069.jpg_2.jpg,2379,480,640,61,379,440,115,154,True,83
트,48,"kaist_dataset/Korean/Mobile_Phone/(M,K)E-bookCover/P090831056.jpg",char_data/트/P090831056.jpg_2.jpg,1536,480,640,32,89,121,310,358,True,83
트,83,"kaist_dataset/Korean/Mobile_Phone/(M,K)E-bookCover/P090831149.jpg",char_data/트/P090831149.jpg_2.jpg,7968,480,640,96,232,328,89,172,True,83
트,153,kaist_dataset/Mixed/Digital_Camera/(C.S)A-shadow/DSC04318.JPG,char_data/트/DSC04318.JPG_2.jpg,13617,480,640,89,435,524,207,360,True,83
트,110,kaist_dataset/Mixed/Digital_Camera/(C.S)C-outdoor1/009.JPG,char_data/트/009.JPG_2.jpg,14080,480,640,128,462,590,151,261,True,83
트,128,kaist_dataset/Mixed/Digital_Camera/(C.S)C-outdoor1/080118-0014.jpg,char_data/트/080118-0014.jpg_2.jpg,13568,1200,1600,106,777,883,1020,1148,True,83
트,29,kaist_dataset/Mixed/Digital_Camera/(C.S)C-outdoor1/081.JPG,char_data/트/081.JPG_2.jpg,1073,480,640,37,531,568,103,132,True,83
트,52,kaist_dataset/Mixed/Digital_Camera/(C.S)C-outdoor1/133.JPG,char_data/트/133.JPG_2.jpg,2444,480,640,47,138,185,326,378,True,83
트,252,kaist_dataset/Mixed/Digital_Camera/(C.S)C-outdoor1/2007-12-09-day-exterior-044.jpg,char_data/트/2007-12-09-day-exterior-044.jpg_2.jpg,75096,1200,1600,298,990,1288,454,706,True,83
트,46,kaist_dataset/Mixed/Digital_Camera/(C.S)C-outdoor1/3.JPG,char_data/트/3.JPG_2.jpg,1380,576,768,30,86,116,412,458,True,83
트,72,kaist_dataset/Mixed/Digital_Camera/(C.S)C-outdoor1/DSC02323.JPG,char_data/트/DSC02323.JPG_2.jpg,4392,480,640,61,87,148,132,204,True,83
트,38,kaist_dataset/Mixed/Digital_Camera/(C.S)C-outdoor1/P1010009.JPG,char_data/트/P1010009.JPG_4.jpg,1254,480,640,33,390,423,245,283,True,83
트,41,kaist_dataset/Mixed/Digital_Camera/(C.S)C-outdoor1/P1010009.JPG,char_data/트/P1010009.JPG_5.jpg,1476,480,640,36,501,537,245,286,True,83
트,34,kaist_dataset/Mixed/Digital_Camera/(C.S)C-outdoor2/DSC02433.JPG,char_data/트/DSC02433.JPG_2.jpg,816,480,640,24,424,448,265,299,True,83
트,118,kaist_dataset/Mixed/Digital_Camera/(C.S)C-outdoor2/DSC02460.JPG,char_data/트/DSC02460.JPG_4.jpg,12980,480,640,110,497,607,166,284,True,83
트,33,kaist_dataset/Mixed/Digital_Camera/(C.S)C-outdoor2/DSC02460.JPG,char_data/트/DSC02460.JPG_5.jpg,1188,480,640,36,225,261,305,338,True,83
트,152,kaist_dataset/Mixed/Digital_Camera/(C.S)C-outdoor2/DSC02490.JPG,char_data/트/DSC02490.JPG_2.jpg,18848,480,640,124,357,481,113,265,True,83
트,71,kaist_dataset/Mixed/Digital_Camera/(C.S)C-outdoor2/DSC02543.JPG,char_data/트/DSC02543.JPG_2.jpg,5467,480,640,77,342,419,274,345,True,83
트,93,kaist_dataset/Mixed/Digital_Camera/(C.S)C-outdoor2/DSC02556.JPG,char_data/트/DSC02556.JPG_2.jpg,7161,480,640,77,438,515,201,294,True,83
트,97,kaist_dataset/Mixed/Digital_Camera/(C.S)C-outdoor2/DSC02907.JPG,char_data/트/DSC02907.JPG_2.jpg,9409,480,640,97,452,549,207,304,True,83
트,104,kaist_dataset/Mixed/Digital_Camera/(C.S)C-outdoor3/DSC03048.JPG,char_data/트/DSC03048.JPG_2.jpg,9776,480,640,94,541,635,20,124,True,83
트,42,kaist_dataset/Mixed/Digital_Camera/(C.S)C-outdoor3/DSC03055.JPG,char_data/트/DSC03055.JPG_2.jpg,1428,480,640,34,370,404,218,260,True,83
트,96,kaist_dataset/Mixed/Digital_Camera/(C.S)C-outdoor3/DSC03187.JPG,char_data/트/DSC03187.JPG_2.jpg,8736,480,640,91,528,619,278,374,True,83
트,38,kaist_dataset/Mixed/Digital_Camera/(C.S)C-outdoor3/DSC03196.JPG,char_data/트/DSC03196.JPG_2.jpg,1672,480,640,44,434,478,397,435,True,83
트,88,kaist_dataset/Mixed/Digital_Camera/(C.S)C-outdoor3/DSC03247.JPG,char_data/트/DSC03247.JPG_2.jpg,6248,480,640,71,280,351,241,329,True,83
트,83,kaist_dataset/Mixed/Digital_Camera/(C.S)C-outdoor3/DSC03415.JPG,char_data/트/DSC03415.JPG_2.jpg,5312,480,640,64,191,255,151,234,False,83
트,57,kaist_dataset/Mixed/Digital_Camera/(C.S)C-outdoor4/DSC03544.JPG,char_data/트/DSC03544.JPG_2.jpg,2451,480,640,43,305,348,263,320,False,83
트,85,kaist_dataset/Mixed/Digital_Camera/(C.S)C-outdoor4/DSC03549.JPG,char_data/트/DSC03549.JPG_2.jpg,9775,480,640,115,467,582,340,425,False,83
트,111,kaist_dataset/Mixed/Digital_Camera/(C.S)C-outdoor4/DSC03628.JPG,char_data/트/DSC03628.JPG_2.jpg,12432,480,640,112,418,530,219,330,False,83
트,133,kaist_dataset/Mixed/Digital_Camera/(C.S)C-outdoor5/DSC04030.JPG,char_data/트/DSC04030.JPG_2.jpg,16093,480,640,121,477,598,140,273,False,83
트,72,kaist_dataset/Mixed/Digital_Camera/(C.S)C-outdoor5/DSC04048.JPG,char_data/트/DSC04048.JPG_4.jpg,4968,480,640,69,295,364,88,160,False,83
트,77,kaist_dataset/Mixed/Digital_Camera/(C.S)C-outdoor5/DSC04048.JPG,char_data/트/DSC04048.JPG_5.jpg,5698,480,640,74,538,612,87,164,False,83
트,98,kaist_dataset/Mixed/Digital_Camera/(C.S)C-outdoor5/DSC04104.JPG,char_data/트/DSC04104.JPG_2.jpg,8036,480,640,82,504,586,98,196,False,83
트,80,kaist_dataset/Mixed/Digital_Camera/(C.S)C-outdoor5/DSC04140.JPG,char_data/트/DSC04140.JPG_2.jpg,7040,480,640,88,387,475,306,386,False,83
트,31,kaist_dataset/Mixed/Digital_Camera/(C.S)C-outdoor5/DSC04151.JPG,char_data/트/DSC04151.JPG_2.jpg,961,480,640,31,549,580,211,242,False,83
트,87,kaist_dataset/Mixed/Digital_Camera/(C.S)C-outdoor6/P1010045.JPG,char_data/트/P1010045.JPG_2.jpg,6699,480,640,77,279,356,285,372,False,83
트,56,kaist_dataset/Mixed/Digital_Camera/(C.S)C-outdoor6/P1010093.JPG,char_data/트/P1010093.JPG_2.jpg,2240,480,640,40,598,638,173,229,False,83
트,38,kaist_dataset/Mixed/Digital_Camera/(C.S)D-indoor1/DSC03372.JPG,char_data/트/DSC03372.JPG_2.jpg,1596,480,640,42,327,369,395,433,False,83
트,59,kaist_dataset/Mixed/Digital_Camera/(C.S)D-indoor1/DSC03455.JPG,char_data/트/DSC03455.JPG_2.jpg,3186,480,640,54,447,501,384,443,False,83
트,70,kaist_dataset/Mixed/Digital_Camera/(C.S)D-indoor1/DSC03460.JPG,char_data/트/DSC03460.JPG_2.jpg,3640,480,640,52,499,551,384,454,False,83
트,114,kaist_dataset/Mixed/Digital_Camera/(C.S)D-indoor1/DSC03472.JPG,char_data/트/DSC03472.JPG_2.jpg,8094,480,640,71,259,330,176,290,False,83
트,40,kaist_dataset/Mixed/Digital_Camera/(C.S)D-indoor1/DSC03909.JPG,char_data/트/DSC03909.JPG_2.jpg,960,480,640,24,556,580,295,335,False,83
트,63,kaist_dataset/Mixed/Digital_Camera/(C.S)D-indoor1/DSC04019.JPG,char_data/트/DSC04019.JPG_2.jpg,3843,480,640,61,500,561,139,202,False,83
트,100,kaist_dataset/Mixed/Digital_Camera/(C.S)E-night/DSC02673.JPG,char_data/트/DSC02673.JPG_2.jpg,8300,480,640,83,330,413,144,244,False,83
트,41,kaist_dataset/Mixed/Digital_Camera/(C.S)E-night/DSC03514.JPG,char_data/트/DSC03514.JPG_2.jpg,1476,480,640,36,390,426,114,155,False,83
트,62,kaist_dataset/Mixed/Digital_Camera/(C.S)F-others/2007-12-08-day-113.jpg,char_data/트/2007-12-08-day-113.jpg_2.jpg,2914,1200,1600,47,627,674,839,901,False,83
트,36,kaist_dataset/Mixed/Digital_Camera/(C.S)F-others/DSC02504.JPG,char_data/트/DSC02504.JPG_2.jpg,2016,480,640,56,387,443,187,223,False,83
트,51,kaist_dataset/Mixed/Mobile_Phone/(C.M)A-outdoor/P090912037.jpg,char_data/트/P090912037.jpg_2.jpg,2652,480,640,52,446,498,178,229,False,83
트,74,kaist_dataset/Mixed/Mobile_Phone/(C.M)B-indoor/P090831018.jpg,char_data/트/P090831018.jpg_2.jpg,6290,480,640,85,243,328,147,221,False,83
y,44,kaist_dataset/English/Digital_Camera/(E.S)A-shadow/DSC03075.JPG,char_data/y/DSC03075.JPG_2.jpg,1452,480,640,33,263,296,358,402,True,47
y,66,kaist_dataset/English/Digital_Camera/(E.S)A-shadow/DSC03079.JPG,char_data/y/DSC03079.JPG_2.jpg,1848,480,640,28,416,444,330,396,True,47
y,54,kaist_dataset/English/Digital_Camera/(E.S)A-shadow/DSC03081.JPG,char_data/y/DSC03081.JPG_2.jpg,1350,480,640,25,376,401,413,467,True,47
y,60,kaist_dataset/English/Digital_Camera/(E.S)A-shadow/DSC03082.JPG,char_data/y/DSC03082.JPG_2.jpg,1440,480,640,24,320,344,382,442,True,47
y,58,kaist_dataset/English/Digital_Camera/(E.S)C-outdoor1/076.JPG,char_data/y/076.JPG_8.jpg,2320,480,640,40,309,349,222,280,True,47
y,72,kaist_dataset/English/Digital_Camera/(E.S)C-outdoor1/076.JPG,char_data/y/076.JPG_9.jpg,3456,480,640,48,576,624,207,279,True,47
y,18,kaist_dataset/English/Digital_Camera/(E.S)C-outdoor1/076.JPG,char_data/y/076.JPG_10.jpg,162,480,640,9,571,580,321,339,True,47
y,22,kaist_dataset/English/Digital_Camera/(E.S)C-outdoor1/076.JPG,char_data/y/076.JPG_11.jpg,220,480,640,10,630,639,319,341,True,47
y,261,kaist_dataset/English/Digital_Camera/(E.S)C-outdoor1/080119-0036.jpg,char_data/y/080119-0036.jpg_2.jpg,45414,1200,1600,174,378,552,339,600,True,47
y,89,kaist_dataset/English/Digital_Camera/(E.S)C-outdoor1/7.jpg,char_data/y/7.jpg_2.jpg,5251,574,680,59,315,374,261,350,True,47
y,152,kaist_dataset/English/Digital_Camera/(E.S)C-outdoor1/DSC02415.JPG,char_data/y/DSC02415.JPG_2.jpg,14896,480,640,98,159,257,74,226,True,47
y,34,kaist_dataset/English/Digital_Camera/(E.S)C-outdoor1/DSC02559.JPG,char_data/y/DSC02559.JPG_2.jpg,884,480,640,26,252,278,131,165,True,47
y,48,kaist_dataset/English/Digital_Camera/(E.S)C-outdoor1/DSC02918.JPG,char_data/y/DSC02918.JPG_2.jpg,1152,480,640,24,208,232,231,279,True,47
y,41,kaist_dataset/English/Digital_Camera/(E.S)C-outdoor2/DSC03053.JPG,char_data/y/DSC03053.JPG_2.jpg,1025,480,640,25,117,142,142,183,True,47
y,46,kaist_dataset/English/Digital_Camera/(E.S)C-outdoor2/DSC03160.JPG,char_data/y/DSC03160.JPG_5.jpg,1196,480,640,26,374,400,148,194,True,47
y,46,kaist_dataset/English/Digital_Camera/(E.S)C-outdoor2/DSC03168.JPG,char_data/y/DSC03168.JPG_2.jpg,1518,480,640,33,344,377,301,347,True,47
y,96,kaist_dataset/English/Digital_Camera/(E.S)C-outdoor2/DSC03200.JPG,char_data/y/DSC03200.JPG_4.jpg,5280,480,640,55,223,278,251,347,True,47
y,99,kaist_dataset/English/Digital_Camera/(E.S)C-outdoor2/DSC03200.JPG,char_data/y/DSC03200.JPG_5.jpg,6237,480,640,63,413,476,245,344,True,47
y,61,kaist_dataset/English/Digital_Camera/(E.S)C-outdoor2/DSC03290.JPG,char_data/y/DSC03290.JPG_2.jpg,2135,480,640,35,365,400,202,263,True,47
y,52,kaist_dataset/English/Digital_Camera/(E.S)C-outdoor2/DSC03307.JPG,char_data/y/DSC03307.JPG_2.jpg,936,480,640,18,346,364,177,229,True,47
y,81,kaist_dataset/English/Digital_Camera/(E.S)C-outdoor2/DSC03412.JPG,char_data/y/DSC03412.JPG_4.jpg,2997,480,640,37,253,290,145,226,True,47
y,46,kaist_dataset/English/Digital_Camera/(E.S)C-outdoor2/DSC03440.JPG,char_data/y/DSC03440.JPG_2.jpg,1288,480,640,28,434,462,154,200,True,47
y,41,kaist_dataset/English/Digital_Camera/(E.S)C-outdoor2/DSC03664.JPG,char_data/y/DSC03664.JPG_2.jpg,1312,480,640,32,273,305,32,73,True,47
y,58,kaist_dataset/English/Digital_Camera/(E.S)C-outdoor2/DSC04064.JPG,char_data/y/DSC04064.JPG_2.jpg,1740,480,640,30,378,408,140,198,True,47
y,42,kaist_dataset/English/Digital_Camera/(E.S)C-outdoor2/DSC04079.JPG,char_data/y/DSC04079.JPG_8.jpg,1344,480,640,32,309,341,121,163,True,47
y,97,kaist_dataset/English/Digital_Camera/(E.S)C-outdoor2/DSC04160.JPG,char_data/y/DSC04160.JPG_2.jpg,7372,480,640,76,303,379,245,342,True,47
y,136,kaist_dataset/English/Digital_Camera/(E.S)C-outdoor2/DSC04397.JPG,char_data/y/DSC04397.JPG_2.jpg,9656,480,640,71,444,515,235,371,True,47
y,32,kaist_dataset/English/Digital_Camera/(E.S)C-outdoor2/DSC04437.JPG,char_data/y/DSC04437.JPG_9.jpg,480,480,640,15,319,334,45,77,True,47
y,82,kaist_dataset/English/Digital_Camera/(E.S)C-outdoor2/DSC04437.JPG,char_data/y/DSC04437.JPG_11.jpg,4100,480,640,50,258,308,118,200,True,47
y,158,kaist_dataset/English/Digital_Camera/(E.S)C-outdoor2/DSC04458.JPG,char_data/y/DSC04458.JPG_2.jpg,14378,480,640,91,461,552,294,452,True,47
y,51,kaist_dataset/English/Digital_Camera/(E.S)C-outdoor2/P1010057.JPG,char_data/y/P1010057.JPG_2.jpg,1224,480,640,24,285,309,203,254,True,47
y,34,kaist_dataset/English/Digital_Camera/(E.S)C-outdoor3/P1010123.JPG,char_data/y/P1010123.JPG_4.jpg,510,480,640,15,576,591,72,106,True,47
y,31,kaist_dataset/English/Digital_Camera/(E.S)C-outdoor3/P1010123.JPG,char_data/y/P1010123.JPG_5.jpg,558,480,640,18,86,104,79,110,True,47
y,43,kaist_dataset/English/Digital_Camera/(E.S)D-indoor/080119-0009.jpg,char_data/y/080119-0009.jpg_6.jpg,1505,1200,1600,35,1138,1173,692,735,True,47
y,41,kaist_dataset/English/Digital_Camera/(E.S)D-indoor/080119-0009.jpg,char_data/y/080119-0009.jpg_7.jpg,574,1200,1600,14,593,607,1059,1100,True,47
y,71,kaist_dataset/English/Digital_Camera/(E.S)D-indoor/080119-0009.jpg,char_data/y/080119-0009.jpg_8.jpg,2556,1200,1600,36,1549,1585,92,163,True,47
y,89,kaist_dataset/English/Digital_Camera/(E.S)D-indoor/DSC03074.JPG,char_data/y/DSC03074.JPG_2.jpg,2047,480,640,23,238,261,255,344,True,47
y,56,kaist_dataset/English/Digital_Camera/(E.S)D-indoor/DSC03078.JPG,char_data/y/DSC03078.JPG_4.jpg,1848,480,640,33,333,366,236,292,True,47
y,65,kaist_dataset/English/Digital_Camera/(E.S)D-indoor/DSC03078.JPG,char_data/y/DSC03078.JPG_5.jpg,2535,480,640,39,550,589,235,300,True,47
y,100,kaist_dataset/English/Digital_Camera/(E.S)D-indoor/DSC03080.JPG,char_data/y/DSC03080.JPG_2.jpg,4900,480,640,49,499,548,364,464,True,47
y,78,kaist_dataset/English/Digital_Camera/(E.S)D-indoor/DSC03087.JPG,char_data/y/DSC03087.JPG_2.jpg,3198,480,640,41,494,535,376,454,True,47
y,73,kaist_dataset/English/Digital_Camera/(E.S)D-indoor/DSC03091.JPG,char_data/y/DSC03091.JPG_2.jpg,3577,480,640,49,427,476,129,202,True,47
y,44,kaist_dataset/English/Digital_Camera/(E.S)D-indoor/DSC03146.JPG,char_data/y/DSC03146.JPG_2.jpg,1056,480,640,24,329,353,231,275,True,47
y,39,kaist_dataset/English/Digital_Camera/(E.S)D-indoor/DSC03147.JPG,char_data/y/DSC03147.JPG_4.jpg,780,480,640,20,164,184,301,340,True,47
y,42,kaist_dataset/English/Digital_Camera/(E.S)D-indoor/DSC03147.JPG,char_data/y/DSC03147.JPG_5.jpg,882,480,640,21,166,187,240,282,True,47
y,58,kaist_dataset/English/Digital_Camera/(E.S)D-indoor/DSC03345.JPG,char_data/y/DSC03345.JPG_2.jpg,2262,480,640,39,562,601,104,162,True,47
y,66,kaist_dataset/English/Digital_Camera/(E.S)D-indoor/DSC03936.JPG,char_data/y/DSC03936.JPG_2.jpg,1980,480,640,30,584,614,85,151,True,47
y,54,kaist_dataset/English/Digital_Camera/(E.S)D-indoor/DSC03947.JPG,char_data/y/DSC03947.JPG_2.jpg,1836,480,640,34,439,473,279,333,True,47
y,58,kaist_dataset/English/Digital_Camera/(E.S)E-night/DSC02610.JPG,char_data/y/DSC02610.JPG_2.jpg,1508,480,640,26,156,182,269,327,True,47
y,118,kaist_dataset/English/Digital_Camera/(E.S)F-others/DSC02925.JPG,char_data/y/DSC02925.JPG_2.jpg,9204,480,640,78,520,598,202,320,True,47
y,101,kaist_dataset/English/Mobile_Phone/(E.M)A-outdoor/P090912059.jpg,char_data/y/P090912059.jpg_2.jpg,10201,480,640,101,522,623,166,267,True,47
y,96,kaist_dataset/English/Mobile_Phone/(E.M)B-indoor/P090903002.jpg,char_data/y/P090903002.jpg_2.jpg,8448,480,640,88,478,566,296,392,True,47
y,70,kaist_dataset/English/Mobile_Phone/(E.M)B-indoor/P090911060.jpg,char_data/y/P090911060.jpg_4.jpg,3010,480,640,43,112,155,19,89,True,47
y,71,kaist_dataset/English/Mobile_Phone/(E.M)B-indoor/P090911060.jpg,char_data/y/P090911060.jpg_5.jpg,2982,480,640,42,433,475,19,90,True,47
y,132,kaist_dataset/English/Mobile_Phone/(E.M)B-indoor/P090911086.jpg,char_data/y/P090911086.jpg_2.jpg,8448,480,640,64,288,352,237,369,True,47
y,90,kaist_dataset/English/Mobile_Phone/(E.M)C-bookCover/P090831039.jpg,char_data/y/P090831039.jpg_2.jpg,6030,480,640,67,506,573,237,327,True,47
y,95,kaist_dataset/English/Mobile_Phone/(E.M)C-bookCover/P090903054.jpg,char_data/y/P090903054.jpg_2.jpg,5605,480,640,59,428,487,231,326,True,47
y,46,kaist_dataset/Korean/Digital_Camera/G-others/080119-0005.jpg,char_data/y/080119-0005.jpg_2.jpg,1288,1600,1200,28,773,801,1170,1216,True,47
y,53,kaist_dataset/Korean/Digital_Camera/G-others/2007-12-08-day-112.jpg,char_data/y/2007-12-08-day-112.jpg_2.jpg,1060,1200,1600,20,751,771,552,605,True,47
y,85,kaist_dataset/Korean/Digital_Camera/outdoor1/40.jpg,char_data/y/40.jpg_2.jpg,2635,308,367,31,88,119,55,140,True,47
y,43,kaist_dataset/Korean/Digital_Camera/outdoor1/54.JPG,char_data/y/54.JPG_2.jpg,1161,523,767,27,387,414,115,158,True,47
y,46,kaist_dataset/Mixed/Digital_Camera/(C.S)B-light/134.JPG,char_data/y/134.JPG_2.jpg,1012,480,640,22,303,325,292,338,True,47
y,135,kaist_dataset/Mixed/Digital_Camera/(C.S)B-light/DSC04404.JPG,char_data/y/DSC04404.JPG_2.jpg,11745,480,640,87,476,563,221,356,True,47
y,21,kaist_dataset/Mixed/Digital_Camera/(C.S)C-outdoor1/003.JPG,char_data/y/003.JPG_2.jpg,231,480,640,11,449,460,255,276,True,47
y,35,kaist_dataset/Mixed/Digital_Camera/(C.S)C-outdoor1/115.JPG,char_data/y/115.JPG_2.jpg,735,480,640,21,228,249,280,315,True,47
y,44,kaist_dataset/Mixed/Digital_Camera/(C.S)C-outdoor1/130.JPG,char_data/y/130.JPG_2.jpg,1496,480,640,34,150,184,298,342,True,47
y,70,kaist_dataset/Mixed/Digital_Camera/(C.S)C-outdoor1/2007-12-09-day-exterior-004.jpg,char_data/y/2007-12-09-day-exterior-004.jpg_2.jpg,3220,1200,1600,46,668,714,670,740,True,47
y,52,kaist_dataset/Mixed/Digital_Camera/(C.S)C-outdoor1/51.JPG,char_data/y/51.JPG_2.jpg,1872,576,768,36,188,224,227,279,True,47
y,36,kaist_dataset/Mixed/Digital_Camera/(C.S)C-outdoor1/55.JPG,char_data/y/55.JPG_2.jpg,972,576,768,27,380,407,166,202,True,47
y,30,kaist_dataset/Mixed/Digital_Camera/(C.S)C-outdoor2/DSC02421.JPG,char_data/y/DSC02421.JPG_2.jpg,690,480,640,23,558,581,207,237,True,47
y,63,kaist_dataset/Mixed/Digital_Camera/(C.S)C-outdoor2/DSC02436.JPG,char_data/y/DSC02436.JPG_2.jpg,2016,480,640,32,333,365,188,251,True,47
y,43,kaist_dataset/Mixed/Digital_Camera/(C.S)C-outdoor2/DSC02869.JPG,char_data/y/DSC02869.JPG_2.jpg,1161,480,640,27,316,343,143,186,True,47
y,61,kaist_dataset/Mixed/Digital_Camera/(C.S)C-outdoor2/DSC02926.JPG,char_data/y/DSC02926.JPG_2.jpg,2562,480,640,42,232,274,131,192,True,47
y,49,kaist_dataset/Mixed/Digital_Camera/(C.S)C-outdoor2/DSC02927.JPG,char_data/y/DSC02927.JPG_2.jpg,1274,480,640,26,306,332,370,419,True,47
y,51,kaist_dataset/Mixed/Digital_Camera/(C.S)C-outdoor2/DSC02928.JPG,char_data/y/DSC02928.JPG_2.jpg,1683,480,640,33,477,510,389,440,True,47
y,120,kaist_dataset/Mixed/Digital_Camera/(C.S)C-outdoor2/DSC02940.JPG,char_data/y/DSC02940.JPG_2.jpg,9240,480,640,77,172,249,238,358,True,47
y,60,kaist_dataset/Mixed/Digital_Camera/(C.S)C-outdoor3/DSC02962.JPG,char_data/y/DSC02962.JPG_2.jpg,2340,480,640,39,416,455,164,224,True,47
y,37,kaist_dataset/Mixed/Digital_Camera/(C.S)C-outdoor3/DSC02970.JPG,char_data/y/DSC02970.JPG_2.jpg,777,480,640,21,344,365,308,345,True,47
y,50,kaist_dataset/Mixed/Digital_Camera/(C.S)C-outdoor3/DSC03186.JPG,char_data/y/DSC03186.JPG_4.jpg,1100,480,640,22,129,151,106,156,True,47
y,41,kaist_dataset/Mixed/Digital_Camera/(C.S)C-outdoor3/DSC03186.JPG,char_data/y/DSC03186.JPG_5.jpg,1189,480,640,29,211,240,112,153,True,47
y,142,kaist_dataset/Mixed/Digital_Camera/(C.S)C-outdoor3/DSC03210.JPG,char_data/y/DSC03210.JPG_2.jpg,9656,480,640,68,520,588,239,381,True,47
y,54,kaist_dataset/Mixed/Digital_Camera/(C.S)C-outdoor3/DSC03310.JPG,char_data/y/DSC03310.JPG_2.jpg,1134,480,640,21,341,362,129,183,True,47
y,86,kaist_dataset/Mixed/Digital_Camera/(C.S)C-outdoor3/DSC03421.JPG,char_data/y/DSC03421.JPG_2.jpg,3268,480,640,38,243,281,243,329,True,47
y,74,kaist_dataset/Mixed/Digital_Camera/(C.S)C-outdoor3/DSC03422.JPG,char_data/y/DSC03422.JPG_2.jpg,1998,480,640,27,461,488,263,337,True,47
y,100,kaist_dataset/Mixed/Digital_Camera/(C.S)C-outdoor3/P1010016.JPG,char_data/y/P1010016.JPG_2.jpg,4900,480,640,49,475,524,179,279,True,47
y,44,kaist_dataset/Mixed/Digital_Camera/(C.S)C-outdoor4/DSC03556.JPG,char_data/y/DSC03556.JPG_4.jpg,660,480,640,15,190,205,316,360,True,47
y,35,kaist_dataset/Mixed/Digital_Camera/(C.S)C-outdoor4/DSC03556.JPG,char_data/y/DSC03556.JPG_5.jpg,455,480,640,13,286,299,319,354,True,47
y,49,kaist_dataset/Mixed/Digital_Camera/(C.S)C-outdoor4/DSC03586.JPG,char_data/y/DSC03586.JPG_4.jpg,1078,480,640,22,215,237,154,203,True,47
y,49,kaist_dataset/Mixed/Digital_Camera/(C.S)C-outdoor4/DSC03586.JPG,char_data/y/DSC03586.JPG_5.jpg,1078,480,640,22,388,410,159,208,True,47
y,105,kaist_dataset/Mixed/Digital_Camera/(C.S)C-outdoor4/DSC03635.JPG,char_data/y/DSC03635.JPG_2.jpg,8190,480,640,78,450,528,148,253,True,47
y,110,kaist_dataset/Mixed/Digital_Camera/(C.S)C-outdoor4/DSC03638.JPG,char_data/y/DSC03638.JPG_2.jpg,9460,480,640,86,444,530,105,215,True,47
y,101,kaist_dataset/Mixed/Digital_Camera/(C.S)C-outdoor4/DSC03651.JPG,char_data/y/DSC03651.JPG_4.jpg,6666,480,640,66,187,253,174,275,True,47
y,100,kaist_dataset/Mixed/Digital_Camera/(C.S)C-outdoor4/DSC03651.JPG,char_data/y/DSC03651.JPG_5.jpg,5900,480,640,59,389,448,177,277,True,47
y,45,kaist_dataset/Mixed/Digital_Camera/(C.S)C-outdoor4/DSC03672.JPG,char_data/y/DSC03672.JPG_2.jpg,855,480,640,19,258,277,413,458,True,47
y,107,kaist_dataset/Mixed/Digital_Camera/(C.S)C-outdoor5/DSC03819.JPG,char_data/y/DSC03819.JPG_2.jpg,5778,480,640,54,445,499,99,206,False,47
y,40,kaist_dataset/Mixed/Digital_Camera/(C.S)C-outdoor5/DSC03839.JPG,char_data/y/DSC03839.JPG_4.jpg,680,480,640,17,284,301,37,77,False,47
y,33,kaist_dataset/Mixed/Digital_Camera/(C.S)C-outdoor5/DSC03839.JPG,char_data/y/DSC03839.JPG_5.jpg,759,480,640,23,420,443,39,72,False,47
y,91,kaist_dataset/Mixed/Digital_Camera/(C.S)C-outdoor5/DSC04030.JPG,char_data/y/DSC04030.JPG_2.jpg,6006,480,640,66,266,332,185,276,False,47
y,95,kaist_dataset/Mixed/Digital_Camera/(C.S)C-outdoor5/DSC04115.JPG,char_data/y/DSC04115.JPG_2.jpg,4560,480,640,48,290,338,206,301,False,47
y,50,kaist_dataset/Mixed/Digital_Camera/(C.S)C-outdoor5/DSC04321.JPG,char_data/y/DSC04321.JPG_2.jpg,1250,480,640,25,561,586,205,255,False,47
y,63,kaist_dataset/Mixed/Digital_Camera/(C.S)C-outdoor5/DSC04322.JPG,char_data/y/DSC04322.JPG_2.jpg,1197,480,640,19,405,424,218,281,False,47
y,49,kaist_dataset/Mixed/Digital_Camera/(C.S)C-outdoor5/DSC04456.JPG,char_data/y/DSC04456.JPG_2.jpg,1519,480,640,31,358,389,175,224,False,47
y,190,kaist_dataset/Mixed/Digital_Camera/(C.S)C-outdoor6/080116-0057.jpg,char_data/y/080116-0057.jpg_2.jpg,20710,1200,1600,109,1296,1405,577,767,False,47
y,66,kaist_dataset/Mixed/Digital_Camera/(C.S)C-outdoor6/117.JPG,char_data/y/117.JPG_2.jpg,3432,480,640,52,235,287,192,258,False,47
y,40,kaist_dataset/Mixed/Digital_Camera/(C.S)C-outdoor6/P1010085.JPG,char_data/y/P1010085.JPG_2.jpg,960,480,640,24,124,148,93,133,False,47
y,26,kaist_dataset/Mixed/Digital_Camera/(C.S)C-outdoor6/P1010138.JPG,char_data/y/P1010138.JPG_2.jpg,468,480,640,18,187,205,184,210,False,47
y,49,kaist_dataset/Mixed/Digital_Camera/(C.S)D-indoor1/082.JPG,char_data/y/082.JPG_4.jpg,1323,480,640,27,249,276,184,233,False,47
y,51,kaist_dataset/Mixed/Digital_Camera/(C.S)D-indoor1/082.JPG,char_data/y/082.JPG_5.jpg,1428,480,640,28,426,454,181,232,False,47
y,38,kaist_dataset/Mixed/Digital_Camera/(C.S)D-indoor1/DSC02787.JPG,char_data/y/DSC02787.JPG_2.jpg,646,480,640,17,197,214,383,421,False,47
y,44,kaist_dataset/Mixed/Digital_Camera/(C.S)D-indoor1/DSC02804.JPG,char_data/y/DSC02804.JPG_2.jpg,924,480,640,21,336,357,352,396,False,47
y,47,kaist_dataset/Mixed/Digital_Camera/(C.S)D-indoor1/DSC03073.JPG,char_data/y/DSC03073.JPG_2.jpg,1081,480,640,23,322,345,288,335,False,47
y,43,kaist_dataset/Mixed/Digital_Camera/(C.S)D-indoor1/DSC04206.JPG,char_data/y/DSC04206.JPG_2.jpg,731,480,640,17,271,288,289,332,False,47
y,41,kaist_dataset/Mixed/Digital_Camera/(C.S)D-indoor1/DSC04246.JPG,char_data/y/DSC04246.JPG_2.jpg,943,480,640,23,515,538,249,290,False,47
y,46,kaist_dataset/Mixed/Digital_Camera/(C.S)E-night/DSC02623.JPG,char_data/y/DSC02623.JPG_2.jpg,1242,480,640,27,362,389,395,441,False,47
y,110,kaist_dataset/Mixed/Digital_Camera/(C.S)E-night/DSC02903.JPG,char_data/y/DSC02903.JPG_2.jpg,11330,480,640,103,174,277,145,255,False,47
y,35,kaist_dataset/Mixed/Digital_Camera/(C.S)F-others/2007-12-09-day-exterior-032.jpg,char_data/y/2007-12-09-day-exterior-032.jpg_2.jpg,945,1600,1200,27,654,681,279,314,False,47
y,88,kaist_dataset/Mixed/Mobile_Phone/(C.M)B-indoor/P090831008.jpg,char_data/y/P090831008.jpg_2.jpg,3432,480,640,39,261,300,316,404,False,47
y,37,kaist_dataset/Mixed/Mobile_Phone/(C.M)C-bookCover/P090903024.jpg,char_data/y/P090903024.jpg_2.jpg,1147,480,640,31,324,355,176,213,False,47
K,82,kaist_dataset/English/Digital_Camera/(E.S)A-shadow/DSC02423.JPG,char_data/K/DSC02423.JPG_2.jpg,5330,480,640,65,338,403,155,237,True,21
K,107,kaist_dataset/English/Digital_Camera/(E.S)A-shadow/DSC03084.JPG,char_data/K/DSC03084.JPG_2.jpg,10700,480,640,100,264,364,141,248,True,21
K,76,kaist_dataset/English/Digital_Camera/(E.S)B-light/DSC03007.JPG,char_data/K/DSC03007.JPG_4.jpg,4636,480,640,61,107,168,173,249,True,21
K,74,kaist_dataset/English/Digital_Camera/(E.S)B-light/DSC03007.JPG,char_data/K/DSC03007.JPG_5.jpg,4662,480,640,63,167,230,173,247,True,21
K,65,kaist_dataset/English/Digital_Camera/(E.S)C-outdoor1/035.jpg,char_data/K/035.jpg_2.jpg,1755,210,354,27,218,245,89,154,True,21
K,24,kaist_dataset/English/Digital_Camera/(E.S)C-outdoor1/077.JPG,char_data/K/077.JPG_2.jpg,360,480,640,15,294,309,251,275,True,21
K,94,kaist_dataset/English/Digital_Camera/(E.S)C-outdoor1/080116-0065.jpg,char_data/K/080116-0065.jpg_2.jpg,6392,600,800,68,513,581,250,344,True,21
K,30,kaist_dataset/English/Digital_Camera/(E.S)C-outdoor1/113.jpg,char_data/K/113.jpg_6.jpg,840,480,640,28,463,491,229,259,True,21
K,130,kaist_dataset/English/Digital_Camera/(E.S)C-outdoor1/129.JPG,char_data/K/129.JPG_2.jpg,12220,480,640,94,198,292,173,303,True,21
K,66,kaist_dataset/English/Digital_Camera/(E.S)C-outdoor1/139.JPG,char_data/K/139.JPG_2.jpg,3234,480,640,49,366,415,249,315,True,21
K,75,kaist_dataset/English/Digital_Camera/(E.S)C-outdoor1/DSC02356.JPG,char_data/K/DSC02356.JPG_8.jpg,4425,480,640,59,550,609,169,244,True,21
K,41,kaist_dataset/English/Digital_Camera/(E.S)C-outdoor1/DSC02364.JPG,char_data/K/DSC02364.JPG_6.jpg,861,480,640,21,271,292,346,387,True,21
K,45,kaist_dataset/English/Digital_Camera/(E.S)C-outdoor1/DSC02364.JPG,char_data/K/DSC02364.JPG_7.jpg,1035,480,640,23,340,363,345,390,True,21
K,41,kaist_dataset/English/Digital_Camera/(E.S)C-outdoor1/DSC02364.JPG,char_data/K/DSC02364.JPG_8.jpg,943,480,640,23,416,439,345,386,True,21
K,65,kaist_dataset/English/Digital_Camera/(E.S)C-outdoor1/DSC02395.JPG,char_data/K/DSC02395.JPG_2.jpg,4615,480,640,71,268,339,299,364,True,21
K,128,kaist_dataset/English/Digital_Camera/(E.S)C-outdoor1/DSC02448.JPG,char_data/K/DSC02448.JPG_4.jpg,10880,480,640,85,380,465,36,164,True,21
K,128,kaist_dataset/English/Digital_Camera/(E.S)C-outdoor1/DSC02448.JPG,char_data/K/DSC02448.JPG_5.jpg,11008,480,640,86,399,485,191,319,True,21
K,120,kaist_dataset/English/Digital_Camera/(E.S)C-outdoor1/DSC02450.JPG,char_data/K/DSC02450.JPG_2.jpg,6840,480,640,57,168,225,66,186,True,21
K,145,kaist_dataset/English/Digital_Camera/(E.S)C-outdoor2/DSC03408.JPG,char_data/K/DSC03408.JPG_2.jpg,12470,480,640,86,110,196,286,431,True,21
K,121,kaist_dataset/English/Digital_Camera/(E.S)C-outdoor2/DSC03410.JPG,char_data/K/DSC03410.JPG_2.jpg,18634,480,640,154,210,364,306,427,True,21
K,84,kaist_dataset/English/Digital_Camera/(E.S)C-outdoor2/DSC03411.JPG,char_data/K/DSC03411.JPG_2.jpg,6468,480,640,77,293,370,156,240,True,21
K,45,kaist_dataset/English/Digital_Camera/(E.S)C-outdoor2/DSC03575.JPG,char_data/K/DSC03575.JPG_4.jpg,1350,480,640,30,135,165,181,226,True,21
K,46,kaist_dataset/English/Digital_Camera/(E.S)C-outdoor2/DSC03575.JPG,char_data/K/DSC03575.JPG_5.jpg,1748,480,640,38,93,131,267,313,True,21
K,51,kaist_dataset/English/Digital_Camera/(E.S)C-outdoor2/DSC03650.JPG,char_data/K/DSC03650.JPG_2.jpg,1836,480,640,36,400,436,211,262,True,21
K,72,kaist_dataset/English/Digital_Camera/(E.S)C-outdoor2/DSC03684.JPG,char_data/K/DSC03684.JPG_2.jpg,3384,480,640,47,421,468,86,158,True,21
K,75,kaist_dataset/English/Digital_Camera/(E.S)C-outdoor2/DSC03759.JPG,char_data/K/DSC03759.JPG_2.jpg,9150,480,640,122,394,516,195,270,True,21
K,47,kaist_dataset/English/Digital_Camera/(E.S)C-outdoor2/DSC03865.JPG,char_data/K/DSC03865.JPG_2.jpg,1927,480,640,41,9,50,45,92,True,21
K,47,kaist_dataset/English/Digital_Camera/(E.S)C-outdoor2/DSC04064.JPG,char_data/K/DSC04064.JPG_2.jpg,1222,480,640,26,526,552,135,182,True,21
K,93,kaist_dataset/English/Digital_Camera/(E.S)C-outdoor2/ktx.jpg,char_data/K/ktx.jpg_2.jpg,5766,240,320,62,59,121,55,148,True,21
K,48,kaist_dataset/English/Digital_Camera/(E.S)C-outdoor3/DSC02690.JPG,char_data/K/DSC02690.JPG_2.jpg,2112,480,640,44,329,373,162,210,True,21
K,61,kaist_dataset/English/Digital_Camera/(E.S)C-outdoor3/DSC02788.JPG,char_data/K/DSC02788.JPG_2.jpg,2379,480,640,39,269,308,311,372,True,21
K,47,kaist_dataset/English/Digital_Camera/(E.S)C-outdoor3/DSC03038.JPG,char_data/K/DSC03038.JPG_2.jpg,1551,480,640,33,98,131,326,373,True,21
K,64,kaist_dataset/English/Digital_Camera/(E.S)D-indoor/DSC02769.JPG,char_data/K/DSC02769.JPG_2.jpg,3200,480,640,50,231,281,219,283,True,21
K,74,kaist_dataset/English/Digital_Camera/(E.S)D-indoor/DSC03091.JPG,char_data/K/DSC03091.JPG_2.jpg,4070,480,640,55,330,385,198,272,True,21
K,67,kaist_dataset/English/Digital_Camera/(E.S)D-indoor/DSC03136.JPG,char_data/K/DSC03136.JPG_5.jpg,2814,480,640,42,376,418,252,319,True,21
K,66,kaist_dataset/English/Digital_Camera/(E.S)D-indoor/DSC03150.JPG,char_data/K/DSC03150.JPG_4.jpg,3432,480,640,52,31,83,22,88,True,21
K,53,kaist_dataset/English/Digital_Camera/(E.S)D-indoor/DSC03151.JPG,char_data/K/DSC03151.JPG_4.jpg,2438,480,640,46,74,120,106,159,True,21
K,49,kaist_dataset/English/Digital_Camera/(E.S)D-indoor/DSC03467.JPG,char_data/K/DSC03467.JPG_2.jpg,1715,480,640,35,249,284,152,201,True,21
K,51,kaist_dataset/English/Digital_Camera/(E.S)D-indoor/DSC03942.JPG,char_data/K/DSC03942.JPG_2.jpg,1173,480,640,23,161,184,9,60,True,21
K,81,kaist_dataset/English/Digital_Camera/(E.S)D-indoor/DSC03943.JPG,char_data/K/DSC03943.JPG_2.jpg,5913,480,640,73,246,319,208,289,True,21
K,18,kaist_dataset/English/Digital_Camera/(E.S)D-indoor/z.jpg,char_data/K/z.jpg_2.jpg,378,240,320,21,86,107,72,90,True,21
K,71,kaist_dataset/English/Digital_Camera/(E.S)F-others/032.jpg,char_data/K/032.jpg_2.jpg,3124,245,422,44,168,212,44,115,True,21
K,52,kaist_dataset/English/Digital_Camera/(E.S)F-others/080119-0007.jpg,char_data/K/080119-0007.jpg_2.jpg,3068,1200,1600,59,1235,1294,898,950,True,21
K,179,kaist_dataset/English/Digital_Camera/(E.S)F-others/080119-0013.jpg,char_data/K/080119-0013.jpg_2.jpg,23270,1200,1600,130,738,868,600,779,True,21
K,63,kaist_dataset/English/Digital_Camera/(E.S)F-others/크기변환_%B0%A3%C6%C77_m_starfirm.jpg,char_data/K/크기변환_%B0%A3%C6%C77_m_starfirm.jpg_2.jpg,3024,480,640,48,369,417,188,251,True,21
K,100,kaist_dataset/English/Mobile_Phone/(E.M)C-bookCover/P090903050.jpg,char_data/K/P090903050.jpg_2.jpg,9000,480,640,90,427,517,75,175,True,21
K,40,kaist_dataset/Korean/Digital_Camera/A-shadow/2007-12-09-day-exterior-031.jpg,char_data/K/2007-12-09-day-exterior-031.jpg_2.jpg,1280,1200,1600,32,308,340,610,650,True,21
K,19,kaist_dataset/Korean/Digital_Camera/indoor1/146.JPG,char_data/K/146.JPG_2.jpg,190,480,640,10,349,359,269,288,True,21
K,34,kaist_dataset/Korean/Digital_Camera/indoor1/2007-12-08-day-139.jpg,char_data/K/2007-12-08-day-139.jpg_2.jpg,850,1200,1600,25,561,586,353,387,True,21
K,28,kaist_dataset/Korean/Digital_Camera/outdoor2/2007-12-08-day-101.jpg,char_data/K/2007-12-08-day-101.jpg_5.jpg,448,1200,1600,16,167,183,1059,1087,True,21
K,99,kaist_dataset/Korean/Digital_Camera/outdoor5/DSC03636.JPG,char_data/K/DSC03636.JPG_2.jpg,9504,480,640,96,41,137,232,331,True,21
K,70,kaist_dataset/Korean/Digital_Camera/outdoor5/DSC03869.JPG,char_data/K/DSC03869.JPG_2.jpg,3220,480,640,46,202,248,265,335,True,21
K,58,kaist_dataset/Mixed/Digital_Camera/(C.S)C-outdoor1/003.JPG,char_data/K/003.JPG_4.jpg,2436,480,640,42,256,298,98,156,True,21
K,22,kaist_dataset/Mixed/Digital_Camera/(C.S)C-outdoor1/003.JPG,char_data/K/003.JPG_5.jpg,352,480,640,16,66,82,267,289,True,21
K,120,kaist_dataset/Mixed/Digital_Camera/(C.S)C-outdoor1/008.JPG,char_data/K/008.JPG_4.jpg,8280,480,640,69,180,249,135,255,True,21
K,125,kaist_dataset/Mixed/Digital_Camera/(C.S)C-outdoor1/008.JPG,char_data/K/008.JPG_5.jpg,8125,480,640,65,463,528,133,258,True,21
K,72,kaist_dataset/Mixed/Digital_Camera/(C.S)C-outdoor1/046.JPG,char_data/K/046.JPG_2.jpg,3960,480,640,55,154,209,205,277,True,21
K,143,kaist_dataset/Mixed/Digital_Camera/(C.S)C-outdoor1/049.JPG,char_data/K/049.JPG_2.jpg,9867,480,640,69,528,597,178,321,True,21
K,28,kaist_dataset/Mixed/Digital_Camera/(C.S)C-outdoor1/054.JPG,char_data/K/054.JPG_2.jpg,840,480,640,30,514,544,274,302,True,21
K,114,kaist_dataset/Mixed/Digital_Camera/(C.S)C-outdoor1/080116-0084.jpg,char_data/K/080116-0084.jpg_2.jpg,11514,600,800,101,222,323,156,270,True,21
K,176,kaist_dataset/Mixed/Digital_Camera/(C.S)C-outdoor1/080118-0007.jpg,char_data/K/080118-0007.jpg_2.jpg,28160,1200,1600,160,145,305,436,612,True,21
K,130,kaist_dataset/Mixed/Digital_Camera/(C.S)C-outdoor1/080119-0027.jpg,char_data/K/080119-0027.jpg_2.jpg,16770,1200,1600,129,208,337,460,590,True,21
K,62,kaist_dataset/Mixed/Digital_Camera/(C.S)C-outdoor1/1.JPG,char_data/K/1.JPG_4.jpg,1860,576,768,30,190,220,452,514,True,21
K,49,kaist_dataset/Mixed/Digital_Camera/(C.S)C-outdoor1/1.JPG,char_data/K/1.JPG_5.jpg,1225,576,768,25,289,314,463,512,True,21
K,130,kaist_dataset/Mixed/Digital_Camera/(C.S)C-outdoor1/113.JPG,char_data/K/113.JPG_7.jpg,7670,480,640,59,313,372,83,213,True,21
K,133,kaist_dataset/Mixed/Digital_Camera/(C.S)C-outdoor1/113.JPG,char_data/K/113.JPG_8.jpg,7847,480,640,59,401,460,80,213,True,21
K,38,kaist_dataset/Mixed/Digital_Camera/(C.S)C-outdoor1/114.jpg,char_data/K/114.jpg_2.jpg,1330,480,640,35,341,376,316,354,True,21
K,42,kaist_dataset/Mixed/Digital_Camera/(C.S)C-outdoor1/2007-12-08-day-103.jpg,char_data/K/2007-12-08-day-103.jpg_2.jpg,1386,1200,1600,33,626,659,613,655,True,21
K,55,kaist_dataset/Mixed/Digital_Camera/(C.S)C-outdoor1/2007-12-08-day-130.jpg,char_data/K/2007-12-08-day-130.jpg_2.jpg,2255,1200,1600,41,1042,1083,703,758,True,21
K,30,kaist_dataset/Mixed/Digital_Camera/(C.S)C-outdoor1/2007-12-09-day-exterior-051.jpg,char_data/K/2007-12-09-day-exterior-051.jpg_2.jpg,720,1200,1600,24,566,590,680,710,True,21
K,23,kaist_dataset/Mixed/Digital_Camera/(C.S)C-outdoor1/3.JPG,char_data/K/3.JPG_6.jpg,483,576,768,21,222,243,62,85,True,21
K,22,kaist_dataset/Mixed/Digital_Camera/(C.S)C-outdoor1/3.JPG,char_data/K/3.JPG_7.jpg,374,576,768,17,428,445,56,78,True,21
K,23,kaist_dataset/Mixed/Digital_Camera/(C.S)C-outdoor1/3.JPG,char_data/K/3.JPG_8.jpg,230,576,768,10,654,664,292,315,True,21
K,31,kaist_dataset/Mixed/Digital_Camera/(C.S)C-outdoor1/DSC02240.JPG,char_data/K/DSC02240.JPG_2.jpg,806,480,640,26,321,347,282,313,True,21
K,27,kaist_dataset/Mixed/Digital_Camera/(C.S)C-outdoor1/DSC02320.JPG,char_data/K/DSC02320.JPG_2.jpg,459,480,640,17,516,533,249,276,True,21
K,74,kaist_dataset/Mixed/Digital_Camera/(C.S)C-outdoor1/DSC02325.JPG,char_data/K/DSC02325.JPG_2.jpg,3774,480,640,51,219,270,200,274,True,21
K,30,kaist_dataset/Mixed/Digital_Camera/(C.S)C-outdoor2/DSC02391.JPG,char_data/K/DSC02391.JPG_2.jpg,1050,480,640,35,214,249,334,364,True,21
K,141,kaist_dataset/Mixed/Digital_Camera/(C.S)C-outdoor2/DSC02397.JPG,char_data/K/DSC02397.JPG_2.jpg,18189,480,640,129,423,552,294,435,True,21
K,47,kaist_dataset/Mixed/Digital_Camera/(C.S)C-outdoor2/DSC02872.JPG,char_data/K/DSC02872.JPG_2.jpg,1222,480,640,26,313,339,217,264,True,21
K,38,kaist_dataset/Mixed/Digital_Camera/(C.S)C-outdoor2/DSC02886.JPG,char_data/K/DSC02886.JPG_2.jpg,1444,480,640,38,263,301,141,179,True,21
K,72,kaist_dataset/Mixed/Digital_Camera/(C.S)C-outdoor3/DSC03164.JPG,char_data/K/DSC03164.JPG_2.jpg,5040,480,640,70,291,361,83,155,True,21
K,117,kaist_dataset/Mixed/Digital_Camera/(C.S)C-outdoor3/DSC03247.JPG,char_data/K/DSC03247.JPG_2.jpg,9243,480,640,79,58,137,111,228,True,21
K,30,kaist_dataset/Mixed/Digital_Camera/(C.S)C-outdoor3/DSC03255.JPG,char_data/K/DSC03255.JPG_2.jpg,390,480,640,13,553,566,174,204,True,21
K,69,kaist_dataset/Mixed/Digital_Camera/(C.S)C-outdoor3/DSC03265.JPG,char_data/K/DSC03265.JPG_2.jpg,3588,480,640,52,206,258,194,263,True,21
K,84,kaist_dataset/Mixed/Digital_Camera/(C.S)C-outdoor3/DSC03266.JPG,char_data/K/DSC03266.JPG_2.jpg,5292,480,640,63,183,246,164,248,True,21
K,48,kaist_dataset/Mixed/Digital_Camera/(C.S)C-outdoor3/DSC03428.JPG,char_data/K/DSC03428.JPG_2.jpg,1920,480,640,40,115,155,318,366,True,21
K,35,kaist_dataset/Mixed/Digital_Camera/(C.S)C-outdoor3/DSC03429.JPG,char_data/K/DSC03429.JPG_2.jpg,980,480,640,28,396,424,203,238,True,21
K,31,kaist_dataset/Mixed/Digital_Camera/(C.S)C-outdoor3/DSC03430.JPG,char_data/K/DSC03430.JPG_2.jpg,651,480,640,21,191,212,240,271,True,21
K,55,kaist_dataset/Mixed/Digital_Camera/(C.S)C-outdoor4/DSC03433.JPG,char_data/K/DSC03433.JPG_2.jpg,1870,480,640,34,87,121,378,433,True,21
K,63,kaist_dataset/Mixed/Digital_Camera/(C.S)C-outdoor4/DSC03533.JPG,char_data/K/DSC03533.JPG_2.jpg,2709,480,640,43,85,128,297,360,True,21
K,87,kaist_dataset/Mixed/Digital_Camera/(C.S)C-outdoor4/DSC03534.JPG,char_data/K/DSC03534.JPG_2.jpg,4437,480,640,51,25,76,132,219,True,21
K,30,kaist_dataset/Mixed/Digital_Camera/(C.S)C-outdoor4/DSC03556.JPG,char_data/K/DSC03556.JPG_5.jpg,570,480,640,19,561,580,322,352,True,21
K,46,kaist_dataset/Mixed/Digital_Camera/(C.S)C-outdoor4/DSC03604.JPG,char_data/K/DSC03604.JPG_2.jpg,1886,480,640,41,239,280,209,255,True,21
K,52,kaist_dataset/Mixed/Digital_Camera/(C.S)C-outdoor4/DSC03711.JPG,char_data/K/DSC03711.JPG_2.jpg,1664,480,640,32,11,43,383,435,False,21
K,36,kaist_dataset/Mixed/Digital_Camera/(C.S)C-outdoor4/DSC03716.JPG,char_data/K/DSC03716.JPG_2.jpg,540,480,640,15,329,344,234,270,False,21
K,65,kaist_dataset/Mixed/Digital_Camera/(C.S)C-outdoor4/DSC03756.JPG,char_data/K/DSC03756.JPG_2.jpg,3250,480,640,50,492,542,387,452,False,21
K,79,kaist_dataset/Mixed/Digital_Camera/(C.S)C-outdoor5/DSC03822.JPG,char_data/K/DSC03822.JPG_2.jpg,4582,480,640,58,403,461,81,160,False,21
K,111,kaist_dataset/Mixed/Digital_Camera/(C.S)C-outdoor5/DSC03823.JPG,char_data/K/DSC03823.JPG_2.jpg,9102,480,640,82,319,401,75,186,False,21
K,99,kaist_dataset/Mixed/Digital_Camera/(C.S)C-outdoor5/DSC03839.JPG,char_data/K/DSC03839.JPG_2.jpg,8811,480,640,89,354,443,195,294,False,21
K,44,kaist_dataset/Mixed/Digital_Camera/(C.S)C-outdoor5/DSC03847.JPG,char_data/K/DSC03847.JPG_2.jpg,1540,480,640,35,245,280,91,135,False,21
K,62,kaist_dataset/Mixed/Digital_Camera/(C.S)C-outdoor5/DSC04014.JPG,char_data/K/DSC04014.JPG_2.jpg,2852,480,640,46,185,231,100,162,False,21
K,38,kaist_dataset/Mixed/Digital_Camera/(C.S)C-outdoor5/DSC04063.JPG,char_data/K/DSC04063.JPG_2.jpg,912,480,640,24,601,625,310,348,False,21
K,43,kaist_dataset/Mixed/Digital_Camera/(C.S)C-outdoor5/DSC04065.JPG,char_data/K/DSC04065.JPG_2.jpg,1505,480,640,35,478,513,136,179,False,21
K,43,kaist_dataset/Mixed/Digital_Camera/(C.S)C-outdoor5/DSC04098.JPG,char_data/K/DSC04098.JPG_2.jpg,1462,480,640,34,389,423,72,115,False,21
K,43,kaist_dataset/Mixed/Digital_Camera/(C.S)C-outdoor5/DSC04139.JPG,char_data/K/DSC04139.JPG_2.jpg,1247,480,640,29,265,294,87,130,False,21
K,39,kaist_dataset/Mixed/Digital_Camera/(C.S)C-outdoor5/DSC04434.JPG,char_data/K/DSC04434.JPG_2.jpg,819,480,640,21,311,332,268,307,False,21
K,23,kaist_dataset/Mixed/Digital_Camera/(C.S)C-outdoor6/P1010065.JPG,char_data/K/P1010065.JPG_2.jpg,529,480,640,23,48,71,105,128,False,21
K,44,kaist_dataset/Mixed/Digital_Camera/(C.S)C-outdoor6/P1010132.JPG,char_data/K/P1010132.JPG_2.jpg,1452,480,640,33,170,203,159,203,False,21
K,53,kaist_dataset/Mixed/Digital_Camera/(C.S)D-indoor1/DSC03118.JPG,char_data/K/DSC03118.JPG_2.jpg,1643,480,640,31,130,161,144,197,False,21
K,47,kaist_dataset/Mixed/Digital_Camera/(C.S)D-indoor1/DSC03980.JPG,char_data/K/DSC03980.JPG_4.jpg,1128,480,640,24,153,177,126,173,False,21
K,40,kaist_dataset/Mixed/Digital_Camera/(C.S)D-indoor1/DSC03980.JPG,char_data/K/DSC03980.JPG_5.jpg,1160,480,640,29,265,294,137,177,False,21
K,43,kaist_dataset/Mixed/Digital_Camera/(C.S)D-indoor1/DSC04009.JPG,char_data/K/DSC04009.JPG_2.jpg,1591,480,640,37,450,487,405,448,False,21
K,40,kaist_dataset/Mixed/Digital_Camera/(C.S)E-night/DSC03871.JPG,char_data/K/DSC03871.JPG_2.jpg,1360,480,640,34,119,153,181,221,False,21
K,49,kaist_dataset/Mixed/Digital_Camera/(C.S)E-night/사진9.jpg수정.jpg,char_data/K/사진9.jpg수정.jpg_2.jpg,2058,480,680,42,261,303,203,252,False,21
K,70,kaist_dataset/Mixed/Mobile_Phone/(C.M)A-outdoor/P090903099.jpg,char_data/K/P090903099.jpg_2.jpg,3430,480,640,49,29,78,163,233,False,21
K,30,kaist_dataset/Mixed/Mobile_Phone/(C.M)A-outdoor/P090908006.jpg,char_data/K/P090908006.jpg_2.jpg,720,480,640,24,15,39,376,406,False,21
K,45,kaist_dataset/Mixed/Mobile_Phone/(C.M)B-indoor/P090831021.jpg,char_data/K/P090831021.jpg_2.jpg,1665,480,640,37,221,258,40,85,False,21
교,59,kaist_dataset/Korean/Digital_Camera/E-night/DSC03876.JPG,char_data/교/DSC03876.JPG_2.jpg,2832,480,640,48,361,409,288,347,True,50
교,116,kaist_dataset/Korean/Digital_Camera/F-bookCover/DSC02830.JPG,char_data/교/DSC02830.JPG_2.jpg,14500,480,640,125,48,173,170,286,True,50
교,94,kaist_dataset/Korean/Digital_Camera/indoor1/DSC02742.JPG,char_data/교/DSC02742.JPG_2.jpg,13066,480,640,139,346,485,262,356,True,50
교,54,kaist_dataset/Korean/Digital_Camera/indoor1/DSC03092.JPG,char_data/교/DSC03092.JPG_2.jpg,3024,480,640,56,561,617,94,148,True,50
교,72,kaist_dataset/Korean/Digital_Camera/indoor2/DSC03530.JPG,char_data/교/DSC03530.JPG_2.jpg,7200,480,640,100,416,516,362,434,True,50
교,80,kaist_dataset/Korean/Digital_Camera/indoor2/DSC03975.JPG,char_data/교/DSC03975.JPG_2.jpg,4320,480,640,54,413,467,186,266,True,50
교,113,kaist_dataset/Korean/Digital_Camera/indoor2/DSC03977.JPG,char_data/교/DSC03977.JPG_2.jpg,10170,480,640,90,436,526,85,198,True,50
교,60,kaist_dataset/Korean/Digital_Camera/indoor2/DSC04186.JPG,char_data/교/DSC04186.JPG_2.jpg,3420,480,640,57,339,396,75,135,True,50
교,60,kaist_dataset/Korean/Digital_Camera/outdoor1/051.JPG,char_data/교/051.JPG_2.jpg,3780,480,640,63,283,346,193,253,True,50
교,58,kaist_dataset/Korean/Digital_Camera/outdoor1/100.jpg,char_data/교/100.jpg_2.jpg,3306,480,640,57,348,405,141,199,True,50
교,88,kaist_dataset/Korean/Digital_Camera/outdoor1/128.JPG,char_data/교/128.JPG_2.jpg,7392,480,640,84,421,505,181,269,True,50
교,66,kaist_dataset/Korean/Digital_Camera/outdoor1/2007-12-08-day-065.jpg,char_data/교/2007-12-08-day-065.jpg_4.jpg,4818,1600,1200,73,314,387,417,483,True,50
교,134,kaist_dataset/Korean/Digital_Camera/outdoor1/2007-12-08-day-065.jpg,char_data/교/2007-12-08-day-065.jpg_5.jpg,14204,1600,1200,106,795,901,522,656,True,50
교,69,kaist_dataset/Korean/Digital_Camera/outdoor2/DSC02468.JPG,char_data/교/DSC02468.JPG_2.jpg,6072,480,640,88,428,516,216,285,True,50
교,60,kaist_dataset/Korean/Digital_Camera/outdoor2/DSC02485.JPG,char_data/교/DSC02485.JPG_4.jpg,3360,480,640,56,440,496,181,241,True,50
교,35,kaist_dataset/Korean/Digital_Camera/outdoor2/DSC02485.JPG,char_data/교/DSC02485.JPG_5.jpg,1260,480,640,36,492,528,279,314,True,50
교,35,kaist_dataset/Korean/Digital_Camera/outdoor2/DSC02488.JPG,char_data/교/DSC02488.JPG_2.jpg,770,480,640,22,528,550,332,367,True,50
교,48,kaist_dataset/Korean/Digital_Camera/outdoor2/DSC02499.JPG,char_data/교/DSC02499.JPG_2.jpg,3168,480,640,66,528,594,1,49,True,50
교,102,kaist_dataset/Korean/Digital_Camera/outdoor3/DSC02561.JPG,char_data/교/DSC02561.JPG_2.jpg,8466,480,640,83,421,504,199,301,True,50
교,51,kaist_dataset/Korean/Digital_Camera/outdoor3/DSC03070.JPG,char_data/교/DSC03070.JPG_2.jpg,1581,480,640,31,268,299,213,264,True,50
교,32,kaist_dataset/Korean/Digital_Camera/outdoor3/DSC03232.JPG,char_data/교/DSC03232.JPG_2.jpg,1024,480,640,32,41,73,291,323,True,50
교,56,kaist_dataset/Korean/Digital_Camera/outdoor4/DSC03339.JPG,char_data/교/DSC03339.JPG_2.jpg,2856,480,640,51,361,412,203,259,True,50
교,79,kaist_dataset/Korean/Digital_Camera/outdoor4/DSC03555.JPG,char_data/교/DSC03555.JPG_2.jpg,6004,480,640,76,329,405,202,281,True,50
교,77,kaist_dataset/Korean/Digital_Camera/outdoor4/DSC03590.JPG,char_data/교/DSC03590.JPG_2.jpg,5236,480,640,68,142,210,115,192,True,50
교,71,kaist_dataset/Korean/Digital_Camera/outdoor4/DSC03598.JPG,char_data/교/DSC03598.JPG_2.jpg,4615,480,640,65,488,553,88,159,True,50
교,88,kaist_dataset/Korean/Digital_Camera/outdoor4/DSC03599.JPG,char_data/교/DSC03599.JPG_2.jpg,8272,480,640,94,461,555,105,193,True,50
교,64,kaist_dataset/Korean/Digital_Camera/outdoor4/DSC03600.JPG,char_data/교/DSC03600.JPG_2.jpg,4160,480,640,65,500,565,181,245,True,50
교,70,kaist_dataset/Korean/Digital_Camera/outdoor4/DSC03601.JPG,char_data/교/DSC03601.JPG_2.jpg,4130,480,640,59,470,529,158,228,True,50
교,86,kaist_dataset/Korean/Digital_Camera/outdoor4/DSC03610.JPG,char_data/교/DSC03610.JPG_2.jpg,6020,480,640,70,511,581,24,110,True,50
교,65,kaist_dataset/Korean/Digital_Camera/outdoor4/DSC03612.JPG,char_data/교/DSC03612.JPG_2.jpg,3705,480,640,57,473,530,38,103,True,50
교,33,kaist_dataset/Korean/Digital_Camera/outdoor4/DSC03614.JPG,char_data/교/DSC03614.JPG_2.jpg,1782,480,640,54,535,589,267,300,True,50
교,41,kaist_dataset/Korean/Digital_Camera/outdoor4/DSC03622.JPG,char_data/교/DSC03622.JPG_4.jpg,1230,480,640,30,257,287,253,294,True,50
교,52,kaist_dataset/Korean/Digital_Camera/outdoor4/DSC03622.JPG,char_data/교/DSC03622.JPG_5.jpg,1820,480,640,35,546,581,238,290,True,50
교,89,kaist_dataset/Korean/Digital_Camera/outdoor5/DSC03623.JPG,char_data/교/DSC03623.JPG_4.jpg,7120,480,640,80,192,272,111,200,True,50
교,96,kaist_dataset/Korean/Digital_Camera/outdoor5/DSC03623.JPG,char_data/교/DSC03623.JPG_5.jpg,7296,480,640,76,298,374,107,203,True,50
교,105,kaist_dataset/Korean/Digital_Camera/outdoor5/DSC03629.JPG,char_data/교/DSC03629.JPG_2.jpg,6090,480,640,58,124,182,53,158,True,50
교,75,kaist_dataset/Korean/Digital_Camera/outdoor5/DSC03645.JPG,char_data/교/DSC03645.JPG_4.jpg,2100,480,640,28,153,181,214,289,True,50
교,119,kaist_dataset/Korean/Digital_Camera/outdoor5/DSC03645.JPG,char_data/교/DSC03645.JPG_5.jpg,12733,480,640,107,427,534,224,343,True,50
교,68,kaist_dataset/Korean/Digital_Camera/outdoor5/DSC03653.JPG,char_data/교/DSC03653.JPG_2.jpg,3332,480,640,49,134,183,69,137,True,50
교,87,kaist_dataset/Korean/Digital_Camera/outdoor5/DSC03671.JPG,char_data/교/DSC03671.JPG_4.jpg,5568,480,640,64,473,537,309,396,True,50
교,40,kaist_dataset/Korean/Digital_Camera/outdoor5/DSC03671.JPG,char_data/교/DSC03671.JPG_5.jpg,880,480,640,22,66,88,405,445,True,50
교,121,kaist_dataset/Korean/Digital_Camera/outdoor5/DSC03683.JPG,char_data/교/DSC03683.JPG_4.jpg,11979,480,640,99,372,471,107,228,True,50
교,52,kaist_dataset/Korean/Digital_Camera/outdoor5/DSC03683.JPG,char_data/교/DSC03683.JPG_5.jpg,2808,480,640,54,268,322,46,98,True,50
교,83,kaist_dataset/Korean/Digital_Camera/outdoor5/DSC03714.JPG,char_data/교/DSC03714.JPG_2.jpg,6308,480,640,76,440,516,154,237,True,50
교,79,kaist_dataset/Korean/Digital_Camera/outdoor5/DSC03739.JPG,char_data/교/DSC03739.JPG_6.jpg,5293,480,640,67,240,307,181,260,True,50
교,82,kaist_dataset/Korean/Digital_Camera/outdoor5/DSC03739.JPG,char_data/교/DSC03739.JPG_7.jpg,6232,480,640,76,471,547,233,315,True,50
교,74,kaist_dataset/Korean/Digital_Camera/outdoor5/DSC03739.JPG,char_data/교/DSC03739.JPG_8.jpg,3330,480,640,45,514,559,372,446,True,50
교,54,kaist_dataset/Korean/Digital_Camera/outdoor5/DSC03740.JPG,char_data/교/DSC03740.JPG_2.jpg,2646,480,640,49,438,487,213,267,True,50
교,225,kaist_dataset/Korean/Digital_Camera/outdoor5/DSC03749.JPG,char_data/교/DSC03749.JPG_4.jpg,14400,480,640,64,444,508,158,383,True,50
교,54,kaist_dataset/Korean/Digital_Camera/outdoor5/DSC03749.JPG,char_data/교/DSC03749.JPG_5.jpg,1836,480,640,34,160,194,89,143,True,50
교,117,kaist_dataset/Korean/Digital_Camera/outdoor5/DSC03788.JPG,char_data/교/DSC03788.JPG_2.jpg,14976,480,640,128,379,507,26,143,True,50
교,88,kaist_dataset/Korean/Digital_Camera/outdoor6/DSC04077.JPG,char_data/교/DSC04077.JPG_4.jpg,8448,480,640,96,421,517,222,310,True,50
교,29,kaist_dataset/Korean/Digital_Camera/outdoor6/DSC04077.JPG,char_data/교/DSC04077.JPG_5.jpg,638,480,640,22,311,333,191,220,True,50
교,128,kaist_dataset/Korean/Digital_Camera/outdoor6/DSC04099.JPG,char_data/교/DSC04099.JPG_4.jpg,13440,480,640,105,387,492,220,348,True,50
교,33,kaist_dataset/Korean/Digital_Camera/outdoor6/DSC04099.JPG,char_data/교/DSC04099.JPG_5.jpg,1023,480,640,31,312,343,174,207,True,50
교,79,kaist_dataset/Korean/Digital_Camera/outdoor6/DSC04101.JPG,char_data/교/DSC04101.JPG_2.jpg,5767,480,640,73,327,400,366,445,True,50
교,39,kaist_dataset/Korean/Digital_Camera/outdoor6/DSC04116.JPG,char_data/교/DSC04116.JPG_4.jpg,1131,480,640,29,314,343,174,213,True,50
교,98,kaist_dataset/Korean/Digital_Camera/outdoor6/DSC04116.JPG,char_data/교/DSC04116.JPG_5.jpg,8624,480,640,88,415,503,218,316,True,50
교,32,kaist_dataset/Korean/Digital_Camera/outdoor6/DSC04157.JPG,char_data/교/DSC04157.JPG_2.jpg,1024,480,640,32,227,259,178,210,True,50
교,87,kaist_dataset/Korean/Digital_Camera/outdoor6/DSC04359.JPG,char_data/교/DSC04359.JPG_2.jpg,5046,480,640,58,426,484,15,102,True,50
교,61,kaist_dataset/Korean/Digital_Camera/outdoor7/P1010015.JPG,char_data/교/P1010015.JPG_2.jpg,3416,480,640,56,69,125,79,140,True,50
교,82,kaist_dataset/Korean/Digital_Camera/outdoor8/DSC02508.JPG,char_data/교/DSC02508.JPG_2.jpg,8200,480,640,100,393,493,139,221,True,50
교,40,"kaist_dataset/Korean/Mobile_Phone/(M,K)C-outdoor/P090912033.jpg",char_data/교/P090912033.jpg_2.jpg,960,480,640,24,106,130,355,395,True,50
교,109,"kaist_dataset/Korean/Mobile_Phone/(M,K)E-bookCover/P090831031.jpg",char_data/교/P090831031.jpg_2.jpg,11554,480,640,106,116,222,171,280,True,50
교,45,"kaist_dataset/Korean/Mobile_Phone/(M,K)E-bookCover/P090831056.jpg",char_data/교/P090831056.jpg_2.jpg,1485,480,640,33,391,424,306,351,True,50
교,56,"kaist_dataset/Korean/Mobile_Phone/(M,K)E-bookCover/P090831132.jpg",char_data/교/P090831132.jpg_2.jpg,2184,480,640,39,368,407,209,265,True,50
교,39,kaist_dataset/Mixed/Digital_Camera/(C.S)C-outdoor1/2.JPG,char_data/교/2.JPG_2.jpg,1482,576,768,38,201,239,16,55,True,50
교,43,kaist_dataset/Mixed/Digital_Camera/(C.S)C-outdoor2/DSC02413.JPG,char_data/교/DSC02413.JPG_2.jpg,1806,480,640,42,193,235,209,252,True,50
교,59,kaist_dataset/Mixed/Digital_Camera/(C.S)C-outdoor2/DSC02483.JPG,char_data/교/DSC02483.JPG_4.jpg,4838,480,640,82,448,530,179,238,True,50
교,51,kaist_dataset/Mixed/Digital_Camera/(C.S)C-outdoor2/DSC02483.JPG,char_data/교/DSC02483.JPG_5.jpg,2040,480,640,40,474,514,288,339,True,50
교,53,kaist_dataset/Mixed/Digital_Camera/(C.S)C-outdoor2/DSC02533.JPG,char_data/교/DSC02533.JPG_4.jpg,2809,480,640,53,156,209,115,168,True,50
교,129,kaist_dataset/Mixed/Digital_Camera/(C.S)C-outdoor2/DSC02533.JPG,char_data/교/DSC02533.JPG_5.jpg,14061,480,640,109,272,381,196,325,True,50
교,82,kaist_dataset/Mixed/Digital_Camera/(C.S)C-outdoor2/DSC02885.JPG,char_data/교/DSC02885.JPG_2.jpg,6970,480,640,85,378,463,19,101,True,50
교,72,kaist_dataset/Mixed/Digital_Camera/(C.S)C-outdoor2/DSC02887.JPG,char_data/교/DSC02887.JPG_2.jpg,7848,480,640,109,369,478,27,99,True,50
교,41,kaist_dataset/Mixed/Digital_Camera/(C.S)C-outdoor4/DSC03435.JPG,char_data/교/DSC03435.JPG_2.jpg,1312,480,640,32,361,393,74,115,True,50
교,51,kaist_dataset/Mixed/Digital_Camera/(C.S)C-outdoor4/DSC03556.JPG,char_data/교/DSC03556.JPG_2.jpg,1785,480,640,35,412,447,250,301,True,50
교,77,kaist_dataset/Mixed/Digital_Camera/(C.S)C-outdoor4/DSC03586.JPG,char_data/교/DSC03586.JPG_2.jpg,5082,480,640,66,340,406,72,149,True,50
교,141,kaist_dataset/Mixed/Digital_Camera/(C.S)C-outdoor4/DSC03631.JPG,char_data/교/DSC03631.JPG_4.jpg,7614,480,640,54,324,378,181,322,True,50
교,67,kaist_dataset/Mixed/Digital_Camera/(C.S)C-outdoor4/DSC03631.JPG,char_data/교/DSC03631.JPG_5.jpg,2479,480,640,37,157,194,177,244,True,50
교,69,kaist_dataset/Mixed/Digital_Camera/(C.S)C-outdoor4/DSC03642.JPG,char_data/교/DSC03642.JPG_2.jpg,3450,480,640,50,143,193,356,425,True,50
교,106,kaist_dataset/Mixed/Digital_Camera/(C.S)C-outdoor4/DSC03654.JPG,char_data/교/DSC03654.JPG_2.jpg,7314,480,640,69,22,91,143,249,True,50
교,127,kaist_dataset/Mixed/Digital_Camera/(C.S)C-outdoor4/DSC03662.JPG,char_data/교/DSC03662.JPG_4.jpg,14605,480,640,115,376,491,241,368,True,50
교,52,kaist_dataset/Mixed/Digital_Camera/(C.S)C-outdoor4/DSC03662.JPG,char_data/교/DSC03662.JPG_5.jpg,1716,480,640,33,94,127,152,204,True,50
교,46,kaist_dataset/Mixed/Digital_Camera/(C.S)C-outdoor4/DSC03693.JPG,char_data/교/DSC03693.JPG_4.jpg,2484,480,640,54,243,297,356,402,True,50
교,73,kaist_dataset/Mixed/Digital_Camera/(C.S)C-outdoor4/DSC03693.JPG,char_data/교/DSC03693.JPG_5.jpg,6205,480,640,85,363,448,243,316,True,50
교,37,kaist_dataset/Mixed/Digital_Camera/(C.S)C-outdoor4/DSC03730.JPG,char_data/교/DSC03730.JPG_2.jpg,1332,480,640,36,162,198,257,294,True,50
교,39,kaist_dataset/Mixed/Digital_Camera/(C.S)C-outdoor4/DSC03732.JPG,char_data/교/DSC03732.JPG_2.jpg,1833,480,640,47,118,165,398,437,True,50
교,67,kaist_dataset/Mixed/Digital_Camera/(C.S)C-outdoor4/DSC03741.JPG,char_data/교/DSC03741.JPG_2.jpg,3551,480,640,53,479,532,295,362,True,50
교,53,kaist_dataset/Mixed/Digital_Camera/(C.S)C-outdoor4/DSC03773.JPG,char_data/교/DSC03773.JPG_2.jpg,2226,480,640,42,6,48,103,156,True,50
교,110,kaist_dataset/Mixed/Digital_Camera/(C.S)C-outdoor4/DSC03787.JPG,char_data/교/DSC03787.JPG_2.jpg,8030,480,640,73,37,110,126,236,True,50
교,88,kaist_dataset/Mixed/Digital_Camera/(C.S)C-outdoor5/DSC04013.JPG,char_data/교/DSC04013.JPG_2.jpg,3080,480,640,35,376,411,318,406,True,50
교,88,kaist_dataset/Mixed/Digital_Camera/(C.S)C-outdoor5/DSC04016.JPG,char_data/교/DSC04016.JPG_2.jpg,7304,480,640,83,131,214,221,309,True,50
교,115,kaist_dataset/Mixed/Digital_Camera/(C.S)C-outdoor5/DSC04029.JPG,char_data/교/DSC04029.JPG_4.jpg,8740,480,640,76,150,226,40,155,False,50
교,38,kaist_dataset/Mixed/Digital_Camera/(C.S)C-outdoor5/DSC04029.JPG,char_data/교/DSC04029.JPG_5.jpg,1634,480,640,43,443,486,244,282,False,50
교,58,kaist_dataset/Mixed/Digital_Camera/(C.S)C-outdoor5/DSC04094.JPG,char_data/교/DSC04094.JPG_4.jpg,3074,480,640,53,324,377,191,249,False,50
교,110,kaist_dataset/Mixed/Digital_Camera/(C.S)C-outdoor5/DSC04094.JPG,char_data/교/DSC04094.JPG_5.jpg,13860,480,640,126,332,458,263,373,False,50
교,37,kaist_dataset/Mixed/Digital_Camera/(C.S)C-outdoor5/DSC04122.JPG,char_data/교/DSC04122.JPG_2.jpg,999,480,640,27,249,276,411,448,False,50
교,112,kaist_dataset/Mixed/Digital_Camera/(C.S)C-outdoor5/DSC04135.JPG,char_data/교/DSC04135.JPG_2.jpg,4704,480,640,42,414,456,267,379,False,50
교,77,kaist_dataset/Mixed/Digital_Camera/(C.S)C-outdoor5/DSC04139.JPG,char_data/교/DSC04139.JPG_4.jpg,2541,480,640,33,273,306,195,272,False,50
교,64,kaist_dataset/Mixed/Digital_Camera/(C.S)C-outdoor5/DSC04139.JPG,char_data/교/DSC04139.JPG_5.jpg,896,480,640,14,247,261,323,387,False,50
교,79,kaist_dataset/Mixed/Digital_Camera/(C.S)C-outdoor5/DSC04321.JPG,char_data/교/DSC04321.JPG_2.jpg,6399,480,640,81,416,497,119,198,False,50
교,75,kaist_dataset/Mixed/Digital_Camera/(C.S)C-outdoor5/DSC04322.JPG,char_data/교/DSC04322.JPG_2.jpg,5850,480,640,78,450,528,134,209,False,50
교,72,kaist_dataset/Mixed/Digital_Camera/(C.S)C-outdoor5/DSC04449.JPG,char_data/교/DSC04449.JPG_2.jpg,3744,480,640,52,352,404,218,290,False,50
교,39,kaist_dataset/Mixed/Digital_Camera/(C.S)D-indoor1/DSC02751.JPG,char_data/교/DSC02751.JPG_4.jpg,1872,480,640,48,352,400,248,287,False,50
교,44,kaist_dataset/Mixed/Digital_Camera/(C.S)D-indoor1/DSC02751.JPG,char_data/교/DSC02751.JPG_5.jpg,2112,480,640,48,347,395,193,237,False,50
교,69,kaist_dataset/Mixed/Digital_Camera/(C.S)D-indoor1/DSC02752.JPG,char_data/교/DSC02752.JPG_2.jpg,4209,480,640,61,306,367,216,285,False,50
교,59,kaist_dataset/Mixed/Digital_Camera/(C.S)D-indoor1/DSC02755.JPG,char_data/교/DSC02755.JPG_2.jpg,3776,480,640,64,356,420,207,266,False,50
교,76,kaist_dataset/Mixed/Digital_Camera/(C.S)D-indoor1/DSC02756.JPG,char_data/교/DSC02756.JPG_2.jpg,5092,480,640,67,375,442,192,268,False,50
교,58,kaist_dataset/Mixed/Digital_Camera/(C.S)D-indoor1/DSC02776.JPG,char_data/교/DSC02776.JPG_2.jpg,4234,480,640,73,426,499,206,264,False,50
교,81,kaist_dataset/Mixed/Digital_Camera/(C.S)D-indoor1/DSC02780.JPG,char_data/교/DSC02780.JPG_2.jpg,9072,480,640,112,437,549,215,296,False,50
교,71,kaist_dataset/Mixed/Digital_Camera/(C.S)D-indoor1/DSC03998.JPG,char_data/교/DSC03998.JPG_2.jpg,1704,480,640,24,461,485,298,369,False,50
교,131,kaist_dataset/Mixed/Digital_Camera/(C.S)D-indoor1/DSC04002.JPG,char_data/교/DSC04002.JPG_2.jpg,6157,480,640,47,267,314,121,252,False,50
교,55,kaist_dataset/Mixed/Digital_Camera/(C.S)D-indoor2/DSC04254.JPG,char_data/교/DSC04254.JPG_4.jpg,2860,480,640,52,282,334,270,325,False,50
교,53,kaist_dataset/Mixed/Digital_Camera/(C.S)D-indoor2/DSC04254.JPG,char_data/교/DSC04254.JPG_5.jpg,2650,480,640,50,445,495,266,319,False,50
교,149,kaist_dataset/Mixed/Digital_Camera/(C.S)F-others/2007-12-08-day-067.jpg,char_data/교/2007-12-08-day-067.jpg_2.jpg,17731,1600,1200,119,522,641,735,884,False,50
교,40,kaist_dataset/Mixed/Mobile_Phone/(C.M)C-bookCover/P090903009.jpg,char_data/교/P090903009.jpg_2.jpg,1240,480,640,31,25,56,346,386,False,50
d,84,kaist_dataset/English/Digital_Camera/(E.S)A-shadow/DSC03084.JPG,char_data/d/DSC03084.JPG_4.jpg,2772,480,640,33,92,125,341,425,True,33
d,79,kaist_dataset/English/Digital_Camera/(E.S)A-shadow/DSC03084.JPG,char_data/d/DSC03084.JPG_5.jpg,1896,480,640,24,446,470,347,426,True,33
d,43,kaist_dataset/English/Digital_Camera/(E.S)C-outdoor1/077.JPG,char_data/d/077.JPG_2.jpg,1720,480,640,40,250,290,203,246,True,33
d,200,kaist_dataset/English/Digital_Camera/(E.S)C-outdoor1/2007-12-08-day-015.jpg,char_data/d/2007-12-08-day-015.jpg_4.jpg,43000,1200,1600,215,1189,1404,451,651,True,33
d,50,kaist_dataset/English/Digital_Camera/(E.S)C-outdoor1/2007-12-08-day-015.jpg,char_data/d/2007-12-08-day-015.jpg_5.jpg,1300,1200,1600,26,714,740,804,854,True,33
d,52,kaist_dataset/English/Digital_Camera/(E.S)C-outdoor1/DSC02355.JPG,char_data/d/DSC02355.JPG_2.jpg,1144,480,640,22,255,277,300,352,True,33
d,64,kaist_dataset/English/Digital_Camera/(E.S)C-outdoor1/DSC02514.JPG,char_data/d/DSC02514.JPG_2.jpg,2432,480,640,38,412,450,182,246,True,33
d,98,kaist_dataset/English/Digital_Camera/(E.S)C-outdoor1/DSC02524.JPG,char_data/d/DSC02524.JPG_2.jpg,5390,480,640,55,217,272,307,405,True,33
d,45,kaist_dataset/English/Digital_Camera/(E.S)C-outdoor2/DSC03165.JPG,char_data/d/DSC03165.JPG_2.jpg,1620,480,640,36,313,349,238,283,True,33
d,93,kaist_dataset/English/Digital_Camera/(E.S)C-outdoor2/DSC03200.JPG,char_data/d/DSC03200.JPG_2.jpg,6045,480,640,65,160,225,221,314,True,33
d,47,kaist_dataset/English/Digital_Camera/(E.S)C-outdoor2/DSC03201.JPG,char_data/d/DSC03201.JPG_2.jpg,1551,480,640,33,363,396,146,193,True,33
d,59,kaist_dataset/English/Digital_Camera/(E.S)C-outdoor2/DSC03277.JPG,char_data/d/DSC03277.JPG_2.jpg,2773,480,640,47,260,307,186,245,True,33
d,55,kaist_dataset/English/Digital_Camera/(E.S)C-outdoor2/DSC04035.JPG,char_data/d/DSC04035.JPG_2.jpg,1705,480,640,31,227,258,190,245,True,33
d,68,kaist_dataset/English/Digital_Camera/(E.S)C-outdoor2/DSC04066.JPG,char_data/d/DSC04066.JPG_2.jpg,2720,480,640,40,471,511,330,398,True,33
d,48,kaist_dataset/English/Digital_Camera/(E.S)C-outdoor2/DSC04079.JPG,char_data/d/DSC04079.JPG_2.jpg,1392,480,640,29,198,227,111,159,True,33
d,151,kaist_dataset/English/Digital_Camera/(E.S)C-outdoor2/DSC04431.JPG,char_data/d/DSC04431.JPG_2.jpg,15100,480,640,100,465,565,102,253,True,33
d,30,kaist_dataset/English/Digital_Camera/(E.S)C-outdoor2/DSC04437.JPG,char_data/d/DSC04437.JPG_2.jpg,420,480,640,14,269,283,43,73,True,33
d,106,kaist_dataset/English/Digital_Camera/(E.S)C-outdoor2/IMG_2618.JPG,char_data/d/IMG_2618.JPG_2.jpg,3180,279,640,30,588,618,164,270,True,33
d,30,kaist_dataset/English/Digital_Camera/(E.S)C-outdoor3/P1010123.JPG,char_data/d/P1010123.JPG_4.jpg,330,480,640,11,558,569,67,97,True,33
d,33,kaist_dataset/English/Digital_Camera/(E.S)C-outdoor3/P1010123.JPG,char_data/d/P1010123.JPG_5.jpg,495,480,640,15,65,80,69,102,True,33
d,49,kaist_dataset/English/Digital_Camera/(E.S)D-indoor/080119-0009.jpg,char_data/d/080119-0009.jpg_12.jpg,1519,1200,1600,31,760,791,668,717,True,33
d,49,kaist_dataset/English/Digital_Camera/(E.S)D-indoor/080119-0009.jpg,char_data/d/080119-0009.jpg_13.jpg,980,1200,1600,20,657,677,1028,1077,True,33
d,43,kaist_dataset/English/Digital_Camera/(E.S)D-indoor/080119-0009.jpg,char_data/d/080119-0009.jpg_14.jpg,817,1200,1600,19,731,750,1051,1094,True,33
d,46,kaist_dataset/English/Digital_Camera/(E.S)D-indoor/080119-0009.jpg,char_data/d/080119-0009.jpg_15.jpg,1012,1200,1600,22,689,711,1083,1129,True,33
d,44,kaist_dataset/English/Digital_Camera/(E.S)D-indoor/080119-0009.jpg,char_data/d/080119-0009.jpg_16.jpg,1144,1200,1600,26,789,815,1109,1153,True,33
d,81,kaist_dataset/English/Digital_Camera/(E.S)D-indoor/DSC02853.JPG,char_data/d/DSC02853.JPG_2.jpg,4050,480,640,50,405,455,129,210,True,33
d,67,kaist_dataset/English/Digital_Camera/(E.S)D-indoor/DSC03078.JPG,char_data/d/DSC03078.JPG_2.jpg,2412,480,640,36,237,273,295,362,True,33
d,47,kaist_dataset/English/Digital_Camera/(E.S)D-indoor/DSC03090.JPG,char_data/d/DSC03090.JPG_2.jpg,1269,480,640,27,391,418,234,281,True,33
d,75,kaist_dataset/English/Digital_Camera/(E.S)D-indoor/DSC03093.JPG,char_data/d/DSC03093.JPG_2.jpg,3900,480,640,52,412,464,113,188,True,33
d,42,kaist_dataset/English/Digital_Camera/(E.S)D-indoor/DSC03112.JPG,char_data/d/DSC03112.JPG_4.jpg,1092,480,640,26,421,447,205,247,True,33
d,53,kaist_dataset/English/Digital_Camera/(E.S)D-indoor/DSC03112.JPG,char_data/d/DSC03112.JPG_5.jpg,2226,480,640,42,363,405,259,312,True,33
d,37,kaist_dataset/English/Digital_Camera/(E.S)D-indoor/DSC03144.JPG,char_data/d/DSC03144.JPG_4.jpg,962,480,640,26,456,482,234,271,True,33
d,36,kaist_dataset/English/Digital_Camera/(E.S)D-indoor/DSC03144.JPG,char_data/d/DSC03144.JPG_5.jpg,900,480,640,25,462,487,287,323,True,33
d,36,kaist_dataset/English/Digital_Camera/(E.S)D-indoor/DSC03145.JPG,char_data/d/DSC03145.JPG_4.jpg,864,480,640,24,358,382,176,212,True,33
d,41,kaist_dataset/English/Digital_Camera/(E.S)D-indoor/DSC03145.JPG,char_data/d/DSC03145.JPG_5.jpg,1107,480,640,27,351,378,119,160,True,33
d,38,kaist_dataset/English/Digital_Camera/(E.S)D-indoor/DSC03146.JPG,char_data/d/DSC03146.JPG_4.jpg,1102,480,640,29,499,528,232,270,True,33
d,39,kaist_dataset/English/Digital_Camera/(E.S)D-indoor/DSC03146.JPG,char_data/d/DSC03146.JPG_5.jpg,975,480,640,25,505,530,178,217,True,33
d,32,kaist_dataset/English/Digital_Camera/(E.S)D-indoor/DSC03147.JPG,char_data/d/DSC03147.JPG_4.jpg,800,480,640,25,482,507,295,327,True,33
d,38,kaist_dataset/English/Digital_Camera/(E.S)D-indoor/DSC03147.JPG,char_data/d/DSC03147.JPG_5.jpg,988,480,640,26,478,504,235,273,True,33
d,44,kaist_dataset/English/Digital_Camera/(E.S)D-indoor/DSC03149.JPG,char_data/d/DSC03149.JPG_2.jpg,1276,480,640,29,203,232,387,431,True,33
d,53,kaist_dataset/English/Digital_Camera/(E.S)D-indoor/DSC03345.JPG,char_data/d/DSC03345.JPG_2.jpg,2014,480,640,38,170,208,95,148,True,33
d,112,kaist_dataset/English/Digital_Camera/(E.S)D-indoor/DSC03398.JPG,char_data/d/DSC03398.JPG_4.jpg,10192,480,640,91,213,304,306,418,True,33
d,116,kaist_dataset/English/Digital_Camera/(E.S)D-indoor/DSC03398.JPG,char_data/d/DSC03398.JPG_5.jpg,9976,480,640,86,334,420,307,423,True,33
d,31,kaist_dataset/English/Digital_Camera/(E.S)D-indoor/DSC03532.JPG,char_data/d/DSC03532.JPG_2.jpg,620,480,640,20,295,315,381,412,True,33
d,104,kaist_dataset/English/Digital_Camera/(E.S)D-indoor/DSC03918.JPG,char_data/d/DSC03918.JPG_4.jpg,7384,480,640,71,200,271,267,371,True,33
d,106,kaist_dataset/English/Digital_Camera/(E.S)D-indoor/DSC03918.JPG,char_data/d/DSC03918.JPG_5.jpg,7208,480,640,68,290,358,265,371,True,33
d,51,kaist_dataset/English/Digital_Camera/(E.S)D-indoor/DSC03947.JPG,char_data/d/DSC03947.JPG_4.jpg,1683,480,640,33,402,435,269,320,True,33
d,41,kaist_dataset/English/Digital_Camera/(E.S)D-indoor/DSC03947.JPG,char_data/d/DSC03947.JPG_5.jpg,1271,480,640,31,404,435,424,465,True,33
d,39,kaist_dataset/English/Digital_Camera/(E.S)F-others/080119-0007.jpg,char_data/d/080119-0007.jpg_2.jpg,702,1200,1600,18,910,928,880,919,True,33
d,197,kaist_dataset/English/Digital_Camera/(E.S)F-others/080119-0014.jpg,char_data/d/080119-0014.jpg_2.jpg,18321,1200,1600,93,769,862,512,709,True,33
d,84,kaist_dataset/English/Mobile_Phone/(E.M)A-outdoor/P090911071.jpg,char_data/d/P090911071.jpg_2.jpg,4200,480,640,50,232,282,120,204,True,33
d,69,kaist_dataset/English/Mobile_Phone/(E.M)A-outdoor/P090912072.jpg,char_data/d/P090912072.jpg_2.jpg,3174,480,640,46,159,205,21,90,True,33
d,70,kaist_dataset/English/Mobile_Phone/(E.M)B-indoor/P090902018.jpg,char_data/d/P090902018.jpg_2.jpg,2310,480,640,33,321,354,292,362,True,33
d,61,kaist_dataset/English/Mobile_Phone/(E.M)B-indoor/P090911060.jpg,char_data/d/P090911060.jpg_2.jpg,2135,480,640,35,365,400,16,77,True,33
d,90,kaist_dataset/English/Mobile_Phone/(E.M)B-indoor/P090911083.jpg,char_data/d/P090911083.jpg_2.jpg,5310,480,640,59,238,297,194,284,True,33
d,30,kaist_dataset/Korean/Digital_Camera/indoor1/080119-0029.jpg,char_data/d/080119-0029.jpg_2.jpg,480,1200,1600,16,736,752,648,678,True,33
d,24,kaist_dataset/Korean/Digital_Camera/outdoor1/001.JPG,char_data/d/001.JPG_2.jpg,360,480,640,15,398,413,237,261,True,33
d,36,kaist_dataset/Korean/Digital_Camera/outdoor1/2007-12-08-day-087.jpg,char_data/d/2007-12-08-day-087.jpg_2.jpg,936,1200,1600,26,146,172,500,536,True,33
d,52,kaist_dataset/Korean/Digital_Camera/outdoor2/080118-0018.jpg,char_data/d/080118-0018.jpg_5.jpg,1924,1200,1600,37,1023,1060,680,732,True,33
d,45,kaist_dataset/Mixed/Digital_Camera/(C.S)A-shadow/DSC02609.JPG,char_data/d/DSC02609.JPG_14.jpg,1260,480,640,28,434,462,291,336,True,33
d,116,kaist_dataset/Mixed/Digital_Camera/(C.S)B-light/DSC04404.JPG,char_data/d/DSC04404.JPG_2.jpg,8816,480,640,76,402,478,200,316,True,33
d,22,kaist_dataset/Mixed/Digital_Camera/(C.S)C-outdoor1/003.JPG,char_data/d/003.JPG_2.jpg,308,480,640,14,338,352,257,279,True,33
d,30,kaist_dataset/Mixed/Digital_Camera/(C.S)C-outdoor1/086.JPG,char_data/d/086.JPG_2.jpg,450,480,640,15,269,284,332,362,True,33
d,40,kaist_dataset/Mixed/Digital_Camera/(C.S)C-outdoor1/1.JPG,char_data/d/1.JPG_6.jpg,960,576,768,24,376,400,5,45,True,33
d,44,kaist_dataset/Mixed/Digital_Camera/(C.S)C-outdoor1/1.JPG,char_data/d/1.JPG_7.jpg,1188,576,768,27,663,690,9,53,True,33
d,40,kaist_dataset/Mixed/Digital_Camera/(C.S)C-outdoor1/115.JPG,char_data/d/115.JPG_2.jpg,920,480,640,23,289,312,268,308,True,33
d,86,kaist_dataset/Mixed/Digital_Camera/(C.S)C-outdoor1/2007-12-08-day-106.jpg,char_data/d/2007-12-08-day-106.jpg_2.jpg,5074,1200,1600,59,532,591,723,809,True,33
d,31,kaist_dataset/Mixed/Digital_Camera/(C.S)C-outdoor1/DSC02242.JPG,char_data/d/DSC02242.JPG_5.jpg,527,480,640,17,315,332,161,192,True,33
d,48,kaist_dataset/Mixed/Digital_Camera/(C.S)C-outdoor1/DSC02320.JPG,char_data/d/DSC02320.JPG_2.jpg,1824,480,640,38,393,431,223,271,True,33
d,50,kaist_dataset/Mixed/Digital_Camera/(C.S)C-outdoor2/DSC02411.JPG,char_data/d/DSC02411.JPG_5.jpg,900,480,640,18,217,235,346,396,True,33
d,67,kaist_dataset/Mixed/Digital_Camera/(C.S)C-outdoor2/DSC02416.JPG,char_data/d/DSC02416.JPG_2.jpg,3551,480,640,53,246,299,203,270,True,33
d,25,kaist_dataset/Mixed/Digital_Camera/(C.S)C-outdoor2/DSC02421.JPG,char_data/d/DSC02421.JPG_5.jpg,600,480,640,24,477,501,208,233,True,33
d,34,kaist_dataset/Mixed/Digital_Camera/(C.S)C-outdoor2/DSC02545.JPG,char_data/d/DSC02545.JPG_2.jpg,748,480,640,22,381,403,363,397,True,33
d,57,kaist_dataset/Mixed/Digital_Camera/(C.S)C-outdoor2/DSC02869.JPG,char_data/d/DSC02869.JPG_2.jpg,1311,480,640,23,163,186,130,187,True,33
d,41,kaist_dataset/Mixed/Digital_Camera/(C.S)C-outdoor2/DSC02936.JPG,char_data/d/DSC02936.JPG_2.jpg,738,480,640,18,211,229,75,116,True,33
d,50,kaist_dataset/Mixed/Digital_Camera/(C.S)C-outdoor3/DSC02962.JPG,char_data/d/DSC02962.JPG_2.jpg,2400,480,640,48,152,200,279,329,True,33
d,73,kaist_dataset/Mixed/Digital_Camera/(C.S)C-outdoor3/DSC03047.JPG,char_data/d/DSC03047.JPG_2.jpg,2409,480,640,33,388,421,183,256,True,33
d,39,kaist_dataset/Mixed/Digital_Camera/(C.S)C-outdoor3/DSC03186.JPG,char_data/d/DSC03186.JPG_2.jpg,1053,480,640,27,101,128,102,141,True,33
d,105,kaist_dataset/Mixed/Digital_Camera/(C.S)C-outdoor3/DSC03190.JPG,char_data/d/DSC03190.JPG_2.jpg,8925,480,640,85,279,364,206,311,True,33
d,68,kaist_dataset/Mixed/Digital_Camera/(C.S)C-outdoor3/DSC03422.JPG,char_data/d/DSC03422.JPG_2.jpg,1972,480,640,29,368,397,252,320,True,33
d,54,kaist_dataset/Mixed/Digital_Camera/(C.S)C-outdoor4/DSC03642.JPG,char_data/d/DSC03642.JPG_2.jpg,1512,480,640,28,201,229,244,298,True,33
d,64,kaist_dataset/Mixed/Digital_Camera/(C.S)C-outdoor4/DSC03643.JPG,char_data/d/DSC03643.JPG_2.jpg,2944,480,640,46,80,126,246,310,True,33
d,43,kaist_dataset/Mixed/Digital_Camera/(C.S)C-outdoor4/DSC03773.JPG,char_data/d/DSC03773.JPG_2.jpg,1548,480,640,36,374,410,283,326,True,33
d,46,kaist_dataset/Mixed/Digital_Camera/(C.S)C-outdoor5/DSC03821.JPG,char_data/d/DSC03821.JPG_2.jpg,1334,480,640,29,111,140,26,72,True,33
d,90,kaist_dataset/Mixed/Digital_Camera/(C.S)C-outdoor5/DSC04030.JPG,char_data/d/DSC04030.JPG_2.jpg,5490,480,640,61,147,208,172,262,True,33
d,36,kaist_dataset/Mixed/Digital_Camera/(C.S)C-outdoor5/DSC04070.JPG,char_data/d/DSC04070.JPG_2.jpg,612,480,640,17,141,158,109,145,True,33
d,30,kaist_dataset/Mixed/Digital_Camera/(C.S)C-outdoor5/DSC04091.JPG,char_data/d/DSC04091.JPG_2.jpg,570,480,640,19,304,323,428,458,True,33
d,50,kaist_dataset/Mixed/Digital_Camera/(C.S)C-outdoor5/DSC04322.JPG,char_data/d/DSC04322.JPG_2.jpg,1300,480,640,26,133,159,209,259,True,33
d,39,kaist_dataset/Mixed/Digital_Camera/(C.S)C-outdoor5/DSC04323.JPG,char_data/d/DSC04323.JPG_2.jpg,819,480,640,21,189,210,200,239,True,33
d,107,kaist_dataset/Mixed/Digital_Camera/(C.S)C-outdoor5/DSC04349.JPG,char_data/d/DSC04349.JPG_2.jpg,7276,480,640,68,256,324,75,182,True,33
d,36,kaist_dataset/Mixed/Digital_Camera/(C.S)C-outdoor6/002.jpg,char_data/d/002.jpg_2.jpg,1368,240,352,38,88,126,53,89,True,33
d,194,kaist_dataset/Mixed/Digital_Camera/(C.S)C-outdoor6/080116-0057.jpg,char_data/d/080116-0057.jpg_6.jpg,26772,1200,1600,138,684,822,526,720,False,33
d,57,kaist_dataset/Mixed/Digital_Camera/(C.S)C-outdoor6/080116-0057.jpg,char_data/d/080116-0057.jpg_7.jpg,1938,1200,1600,34,894,928,822,879,False,33
d,63,kaist_dataset/Mixed/Digital_Camera/(C.S)C-outdoor6/080116-0057.jpg,char_data/d/080116-0057.jpg_8.jpg,2142,1200,1600,34,294,328,904,967,False,33
d,30,kaist_dataset/Mixed/Digital_Camera/(C.S)C-outdoor6/090.jpg,char_data/d/090.jpg_2.jpg,570,480,640,19,306,325,156,186,False,33
d,40,kaist_dataset/Mixed/Digital_Camera/(C.S)D-indoor1/DSC02804.JPG,char_data/d/DSC02804.JPG_2.jpg,840,480,640,21,317,338,349,389,False,33
d,33,kaist_dataset/Mixed/Digital_Camera/(C.S)D-indoor1/DSC03096.JPG,char_data/d/DSC03096.JPG_2.jpg,627,480,640,19,337,356,422,455,False,33
d,49,kaist_dataset/Mixed/Digital_Camera/(C.S)D-indoor1/DSC03118.JPG,char_data/d/DSC03118.JPG_2.jpg,1323,480,640,27,357,384,150,199,False,33
d,39,kaist_dataset/Mixed/Digital_Camera/(C.S)D-indoor1/DSC03122.JPG,char_data/d/DSC03122.JPG_4.jpg,897,480,640,23,280,303,148,187,False,33
d,55,kaist_dataset/Mixed/Digital_Camera/(C.S)D-indoor1/DSC03925.JPG,char_data/d/DSC03925.JPG_2.jpg,2200,480,640,40,457,497,380,435,False,33
d,44,kaist_dataset/Mixed/Digital_Camera/(C.S)D-indoor1/DSC04183.JPG,char_data/d/DSC04183.JPG_4.jpg,968,480,640,22,179,201,246,290,False,33
d,44,kaist_dataset/Mixed/Digital_Camera/(C.S)D-indoor1/DSC04183.JPG,char_data/d/DSC04183.JPG_5.jpg,924,480,640,21,346,367,249,293,False,33
d,40,kaist_dataset/Mixed/Digital_Camera/(C.S)D-indoor1/DSC04246.JPG,char_data/d/DSC04246.JPG_2.jpg,920,480,640,23,271,294,243,283,False,33
d,41,kaist_dataset/Mixed/Digital_Camera/(C.S)D-indoor2/DSC04249.JPG,char_data/d/DSC04249.JPG_2.jpg,1066,480,640,26,229,255,210,251,False,33
d,37,kaist_dataset/Mixed/Digital_Camera/(C.S)D-indoor2/DSC04254.JPG,char_data/d/DSC04254.JPG_2.jpg,814,480,640,22,344,366,335,372,False,33
d,45,kaist_dataset/Mixed/Digital_Camera/(C.S)F-others/DSC02609.JPG,char_data/d/DSC02609.JPG_17.jpg,1260,480,640,28,434,462,291,336,False,33
d,42,kaist_dataset/Mixed/Mobile_Phone/(C.M)B-indoor/P090831005.jpg,char_data/d/P090831005.jpg_2.jpg,798,480,640,19,179,198,235,277,False,33
d,78,kaist_dataset/Mixed/Mobile_Phone/(C.M)B-indoor/P090831008.jpg,char_data/d/P090831008.jpg_2.jpg,4212,480,640,54,207,261,307,385,False,33
d,52,kaist_dataset/Mixed/Mobile_Phone/(C.M)B-indoor/P090831012.jpg,char_data/d/P090831012.jpg_2.jpg,2080,480,640,40,275,315,171,223,False,33
d,65,kaist_dataset/Mixed/Mobile_Phone/(C.M)B-indoor/P090831013.jpg,char_data/d/P090831013.jpg_4.jpg,2080,480,640,32,184,216,180,245,False,33
d,56,kaist_dataset/Mixed/Mobile_Phone/(C.M)B-indoor/P090831013.jpg,char_data/d/P090831013.jpg_5.jpg,2072,480,640,37,380,417,188,244,False,33
d,71,kaist_dataset/Mixed/Mobile_Phone/(C.M)B-indoor/P090831023.jpg,char_data/d/P090831023.jpg_2.jpg,3479,480,640,49,192,241,263,334,False,33
d,43,kaist_dataset/Mixed/Mobile_Phone/(C.M)C-bookCover/P090831080.jpg,char_data/d/P090831080.jpg_2.jpg,1376,480,640,32,383,415,365,408,False,33
d,55,kaist_dataset/Mixed/Mobile_Phone/(C.M)C-bookCover/P090831115.jpg,char_data/d/P090831115.jpg_2.jpg,1320,480,640,24,343,367,156,211,False,33
국,74,kaist_dataset/Korean/Digital_Camera/A-shadow/2007-12-09-day-exterior-031.jpg,char_data/국/2007-12-09-day-exterior-031.jpg_2.jpg,3626,1200,1600,49,1133,1182,972,1046,True,52
국,58,kaist_dataset/Korean/Digital_Camera/A-shadow/DSC04105.JPG,char_data/국/DSC04105.JPG_2.jpg,4118,480,640,71,284,355,133,191,True,52
국,102,kaist_dataset/Korean/Digital_Camera/A-shadow/DSC04373.JPG,char_data/국/DSC04373.JPG_2.jpg,13056,480,640,128,501,629,229,331,True,52
국,69,kaist_dataset/Korean/Digital_Camera/A-shadow/P1010036.JPG,char_data/국/P1010036.JPG_2.jpg,4968,480,640,72,508,580,97,166,True,52
국,73,kaist_dataset/Korean/Digital_Camera/F-bookCover/DSC03929.JPG,char_data/국/DSC03929.JPG_2.jpg,3796,480,640,52,219,271,126,199,True,52
국,59,kaist_dataset/Korean/Digital_Camera/F-bookCover/DSC04235.JPG,char_data/국/DSC04235.JPG_2.jpg,2242,480,640,38,87,125,96,155,True,52
국,75,kaist_dataset/Korean/Digital_Camera/G-others/2007-12-09-day-exterior-083.jpg,char_data/국/2007-12-09-day-exterior-083.jpg_2.jpg,8700,1600,1200,116,579,695,777,852,True,52
국,43,kaist_dataset/Korean/Digital_Camera/indoor1/057.jpg,char_data/국/057.jpg_2.jpg,1032,322,425,24,88,112,236,279,True,52
국,419,kaist_dataset/Korean/Digital_Camera/indoor1/080118-0017.jpg,char_data/국/080118-0017.jpg_2.jpg,168857,1200,1600,403,24,427,391,810,True,52
국,67,kaist_dataset/Korean/Digital_Camera/indoor1/DSC03092.JPG,char_data/국/DSC03092.JPG_2.jpg,3283,480,640,49,191,240,83,150,True,52
국,80,kaist_dataset/Korean/Digital_Camera/indoor1/DSC03097.JPG,char_data/국/DSC03097.JPG_2.jpg,6480,480,640,81,49,130,162,242,True,52
국,50,kaist_dataset/Korean/Digital_Camera/indoor1/DSC03375.JPG,char_data/국/DSC03375.JPG_2.jpg,2300,480,640,46,95,141,33,83,True,52
국,60,kaist_dataset/Korean/Digital_Camera/indoor2/DSC03818.JPG,char_data/국/DSC03818.JPG_2.jpg,3000,480,640,50,525,575,388,448,True,52
국,79,kaist_dataset/Korean/Digital_Camera/indoor2/DSC04175.JPG,char_data/국/DSC04175.JPG_2.jpg,4266,480,640,54,156,210,370,449,True,52
국,112,kaist_dataset/Korean/Digital_Camera/indoor2/DSC04253.JPG,char_data/국/DSC04253.JPG_2.jpg,5264,480,640,47,58,105,95,207,True,52
국,111,kaist_dataset/Korean/Digital_Camera/outdoor1/032.JPG,char_data/국/032.JPG_2.jpg,18759,480,640,169,312,481,144,255,True,52
국,96,kaist_dataset/Korean/Digital_Camera/outdoor1/035.JPG,char_data/국/035.JPG_2.jpg,6336,480,640,66,484,550,184,280,True,52
국,58,kaist_dataset/Korean/Digital_Camera/outdoor1/070.JPG,char_data/국/070.JPG_2.jpg,4234,480,640,73,426,499,189,247,True,52
국,27,kaist_dataset/Korean/Digital_Camera/outdoor1/100.jpg,char_data/국/100.jpg_2.jpg,486,480,640,18,323,341,208,235,True,52
국,131,kaist_dataset/Korean/Digital_Camera/outdoor1/102.JPG,char_data/국/102.JPG_4.jpg,13624,480,640,104,505,609,174,305,True,52
국,30,kaist_dataset/Korean/Digital_Camera/outdoor1/102.JPG,char_data/국/102.JPG_5.jpg,540,480,640,18,590,608,311,341,True,52
국,121,kaist_dataset/Korean/Digital_Camera/outdoor1/120.JPG,char_data/국/120.JPG_2.jpg,10527,480,640,87,478,565,151,272,True,52
국,26,kaist_dataset/Korean/Digital_Camera/outdoor1/2007-12-08-day-047.jpg,char_data/국/2007-12-08-day-047.jpg_8.jpg,520,1200,1600,20,635,655,964,990,True,52
국,22,kaist_dataset/Korean/Digital_Camera/outdoor1/2007-12-08-day-047.jpg,char_data/국/2007-12-08-day-047.jpg_9.jpg,594,1200,1600,27,662,689,940,962,True,52
국,53,kaist_dataset/Korean/Digital_Camera/outdoor1/2007-12-08-day-047.jpg,char_data/국/2007-12-08-day-047.jpg_10.jpg,1643,1200,1600,31,750,781,1023,1076,True,52
국,62,kaist_dataset/Korean/Digital_Camera/outdoor1/2007-12-08-day-047.jpg,char_data/국/2007-12-08-day-047.jpg_11.jpg,1674,1200,1600,27,1239,1266,1003,1065,True,52
국,74,kaist_dataset/Korean/Digital_Camera/outdoor1/2007-12-08-day-065.jpg,char_data/국/2007-12-08-day-065.jpg_2.jpg,4958,1600,1200,67,472,539,423,497,True,52
국,34,kaist_dataset/Korean/Digital_Camera/outdoor2/2007-12-09-day-exterior-035.jpg,char_data/국/2007-12-09-day-exterior-035.jpg_2.jpg,1530,1200,1600,45,574,619,504,538,True,52
국,138,kaist_dataset/Korean/Digital_Camera/outdoor2/2007-12-09-day-exterior-055.jpg,char_data/국/2007-12-09-day-exterior-055.jpg_2.jpg,15180,1200,1600,110,668,778,464,602,True,52
국,146,kaist_dataset/Korean/Digital_Camera/outdoor2/2007-12-09-day-exterior-084.jpg,char_data/국/2007-12-09-day-exterior-084.jpg_2.jpg,20440,1200,1600,140,807,947,616,762,True,52
국,46,kaist_dataset/Korean/Digital_Camera/outdoor2/DSC02396.JPG,char_data/국/DSC02396.JPG_2.jpg,966,480,640,21,59,80,370,416,True,52
국,96,kaist_dataset/Korean/Digital_Camera/outdoor2/DSC02485.JPG,char_data/국/DSC02485.JPG_4.jpg,8544,480,640,89,235,324,174,270,True,52
국,45,kaist_dataset/Korean/Digital_Camera/outdoor2/DSC02485.JPG,char_data/국/DSC02485.JPG_5.jpg,1980,480,640,44,400,444,275,320,True,52
국,110,kaist_dataset/Korean/Digital_Camera/outdoor2/DSC02499.JPG,char_data/국/DSC02499.JPG_2.jpg,12100,480,640,110,477,587,123,233,True,52
국,112,kaist_dataset/Korean/Digital_Camera/outdoor4/DSC03295.JPG,char_data/국/DSC03295.JPG_2.jpg,10080,480,640,90,430,520,289,401,True,52
국,68,kaist_dataset/Korean/Digital_Camera/outdoor4/DSC03325.JPG,char_data/국/DSC03325.JPG_2.jpg,4488,480,640,66,389,455,129,197,True,52
국,50,kaist_dataset/Korean/Digital_Camera/outdoor4/DSC03437.JPG,char_data/국/DSC03437.JPG_2.jpg,2750,480,640,55,149,204,31,81,True,52
국,110,kaist_dataset/Korean/Digital_Camera/outdoor4/DSC03509.JPG,char_data/국/DSC03509.JPG_2.jpg,9900,480,640,90,264,354,37,147,True,52
국,95,kaist_dataset/Korean/Digital_Camera/outdoor5/DSC03626.JPG,char_data/국/DSC03626.JPG_2.jpg,9880,480,640,104,145,249,180,275,True,52
국,37,kaist_dataset/Korean/Digital_Camera/outdoor5/DSC03636.JPG,char_data/국/DSC03636.JPG_2.jpg,1147,480,640,31,164,195,335,372,True,52
국,126,kaist_dataset/Korean/Digital_Camera/outdoor5/DSC03647.JPG,char_data/국/DSC03647.JPG_2.jpg,16002,480,640,127,459,586,257,383,True,52
국,58,kaist_dataset/Korean/Digital_Camera/outdoor5/DSC03790.JPG,char_data/국/DSC03790.JPG_2.jpg,2958,480,640,51,203,254,163,221,True,52
국,71,kaist_dataset/Korean/Digital_Camera/outdoor5/DSC03791.JPG,char_data/국/DSC03791.JPG_2.jpg,5112,480,640,72,222,294,75,146,True,52
국,28,kaist_dataset/Korean/Digital_Camera/outdoor5/DSC03832.JPG,char_data/국/DSC03832.JPG_2.jpg,672,480,640,24,371,395,68,96,True,52
국,125,kaist_dataset/Korean/Digital_Camera/outdoor5/DSC03868.JPG,char_data/국/DSC03868.JPG_2.jpg,9625,480,640,77,12,89,224,349,True,52
국,57,kaist_dataset/Korean/Digital_Camera/outdoor6/DSC04043.JPG,char_data/국/DSC04043.JPG_4.jpg,1083,480,640,19,43,62,213,270,True,52
국,51,kaist_dataset/Korean/Digital_Camera/outdoor6/DSC04043.JPG,char_data/국/DSC04043.JPG_5.jpg,1224,480,640,24,414,438,222,273,True,52
국,62,kaist_dataset/Korean/Digital_Camera/outdoor6/DSC04118.JPG,char_data/국/DSC04118.JPG_2.jpg,2542,480,640,41,304,345,189,251,True,52
국,76,kaist_dataset/Korean/Digital_Camera/outdoor6/DSC04147.JPG,char_data/국/DSC04147.JPG_2.jpg,5016,480,640,66,399,465,91,167,True,52
국,89,kaist_dataset/Korean/Digital_Camera/outdoor6/DSC04295.JPG,char_data/국/DSC04295.JPG_2.jpg,7476,480,640,84,461,545,105,194,True,52
국,34,kaist_dataset/Korean/Digital_Camera/outdoor6/DSC04343.JPG,char_data/국/DSC04343.JPG_2.jpg,1666,480,640,49,520,569,195,229,True,52
국,91,kaist_dataset/Korean/Digital_Camera/outdoor6/DSC04440.JPG,char_data/국/DSC04440.JPG_2.jpg,7189,480,640,79,505,584,40,131,True,52
국,69,kaist_dataset/Korean/Digital_Camera/outdoor7/DSC04481.JPG,char_data/국/DSC04481.JPG_2.jpg,2760,480,640,40,351,391,226,295,True,52
국,66,kaist_dataset/Korean/Digital_Camera/outdoor7/P1010024.JPG,char_data/국/P1010024.JPG_2.jpg,4752,480,640,72,515,587,126,192,True,52
국,93,kaist_dataset/Korean/Digital_Camera/outdoor7/P1010029.JPG,char_data/국/P1010029.JPG_2.jpg,8463,480,640,91,340,431,335,428,True,52
국,84,kaist_dataset/Korean/Digital_Camera/outdoor7/P1010035.JPG,char_data/국/P1010035.JPG_2.jpg,7476,480,640,89,534,623,130,214,True,52
국,69,kaist_dataset/Korean/Digital_Camera/outdoor7/P1010075.JPG,char_data/국/P1010075.JPG_2.jpg,4554,480,640,66,175,241,252,321,True,52
국,110,kaist_dataset/Korean/Digital_Camera/outdoor7/P1010080.JPG,char_data/국/P1010080.JPG_2.jpg,11880,480,640,108,102,210,55,165,True,52
국,97,kaist_dataset/Korean/Digital_Camera/outdoor7/P1010121.JPG,char_data/국/P1010121.JPG_2.jpg,11640,480,640,120,364,484,108,205,True,52
국,114,kaist_dataset/Korean/Digital_Camera/outdoor7/P1010122.JPG,char_data/국/P1010122.JPG_2.jpg,7980,480,640,70,482,552,40,154,True,52
국,109,kaist_dataset/Korean/Digital_Camera/outdoor7/P1010131.JPG,char_data/국/P1010131.JPG_2.jpg,6758,480,640,62,484,546,111,220,True,52
국,122,kaist_dataset/Korean/Digital_Camera/outdoor7/P1010136.JPG,char_data/국/P1010136.JPG_2.jpg,15250,480,640,125,503,628,66,188,True,52
국,51,kaist_dataset/Korean/Digital_Camera/outdoor8/P090912069.jpg,char_data/국/P090912069.jpg_2.jpg,2142,480,640,42,241,283,188,239,True,52
국,80,kaist_dataset/Korean/Digital_Camera/outdoor8/P1010151.JPG,char_data/국/P1010151.JPG_2.jpg,7120,480,640,89,387,476,179,259,True,52
국,92,kaist_dataset/Korean/Digital_Camera/outdoor8/P1010170.JPG,char_data/국/P1010170.JPG_2.jpg,12696,480,640,138,459,597,170,262,True,52
국,142,kaist_dataset/Korean/Digital_Camera/outdoor8/크기변환_P1010005.JPG,char_data/국/크기변환_P1010005.JPG_2.jpg,23998,480,640,169,414,583,102,244,True,52
국,138,"kaist_dataset/Korean/Mobile_Phone/(M,K)C-outdoor/P090912041.jpg",char_data/국/P090912041.jpg_2.jpg,14904,480,640,108,355,463,139,277,True,52
국,65,"kaist_dataset/Korean/Mobile_Phone/(M,K)C-outdoor/P090912044.jpg",char_data/국/P090912044.jpg_2.jpg,4160,480,640,64,212,276,124,189,True,52
국,65,"kaist_dataset/Korean/Mobile_Phone/(M,K)C-outdoor/P090912049.jpg",char_data/국/P090912049.jpg_2.jpg,3965,480,640,61,514,575,66,131,True,52
국,133,"kaist_dataset/Korean/Mobile_Phone/(M,K)E-bookCover/P090831036.jpg",char_data/국/P090831036.jpg_2.jpg,14630,480,640,110,44,154,93,226,True,52
국,111,"kaist_dataset/Korean/Mobile_Phone/(M,K)E-bookCover/P090831097.jpg",char_data/국/P090831097.jpg_2.jpg,10545,480,640,95,202,297,17,128,True,52
국,104,"kaist_dataset/Korean/Mobile_Phone/(M,K)E-bookCover/P090831142.jpg",char_data/국/P090831142.jpg_2.jpg,7384,480,640,71,116,187,31,135,True,52
국,85,"kaist_dataset/Korean/Mobile_Phone/(M,K)E-bookCover/P090831144.jpg",char_data/국/P090831144.jpg_2.jpg,4675,480,640,55,295,350,26,111,True,52
국,176,"kaist_dataset/Korean/Mobile_Phone/(M,K)E-bookCover/P090911054.jpg",char_data/국/P090911054.jpg_2.jpg,13200,480,640,75,248,323,42,218,True,52
국,62,kaist_dataset/Mixed/Digital_Camera/(C.S)C-outdoor1/003.JPG,char_data/국/003.JPG_2.jpg,2976,480,640,48,110,158,190,252,True,52
국,93,kaist_dataset/Mixed/Digital_Camera/(C.S)C-outdoor1/078.JPG,char_data/국/078.JPG_2.jpg,10230,480,640,110,497,607,171,264,True,52
국,70,kaist_dataset/Mixed/Digital_Camera/(C.S)C-outdoor1/2007-12-08-day-091.jpg,char_data/국/2007-12-08-day-091.jpg_2.jpg,5320,1200,1600,76,1371,1447,508,578,True,52
국,112,kaist_dataset/Mixed/Digital_Camera/(C.S)C-outdoor1/2007-12-08-day-092.jpg,char_data/국/2007-12-08-day-092.jpg_4.jpg,14896,1200,1600,133,974,1107,474,586,True,52
국,89,kaist_dataset/Mixed/Digital_Camera/(C.S)C-outdoor1/2007-12-08-day-092.jpg,char_data/국/2007-12-08-day-092.jpg_5.jpg,3026,1200,1600,34,1553,1587,802,891,True,52
국,271,kaist_dataset/Mixed/Digital_Camera/(C.S)C-outdoor1/2007-12-09-day-exterior-004.jpg,char_data/국/2007-12-09-day-exterior-004.jpg_2.jpg,73170,1200,1600,270,1367,1599,376,647,True,52
국,99,kaist_dataset/Mixed/Digital_Camera/(C.S)C-outdoor1/DSC02319.JPG,char_data/국/DSC02319.JPG_2.jpg,6930,480,640,70,521,591,252,351,True,52
국,121,kaist_dataset/Mixed/Digital_Camera/(C.S)C-outdoor2/DSC02489.JPG,char_data/국/DSC02489.JPG_2.jpg,12100,480,640,100,420,520,133,254,True,52
국,65,kaist_dataset/Mixed/Digital_Camera/(C.S)C-outdoor2/DSC02533.JPG,char_data/국/DSC02533.JPG_2.jpg,2990,480,640,46,273,319,103,168,True,52
국,123,kaist_dataset/Mixed/Digital_Camera/(C.S)C-outdoor2/DSC02864.JPG,char_data/국/DSC02864.JPG_2.jpg,15375,480,640,125,266,391,131,254,True,52
국,69,kaist_dataset/Mixed/Digital_Camera/(C.S)C-outdoor2/DSC02866.JPG,char_data/국/DSC02866.JPG_4.jpg,4968,480,640,72,150,222,116,185,True,52
국,63,kaist_dataset/Mixed/Digital_Camera/(C.S)C-outdoor2/DSC02866.JPG,char_data/국/DSC02866.JPG_5.jpg,4410,480,640,70,232,302,117,180,True,52
국,55,kaist_dataset/Mixed/Digital_Camera/(C.S)C-outdoor2/DSC02867.JPG,char_data/국/DSC02867.JPG_2.jpg,2970,480,640,54,295,349,343,398,True,52
국,40,kaist_dataset/Mixed/Digital_Camera/(C.S)C-outdoor2/DSC02954.JPG,char_data/국/DSC02954.JPG_2.jpg,1280,480,640,32,167,199,96,136,True,52
국,89,kaist_dataset/Mixed/Digital_Camera/(C.S)C-outdoor3/DSC02969.JPG,char_data/국/DSC02969.JPG_2.jpg,5785,480,640,65,572,637,96,185,True,52
국,44,kaist_dataset/Mixed/Digital_Camera/(C.S)C-outdoor3/DSC03217.JPG,char_data/국/DSC03217.JPG_2.jpg,1716,480,640,39,210,249,327,371,True,52
국,165,kaist_dataset/Mixed/Digital_Camera/(C.S)C-outdoor3/DSC03236.JPG,char_data/국/DSC03236.JPG_2.jpg,13695,480,640,83,404,487,233,398,True,52
국,85,kaist_dataset/Mixed/Digital_Camera/(C.S)C-outdoor3/DSC03314.JPG,char_data/국/DSC03314.JPG_2.jpg,3995,480,640,47,90,137,175,260,False,52
국,61,kaist_dataset/Mixed/Digital_Camera/(C.S)C-outdoor4/DSC03554.JPG,char_data/국/DSC03554.JPG_2.jpg,6893,480,640,113,482,595,40,101,False,52
국,61,kaist_dataset/Mixed/Digital_Camera/(C.S)C-outdoor4/DSC03604.JPG,char_data/국/DSC03604.JPG_4.jpg,2806,480,640,46,120,166,258,319,False,52
국,62,kaist_dataset/Mixed/Digital_Camera/(C.S)C-outdoor4/DSC03604.JPG,char_data/국/DSC03604.JPG_5.jpg,3038,480,640,49,496,545,267,329,False,52
국,90,kaist_dataset/Mixed/Digital_Camera/(C.S)C-outdoor4/DSC03657.JPG,char_data/국/DSC03657.JPG_2.jpg,7650,480,640,85,388,473,317,407,False,52
국,93,kaist_dataset/Mixed/Digital_Camera/(C.S)C-outdoor4/DSC03734.JPG,char_data/국/DSC03734.JPG_2.jpg,9300,480,640,100,508,608,248,341,False,52
국,52,kaist_dataset/Mixed/Digital_Camera/(C.S)C-outdoor5/DSC03847.JPG,char_data/국/DSC03847.JPG_2.jpg,1820,480,640,35,429,464,80,132,False,52
국,109,kaist_dataset/Mixed/Digital_Camera/(C.S)C-outdoor5/DSC04013.JPG,char_data/국/DSC04013.JPG_2.jpg,4578,480,640,42,245,287,326,435,False,52
국,65,kaist_dataset/Mixed/Digital_Camera/(C.S)C-outdoor5/DSC04091.JPG,char_data/국/DSC04091.JPG_2.jpg,3640,480,640,56,284,340,330,395,False,52
국,39,kaist_dataset/Mixed/Digital_Camera/(C.S)C-outdoor5/DSC04115.JPG,char_data/국/DSC04115.JPG_2.jpg,936,480,640,24,254,278,358,397,False,52
국,40,kaist_dataset/Mixed/Digital_Camera/(C.S)C-outdoor5/DSC04150.JPG,char_data/국/DSC04150.JPG_2.jpg,800,480,640,20,496,516,311,351,False,52
국,143,kaist_dataset/Mixed/Digital_Camera/(C.S)C-outdoor5/DSC04337.JPG,char_data/국/DSC04337.JPG_2.jpg,12155,480,640,85,470,555,158,301,False,52
국,131,kaist_dataset/Mixed/Digital_Camera/(C.S)C-outdoor5/DSC04364.JPG,char_data/국/DSC04364.JPG_2.jpg,14803,480,640,113,500,613,273,404,False,52
국,114,kaist_dataset/Mixed/Digital_Camera/(C.S)C-outdoor5/P1010002.JPG,char_data/국/P1010002.JPG_2.jpg,14250,480,640,125,475,600,143,257,False,52
국,86,kaist_dataset/Mixed/Digital_Camera/(C.S)D-indoor1/DSC02804.JPG,char_data/국/DSC02804.JPG_2.jpg,5848,480,640,68,355,423,256,342,False,52
국,88,kaist_dataset/Mixed/Digital_Camera/(C.S)D-indoor1/DSC03998.JPG,char_data/국/DSC03998.JPG_2.jpg,2376,480,640,27,379,406,295,383,False,52
국,156,kaist_dataset/Mixed/Digital_Camera/(C.S)D-indoor1/DSC04002.JPG,char_data/국/DSC04002.JPG_2.jpg,7020,480,640,45,130,175,122,278,False,52
국,79,kaist_dataset/Mixed/Digital_Camera/(C.S)E-night/DSC02600.JPG,char_data/국/DSC02600.JPG_2.jpg,7031,480,640,89,102,191,110,189,False,52
국,54,kaist_dataset/Mixed/Digital_Camera/(C.S)E-night/DSC03840.JPG,char_data/국/DSC03840.JPG_2.jpg,3132,480,640,58,535,593,141,195,False,52
국,131,kaist_dataset/Mixed/Mobile_Phone/(C.M)A-outdoor/P090912047.jpg,char_data/국/P090912047.jpg_2.jpg,9825,480,640,75,450,525,140,271,False,52
국,73,kaist_dataset/Mixed/Mobile_Phone/(C.M)A-outdoor/P090912068.jpg,char_data/국/P090912068.jpg_2.jpg,4088,480,640,56,115,171,172,245,False,52
국,87,kaist_dataset/Mixed/Mobile_Phone/(C.M)C-bookCover/P090903024.jpg,char_data/국/P090903024.jpg_2.jpg,6786,480,640,78,181,259,287,374,False,52
국,144,kaist_dataset/Mixed/Mobile_Phone/(C.M)C-bookCover/P090903072.jpg,char_data/국/P090903072.jpg_2.jpg,17712,480,640,123,192,315,198,342,False,52
w,86,kaist_dataset/English/Digital_Camera/(E.S)B-light/DSC02980.JPG,char_data/w/DSC02980.JPG_2.jpg,10406,480,640,121,282,403,162,248,True,46
w,27,kaist_dataset/English/Digital_Camera/(E.S)B-light/크기변환_%B0%A3%C6%C74_fabdent.jpg,char_data/w/크기변환_%B0%A3%C6%C74_fabdent.jpg_2.jpg,594,480,640,22,220,242,262,289,True,46
w,80,kaist_dataset/English/Digital_Camera/(E.S)C-outdoor1/027.jpg,char_data/w/027.jpg_2.jpg,7520,300,472,94,203,297,95,175,True,46
w,55,kaist_dataset/English/Digital_Camera/(E.S)C-outdoor1/076.JPG,char_data/w/076.JPG_4.jpg,3795,480,640,69,468,537,208,263,True,46
w,21,kaist_dataset/English/Digital_Camera/(E.S)C-outdoor1/076.JPG,char_data/w/076.JPG_5.jpg,252,480,640,12,609,621,317,338,True,46
w,122,kaist_dataset/English/Digital_Camera/(E.S)C-outdoor1/DSC02354.JPG,char_data/w/DSC02354.JPG_2.jpg,16592,480,640,136,148,284,202,324,True,46
w,33,kaist_dataset/English/Digital_Camera/(E.S)C-outdoor1/DSC02356.JPG,char_data/w/DSC02356.JPG_2.jpg,1155,480,640,35,283,318,311,344,True,46
w,72,kaist_dataset/English/Digital_Camera/(E.S)C-outdoor1/DSC02491.JPG,char_data/w/DSC02491.JPG_2.jpg,5256,480,640,73,256,329,56,128,True,46
w,37,kaist_dataset/English/Digital_Camera/(E.S)C-outdoor1/DSC02918.JPG,char_data/w/DSC02918.JPG_2.jpg,1221,480,640,33,99,132,238,275,True,46
w,50,kaist_dataset/English/Digital_Camera/(E.S)C-outdoor2/DSC03001.JPG,char_data/w/DSC03001.JPG_2.jpg,2450,480,640,49,115,164,200,250,True,46
w,34,kaist_dataset/English/Digital_Camera/(E.S)C-outdoor2/DSC03160.JPG,char_data/w/DSC03160.JPG_2.jpg,1258,480,640,37,134,171,154,188,True,46
w,43,kaist_dataset/English/Digital_Camera/(E.S)C-outdoor2/DSC03162.JPG,char_data/w/DSC03162.JPG_6.jpg,1892,480,640,44,57,101,143,186,True,46
w,45,kaist_dataset/English/Digital_Camera/(E.S)C-outdoor2/DSC03162.JPG,char_data/w/DSC03162.JPG_7.jpg,1710,480,640,38,101,139,142,187,True,46
w,48,kaist_dataset/English/Digital_Camera/(E.S)C-outdoor2/DSC03162.JPG,char_data/w/DSC03162.JPG_8.jpg,1728,480,640,36,139,175,144,192,True,46
w,42,kaist_dataset/English/Digital_Camera/(E.S)C-outdoor2/DSC03169.JPG,char_data/w/DSC03169.JPG_2.jpg,2016,480,640,48,250,298,295,337,True,46
w,41,kaist_dataset/English/Digital_Camera/(E.S)C-outdoor2/DSC03203.JPG,char_data/w/DSC03203.JPG_4.jpg,1599,480,640,39,98,137,374,415,True,46
w,42,kaist_dataset/English/Digital_Camera/(E.S)C-outdoor2/DSC04052.JPG,char_data/w/DSC04052.JPG_6.jpg,1848,480,640,44,91,135,186,228,True,46
w,42,kaist_dataset/English/Digital_Camera/(E.S)C-outdoor2/DSC04052.JPG,char_data/w/DSC04052.JPG_7.jpg,1974,480,640,47,131,178,187,229,True,46
w,43,kaist_dataset/English/Digital_Camera/(E.S)C-outdoor2/DSC04052.JPG,char_data/w/DSC04052.JPG_8.jpg,1763,480,640,41,176,217,185,228,True,46
w,60,kaist_dataset/English/Digital_Camera/(E.S)C-outdoor2/DSC04066.JPG,char_data/w/DSC04066.JPG_6.jpg,3000,480,640,50,126,176,343,403,True,46
w,58,kaist_dataset/English/Digital_Camera/(E.S)C-outdoor2/DSC04066.JPG,char_data/w/DSC04066.JPG_7.jpg,2436,480,640,42,171,213,342,400,True,46
w,56,kaist_dataset/English/Digital_Camera/(E.S)C-outdoor2/DSC04066.JPG,char_data/w/DSC04066.JPG_8.jpg,2408,480,640,43,211,254,341,397,True,46
w,50,kaist_dataset/English/Digital_Camera/(E.S)C-outdoor2/DSC04163.JPG,char_data/w/DSC04163.JPG_2.jpg,3100,480,640,62,338,400,260,310,True,46
w,47,kaist_dataset/English/Digital_Camera/(E.S)D-indoor/DSC02719.JPG,char_data/w/DSC02719.JPG_2.jpg,3055,480,640,65,202,267,299,346,True,46
w,72,kaist_dataset/English/Digital_Camera/(E.S)D-indoor/DSC02842.JPG,char_data/w/DSC02842.JPG_2.jpg,7416,480,640,103,288,391,79,151,True,46
w,69,kaist_dataset/English/Digital_Camera/(E.S)D-indoor/DSC02853.JPG,char_data/w/DSC02853.JPG_2.jpg,4209,480,640,61,264,325,143,212,True,46
w,57,kaist_dataset/English/Digital_Camera/(E.S)D-indoor/DSC02854.JPG,char_data/w/DSC02854.JPG_2.jpg,2508,480,640,44,251,295,150,207,True,46
w,44,kaist_dataset/English/Digital_Camera/(E.S)D-indoor/DSC02859.JPG,char_data/w/DSC02859.JPG_2.jpg,1980,480,640,45,182,227,344,388,True,46
w,39,kaist_dataset/English/Digital_Camera/(E.S)D-indoor/DSC03083.JPG,char_data/w/DSC03083.JPG_2.jpg,1872,480,640,48,430,478,404,443,True,46
w,36,kaist_dataset/English/Digital_Camera/(E.S)D-indoor/DSC03396.JPG,char_data/w/DSC03396.JPG_4.jpg,1440,480,640,40,316,356,343,379,True,46
w,44,kaist_dataset/English/Digital_Camera/(E.S)D-indoor/크기변환_%B0%A3%C6%C76_fabdent.jpg,char_data/w/크기변환_%B0%A3%C6%C76_fabdent.jpg_2.jpg,1496,480,640,34,247,281,182,226,True,46
w,101,kaist_dataset/English/Digital_Camera/(E.S)E-night/DSC02981.JPG,char_data/w/DSC02981.JPG_2.jpg,8585,480,640,85,202,287,190,291,True,46
w,78,kaist_dataset/English/Digital_Camera/(E.S)F-others/DSC02925.JPG,char_data/w/DSC02925.JPG_2.jpg,7410,480,640,95,362,457,239,317,True,46
w,57,kaist_dataset/English/Mobile_Phone/(E.M)B-indoor/P090902018.jpg,char_data/w/P090902018.jpg_2.jpg,2964,480,640,52,249,301,189,246,True,46
w,50,kaist_dataset/Korean/Digital_Camera/outdoor1/2007-12-08-day-087.jpg,char_data/w/2007-12-08-day-087.jpg_6.jpg,2650,1200,1600,53,991,1044,689,739,True,46
w,46,kaist_dataset/Korean/Digital_Camera/outdoor1/2007-12-08-day-087.jpg,char_data/w/2007-12-08-day-087.jpg_7.jpg,2208,1200,1600,48,1045,1093,687,733,True,46
w,51,kaist_dataset/Korean/Digital_Camera/outdoor1/2007-12-08-day-087.jpg,char_data/w/2007-12-08-day-087.jpg_8.jpg,2397,1200,1600,47,1092,1139,685,736,True,46
w,40,kaist_dataset/Korean/Digital_Camera/outdoor2/2007-12-09-day-exterior-036.jpg,char_data/w/2007-12-09-day-exterior-036.jpg_6.jpg,1680,1200,1600,42,1199,1241,545,585,True,46
w,44,kaist_dataset/Korean/Digital_Camera/outdoor2/2007-12-09-day-exterior-036.jpg,char_data/w/2007-12-09-day-exterior-036.jpg_7.jpg,1452,1200,1600,33,1243,1276,544,588,True,46
w,44,kaist_dataset/Korean/Digital_Camera/outdoor2/2007-12-09-day-exterior-036.jpg,char_data/w/2007-12-09-day-exterior-036.jpg_8.jpg,1540,1200,1600,35,1273,1308,545,589,True,46
w,33,kaist_dataset/Mixed/Digital_Camera/(C.S)B-light/134.JPG,char_data/w/134.JPG_2.jpg,1023,480,640,31,254,285,291,324,True,46
w,42,kaist_dataset/Mixed/Digital_Camera/(C.S)C-outdoor1/101.JPG,char_data/w/101.JPG_6.jpg,2562,480,640,61,82,143,256,298,True,46
w,42,kaist_dataset/Mixed/Digital_Camera/(C.S)C-outdoor1/101.JPG,char_data/w/101.JPG_7.jpg,2268,480,640,54,142,196,255,297,True,46
w,50,kaist_dataset/Mixed/Digital_Camera/(C.S)C-outdoor1/101.JPG,char_data/w/101.JPG_8.jpg,2450,480,640,49,197,246,254,304,True,46
w,24,kaist_dataset/Mixed/Digital_Camera/(C.S)C-outdoor1/115.JPG,char_data/w/115.JPG_6.jpg,840,480,640,35,91,126,283,307,True,46
w,26,kaist_dataset/Mixed/Digital_Camera/(C.S)C-outdoor1/115.JPG,char_data/w/115.JPG_7.jpg,910,480,640,35,128,163,283,309,True,46
w,22,kaist_dataset/Mixed/Digital_Camera/(C.S)C-outdoor1/115.JPG,char_data/w/115.JPG_8.jpg,748,480,640,34,163,197,285,307,True,46
w,22,kaist_dataset/Mixed/Digital_Camera/(C.S)C-outdoor1/2.JPG,char_data/w/2.JPG_6.jpg,352,576,768,16,18,34,384,406,True,46
w,27,kaist_dataset/Mixed/Digital_Camera/(C.S)C-outdoor1/2.JPG,char_data/w/2.JPG_7.jpg,297,576,768,11,34,45,382,409,True,46
w,26,kaist_dataset/Mixed/Digital_Camera/(C.S)C-outdoor1/2.JPG,char_data/w/2.JPG_8.jpg,260,576,768,10,45,55,383,409,True,46
w,23,kaist_dataset/Mixed/Digital_Camera/(C.S)C-outdoor1/DSC02318.JPG,char_data/w/DSC02318.JPG_2.jpg,851,480,640,37,223,260,326,349,True,46
w,45,kaist_dataset/Mixed/Digital_Camera/(C.S)C-outdoor2/DSC02407.JPG,char_data/w/DSC02407.JPG_6.jpg,2295,480,640,51,13,64,183,228,True,46
w,51,kaist_dataset/Mixed/Digital_Camera/(C.S)C-outdoor2/DSC02407.JPG,char_data/w/DSC02407.JPG_7.jpg,2397,480,640,47,65,112,179,230,True,46
w,49,kaist_dataset/Mixed/Digital_Camera/(C.S)C-outdoor2/DSC02407.JPG,char_data/w/DSC02407.JPG_8.jpg,2156,480,640,44,112,156,181,230,True,46
w,38,kaist_dataset/Mixed/Digital_Camera/(C.S)C-outdoor2/DSC02411.JPG,char_data/w/DSC02411.JPG_4.jpg,988,480,640,26,3,29,348,386,True,46
w,36,kaist_dataset/Mixed/Digital_Camera/(C.S)C-outdoor2/DSC02411.JPG,char_data/w/DSC02411.JPG_5.jpg,1044,480,640,29,30,59,352,388,True,46
w,39,kaist_dataset/Mixed/Digital_Camera/(C.S)C-outdoor2/DSC02532.JPG,char_data/w/DSC02532.JPG_6.jpg,1521,480,640,39,294,333,72,111,True,46
w,38,kaist_dataset/Mixed/Digital_Camera/(C.S)C-outdoor2/DSC02532.JPG,char_data/w/DSC02532.JPG_7.jpg,1254,480,640,33,334,367,72,110,True,46
w,37,kaist_dataset/Mixed/Digital_Camera/(C.S)C-outdoor2/DSC02532.JPG,char_data/w/DSC02532.JPG_8.jpg,1147,480,640,31,367,398,79,116,True,46
w,42,kaist_dataset/Mixed/Digital_Camera/(C.S)C-outdoor2/DSC02926.JPG,char_data/w/DSC02926.JPG_2.jpg,1554,480,640,37,165,202,136,178,True,46
w,38,kaist_dataset/Mixed/Digital_Camera/(C.S)C-outdoor2/DSC02927.JPG,char_data/w/DSC02927.JPG_2.jpg,760,480,640,20,271,291,368,406,True,46
w,41,kaist_dataset/Mixed/Digital_Camera/(C.S)C-outdoor2/DSC02928.JPG,char_data/w/DSC02928.JPG_2.jpg,1066,480,640,26,432,458,386,427,True,46
w,21,kaist_dataset/Mixed/Digital_Camera/(C.S)C-outdoor3/DSC02970.JPG,char_data/w/DSC02970.JPG_2.jpg,546,480,640,26,237,263,315,336,True,46
w,31,kaist_dataset/Mixed/Digital_Camera/(C.S)C-outdoor3/DSC03020.JPG,char_data/w/DSC03020.JPG_6.jpg,651,480,640,21,345,366,300,331,True,46
w,29,kaist_dataset/Mixed/Digital_Camera/(C.S)C-outdoor3/DSC03020.JPG,char_data/w/DSC03020.JPG_7.jpg,638,480,640,22,366,388,301,330,True,46
w,31,kaist_dataset/Mixed/Digital_Camera/(C.S)C-outdoor3/DSC03020.JPG,char_data/w/DSC03020.JPG_8.jpg,527,480,640,17,388,405,300,331,True,46
w,44,kaist_dataset/Mixed/Digital_Camera/(C.S)C-outdoor3/DSC03177.JPG,char_data/w/DSC03177.JPG_6.jpg,2112,480,640,48,104,152,137,181,True,46
w,41,kaist_dataset/Mixed/Digital_Camera/(C.S)C-outdoor3/DSC03177.JPG,char_data/w/DSC03177.JPG_7.jpg,1517,480,640,37,153,190,135,176,True,46
w,38,kaist_dataset/Mixed/Digital_Camera/(C.S)C-outdoor3/DSC03177.JPG,char_data/w/DSC03177.JPG_8.jpg,1520,480,640,40,191,231,139,177,True,46
w,25,kaist_dataset/Mixed/Digital_Camera/(C.S)C-outdoor3/DSC03328.JPG,char_data/w/DSC03328.JPG_2.jpg,500,480,640,20,339,359,244,269,True,46
w,46,kaist_dataset/Mixed/Digital_Camera/(C.S)C-outdoor3/DSC03332.JPG,char_data/w/DSC03332.JPG_6.jpg,2852,480,640,62,70,132,245,291,True,46
w,36,kaist_dataset/Mixed/Digital_Camera/(C.S)C-outdoor3/DSC03332.JPG,char_data/w/DSC03332.JPG_7.jpg,1584,480,640,44,130,174,245,281,True,46
w,38,kaist_dataset/Mixed/Digital_Camera/(C.S)C-outdoor3/DSC03332.JPG,char_data/w/DSC03332.JPG_8.jpg,1938,480,640,51,173,224,243,281,True,46
w,24,kaist_dataset/Mixed/Digital_Camera/(C.S)C-outdoor4/DSC03667.JPG,char_data/w/DSC03667.JPG_6.jpg,624,480,640,26,61,87,391,415,True,46
w,25,kaist_dataset/Mixed/Digital_Camera/(C.S)C-outdoor4/DSC03667.JPG,char_data/w/DSC03667.JPG_7.jpg,625,480,640,25,86,111,389,414,True,46
w,27,kaist_dataset/Mixed/Digital_Camera/(C.S)C-outdoor4/DSC03667.JPG,char_data/w/DSC03667.JPG_8.jpg,594,480,640,22,111,133,386,413,True,46
w,40,kaist_dataset/Mixed/Digital_Camera/(C.S)C-outdoor4/DSC03672.JPG,char_data/w/DSC03672.JPG_6.jpg,1360,480,640,34,75,109,409,449,True,46
w,39,kaist_dataset/Mixed/Digital_Camera/(C.S)C-outdoor4/DSC03672.JPG,char_data/w/DSC03672.JPG_7.jpg,1443,480,640,37,105,142,408,447,True,46
w,35,kaist_dataset/Mixed/Digital_Camera/(C.S)C-outdoor4/DSC03672.JPG,char_data/w/DSC03672.JPG_8.jpg,1085,480,640,31,144,175,411,446,True,46
w,34,kaist_dataset/Mixed/Digital_Camera/(C.S)C-outdoor4/DSC03773.JPG,char_data/w/DSC03773.JPG_8.jpg,1496,480,640,44,255,299,278,312,True,46
w,44,kaist_dataset/Mixed/Digital_Camera/(C.S)C-outdoor4/DSC03773.JPG,char_data/w/DSC03773.JPG_9.jpg,1716,480,640,39,20,59,256,300,True,46
w,44,kaist_dataset/Mixed/Digital_Camera/(C.S)C-outdoor4/DSC03773.JPG,char_data/w/DSC03773.JPG_10.jpg,1628,480,640,37,59,96,260,304,True,46
w,45,kaist_dataset/Mixed/Digital_Camera/(C.S)C-outdoor4/DSC03773.JPG,char_data/w/DSC03773.JPG_11.jpg,1845,480,640,41,94,135,261,306,True,46
w,38,kaist_dataset/Mixed/Digital_Camera/(C.S)C-outdoor5/DSC04070.JPG,char_data/w/DSC04070.JPG_6.jpg,1406,480,640,37,58,95,110,148,True,46
w,32,kaist_dataset/Mixed/Digital_Camera/(C.S)C-outdoor5/DSC04070.JPG,char_data/w/DSC04070.JPG_7.jpg,608,480,640,19,96,115,113,145,True,46
w,32,kaist_dataset/Mixed/Digital_Camera/(C.S)C-outdoor5/DSC04070.JPG,char_data/w/DSC04070.JPG_8.jpg,640,480,640,20,115,135,112,144,True,46
w,30,kaist_dataset/Mixed/Digital_Camera/(C.S)C-outdoor5/DSC04076.JPG,char_data/w/DSC04076.JPG_6.jpg,930,480,640,31,299,330,401,431,True,46
w,25,kaist_dataset/Mixed/Digital_Camera/(C.S)C-outdoor5/DSC04076.JPG,char_data/w/DSC04076.JPG_7.jpg,575,480,640,23,330,353,399,424,True,46
w,30,kaist_dataset/Mixed/Digital_Camera/(C.S)C-outdoor5/DSC04076.JPG,char_data/w/DSC04076.JPG_8.jpg,720,480,640,24,353,377,395,425,True,46
w,33,kaist_dataset/Mixed/Digital_Camera/(C.S)C-outdoor5/DSC04091.JPG,char_data/w/DSC04091.JPG_6.jpg,858,480,640,26,192,218,425,458,True,46
w,30,kaist_dataset/Mixed/Digital_Camera/(C.S)C-outdoor5/DSC04091.JPG,char_data/w/DSC04091.JPG_7.jpg,570,480,640,19,218,237,428,458,False,46
w,32,kaist_dataset/Mixed/Digital_Camera/(C.S)C-outdoor5/DSC04091.JPG,char_data/w/DSC04091.JPG_8.jpg,704,480,640,22,236,258,425,457,False,46
w,38,kaist_dataset/Mixed/Digital_Camera/(C.S)C-outdoor5/DSC04104.JPG,char_data/w/DSC04104.JPG_2.jpg,1330,480,640,35,548,583,44,82,False,46
w,37,kaist_dataset/Mixed/Digital_Camera/(C.S)C-outdoor5/DSC04125.JPG,char_data/w/DSC04125.JPG_6.jpg,888,480,640,24,11,35,430,467,False,46
w,31,kaist_dataset/Mixed/Digital_Camera/(C.S)C-outdoor5/DSC04125.JPG,char_data/w/DSC04125.JPG_7.jpg,589,480,640,19,34,53,432,463,False,46
w,31,kaist_dataset/Mixed/Digital_Camera/(C.S)C-outdoor5/DSC04125.JPG,char_data/w/DSC04125.JPG_8.jpg,620,480,640,20,53,73,431,462,False,46
w,29,kaist_dataset/Mixed/Digital_Camera/(C.S)C-outdoor5/DSC04357.JPG,char_data/w/DSC04357.JPG_2.jpg,725,480,640,25,283,308,382,411,False,46
w,42,kaist_dataset/Mixed/Digital_Camera/(C.S)C-outdoor5/DSC04456.JPG,char_data/w/DSC04456.JPG_6.jpg,1680,480,640,40,19,59,174,216,False,46
w,42,kaist_dataset/Mixed/Digital_Camera/(C.S)C-outdoor5/DSC04456.JPG,char_data/w/DSC04456.JPG_7.jpg,1638,480,640,39,59,98,174,216,False,46
w,45,kaist_dataset/Mixed/Digital_Camera/(C.S)C-outdoor5/DSC04456.JPG,char_data/w/DSC04456.JPG_8.jpg,1890,480,640,42,94,136,173,218,False,46
w,32,kaist_dataset/Mixed/Digital_Camera/(C.S)C-outdoor6/P1010069.JPG,char_data/w/P1010069.JPG_6.jpg,1376,480,640,43,68,111,288,320,False,46
w,33,kaist_dataset/Mixed/Digital_Camera/(C.S)C-outdoor6/P1010069.JPG,char_data/w/P1010069.JPG_7.jpg,1254,480,640,38,111,149,287,320,False,46
w,34,kaist_dataset/Mixed/Digital_Camera/(C.S)C-outdoor6/P1010069.JPG,char_data/w/P1010069.JPG_8.jpg,1156,480,640,34,148,182,290,324,False,46
w,35,kaist_dataset/Mixed/Digital_Camera/(C.S)D-indoor1/082.JPG,char_data/w/082.JPG_4.jpg,1365,480,640,39,182,221,186,221,False,46
w,38,kaist_dataset/Mixed/Digital_Camera/(C.S)D-indoor1/082.JPG,char_data/w/082.JPG_5.jpg,1444,480,640,38,315,353,181,219,False,46
w,38,kaist_dataset/Mixed/Digital_Camera/(C.S)D-indoor1/DSC02711.JPG,char_data/w/DSC02711.JPG_2.jpg,1900,480,640,50,183,233,232,270,False,46
w,32,kaist_dataset/Mixed/Digital_Camera/(C.S)D-indoor1/DSC02718.JPG,char_data/w/DSC02718.JPG_2.jpg,768,480,640,24,90,114,226,258,False,46
w,35,kaist_dataset/Mixed/Digital_Camera/(C.S)D-indoor1/DSC03466.JPG,char_data/w/DSC03466.JPG_6.jpg,1295,480,640,37,168,205,233,268,False,46
w,34,kaist_dataset/Mixed/Digital_Camera/(C.S)D-indoor1/DSC03466.JPG,char_data/w/DSC03466.JPG_7.jpg,1156,480,640,34,205,239,229,263,False,46
w,37,kaist_dataset/Mixed/Digital_Camera/(C.S)D-indoor1/DSC03466.JPG,char_data/w/DSC03466.JPG_8.jpg,1147,480,640,31,238,269,230,267,False,46
w,81,kaist_dataset/Mixed/Digital_Camera/(C.S)D-indoor1/DSC03909.JPG,char_data/w/DSC03909.JPG_2.jpg,9558,480,640,118,132,250,103,184,False,46
w,39,kaist_dataset/Mixed/Mobile_Phone/(C.M)B-indoor/P090831016.jpg,char_data/w/P090831016.jpg_2.jpg,1638,480,640,42,360,402,202,241,False,46
w,35,kaist_dataset/Mixed/Mobile_Phone/(C.M)C-bookCover/P090902016.jpg,char_data/w/P090902016.jpg_2.jpg,1295,480,640,37,86,123,270,305,False,46
-,14,kaist_dataset/English/Digital_Camera/(E.S)C-outdoor1/042.JPG,char_data/-/042.JPG_2.jpg,98,480,640,7,530,537,326,340,True,1
-,18,kaist_dataset/English/Digital_Camera/(E.S)C-outdoor1/056.JPG,char_data/-/056.JPG_2.jpg,144,480,640,8,549,557,255,273,True,1
-,24,kaist_dataset/English/Digital_Camera/(E.S)C-outdoor1/080116-0065.jpg,char_data/-/080116-0065.jpg_2.jpg,576,600,800,24,301,325,386,410,True,1
-,35,kaist_dataset/English/Digital_Camera/(E.S)C-outdoor1/2007-12-09-day-exterior-056.jpg,char_data/-/2007-12-09-day-exterior-056.jpg_2.jpg,1645,1200,1600,47,559,606,559,594,True,1
-,28,kaist_dataset/English/Digital_Camera/(E.S)D-indoor/080119-0009.jpg,char_data/-/080119-0009.jpg_2.jpg,896,1200,1600,32,678,710,982,1010,True,1
-,21,kaist_dataset/English/Digital_Camera/(E.S)F-others/2007-12-09-day-exterior-047.jpg,char_data/-/2007-12-09-day-exterior-047.jpg_2.jpg,273,1200,1600,13,32,45,587,608,True,1
-,26,kaist_dataset/Korean/Digital_Camera/A-shadow/2007-12-09-day-exterior-025.jpg,char_data/-/2007-12-09-day-exterior-025.jpg_2.jpg,806,1200,1600,31,1002,1033,748,774,True,1
-,33,kaist_dataset/Korean/Digital_Camera/A-shadow/2007-12-09-day-exterior-026.jpg,char_data/-/2007-12-09-day-exterior-026.jpg_2.jpg,1386,1200,1600,42,992,1034,778,811,True,1
-,37,kaist_dataset/Korean/Digital_Camera/A-shadow/2007-12-09-day-exterior-031.jpg,char_data/-/2007-12-09-day-exterior-031.jpg_2.jpg,2035,1200,1600,55,690,745,692,729,True,1
-,19,kaist_dataset/Korean/Digital_Camera/A-shadow/2007-12-09-day-exterior-040.jpg,char_data/-/2007-12-09-day-exterior-040.jpg_2.jpg,323,1200,1600,17,1019,1036,821,840,True,1
-,14,kaist_dataset/Korean/Digital_Camera/E-night/103.jpg,char_data/-/103.jpg_2.jpg,126,480,640,9,184,193,316,330,True,1
-,11,kaist_dataset/Korean/Digital_Camera/G-others/2007-12-08-day-045.jpg,char_data/-/2007-12-08-day-045.jpg_4.jpg,88,1200,1600,8,149,157,817,828,True,1
-,15,kaist_dataset/Korean/Digital_Camera/G-others/2007-12-08-day-045.jpg,char_data/-/2007-12-08-day-045.jpg_5.jpg,90,1200,1600,6,25,31,823,838,True,1
-,39,kaist_dataset/Korean/Digital_Camera/G-others/2007-12-08-day-108.jpg,char_data/-/2007-12-08-day-108.jpg_6.jpg,936,1200,1600,24,839,863,699,738,True,1
-,34,kaist_dataset/Korean/Digital_Camera/G-others/2007-12-08-day-108.jpg,char_data/-/2007-12-08-day-108.jpg_7.jpg,1020,1200,1600,30,695,725,743,777,True,1
-,34,kaist_dataset/Korean/Digital_Camera/G-others/2007-12-08-day-108.jpg,char_data/-/2007-12-08-day-108.jpg_8.jpg,748,1200,1600,22,848,870,783,817,True,1
-,26,kaist_dataset/Korean/Digital_Camera/G-others/2007-12-08-day-112.jpg,char_data/-/2007-12-08-day-112.jpg_2.jpg,364,1200,1600,14,822,836,518,544,True,1
-,34,kaist_dataset/Korean/Digital_Camera/G-others/2007-12-09-day-exterior-062.jpg,char_data/-/2007-12-09-day-exterior-062.jpg_2.jpg,952,1600,1200,28,568,596,1434,1468,True,1
-,28,kaist_dataset/Korean/Digital_Camera/G-others/2007-12-09-day-exterior-083.jpg,char_data/-/2007-12-09-day-exterior-083.jpg_4.jpg,700,1600,1200,25,605,630,981,1009,True,1
-,32,kaist_dataset/Korean/Digital_Camera/G-others/2007-12-09-day-exterior-083.jpg,char_data/-/2007-12-09-day-exterior-083.jpg_5.jpg,768,1600,1200,24,411,435,136,168,True,1
-,25,kaist_dataset/Korean/Digital_Camera/indoor1/080119-0018.jpg,char_data/-/080119-0018.jpg_2.jpg,550,1200,1600,22,1111,1133,952,977,True,1
-,20,kaist_dataset/Korean/Digital_Camera/indoor1/080119-0029.jpg,char_data/-/080119-0029.jpg_2.jpg,300,1200,1600,15,837,852,659,679,True,1
-,38,kaist_dataset/Korean/Digital_Camera/indoor2/P071209063.jpg,char_data/-/P071209063.jpg_2.jpg,1900,1200,1600,50,1127,1177,1085,1123,True,1
-,10,kaist_dataset/Korean/Digital_Camera/outdoor1/006.JPG,char_data/-/006.JPG_2.jpg,160,480,640,16,343,359,259,269,True,1
-,17,kaist_dataset/Korean/Digital_Camera/outdoor1/011.JPG,char_data/-/011.JPG_2.jpg,306,480,640,18,406,424,260,277,True,1
-,13,kaist_dataset/Korean/Digital_Camera/outdoor1/017.JPG,char_data/-/017.JPG_2.jpg,156,480,640,12,464,476,275,288,True,1
-,18,kaist_dataset/Korean/Digital_Camera/outdoor1/023.JPG,char_data/-/023.JPG_2.jpg,432,480,640,24,205,229,277,295,True,1
-,24,kaist_dataset/Korean/Digital_Camera/outdoor1/028.JPG,char_data/-/028.JPG_2.jpg,432,480,640,18,325,343,263,287,True,1
-,15,kaist_dataset/Korean/Digital_Camera/outdoor1/029.JPG,char_data/-/029.JPG_2.jpg,165,480,640,11,302,313,298,313,True,1
-,30,kaist_dataset/Korean/Digital_Camera/outdoor1/032.JPG,char_data/-/032.JPG_6.jpg,390,480,640,13,127,140,257,287,True,1
-,26,kaist_dataset/Korean/Digital_Camera/outdoor1/032.JPG,char_data/-/032.JPG_7.jpg,364,480,640,14,302,316,258,284,True,1
-,26,kaist_dataset/Korean/Digital_Camera/outdoor1/032.JPG,char_data/-/032.JPG_8.jpg,364,480,640,14,476,490,254,280,True,1
-,14,kaist_dataset/Korean/Digital_Camera/outdoor1/035.JPG,char_data/-/035.JPG_4.jpg,238,480,640,17,304,321,296,310,True,1
-,17,kaist_dataset/Korean/Digital_Camera/outdoor1/035.JPG,char_data/-/035.JPG_5.jpg,255,480,640,15,506,521,298,315,True,1
-,31,kaist_dataset/Korean/Digital_Camera/outdoor1/040.JPG,char_data/-/040.JPG_2.jpg,527,480,640,17,296,313,300,331,True,1
-,38,kaist_dataset/Korean/Digital_Camera/outdoor1/052.JPG,char_data/-/052.JPG_2.jpg,760,480,640,20,325,345,324,362,True,1
-,34,kaist_dataset/Korean/Digital_Camera/outdoor1/069.JPG,char_data/-/069.JPG_2.jpg,306,480,640,9,322,331,268,302,True,1
-,10,kaist_dataset/Korean/Digital_Camera/outdoor1/070.JPG,char_data/-/070.JPG_2.jpg,120,480,640,12,398,410,257,267,True,1
-,27,kaist_dataset/Korean/Digital_Camera/outdoor1/071.JPG,char_data/-/071.JPG_2.jpg,513,480,640,19,298,317,258,285,True,1
-,24,kaist_dataset/Korean/Digital_Camera/outdoor1/091.JPG,char_data/-/091.JPG_2.jpg,552,480,640,23,337,360,293,317,True,1
-,21,kaist_dataset/Korean/Digital_Camera/outdoor1/098.JPG,char_data/-/098.JPG_2.jpg,693,480,640,33,203,236,364,385,True,1
-,31,kaist_dataset/Korean/Digital_Camera/outdoor1/102.JPG,char_data/-/102.JPG_2.jpg,527,480,640,17,350,367,308,339,True,1
-,20,kaist_dataset/Korean/Digital_Camera/outdoor1/120.JPG,char_data/-/120.JPG_2.jpg,400,480,640,20,314,334,302,322,True,1
-,34,kaist_dataset/Korean/Digital_Camera/outdoor1/123.JPG,char_data/-/123.JPG_4.jpg,476,480,640,14,403,417,273,307,True,1
-,35,kaist_dataset/Korean/Digital_Camera/outdoor1/123.JPG,char_data/-/123.JPG_5.jpg,490,480,640,14,230,244,275,310,True,1
-,30,kaist_dataset/Korean/Digital_Camera/outdoor1/125.JPG,char_data/-/125.JPG_2.jpg,600,480,640,20,327,347,256,286,True,1
-,22,kaist_dataset/Korean/Digital_Camera/outdoor1/126.JPG,char_data/-/126.JPG_4.jpg,484,480,640,22,301,323,265,287,True,1
-,26,kaist_dataset/Korean/Digital_Camera/outdoor1/126.JPG,char_data/-/126.JPG_5.jpg,234,480,640,9,529,538,252,278,True,1
-,44,kaist_dataset/Korean/Digital_Camera/outdoor1/127.JPG,char_data/-/127.JPG_2.jpg,1056,480,640,24,295,319,270,314,True,1
-,24,kaist_dataset/Korean/Digital_Camera/outdoor1/2007-12-08-day-047.jpg,char_data/-/2007-12-08-day-047.jpg_2.jpg,792,1200,1600,33,920,953,722,746,True,1
-,35,kaist_dataset/Korean/Digital_Camera/outdoor1/2007-12-08-day-057.jpg,char_data/-/2007-12-08-day-057.jpg_2.jpg,1400,1200,1600,40,910,950,610,645,True,1
-,23,kaist_dataset/Korean/Digital_Camera/outdoor1/46.JPG,char_data/-/46.JPG_2.jpg,460,576,768,20,269,289,400,423,True,1
-,19,kaist_dataset/Korean/Digital_Camera/outdoor1/50.JPG,char_data/-/50.JPG_2.jpg,228,576,768,12,356,368,345,364,True,1
-,13,kaist_dataset/Korean/Digital_Camera/outdoor1/54.JPG,char_data/-/54.JPG_2.jpg,416,523,767,32,462,494,382,395,True,1
-,27,kaist_dataset/Korean/Digital_Camera/outdoor2/2007-12-09-day-exterior-009.jpg,char_data/-/2007-12-09-day-exterior-009.jpg_2.jpg,1242,1200,1600,46,821,867,693,720,True,1
-,24,kaist_dataset/Korean/Digital_Camera/outdoor2/2007-12-09-day-exterior-012.jpg,char_data/-/2007-12-09-day-exterior-012.jpg_2.jpg,624,1200,1600,26,1154,1180,651,675,True,1
-,34,kaist_dataset/Korean/Digital_Camera/outdoor2/2007-12-09-day-exterior-016.jpg,char_data/-/2007-12-09-day-exterior-016.jpg_2.jpg,1224,1200,1600,36,626,662,765,799,True,1
-,32,kaist_dataset/Korean/Digital_Camera/outdoor2/2007-12-09-day-exterior-033.jpg,char_data/-/2007-12-09-day-exterior-033.jpg_2.jpg,1760,1200,1600,55,688,743,745,777,True,1
-,23,kaist_dataset/Korean/Digital_Camera/outdoor2/2007-12-09-day-exterior-035.jpg,char_data/-/2007-12-09-day-exterior-035.jpg_2.jpg,552,1200,1600,24,511,535,727,750,True,1
-,20,kaist_dataset/Korean/Digital_Camera/outdoor2/2007-12-09-day-exterior-036.jpg,char_data/-/2007-12-09-day-exterior-036.jpg_2.jpg,380,1200,1600,19,1486,1505,639,659,True,1
-,18,kaist_dataset/Korean/Digital_Camera/outdoor2/2007-12-09-day-exterior-084.jpg,char_data/-/2007-12-09-day-exterior-084.jpg_2.jpg,450,1200,1600,25,840,865,808,826,True,1
-,26,kaist_dataset/Mixed/Digital_Camera/(C.S)C-outdoor1/008.JPG,char_data/-/008.JPG_2.jpg,312,480,640,12,489,501,266,292,True,1
-,37,kaist_dataset/Mixed/Digital_Camera/(C.S)C-outdoor1/009.JPG,char_data/-/009.JPG_2.jpg,407,480,640,11,328,339,321,358,True,1
-,14,kaist_dataset/Mixed/Digital_Camera/(C.S)C-outdoor1/014.JPG,char_data/-/014.JPG_2.jpg,196,480,640,14,198,212,282,296,True,1
-,58,kaist_dataset/Mixed/Digital_Camera/(C.S)C-outdoor1/025.JPG,char_data/-/025.JPG_4.jpg,1334,480,640,23,205,228,333,391,True,1
-,51,kaist_dataset/Mixed/Digital_Camera/(C.S)C-outdoor1/025.JPG,char_data/-/025.JPG_5.jpg,1224,480,640,24,461,485,343,394,True,1
-,24,kaist_dataset/Mixed/Digital_Camera/(C.S)C-outdoor1/047.JPG,char_data/-/047.JPG_6.jpg,96,480,640,4,586,590,173,197,True,1
-,22,kaist_dataset/Mixed/Digital_Camera/(C.S)C-outdoor1/047.JPG,char_data/-/047.JPG_7.jpg,154,480,640,7,547,554,240,262,True,1
-,22,kaist_dataset/Mixed/Digital_Camera/(C.S)C-outdoor1/047.JPG,char_data/-/047.JPG_8.jpg,176,480,640,8,584,592,242,264,True,1
-,33,kaist_dataset/Mixed/Digital_Camera/(C.S)C-outdoor1/054.JPG,char_data/-/054.JPG_2.jpg,231,480,640,7,507,514,301,334,True,1
-,27,kaist_dataset/Mixed/Digital_Camera/(C.S)C-outdoor1/080116-0084.jpg,char_data/-/080116-0084.jpg_2.jpg,621,600,800,23,626,649,317,344,True,1
-,57,kaist_dataset/Mixed/Digital_Camera/(C.S)C-outdoor1/080118-0014.jpg,char_data/-/080118-0014.jpg_2.jpg,4674,1200,1600,82,873,955,777,834,True,1
-,20,kaist_dataset/Mixed/Digital_Camera/(C.S)C-outdoor1/080119-0008.jpg,char_data/-/080119-0008.jpg_2.jpg,200,1200,1600,10,1278,1288,683,703,True,1
-,18,kaist_dataset/Mixed/Digital_Camera/(C.S)C-outdoor1/081.JPG,char_data/-/081.JPG_2.jpg,324,480,640,18,274,292,265,283,True,1
-,18,kaist_dataset/Mixed/Digital_Camera/(C.S)C-outdoor1/086.JPG,char_data/-/086.JPG_2.jpg,216,480,640,12,390,402,341,359,True,1
-,15,kaist_dataset/Mixed/Digital_Camera/(C.S)C-outdoor1/090.JPG,char_data/-/090.JPG_2.jpg,195,480,640,13,435,448,402,417,True,1
-,27,kaist_dataset/Mixed/Digital_Camera/(C.S)C-outdoor1/1.JPG,char_data/-/1.JPG_2.jpg,351,576,768,13,275,288,353,380,True,1
-,21,kaist_dataset/Mixed/Digital_Camera/(C.S)C-outdoor1/105.jpg,char_data/-/105.jpg_2.jpg,210,480,640,10,288,298,394,415,True,1
-,33,kaist_dataset/Mixed/Digital_Camera/(C.S)C-outdoor1/118.JPG,char_data/-/118.JPG_2.jpg,660,480,640,20,399,419,358,391,True,1
-,31,kaist_dataset/Mixed/Digital_Camera/(C.S)C-outdoor1/121.JPG,char_data/-/121.JPG_4.jpg,248,480,640,8,327,335,274,305,True,1
-,21,kaist_dataset/Mixed/Digital_Camera/(C.S)C-outdoor1/121.JPG,char_data/-/121.JPG_5.jpg,189,480,640,9,462,471,277,298,True,1
-,18,kaist_dataset/Mixed/Digital_Camera/(C.S)C-outdoor1/2.JPG,char_data/-/2.JPG_6.jpg,288,576,768,16,345,361,74,92,True,1
-,20,kaist_dataset/Mixed/Digital_Camera/(C.S)C-outdoor1/2.JPG,char_data/-/2.JPG_7.jpg,280,576,768,14,248,262,76,96,True,1
-,17,kaist_dataset/Mixed/Digital_Camera/(C.S)C-outdoor1/2.JPG,char_data/-/2.JPG_8.jpg,170,576,768,10,593,603,398,415,True,1
-,38,kaist_dataset/Mixed/Digital_Camera/(C.S)C-outdoor1/2007-12-08-day-091.jpg,char_data/-/2007-12-08-day-091.jpg_2.jpg,1862,1200,1600,49,1218,1267,641,679,True,1
-,46,kaist_dataset/Mixed/Digital_Camera/(C.S)C-outdoor1/2007-12-08-day-092.jpg,char_data/-/2007-12-08-day-092.jpg_2.jpg,3358,1200,1600,73,750,823,692,738,True,1
-,23,kaist_dataset/Mixed/Digital_Camera/(C.S)C-outdoor1/2007-12-08-day-130.jpg,char_data/-/2007-12-08-day-130.jpg_2.jpg,368,1200,1600,16,1029,1045,771,794,True,1
-,28,kaist_dataset/Mixed/Digital_Camera/(C.S)C-outdoor1/2007-12-09-day-exterior-004.jpg,char_data/-/2007-12-09-day-exterior-004.jpg_2.jpg,1120,1200,1600,40,1131,1171,677,705,True,1
-,26,kaist_dataset/Mixed/Digital_Camera/(C.S)C-outdoor1/2007-12-09-day-exterior-037.jpg,char_data/-/2007-12-09-day-exterior-037.jpg_2.jpg,598,1200,1600,23,783,806,715,741,True,1
-,18,kaist_dataset/Mixed/Digital_Camera/(C.S)C-outdoor1/2007-12-09-day-exterior-078.jpg,char_data/-/2007-12-09-day-exterior-078.jpg_6.jpg,234,1200,1600,13,499,512,613,631,False,1
-,15,kaist_dataset/Mixed/Digital_Camera/(C.S)C-outdoor1/2007-12-09-day-exterior-078.jpg,char_data/-/2007-12-09-day-exterior-078.jpg_7.jpg,135,1200,1600,9,728,737,607,622,False,1
-,21,kaist_dataset/Mixed/Digital_Camera/(C.S)C-outdoor1/2007-12-09-day-exterior-078.jpg,char_data/-/2007-12-09-day-exterior-078.jpg_8.jpg,294,1200,1600,14,798,812,601,622,False,1
-,40,kaist_dataset/Mixed/Digital_Camera/(C.S)C-outdoor1/2007-12-09-day-exterior-086.jpg,char_data/-/2007-12-09-day-exterior-086.jpg_2.jpg,2760,1200,1600,69,910,979,740,780,False,1
-,19,kaist_dataset/Mixed/Digital_Camera/(C.S)C-outdoor1/45.JPG,char_data/-/45.JPG_2.jpg,722,576,768,38,368,406,379,398,False,1
-,16,kaist_dataset/Mixed/Digital_Camera/(C.S)C-outdoor1/47.JPG,char_data/-/47.JPG_2.jpg,128,576,768,8,352,360,482,498,False,1
-,9,kaist_dataset/Mixed/Digital_Camera/(C.S)C-outdoor1/48.JPG,char_data/-/48.JPG_6.jpg,63,576,768,7,244,251,348,357,False,1
-,14,kaist_dataset/Mixed/Digital_Camera/(C.S)C-outdoor1/48.JPG,char_data/-/48.JPG_7.jpg,140,576,768,10,364,374,347,361,False,1
-,16,kaist_dataset/Mixed/Digital_Camera/(C.S)C-outdoor1/48.JPG,char_data/-/48.JPG_8.jpg,128,576,768,8,414,422,346,362,False,1
-,24,kaist_dataset/Mixed/Digital_Camera/(C.S)C-outdoor1/51.JPG,char_data/-/51.JPG_2.jpg,744,576,768,31,577,608,384,408,False,1
-,16,kaist_dataset/Mixed/Digital_Camera/(C.S)C-outdoor1/55.JPG,char_data/-/55.JPG_2.jpg,288,576,768,18,360,378,381,397,False,1
-,20,kaist_dataset/Mixed/Digital_Camera/(C.S)C-outdoor1/56.JPG,char_data/-/56.JPG_2.jpg,380,576,768,19,417,436,311,331,False,1
-,15,kaist_dataset/Mixed/Digital_Camera/(C.S)C-outdoor1/57.JPG,char_data/-/57.JPG_10.jpg,225,500,766,15,371,386,300,315,False,1
-,12,kaist_dataset/Mixed/Digital_Camera/(C.S)C-outdoor1/57.JPG,char_data/-/57.JPG_11.jpg,168,500,766,14,529,543,304,316,False,1
-,11,kaist_dataset/Mixed/Digital_Camera/(C.S)C-outdoor1/57.JPG,char_data/-/57.JPG_12.jpg,187,500,766,17,590,607,308,319,False,1
-,14,kaist_dataset/Mixed/Digital_Camera/(C.S)C-outdoor1/57.JPG,char_data/-/57.JPG_13.jpg,224,500,766,16,361,377,461,475,False,1
-,14,kaist_dataset/Mixed/Digital_Camera/(C.S)C-outdoor1/57.JPG,char_data/-/57.JPG_14.jpg,238,500,766,17,418,435,460,474,False,1
-,16,kaist_dataset/Mixed/Digital_Camera/(C.S)C-outdoor6/117.JPG,char_data/-/117.JPG_4.jpg,208,480,640,13,318,331,265,281,False,1
-,10,kaist_dataset/Mixed/Digital_Camera/(C.S)C-outdoor6/117.JPG,char_data/-/117.JPG_5.jpg,130,480,640,13,465,478,272,282,False,1
-,19,kaist_dataset/Mixed/Digital_Camera/(C.S)F-others/2007-12-08-day-044.jpg,char_data/-/2007-12-08-day-044.jpg_4.jpg,266,1200,1600,14,1065,1079,836,855,False,1
-,33,kaist_dataset/Mixed/Digital_Camera/(C.S)F-others/2007-12-08-day-044.jpg,char_data/-/2007-12-08-day-044.jpg_5.jpg,1023,1200,1600,31,12,43,732,765,False,1
-,33,kaist_dataset/Mixed/Digital_Camera/(C.S)F-others/2007-12-08-day-113.jpg,char_data/-/2007-12-08-day-113.jpg_2.jpg,693,1200,1600,21,897,918,423,456,False,1
-,28,kaist_dataset/Mixed/Digital_Camera/(C.S)F-others/2007-12-09-day-exterior-023.jpg,char_data/-/2007-12-09-day-exterior-023.jpg_2.jpg,812,1200,1600,29,983,1012,604,632,False,1
다,31,kaist_dataset/English/Digital_Camera/(E.S)B-light/080116-0059.jpg,char_data/다/080116-0059.jpg_6.jpg,527,1200,1600,17,1185,1202,895,926,True,54
다,33,kaist_dataset/English/Digital_Camera/(E.S)B-light/080116-0059.jpg,char_data/다/080116-0059.jpg_7.jpg,594,1200,1600,18,1105,1123,1056,1089,True,54
다,32,kaist_dataset/English/Digital_Camera/(E.S)B-light/080116-0059.jpg,char_data/다/080116-0059.jpg_8.jpg,640,1200,1600,20,1026,1046,982,1014,True,54
다,120,kaist_dataset/Korean/Digital_Camera/A-shadow/DSC02643.JPG,char_data/다/DSC02643.JPG_2.jpg,13080,480,640,109,226,335,323,443,True,54
다,91,kaist_dataset/Korean/Digital_Camera/A-shadow/DSC04320.JPG,char_data/다/DSC04320.JPG_2.jpg,4823,480,640,53,321,374,386,477,True,54
다,34,kaist_dataset/Korean/Digital_Camera/E-night/075.jpg,char_data/다/075.jpg_2.jpg,1632,253,490,48,202,250,98,132,True,54
다,169,kaist_dataset/Korean/Digital_Camera/E-night/DSC02597.JPG,char_data/다/DSC02597.JPG_2.jpg,29575,480,640,175,264,439,102,271,True,54
다,45,kaist_dataset/Korean/Digital_Camera/F-bookCover/DSC02806.JPG,char_data/다/DSC02806.JPG_2.jpg,2610,480,640,58,562,620,210,255,True,54
다,99,kaist_dataset/Korean/Digital_Camera/F-bookCover/DSC03929.JPG,char_data/다/DSC03929.JPG_4.jpg,11979,480,640,121,228,349,334,433,True,54
다,73,kaist_dataset/Korean/Digital_Camera/F-bookCover/DSC03929.JPG,char_data/다/DSC03929.JPG_5.jpg,5548,480,640,76,539,615,339,412,True,54
다,51,kaist_dataset/Korean/Digital_Camera/F-bookCover/DSC03933.JPG,char_data/다/DSC03933.JPG_2.jpg,1938,480,640,38,571,609,278,329,True,54
다,176,kaist_dataset/Korean/Digital_Camera/F-bookCover/P090911044.jpg,char_data/다/P090911044.jpg_2.jpg,28512,480,640,162,466,628,240,416,True,54
다,103,kaist_dataset/Korean/Digital_Camera/F-bookCover/P090911046.jpg,char_data/다/P090911046.jpg_2.jpg,16789,480,640,163,436,599,370,473,True,54
다,50,kaist_dataset/Korean/Digital_Camera/G-others/5.jpg,char_data/다/5.jpg_4.jpg,2800,553,798,56,248,304,213,263,True,54
다,94,kaist_dataset/Korean/Digital_Camera/G-others/5.jpg,char_data/다/5.jpg_5.jpg,17296,553,798,184,595,779,186,280,True,54
다,27,kaist_dataset/Korean/Digital_Camera/G-others/DSC03863.JPG,char_data/다/DSC03863.JPG_2.jpg,675,480,640,25,198,223,451,478,True,54
다,102,kaist_dataset/Korean/Digital_Camera/indoor1/2007-12-08-day-139.jpg,char_data/다/2007-12-08-day-139.jpg_2.jpg,10710,1200,1600,105,1118,1223,410,512,True,54
다,43,kaist_dataset/Korean/Digital_Camera/indoor1/DSC02298.JPG,char_data/다/DSC02298.JPG_2.jpg,946,480,640,22,581,603,211,254,True,54
다,77,kaist_dataset/Korean/Digital_Camera/indoor1/DSC02729.JPG,char_data/다/DSC02729.JPG_2.jpg,5467,480,640,71,428,499,174,251,True,54
다,50,kaist_dataset/Korean/Digital_Camera/indoor1/DSC02740.JPG,char_data/다/DSC02740.JPG_2.jpg,1600,480,640,32,555,587,90,140,True,54
다,38,kaist_dataset/Korean/Digital_Camera/indoor1/DSC02741.JPG,char_data/다/DSC02741.JPG_2.jpg,1406,480,640,37,536,573,198,236,True,54
다,75,kaist_dataset/Korean/Digital_Camera/indoor1/DSC03037.JPG,char_data/다/DSC03037.JPG_2.jpg,5550,480,640,74,411,485,46,121,True,54
다,100,kaist_dataset/Korean/Digital_Camera/indoor2/DSC03474.JPG,char_data/다/DSC03474.JPG_2.jpg,8700,480,640,87,122,209,49,149,True,54
다,111,kaist_dataset/Korean/Digital_Camera/indoor2/DSC03701.JPG,char_data/다/DSC03701.JPG_2.jpg,10878,480,640,98,459,557,328,439,True,54
다,40,kaist_dataset/Korean/Digital_Camera/indoor2/DSC04250.JPG,char_data/다/DSC04250.JPG_2.jpg,1440,480,640,36,332,368,308,348,True,54
다,120,kaist_dataset/Korean/Digital_Camera/outdoor1/91.jpg,char_data/다/91.jpg_2.jpg,16320,480,640,136,71,207,173,293,True,54
다,150,kaist_dataset/Korean/Digital_Camera/outdoor2/2007-12-09-day-exterior-008.jpg,char_data/다/2007-12-09-day-exterior-008.jpg_2.jpg,26700,1200,1600,178,583,761,379,529,True,54
다,129,kaist_dataset/Korean/Digital_Camera/outdoor2/DSC02445.JPG,char_data/다/DSC02445.JPG_4.jpg,21930,480,640,170,4,174,98,227,True,54
다,40,kaist_dataset/Korean/Digital_Camera/outdoor2/DSC02445.JPG,char_data/다/DSC02445.JPG_5.jpg,2000,480,640,50,269,319,418,458,True,54
다,72,kaist_dataset/Korean/Digital_Camera/outdoor2/DSC02520.JPG,char_data/다/DSC02520.JPG_2.jpg,4320,480,640,60,184,244,365,437,True,54
다,67,kaist_dataset/Korean/Digital_Camera/outdoor3/DSC03172.JPG,char_data/다/DSC03172.JPG_4.jpg,3417,480,640,51,306,357,163,230,True,54
다,78,kaist_dataset/Korean/Digital_Camera/outdoor3/DSC03172.JPG,char_data/다/DSC03172.JPG_5.jpg,3588,480,640,46,529,575,230,308,True,54
다,93,kaist_dataset/Korean/Digital_Camera/outdoor3/DSC03181.JPG,char_data/다/DSC03181.JPG_6.jpg,5952,480,640,64,290,354,30,123,True,54
다,79,kaist_dataset/Korean/Digital_Camera/outdoor3/DSC03181.JPG,char_data/다/DSC03181.JPG_7.jpg,4108,480,640,52,56,108,139,218,True,54
다,80,kaist_dataset/Korean/Digital_Camera/outdoor3/DSC03181.JPG,char_data/다/DSC03181.JPG_8.jpg,4000,480,640,50,344,394,256,336,True,54
다,174,kaist_dataset/Korean/Digital_Camera/outdoor4/DSC03319.JPG,char_data/다/DSC03319.JPG_2.jpg,21750,480,640,125,335,460,191,365,True,54
다,47,kaist_dataset/Korean/Digital_Camera/outdoor4/DSC03443.JPG,char_data/다/DSC03443.JPG_2.jpg,1551,480,640,33,535,568,256,303,True,54
다,73,kaist_dataset/Korean/Digital_Camera/outdoor4/DSC03453.JPG,char_data/다/DSC03453.JPG_2.jpg,5548,480,640,76,468,544,369,442,True,54
다,96,kaist_dataset/Korean/Digital_Camera/outdoor4/DSC03537.JPG,char_data/다/DSC03537.JPG_2.jpg,8256,480,640,86,112,198,25,121,True,54
다,70,kaist_dataset/Korean/Digital_Camera/outdoor4/DSC03580.JPG,char_data/다/DSC03580.JPG_2.jpg,4410,480,640,63,117,180,130,200,True,54
다,77,kaist_dataset/Korean/Digital_Camera/outdoor4/DSC03583.JPG,char_data/다/DSC03583.JPG_2.jpg,5929,480,640,77,402,479,262,339,True,54
다,71,kaist_dataset/Korean/Digital_Camera/outdoor5/DSC03659.JPG,char_data/다/DSC03659.JPG_2.jpg,4757,480,640,67,103,170,215,286,True,54
다,64,kaist_dataset/Korean/Digital_Camera/outdoor5/DSC03668.JPG,char_data/다/DSC03668.JPG_4.jpg,3392,480,640,53,483,536,175,239,True,54
다,77,kaist_dataset/Korean/Digital_Camera/outdoor5/DSC03668.JPG,char_data/다/DSC03668.JPG_5.jpg,5082,480,640,66,483,549,253,330,True,54
다,107,kaist_dataset/Korean/Digital_Camera/outdoor5/DSC03685.JPG,char_data/다/DSC03685.JPG_2.jpg,10914,480,640,102,298,400,56,163,True,54
다,58,kaist_dataset/Korean/Digital_Camera/outdoor5/DSC03713.JPG,char_data/다/DSC03713.JPG_2.jpg,2088,480,640,36,471,507,395,453,True,54
다,47,kaist_dataset/Korean/Digital_Camera/outdoor5/DSC03750.JPG,char_data/다/DSC03750.JPG_2.jpg,2397,480,640,51,555,606,414,461,True,54
다,56,kaist_dataset/Korean/Digital_Camera/outdoor5/DSC03791.JPG,char_data/다/DSC03791.JPG_2.jpg,2688,480,640,48,556,604,156,212,True,54
다,66,kaist_dataset/Korean/Digital_Camera/outdoor6/DSC04045.JPG,char_data/다/DSC04045.JPG_2.jpg,4290,480,640,65,504,569,102,168,True,54
다,50,kaist_dataset/Korean/Digital_Camera/outdoor6/DSC04051.JPG,char_data/다/DSC04051.JPG_2.jpg,2200,480,640,44,473,517,362,412,True,54
다,92,kaist_dataset/Korean/Digital_Camera/outdoor6/DSC04095.JPG,char_data/다/DSC04095.JPG_2.jpg,8924,480,640,97,489,586,204,296,True,54
다,83,kaist_dataset/Korean/Digital_Camera/outdoor6/DSC04103.JPG,char_data/다/DSC04103.JPG_2.jpg,5229,480,640,63,439,502,140,223,True,54
다,63,kaist_dataset/Korean/Digital_Camera/outdoor6/DSC04152.JPG,char_data/다/DSC04152.JPG_2.jpg,4095,480,640,65,505,570,95,158,True,54
다,97,kaist_dataset/Korean/Digital_Camera/outdoor6/DSC04350.JPG,char_data/다/DSC04350.JPG_2.jpg,4850,480,640,50,378,428,320,417,True,54
다,93,kaist_dataset/Korean/Digital_Camera/outdoor6/DSC04390.JPG,char_data/다/DSC04390.JPG_2.jpg,5487,480,640,59,311,370,261,354,True,54
다,48,kaist_dataset/Korean/Digital_Camera/outdoor7/DSC04455.JPG,char_data/다/DSC04455.JPG_2.jpg,1776,480,640,37,567,604,425,473,True,54
다,78,kaist_dataset/Korean/Digital_Camera/outdoor7/DSC04480.JPG,char_data/다/DSC04480.JPG_2.jpg,4914,480,640,63,454,517,106,184,True,54
다,52,kaist_dataset/Korean/Digital_Camera/outdoor7/k.jpg,char_data/다/k.jpg_2.jpg,1248,240,320,24,267,291,128,180,True,54
다,82,kaist_dataset/Korean/Digital_Camera/outdoor7/P1010051.JPG,char_data/다/P1010051.JPG_2.jpg,7052,480,640,86,258,344,238,320,True,54
다,190,kaist_dataset/Korean/Digital_Camera/outdoor7/P1010067.JPG,char_data/다/P1010067.JPG_2.jpg,46170,480,640,243,82,325,116,306,True,54
다,157,kaist_dataset/Korean/Digital_Camera/outdoor7/P1010077.JPG,char_data/다/P1010077.JPG_2.jpg,15072,480,640,96,331,427,76,233,True,54
다,116,kaist_dataset/Korean/Digital_Camera/outdoor7/P1010136.JPG,char_data/다/P1010136.JPG_2.jpg,13340,480,640,115,24,139,78,194,True,54
다,42,kaist_dataset/Korean/Digital_Camera/outdoor8/크기변환_P1010005.JPG,char_data/다/크기변환_P1010005.JPG_2.jpg,1890,480,640,45,542,587,284,326,True,54
다,57,"kaist_dataset/Korean/Mobile_Phone/(M,K)C-outdoor/P090903101.jpg",char_data/다/P090903101.jpg_2.jpg,2679,480,640,47,185,232,170,227,True,54
다,88,"kaist_dataset/Korean/Mobile_Phone/(M,K)E-bookCover/P090831032.jpg",char_data/다/P090831032.jpg_2.jpg,8888,480,640,101,522,623,303,391,True,54
다,113,"kaist_dataset/Korean/Mobile_Phone/(M,K)E-bookCover/P090831035.jpg",char_data/다/P090831035.jpg_2.jpg,10848,480,640,96,425,521,132,245,True,54
다,85,"kaist_dataset/Korean/Mobile_Phone/(M,K)E-bookCover/P090831050.jpg",char_data/다/P090831050.jpg_2.jpg,6375,480,640,75,539,614,387,472,True,54
다,138,"kaist_dataset/Korean/Mobile_Phone/(M,K)E-bookCover/P090831052.jpg",char_data/다/P090831052.jpg_2.jpg,17526,480,640,127,145,272,288,426,True,54
다,64,"kaist_dataset/Korean/Mobile_Phone/(M,K)E-bookCover/P090831058.jpg",char_data/다/P090831058.jpg_2.jpg,3904,480,640,61,561,622,303,367,True,54
다,109,"kaist_dataset/Korean/Mobile_Phone/(M,K)E-bookCover/P090831063.jpg",char_data/다/P090831063.jpg_2.jpg,14170,480,640,130,389,519,329,438,True,54
다,125,"kaist_dataset/Korean/Mobile_Phone/(M,K)E-bookCover/P090831127.jpg",char_data/다/P090831127.jpg_2.jpg,9750,480,640,78,380,458,74,199,True,54
다,78,"kaist_dataset/Korean/Mobile_Phone/(M,K)E-bookCover/P090903038.jpg",char_data/다/P090903038.jpg_2.jpg,6630,480,640,85,295,380,204,282,True,54
다,48,"kaist_dataset/Korean/Mobile_Phone/(M,K)E-bookCover/P090903051.jpg",char_data/다/P090903051.jpg_2.jpg,1872,480,640,39,130,169,195,243,True,54
다,112,"kaist_dataset/Korean/Mobile_Phone/(M,K)E-bookCover/P090903065.jpg",char_data/다/P090903065.jpg_2.jpg,17584,480,640,157,6,163,121,233,True,54
다,68,"kaist_dataset/Korean/Mobile_Phone/(M,K)E-bookCover/P090903094.jpg",char_data/다/P090903094.jpg_2.jpg,3740,480,640,55,416,471,319,387,True,54
다,96,"kaist_dataset/Korean/Mobile_Phone/(M,K)E-bookCover/P090903095.jpg",char_data/다/P090903095.jpg_2.jpg,7968,480,640,83,460,543,123,219,True,54
다,67,"kaist_dataset/Korean/Mobile_Phone/(M,K)E-bookCover/P090903098.jpg",char_data/다/P090903098.jpg_2.jpg,5762,480,640,86,538,624,181,248,True,54
다,92,"kaist_dataset/Korean/Mobile_Phone/(M,K)E-bookCover/P090911013.jpg",char_data/다/P090911013.jpg_2.jpg,9568,480,640,104,268,372,137,229,True,54
다,112,"kaist_dataset/Korean/Mobile_Phone/(M,K)E-bookCover/P090911019.jpg",char_data/다/P090911019.jpg_2.jpg,11872,480,640,106,326,432,190,302,True,54
다,74,kaist_dataset/Mixed/Digital_Camera/(C.S)C-outdoor1/062.JPG,char_data/다/062.JPG_2.jpg,6142,480,640,83,323,406,210,284,True,54
다,135,kaist_dataset/Mixed/Digital_Camera/(C.S)C-outdoor1/080118-0014.jpg,char_data/다/080118-0014.jpg_2.jpg,12285,1200,1600,91,1369,1460,109,244,True,54
다,89,kaist_dataset/Mixed/Digital_Camera/(C.S)C-outdoor1/080119-0006.jpg,char_data/다/080119-0006.jpg_2.jpg,6408,1200,1600,72,1229,1301,836,925,True,54
다,122,kaist_dataset/Mixed/Digital_Camera/(C.S)C-outdoor1/080119-0033.jpg,char_data/다/080119-0033.jpg_2.jpg,11956,1200,1600,98,1110,1208,948,1070,True,54
다,60,kaist_dataset/Mixed/Digital_Camera/(C.S)C-outdoor1/1.JPG,char_data/다/1.JPG_2.jpg,2400,576,768,40,328,368,460,520,True,54
다,69,kaist_dataset/Mixed/Digital_Camera/(C.S)C-outdoor1/114.jpg,char_data/다/114.jpg_2.jpg,4623,480,640,67,268,335,162,231,True,54
다,33,kaist_dataset/Mixed/Digital_Camera/(C.S)C-outdoor1/57.JPG,char_data/다/57.JPG_2.jpg,693,500,766,21,697,718,459,492,True,54
다,34,kaist_dataset/Mixed/Digital_Camera/(C.S)C-outdoor2/DSC02429.JPG,char_data/다/DSC02429.JPG_2.jpg,1598,480,640,47,375,422,251,285,True,54
다,52,kaist_dataset/Mixed/Digital_Camera/(C.S)C-outdoor3/DSC03004.JPG,char_data/다/DSC03004.JPG_2.jpg,2392,480,640,46,373,419,242,294,True,54
다,62,kaist_dataset/Mixed/Digital_Camera/(C.S)C-outdoor3/DSC03006.JPG,char_data/다/DSC03006.JPG_2.jpg,1674,480,640,27,553,580,270,332,True,54
다,92,kaist_dataset/Mixed/Digital_Camera/(C.S)C-outdoor3/DSC03187.JPG,char_data/다/DSC03187.JPG_2.jpg,10304,480,640,112,220,332,276,368,False,54
다,120,kaist_dataset/Mixed/Digital_Camera/(C.S)C-outdoor3/DSC03312.JPG,char_data/다/DSC03312.JPG_2.jpg,14400,480,640,120,326,446,153,273,False,54
다,48,kaist_dataset/Mixed/Digital_Camera/(C.S)C-outdoor4/DSC03582.JPG,char_data/다/DSC03582.JPG_2.jpg,1488,480,640,31,546,577,89,137,False,54
다,54,kaist_dataset/Mixed/Digital_Camera/(C.S)C-outdoor4/DSC03707.JPG,char_data/다/DSC03707.JPG_2.jpg,2430,480,640,45,316,361,396,450,False,54
다,69,kaist_dataset/Mixed/Digital_Camera/(C.S)C-outdoor4/DSC03741.JPG,char_data/다/DSC03741.JPG_2.jpg,3312,480,640,48,224,272,290,359,False,54
다,34,kaist_dataset/Mixed/Digital_Camera/(C.S)C-outdoor5/DSC04057.JPG,char_data/다/DSC04057.JPG_2.jpg,1496,480,640,44,378,422,326,360,False,54
다,50,kaist_dataset/Mixed/Digital_Camera/(C.S)C-outdoor5/DSC04070.JPG,char_data/다/DSC04070.JPG_2.jpg,2300,480,640,46,529,575,41,91,False,54
다,70,kaist_dataset/Mixed/Digital_Camera/(C.S)C-outdoor5/DSC04091.JPG,char_data/다/DSC04091.JPG_2.jpg,4410,480,640,63,333,396,247,317,False,54
다,98,kaist_dataset/Mixed/Digital_Camera/(C.S)C-outdoor5/DSC04312.JPG,char_data/다/DSC04312.JPG_2.jpg,7448,480,640,76,293,369,242,340,False,54
다,47,kaist_dataset/Mixed/Digital_Camera/(C.S)C-outdoor5/DSC04357.JPG,char_data/다/DSC04357.JPG_2.jpg,1739,480,640,37,467,504,294,341,False,54
다,44,kaist_dataset/Mixed/Digital_Camera/(C.S)C-outdoor5/DSC04456.JPG,char_data/다/DSC04456.JPG_2.jpg,1188,480,640,27,606,633,225,269,False,54
다,35,kaist_dataset/Mixed/Digital_Camera/(C.S)C-outdoor6/P1010048.JPG,char_data/다/P1010048.JPG_2.jpg,1015,480,640,29,93,122,112,147,False,54
다,59,kaist_dataset/Mixed/Digital_Camera/(C.S)D-indoor1/DSC02724.JPG,char_data/다/DSC02724.JPG_2.jpg,2419,480,640,41,487,528,339,398,False,54
다,52,kaist_dataset/Mixed/Digital_Camera/(C.S)D-indoor1/DSC03460.JPG,char_data/다/DSC03460.JPG_2.jpg,2392,480,640,46,182,228,262,314,False,54
다,66,kaist_dataset/Mixed/Digital_Camera/(C.S)D-indoor1/DSC03904.JPG,char_data/다/DSC03904.JPG_2.jpg,3168,480,640,48,487,535,384,450,False,54
다,40,kaist_dataset/Mixed/Digital_Camera/(C.S)D-indoor1/DSC03925.JPG,char_data/다/DSC03925.JPG_2.jpg,1080,480,640,27,301,328,343,383,False,54
다,22,kaist_dataset/Mixed/Digital_Camera/(C.S)D-indoor1/DSC03959.JPG,char_data/다/DSC03959.JPG_2.jpg,506,480,640,23,486,509,393,415,False,54
다,45,kaist_dataset/Mixed/Digital_Camera/(C.S)D-indoor1/DSC04022.JPG,char_data/다/DSC04022.JPG_2.jpg,2565,480,640,57,486,543,147,192,False,54
다,59,kaist_dataset/Mixed/Digital_Camera/(C.S)D-indoor2/DSC04487.JPG,char_data/다/DSC04487.JPG_2.jpg,3599,480,640,61,276,337,231,290,False,54
다,113,kaist_dataset/Mixed/Digital_Camera/(C.S)E-night/DSC02595.JPG,char_data/다/DSC02595.JPG_2.jpg,19775,480,640,175,256,431,217,330,False,54
다,45,kaist_dataset/Mixed/Mobile_Phone/(C.M)C-bookCover/P090903009.jpg,char_data/다/P090903009.jpg_2.jpg,1935,480,640,43,494,537,189,234,False,54
다,68,kaist_dataset/Mixed/Mobile_Phone/(C.M)C-bookCover/P090903024.jpg,char_data/다/P090903024.jpg_2.jpg,5508,480,640,81,257,338,377,445,False,54
다,171,kaist_dataset/Mixed/Mobile_Phone/(C.M)C-bookCover/P090903092.jpg,char_data/다/P090903092.jpg_2.jpg,24624,480,640,144,370,514,26,197,False,54
부,32,kaist_dataset/English/Digital_Camera/(E.S)B-light/080116-0059.jpg,char_data/부/080116-0059.jpg_6.jpg,800,1200,1600,25,490,515,998,1030,True,62
부,32,kaist_dataset/English/Digital_Camera/(E.S)B-light/080116-0059.jpg,char_data/부/080116-0059.jpg_7.jpg,608,1200,1600,19,565,584,996,1028,True,62
부,36,kaist_dataset/English/Digital_Camera/(E.S)B-light/080116-0059.jpg,char_data/부/080116-0059.jpg_8.jpg,720,1200,1600,20,892,912,1066,1102,True,62
부,56,kaist_dataset/Korean/Digital_Camera/A-shadow/2007-12-09-day-exterior-031.jpg,char_data/부/2007-12-09-day-exterior-031.jpg_2.jpg,2576,1200,1600,46,753,799,947,1003,True,62
부,94,kaist_dataset/Korean/Digital_Camera/A-shadow/DSC02670.JPG,char_data/부/DSC02670.JPG_2.jpg,7802,480,640,83,301,384,187,281,True,62
부,92,kaist_dataset/Korean/Digital_Camera/A-shadow/DSC03216.JPG,char_data/부/DSC03216.JPG_2.jpg,8004,480,640,87,61,148,71,163,True,62
부,103,kaist_dataset/Korean/Digital_Camera/F-bookCover/DSC02834.JPG,char_data/부/DSC02834.JPG_4.jpg,6180,480,640,60,481,541,27,130,True,62
부,121,kaist_dataset/Korean/Digital_Camera/F-bookCover/DSC02834.JPG,char_data/부/DSC02834.JPG_5.jpg,8470,480,640,70,565,635,294,415,True,62
부,86,kaist_dataset/Korean/Digital_Camera/F-bookCover/DSC02835.JPG,char_data/부/DSC02835.JPG_4.jpg,6364,480,640,74,507,581,18,104,True,62
부,64,kaist_dataset/Korean/Digital_Camera/F-bookCover/DSC02835.JPG,char_data/부/DSC02835.JPG_5.jpg,3904,480,640,61,540,601,327,391,True,62
부,57,kaist_dataset/Korean/Digital_Camera/F-bookCover/DSC04235.JPG,char_data/부/DSC04235.JPG_2.jpg,2052,480,640,36,275,311,104,161,True,62
부,100,kaist_dataset/Korean/Digital_Camera/G-others/DSC03434.JPG,char_data/부/DSC03434.JPG_2.jpg,13000,480,640,130,282,412,100,200,True,62
부,32,kaist_dataset/Korean/Digital_Camera/indoor1/145.JPG,char_data/부/145.JPG_2.jpg,896,480,640,28,91,119,285,317,True,62
부,117,kaist_dataset/Korean/Digital_Camera/indoor1/DSC02737.JPG,char_data/부/DSC02737.JPG_2.jpg,7137,480,640,61,63,124,242,359,True,62
부,50,kaist_dataset/Korean/Digital_Camera/indoor1/DSC02740.JPG,char_data/부/DSC02740.JPG_2.jpg,1850,480,640,37,486,523,94,144,True,62
부,113,kaist_dataset/Korean/Digital_Camera/indoor2/DSC03565.JPG,char_data/부/DSC03565.JPG_2.jpg,11074,480,640,98,300,398,134,247,True,62
부,101,kaist_dataset/Korean/Digital_Camera/indoor2/DSC03698.JPG,char_data/부/DSC03698.JPG_2.jpg,11716,480,640,116,119,235,232,333,True,62
부,173,kaist_dataset/Korean/Digital_Camera/indoor2/DSC03700.JPG,char_data/부/DSC03700.JPG_2.jpg,15051,480,640,87,40,127,121,294,True,62
부,40,kaist_dataset/Korean/Digital_Camera/indoor2/DSC03983.JPG,char_data/부/DSC03983.JPG_2.jpg,1640,480,640,41,294,335,282,322,True,62
부,57,kaist_dataset/Korean/Digital_Camera/outdoor1/001.JPG,char_data/부/001.JPG_2.jpg,4332,480,640,76,540,616,185,242,True,62
부,42,kaist_dataset/Korean/Digital_Camera/outdoor1/029.JPG,char_data/부/029.JPG_2.jpg,1428,480,640,34,91,125,143,185,True,62
부,155,kaist_dataset/Korean/Digital_Camera/outdoor1/105.JPG,char_data/부/105.JPG_2.jpg,17670,480,640,114,282,396,143,298,True,62
부,22,kaist_dataset/Korean/Digital_Camera/outdoor1/109.JPG,char_data/부/109.JPG_8.jpg,396,480,640,18,324,342,2,24,True,62
부,32,kaist_dataset/Korean/Digital_Camera/outdoor1/109.JPG,char_data/부/109.JPG_9.jpg,992,480,640,31,92,123,109,141,True,62
부,91,kaist_dataset/Korean/Digital_Camera/outdoor1/109.JPG,char_data/부/109.JPG_10.jpg,5460,480,640,60,85,145,168,259,True,62
부,54,kaist_dataset/Korean/Digital_Camera/outdoor1/109.JPG,char_data/부/109.JPG_11.jpg,2646,480,640,49,463,512,282,336,True,62
부,49,kaist_dataset/Korean/Digital_Camera/outdoor2/2007-12-08-day-109.jpg,char_data/부/2007-12-08-day-109.jpg_4.jpg,1470,1200,1600,30,517,547,784,833,True,62
부,47,kaist_dataset/Korean/Digital_Camera/outdoor2/2007-12-08-day-109.jpg,char_data/부/2007-12-08-day-109.jpg_5.jpg,611,1200,1600,13,607,620,1116,1163,True,62
부,82,kaist_dataset/Korean/Digital_Camera/outdoor2/2007-12-09-day-exterior-016.jpg,char_data/부/2007-12-09-day-exterior-016.jpg_6.jpg,4346,1200,1600,53,359,412,139,221,True,62
부,81,kaist_dataset/Korean/Digital_Camera/outdoor2/2007-12-09-day-exterior-016.jpg,char_data/부/2007-12-09-day-exterior-016.jpg_7.jpg,4698,1200,1600,58,373,431,219,300,True,62
부,76,kaist_dataset/Korean/Digital_Camera/outdoor2/2007-12-09-day-exterior-016.jpg,char_data/부/2007-12-09-day-exterior-016.jpg_8.jpg,4940,1200,1600,65,342,407,305,381,True,62
부,179,kaist_dataset/Korean/Digital_Camera/outdoor2/DSC02366.JPG,char_data/부/DSC02366.JPG_4.jpg,30072,480,640,168,473,639,204,383,True,62
부,36,kaist_dataset/Korean/Digital_Camera/outdoor2/DSC02366.JPG,char_data/부/DSC02366.JPG_5.jpg,1188,480,640,33,195,228,179,215,True,62
부,106,kaist_dataset/Korean/Digital_Camera/outdoor2/DSC02383.JPG,char_data/부/DSC02383.JPG_2.jpg,10812,480,640,102,228,330,167,273,True,62
부,132,kaist_dataset/Korean/Digital_Camera/outdoor2/DSC02426.JPG,char_data/부/DSC02426.JPG_2.jpg,19800,480,640,150,319,469,68,200,True,62
부,99,kaist_dataset/Korean/Digital_Camera/outdoor2/DSC02470.JPG,char_data/부/DSC02470.JPG_2.jpg,6831,480,640,69,40,109,265,364,True,62
부,132,kaist_dataset/Korean/Digital_Camera/outdoor2/DSC02520.JPG,char_data/부/DSC02520.JPG_2.jpg,15312,480,640,116,229,345,3,135,True,62
부,107,kaist_dataset/Korean/Digital_Camera/outdoor3/DSC02554.JPG,char_data/부/DSC02554.JPG_2.jpg,8667,480,640,81,106,187,193,300,True,62
부,53,kaist_dataset/Korean/Digital_Camera/outdoor3/DSC02891.JPG,char_data/부/DSC02891.JPG_2.jpg,2385,480,640,45,331,376,353,406,True,62
부,165,kaist_dataset/Korean/Digital_Camera/outdoor3/DSC02983.JPG,char_data/부/DSC02983.JPG_2.jpg,22440,480,640,136,98,234,117,282,True,62
부,57,kaist_dataset/Korean/Digital_Camera/outdoor3/DSC03183.JPG,char_data/부/DSC03183.JPG_2.jpg,3306,480,640,58,331,389,270,327,True,62
부,57,kaist_dataset/Korean/Digital_Camera/outdoor3/DSC03220.JPG,char_data/부/DSC03220.JPG_2.jpg,2964,480,640,52,305,357,68,125,True,62
부,82,kaist_dataset/Korean/Digital_Camera/outdoor3/DSC03237.JPG,char_data/부/DSC03237.JPG_2.jpg,6232,480,640,76,167,243,200,282,True,62
부,83,kaist_dataset/Korean/Digital_Camera/outdoor3/DSC03251.JPG,char_data/부/DSC03251.JPG_2.jpg,4482,480,640,54,117,171,269,352,True,62
부,129,kaist_dataset/Korean/Digital_Camera/outdoor4/DSC03252.JPG,char_data/부/DSC03252.JPG_2.jpg,12255,480,640,95,164,259,307,436,True,62
부,49,kaist_dataset/Korean/Digital_Camera/outdoor4/DSC03437.JPG,char_data/부/DSC03437.JPG_2.jpg,1715,480,640,35,543,578,34,83,True,62
부,96,kaist_dataset/Korean/Digital_Camera/outdoor4/DSC03445.JPG,char_data/부/DSC03445.JPG_4.jpg,7680,480,640,80,5,85,202,298,True,62
부,89,kaist_dataset/Korean/Digital_Camera/outdoor4/DSC03445.JPG,char_data/부/DSC03445.JPG_5.jpg,7565,480,640,85,82,167,204,293,True,62
부,58,kaist_dataset/Korean/Digital_Camera/outdoor4/DSC03615.JPG,char_data/부/DSC03615.JPG_2.jpg,3190,480,640,55,461,516,196,254,True,62
부,70,kaist_dataset/Korean/Digital_Camera/outdoor5/DSC03626.JPG,char_data/부/DSC03626.JPG_2.jpg,4060,480,640,58,270,328,200,270,True,62
부,105,kaist_dataset/Korean/Digital_Camera/outdoor5/DSC03629.JPG,char_data/부/DSC03629.JPG_2.jpg,5775,480,640,55,421,476,54,159,True,62
부,112,kaist_dataset/Korean/Digital_Camera/outdoor5/DSC03646.JPG,char_data/부/DSC03646.JPG_2.jpg,11200,480,640,100,163,263,346,458,True,62
부,67,kaist_dataset/Korean/Digital_Camera/outdoor5/DSC03653.JPG,char_data/부/DSC03653.JPG_2.jpg,3216,480,640,48,370,418,70,137,True,62
부,67,kaist_dataset/Korean/Digital_Camera/outdoor5/DSC03680.JPG,char_data/부/DSC03680.JPG_4.jpg,4556,480,640,68,226,294,286,353,True,62
부,74,kaist_dataset/Korean/Digital_Camera/outdoor5/DSC03680.JPG,char_data/부/DSC03680.JPG_5.jpg,5106,480,640,69,466,535,291,365,True,62
부,64,kaist_dataset/Korean/Digital_Camera/outdoor5/DSC03681.JPG,char_data/부/DSC03681.JPG_4.jpg,2624,480,640,41,218,259,353,417,True,62
부,63,kaist_dataset/Korean/Digital_Camera/outdoor5/DSC03681.JPG,char_data/부/DSC03681.JPG_5.jpg,2835,480,640,45,443,488,357,420,True,62
부,112,kaist_dataset/Korean/Digital_Camera/outdoor5/DSC03692.JPG,char_data/부/DSC03692.JPG_2.jpg,9632,480,640,86,314,400,62,174,True,62
부,62,kaist_dataset/Korean/Digital_Camera/outdoor5/DSC03709.JPG,char_data/부/DSC03709.JPG_2.jpg,2108,480,640,34,494,528,127,189,True,62
부,121,kaist_dataset/Korean/Digital_Camera/outdoor5/DSC03713.JPG,char_data/부/DSC03713.JPG_4.jpg,11374,480,640,94,295,389,45,166,True,62
부,64,kaist_dataset/Korean/Digital_Camera/outdoor5/DSC03713.JPG,char_data/부/DSC03713.JPG_5.jpg,2432,480,640,38,186,224,332,396,True,62
부,70,kaist_dataset/Korean/Digital_Camera/outdoor5/DSC03739.JPG,char_data/부/DSC03739.JPG_2.jpg,3710,480,640,53,221,274,374,444,True,62
부,38,kaist_dataset/Korean/Digital_Camera/outdoor5/DSC03776.JPG,char_data/부/DSC03776.JPG_2.jpg,1330,480,640,35,31,66,409,447,True,62
부,103,kaist_dataset/Korean/Digital_Camera/outdoor5/DSC03864.JPG,char_data/부/DSC03864.JPG_2.jpg,7313,480,640,71,101,172,42,145,True,62
부,96,kaist_dataset/Korean/Digital_Camera/outdoor5/DSC04027.JPG,char_data/부/DSC04027.JPG_2.jpg,7872,480,640,82,350,432,280,376,True,62
부,79,kaist_dataset/Korean/Digital_Camera/outdoor6/DSC04113.JPG,char_data/부/DSC04113.JPG_2.jpg,6873,480,640,87,276,363,356,435,True,62
부,143,kaist_dataset/Korean/Digital_Camera/outdoor7/DSC04448.JPG,char_data/부/DSC04448.JPG_2.jpg,16159,480,640,113,139,252,140,283,True,62
부,128,kaist_dataset/Korean/Digital_Camera/outdoor7/P1010081.JPG,char_data/부/P1010081.JPG_2.jpg,15104,480,640,118,141,259,81,209,True,62
부,36,kaist_dataset/Korean/Digital_Camera/outdoor7/P1010082.JPG,char_data/부/P1010082.JPG_2.jpg,2088,480,640,58,530,588,288,324,True,62
부,58,kaist_dataset/Korean/Digital_Camera/outdoor7/P1010101.JPG,char_data/부/P1010101.JPG_2.jpg,3712,480,640,64,88,152,108,166,True,62
부,81,kaist_dataset/Korean/Digital_Camera/outdoor7/P1010111.JPG,char_data/부/P1010111.JPG_2.jpg,7047,480,640,87,177,264,108,189,True,62
부,27,kaist_dataset/Korean/Digital_Camera/outdoor7/P1010117.JPG,char_data/부/P1010117.JPG_6.jpg,621,480,640,23,52,75,163,190,True,62
부,83,kaist_dataset/Korean/Digital_Camera/outdoor7/P1010117.JPG,char_data/부/P1010117.JPG_7.jpg,5063,480,640,61,285,346,102,185,True,62
부,117,kaist_dataset/Korean/Digital_Camera/outdoor7/P1010117.JPG,char_data/부/P1010117.JPG_8.jpg,9126,480,640,78,348,426,85,202,True,62
부,94,kaist_dataset/Korean/Digital_Camera/outdoor7/P1010138.JPG,char_data/부/P1010138.JPG_4.jpg,11656,480,640,124,309,433,122,216,True,62
부,49,kaist_dataset/Korean/Digital_Camera/outdoor7/P1010138.JPG,char_data/부/P1010138.JPG_5.jpg,2499,480,640,51,308,359,222,271,True,62
부,76,kaist_dataset/Korean/Digital_Camera/outdoor8/P1010142.JPG,char_data/부/P1010142.JPG_2.jpg,6156,480,640,81,435,516,81,157,True,62
부,56,kaist_dataset/Korean/Digital_Camera/outdoor8/크기변환_P1010033.JPG,char_data/부/크기변환_P1010033.JPG_2.jpg,3248,480,640,58,245,303,149,205,True,62
부,56,"kaist_dataset/Korean/Mobile_Phone/(M,K)C-outdoor/P090912048.jpg",char_data/부/P090912048.jpg_4.jpg,2296,480,640,41,122,163,114,170,True,62
부,38,"kaist_dataset/Korean/Mobile_Phone/(M,K)C-outdoor/P090912048.jpg",char_data/부/P090912048.jpg_5.jpg,1558,480,640,41,294,335,101,139,True,62
부,150,"kaist_dataset/Korean/Mobile_Phone/(M,K)E-bookCover/P090831104.jpg",char_data/부/P090831104.jpg_2.jpg,16950,480,640,113,17,130,92,242,True,62
부,121,"kaist_dataset/Korean/Mobile_Phone/(M,K)E-bookCover/P090831105.jpg",char_data/부/P090831105.jpg_2.jpg,9559,480,640,79,255,334,101,222,True,62
부,56,"kaist_dataset/Korean/Mobile_Phone/(M,K)E-bookCover/P090831132.jpg",char_data/부/P090831132.jpg_2.jpg,2352,480,640,42,169,211,213,269,True,62
부,36,"kaist_dataset/Korean/Mobile_Phone/(M,K)E-bookCover/P090911007.jpg",char_data/부/P090911007.jpg_2.jpg,1188,480,640,33,408,441,126,162,True,62
부,79,kaist_dataset/Mixed/Digital_Camera/(C.S)A-shadow/DSC03258.JPG,char_data/부/DSC03258.JPG_2.jpg,4187,480,640,53,241,294,358,437,True,62
부,95,kaist_dataset/Mixed/Digital_Camera/(C.S)C-outdoor1/080119-0006.jpg,char_data/부/080119-0006.jpg_2.jpg,6270,1200,1600,66,792,858,832,927,True,62
부,26,kaist_dataset/Mixed/Digital_Camera/(C.S)C-outdoor1/090.JPG,char_data/부/090.JPG_4.jpg,416,480,640,16,425,441,319,345,True,62
부,33,kaist_dataset/Mixed/Digital_Camera/(C.S)C-outdoor1/090.JPG,char_data/부/090.JPG_5.jpg,594,480,640,18,518,536,318,351,True,62
부,42,kaist_dataset/Mixed/Digital_Camera/(C.S)C-outdoor1/112.JPG,char_data/부/112.JPG_2.jpg,1596,480,640,38,270,308,281,323,False,62
부,98,kaist_dataset/Mixed/Digital_Camera/(C.S)C-outdoor1/118.JPG,char_data/부/118.JPG_2.jpg,6860,480,640,70,160,230,251,349,False,62
부,89,kaist_dataset/Mixed/Digital_Camera/(C.S)C-outdoor1/DSC02349.JPG,char_data/부/DSC02349.JPG_4.jpg,5518,480,640,62,153,215,113,202,False,62
부,71,kaist_dataset/Mixed/Digital_Camera/(C.S)C-outdoor1/DSC02349.JPG,char_data/부/DSC02349.JPG_5.jpg,5112,480,640,72,270,342,354,425,False,62
부,128,kaist_dataset/Mixed/Digital_Camera/(C.S)C-outdoor2/DSC02937.JPG,char_data/부/DSC02937.JPG_4.jpg,13824,480,640,108,172,280,45,173,False,62
부,47,kaist_dataset/Mixed/Digital_Camera/(C.S)C-outdoor2/DSC02937.JPG,char_data/부/DSC02937.JPG_5.jpg,1645,480,640,35,382,417,187,234,False,62
부,38,kaist_dataset/Mixed/Digital_Camera/(C.S)C-outdoor2/P1010013.JPG,char_data/부/P1010013.JPG_2.jpg,1444,480,640,38,320,358,240,278,False,62
부,42,kaist_dataset/Mixed/Digital_Camera/(C.S)C-outdoor3/DSC02969.JPG,char_data/부/DSC02969.JPG_2.jpg,1344,480,640,32,259,291,16,58,False,62
부,66,kaist_dataset/Mixed/Digital_Camera/(C.S)C-outdoor3/DSC03311.JPG,char_data/부/DSC03311.JPG_2.jpg,5610,480,640,85,368,453,299,365,False,62
부,64,kaist_dataset/Mixed/Digital_Camera/(C.S)C-outdoor3/DSC03330.JPG,char_data/부/DSC03330.JPG_2.jpg,3712,480,640,58,174,232,158,222,False,62
부,91,kaist_dataset/Mixed/Digital_Camera/(C.S)C-outdoor3/DSC03428.JPG,char_data/부/DSC03428.JPG_2.jpg,8827,480,640,97,502,599,147,238,False,62
부,36,kaist_dataset/Mixed/Digital_Camera/(C.S)C-outdoor4/DSC03435.JPG,char_data/부/DSC03435.JPG_2.jpg,900,480,640,25,245,270,235,271,False,62
부,54,kaist_dataset/Mixed/Digital_Camera/(C.S)C-outdoor4/DSC03707.JPG,char_data/부/DSC03707.JPG_2.jpg,2214,480,640,41,300,341,217,271,False,62
부,32,kaist_dataset/Mixed/Digital_Camera/(C.S)C-outdoor4/DSC03735.JPG,char_data/부/DSC03735.JPG_2.jpg,576,480,640,18,255,273,191,223,False,62
부,121,kaist_dataset/Mixed/Digital_Camera/(C.S)C-outdoor5/DSC04135.JPG,char_data/부/DSC04135.JPG_2.jpg,4235,480,640,35,60,95,243,364,False,62
부,118,kaist_dataset/Mixed/Digital_Camera/(C.S)C-outdoor5/DSC04449.JPG,char_data/부/DSC04449.JPG_2.jpg,11918,480,640,101,235,336,347,465,False,62
부,31,kaist_dataset/Mixed/Digital_Camera/(C.S)C-outdoor6/P1010075.JPG,char_data/부/P1010075.JPG_2.jpg,496,480,640,16,342,358,138,169,False,62
부,50,kaist_dataset/Mixed/Digital_Camera/(C.S)C-outdoor6/크기변환_P1010029.JPG,char_data/부/크기변환_P1010029.JPG_2.jpg,2000,480,640,40,439,479,334,384,False,62
부,37,kaist_dataset/Mixed/Digital_Camera/(C.S)D-indoor1/DSC02796.JPG,char_data/부/DSC02796.JPG_2.jpg,1369,480,640,37,383,420,269,306,False,62
부,51,kaist_dataset/Mixed/Digital_Camera/(C.S)D-indoor1/DSC03121.JPG,char_data/부/DSC03121.JPG_2.jpg,2244,480,640,44,251,295,274,325,False,62
부,29,kaist_dataset/Mixed/Digital_Camera/(C.S)D-indoor1/DSC03959.JPG,char_data/부/DSC03959.JPG_2.jpg,551,480,640,19,415,434,381,410,False,62
부,54,kaist_dataset/Mixed/Digital_Camera/(C.S)E-night/DSC02569.JPG,char_data/부/DSC02569.JPG_2.jpg,2862,480,640,53,269,322,221,275,False,62
부,48,kaist_dataset/Mixed/Mobile_Phone/(C.M)C-bookCover/P090904004.jpg,char_data/부/P090904004.jpg_2.jpg,912,480,640,19,474,493,142,190,False,62
서,32,kaist_dataset/English/Digital_Camera/(E.S)B-light/080116-0059.jpg,char_data/서/080116-0059.jpg_6.jpg,608,1200,1600,19,694,713,910,942,True,65
서,30,kaist_dataset/English/Digital_Camera/(E.S)B-light/080116-0059.jpg,char_data/서/080116-0059.jpg_7.jpg,540,1200,1600,18,836,854,1031,1061,True,65
서,34,kaist_dataset/English/Digital_Camera/(E.S)B-light/080116-0059.jpg,char_data/서/080116-0059.jpg_8.jpg,714,1200,1600,21,487,508,955,989,True,65
서,38,kaist_dataset/Korean/Digital_Camera/A-shadow/DSC03536.JPG,char_data/서/DSC03536.JPG_2.jpg,1026,480,640,27,69,96,236,274,True,65
서,113,kaist_dataset/Korean/Digital_Camera/A-shadow/P1010003.JPG,char_data/서/P1010003.JPG_2.jpg,8701,480,640,77,381,458,135,248,True,65
서,102,kaist_dataset/Korean/Digital_Camera/F-bookCover/DSC02830.JPG,char_data/서/DSC02830.JPG_2.jpg,13464,480,640,132,326,458,154,256,True,65
서,54,kaist_dataset/Korean/Digital_Camera/F-bookCover/DSC03933.JPG,char_data/서/DSC03933.JPG_2.jpg,2322,480,640,43,187,230,281,335,True,65
서,80,kaist_dataset/Korean/Digital_Camera/F-bookCover/DSC04217.JPG,char_data/서/DSC04217.JPG_2.jpg,6560,480,640,82,151,233,67,147,True,65
서,81,kaist_dataset/Korean/Digital_Camera/F-bookCover/DSC04227.JPG,char_data/서/DSC04227.JPG_2.jpg,4374,480,640,54,532,586,60,141,True,65
서,28,kaist_dataset/Korean/Digital_Camera/indoor1/145.JPG,char_data/서/145.JPG_2.jpg,784,480,640,28,489,517,242,270,True,65
서,43,kaist_dataset/Korean/Digital_Camera/indoor1/DSC02704.JPG,char_data/서/DSC02704.JPG_2.jpg,1548,480,640,36,405,441,325,368,True,65
서,76,kaist_dataset/Korean/Digital_Camera/indoor1/DSC02707.JPG,char_data/서/DSC02707.JPG_2.jpg,5168,480,640,68,171,239,129,205,True,65
서,59,kaist_dataset/Korean/Digital_Camera/indoor1/DSC02716.JPG,char_data/서/DSC02716.JPG_2.jpg,2950,480,640,50,334,384,211,270,True,65
서,95,kaist_dataset/Korean/Digital_Camera/indoor1/DSC02736.JPG,char_data/서/DSC02736.JPG_4.jpg,12065,480,640,127,306,433,200,295,True,65
서,33,kaist_dataset/Korean/Digital_Camera/indoor1/DSC02736.JPG,char_data/서/DSC02736.JPG_5.jpg,891,480,640,27,443,470,142,175,True,65
서,119,kaist_dataset/Korean/Digital_Camera/indoor1/DSC02741.JPG,char_data/서/DSC02741.JPG_2.jpg,12257,480,640,103,203,306,266,385,True,65
서,83,kaist_dataset/Korean/Digital_Camera/indoor1/DSC02811.JPG,char_data/서/DSC02811.JPG_2.jpg,6806,480,640,82,378,460,255,338,True,65
서,45,kaist_dataset/Korean/Digital_Camera/indoor1/DSC03072.JPG,char_data/서/DSC03072.JPG_2.jpg,2520,480,640,56,307,363,242,287,True,65
서,57,kaist_dataset/Korean/Digital_Camera/indoor1/DSC03088.JPG,char_data/서/DSC03088.JPG_2.jpg,3534,480,640,62,81,143,255,312,True,65
서,80,kaist_dataset/Korean/Digital_Camera/indoor1/DSC03089.JPG,char_data/서/DSC03089.JPG_2.jpg,5760,480,640,72,167,239,326,406,True,65
서,78,kaist_dataset/Korean/Digital_Camera/indoor1/DSC03097.JPG,char_data/서/DSC03097.JPG_2.jpg,6162,480,640,79,305,384,161,239,True,65
서,40,kaist_dataset/Korean/Digital_Camera/indoor1/DSC03113.JPG,char_data/서/DSC03113.JPG_4.jpg,1440,480,640,36,378,414,117,157,True,65
서,40,kaist_dataset/Korean/Digital_Camera/indoor1/DSC03113.JPG,char_data/서/DSC03113.JPG_5.jpg,1200,480,640,30,303,333,286,326,True,65
서,51,kaist_dataset/Korean/Digital_Camera/indoor1/DSC03116.JPG,char_data/서/DSC03116.JPG_4.jpg,2142,480,640,42,175,217,255,306,True,65
서,55,kaist_dataset/Korean/Digital_Camera/indoor1/DSC03116.JPG,char_data/서/DSC03116.JPG_5.jpg,2585,480,640,47,304,351,249,304,True,65
서,76,kaist_dataset/Korean/Digital_Camera/indoor2/DSC03391.JPG,char_data/서/DSC03391.JPG_2.jpg,5244,480,640,69,329,398,236,312,True,65
서,105,kaist_dataset/Korean/Digital_Camera/indoor2/DSC03564.JPG,char_data/서/DSC03564.JPG_2.jpg,9450,480,640,90,444,534,54,159,True,65
서,56,kaist_dataset/Korean/Digital_Camera/indoor2/DSC03983.JPG,char_data/서/DSC03983.JPG_2.jpg,4256,480,640,76,270,346,137,193,True,65
서,92,kaist_dataset/Korean/Digital_Camera/indoor2/DSC04179.JPG,char_data/서/DSC04179.JPG_2.jpg,5704,480,640,62,93,155,130,222,True,65
서,68,kaist_dataset/Korean/Digital_Camera/indoor2/DSC04186.JPG,char_data/서/DSC04186.JPG_2.jpg,3468,480,640,51,454,505,72,140,True,65
서,79,kaist_dataset/Korean/Digital_Camera/indoor2/DSC04195.JPG,char_data/서/DSC04195.JPG_2.jpg,5293,480,640,67,165,232,62,141,True,65
서,71,kaist_dataset/Korean/Digital_Camera/indoor2/DSC04196.JPG,char_data/서/DSC04196.JPG_2.jpg,4402,480,640,62,238,300,67,138,True,65
서,54,kaist_dataset/Korean/Digital_Camera/indoor2/DSC04243.JPG,char_data/서/DSC04243.JPG_2.jpg,2916,480,640,54,352,406,70,124,True,65
서,78,kaist_dataset/Korean/Digital_Camera/outdoor1/016.JPG,char_data/서/016.JPG_2.jpg,7566,480,640,97,414,511,178,256,True,65
서,70,kaist_dataset/Korean/Digital_Camera/outdoor1/2007-12-08-day-050.jpg,char_data/서/2007-12-08-day-050.jpg_2.jpg,3850,1200,1600,55,639,694,926,996,True,65
서,40,kaist_dataset/Korean/Digital_Camera/outdoor1/39.jpg,char_data/서/39.jpg_2.jpg,1120,197,320,28,278,306,123,163,True,65
서,19,kaist_dataset/Korean/Digital_Camera/outdoor1/45.jpg,char_data/서/45.jpg_2.jpg,266,253,373,14,199,213,51,70,True,65
서,40,kaist_dataset/Korean/Digital_Camera/outdoor2/DSC02396.JPG,char_data/서/DSC02396.JPG_2.jpg,1000,480,640,25,159,184,368,408,True,65
서,122,kaist_dataset/Korean/Digital_Camera/outdoor3/DSC02552.JPG,char_data/서/DSC02552.JPG_2.jpg,12322,480,640,101,21,122,249,371,True,65
서,108,kaist_dataset/Korean/Digital_Camera/outdoor3/DSC02562.JPG,char_data/서/DSC02562.JPG_2.jpg,9288,480,640,86,296,382,240,348,True,65
서,49,kaist_dataset/Korean/Digital_Camera/outdoor3/DSC03070.JPG,char_data/서/DSC03070.JPG_2.jpg,1568,480,640,32,330,362,214,263,True,65
서,57,kaist_dataset/Korean/Digital_Camera/outdoor4/DSC03325.JPG,char_data/서/DSC03325.JPG_2.jpg,3078,480,640,54,423,477,209,266,True,65
서,113,kaist_dataset/Korean/Digital_Camera/outdoor4/DSC03404.JPG,char_data/서/DSC03404.JPG_2.jpg,12204,480,640,108,24,132,131,244,True,65
서,47,kaist_dataset/Korean/Digital_Camera/outdoor4/DSC03443.JPG,char_data/서/DSC03443.JPG_2.jpg,1551,480,640,33,102,135,257,304,True,65
서,71,kaist_dataset/Korean/Digital_Camera/outdoor4/DSC03448.JPG,char_data/서/DSC03448.JPG_2.jpg,6745,480,640,95,374,469,346,417,True,65
서,63,kaist_dataset/Korean/Digital_Camera/outdoor4/DSC03449.JPG,char_data/서/DSC03449.JPG_2.jpg,2079,480,640,33,408,441,300,363,True,65
서,59,kaist_dataset/Korean/Digital_Camera/outdoor4/DSC03540.JPG,char_data/서/DSC03540.JPG_2.jpg,2360,480,640,40,532,572,317,376,True,65
서,60,kaist_dataset/Korean/Digital_Camera/outdoor4/DSC03541.JPG,char_data/서/DSC03541.JPG_2.jpg,2880,480,640,48,527,575,373,433,True,65
서,97,kaist_dataset/Korean/Digital_Camera/outdoor4/DSC03547.JPG,char_data/서/DSC03547.JPG_2.jpg,10767,480,640,111,199,310,73,170,True,65
서,55,kaist_dataset/Korean/Digital_Camera/outdoor4/DSC03578.JPG,char_data/서/DSC03578.JPG_2.jpg,2475,480,640,45,371,416,224,279,True,65
서,69,kaist_dataset/Korean/Digital_Camera/outdoor4/DSC03583.JPG,char_data/서/DSC03583.JPG_2.jpg,4347,480,640,63,217,280,176,245,True,65
서,128,kaist_dataset/Korean/Digital_Camera/outdoor5/DSC03625.JPG,char_data/서/DSC03625.JPG_2.jpg,8832,480,640,69,203,272,311,439,True,65
서,77,kaist_dataset/Korean/Digital_Camera/outdoor5/DSC03869.JPG,char_data/서/DSC03869.JPG_2.jpg,4235,480,640,55,534,589,256,333,True,65
서,54,kaist_dataset/Korean/Digital_Camera/outdoor5/DSC04040.JPG,char_data/서/DSC04040.JPG_8.jpg,3132,480,640,58,272,330,121,175,True,65
서,43,kaist_dataset/Korean/Digital_Camera/outdoor5/DSC04040.JPG,char_data/서/DSC04040.JPG_9.jpg,2193,480,640,51,516,567,134,177,True,65
서,42,kaist_dataset/Korean/Digital_Camera/outdoor5/DSC04040.JPG,char_data/서/DSC04040.JPG_10.jpg,1974,480,640,47,392,439,182,224,True,65
서,118,kaist_dataset/Korean/Digital_Camera/outdoor5/DSC04040.JPG,char_data/서/DSC04040.JPG_11.jpg,12980,480,640,110,421,531,222,340,True,65
서,64,kaist_dataset/Korean/Digital_Camera/outdoor6/DSC04074.JPG,char_data/서/DSC04074.JPG_2.jpg,3200,480,640,50,304,354,27,91,True,65
서,69,kaist_dataset/Korean/Digital_Camera/outdoor6/DSC04083.JPG,char_data/서/DSC04083.JPG_2.jpg,5106,480,640,74,26,100,160,229,True,65
서,59,kaist_dataset/Korean/Digital_Camera/outdoor6/DSC04118.JPG,char_data/서/DSC04118.JPG_2.jpg,2596,480,640,44,424,468,189,248,True,65
서,65,kaist_dataset/Korean/Digital_Camera/outdoor7/P1010015.JPG,char_data/서/P1010015.JPG_2.jpg,3770,480,640,58,210,268,204,269,True,65
서,65,kaist_dataset/Korean/Digital_Camera/outdoor7/P1010075.JPG,char_data/서/P1010075.JPG_2.jpg,4160,480,640,64,449,513,172,237,True,65
서,89,kaist_dataset/Korean/Digital_Camera/outdoor7/P1010076.JPG,char_data/서/P1010076.JPG_2.jpg,8900,480,640,100,400,500,192,281,True,65
서,124,kaist_dataset/Korean/Digital_Camera/outdoor7/P1010079.JPG,char_data/서/P1010079.JPG_4.jpg,16368,480,640,132,193,325,50,174,True,65
서,127,kaist_dataset/Korean/Digital_Camera/outdoor7/P1010079.JPG,char_data/서/P1010079.JPG_5.jpg,18034,480,640,142,325,467,191,318,True,65
서,93,kaist_dataset/Korean/Digital_Camera/outdoor8/DSC02880.JPG,char_data/서/DSC02880.JPG_2.jpg,7626,480,640,82,466,548,173,266,True,65
서,107,"kaist_dataset/Korean/Mobile_Phone/(M,K)E-bookCover/P090831040.jpg",char_data/서/P090831040.jpg_2.jpg,10165,480,640,95,409,504,129,236,True,65
서,128,"kaist_dataset/Korean/Mobile_Phone/(M,K)E-bookCover/P090831070.jpg",char_data/서/P090831070.jpg_2.jpg,11776,480,640,92,231,323,195,323,True,65
서,198,"kaist_dataset/Korean/Mobile_Phone/(M,K)E-bookCover/P090831107.jpg",char_data/서/P090831107.jpg_2.jpg,34056,480,640,172,270,442,31,229,True,65
서,139,"kaist_dataset/Korean/Mobile_Phone/(M,K)E-bookCover/P090831108.jpg",char_data/서/P090831108.jpg_2.jpg,17097,480,640,123,115,238,100,239,True,65
서,51,"kaist_dataset/Korean/Mobile_Phone/(M,K)E-bookCover/P090831132.jpg",char_data/서/P090831132.jpg_2.jpg,1887,480,640,37,469,506,215,266,True,65
서,122,"kaist_dataset/Korean/Mobile_Phone/(M,K)E-bookCover/P090903097.jpg",char_data/서/P090903097.jpg_2.jpg,10858,480,640,89,382,471,185,307,True,65
서,126,"kaist_dataset/Korean/Mobile_Phone/(M,K)E-bookCover/P090905008.jpg",char_data/서/P090905008.jpg_2.jpg,14364,480,640,114,496,610,134,260,True,65
서,119,kaist_dataset/Mixed/Digital_Camera/(C.S)C-outdoor1/080119-0033.jpg,char_data/서/080119-0033.jpg_2.jpg,12733,1200,1600,107,385,492,147,266,True,65
서,80,kaist_dataset/Mixed/Digital_Camera/(C.S)C-outdoor1/133.JPG,char_data/서/133.JPG_2.jpg,4960,480,640,62,294,356,198,278,True,65
서,78,kaist_dataset/Mixed/Digital_Camera/(C.S)C-outdoor1/DSC02318.JPG,char_data/서/DSC02318.JPG_2.jpg,5850,480,640,75,173,248,229,307,True,65
서,85,kaist_dataset/Mixed/Digital_Camera/(C.S)C-outdoor2/DSC02466.JPG,char_data/서/DSC02466.JPG_2.jpg,11220,480,640,132,339,471,173,258,True,65
서,83,kaist_dataset/Mixed/Digital_Camera/(C.S)C-outdoor2/DSC02701.JPG,char_data/서/DSC02701.JPG_2.jpg,6059,480,640,73,355,428,203,286,True,65
서,40,kaist_dataset/Mixed/Digital_Camera/(C.S)C-outdoor2/DSC02954.JPG,char_data/서/DSC02954.JPG_2.jpg,1160,480,640,29,310,339,105,145,True,65
서,60,kaist_dataset/Mixed/Digital_Camera/(C.S)C-outdoor3/DSC03329.JPG,char_data/서/DSC03329.JPG_2.jpg,3480,480,640,58,448,506,190,250,True,65
서,33,kaist_dataset/Mixed/Digital_Camera/(C.S)C-outdoor4/DSC03435.JPG,char_data/서/DSC03435.JPG_2.jpg,726,480,640,22,452,474,415,448,True,65
서,47,kaist_dataset/Mixed/Digital_Camera/(C.S)C-outdoor4/DSC03556.JPG,char_data/서/DSC03556.JPG_2.jpg,1692,480,640,36,227,263,252,299,True,65
서,48,kaist_dataset/Mixed/Digital_Camera/(C.S)C-outdoor4/DSC03571.JPG,char_data/서/DSC03571.JPG_2.jpg,1632,480,640,34,171,205,303,351,True,65
서,55,kaist_dataset/Mixed/Digital_Camera/(C.S)C-outdoor4/DSC03707.JPG,char_data/서/DSC03707.JPG_2.jpg,2255,480,640,41,259,300,216,271,True,65
서,98,kaist_dataset/Mixed/Digital_Camera/(C.S)C-outdoor5/DSC04016.JPG,char_data/서/DSC04016.JPG_2.jpg,5488,480,640,56,256,312,5,103,True,65
서,55,kaist_dataset/Mixed/Digital_Camera/(C.S)C-outdoor5/DSC04031.JPG,char_data/서/DSC04031.JPG_2.jpg,5500,480,640,100,391,491,330,385,True,65
서,78,kaist_dataset/Mixed/Digital_Camera/(C.S)C-outdoor5/DSC04048.JPG,char_data/서/DSC04048.JPG_2.jpg,4680,480,640,60,480,540,87,165,True,65
서,86,kaist_dataset/Mixed/Digital_Camera/(C.S)C-outdoor5/DSC04056.JPG,char_data/서/DSC04056.JPG_2.jpg,4816,480,640,56,240,296,325,411,True,65
서,86,kaist_dataset/Mixed/Digital_Camera/(C.S)C-outdoor5/DSC04063.JPG,char_data/서/DSC04063.JPG_2.jpg,2752,480,640,32,165,197,263,349,False,65
서,56,kaist_dataset/Mixed/Digital_Camera/(C.S)C-outdoor5/DSC04128.JPG,char_data/서/DSC04128.JPG_2.jpg,3304,480,640,59,318,377,127,183,False,65
서,71,kaist_dataset/Mixed/Digital_Camera/(C.S)C-outdoor6/080116-0057.jpg,char_data/서/080116-0057.jpg_2.jpg,3479,1200,1600,49,303,352,820,891,False,65
서,38,kaist_dataset/Mixed/Digital_Camera/(C.S)C-outdoor6/P1010045.JPG,char_data/서/P1010045.JPG_2.jpg,1216,480,640,32,321,353,403,441,False,65
서,31,kaist_dataset/Mixed/Digital_Camera/(C.S)C-outdoor6/P1010048.JPG,char_data/서/P1010048.JPG_2.jpg,868,480,640,28,152,180,113,144,False,65
서,123,kaist_dataset/Mixed/Digital_Camera/(C.S)C-outdoor6/P1010067.JPG,char_data/서/P1010067.JPG_2.jpg,15252,480,640,124,207,331,174,297,False,65
서,109,kaist_dataset/Mixed/Digital_Camera/(C.S)D-indoor1/DSC02739.JPG,char_data/서/DSC02739.JPG_2.jpg,11445,480,640,105,387,492,39,148,False,65
서,57,kaist_dataset/Mixed/Digital_Camera/(C.S)D-indoor1/DSC02746.JPG,char_data/서/DSC02746.JPG_2.jpg,3990,480,640,70,492,562,239,296,False,65
서,47,kaist_dataset/Mixed/Digital_Camera/(C.S)D-indoor1/DSC02749.JPG,char_data/서/DSC02749.JPG_2.jpg,2679,480,640,57,487,544,343,390,False,65
서,48,kaist_dataset/Mixed/Digital_Camera/(C.S)D-indoor1/DSC02750.JPG,char_data/서/DSC02750.JPG_2.jpg,3264,480,640,68,490,558,224,272,False,65
서,42,kaist_dataset/Mixed/Digital_Camera/(C.S)D-indoor1/DSC02751.JPG,char_data/서/DSC02751.JPG_2.jpg,2226,480,640,53,490,543,187,229,False,65
서,66,kaist_dataset/Mixed/Digital_Camera/(C.S)D-indoor1/DSC02752.JPG,char_data/서/DSC02752.JPG_2.jpg,3894,480,640,59,483,542,222,288,False,65
서,106,kaist_dataset/Mixed/Digital_Camera/(C.S)D-indoor1/DSC02787.JPG,char_data/서/DSC02787.JPG_2.jpg,6254,480,640,59,307,366,237,343,False,65
서,36,kaist_dataset/Mixed/Digital_Camera/(C.S)D-indoor1/DSC03096.JPG,char_data/서/DSC03096.JPG_2.jpg,1008,480,640,28,408,436,353,389,False,65
서,88,kaist_dataset/Mixed/Digital_Camera/(C.S)D-indoor1/DSC04246.JPG,char_data/서/DSC04246.JPG_2.jpg,6864,480,640,78,345,423,118,206,False,65
서,67,kaist_dataset/Mixed/Digital_Camera/(C.S)D-indoor2/DSC04487.JPG,char_data/서/DSC04487.JPG_2.jpg,4087,480,640,61,211,272,221,288,False,65
서,91,kaist_dataset/Mixed/Digital_Camera/(C.S)E-night/DSC02569.JPG,char_data/서/DSC02569.JPG_2.jpg,8281,480,640,91,255,346,74,165,False,65
서,121,kaist_dataset/Mixed/Digital_Camera/(C.S)E-night/DSC02575.JPG,char_data/서/DSC02575.JPG_2.jpg,12826,480,640,106,373,479,197,318,False,65
서,166,kaist_dataset/Mixed/Digital_Camera/(C.S)E-night/P1010151.JPG,char_data/서/P1010151.JPG_2.jpg,20418,480,640,123,155,278,182,348,False,65
서,51,kaist_dataset/Mixed/Digital_Camera/(C.S)F-others/2007-12-08-day-113.jpg,char_data/서/2007-12-08-day-113.jpg_2.jpg,1479,1200,1600,29,1044,1073,866,917,False,65
서,122,kaist_dataset/Mixed/Mobile_Phone/(C.M)B-indoor/P090831008.jpg,char_data/서/P090831008.jpg_2.jpg,10980,480,640,90,286,376,53,175,False,65
서,67,kaist_dataset/Mixed/Mobile_Phone/(C.M)C-bookCover/P090903024.jpg,char_data/서/P090903024.jpg_2.jpg,4623,480,640,69,331,400,290,357,False,65
화,37,kaist_dataset/English/Digital_Camera/(E.S)B-light/080116-0059.jpg,char_data/화/080116-0059.jpg_2.jpg,777,1200,1600,21,679,700,1077,1114,True,87
화,49,kaist_dataset/Korean/Digital_Camera/A-shadow/DSC03755.JPG,char_data/화/DSC03755.JPG_2.jpg,2548,480,640,52,86,138,243,292,True,87
화,78,kaist_dataset/Korean/Digital_Camera/F-bookCover/DSC04240.JPG,char_data/화/DSC04240.JPG_2.jpg,4992,480,640,64,374,438,94,172,True,87
화,37,kaist_dataset/Korean/Digital_Camera/indoor1/DSC02700.JPG,char_data/화/DSC02700.JPG_2.jpg,1073,480,640,29,184,213,424,461,True,87
화,83,kaist_dataset/Korean/Digital_Camera/indoor1/DSC02723.JPG,char_data/화/DSC02723.JPG_2.jpg,6308,480,640,76,399,475,328,411,True,87
화,138,kaist_dataset/Korean/Digital_Camera/indoor1/DSC02744.JPG,char_data/화/DSC02744.JPG_2.jpg,22218,480,640,161,390,551,206,344,True,87
화,92,kaist_dataset/Korean/Digital_Camera/indoor1/DSC02761.JPG,char_data/화/DSC02761.JPG_2.jpg,7820,480,640,85,315,400,273,365,True,87
화,97,kaist_dataset/Korean/Digital_Camera/indoor1/DSC02778.JPG,char_data/화/DSC02778.JPG_2.jpg,8245,480,640,85,421,506,277,374,True,87
화,116,kaist_dataset/Korean/Digital_Camera/indoor2/DSC03563.JPG,char_data/화/DSC03563.JPG_2.jpg,6960,480,640,60,108,168,236,352,True,87
화,135,kaist_dataset/Korean/Digital_Camera/outdoor1/052.JPG,char_data/화/052.JPG_2.jpg,21060,480,640,156,458,614,180,315,True,87
화,100,kaist_dataset/Korean/Digital_Camera/outdoor1/071.JPG,char_data/화/071.JPG_2.jpg,15100,480,640,151,314,465,156,256,True,87
화,87,kaist_dataset/Korean/Digital_Camera/outdoor1/085.JPG,char_data/화/085.JPG_2.jpg,9048,480,640,104,238,342,181,268,True,87
화,116,kaist_dataset/Korean/Digital_Camera/outdoor1/092.JPG,char_data/화/092.JPG_2.jpg,16936,480,640,146,420,566,163,279,True,87
화,178,kaist_dataset/Korean/Digital_Camera/outdoor1/094.JPG,char_data/화/094.JPG_2.jpg,37202,480,640,209,41,250,81,259,True,87
화,103,kaist_dataset/Korean/Digital_Camera/outdoor1/110.JPG,char_data/화/110.JPG_2.jpg,9167,480,640,89,276,365,150,253,True,87
화,134,kaist_dataset/Korean/Digital_Camera/outdoor1/120.JPG,char_data/화/120.JPG_2.jpg,12730,480,640,95,70,165,139,273,True,87
화,43,kaist_dataset/Korean/Digital_Camera/outdoor1/45.jpg,char_data/화/45.jpg_2.jpg,1462,253,373,34,272,306,79,122,True,87
화,112,kaist_dataset/Korean/Digital_Camera/outdoor2/2007-12-08-day-094.jpg,char_data/화/2007-12-08-day-094.jpg_2.jpg,8624,1600,1200,77,948,1025,351,463,True,87
화,61,kaist_dataset/Korean/Digital_Camera/outdoor2/2007-12-09-day-exterior-009.jpg,char_data/화/2007-12-09-day-exterior-009.jpg_2.jpg,4453,1200,1600,73,589,662,697,758,True,87
화,215,kaist_dataset/Korean/Digital_Camera/outdoor2/2007-12-09-day-exterior-012.jpg,char_data/화/2007-12-09-day-exterior-012.jpg_4.jpg,50955,1200,1600,237,915,1152,378,593,True,87
화,63,kaist_dataset/Korean/Digital_Camera/outdoor2/2007-12-09-day-exterior-012.jpg,char_data/화/2007-12-09-day-exterior-012.jpg_5.jpg,4284,1200,1600,68,872,940,1005,1068,True,87
화,228,kaist_dataset/Korean/Digital_Camera/outdoor2/2007-12-09-day-exterior-016.jpg,char_data/화/2007-12-09-day-exterior-016.jpg_2.jpg,68628,1200,1600,301,684,985,504,732,True,87
화,30,kaist_dataset/Korean/Digital_Camera/outdoor2/DSC02326.JPG,char_data/화/DSC02326.JPG_4.jpg,870,480,640,29,72,101,149,179,True,87
화,128,kaist_dataset/Korean/Digital_Camera/outdoor2/DSC02326.JPG,char_data/화/DSC02326.JPG_5.jpg,8576,480,640,67,469,536,207,335,True,87
화,58,kaist_dataset/Korean/Digital_Camera/outdoor2/DSC02327.JPG,char_data/화/DSC02327.JPG_4.jpg,4002,480,640,69,327,396,156,214,True,87
화,84,kaist_dataset/Korean/Digital_Camera/outdoor2/DSC02327.JPG,char_data/화/DSC02327.JPG_5.jpg,5208,480,640,62,85,147,246,330,True,87
화,89,kaist_dataset/Korean/Digital_Camera/outdoor2/DSC02380.JPG,char_data/화/DSC02380.JPG_2.jpg,9701,480,640,109,387,496,138,227,True,87
화,47,kaist_dataset/Korean/Digital_Camera/outdoor2/DSC02499.JPG,char_data/화/DSC02499.JPG_2.jpg,2820,480,640,60,419,479,1,48,True,87
화,108,kaist_dataset/Korean/Digital_Camera/outdoor2/DSC02512.JPG,char_data/화/DSC02512.JPG_2.jpg,9288,480,640,86,12,98,47,155,True,87
화,112,kaist_dataset/Korean/Digital_Camera/outdoor3/DSC02525.JPG,char_data/화/DSC02525.JPG_2.jpg,10976,480,640,98,273,371,144,256,True,87
화,38,kaist_dataset/Korean/Digital_Camera/outdoor3/DSC02531.JPG,char_data/화/DSC02531.JPG_2.jpg,950,480,640,25,56,81,290,328,True,87
화,47,kaist_dataset/Korean/Digital_Camera/outdoor3/DSC02698.JPG,char_data/화/DSC02698.JPG_2.jpg,1504,480,640,32,249,281,395,442,True,87
화,55,kaist_dataset/Korean/Digital_Camera/outdoor3/DSC02891.JPG,char_data/화/DSC02891.JPG_4.jpg,2420,480,640,44,122,166,353,408,True,87
화,99,kaist_dataset/Korean/Digital_Camera/outdoor3/DSC02891.JPG,char_data/화/DSC02891.JPG_5.jpg,9009,480,640,91,343,434,203,302,True,87
화,72,kaist_dataset/Korean/Digital_Camera/outdoor3/DSC02943.JPG,char_data/화/DSC02943.JPG_2.jpg,6624,480,640,92,222,314,362,434,True,87
화,61,kaist_dataset/Korean/Digital_Camera/outdoor3/DSC03064.JPG,char_data/화/DSC03064.JPG_2.jpg,4941,480,640,81,273,354,284,345,True,87
화,59,kaist_dataset/Korean/Digital_Camera/outdoor3/DSC03183.JPG,char_data/화/DSC03183.JPG_2.jpg,4425,480,640,75,370,445,145,204,True,87
화,34,kaist_dataset/Korean/Digital_Camera/outdoor4/DSC03272.JPG,char_data/화/DSC03272.JPG_2.jpg,1156,480,640,34,294,328,250,284,True,87
화,98,kaist_dataset/Korean/Digital_Camera/outdoor4/DSC03296.JPG,char_data/화/DSC03296.JPG_2.jpg,12152,480,640,124,20,144,215,313,True,87
화,38,kaist_dataset/Korean/Digital_Camera/outdoor4/DSC03547.JPG,char_data/화/DSC03547.JPG_2.jpg,1558,480,640,41,170,211,166,204,True,87
화,74,kaist_dataset/Korean/Digital_Camera/outdoor4/DSC03555.JPG,char_data/화/DSC03555.JPG_2.jpg,3478,480,640,47,407,454,353,427,True,87
화,62,kaist_dataset/Korean/Digital_Camera/outdoor4/DSC03596.JPG,char_data/화/DSC03596.JPG_2.jpg,3286,480,640,53,243,296,139,201,True,87
화,111,kaist_dataset/Korean/Digital_Camera/outdoor5/DSC03692.JPG,char_data/화/DSC03692.JPG_2.jpg,9546,480,640,86,413,499,66,177,True,87
화,75,kaist_dataset/Korean/Digital_Camera/outdoor5/DSC03727.JPG,char_data/화/DSC03727.JPG_2.jpg,5025,480,640,67,337,404,396,471,True,87
화,72,kaist_dataset/Korean/Digital_Camera/outdoor5/DSC03766.JPG,char_data/화/DSC03766.JPG_2.jpg,7560,480,640,105,181,286,107,179,True,87
화,125,kaist_dataset/Korean/Digital_Camera/outdoor5/DSC03770.JPG,char_data/화/DSC03770.JPG_2.jpg,8625,480,640,69,462,531,291,416,True,87
화,89,kaist_dataset/Korean/Digital_Camera/outdoor5/DSC03778.JPG,char_data/화/DSC03778.JPG_2.jpg,7120,480,640,80,249,329,226,315,True,87
화,71,kaist_dataset/Korean/Digital_Camera/outdoor5/DSC03780.JPG,char_data/화/DSC03780.JPG_2.jpg,4402,480,640,62,182,244,364,435,True,87
화,51,kaist_dataset/Korean/Digital_Camera/outdoor6/DSC04110.JPG,char_data/화/DSC04110.JPG_2.jpg,2091,480,640,41,466,507,165,216,True,87
화,33,kaist_dataset/Korean/Digital_Camera/outdoor6/DSC04112.JPG,char_data/화/DSC04112.JPG_2.jpg,858,480,640,26,34,60,273,306,True,87
화,55,kaist_dataset/Korean/Digital_Camera/outdoor6/DSC04141.JPG,char_data/화/DSC04141.JPG_2.jpg,2310,480,640,42,511,553,358,413,True,87
화,95,kaist_dataset/Korean/Digital_Camera/outdoor6/DSC04301.JPG,char_data/화/DSC04301.JPG_2.jpg,9880,480,640,104,310,414,52,147,True,87
화,84,kaist_dataset/Korean/Digital_Camera/outdoor6/DSC04370.JPG,char_data/화/DSC04370.JPG_2.jpg,7140,480,640,85,327,412,64,148,True,87
화,130,kaist_dataset/Korean/Digital_Camera/outdoor7/P1010011.JPG,char_data/화/P1010011.JPG_2.jpg,13650,480,640,105,378,483,87,217,True,87
화,97,kaist_dataset/Korean/Digital_Camera/outdoor7/P1010052.JPG,char_data/화/P1010052.JPG_2.jpg,11252,480,640,116,203,319,128,225,True,87
화,42,kaist_dataset/Korean/Digital_Camera/outdoor8/P1010170.JPG,char_data/화/P1010170.JPG_2.jpg,1722,480,640,41,115,156,272,314,True,87
화,123,"kaist_dataset/Korean/Mobile_Phone/(M,K)C-outdoor/P090912048.jpg",char_data/화/P090912048.jpg_2.jpg,12792,480,640,104,202,306,158,281,True,87
화,93,"kaist_dataset/Korean/Mobile_Phone/(M,K)D-indoor/P090831009.jpg",char_data/화/P090831009.jpg_2.jpg,8649,480,640,93,105,198,203,296,True,87
화,74,"kaist_dataset/Korean/Mobile_Phone/(M,K)D-indoor/P090911062.jpg",char_data/화/P090911062.jpg_2.jpg,5550,480,640,75,450,525,130,204,True,87
화,48,"kaist_dataset/Korean/Mobile_Phone/(M,K)D-indoor/P090911069.jpg",char_data/화/P090911069.jpg_2.jpg,2592,480,640,54,223,277,164,212,True,87
화,122,"kaist_dataset/Korean/Mobile_Phone/(M,K)E-bookCover/P090831036.jpg",char_data/화/P090831036.jpg_2.jpg,12688,480,640,104,499,603,231,353,True,87
화,121,"kaist_dataset/Korean/Mobile_Phone/(M,K)E-bookCover/P090831102.jpg",char_data/화/P090831102.jpg_2.jpg,12705,480,640,105,510,615,39,160,True,87
화,179,"kaist_dataset/Korean/Mobile_Phone/(M,K)E-bookCover/P090903064.jpg",char_data/화/P090903064.jpg_2.jpg,36516,480,640,204,37,241,251,430,True,87
화,54,"kaist_dataset/Korean/Mobile_Phone/(M,K)E-bookCover/P090903093.jpg",char_data/화/P090903093.jpg_2.jpg,2430,480,640,45,476,521,330,384,True,87
화,49,"kaist_dataset/Korean/Mobile_Phone/(M,K)E-bookCover/P090912015.jpg",char_data/화/P090912015.jpg_2.jpg,2107,480,640,43,340,383,64,113,True,87
화,32,kaist_dataset/Mixed/Digital_Camera/(C.S)C-outdoor1/047.JPG,char_data/화/047.JPG_2.jpg,480,480,640,15,83,98,238,270,True,87
화,141,kaist_dataset/Mixed/Digital_Camera/(C.S)C-outdoor1/049.JPG,char_data/화/049.JPG_2.jpg,21714,480,640,154,197,351,177,318,True,87
화,76,kaist_dataset/Mixed/Digital_Camera/(C.S)C-outdoor1/080119-0017.jpg,char_data/화/080119-0017.jpg_2.jpg,4940,1200,1600,65,667,732,1107,1183,True,87
화,42,kaist_dataset/Mixed/Digital_Camera/(C.S)C-outdoor1/48.JPG,char_data/화/48.JPG_2.jpg,1470,576,768,35,204,239,178,220,True,87
화,150,kaist_dataset/Mixed/Digital_Camera/(C.S)C-outdoor2/DSC02359.JPG,char_data/화/DSC02359.JPG_2.jpg,15750,480,640,105,439,544,26,176,True,87
화,109,kaist_dataset/Mixed/Digital_Camera/(C.S)C-outdoor2/DSC02413.JPG,char_data/화/DSC02413.JPG_2.jpg,11554,480,640,106,360,466,64,173,True,87
화,73,kaist_dataset/Mixed/Digital_Camera/(C.S)C-outdoor2/DSC02527.JPG,char_data/화/DSC02527.JPG_2.jpg,5475,480,640,75,378,453,274,347,True,87
화,36,kaist_dataset/Mixed/Digital_Camera/(C.S)C-outdoor2/DSC02933.JPG,char_data/화/DSC02933.JPG_2.jpg,900,480,640,25,260,285,238,274,True,87
화,96,kaist_dataset/Mixed/Digital_Camera/(C.S)C-outdoor2/DSC02938.JPG,char_data/화/DSC02938.JPG_2.jpg,11808,480,640,123,210,333,122,218,True,87
화,85,kaist_dataset/Mixed/Digital_Camera/(C.S)C-outdoor3/DSC02969.JPG,char_data/화/DSC02969.JPG_2.jpg,5695,480,640,67,279,346,98,183,True,87
화,65,kaist_dataset/Mixed/Digital_Camera/(C.S)C-outdoor3/DSC03329.JPG,char_data/화/DSC03329.JPG_2.jpg,4615,480,640,71,143,214,172,237,True,87
화,87,kaist_dataset/Mixed/Digital_Camera/(C.S)C-outdoor3/DSC03409.JPG,char_data/화/DSC03409.JPG_2.jpg,5046,480,640,58,352,410,37,124,True,87
화,61,kaist_dataset/Mixed/Digital_Camera/(C.S)C-outdoor4/DSC03620.JPG,char_data/화/DSC03620.JPG_2.jpg,5124,480,640,84,348,432,395,456,True,87
화,128,kaist_dataset/Mixed/Digital_Camera/(C.S)C-outdoor4/DSC03655.JPG,char_data/화/DSC03655.JPG_2.jpg,13184,480,640,103,405,508,238,366,True,87
화,148,kaist_dataset/Mixed/Digital_Camera/(C.S)C-outdoor4/DSC03675.JPG,char_data/화/DSC03675.JPG_2.jpg,12136,480,640,82,377,459,181,329,True,87
화,50,kaist_dataset/Mixed/Digital_Camera/(C.S)C-outdoor4/DSC03678.JPG,char_data/화/DSC03678.JPG_2.jpg,1650,480,640,33,425,458,181,231,True,87
화,76,kaist_dataset/Mixed/Digital_Camera/(C.S)C-outdoor4/DSC03691.JPG,char_data/화/DSC03691.JPG_2.jpg,5624,480,640,74,501,575,126,202,True,87
화,101,kaist_dataset/Mixed/Digital_Camera/(C.S)C-outdoor4/DSC03735.JPG,char_data/화/DSC03735.JPG_2.jpg,8282,480,640,82,95,177,219,320,True,87
화,95,kaist_dataset/Mixed/Digital_Camera/(C.S)C-outdoor4/DSC03784.JPG,char_data/화/DSC03784.JPG_2.jpg,6650,480,640,70,340,410,183,278,True,87
화,58,kaist_dataset/Mixed/Digital_Camera/(C.S)C-outdoor5/DSC03847.JPG,char_data/화/DSC03847.JPG_2.jpg,2494,480,640,43,259,302,15,73,True,87
화,70,kaist_dataset/Mixed/Digital_Camera/(C.S)C-outdoor5/DSC03867.JPG,char_data/화/DSC03867.JPG_2.jpg,4060,480,640,58,486,544,299,369,True,87
화,85,kaist_dataset/Mixed/Digital_Camera/(C.S)C-outdoor5/DSC04092.JPG,char_data/화/DSC04092.JPG_2.jpg,7055,480,640,83,189,272,176,261,True,87
화,112,kaist_dataset/Mixed/Digital_Camera/(C.S)C-outdoor5/DSC04094.JPG,char_data/화/DSC04094.JPG_2.jpg,15344,480,640,137,187,324,259,371,False,87
화,120,kaist_dataset/Mixed/Digital_Camera/(C.S)C-outdoor5/DSC04108.JPG,char_data/화/DSC04108.JPG_2.jpg,7680,480,640,64,207,271,180,300,False,87
화,41,kaist_dataset/Mixed/Digital_Camera/(C.S)C-outdoor5/DSC04109.JPG,char_data/화/DSC04109.JPG_2.jpg,1271,480,640,31,85,116,150,191,False,87
화,52,kaist_dataset/Mixed/Digital_Camera/(C.S)C-outdoor5/DSC04349.JPG,char_data/화/DSC04349.JPG_2.jpg,2496,480,640,48,161,209,306,358,False,87
화,112,kaist_dataset/Mixed/Digital_Camera/(C.S)C-outdoor6/P1010018.JPG,char_data/화/P1010018.JPG_2.jpg,12096,480,640,108,410,518,121,233,False,87
화,112,kaist_dataset/Mixed/Digital_Camera/(C.S)C-outdoor6/P1010021.JPG,char_data/화/P1010021.JPG_2.jpg,15568,480,640,139,496,635,84,196,False,87
화,96,kaist_dataset/Mixed/Digital_Camera/(C.S)C-outdoor6/P1010075.JPG,char_data/화/P1010075.JPG_2.jpg,8064,480,640,84,280,364,177,273,False,87
화,71,kaist_dataset/Mixed/Digital_Camera/(C.S)C-outdoor6/P1010097.JPG,char_data/화/P1010097.JPG_2.jpg,3692,480,640,52,136,188,91,162,False,87
화,97,kaist_dataset/Mixed/Digital_Camera/(C.S)C-outdoor6/크기변환_P1010029.JPG,char_data/화/크기변환_P1010029.JPG_2.jpg,9215,480,640,95,362,457,128,225,False,87
화,48,kaist_dataset/Mixed/Digital_Camera/(C.S)D-indoor1/DSC02718.JPG,char_data/화/DSC02718.JPG_4.jpg,1728,480,640,36,86,122,1,48,False,87
화,126,kaist_dataset/Mixed/Digital_Camera/(C.S)D-indoor1/DSC02718.JPG,char_data/화/DSC02718.JPG_5.jpg,13104,480,640,104,16,120,314,440,False,87
화,53,kaist_dataset/Mixed/Digital_Camera/(C.S)D-indoor1/DSC02724.JPG,char_data/화/DSC02724.JPG_2.jpg,2120,480,640,40,123,163,110,163,False,87
화,71,kaist_dataset/Mixed/Digital_Camera/(C.S)D-indoor1/DSC02782.JPG,char_data/화/DSC02782.JPG_2.jpg,6603,480,640,93,482,575,174,245,False,87
화,65,kaist_dataset/Mixed/Digital_Camera/(C.S)D-indoor1/DSC02785.JPG,char_data/화/DSC02785.JPG_2.jpg,4745,480,640,73,497,570,206,271,False,87
화,48,kaist_dataset/Mixed/Digital_Camera/(C.S)D-indoor1/DSC03478.JPG,char_data/화/DSC03478.JPG_2.jpg,2544,480,640,53,417,470,150,198,False,87
화,76,kaist_dataset/Mixed/Digital_Camera/(C.S)D-indoor1/DSC04173.JPG,char_data/화/DSC04173.JPG_2.jpg,4104,480,640,54,433,487,398,474,False,87
화,66,kaist_dataset/Mixed/Digital_Camera/(C.S)D-indoor1/DSC04198.JPG,char_data/화/DSC04198.JPG_2.jpg,3894,480,640,59,456,515,79,145,False,87
화,61,kaist_dataset/Mixed/Digital_Camera/(C.S)E-night/DSC02574.JPG,char_data/화/DSC02574.JPG_2.jpg,3355,480,640,55,397,452,61,122,False,87
화,117,kaist_dataset/Mixed/Digital_Camera/(C.S)E-night/DSC02575.JPG,char_data/화/DSC02575.JPG_2.jpg,14859,480,640,127,22,149,194,311,False,87
화,190,kaist_dataset/Mixed/Digital_Camera/(C.S)F-others/2007-12-08-day-067.jpg,char_data/화/2007-12-08-day-067.jpg_2.jpg,24890,1600,1200,131,512,643,536,726,False,87
화,53,kaist_dataset/Mixed/Digital_Camera/(C.S)F-others/2007-12-08-day-113.jpg,char_data/화/2007-12-08-day-113.jpg_2.jpg,1855,1200,1600,35,800,835,855,908,False,87
화,77,kaist_dataset/Mixed/Mobile_Phone/(C.M)B-indoor/P090831021.jpg,char_data/화/P090831021.jpg_2.jpg,7392,480,640,96,242,338,123,200,False,87
라,29,kaist_dataset/English/Digital_Camera/(E.S)B-light/080116-0059.jpg,char_data/라/080116-0059.jpg_4.jpg,551,1200,1600,19,468,487,957,986,True,58
라,35,kaist_dataset/English/Digital_Camera/(E.S)B-light/080116-0059.jpg,char_data/라/080116-0059.jpg_5.jpg,735,1200,1600,21,584,605,1082,1117,True,58
라,117,kaist_dataset/Korean/Digital_Camera/A-shadow/P090911055.jpg,char_data/라/P090911055.jpg_2.jpg,13338,480,640,114,451,565,211,328,True,58
라,106,kaist_dataset/Korean/Digital_Camera/F-bookCover/DSC02814.JPG,char_data/라/DSC02814.JPG_2.jpg,11978,480,640,113,508,621,131,237,True,58
라,69,kaist_dataset/Korean/Digital_Camera/F-bookCover/DSC02829.JPG,char_data/라/DSC02829.JPG_2.jpg,5175,480,640,75,512,587,294,363,True,58
라,86,kaist_dataset/Korean/Digital_Camera/F-bookCover/DSC02830.JPG,char_data/라/DSC02830.JPG_2.jpg,9546,480,640,111,320,431,271,357,True,58
라,90,kaist_dataset/Korean/Digital_Camera/F-bookCover/DSC02831.JPG,char_data/라/DSC02831.JPG_2.jpg,9720,480,640,108,444,552,113,203,True,58
라,76,kaist_dataset/Korean/Digital_Camera/F-bookCover/DSC03926.JPG,char_data/라/DSC03926.JPG_2.jpg,5016,480,640,66,460,526,287,363,True,58
라,77,kaist_dataset/Korean/Digital_Camera/F-bookCover/DSC03931.JPG,char_data/라/DSC03931.JPG_2.jpg,4697,480,640,61,321,382,168,245,True,58
라,122,kaist_dataset/Korean/Digital_Camera/F-bookCover/P090911040.jpg,char_data/라/P090911040.jpg_4.jpg,16714,480,640,137,453,590,287,409,True,58
라,120,kaist_dataset/Korean/Digital_Camera/F-bookCover/P090911040.jpg,char_data/라/P090911040.jpg_5.jpg,17880,480,640,149,421,570,87,207,True,58
라,122,kaist_dataset/Korean/Digital_Camera/G-others/2007-12-09-day-exterior-005.jpg,char_data/라/2007-12-09-day-exterior-005.jpg_2.jpg,11590,1600,1200,95,454,549,348,470,True,58
라,96,kaist_dataset/Korean/Digital_Camera/indoor1/DSC02708.JPG,char_data/라/DSC02708.JPG_2.jpg,6336,480,640,66,298,364,254,350,True,58
라,54,kaist_dataset/Korean/Digital_Camera/indoor1/DSC02715.JPG,char_data/라/DSC02715.JPG_2.jpg,2376,480,640,44,433,477,182,236,True,58
라,87,kaist_dataset/Korean/Digital_Camera/indoor1/DSC02728.JPG,char_data/라/DSC02728.JPG_2.jpg,6699,480,640,77,132,209,267,354,True,58
라,137,kaist_dataset/Korean/Digital_Camera/indoor1/DSC03343.JPG,char_data/라/DSC03343.JPG_2.jpg,13837,480,640,101,185,286,179,316,True,58
라,62,kaist_dataset/Korean/Digital_Camera/indoor2/DSC03383.JPG,char_data/라/DSC03383.JPG_2.jpg,4030,480,640,65,264,329,320,382,True,58
라,110,kaist_dataset/Korean/Digital_Camera/indoor2/DSC04178.JPG,char_data/라/DSC04178.JPG_2.jpg,10780,480,640,98,186,284,96,206,True,58
라,111,kaist_dataset/Korean/Digital_Camera/indoor2/DSC04190.JPG,char_data/라/DSC04190.JPG_2.jpg,11988,480,640,108,147,255,206,317,True,58
라,95,kaist_dataset/Korean/Digital_Camera/outdoor1/026.jpg,char_data/라/026.jpg_2.jpg,9975,480,640,105,405,510,159,254,True,58
라,56,kaist_dataset/Korean/Digital_Camera/outdoor1/041.jpg,char_data/라/041.jpg_2.jpg,3248,216,352,58,134,192,78,134,True,58
라,37,kaist_dataset/Korean/Digital_Camera/outdoor1/128.JPG,char_data/라/128.JPG_4.jpg,1369,480,640,37,78,115,115,152,True,58
라,42,kaist_dataset/Korean/Digital_Camera/outdoor1/128.JPG,char_data/라/128.JPG_5.jpg,1764,480,640,42,270,312,106,148,True,58
라,88,kaist_dataset/Korean/Digital_Camera/outdoor2/2007-12-08-day-109.jpg,char_data/라/2007-12-08-day-109.jpg_2.jpg,1760,1200,1600,20,212,232,490,578,True,58
라,97,kaist_dataset/Korean/Digital_Camera/outdoor3/DSC02876.JPG,char_data/라/DSC02876.JPG_2.jpg,7954,480,640,82,156,238,35,132,True,58
라,71,kaist_dataset/Korean/Digital_Camera/outdoor3/DSC02932.JPG,char_data/라/DSC02932.JPG_2.jpg,4544,480,640,64,182,246,124,195,True,58
라,97,kaist_dataset/Korean/Digital_Camera/outdoor3/DSC02951.JPG,char_data/라/DSC02951.JPG_2.jpg,7663,480,640,79,13,92,284,381,True,58
라,170,kaist_dataset/Korean/Digital_Camera/outdoor3/DSC02957.JPG,char_data/라/DSC02957.JPG_2.jpg,21420,480,640,126,1,127,220,390,True,58
라,97,kaist_dataset/Korean/Digital_Camera/outdoor3/DSC02997.JPG,char_data/라/DSC02997.JPG_2.jpg,8633,480,640,89,114,203,149,246,True,58
라,98,kaist_dataset/Korean/Digital_Camera/outdoor3/DSC03034.JPG,char_data/라/DSC03034.JPG_2.jpg,6860,480,640,70,302,372,187,285,True,58
라,66,kaist_dataset/Korean/Digital_Camera/outdoor3/DSC03172.JPG,char_data/라/DSC03172.JPG_2.jpg,3762,480,640,57,217,274,236,302,True,58
라,62,kaist_dataset/Korean/Digital_Camera/outdoor3/DSC03183.JPG,char_data/라/DSC03183.JPG_2.jpg,2604,480,640,42,491,533,71,133,True,58
라,31,kaist_dataset/Korean/Digital_Camera/outdoor4/DSC03252.JPG,char_data/라/DSC03252.JPG_2.jpg,1147,480,640,37,71,108,415,446,True,58
라,121,kaist_dataset/Korean/Digital_Camera/outdoor4/DSC03288.JPG,char_data/라/DSC03288.JPG_2.jpg,21780,480,640,180,39,219,232,353,True,58
라,91,kaist_dataset/Korean/Digital_Camera/outdoor4/DSC03293.JPG,char_data/라/DSC03293.JPG_2.jpg,8645,480,640,95,340,435,177,268,True,58
라,49,kaist_dataset/Korean/Digital_Camera/outdoor4/DSC03325.JPG,char_data/라/DSC03325.JPG_2.jpg,2646,480,640,54,404,458,373,422,True,58
라,42,kaist_dataset/Korean/Digital_Camera/outdoor5/DSC03632.JPG,char_data/라/DSC03632.JPG_2.jpg,1974,480,640,47,319,366,375,417,True,58
라,64,kaist_dataset/Korean/Digital_Camera/outdoor5/DSC03752.JPG,char_data/라/DSC03752.JPG_2.jpg,3008,480,640,47,191,238,344,408,True,58
라,114,kaist_dataset/Korean/Digital_Camera/outdoor5/DSC03833.JPG,char_data/라/DSC03833.JPG_2.jpg,8436,480,640,74,326,400,105,219,True,58
라,79,kaist_dataset/Korean/Digital_Camera/outdoor5/DSC03854.JPG,char_data/라/DSC03854.JPG_2.jpg,6320,480,640,80,377,457,64,143,True,58
라,61,kaist_dataset/Korean/Digital_Camera/outdoor5/DSC03979.JPG,char_data/라/DSC03979.JPG_2.jpg,4331,480,640,71,310,381,142,203,True,58
라,124,kaist_dataset/Korean/Digital_Camera/outdoor5/DSC03996.JPG,char_data/라/DSC03996.JPG_2.jpg,14012,480,640,113,418,531,148,272,True,58
라,53,kaist_dataset/Korean/Digital_Camera/outdoor6/DSC04044.JPG,char_data/라/DSC04044.JPG_2.jpg,2491,480,640,47,203,250,354,407,True,58
라,101,kaist_dataset/Korean/Digital_Camera/outdoor6/DSC04096.JPG,char_data/라/DSC04096.JPG_2.jpg,6363,480,640,63,213,276,102,203,True,58
라,95,kaist_dataset/Korean/Digital_Camera/outdoor6/DSC04303.JPG,char_data/라/DSC04303.JPG_2.jpg,8835,480,640,93,365,458,85,180,True,58
라,100,kaist_dataset/Korean/Digital_Camera/outdoor6/DSC04344.JPG,char_data/라/DSC04344.JPG_2.jpg,13000,480,640,130,479,609,146,246,True,58
라,62,kaist_dataset/Korean/Digital_Camera/outdoor6/DSC04446.JPG,char_data/라/DSC04446.JPG_2.jpg,3472,480,640,56,287,343,200,262,True,58
라,164,kaist_dataset/Korean/Digital_Camera/outdoor7/DSC04452.JPG,char_data/라/DSC04452.JPG_2.jpg,20828,480,640,127,323,450,75,239,True,58
라,48,kaist_dataset/Korean/Digital_Camera/outdoor7/P1010011.JPG,char_data/라/P1010011.JPG_2.jpg,1488,480,640,31,53,84,226,274,True,58
라,64,kaist_dataset/Korean/Digital_Camera/outdoor7/P1010015.JPG,char_data/라/P1010015.JPG_2.jpg,3008,480,640,47,436,483,106,170,True,58
라,68,kaist_dataset/Korean/Digital_Camera/outdoor7/P1010020.JPG,char_data/라/P1010020.JPG_4.jpg,6528,480,640,96,241,337,44,112,True,58
라,73,kaist_dataset/Korean/Digital_Camera/outdoor7/P1010020.JPG,char_data/라/P1010020.JPG_5.jpg,6935,480,640,95,242,337,123,196,True,58
라,90,kaist_dataset/Korean/Digital_Camera/outdoor7/P1010053.JPG,char_data/라/P1010053.JPG_2.jpg,9450,480,640,105,376,481,143,233,True,58
라,78,kaist_dataset/Korean/Digital_Camera/outdoor7/P1010066.JPG,char_data/라/P1010066.JPG_2.jpg,7956,480,640,102,236,338,62,140,True,58
라,43,kaist_dataset/Korean/Digital_Camera/outdoor8/DSC02929.JPG,char_data/라/DSC02929.JPG_2.jpg,1806,480,640,42,211,253,209,252,True,58
라,86,kaist_dataset/Korean/Digital_Camera/outdoor8/크기변환_P1010025.JPG,char_data/라/크기변환_P1010025.JPG_2.jpg,6106,480,640,71,401,472,88,174,True,58
라,47,"kaist_dataset/Korean/Mobile_Phone/(M,K)E-bookCover/P090831056.jpg",char_data/라/P090831056.jpg_2.jpg,1363,480,640,29,208,237,308,355,True,58
라,197,"kaist_dataset/Korean/Mobile_Phone/(M,K)E-bookCover/P090831061.jpg",char_data/라/P090831061.jpg_2.jpg,26004,480,640,132,382,514,35,232,True,58
라,88,"kaist_dataset/Korean/Mobile_Phone/(M,K)E-bookCover/P090831140.jpg",char_data/라/P090831140.jpg_2.jpg,8008,480,640,91,103,194,115,203,True,58
라,126,"kaist_dataset/Korean/Mobile_Phone/(M,K)E-bookCover/P090831146.jpg",char_data/라/P090831146.jpg_2.jpg,13230,480,640,105,7,112,28,154,True,58
라,73,"kaist_dataset/Korean/Mobile_Phone/(M,K)E-bookCover/P090831152.jpg",char_data/라/P090831152.jpg_2.jpg,5402,480,640,74,152,226,55,128,True,58
라,89,"kaist_dataset/Korean/Mobile_Phone/(M,K)E-bookCover/P090903028.jpg",char_data/라/P090903028.jpg_2.jpg,7921,480,640,89,522,611,254,343,True,58
라,40,"kaist_dataset/Korean/Mobile_Phone/(M,K)E-bookCover/P090903029.jpg",char_data/라/P090903029.jpg_2.jpg,1160,480,640,29,220,249,260,300,True,58
라,58,"kaist_dataset/Korean/Mobile_Phone/(M,K)E-bookCover/P090903043.jpg",char_data/라/P090903043.jpg_2.jpg,4176,480,640,72,499,571,139,197,True,58
라,44,"kaist_dataset/Korean/Mobile_Phone/(M,K)E-bookCover/P090903051.jpg",char_data/라/P090903051.jpg_2.jpg,1364,480,640,31,100,131,193,237,True,58
라,137,"kaist_dataset/Korean/Mobile_Phone/(M,K)E-bookCover/P090903087.jpg",char_data/라/P090903087.jpg_2.jpg,22605,480,640,165,43,208,218,355,True,58
라,112,"kaist_dataset/Korean/Mobile_Phone/(M,K)E-bookCover/P090911052.jpg",char_data/라/P090911052.jpg_4.jpg,11760,480,640,105,247,352,1,113,True,58
라,141,"kaist_dataset/Korean/Mobile_Phone/(M,K)E-bookCover/P090911052.jpg",char_data/라/P090911052.jpg_5.jpg,16920,480,640,120,287,407,96,237,True,58
라,67,"kaist_dataset/Korean/Mobile_Phone/(M,K)E-bookCover/P090912002.jpg",char_data/라/P090912002.jpg_2.jpg,4288,480,640,64,158,222,71,138,True,58
라,78,"kaist_dataset/Korean/Mobile_Phone/(M,K)E-bookCover/P090912003.jpg",char_data/라/P090912003.jpg_2.jpg,5148,480,640,66,466,532,79,157,True,58
라,93,kaist_dataset/Mixed/Digital_Camera/(C.S)B-light/DSC03298.JPG,char_data/라/DSC03298.JPG_2.jpg,7347,480,640,79,211,290,176,269,True,58
라,34,kaist_dataset/Mixed/Digital_Camera/(C.S)C-outdoor1/080.JPG,char_data/라/080.JPG_2.jpg,2006,480,640,59,435,494,123,157,True,58
라,108,kaist_dataset/Mixed/Digital_Camera/(C.S)C-outdoor1/080119-0033.jpg,char_data/라/080119-0033.jpg_2.jpg,11232,1200,1600,104,1372,1476,833,941,True,58
라,104,kaist_dataset/Mixed/Digital_Camera/(C.S)C-outdoor1/2007-12-09-day-exterior-051.jpg,char_data/라/2007-12-09-day-exterior-051.jpg_2.jpg,9776,1200,1600,94,910,1004,741,845,True,58
라,44,kaist_dataset/Mixed/Digital_Camera/(C.S)C-outdoor1/3.JPG,char_data/라/3.JPG_2.jpg,1320,576,768,30,117,147,412,456,True,58
라,39,kaist_dataset/Mixed/Digital_Camera/(C.S)C-outdoor1/DSC02350.JPG,char_data/라/DSC02350.JPG_2.jpg,1521,480,640,39,520,559,351,390,True,58
라,71,kaist_dataset/Mixed/Digital_Camera/(C.S)C-outdoor1/P1010012.JPG,char_data/라/P1010012.JPG_2.jpg,5112,480,640,72,483,555,128,199,True,58
라,35,kaist_dataset/Mixed/Digital_Camera/(C.S)C-outdoor2/DSC02447.JPG,char_data/라/DSC02447.JPG_2.jpg,980,480,640,28,397,425,181,216,True,58
라,61,kaist_dataset/Mixed/Digital_Camera/(C.S)C-outdoor2/DSC02493.JPG,char_data/라/DSC02493.JPG_2.jpg,2684,480,640,44,501,545,370,431,True,58
라,63,kaist_dataset/Mixed/Digital_Camera/(C.S)C-outdoor2/DSC02894.JPG,char_data/라/DSC02894.JPG_2.jpg,6741,480,640,107,80,187,180,243,True,58
라,102,kaist_dataset/Mixed/Digital_Camera/(C.S)C-outdoor2/P1010013.JPG,char_data/라/P1010013.JPG_2.jpg,8466,480,640,83,102,185,245,347,True,58
라,93,kaist_dataset/Mixed/Digital_Camera/(C.S)C-outdoor3/DSC02970.JPG,char_data/라/DSC02970.JPG_2.jpg,8463,480,640,91,147,238,201,294,True,58
라,49,kaist_dataset/Mixed/Digital_Camera/(C.S)C-outdoor3/DSC03010.JPG,char_data/라/DSC03010.JPG_2.jpg,2646,480,640,54,230,284,1,50,True,58
라,42,kaist_dataset/Mixed/Digital_Camera/(C.S)C-outdoor3/DSC03055.JPG,char_data/라/DSC03055.JPG_2.jpg,1470,480,640,35,153,188,215,257,True,58
라,78,kaist_dataset/Mixed/Digital_Camera/(C.S)C-outdoor3/DSC03189.JPG,char_data/라/DSC03189.JPG_2.jpg,5148,480,640,66,486,552,186,264,True,58
라,65,kaist_dataset/Mixed/Digital_Camera/(C.S)C-outdoor3/DSC03234.JPG,char_data/라/DSC03234.JPG_2.jpg,4680,480,640,72,222,294,106,171,True,58
라,33,kaist_dataset/Mixed/Digital_Camera/(C.S)C-outdoor3/DSC03236.JPG,char_data/라/DSC03236.JPG_2.jpg,726,480,640,22,544,566,428,461,True,58
라,78,kaist_dataset/Mixed/Digital_Camera/(C.S)C-outdoor3/DSC03242.JPG,char_data/라/DSC03242.JPG_2.jpg,8190,480,640,105,212,317,239,317,False,58
라,87,kaist_dataset/Mixed/Digital_Camera/(C.S)C-outdoor3/DSC03250.JPG,char_data/라/DSC03250.JPG_2.jpg,9657,480,640,111,147,258,335,422,False,58
라,132,kaist_dataset/Mixed/Digital_Camera/(C.S)C-outdoor3/DSC03260.JPG,char_data/라/DSC03260.JPG_2.jpg,15312,480,640,116,26,142,142,274,False,58
라,66,kaist_dataset/Mixed/Digital_Camera/(C.S)C-outdoor3/DSC03311.JPG,char_data/라/DSC03311.JPG_2.jpg,3498,480,640,53,169,222,312,378,False,58
라,111,kaist_dataset/Mixed/Digital_Camera/(C.S)C-outdoor3/DSC03328.JPG,char_data/라/DSC03328.JPG_2.jpg,11766,480,640,106,185,291,281,392,False,58
라,53,kaist_dataset/Mixed/Digital_Camera/(C.S)C-outdoor3/DSC03329.JPG,char_data/라/DSC03329.JPG_2.jpg,3127,480,640,59,97,156,419,472,False,58
라,45,kaist_dataset/Mixed/Digital_Camera/(C.S)C-outdoor3/DSC03331.JPG,char_data/라/DSC03331.JPG_2.jpg,1755,480,640,39,438,477,373,418,False,58
라,119,kaist_dataset/Mixed/Digital_Camera/(C.S)C-outdoor4/DSC03658.JPG,char_data/라/DSC03658.JPG_2.jpg,10829,480,640,91,220,311,284,403,False,58
라,43,kaist_dataset/Mixed/Digital_Camera/(C.S)C-outdoor4/DSC03691.JPG,char_data/라/DSC03691.JPG_2.jpg,1548,480,640,36,161,197,222,265,False,58
라,54,kaist_dataset/Mixed/Digital_Camera/(C.S)C-outdoor4/DSC03718.JPG,char_data/라/DSC03718.JPG_4.jpg,3780,480,640,70,219,289,1,55,False,58
라,75,kaist_dataset/Mixed/Digital_Camera/(C.S)C-outdoor4/DSC03718.JPG,char_data/라/DSC03718.JPG_5.jpg,3750,480,640,50,491,541,307,382,False,58
라,80,kaist_dataset/Mixed/Digital_Camera/(C.S)C-outdoor4/DSC03719.JPG,char_data/라/DSC03719.JPG_2.jpg,4480,480,640,56,492,548,83,163,False,58
라,77,kaist_dataset/Mixed/Digital_Camera/(C.S)C-outdoor5/DSC04091.JPG,char_data/라/DSC04091.JPG_2.jpg,4235,480,640,55,114,169,323,400,False,58
라,60,kaist_dataset/Mixed/Digital_Camera/(C.S)C-outdoor5/DSC04290.JPG,char_data/라/DSC04290.JPG_2.jpg,2640,480,640,44,300,344,212,272,False,58
라,66,kaist_dataset/Mixed/Digital_Camera/(C.S)C-outdoor6/080116-0057.jpg,char_data/라/080116-0057.jpg_2.jpg,3432,1200,1600,52,356,408,822,888,False,58
라,32,kaist_dataset/Mixed/Digital_Camera/(C.S)C-outdoor6/P1010111.JPG,char_data/라/P1010111.JPG_4.jpg,768,480,640,24,295,319,332,364,False,58
라,92,kaist_dataset/Mixed/Digital_Camera/(C.S)C-outdoor6/P1010111.JPG,char_data/라/P1010111.JPG_5.jpg,9752,480,640,106,418,524,77,169,False,58
라,98,kaist_dataset/Mixed/Digital_Camera/(C.S)C-outdoor6/P1010114.JPG,char_data/라/P1010114.JPG_2.jpg,6664,480,640,68,432,500,93,191,False,58
라,89,kaist_dataset/Mixed/Digital_Camera/(C.S)C-outdoor6/P1010120.JPG,char_data/라/P1010120.JPG_2.jpg,6319,480,640,71,401,472,74,163,False,58
라,39,kaist_dataset/Mixed/Digital_Camera/(C.S)C-outdoor6/P1010137.JPG,char_data/라/P1010137.JPG_2.jpg,1170,480,640,30,353,383,174,213,False,58
라,107,kaist_dataset/Mixed/Digital_Camera/(C.S)D-indoor1/DSC04226.JPG,char_data/라/DSC04226.JPG_2.jpg,9630,480,640,90,199,289,159,266,False,58
라,74,kaist_dataset/Mixed/Digital_Camera/(C.S)F-others/2007-12-08-day-113.jpg,char_data/라/2007-12-08-day-113.jpg_2.jpg,3700,1200,1600,50,376,426,828,902,False,58
세,30,kaist_dataset/English/Digital_Camera/(E.S)B-light/080116-0059.jpg,char_data/세/080116-0059.jpg_2.jpg,600,1200,1600,20,631,651,911,941,True,66
세,26,kaist_dataset/Korean/Digital_Camera/E-night/106.jpg,char_data/세/106.jpg_2.jpg,676,480,640,26,165,191,112,138,True,66
세,52,kaist_dataset/Korean/Digital_Camera/E-night/DSC03849.JPG,char_data/세/DSC03849.JPG_2.jpg,2756,480,640,53,89,142,366,418,True,66
세,85,kaist_dataset/Korean/Digital_Camera/F-bookCover/DSC02812.JPG,char_data/세/DSC02812.JPG_2.jpg,7140,480,640,84,453,537,24,109,True,66
세,79,kaist_dataset/Korean/Digital_Camera/F-bookCover/DSC02813.JPG,char_data/세/DSC02813.JPG_2.jpg,6557,480,640,83,409,492,27,106,True,66
세,79,kaist_dataset/Korean/Digital_Camera/F-bookCover/DSC02814.JPG,char_data/세/DSC02814.JPG_2.jpg,5609,480,640,71,417,488,27,106,True,66
세,56,kaist_dataset/Korean/Digital_Camera/F-bookCover/DSC02815.JPG,char_data/세/DSC02815.JPG_2.jpg,4032,480,640,72,385,457,36,92,True,66
세,96,kaist_dataset/Korean/Digital_Camera/F-bookCover/DSC02822.JPG,char_data/세/DSC02822.JPG_2.jpg,9984,480,640,104,117,221,148,244,True,66
세,62,kaist_dataset/Korean/Digital_Camera/F-bookCover/DSC02823.JPG,char_data/세/DSC02823.JPG_2.jpg,5828,480,640,94,117,211,239,301,True,66
세,76,kaist_dataset/Korean/Digital_Camera/F-bookCover/DSC02824.JPG,char_data/세/DSC02824.JPG_2.jpg,7448,480,640,98,123,221,230,306,True,66
세,74,kaist_dataset/Korean/Digital_Camera/F-bookCover/DSC02826.JPG,char_data/세/DSC02826.JPG_2.jpg,5846,480,640,79,126,205,294,368,True,66
세,57,kaist_dataset/Korean/Digital_Camera/F-bookCover/DSC02827.JPG,char_data/세/DSC02827.JPG_4.jpg,4104,480,640,72,190,262,359,416,True,66
세,50,kaist_dataset/Korean/Digital_Camera/F-bookCover/DSC02827.JPG,char_data/세/DSC02827.JPG_5.jpg,2900,480,640,58,206,264,98,148,True,66
세,58,kaist_dataset/Korean/Digital_Camera/F-bookCover/DSC02829.JPG,char_data/세/DSC02829.JPG_2.jpg,3306,480,640,57,278,335,95,153,True,66
세,51,kaist_dataset/Korean/Digital_Camera/F-bookCover/DSC02832.JPG,char_data/세/DSC02832.JPG_4.jpg,2907,480,640,57,288,345,375,426,True,66
세,67,kaist_dataset/Korean/Digital_Camera/F-bookCover/DSC02832.JPG,char_data/세/DSC02832.JPG_5.jpg,4154,480,640,62,267,329,63,130,True,66
세,53,kaist_dataset/Korean/Digital_Camera/F-bookCover/DSC02833.JPG,char_data/세/DSC02833.JPG_4.jpg,2544,480,640,48,286,334,399,452,True,66
세,38,kaist_dataset/Korean/Digital_Camera/F-bookCover/DSC02833.JPG,char_data/세/DSC02833.JPG_5.jpg,1976,480,640,52,248,300,90,128,True,66
세,46,kaist_dataset/Korean/Digital_Camera/F-bookCover/DSC02834.JPG,char_data/세/DSC02834.JPG_4.jpg,2760,480,640,60,221,281,93,139,True,66
세,69,kaist_dataset/Korean/Digital_Camera/F-bookCover/DSC02834.JPG,char_data/세/DSC02834.JPG_5.jpg,4416,480,640,64,284,348,370,439,True,66
세,44,kaist_dataset/Korean/Digital_Camera/F-bookCover/DSC02835.JPG,char_data/세/DSC02835.JPG_4.jpg,2420,480,640,55,237,292,71,115,True,66
세,46,kaist_dataset/Korean/Digital_Camera/F-bookCover/DSC02835.JPG,char_data/세/DSC02835.JPG_5.jpg,2668,480,640,58,261,319,377,423,True,66
세,59,kaist_dataset/Korean/Digital_Camera/F-bookCover/DSC02836.JPG,char_data/세/DSC02836.JPG_2.jpg,5723,480,640,97,116,213,249,308,True,66
세,96,kaist_dataset/Korean/Digital_Camera/F-bookCover/P090911046.jpg,char_data/세/P090911046.jpg_2.jpg,9888,480,640,103,329,432,370,466,True,66
세,61,kaist_dataset/Korean/Digital_Camera/indoor1/141.JPG,char_data/세/141.JPG_2.jpg,3233,480,640,53,321,374,223,284,True,66
세,98,kaist_dataset/Korean/Digital_Camera/indoor1/2007-12-08-day-139.jpg,char_data/세/2007-12-08-day-139.jpg_2.jpg,9310,1200,1600,95,980,1075,635,733,True,66
세,83,kaist_dataset/Korean/Digital_Camera/indoor1/DSC02700.JPG,char_data/세/DSC02700.JPG_2.jpg,5312,480,640,64,401,465,80,163,True,66
세,28,kaist_dataset/Korean/Digital_Camera/indoor1/DSC02757.JPG,char_data/세/DSC02757.JPG_2.jpg,756,480,640,27,393,420,154,182,True,66
세,151,kaist_dataset/Korean/Digital_Camera/indoor1/DSC02768.JPG,char_data/세/DSC02768.JPG_2.jpg,22650,480,640,150,321,471,169,320,True,66
세,32,kaist_dataset/Korean/Digital_Camera/indoor1/DSC03113.JPG,char_data/세/DSC03113.JPG_2.jpg,832,480,640,26,375,401,293,325,True,66
세,50,kaist_dataset/Korean/Digital_Camera/indoor1/DSC03116.JPG,char_data/세/DSC03116.JPG_2.jpg,2200,480,640,44,130,174,186,236,True,66
세,114,kaist_dataset/Korean/Digital_Camera/indoor1/DSC03374.JPG,char_data/세/DSC03374.JPG_2.jpg,10374,480,640,91,317,408,112,226,True,66
세,80,kaist_dataset/Korean/Digital_Camera/indoor2/DSC03391.JPG,char_data/세/DSC03391.JPG_2.jpg,4480,480,640,56,276,332,232,312,True,66
세,81,kaist_dataset/Korean/Digital_Camera/indoor2/DSC03497.JPG,char_data/세/DSC03497.JPG_2.jpg,4617,480,640,57,382,439,91,172,True,66
세,129,kaist_dataset/Korean/Digital_Camera/indoor2/DSC03558.JPG,char_data/세/DSC03558.JPG_2.jpg,10965,480,640,85,306,391,171,300,True,66
세,50,kaist_dataset/Korean/Digital_Camera/indoor2/DSC03564.JPG,char_data/세/DSC03564.JPG_2.jpg,2650,480,640,53,138,191,165,215,True,66
세,181,kaist_dataset/Korean/Digital_Camera/indoor2/DSC03697.JPG,char_data/세/DSC03697.JPG_2.jpg,19005,480,640,105,335,440,201,382,True,66
세,63,kaist_dataset/Korean/Digital_Camera/indoor2/DSC03974.JPG,char_data/세/DSC03974.JPG_2.jpg,3402,480,640,54,67,121,200,263,True,66
세,82,kaist_dataset/Korean/Digital_Camera/outdoor1/066.jpg,char_data/세/066.jpg_2.jpg,6396,270,468,78,236,314,63,145,True,66
세,147,kaist_dataset/Korean/Digital_Camera/outdoor1/105.JPG,char_data/세/105.JPG_2.jpg,16611,480,640,113,48,161,143,290,True,66
세,24,kaist_dataset/Korean/Digital_Camera/outdoor1/109.JPG,char_data/세/109.JPG_2.jpg,384,480,640,16,328,344,36,60,True,66
세,28,kaist_dataset/Korean/Digital_Camera/outdoor1/2007-12-08-day-087.jpg,char_data/세/2007-12-08-day-087.jpg_2.jpg,1372,1200,1600,49,261,310,627,655,True,66
세,124,kaist_dataset/Korean/Digital_Camera/outdoor2/080118-0018.jpg,char_data/세/080118-0018.jpg_2.jpg,13888,1200,1600,112,447,559,1092,1199,True,66
세,126,kaist_dataset/Korean/Digital_Camera/outdoor2/DSC02373.JPG,char_data/세/DSC02373.JPG_2.jpg,12222,480,640,97,256,353,203,329,True,66
세,114,kaist_dataset/Korean/Digital_Camera/outdoor2/DSC02465.JPG,char_data/세/DSC02465.JPG_2.jpg,16188,480,640,142,26,168,332,446,True,66
세,96,kaist_dataset/Korean/Digital_Camera/outdoor2/DSC02467.JPG,char_data/세/DSC02467.JPG_2.jpg,9408,480,640,98,54,152,153,249,True,66
세,64,kaist_dataset/Korean/Digital_Camera/outdoor3/DSC02697.JPG,char_data/세/DSC02697.JPG_2.jpg,4032,480,640,63,87,150,143,207,True,66
세,73,kaist_dataset/Korean/Digital_Camera/outdoor3/DSC03214.JPG,char_data/세/DSC03214.JPG_2.jpg,3139,480,640,43,381,424,173,246,True,66
세,46,kaist_dataset/Korean/Digital_Camera/outdoor4/DSC03443.JPG,char_data/세/DSC03443.JPG_2.jpg,1656,480,640,36,167,203,259,305,True,66
세,88,kaist_dataset/Korean/Digital_Camera/outdoor4/DSC03445.JPG,char_data/세/DSC03445.JPG_2.jpg,8184,480,640,93,265,358,201,289,True,66
세,76,kaist_dataset/Korean/Digital_Camera/outdoor4/DSC03457.JPG,char_data/세/DSC03457.JPG_2.jpg,6156,480,640,81,373,454,192,268,True,66
세,48,kaist_dataset/Korean/Digital_Camera/outdoor4/DSC03538.JPG,char_data/세/DSC03538.JPG_2.jpg,1104,480,640,23,127,150,114,162,True,66
세,47,kaist_dataset/Korean/Digital_Camera/outdoor4/DSC03578.JPG,char_data/세/DSC03578.JPG_2.jpg,799,480,640,17,467,484,144,191,True,66
세,79,kaist_dataset/Korean/Digital_Camera/outdoor5/DSC03659.JPG,char_data/세/DSC03659.JPG_2.jpg,5214,480,640,66,168,234,211,290,True,66
세,113,kaist_dataset/Korean/Digital_Camera/outdoor5/DSC03857.JPG,char_data/세/DSC03857.JPG_2.jpg,9944,480,640,88,51,139,287,400,True,66
세,73,kaist_dataset/Korean/Digital_Camera/outdoor5/DSC04037.JPG,char_data/세/DSC04037.JPG_2.jpg,4526,480,640,62,151,213,128,201,True,66
세,48,kaist_dataset/Korean/Digital_Camera/outdoor6/DSC04126.JPG,char_data/세/DSC04126.JPG_2.jpg,1440,480,640,30,272,302,203,251,True,66
세,51,kaist_dataset/Korean/Digital_Camera/outdoor6/DSC04148.JPG,char_data/세/DSC04148.JPG_2.jpg,1785,480,640,35,207,242,364,415,True,66
세,85,kaist_dataset/Korean/Digital_Camera/outdoor6/DSC04396.JPG,char_data/세/DSC04396.JPG_2.jpg,5015,480,640,59,418,477,148,233,True,66
세,35,kaist_dataset/Korean/Digital_Camera/outdoor7/P1010045.JPG,char_data/세/P1010045.JPG_2.jpg,1155,480,640,33,154,187,25,60,True,66
세,49,kaist_dataset/Korean/Digital_Camera/outdoor7/P1010089.JPG,char_data/세/P1010089.JPG_2.jpg,2254,480,640,46,158,204,292,341,True,66
세,32,kaist_dataset/Korean/Digital_Camera/outdoor7/P1010136.JPG,char_data/세/P1010136.JPG_4.jpg,576,480,640,18,218,236,261,293,True,66
세,35,kaist_dataset/Korean/Digital_Camera/outdoor7/P1010136.JPG,char_data/세/P1010136.JPG_5.jpg,700,480,640,20,356,376,263,298,True,66
세,31,kaist_dataset/Korean/Digital_Camera/outdoor8/DSC02875.JPG,char_data/세/DSC02875.JPG_4.jpg,961,480,640,31,216,247,426,457,True,66
세,72,kaist_dataset/Korean/Digital_Camera/outdoor8/DSC02875.JPG,char_data/세/DSC02875.JPG_5.jpg,5616,480,640,78,268,346,179,251,True,66
세,66,kaist_dataset/Korean/Digital_Camera/outdoor8/DSC02896.JPG,char_data/세/DSC02896.JPG_2.jpg,4620,480,640,70,306,376,188,254,True,66
세,69,kaist_dataset/Korean/Digital_Camera/outdoor8/크기변환_P1010026.JPG,char_data/세/크기변환_P1010026.JPG_2.jpg,3450,480,640,50,214,264,130,199,True,66
세,47,"kaist_dataset/Korean/Mobile_Phone/(M,K)C-outdoor/P090912033.jpg",char_data/세/P090912033.jpg_4.jpg,1692,480,640,36,374,410,303,350,True,66
세,47,"kaist_dataset/Korean/Mobile_Phone/(M,K)C-outdoor/P090912033.jpg",char_data/세/P090912033.jpg_5.jpg,2397,480,640,51,471,522,303,350,True,66
세,68,"kaist_dataset/Korean/Mobile_Phone/(M,K)D-indoor/P090912024.jpg",char_data/세/P090912024.jpg_2.jpg,4828,480,640,71,465,536,151,219,True,66
세,87,"kaist_dataset/Korean/Mobile_Phone/(M,K)E-bookCover/P090831047.jpg",char_data/세/P090831047.jpg_2.jpg,5133,480,640,59,79,138,143,230,True,66
세,55,"kaist_dataset/Korean/Mobile_Phone/(M,K)E-bookCover/P090831132.jpg",char_data/세/P090831132.jpg_2.jpg,2090,480,640,38,84,122,214,269,True,66
세,109,"kaist_dataset/Korean/Mobile_Phone/(M,K)E-bookCover/P090903040.jpg",char_data/세/P090903040.jpg_2.jpg,10900,480,640,100,186,286,192,301,True,66
세,102,kaist_dataset/Mixed/Digital_Camera/(C.S)A-shadow/DSC02567.JPG,char_data/세/DSC02567.JPG_4.jpg,6732,480,640,66,24,90,31,133,True,66
세,69,kaist_dataset/Mixed/Digital_Camera/(C.S)A-shadow/DSC02568.JPG,char_data/세/DSC02568.JPG_4.jpg,4002,480,640,58,9,67,134,203,True,66
세,21,kaist_dataset/Mixed/Digital_Camera/(C.S)C-outdoor1/014.JPG,char_data/세/014.JPG_2.jpg,399,480,640,19,426,445,277,298,True,66
세,176,kaist_dataset/Mixed/Digital_Camera/(C.S)C-outdoor1/080118-0007.jpg,char_data/세/080118-0007.jpg_2.jpg,24992,1200,1600,142,706,848,182,358,True,66
세,37,kaist_dataset/Mixed/Digital_Camera/(C.S)C-outdoor1/080119-0027.jpg,char_data/세/080119-0027.jpg_2.jpg,1036,1200,1600,28,952,980,1002,1039,True,66
세,127,kaist_dataset/Mixed/Digital_Camera/(C.S)C-outdoor1/080119-0033.jpg,char_data/세/080119-0033.jpg_2.jpg,12573,1200,1600,99,1045,1144,143,270,True,66
세,97,kaist_dataset/Mixed/Digital_Camera/(C.S)C-outdoor1/51.JPG,char_data/세/51.JPG_2.jpg,8245,576,768,85,233,318,198,295,True,66
세,121,kaist_dataset/Mixed/Digital_Camera/(C.S)C-outdoor1/DSC02244.JPG,char_data/세/DSC02244.JPG_2.jpg,15125,480,640,125,26,151,107,228,True,66
세,31,kaist_dataset/Mixed/Digital_Camera/(C.S)C-outdoor2/DSC02429.JPG,char_data/세/DSC02429.JPG_2.jpg,1178,480,640,38,462,500,251,282,True,66
세,39,kaist_dataset/Mixed/Digital_Camera/(C.S)C-outdoor2/DSC02434.JPG,char_data/세/DSC02434.JPG_2.jpg,1872,480,640,48,79,127,101,140,True,66
세,41,kaist_dataset/Mixed/Digital_Camera/(C.S)C-outdoor2/DSC02447.JPG,char_data/세/DSC02447.JPG_2.jpg,1107,480,640,27,281,308,173,214,True,66
세,90,kaist_dataset/Mixed/Digital_Camera/(C.S)C-outdoor2/DSC02461.JPG,char_data/세/DSC02461.JPG_2.jpg,6480,480,640,72,1,73,195,285,True,66
세,88,kaist_dataset/Mixed/Digital_Camera/(C.S)C-outdoor2/DSC02466.JPG,char_data/세/DSC02466.JPG_2.jpg,10472,480,640,119,58,177,173,261,True,66
세,102,kaist_dataset/Mixed/Digital_Camera/(C.S)C-outdoor2/DSC02567.JPG,char_data/세/DSC02567.JPG_5.jpg,6732,480,640,66,24,90,31,133,True,66
세,69,kaist_dataset/Mixed/Digital_Camera/(C.S)C-outdoor2/DSC02568.JPG,char_data/세/DSC02568.JPG_5.jpg,4002,480,640,58,9,67,134,203,False,66
세,37,kaist_dataset/Mixed/Digital_Camera/(C.S)C-outdoor3/DSC02969.JPG,char_data/세/DSC02969.JPG_2.jpg,1295,480,640,35,147,182,18,55,False,66
세,41,kaist_dataset/Mixed/Digital_Camera/(C.S)C-outdoor3/DSC03055.JPG,char_data/세/DSC03055.JPG_2.jpg,1189,480,640,29,260,289,218,259,False,66
세,51,kaist_dataset/Mixed/Digital_Camera/(C.S)C-outdoor3/DSC03186.JPG,char_data/세/DSC03186.JPG_2.jpg,2397,480,640,47,156,203,51,102,False,66
세,75,kaist_dataset/Mixed/Digital_Camera/(C.S)C-outdoor4/DSC03446.JPG,char_data/세/DSC03446.JPG_2.jpg,5850,480,640,78,158,236,216,291,False,66
세,67,kaist_dataset/Mixed/Digital_Camera/(C.S)C-outdoor4/DSC03570.JPG,char_data/세/DSC03570.JPG_2.jpg,2479,480,640,37,474,511,353,420,False,66
세,122,kaist_dataset/Mixed/Digital_Camera/(C.S)C-outdoor4/DSC03722.JPG,char_data/세/DSC03722.JPG_2.jpg,16104,480,640,132,281,413,68,190,False,66
세,70,kaist_dataset/Mixed/Digital_Camera/(C.S)C-outdoor5/DSC03830.JPG,char_data/세/DSC03830.JPG_2.jpg,2660,480,640,38,411,449,26,96,False,66
세,49,kaist_dataset/Mixed/Digital_Camera/(C.S)C-outdoor5/DSC04078.JPG,char_data/세/DSC04078.JPG_2.jpg,2254,480,640,46,163,209,225,274,False,66
세,70,kaist_dataset/Mixed/Digital_Camera/(C.S)C-outdoor5/DSC04091.JPG,char_data/세/DSC04091.JPG_2.jpg,4270,480,640,61,249,310,168,238,False,66
세,59,kaist_dataset/Mixed/Digital_Camera/(C.S)C-outdoor5/DSC04447.JPG,char_data/세/DSC04447.JPG_2.jpg,2655,480,640,45,175,220,133,192,False,66
세,69,kaist_dataset/Mixed/Digital_Camera/(C.S)C-outdoor6/080116-0057.jpg,char_data/세/080116-0057.jpg_4.jpg,3588,1200,1600,52,249,301,820,889,False,66
세,61,kaist_dataset/Mixed/Digital_Camera/(C.S)C-outdoor6/080116-0057.jpg,char_data/세/080116-0057.jpg_5.jpg,3477,1200,1600,57,445,502,1084,1145,False,66
세,58,kaist_dataset/Mixed/Digital_Camera/(C.S)C-outdoor6/P1010062.JPG,char_data/세/P1010062.JPG_2.jpg,5626,480,640,97,206,303,142,200,False,66
세,57,kaist_dataset/Mixed/Digital_Camera/(C.S)C-outdoor6/P1010095.JPG,char_data/세/P1010095.JPG_2.jpg,2337,480,640,41,434,475,301,358,False,66
세,91,kaist_dataset/Mixed/Digital_Camera/(C.S)D-indoor1/DSC04231.JPG,char_data/세/DSC04231.JPG_2.jpg,6461,480,640,71,57,128,273,364,False,66
세,66,kaist_dataset/Mixed/Digital_Camera/(C.S)D-indoor2/DSC04487.JPG,char_data/세/DSC04487.JPG_2.jpg,3762,480,640,57,382,439,227,293,False,66
세,72,kaist_dataset/Mixed/Mobile_Phone/(C.M)B-indoor/P090831017.jpg,char_data/세/P090831017.jpg_2.jpg,6624,480,640,92,133,225,151,223,False,66
세,152,kaist_dataset/Mixed/Mobile_Phone/(C.M)C-bookCover/P090831124.jpg,char_data/세/P090831124.jpg_4.jpg,18088,480,640,119,149,268,237,389,False,66
세,177,kaist_dataset/Mixed/Mobile_Phone/(C.M)C-bookCover/P090831124.jpg,char_data/세/P090831124.jpg_5.jpg,22125,480,640,125,507,632,205,382,False,66
세,109,kaist_dataset/Mixed/Mobile_Phone/(C.M)C-bookCover/P090902019.jpg,char_data/세/P090902019.jpg_2.jpg,10028,480,640,92,235,327,72,181,False,66
세,108,kaist_dataset/Mixed/Mobile_Phone/(C.M)C-bookCover/P090903009.jpg,char_data/세/P090903009.jpg_2.jpg,7668,480,640,71,398,469,245,353,False,66
도,33,kaist_dataset/English/Digital_Camera/(E.S)B-light/080116-0059.jpg,char_data/도/080116-0059.jpg_2.jpg,627,1200,1600,19,805,824,902,935,True,56
도,73,kaist_dataset/Korean/Digital_Camera/A-shadow/DSC03755.JPG,char_data/도/DSC03755.JPG_2.jpg,4526,480,640,62,491,553,27,100,True,56
도,76,kaist_dataset/Korean/Digital_Camera/A-shadow/DSC03793.JPG,char_data/도/DSC03793.JPG_2.jpg,4940,480,640,65,236,301,160,236,True,56
도,59,kaist_dataset/Korean/Digital_Camera/B-light/DSC03492.JPG,char_data/도/DSC03492.JPG_2.jpg,5664,480,640,96,169,265,320,379,True,56
도,29,kaist_dataset/Korean/Digital_Camera/E-night/P1010146.JPG,char_data/도/P1010146.JPG_2.jpg,1740,480,640,60,528,588,17,46,True,56
도,68,kaist_dataset/Korean/Digital_Camera/E-night/P1010149.JPG,char_data/도/P1010149.JPG_2.jpg,4080,480,640,60,211,271,198,266,True,56
도,96,kaist_dataset/Korean/Digital_Camera/E-night/사진14.jpg 수정.jpg,char_data/도/사진14.jpg 수정.jpg_2.jpg,11232,300,400,117,23,140,64,160,True,56
도,75,kaist_dataset/Korean/Digital_Camera/F-bookCover/DSC04217.JPG,char_data/도/DSC04217.JPG_2.jpg,6825,480,640,91,60,151,68,143,True,56
도,79,kaist_dataset/Korean/Digital_Camera/F-bookCover/DSC04220.JPG,char_data/도/DSC04220.JPG_2.jpg,4582,480,640,58,232,290,104,183,True,56
도,81,kaist_dataset/Korean/Digital_Camera/G-others/DSC02904.JPG,char_data/도/DSC02904.JPG_2.jpg,6966,480,640,86,427,513,329,410,True,56
도,52,kaist_dataset/Korean/Digital_Camera/G-others/DSC03863.JPG,char_data/도/DSC03863.JPG_2.jpg,4004,480,640,77,245,322,127,179,True,56
도,76,kaist_dataset/Korean/Digital_Camera/indoor1/DSC02745.JPG,char_data/도/DSC02745.JPG_2.jpg,7144,480,640,94,448,542,266,342,True,56
도,86,kaist_dataset/Korean/Digital_Camera/indoor1/DSC02811.JPG,char_data/도/DSC02811.JPG_2.jpg,7482,480,640,87,294,381,256,342,True,56
도,55,kaist_dataset/Korean/Digital_Camera/indoor1/DSC03072.JPG,char_data/도/DSC03072.JPG_2.jpg,2860,480,640,52,256,308,241,296,True,56
도,60,kaist_dataset/Korean/Digital_Camera/indoor1/DSC03088.JPG,char_data/도/DSC03088.JPG_2.jpg,3600,480,640,60,20,80,257,317,True,56
도,74,kaist_dataset/Korean/Digital_Camera/indoor1/DSC03089.JPG,char_data/도/DSC03089.JPG_2.jpg,5550,480,640,75,91,166,326,400,True,56
도,80,kaist_dataset/Korean/Digital_Camera/indoor1/DSC03097.JPG,char_data/도/DSC03097.JPG_2.jpg,7600,480,640,95,211,306,161,241,True,56
도,46,kaist_dataset/Korean/Digital_Camera/indoor1/DSC03116.JPG,char_data/도/DSC03116.JPG_2.jpg,1840,480,640,40,135,175,256,302,True,56
도,54,kaist_dataset/Korean/Digital_Camera/indoor1/DSC03380.JPG,char_data/도/DSC03380.JPG_2.jpg,2808,480,640,52,260,312,203,257,True,56
도,34,kaist_dataset/Korean/Digital_Camera/indoor2/DSC03530.JPG,char_data/도/DSC03530.JPG_2.jpg,986,480,640,29,319,348,220,254,True,56
도,46,kaist_dataset/Korean/Digital_Camera/indoor2/DSC03994.JPG,char_data/도/DSC03994.JPG_2.jpg,1472,480,640,32,235,267,89,135,True,56
도,62,kaist_dataset/Korean/Digital_Camera/indoor2/DSC03995.JPG,char_data/도/DSC03995.JPG_2.jpg,4092,480,640,66,45,111,205,267,True,56
도,84,kaist_dataset/Korean/Digital_Camera/indoor2/DSC04179.JPG,char_data/도/DSC04179.JPG_2.jpg,5544,480,640,66,29,95,132,216,True,56
도,61,kaist_dataset/Korean/Digital_Camera/indoor2/DSC04186.JPG,char_data/도/DSC04186.JPG_2.jpg,3660,480,640,60,395,455,73,134,True,56
도,54,kaist_dataset/Korean/Digital_Camera/indoor2/DSC04243.JPG,char_data/도/DSC04243.JPG_2.jpg,2700,480,640,50,291,341,71,125,True,56
도,35,kaist_dataset/Korean/Digital_Camera/outdoor1/028.JPG,char_data/도/028.JPG_2.jpg,1435,480,640,41,360,401,416,451,True,56
도,57,kaist_dataset/Korean/Digital_Camera/outdoor1/051.JPG,char_data/도/051.JPG_2.jpg,3648,480,640,64,402,466,195,252,True,56
도,22,kaist_dataset/Korean/Digital_Camera/outdoor1/109.JPG,char_data/도/109.JPG_2.jpg,396,480,640,18,278,296,36,58,True,56
도,77,kaist_dataset/Korean/Digital_Camera/outdoor2/2007-12-08-day-109.jpg,char_data/도/2007-12-08-day-109.jpg_2.jpg,1925,1200,1600,25,153,178,546,623,True,56
도,41,kaist_dataset/Korean/Digital_Camera/outdoor2/DSC02453.JPG,char_data/도/DSC02453.JPG_2.jpg,1312,480,640,32,389,421,233,274,True,56
도,151,kaist_dataset/Korean/Digital_Camera/outdoor3/DSC02900.JPG,char_data/도/DSC02900.JPG_2.jpg,16459,480,640,109,14,123,188,339,True,56
도,123,kaist_dataset/Korean/Digital_Camera/outdoor3/DSC02911.JPG,char_data/도/DSC02911.JPG_2.jpg,9840,480,640,80,174,254,144,267,True,56
도,55,kaist_dataset/Korean/Digital_Camera/outdoor3/DSC03066.JPG,char_data/도/DSC03066.JPG_2.jpg,4290,480,640,78,399,477,178,233,True,56
도,112,kaist_dataset/Korean/Digital_Camera/outdoor3/DSC03231.JPG,char_data/도/DSC03231.JPG_2.jpg,13328,480,640,119,214,333,172,284,True,56
도,93,kaist_dataset/Korean/Digital_Camera/outdoor4/DSC03547.JPG,char_data/도/DSC03547.JPG_2.jpg,10137,480,640,109,88,197,72,165,True,56
도,65,kaist_dataset/Korean/Digital_Camera/outdoor4/DSC03584.JPG,char_data/도/DSC03584.JPG_2.jpg,3835,480,640,59,517,576,168,233,True,56
도,51,kaist_dataset/Korean/Digital_Camera/outdoor4/DSC03589.JPG,char_data/도/DSC03589.JPG_2.jpg,1887,480,640,37,370,407,206,257,True,56
도,62,kaist_dataset/Korean/Digital_Camera/outdoor4/DSC03605.JPG,char_data/도/DSC03605.JPG_2.jpg,3286,480,640,53,476,529,310,372,True,56
도,63,kaist_dataset/Korean/Digital_Camera/outdoor4/DSC03619.JPG,char_data/도/DSC03619.JPG_2.jpg,5040,480,640,80,423,503,386,449,True,56
도,62,kaist_dataset/Korean/Digital_Camera/outdoor5/DSC03690.JPG,char_data/도/DSC03690.JPG_2.jpg,3720,480,640,60,259,319,176,238,True,56
도,150,kaist_dataset/Korean/Digital_Camera/outdoor5/DSC03692.JPG,char_data/도/DSC03692.JPG_2.jpg,18450,480,640,123,47,170,244,394,True,56
도,79,kaist_dataset/Korean/Digital_Camera/outdoor5/DSC03710.JPG,char_data/도/DSC03710.JPG_2.jpg,5214,480,640,66,212,278,325,404,True,56
도,123,kaist_dataset/Korean/Digital_Camera/outdoor5/DSC03717.JPG,char_data/도/DSC03717.JPG_2.jpg,8241,480,640,67,199,266,218,341,True,56
도,104,kaist_dataset/Korean/Digital_Camera/outdoor5/DSC03729.JPG,char_data/도/DSC03729.JPG_2.jpg,12272,480,640,118,489,607,283,387,True,56
도,24,kaist_dataset/Korean/Digital_Camera/outdoor5/DSC03777.JPG,char_data/도/DSC03777.JPG_2.jpg,504,480,640,21,127,148,276,300,True,56
도,93,kaist_dataset/Korean/Digital_Camera/outdoor5/DSC03780.JPG,char_data/도/DSC03780.JPG_2.jpg,7533,480,640,81,416,497,365,458,True,56
도,92,kaist_dataset/Korean/Digital_Camera/outdoor6/DSC04081.JPG,char_data/도/DSC04081.JPG_2.jpg,8372,480,640,91,336,427,207,299,True,56
도,90,kaist_dataset/Korean/Digital_Camera/outdoor6/DSC04082.JPG,char_data/도/DSC04082.JPG_2.jpg,5850,480,640,65,337,402,106,196,True,56
도,46,kaist_dataset/Korean/Digital_Camera/outdoor6/DSC04148.JPG,char_data/도/DSC04148.JPG_6.jpg,1518,480,640,33,269,302,250,296,True,56
도,44,kaist_dataset/Korean/Digital_Camera/outdoor6/DSC04148.JPG,char_data/도/DSC04148.JPG_7.jpg,1628,480,640,37,289,326,305,349,True,56
도,46,kaist_dataset/Korean/Digital_Camera/outdoor6/DSC04148.JPG,char_data/도/DSC04148.JPG_8.jpg,1794,480,640,39,344,383,361,407,True,56
도,90,kaist_dataset/Korean/Digital_Camera/outdoor6/DSC04441.JPG,char_data/도/DSC04441.JPG_2.jpg,8370,480,640,93,90,183,45,135,True,56
도,63,kaist_dataset/Korean/Digital_Camera/outdoor7/P1010065.JPG,char_data/도/P1010065.JPG_2.jpg,5355,480,640,85,85,170,317,380,True,56
도,115,kaist_dataset/Korean/Digital_Camera/outdoor7/P1010068.JPG,char_data/도/P1010068.JPG_2.jpg,13225,480,640,115,59,174,141,256,True,56
도,51,kaist_dataset/Korean/Digital_Camera/outdoor7/P1010085.JPG,char_data/도/P1010085.JPG_2.jpg,1530,480,640,30,124,154,52,103,True,56
도,166,kaist_dataset/Korean/Digital_Camera/outdoor7/P1010086.JPG,char_data/도/P1010086.JPG_2.jpg,33864,480,640,204,61,265,74,240,True,56
도,161,kaist_dataset/Korean/Digital_Camera/outdoor7/P1010087.JPG,char_data/도/P1010087.JPG_2.jpg,17871,480,640,111,116,227,45,206,True,56
도,74,kaist_dataset/Korean/Digital_Camera/outdoor7/P1010107.JPG,char_data/도/P1010107.JPG_2.jpg,7252,480,640,98,504,602,130,204,True,56
도,75,"kaist_dataset/Korean/Mobile_Phone/(M,K)C-outdoor/P090912042.jpg",char_data/도/P090912042.jpg_2.jpg,4650,480,640,62,323,385,180,255,True,56
도,65,"kaist_dataset/Korean/Mobile_Phone/(M,K)E-bookCover/P090831047.jpg",char_data/도/P090831047.jpg_2.jpg,3705,480,640,57,277,334,154,219,True,56
도,61,"kaist_dataset/Korean/Mobile_Phone/(M,K)E-bookCover/P090831056.jpg",char_data/도/P090831056.jpg_4.jpg,2684,480,640,44,28,72,96,157,True,56
도,104,"kaist_dataset/Korean/Mobile_Phone/(M,K)E-bookCover/P090831056.jpg",char_data/도/P090831056.jpg_5.jpg,11024,480,640,106,3,109,178,282,True,56
도,120,"kaist_dataset/Korean/Mobile_Phone/(M,K)E-bookCover/P090831127.jpg",char_data/도/P090831127.jpg_2.jpg,9480,480,640,79,529,608,67,187,True,56
도,49,"kaist_dataset/Korean/Mobile_Phone/(M,K)E-bookCover/P090831132.jpg",char_data/도/P090831132.jpg_2.jpg,1421,480,640,29,442,471,216,265,True,56
도,93,"kaist_dataset/Korean/Mobile_Phone/(M,K)E-bookCover/P090903091.jpg",char_data/도/P090903091.jpg_2.jpg,11160,480,640,120,437,557,352,445,True,56
도,127,kaist_dataset/Mixed/Digital_Camera/(C.S)C-outdoor1/2007-12-08-day-092.jpg,char_data/도/2007-12-08-day-092.jpg_2.jpg,21082,1200,1600,166,1376,1542,524,651,True,56
도,59,kaist_dataset/Mixed/Digital_Camera/(C.S)C-outdoor1/2007-12-09-day-exterior-078.jpg,char_data/도/2007-12-09-day-exterior-078.jpg_2.jpg,2065,1200,1600,35,1195,1230,545,604,True,56
도,41,kaist_dataset/Mixed/Digital_Camera/(C.S)C-outdoor1/DSC02320.JPG,char_data/도/DSC02320.JPG_4.jpg,1435,480,640,35,256,291,352,393,True,56
도,39,kaist_dataset/Mixed/Digital_Camera/(C.S)C-outdoor1/DSC02320.JPG,char_data/도/DSC02320.JPG_5.jpg,1521,480,640,39,395,434,352,391,True,56
도,31,kaist_dataset/Mixed/Digital_Camera/(C.S)C-outdoor2/DSC02411.JPG,char_data/도/DSC02411.JPG_6.jpg,1116,480,640,36,59,95,154,185,True,56
도,99,kaist_dataset/Mixed/Digital_Camera/(C.S)C-outdoor2/DSC02411.JPG,char_data/도/DSC02411.JPG_7.jpg,9999,480,640,101,389,490,198,297,True,56
도,37,kaist_dataset/Mixed/Digital_Camera/(C.S)C-outdoor2/DSC02411.JPG,char_data/도/DSC02411.JPG_8.jpg,962,480,640,26,611,637,428,465,True,56
도,89,kaist_dataset/Mixed/Digital_Camera/(C.S)C-outdoor2/DSC02416.JPG,char_data/도/DSC02416.JPG_2.jpg,12104,480,640,136,143,279,103,192,True,56
도,41,kaist_dataset/Mixed/Digital_Camera/(C.S)C-outdoor2/DSC02425.JPG,char_data/도/DSC02425.JPG_2.jpg,1599,480,640,39,505,544,105,146,True,56
도,76,kaist_dataset/Mixed/Digital_Camera/(C.S)C-outdoor2/DSC02877.JPG,char_data/도/DSC02877.JPG_2.jpg,4712,480,640,62,357,419,136,212,True,56
도,50,kaist_dataset/Mixed/Digital_Camera/(C.S)C-outdoor2/DSC02887.JPG,char_data/도/DSC02887.JPG_2.jpg,2000,480,640,40,341,381,233,283,True,56
도,43,kaist_dataset/Mixed/Digital_Camera/(C.S)C-outdoor2/DSC02933.JPG,char_data/도/DSC02933.JPG_2.jpg,1075,480,640,25,286,311,233,276,True,56
도,86,kaist_dataset/Mixed/Digital_Camera/(C.S)C-outdoor2/DSC02954.JPG,char_data/도/DSC02954.JPG_2.jpg,9632,480,640,112,401,513,157,243,True,56
도,95,kaist_dataset/Mixed/Digital_Camera/(C.S)C-outdoor3/DSC02969.JPG,char_data/도/DSC02969.JPG_2.jpg,7030,480,640,74,108,182,95,190,True,56
도,85,kaist_dataset/Mixed/Digital_Camera/(C.S)C-outdoor3/DSC03004.JPG,char_data/도/DSC03004.JPG_2.jpg,7480,480,640,88,306,394,154,239,True,56
도,43,kaist_dataset/Mixed/Digital_Camera/(C.S)C-outdoor3/DSC03190.JPG,char_data/도/DSC03190.JPG_2.jpg,1591,480,640,37,510,547,326,369,True,56
도,47,kaist_dataset/Mixed/Digital_Camera/(C.S)C-outdoor4/DSC03582.JPG,char_data/도/DSC03582.JPG_2.jpg,1410,480,640,30,316,346,87,134,True,56
도,45,kaist_dataset/Mixed/Digital_Camera/(C.S)C-outdoor4/DSC03630.JPG,char_data/도/DSC03630.JPG_2.jpg,945,480,640,21,518,539,390,435,True,56
도,84,kaist_dataset/Mixed/Digital_Camera/(C.S)C-outdoor4/DSC03633.JPG,char_data/도/DSC03633.JPG_2.jpg,5796,480,640,69,385,454,157,241,False,56
도,72,kaist_dataset/Mixed/Digital_Camera/(C.S)C-outdoor4/DSC03656.JPG,char_data/도/DSC03656.JPG_2.jpg,5256,480,640,73,244,317,330,402,False,56
도,51,kaist_dataset/Mixed/Digital_Camera/(C.S)C-outdoor5/DSC04063.JPG,char_data/도/DSC04063.JPG_2.jpg,918,480,640,18,489,507,297,348,False,56
도,62,kaist_dataset/Mixed/Digital_Camera/(C.S)C-outdoor5/DSC04065.JPG,char_data/도/DSC04065.JPG_2.jpg,3844,480,640,62,188,250,118,180,False,56
도,98,kaist_dataset/Mixed/Digital_Camera/(C.S)C-outdoor5/DSC04069.JPG,char_data/도/DSC04069.JPG_2.jpg,8526,480,640,87,150,237,256,354,False,56
도,58,kaist_dataset/Mixed/Digital_Camera/(C.S)C-outdoor5/DSC04109.JPG,char_data/도/DSC04109.JPG_2.jpg,3074,480,640,53,137,190,307,365,False,56
도,82,kaist_dataset/Mixed/Digital_Camera/(C.S)C-outdoor5/DSC04155.JPG,char_data/도/DSC04155.JPG_2.jpg,7216,480,640,88,26,114,213,295,False,56
도,126,kaist_dataset/Mixed/Digital_Camera/(C.S)C-outdoor5/DSC04330.JPG,char_data/도/DSC04330.JPG_2.jpg,11214,480,640,89,402,491,215,341,False,56
도,73,kaist_dataset/Mixed/Digital_Camera/(C.S)C-outdoor5/DSC04338.JPG,char_data/도/DSC04338.JPG_2.jpg,5402,480,640,74,281,355,97,170,False,56
도,94,kaist_dataset/Mixed/Digital_Camera/(C.S)C-outdoor5/DSC04461.JPG,char_data/도/DSC04461.JPG_2.jpg,9400,480,640,100,131,231,107,201,False,56
도,43,kaist_dataset/Mixed/Digital_Camera/(C.S)C-outdoor5/P1010004.JPG,char_data/도/P1010004.JPG_4.jpg,1763,480,640,41,181,222,104,147,False,56
도,47,kaist_dataset/Mixed/Digital_Camera/(C.S)C-outdoor5/P1010004.JPG,char_data/도/P1010004.JPG_5.jpg,2256,480,640,48,236,284,102,149,False,56
도,53,kaist_dataset/Mixed/Digital_Camera/(C.S)C-outdoor6/크기변환_P1010029.JPG,char_data/도/크기변환_P1010029.JPG_2.jpg,1749,480,640,33,278,311,331,384,False,56
도,35,kaist_dataset/Mixed/Digital_Camera/(C.S)D-indoor1/DSC03096.JPG,char_data/도/DSC03096.JPG_2.jpg,1120,480,640,32,375,407,355,390,False,56
도,79,kaist_dataset/Mixed/Digital_Camera/(C.S)D-indoor1/DSC03904.JPG,char_data/도/DSC03904.JPG_2.jpg,6004,480,640,76,298,374,96,175,False,56
도,98,kaist_dataset/Mixed/Digital_Camera/(C.S)D-indoor1/DSC03980.JPG,char_data/도/DSC03980.JPG_4.jpg,9702,480,640,99,426,525,44,142,False,56
도,88,kaist_dataset/Mixed/Digital_Camera/(C.S)D-indoor1/DSC03980.JPG,char_data/도/DSC03980.JPG_5.jpg,9064,480,640,103,375,478,221,309,False,56
도,46,kaist_dataset/Mixed/Digital_Camera/(C.S)E-night/사진9.jpg수정.jpg,char_data/도/사진9.jpg수정.jpg_2.jpg,2714,480,680,59,397,456,245,291,False,56
도,81,kaist_dataset/Mixed/Digital_Camera/(C.S)F-others/2007-12-08-day-113.jpg,char_data/도/2007-12-08-day-113.jpg_2.jpg,4374,1200,1600,54,999,1053,757,838,False,56
도,58,kaist_dataset/Mixed/Mobile_Phone/(C.M)A-outdoor/P090912040.jpg,char_data/도/P090912040.jpg_2.jpg,5162,480,640,89,34,123,120,178,False,56
도,124,kaist_dataset/Mixed/Mobile_Phone/(C.M)C-bookCover/P090831043.jpg,char_data/도/P090831043.jpg_2.jpg,11904,480,640,96,10,106,108,232,False,56
비,135,kaist_dataset/Korean/Digital_Camera/A-shadow/104.JPG,char_data/비/104.JPG_4.jpg,12285,480,640,91,326,417,157,292,True,63
비,120,kaist_dataset/Korean/Digital_Camera/A-shadow/104.JPG,char_data/비/104.JPG_5.jpg,7800,480,640,65,255,320,343,463,True,63
비,59,kaist_dataset/Korean/Digital_Camera/A-shadow/2007-12-09-day-exterior-040.jpg,char_data/비/2007-12-09-day-exterior-040.jpg_4.jpg,1652,1200,1600,28,364,392,850,909,True,63
비,82,kaist_dataset/Korean/Digital_Camera/A-shadow/2007-12-09-day-exterior-040.jpg,char_data/비/2007-12-09-day-exterior-040.jpg_5.jpg,8364,1200,1600,102,784,886,803,885,True,63
비,108,kaist_dataset/Korean/Digital_Camera/A-shadow/P1010003.JPG,char_data/비/P1010003.JPG_2.jpg,8640,480,640,80,461,541,142,250,True,63
비,81,kaist_dataset/Korean/Digital_Camera/A-shadow/P1010036.JPG,char_data/비/P1010036.JPG_2.jpg,4941,480,640,61,353,414,1,81,True,63
비,51,kaist_dataset/Korean/Digital_Camera/A-shadow/P1010064.JPG,char_data/비/P1010064.JPG_6.jpg,2805,480,640,55,400,455,136,187,True,63
비,62,kaist_dataset/Korean/Digital_Camera/A-shadow/P1010064.JPG,char_data/비/P1010064.JPG_7.jpg,2728,480,640,44,370,414,277,339,True,63
비,37,kaist_dataset/Korean/Digital_Camera/A-shadow/P1010064.JPG,char_data/비/P1010064.JPG_8.jpg,1184,480,640,32,429,461,407,444,True,63
비,103,kaist_dataset/Korean/Digital_Camera/B-light/DSC03494.JPG,char_data/비/DSC03494.JPG_2.jpg,7725,480,640,75,300,375,281,384,True,63
비,200,kaist_dataset/Korean/Digital_Camera/E-night/DSC02612.JPG,char_data/비/DSC02612.JPG_2.jpg,32600,480,640,163,9,172,191,391,True,63
비,120,kaist_dataset/Korean/Digital_Camera/E-night/DSC02663.JPG,char_data/비/DSC02663.JPG_2.jpg,9720,480,640,81,137,218,306,426,True,63
비,23,kaist_dataset/Korean/Digital_Camera/indoor1/136.JPG,char_data/비/136.JPG_2.jpg,529,480,640,23,277,300,268,291,True,63
비,105,kaist_dataset/Korean/Digital_Camera/indoor1/DSC02699.JPG,char_data/비/DSC02699.JPG_2.jpg,7980,480,640,76,235,311,92,197,True,63
비,42,kaist_dataset/Korean/Digital_Camera/indoor1/DSC02704.JPG,char_data/비/DSC02704.JPG_2.jpg,1344,480,640,32,440,472,326,368,True,63
비,97,kaist_dataset/Korean/Digital_Camera/indoor1/DSC02766.JPG,char_data/비/DSC02766.JPG_2.jpg,9118,480,640,94,70,164,145,242,True,63
비,120,kaist_dataset/Korean/Digital_Camera/indoor1/DSC02774.JPG,char_data/비/DSC02774.JPG_2.jpg,10920,480,640,91,33,124,269,389,True,63
비,115,kaist_dataset/Korean/Digital_Camera/indoor2/DSC03565.JPG,char_data/비/DSC03565.JPG_2.jpg,11385,480,640,99,77,176,137,252,True,63
비,68,kaist_dataset/Korean/Digital_Camera/indoor2/DSC04021.JPG,char_data/비/DSC04021.JPG_2.jpg,3400,480,640,50,265,315,106,174,True,63
비,82,kaist_dataset/Korean/Digital_Camera/indoor2/DSC04175.JPG,char_data/비/DSC04175.JPG_2.jpg,3690,480,640,45,207,252,367,449,True,63
비,50,kaist_dataset/Korean/Digital_Camera/indoor2/DSC04250.JPG,char_data/비/DSC04250.JPG_2.jpg,1850,480,640,37,193,230,252,302,True,63
비,113,kaist_dataset/Korean/Digital_Camera/indoor2/DSC04253.JPG,char_data/비/DSC04253.JPG_2.jpg,4633,480,640,41,528,569,88,201,True,63
비,43,kaist_dataset/Korean/Digital_Camera/outdoor1/2007-12-08-day-057.jpg,char_data/비/2007-12-08-day-057.jpg_2.jpg,2150,1200,1600,50,730,780,1116,1159,True,63
비,19,kaist_dataset/Korean/Digital_Camera/outdoor1/45.jpg,char_data/비/45.jpg_2.jpg,342,253,373,18,222,240,53,72,True,63
비,76,kaist_dataset/Korean/Digital_Camera/outdoor2/2007-12-09-day-exterior-055.jpg,char_data/비/2007-12-09-day-exterior-055.jpg_2.jpg,5016,1200,1600,66,1035,1101,1,77,True,63
비,93,kaist_dataset/Korean/Digital_Camera/outdoor2/DSC02372.JPG,char_data/비/DSC02372.JPG_2.jpg,6231,480,640,67,394,461,201,294,True,63
비,92,kaist_dataset/Korean/Digital_Camera/outdoor2/DSC02393.JPG,char_data/비/DSC02393.JPG_2.jpg,12788,480,640,139,119,258,166,258,True,63
비,43,kaist_dataset/Korean/Digital_Camera/outdoor2/DSC02396.JPG,char_data/비/DSC02396.JPG_2.jpg,817,480,640,19,187,206,367,410,True,63
비,126,kaist_dataset/Korean/Digital_Camera/outdoor2/DSC02420.JPG,char_data/비/DSC02420.JPG_2.jpg,12348,480,640,98,14,112,123,249,True,63
비,103,kaist_dataset/Korean/Digital_Camera/outdoor3/DSC02538.JPG,char_data/비/DSC02538.JPG_2.jpg,9373,480,640,91,280,371,171,274,True,63
비,109,kaist_dataset/Korean/Digital_Camera/outdoor3/DSC02539.JPG,char_data/비/DSC02539.JPG_2.jpg,12862,480,640,118,451,569,185,294,True,63
비,69,kaist_dataset/Korean/Digital_Camera/outdoor3/DSC02697.JPG,char_data/비/DSC02697.JPG_2.jpg,3933,480,640,57,279,336,153,222,True,63
비,103,kaist_dataset/Korean/Digital_Camera/outdoor3/DSC02899.JPG,char_data/비/DSC02899.JPG_2.jpg,15244,480,640,148,247,395,98,201,True,63
비,109,kaist_dataset/Korean/Digital_Camera/outdoor4/DSC03278.JPG,char_data/비/DSC03278.JPG_2.jpg,10573,480,640,97,277,374,290,399,True,63
비,56,kaist_dataset/Korean/Digital_Camera/outdoor4/DSC03325.JPG,char_data/비/DSC03325.JPG_2.jpg,2800,480,640,50,477,527,207,263,True,63
비,118,kaist_dataset/Korean/Digital_Camera/outdoor4/DSC03404.JPG,char_data/비/DSC03404.JPG_2.jpg,12390,480,640,105,133,238,128,246,True,63
비,80,kaist_dataset/Korean/Digital_Camera/outdoor4/DSC03546.JPG,char_data/비/DSC03546.JPG_2.jpg,6800,480,640,85,329,414,318,398,True,63
비,69,kaist_dataset/Korean/Digital_Camera/outdoor4/DSC03567.JPG,char_data/비/DSC03567.JPG_2.jpg,4209,480,640,61,204,265,84,153,True,63
비,59,kaist_dataset/Korean/Digital_Camera/outdoor5/DSC03713.JPG,char_data/비/DSC03713.JPG_2.jpg,2301,480,640,39,468,507,336,395,True,63
비,34,kaist_dataset/Korean/Digital_Camera/outdoor5/DSC03751.JPG,char_data/비/DSC03751.JPG_2.jpg,1088,480,640,32,84,116,333,367,True,63
비,142,kaist_dataset/Korean/Digital_Camera/outdoor5/DSC03997.JPG,char_data/비/DSC03997.JPG_2.jpg,14058,480,640,99,330,429,62,204,True,63
비,102,kaist_dataset/Korean/Digital_Camera/outdoor6/DSC04088.JPG,char_data/비/DSC04088.JPG_2.jpg,7650,480,640,75,305,380,205,307,True,63
비,126,kaist_dataset/Korean/Digital_Camera/outdoor6/DSC04356.JPG,char_data/비/DSC04356.JPG_2.jpg,8946,480,640,71,316,387,290,416,True,63
비,73,kaist_dataset/Korean/Digital_Camera/outdoor6/DSC04396.JPG,char_data/비/DSC04396.JPG_2.jpg,4526,480,640,62,94,156,88,161,True,63
비,85,kaist_dataset/Korean/Digital_Camera/outdoor7/P1010017.JPG,char_data/비/P1010017.JPG_4.jpg,4165,480,640,49,452,501,227,312,True,63
비,69,kaist_dataset/Korean/Digital_Camera/outdoor7/P1010019.JPG,char_data/비/P1010019.JPG_2.jpg,4968,480,640,72,86,158,149,218,True,63
비,92,kaist_dataset/Korean/Digital_Camera/outdoor7/P1010023.JPG,char_data/비/P1010023.JPG_2.jpg,7820,480,640,85,306,391,178,270,True,63
비,60,kaist_dataset/Korean/Digital_Camera/outdoor7/P1010065.JPG,char_data/비/P1010065.JPG_2.jpg,4860,480,640,81,495,576,243,303,True,63
비,62,kaist_dataset/Korean/Digital_Camera/outdoor7/P1010070.JPG,char_data/비/P1010070.JPG_2.jpg,5332,480,640,86,113,199,93,155,True,63
비,133,kaist_dataset/Korean/Digital_Camera/outdoor7/P1010079.JPG,char_data/비/P1010079.JPG_2.jpg,16226,480,640,122,345,467,49,182,True,63
비,69,kaist_dataset/Korean/Digital_Camera/outdoor7/P1010135.JPG,char_data/비/P1010135.JPG_4.jpg,6486,480,640,94,241,335,129,198,True,63
비,33,kaist_dataset/Korean/Digital_Camera/outdoor7/P1010135.JPG,char_data/비/P1010135.JPG_5.jpg,957,480,640,29,324,353,84,117,True,63
비,79,kaist_dataset/Korean/Digital_Camera/outdoor8/크기변환_P1010033.JPG,char_data/비/크기변환_P1010033.JPG_2.jpg,6241,480,640,79,213,292,59,138,True,63
비,140,"kaist_dataset/Korean/Mobile_Phone/(M,K)E-bookCover/P090831031.jpg",char_data/비/P090831031.jpg_2.jpg,14420,480,640,103,15,118,165,305,True,63
비,86,"kaist_dataset/Korean/Mobile_Phone/(M,K)E-bookCover/P090831147.jpg",char_data/비/P090831147.jpg_2.jpg,7740,480,640,90,428,518,69,155,True,63
비,114,"kaist_dataset/Korean/Mobile_Phone/(M,K)E-bookCover/P090903025.jpg",char_data/비/P090903025.jpg_2.jpg,10716,480,640,94,250,344,188,302,True,63
비,90,kaist_dataset/Mixed/Digital_Camera/(C.S)A-shadow/DSC03257.JPG,char_data/비/DSC03257.JPG_2.jpg,10980,480,640,122,498,620,272,362,True,63
비,81,kaist_dataset/Mixed/Digital_Camera/(C.S)C-outdoor1/080119-0006.jpg,char_data/비/080119-0006.jpg_2.jpg,5508,1200,1600,68,274,342,839,920,True,63
비,35,kaist_dataset/Mixed/Digital_Camera/(C.S)C-outdoor1/080119-0027.jpg,char_data/비/080119-0027.jpg_2.jpg,840,1200,1600,24,1028,1052,1002,1037,True,63
비,47,kaist_dataset/Mixed/Digital_Camera/(C.S)C-outdoor1/112.JPG,char_data/비/112.JPG_2.jpg,1786,480,640,38,327,365,279,326,True,63
비,81,kaist_dataset/Mixed/Digital_Camera/(C.S)C-outdoor1/118.JPG,char_data/비/118.JPG_2.jpg,5508,480,640,68,360,428,265,346,True,63
비,81,kaist_dataset/Mixed/Digital_Camera/(C.S)C-outdoor1/133.JPG,char_data/비/133.JPG_2.jpg,5508,480,640,68,352,420,199,280,True,63
비,86,kaist_dataset/Mixed/Digital_Camera/(C.S)C-outdoor1/2007-12-09-day-exterior-078.jpg,char_data/비/2007-12-09-day-exterior-078.jpg_4.jpg,5418,1200,1600,63,631,694,398,484,True,63
비,62,kaist_dataset/Mixed/Digital_Camera/(C.S)C-outdoor1/2007-12-09-day-exterior-078.jpg,char_data/비/2007-12-09-day-exterior-078.jpg_5.jpg,2232,1200,1600,36,1104,1140,421,483,True,63
비,33,kaist_dataset/Mixed/Digital_Camera/(C.S)C-outdoor1/3.JPG,char_data/비/3.JPG_4.jpg,924,576,768,28,7,35,2,35,True,63
비,24,kaist_dataset/Mixed/Digital_Camera/(C.S)C-outdoor1/3.JPG,char_data/비/3.JPG_5.jpg,504,576,768,21,340,361,292,316,True,63
비,127,kaist_dataset/Mixed/Digital_Camera/(C.S)C-outdoor1/DSC02322.JPG,char_data/비/DSC02322.JPG_2.jpg,7620,480,640,60,133,193,217,344,True,63
비,93,kaist_dataset/Mixed/Digital_Camera/(C.S)C-outdoor2/DSC02397.JPG,char_data/비/DSC02397.JPG_2.jpg,10137,480,640,109,233,342,91,184,True,63
비,76,kaist_dataset/Mixed/Digital_Camera/(C.S)C-outdoor2/DSC02527.JPG,char_data/비/DSC02527.JPG_2.jpg,4788,480,640,63,205,268,137,213,True,63
비,78,kaist_dataset/Mixed/Digital_Camera/(C.S)C-outdoor2/DSC02701.JPG,char_data/비/DSC02701.JPG_2.jpg,6006,480,640,77,427,504,203,281,True,63
비,97,kaist_dataset/Mixed/Digital_Camera/(C.S)C-outdoor2/DSC02874.JPG,char_data/비/DSC02874.JPG_2.jpg,8342,480,640,86,207,293,224,321,True,63
비,29,kaist_dataset/Mixed/Digital_Camera/(C.S)C-outdoor2/DSC02936.JPG,char_data/비/DSC02936.JPG_2.jpg,841,480,640,29,333,362,225,254,True,63
비,38,kaist_dataset/Mixed/Digital_Camera/(C.S)C-outdoor2/DSC02954.JPG,char_data/비/DSC02954.JPG_2.jpg,1102,480,640,29,338,367,110,148,True,63
비,36,kaist_dataset/Mixed/Digital_Camera/(C.S)C-outdoor2/P1010013.JPG,char_data/비/P1010013.JPG_2.jpg,1512,480,640,42,278,320,279,315,True,63
비,58,kaist_dataset/Mixed/Digital_Camera/(C.S)C-outdoor3/DSC03006.JPG,char_data/비/DSC03006.JPG_2.jpg,2088,480,640,36,516,552,276,334,True,63
비,107,kaist_dataset/Mixed/Digital_Camera/(C.S)C-outdoor3/DSC03285.JPG,char_data/비/DSC03285.JPG_2.jpg,16906,480,640,158,154,312,141,248,True,63
비,71,kaist_dataset/Mixed/Digital_Camera/(C.S)C-outdoor3/DSC03309.JPG,char_data/비/DSC03309.JPG_2.jpg,4970,480,640,70,533,603,123,194,True,63
비,45,kaist_dataset/Mixed/Digital_Camera/(C.S)C-outdoor4/DSC03571.JPG,char_data/비/DSC03571.JPG_2.jpg,1620,480,640,36,206,242,307,352,True,63
비,55,kaist_dataset/Mixed/Digital_Camera/(C.S)C-outdoor4/DSC03613.JPG,char_data/비/DSC03613.JPG_2.jpg,2475,480,640,45,178,223,23,78,True,63
비,48,kaist_dataset/Mixed/Digital_Camera/(C.S)C-outdoor4/DSC03678.JPG,char_data/비/DSC03678.JPG_2.jpg,1536,480,640,32,340,372,239,287,True,63
비,41,kaist_dataset/Mixed/Digital_Camera/(C.S)C-outdoor5/DSC03839.JPG,char_data/비/DSC03839.JPG_2.jpg,1640,480,640,40,262,302,149,190,True,63
비,75,kaist_dataset/Mixed/Digital_Camera/(C.S)C-outdoor5/DSC03867.JPG,char_data/비/DSC03867.JPG_2.jpg,4125,480,640,55,309,364,190,265,True,63
비,47,kaist_dataset/Mixed/Digital_Camera/(C.S)C-outdoor5/DSC04014.JPG,char_data/비/DSC04014.JPG_2.jpg,3901,480,640,83,318,401,182,229,False,63
비,85,kaist_dataset/Mixed/Digital_Camera/(C.S)C-outdoor5/DSC04056.JPG,char_data/비/DSC04056.JPG_2.jpg,5440,480,640,64,293,357,323,408,False,63
비,39,kaist_dataset/Mixed/Digital_Camera/(C.S)C-outdoor5/DSC04057.JPG,char_data/비/DSC04057.JPG_2.jpg,1638,480,640,42,329,371,323,362,False,63
비,83,kaist_dataset/Mixed/Digital_Camera/(C.S)C-outdoor5/DSC04063.JPG,char_data/비/DSC04063.JPG_2.jpg,2822,480,640,34,197,231,258,341,False,63
비,112,kaist_dataset/Mixed/Digital_Camera/(C.S)C-outdoor5/DSC04135.JPG,char_data/비/DSC04135.JPG_2.jpg,4032,480,640,36,104,140,245,357,False,63
비,75,kaist_dataset/Mixed/Digital_Camera/(C.S)C-outdoor5/DSC04150.JPG,char_data/비/DSC04150.JPG_2.jpg,5700,480,640,76,364,440,306,381,False,63
비,104,kaist_dataset/Mixed/Digital_Camera/(C.S)C-outdoor5/DSC04155.JPG,char_data/비/DSC04155.JPG_2.jpg,11648,480,640,112,317,429,199,303,False,63
비,92,kaist_dataset/Mixed/Digital_Camera/(C.S)C-outdoor5/DSC04312.JPG,char_data/비/DSC04312.JPG_2.jpg,5888,480,640,64,429,493,238,330,False,63
비,96,kaist_dataset/Mixed/Digital_Camera/(C.S)C-outdoor6/P1010017.JPG,char_data/비/P1010017.JPG_5.jpg,3936,480,640,41,431,472,64,160,False,63
비,41,kaist_dataset/Mixed/Digital_Camera/(C.S)C-outdoor6/P1010045.JPG,char_data/비/P1010045.JPG_2.jpg,1066,480,640,26,351,377,404,445,False,63
비,52,kaist_dataset/Mixed/Digital_Camera/(C.S)C-outdoor6/P1010054.JPG,char_data/비/P1010054.JPG_2.jpg,1924,480,640,37,199,236,218,270,False,63
비,107,kaist_dataset/Mixed/Digital_Camera/(C.S)C-outdoor6/P1010055.JPG,char_data/비/P1010055.JPG_2.jpg,10593,480,640,99,170,269,121,228,False,63
비,123,kaist_dataset/Mixed/Digital_Camera/(C.S)C-outdoor6/P1010067.JPG,char_data/비/P1010067.JPG_2.jpg,16359,480,640,133,346,479,174,297,False,63
비,83,kaist_dataset/Mixed/Digital_Camera/(C.S)D-indoor1/DSC02775.JPG,char_data/비/DSC02775.JPG_2.jpg,7719,480,640,93,197,290,200,283,False,63
비,41,kaist_dataset/Mixed/Digital_Camera/(C.S)D-indoor1/DSC02840.JPG,char_data/비/DSC02840.JPG_2.jpg,1312,480,640,32,296,328,368,409,False,63
비,125,kaist_dataset/Mixed/Digital_Camera/(C.S)D-indoor1/DSC03472.JPG,char_data/비/DSC03472.JPG_2.jpg,10750,480,640,86,485,571,179,304,False,63
비,70,kaist_dataset/Mixed/Digital_Camera/(C.S)D-indoor1/DSC04009.JPG,char_data/비/DSC04009.JPG_2.jpg,3780,480,640,54,299,353,229,299,False,63
비,42,kaist_dataset/Mixed/Digital_Camera/(C.S)F-others/DSC02881.JPG,char_data/비/DSC02881.JPG_6.jpg,1932,480,640,46,121,167,174,216,False,63
비,32,kaist_dataset/Mixed/Digital_Camera/(C.S)F-others/DSC02881.JPG,char_data/비/DSC02881.JPG_7.jpg,672,480,640,21,178,199,317,349,False,63
비,32,kaist_dataset/Mixed/Digital_Camera/(C.S)F-others/DSC02881.JPG,char_data/비/DSC02881.JPG_8.jpg,800,480,640,25,534,559,219,251,False,63
비,90,kaist_dataset/Mixed/Mobile_Phone/(C.M)A-outdoor/P090912038.jpg,char_data/비/P090912038.jpg_2.jpg,8010,480,640,89,250,339,58,148,False,63
만,32,kaist_dataset/English/Digital_Camera/(E.S)B-light/080116-0059.jpg,char_data/만/080116-0059.jpg_4.jpg,736,1200,1600,23,1048,1071,1020,1052,True,60
만,33,kaist_dataset/English/Digital_Camera/(E.S)B-light/080116-0059.jpg,char_data/만/080116-0059.jpg_5.jpg,726,1200,1600,22,516,538,1084,1117,True,60
만,49,kaist_dataset/Korean/Digital_Camera/E-night/DSC03850.JPG,char_data/만/DSC03850.JPG_2.jpg,2254,480,640,46,155,201,2,51,True,60
만,45,kaist_dataset/Korean/Digital_Camera/F-bookCover/DSC02812.JPG,char_data/만/DSC02812.JPG_2.jpg,1710,480,640,38,351,389,7,52,True,60
만,38,kaist_dataset/Korean/Digital_Camera/F-bookCover/DSC02813.JPG,char_data/만/DSC02813.JPG_2.jpg,1292,480,640,34,317,351,16,54,True,60
만,43,kaist_dataset/Korean/Digital_Camera/F-bookCover/DSC02814.JPG,char_data/만/DSC02814.JPG_2.jpg,1505,480,640,35,329,364,15,58,True,60
만,31,kaist_dataset/Korean/Digital_Camera/F-bookCover/DSC02815.JPG,char_data/만/DSC02815.JPG_2.jpg,899,480,640,29,316,345,25,56,True,60
만,115,kaist_dataset/Korean/Digital_Camera/F-bookCover/DSC02833.JPG,char_data/만/DSC02833.JPG_2.jpg,11385,480,640,99,339,438,346,461,True,60
만,52,kaist_dataset/Korean/Digital_Camera/indoor1/DSC02740.JPG,char_data/만/DSC02740.JPG_2.jpg,1820,480,640,35,402,437,91,143,True,60
만,40,kaist_dataset/Korean/Digital_Camera/indoor1/DSC02757.JPG,char_data/만/DSC02757.JPG_2.jpg,1080,480,640,27,368,395,154,194,True,60
만,96,kaist_dataset/Korean/Digital_Camera/indoor1/DSC02761.JPG,char_data/만/DSC02761.JPG_2.jpg,8064,480,640,84,232,316,272,368,True,60
만,44,kaist_dataset/Korean/Digital_Camera/indoor1/DSC03113.JPG,char_data/만/DSC03113.JPG_2.jpg,1540,480,640,35,198,233,155,199,True,60
만,34,kaist_dataset/Korean/Digital_Camera/indoor2/DSC03564.JPG,char_data/만/DSC03564.JPG_4.jpg,1088,480,640,32,209,241,266,300,True,60
만,34,kaist_dataset/Korean/Digital_Camera/indoor2/DSC03564.JPG,char_data/만/DSC03564.JPG_5.jpg,1054,480,640,31,212,243,314,348,True,60
만,59,kaist_dataset/Korean/Digital_Camera/indoor2/DSC03902.JPG,char_data/만/DSC03902.JPG_2.jpg,2832,480,640,48,84,132,215,274,True,60
만,115,kaist_dataset/Korean/Digital_Camera/indoor2/DSC04001.JPG,char_data/만/DSC04001.JPG_2.jpg,10695,480,640,93,112,205,351,466,True,60
만,91,kaist_dataset/Korean/Digital_Camera/outdoor1/071.JPG,char_data/만/071.JPG_2.jpg,13559,480,640,149,160,309,165,256,True,60
만,230,kaist_dataset/Korean/Digital_Camera/outdoor2/2007-12-09-day-exterior-016.jpg,char_data/만/2007-12-09-day-exterior-016.jpg_2.jpg,59800,1200,1600,260,393,653,510,740,True,60
만,90,kaist_dataset/Korean/Digital_Camera/outdoor2/DSC02314.JPG,char_data/만/DSC02314.JPG_2.jpg,6120,480,640,68,309,377,87,177,True,60
만,252,kaist_dataset/Korean/Digital_Camera/outdoor3/DSC03180.JPG,char_data/만/DSC03180.JPG_2.jpg,52416,480,640,208,69,277,90,342,True,60
만,106,kaist_dataset/Korean/Digital_Camera/outdoor4/DSC03288.JPG,char_data/만/DSC03288.JPG_2.jpg,11024,480,640,104,318,422,197,303,True,60
만,36,kaist_dataset/Korean/Digital_Camera/outdoor4/DSC03547.JPG,char_data/만/DSC03547.JPG_2.jpg,1404,480,640,39,113,152,165,201,True,60
만,48,kaist_dataset/Korean/Digital_Camera/outdoor4/DSC03589.JPG,char_data/만/DSC03589.JPG_2.jpg,1536,480,640,32,209,241,192,240,True,60
만,61,kaist_dataset/Korean/Digital_Camera/outdoor4/DSC03591.JPG,char_data/만/DSC03591.JPG_2.jpg,4026,480,640,66,171,237,326,387,True,60
만,72,kaist_dataset/Korean/Digital_Camera/outdoor4/DSC03598.JPG,char_data/만/DSC03598.JPG_2.jpg,4968,480,640,69,149,218,90,162,True,60
만,89,kaist_dataset/Korean/Digital_Camera/outdoor4/DSC03599.JPG,char_data/만/DSC03599.JPG_4.jpg,6230,480,640,70,173,243,111,200,True,60
만,44,kaist_dataset/Korean/Digital_Camera/outdoor4/DSC03599.JPG,char_data/만/DSC03599.JPG_5.jpg,924,480,640,21,296,317,308,352,True,60
만,75,kaist_dataset/Korean/Digital_Camera/outdoor4/DSC03600.JPG,char_data/만/DSC03600.JPG_2.jpg,4800,480,640,64,215,279,178,253,True,60
만,87,kaist_dataset/Korean/Digital_Camera/outdoor4/DSC03607.JPG,char_data/만/DSC03607.JPG_4.jpg,5742,480,640,66,33,99,262,349,True,60
만,77,kaist_dataset/Korean/Digital_Camera/outdoor4/DSC03607.JPG,char_data/만/DSC03607.JPG_5.jpg,5775,480,640,75,22,97,353,430,True,60
만,80,kaist_dataset/Korean/Digital_Camera/outdoor4/DSC03608.JPG,char_data/만/DSC03608.JPG_2.jpg,5680,480,640,71,239,310,198,278,True,60
만,79,kaist_dataset/Korean/Digital_Camera/outdoor4/DSC03610.JPG,char_data/만/DSC03610.JPG_2.jpg,6083,480,640,77,195,272,19,98,True,60
만,66,kaist_dataset/Korean/Digital_Camera/outdoor4/DSC03612.JPG,char_data/만/DSC03612.JPG_2.jpg,3630,480,640,55,175,230,36,102,True,60
만,54,kaist_dataset/Korean/Digital_Camera/outdoor4/DSC03622.JPG,char_data/만/DSC03622.JPG_2.jpg,1728,480,640,32,484,516,240,294,True,60
만,39,kaist_dataset/Korean/Digital_Camera/outdoor5/DSC03636.JPG,char_data/만/DSC03636.JPG_2.jpg,1443,480,640,37,43,80,402,441,True,60
만,118,kaist_dataset/Korean/Digital_Camera/outdoor5/DSC03645.JPG,char_data/만/DSC03645.JPG_2.jpg,13688,480,640,116,202,318,229,347,True,60
만,64,kaist_dataset/Korean/Digital_Camera/outdoor5/DSC03694.JPG,char_data/만/DSC03694.JPG_2.jpg,3648,480,640,57,163,220,37,101,True,60
만,61,kaist_dataset/Korean/Digital_Camera/outdoor5/DSC03715.JPG,char_data/만/DSC03715.JPG_2.jpg,3111,480,640,51,227,278,176,237,True,60
만,52,kaist_dataset/Korean/Digital_Camera/outdoor5/DSC03740.JPG,char_data/만/DSC03740.JPG_2.jpg,2600,480,640,50,186,236,216,268,True,60
만,68,kaist_dataset/Korean/Digital_Camera/outdoor5/DSC03744.JPG,char_data/만/DSC03744.JPG_2.jpg,5576,480,640,82,2,84,246,314,True,60
만,89,kaist_dataset/Korean/Digital_Camera/outdoor5/DSC03762.JPG,char_data/만/DSC03762.JPG_2.jpg,6497,480,640,73,311,384,174,263,True,60
만,100,kaist_dataset/Korean/Digital_Camera/outdoor5/DSC03763.JPG,char_data/만/DSC03763.JPG_2.jpg,7500,480,640,75,346,421,135,235,True,60
만,126,kaist_dataset/Korean/Digital_Camera/outdoor5/DSC03770.JPG,char_data/만/DSC03770.JPG_2.jpg,8190,480,640,65,90,155,296,422,True,60
만,111,kaist_dataset/Korean/Digital_Camera/outdoor5/DSC03771.JPG,char_data/만/DSC03771.JPG_2.jpg,10656,480,640,96,44,140,84,195,True,60
만,43,kaist_dataset/Korean/Digital_Camera/outdoor5/DSC03779.JPG,char_data/만/DSC03779.JPG_2.jpg,1376,480,640,32,347,379,240,283,True,60
만,60,kaist_dataset/Korean/Digital_Camera/outdoor5/DSC03791.JPG,char_data/만/DSC03791.JPG_2.jpg,3000,480,640,50,451,501,85,145,True,60
만,117,kaist_dataset/Korean/Digital_Camera/outdoor5/DSC03848.JPG,char_data/만/DSC03848.JPG_2.jpg,11115,480,640,95,131,226,58,175,True,60
만,57,kaist_dataset/Korean/Digital_Camera/outdoor5/DSC04011.JPG,char_data/만/DSC04011.JPG_2.jpg,3021,480,640,53,385,438,219,276,True,60
만,32,kaist_dataset/Korean/Digital_Camera/outdoor6/DSC04041.JPG,char_data/만/DSC04041.JPG_2.jpg,928,480,640,29,310,339,138,170,True,60
만,71,kaist_dataset/Korean/Digital_Camera/outdoor6/DSC04074.JPG,char_data/만/DSC04074.JPG_2.jpg,3621,480,640,51,423,474,25,96,True,60
만,76,kaist_dataset/Korean/Digital_Camera/outdoor6/DSC04083.JPG,char_data/만/DSC04083.JPG_2.jpg,5548,480,640,73,179,252,160,236,True,60
만,97,kaist_dataset/Korean/Digital_Camera/outdoor6/DSC04088.JPG,char_data/만/DSC04088.JPG_2.jpg,6693,480,640,69,82,151,213,310,True,60
만,75,kaist_dataset/Korean/Digital_Camera/outdoor6/DSC04093.JPG,char_data/만/DSC04093.JPG_2.jpg,7425,480,640,99,20,119,366,441,True,60
만,46,kaist_dataset/Korean/Digital_Camera/outdoor6/DSC04136.JPG,char_data/만/DSC04136.JPG_2.jpg,1886,480,640,41,224,265,328,374,True,60
만,72,kaist_dataset/Korean/Digital_Camera/outdoor6/DSC04138.JPG,char_data/만/DSC04138.JPG_2.jpg,6624,480,640,92,58,150,82,154,True,60
만,42,kaist_dataset/Korean/Digital_Camera/outdoor6/DSC04157.JPG,char_data/만/DSC04157.JPG_2.jpg,2100,480,640,50,264,314,172,214,True,60
만,103,kaist_dataset/Korean/Digital_Camera/outdoor6/DSC04158.JPG,char_data/만/DSC04158.JPG_2.jpg,9373,480,640,91,44,135,310,413,True,60
만,56,kaist_dataset/Korean/Digital_Camera/outdoor6/DSC04161.JPG,char_data/만/DSC04161.JPG_2.jpg,2464,480,640,44,162,206,112,168,True,60
만,99,kaist_dataset/Korean/Digital_Camera/outdoor6/DSC04390.JPG,char_data/만/DSC04390.JPG_4.jpg,5643,480,640,57,182,239,80,179,True,60
만,89,kaist_dataset/Korean/Digital_Camera/outdoor6/DSC04390.JPG,char_data/만/DSC04390.JPG_5.jpg,4361,480,640,49,230,279,180,269,True,60
만,134,kaist_dataset/Korean/Digital_Camera/outdoor7/P1010004.JPG,char_data/만/P1010004.JPG_2.jpg,19564,480,640,146,249,395,156,290,True,60
만,64,kaist_dataset/Korean/Digital_Camera/outdoor7/P1010070.JPG,char_data/만/P1010070.JPG_2.jpg,5248,480,640,82,209,291,99,163,True,60
만,143,"kaist_dataset/Korean/Mobile_Phone/(M,K)E-bookCover/P090831033.jpg",char_data/만/P090831033.jpg_2.jpg,18018,480,640,126,38,164,187,330,True,60
만,167,"kaist_dataset/Korean/Mobile_Phone/(M,K)E-bookCover/P090831133.jpg",char_data/만/P090831133.jpg_2.jpg,18203,480,640,109,225,334,262,429,True,60
만,104,"kaist_dataset/Korean/Mobile_Phone/(M,K)E-bookCover/P090831134.jpg",char_data/만/P090831134.jpg_2.jpg,6344,480,640,61,228,289,252,356,True,60
만,118,"kaist_dataset/Korean/Mobile_Phone/(M,K)E-bookCover/P090903023.jpg",char_data/만/P090903023.jpg_2.jpg,10974,480,640,93,333,426,93,211,True,60
만,45,"kaist_dataset/Korean/Mobile_Phone/(M,K)E-bookCover/P090903051.jpg",char_data/만/P090903051.jpg_2.jpg,1665,480,640,37,219,256,202,247,True,60
만,75,"kaist_dataset/Korean/Mobile_Phone/(M,K)E-bookCover/P090907004.jpg",char_data/만/P090907004.jpg_2.jpg,4050,480,640,54,296,350,64,139,True,60
만,178,"kaist_dataset/Korean/Mobile_Phone/(M,K)E-bookCover/P090911002.jpg",char_data/만/P090911002.jpg_2.jpg,32040,480,640,180,36,216,122,300,True,60
만,61,"kaist_dataset/Korean/Mobile_Phone/(M,K)E-bookCover/P090911074.jpg",char_data/만/P090911074.jpg_2.jpg,3416,480,640,56,466,522,99,160,True,60
만,143,kaist_dataset/Mixed/Digital_Camera/(C.S)C-outdoor1/049.JPG,char_data/만/049.JPG_2.jpg,22308,480,640,156,38,194,178,321,True,60
만,118,kaist_dataset/Mixed/Digital_Camera/(C.S)C-outdoor1/081.JPG,char_data/만/081.JPG_2.jpg,10974,480,640,93,335,428,130,248,True,60
만,47,kaist_dataset/Mixed/Digital_Camera/(C.S)C-outdoor1/112.JPG,char_data/만/112.JPG_2.jpg,1880,480,640,40,366,406,281,328,True,60
만,158,kaist_dataset/Mixed/Digital_Camera/(C.S)C-outdoor2/DSC02359.JPG,char_data/만/DSC02359.JPG_2.jpg,16748,480,640,106,336,442,17,175,True,60
만,48,kaist_dataset/Mixed/Digital_Camera/(C.S)C-outdoor2/DSC02912.JPG,char_data/만/DSC02912.JPG_2.jpg,1728,480,640,36,271,307,64,112,True,60
만,38,kaist_dataset/Mixed/Digital_Camera/(C.S)C-outdoor2/P1010013.JPG,char_data/만/P1010013.JPG_2.jpg,1444,480,640,38,320,358,278,316,True,60
만,65,kaist_dataset/Mixed/Digital_Camera/(C.S)C-outdoor3/DSC02964.JPG,char_data/만/DSC02964.JPG_2.jpg,3185,480,640,49,214,263,77,142,True,60
만,67,kaist_dataset/Mixed/Digital_Camera/(C.S)C-outdoor3/DSC02989.JPG,char_data/만/DSC02989.JPG_2.jpg,2144,480,640,32,63,95,326,393,True,60
만,81,kaist_dataset/Mixed/Digital_Camera/(C.S)C-outdoor3/DSC03273.JPG,char_data/만/DSC03273.JPG_2.jpg,5103,480,640,63,386,449,214,295,True,60
만,48,kaist_dataset/Mixed/Digital_Camera/(C.S)C-outdoor4/DSC03556.JPG,char_data/만/DSC03556.JPG_2.jpg,1680,480,640,35,312,347,251,299,True,60
만,72,kaist_dataset/Mixed/Digital_Camera/(C.S)C-outdoor4/DSC03586.JPG,char_data/만/DSC03586.JPG_2.jpg,3816,480,640,53,163,216,72,144,True,60
만,107,kaist_dataset/Mixed/Digital_Camera/(C.S)C-outdoor4/DSC03616.JPG,char_data/만/DSC03616.JPG_2.jpg,9951,480,640,93,62,155,23,130,True,60
만,47,kaist_dataset/Mixed/Digital_Camera/(C.S)C-outdoor4/DSC03642.JPG,char_data/만/DSC03642.JPG_2.jpg,1457,480,640,31,474,505,346,393,False,60
만,135,kaist_dataset/Mixed/Digital_Camera/(C.S)C-outdoor4/DSC03655.JPG,char_data/만/DSC03655.JPG_2.jpg,13905,480,640,103,66,169,233,368,False,60
만,57,kaist_dataset/Mixed/Digital_Camera/(C.S)C-outdoor4/DSC03660.JPG,char_data/만/DSC03660.JPG_2.jpg,3705,480,640,65,191,256,38,95,False,60
만,28,kaist_dataset/Mixed/Digital_Camera/(C.S)C-outdoor4/DSC03674.JPG,char_data/만/DSC03674.JPG_2.jpg,588,480,640,21,432,453,422,450,False,60
만,93,kaist_dataset/Mixed/Digital_Camera/(C.S)C-outdoor4/DSC03676.JPG,char_data/만/DSC03676.JPG_2.jpg,5115,480,640,55,235,290,334,427,False,60
만,30,kaist_dataset/Mixed/Digital_Camera/(C.S)C-outdoor4/DSC03677.JPG,char_data/만/DSC03677.JPG_2.jpg,540,480,640,18,511,529,283,313,False,60
만,108,kaist_dataset/Mixed/Digital_Camera/(C.S)C-outdoor4/DSC03734.JPG,char_data/만/DSC03734.JPG_2.jpg,10260,480,640,95,205,300,246,354,False,60
만,103,kaist_dataset/Mixed/Digital_Camera/(C.S)C-outdoor4/DSC03743.JPG,char_data/만/DSC03743.JPG_2.jpg,11536,480,640,112,8,120,295,398,False,60
만,76,kaist_dataset/Mixed/Digital_Camera/(C.S)C-outdoor5/DSC04017.JPG,char_data/만/DSC04017.JPG_2.jpg,4256,480,640,56,111,167,348,424,False,60
만,37,kaist_dataset/Mixed/Digital_Camera/(C.S)C-outdoor5/DSC04029.JPG,char_data/만/DSC04029.JPG_2.jpg,1554,480,640,42,228,270,248,285,False,60
만,115,kaist_dataset/Mixed/Digital_Camera/(C.S)C-outdoor5/DSC04032.JPG,char_data/만/DSC04032.JPG_2.jpg,13685,480,640,119,200,319,299,414,False,60
만,73,kaist_dataset/Mixed/Digital_Camera/(C.S)C-outdoor5/DSC04071.JPG,char_data/만/DSC04071.JPG_2.jpg,4526,480,640,62,21,83,238,311,False,60
만,46,kaist_dataset/Mixed/Digital_Camera/(C.S)C-outdoor5/DSC04125.JPG,char_data/만/DSC04125.JPG_2.jpg,1794,480,640,39,308,347,412,458,False,60
만,107,kaist_dataset/Mixed/Digital_Camera/(C.S)C-outdoor5/DSC04135.JPG,char_data/만/DSC04135.JPG_4.jpg,3959,480,640,37,139,176,255,362,False,60
만,46,kaist_dataset/Mixed/Digital_Camera/(C.S)C-outdoor5/DSC04135.JPG,char_data/만/DSC04135.JPG_5.jpg,2760,480,640,60,171,231,376,422,False,60
만,74,kaist_dataset/Mixed/Digital_Camera/(C.S)C-outdoor5/DSC04357.JPG,char_data/만/DSC04357.JPG_2.jpg,5106,480,640,69,299,368,218,292,False,60
만,67,kaist_dataset/Mixed/Digital_Camera/(C.S)D-indoor1/DSC02782.JPG,char_data/만/DSC02782.JPG_2.jpg,5695,480,640,85,395,480,176,243,False,60
만,66,kaist_dataset/Mixed/Digital_Camera/(C.S)D-indoor1/DSC03998.JPG,char_data/만/DSC03998.JPG_2.jpg,4158,480,640,63,23,86,409,475,False,60
만,142,kaist_dataset/Mixed/Mobile_Phone/(C.M)C-bookCover/P090903022.jpg,char_data/만/P090903022.jpg_2.jpg,19312,480,640,136,453,589,267,409,False,60
만,71,kaist_dataset/Mixed/Mobile_Phone/(C.M)C-bookCover/P090903024.jpg,char_data/만/P090903024.jpg_2.jpg,5396,480,640,76,416,492,282,353,False,60
만,222,kaist_dataset/Mixed/Mobile_Phone/(C.M)C-bookCover/P090903063.jpg,char_data/만/P090903063.jpg_2.jpg,23088,480,640,104,120,224,41,263,False,60
